afilados	None
desilude	Positive
traduzirás	None
desafogarão	None
comprimi	Positive
dominarem	None
trama	Positive
reino	None
repugna	Positive
promulga	Positive
habitam	None
transbordado	None
aninhai	Positive
insistes	None
redigitai	Positive
descortineis	Negative
proporciones	Negative
apóia	Positive
acupuntura	Positive
abortando	None
sincopeis	Negative
orneai	Positive
abjurai	Positive
palpitai	Positive
aromatizeis	Negative
debilitai	Positive
ludibria	Positive
estenographará	None
estragues	Negative
encapsula	Positive
abríreis	None
partilhando	None
persuadais	Negative
chafurdasse	None
intercepta	Positive
prui	Positive
assoberbai	Positive
reduzi	Positive
debuxes	Negative
reorganizes	Negative
aferventeis	Negative
apruma	Positive
esmagaria	None
pana	Positive
sagres	Negative
acolhe	Positive
pendendo	None
incha	Positive
esfola	Positive
demonstra	Positive
origines	Negative
sobrevivessem	None
resumiram	None
perspectiveis	Negative
flagela	Positive
chocada	None
sumules	Negative
aperfeiçoa	Positive
une	Positive
impossibilita	Positive
forram	None
artilharias	None
reverencia	Positive
acalmeis	Negative
finge	Positive
aportuguesou	None
tangara	None
transfere	Positive
arranhados	None
redescobre	Positive
bombardeia	Positive
printeis	Negative
agrupai	Positive
computai	Positive
estagia	Positive
situasse	None
desconheciam	None
moscada	None
adolesçais	Negative
reverbereis	Negative
reafirmado	None
segui	Positive
papariques	Negative
supliqueis	Negative
chia	Positive
apossa	Positive
concordáreis	None
demarcava	None
calafetamos	None
preferia	None
abuses	Negative
obtempera	Positive
electrocutará	None
irriteis	Negative
beijou	None
monta	Positive
amedorentai	Positive
resseca	Positive
compartilhes	Negative
dirige	Positive
embaraçado	None
rebrilha	Positive
ablaqueado	None
engoli	Positive
delongueis	Negative
ramifiques	Negative
desprende	Positive
atravancaste	None
confies	Negative
aureola	Positive
desmontadas	None
defenderiam	None
aparatar	None
barras	Negative
vindimeis	Negative
internacionaliza	Positive
vetando	None
fatura	Positive
desenterra	Positive
redireciona	Positive
deve	Positive
constatariam	None
tremules	Negative
sublimes	Negative
desinfetáramos	None
sofri	None
modula	Positive
convenhais	Negative
prova	Positive
progredirem	None
representaram	None
sujai	Positive
fendais	Negative
conservarão	None
demoravam	None
distanciam	None
esvoaça	Positive
inicieis	Negative
compactados	None
selecta	Positive
baldeai	Positive
loca	Positive
distancia	Positive
coubemos	None
perfuma	Positive
tentando	None
enfeitiça	Positive
explana	Positive
desaloja	Positive
mudes	Negative
envernizeis	Negative
confia	Positive
dá	Positive
expulsaram	None
zomba	Positive
mostrarei	None
intromete	Positive
serpenteia	Positive
pensai	Positive
azulou	None
julgo	None
aventura	Positive
livro	None
coles	Negative
renuncies	Negative
engessai	Positive
liquideis	Negative
forjes	Negative
inflama	Positive
choques	Negative
vadia	Positive
substancia	Positive
propões	None
canto	None
acalma	Positive
floresce	Positive
tumultua	Positive
referenciar	None
requisiteis	Negative
agrava	Positive
emparelha	Positive
promulgados	None
desligues	Negative
avançarem	None
pelai	Positive
assenhoreai	Positive
ruma	Positive
adoece	Positive
desnudo	None
reportes	Negative
assestai	Positive
albergar	None
refere	Positive
evacua	Positive
gestualiza	Positive
condenes	Negative
educava	None
acovardou	None
turbai	Positive
cosas	Negative
mamam	None
finca	Positive
polida	None
repensarmos	None
orbiteis	Negative
amorena	Positive
batuques	Negative
enganaste	None
recomenda	Positive
fizerdes	None
vacinai	Positive
diminui	Positive
antipatiza	Positive
areia	Positive
colmai	Positive
credita	Positive
peleai	Positive
sulca	Positive
atacasse	None
unissem	None
dissuadas	Negative
mexericáveis	None
remediar	None
argumentarem	None
abacharelas	None
negados	None
sortearam	None
correspondidas	None
potencializa	Positive
derribes	Negative
lava	Positive
injustices	Negative
intoxicáramos	None
entra	Positive
lavra	Positive
assola	Positive
afugentados	None
convenciones	Negative
traves	Negative
arrumei	None
derretei	Positive
liderai	Positive
demandes	Negative
escolhei	Positive
foca	Positive
partira	None
comparece	Positive
afluas	Negative
objetes	Negative
pronunciamos	None
sussurres	Negative
numera	Positive
redige	Positive
dupliqueis	Negative
redobra	Positive
vacileis	Negative
quebrada	None
trança	Positive
dissolve	Positive
prejudiques	Negative
nivela	Positive
dadiva	Positive
enferruja	Positive
nocauteado	None
concatenados	None
latines	Negative
naufragueis	Negative
beira	Positive
resistissem	None
ajoelha	Positive
exibireis	None
compulses	Negative
bombes	Negative
vacilou	None
edites	Negative
soterrai	Positive
cursa	Positive
encharca	Positive
convalesçais	Negative
boceja	Positive
desorganizes	Negative
afoga	Positive
recicla	Positive
mimes	Negative
permite	Positive
requere	Positive
evaporar	None
dourai	Positive
intensificarias	None
prosperam	None
colabores	Negative
erodais	Negative
conserva	Positive
ganas	Negative
arrotastes	None
educaram	None
pulveriza	Positive
atropelariam	None
aligeiravas	None
ventileis	Negative
agüenteis	Negative
mune	Positive
negocies	Negative
quitaria	None
aira	Positive
decapitai	Positive
acrescenta	Positive
orbitaria	None
creditando	None
ranqueia	Positive
pavoneies	Negative
lustra	Positive
murcha	Positive
polimeriza	Positive
ajeiteis	Negative
comei	Positive
deiteis	Negative
retornavam	None
automatizara	None
lamenteis	Negative
assenhoreou	None
fosforileis	Negative
alocai	Positive
corroas	Negative
resultara	None
socorrais	Negative
murmura	Positive
sinaliza	Positive
rateeis	Negative
curveteia	Positive
lesma	Positive
comenta	Positive
dadivai	Positive
assedia	Positive
viceja	Positive
retende	Positive
apimenteis	Negative
finalizará	None
funcioneis	Negative
perderia	None
bruxuleies	Negative
acrescentariam	None
lamuria	Positive
asfixia	Positive
extraída	None
reines	Negative
desistas	Negative
calcificarmos	None
insinua	Positive
cochicheis	Negative
carece	Positive
parasites	Negative
seleciona	Positive
inscritas	None
coadjuveis	Negative
discuti	Positive
imprecarei	None
esmalta	Positive
taxies	Negative
aduz	Positive
encurta	Positive
mexas	Negative
economizavam	None
adquiri	Positive
superavam	None
suicida	Positive
caiada	None
cativas	None
registara	None
encaroçai	Positive
subtrai	Positive
falheis	Negative
pôr	None
desvendando	None
encerra	Positive
bajulai	Positive
assisti	Positive
aplicai	Positive
adjetiva	Positive
admirei	None
matricula	Positive
venera	Positive
procurava	None
suportes	Negative
approvai	Positive
voltai	Positive
demarca	Positive
rabisqueis	Negative
afligi	Positive
abastarda	Positive
expiravam	None
enxertai	Positive
sonambula	Positive
enlatados	None
emprehendei	Positive
escama	Positive
engabelai	Positive
respeitai	Positive
madura	Positive
veste	Positive
detonai	Positive
enchei	Positive
injungirmos	None
tardados	None
agoirentai	Positive
constateis	Negative
revê	Positive
suspira	Positive
simbolizaria	None
apensa	Positive
espreiteis	Negative
acupunturai	Positive
broches	Negative
gostaram	None
abiqueis	Negative
amordaceis	Negative
enterra	Positive
rivalizando	None
compenetres	Negative
menciona	Positive
induzi	Positive
anualizeis	Negative
coíbi	Positive
capturassem	None
amanha	Positive
fecha	Positive
engessa	Positive
maneja	Positive
aproxima	Positive
sitia	Positive
firas	Negative
questionávamos	None
escancarai	Positive
cozer	None
expulsasse	None
eduqueis	Negative
peleeis	Negative
fracassa	Positive
dissintas	Negative
envenenada	None
precede	Positive
queimes	Negative
corrobora	Positive
refaze	Positive
sobrepõe	Positive
estimula	Positive
concentrai	Positive
ofendendo	None
troámos	None
indultando	None
reavivasse	None
elabores	Negative
noticia	Positive
embosques	Negative
dilatou	None
piai	Positive
vazes	Negative
poupamos	None
apalpeis	Negative
descambes	Negative
pindureis	Negative
refinava	None
formigais	None
festejai	Positive
sintonizado	None
sentidas	None
imantes	Negative
balanceies	Negative
cabeceou	None
erravam	None
goteja	Positive
dureis	Negative
pronunciadas	None
bocejes	Negative
perde	Positive
adulai	Positive
castres	Negative
envelhecei	Positive
intrigai	Positive
adornai	Positive
replica	Positive
confere	Positive
penteado	None
esclareças	Negative
recolocarão	None
subordinou	None
duvides	Negative
dividas	Negative
depreciai	Positive
teme	Positive
gabai	Positive
incumbindo	None
serpenteies	Negative
consultassem	None
cronometrava	None
isolar	None
desisti	Positive
sobrestimes	Negative
quica	Positive
labutes	Negative
capacitando	None
enrola	Positive
aborrecei	Positive
inspira	Positive
vivenciava	None
palpa	Positive
espuma	Positive
lembrara	None
cabeceia	Positive
sonda	Positive
regatai	Positive
amassai	Positive
ferra	Positive
sagram	None
atuai	Positive
lisonjeis	Negative
agoura	Positive
desertáramos	None
demores	Negative
lede	Positive
camufladas	None
devolvais	Negative
marcarão	None
apunhala	Positive
franjai	Positive
imputou	None
visa	Positive
discrimina	Positive
papeis	Negative
descamarias	None
acordai	Positive
favoreçais	Negative
açucares	Negative
lubrificassem	None
sorteio	None
discutida	None
contata	Positive
valei	Positive
manobra	Positive
aquece	Positive
abrisse	None
aviseis	Negative
imiscuí	Positive
baixo	None
branqueia	Positive
reputássemos	None
digitava	None
ruge	Positive
ocasiones	Negative
aluminizes	Negative
escoeis	Negative
amputa	Positive
pensássemos	None
ordenaram	None
reescreve	Positive
impelindo	None
acresce	Positive
medi	Positive
modernizasse	None
devora	Positive
fumega	Positive
suai	Positive
rabisca	Positive
patineis	Negative
agradeças	Negative
escarra	Positive
tenderem	None
rebobines	Negative
inverneis	Negative
chanfradas	None
amplia	Positive
rearranjeis	Negative
temperes	Negative
inunda	Positive
derroca	Positive
apartes	Negative
acede	Positive
percebas	Negative
banha	Positive
acinzentai	Positive
aguça	Positive
ide	Positive
extingue	Positive
acariciados	None
reproduzido	None
alvorecendo	None
madrugues	Negative
joga	Positive
contesta	Positive
lambuza	Positive
coligi	Positive
plasma	Positive
cobres	Negative
disperses	Negative
admoesteis	Negative
cheirou	None
avenhas	Negative
badalados	None
vara	Positive
votarias	None
credencia	Positive
orces	Negative
embromeis	Negative
parasita	Positive
forrados	None
escreveste	None
transportei	None
desce	Positive
partilham	None
deli	Positive
esboçada	None
namorarem	None
consulta	Positive
entristecer	None
ordenheis	Negative
tripudiar	None
consumai	Positive
britadas	None
congelada	None
convida	Positive
contrabalanceai	Positive
pisardes	None
coaxeis	Negative
mostrai	Positive
ateará	None
amiga	Positive
reconstruídas	None
sangra	Positive
sopra	Positive
entrevistou	None
firmes	Negative
assumiriam	None
soluça	Positive
caberdes	None
alquiles	Negative
cotoveles	Negative
segrega	Positive
escorras	Negative
remetei	Positive
implora	Positive
graduados	None
moderai	Positive
topai	Positive
salpica	Positive
plantes	Negative
contactassem	None
resenha	Positive
tumultuado	None
extraiais	Negative
indica	Positive
banca	Positive
torra	Positive
dissipa	Positive
enfeeis	Negative
japoniza	Positive
refratai	Positive
encobre	Positive
guinda	Positive
ajustes	Negative
calques	Negative
duches	Negative
agrafa	Positive
difundais	Negative
pies	Negative
aligeireis	Negative
proibira	None
concede	Positive
marcha	Positive
patrocines	Negative
veto	None
sobeja	Positive
festeja	Positive
cõfesseis	Negative
comprara	None
evoluírem	None
retocai	Positive
desmama	Positive
enfraqueças	Negative
capines	Negative
encarregava	None
proselitizeis	Negative
rebolar	None
antagoniza	Positive
unas	Negative
photographa	Positive
expulsados	None
escalonarei	None
comparam	None
vigores	Negative
atrapalha	Positive
transmite	Positive
latas	Negative
cuidarei	None
cedei	Positive
pasmo	None
rodeadas	None
amonta	Positive
entrincheires	Negative
apunhalai	Positive
lobrigai	Positive
suportai	Positive
apenseis	Negative
evitai	Positive
superado	None
intrinqueis	Negative
iludi	Positive
exige	Positive
registra	Positive
exploreis	Negative
financia	Positive
contaram	None
especulardes	None
argumentáveis	None
recalcules	Negative
decepcionai	Positive
ordena	Positive
colecionai	Positive
catalogai	Positive
espirrai	Positive
está	Positive
datai	Positive
dissolverem	None
rectifiqueis	Negative
conta	Positive
pronuncia	Positive
vaziáreis	None
associa	Positive
trocam	None
aliviando	None
trunca	Positive
aplaques	Negative
peças	Negative
tiraria	None
cinge	Positive
aquiescer	None
balda	Positive
promete	Positive
aquecidas	None
destranques	Negative
demolindo	None
monopolizada	None
mexe	Positive
sanciones	Negative
discute	Positive
disponibilizarem	None
suplanta	Positive
frisa	Positive
derreter	None
gruda	Positive
paralizai	Positive
liquida	Positive
imitava	None
cessa	Positive
percebeis	None
desactiva	Positive
reivindica	Positive
trisca	Positive
culpes	Negative
supprimas	Negative
lida	Positive
abole	Positive
limitar	None
mura	Positive
acedais	Negative
subordinai	Positive
caça	Positive
macaqueará	None
prenseis	Negative
abortou	None
podereis	None
poupas	None
repensa	Positive
chovendo	None
sagrai	Positive
estreiaram	None
destilleis	Negative
cantarolaram	None
sorteia	Positive
permanecerem	None
aterrorizadas	None
esculacha	Positive
endireitai	Positive
lembras	None
portes	Negative
espionado	None
resultava	None
gorjeai	Positive
forres	Negative
dubles	Negative
passeia	Positive
disciplina	Positive
cambia	Positive
accordai	Positive
arquivaram	None
santificai	Positive
acidifica	Positive
procuramos	None
alaga	Positive
origina	Positive
fissionará	None
atenua	Positive
proibimos	None
academizai	Positive
ostenta	Positive
estanca	Positive
ensineis	Negative
consideráveis	None
cauterizeis	Negative
parcela	Positive
loga	Positive
fazei	Positive
objeta	Positive
consubstancia	Positive
balanceasses	None
rumou	None
estoures	Negative
concedida	None
epitomizai	Positive
minucia	Positive
sustém	Positive
perdoai	Positive
instituída	None
encaminha	Positive
confessa	Positive
surrupia	Positive
enlata	Positive
contra-ataqueis	Negative
anotado	None
invalidadas	None
aureoles	Negative
usaste	None
congela	Positive
coloria	None
saliva	Positive
calafeta	Positive
zonais	None
atola	Positive
impregnai	Positive
descortina	Positive
reclamarem	None
ventila	Positive
contribuas	Negative
proselita	Positive
fedei	Positive
salgues	Negative
disputes	Negative
regeneres	Negative
fragmentar	None
gargarejes	Negative
publicamos	None
deglutirias	None
tocasse	None
alai	Positive
reveleis	Negative
retornarei	None
aflijais	Negative
avassala	Positive
estimularam	None
qualifico	None
beneficia	Positive
manes	Negative
desencantado	None
flagelares	None
iguala	Positive
falhará	None
esterres	Negative
espancarem	None
pinai	Positive
ultima	Positive
roteeis	Negative
fracionada	None
berra	Positive
acabrunhes	Negative
tenta	Positive
remeis	Negative
vaiarmos	None
prepara	Positive
miscra	Positive
adivinha	Positive
assustes	Negative
pulverizes	Negative
louva	Positive
nocauteeis	Negative
tuteai	Positive
concedei	Positive
meles	Negative
pindura	Positive
escancareis	Negative
gerar	None
mira	Positive
privilegiaram	None
numeriza	Positive
alardeies	Negative
requeridos	None
ejaculeis	Negative
assalaria	Positive
assusta	Positive
esgueires	Negative
inundai	Positive
sobrestimásseis	None
borda	Positive
danço	None
aspireis	Negative
dialogou	None
lidarem	None
permitiria	None
wikifica	Positive
cultivo	None
otimizariam	None
esbulheis	Negative
subestimai	Positive
vaiar	None
derrotasse	None
plagia	Positive
mimi	Positive
grafitarás	None
arruinou	None
regenerarem	None
desativeis	Negative
afronteis	Negative
detecteis	Negative
encapai	Positive
negativeis	Negative
tingidas	None
antolhes	Negative
afastes	Negative
fratura	Positive
judia	Positive
engrena	Positive
quita	Positive
lampejeis	Negative
purga	Positive
findado	None
contrabalança	Positive
dividiriam	None
atravessai	Positive
derrotadas	None
dosa	Positive
solapai	Positive
influi	Positive
modela	Positive
resgata	Positive
temeram	None
restitui	Positive
multes	Negative
localizeis	Negative
lavrados	None
intrigueis	Negative
apurada	None
escancaradas	None
escondera	None
debruçai	Positive
picar	None
serres	Negative
desorganizasse	None
dedica	Positive
defraudai	Positive
engomes	Negative
cesses	Negative
inventa	Positive
fabrica	Positive
petrificados	None
bendizei	Positive
decendais	Negative
apaziguai	Positive
ressaltai	Positive
dizerem	None
fervo	None
teletransporta	Positive
persegue	Positive
bate	Positive
interpeles	Negative
horta	Positive
baseia	Positive
coze	Positive
dormitei	None
educa	Positive
impetra	Positive
assemelheis	Negative
silva	Positive
brune	Positive
fruais	Negative
cristalizarei	None
escande	Positive
danes	Negative
acosta	Positive
encenando	None
cursadas	None
tomai	Positive
reenchas	Negative
aposento	None
enamora	Positive
emitiria	None
devotavam	None
pilha	Positive
descascares	None
retirarão	None
referimos	None
cose	Positive
deformou	None
compreendemos	None
fragmentadas	None
sugou	None
uiva	Positive
intercalavam	None
fodas	Negative
derrubes	Negative
afundais	Negative
estarreças	Negative
falirão	None
frisai	Positive
examines	Negative
encetadas	None
ornes	Negative
flutuai	Positive
substantiva	Positive
azeda	Positive
vislumbrados	None
tosei	None
estica	Positive
metilado	None
encarnai	Positive
poli	Positive
protege	Positive
orai	Positive
assimila	Positive
borbulha	Positive
pensarão	None
reinstales	Negative
refletir	None
encarece	Positive
foge	Positive
abastece	Positive
acampeis	Negative
esvazia	Positive
deflores	Negative
implantavam	None
tormentes	Negative
recebido	None
submete	Positive
aplicassem	None
aterrisses	Negative
telecomandados	None
quedar	None
desativarem	None
sacrificados	None
coibir	None
gerando	None
connecta	Positive
igualares	None
xingues	Negative
raptasse	None
aventes	Negative
insere	Positive
formuleis	Negative
empateis	Negative
codificadas	None
mumifiqueis	Negative
descarregando	None
invejai	Positive
doas	Negative
enguiça	Positive
janeleis	Negative
lima	Positive
exacerba	Positive
aliaram	None
tornei	None
resplendece	Positive
arrasaram	None
renderiza	Positive
orla	Positive
acata	Positive
rejuvenescei	Positive
provisiones	Negative
repreende	Positive
desencaminhes	Negative
arroga	Positive
desativo	None
boie	None
saciai	Positive
recrutada	None
apertes	Negative
retoqueis	Negative
acotoveles	Negative
ficai	Positive
falseia	Positive
enfardelarias	None
intitularem	None
paparicai	Positive
coexistiremos	None
espeçais	Negative
agia	None
gazeteavas	None
remata	Positive
soles	Negative
possibilitará	None
cabidos	None
apostemei	None
desarranjo	None
zipado	None
apoieis	Negative
urinar	None
harmoniza	Positive
algoritmizes	Negative
concretai	Positive
erode	Positive
surta	Positive
querelai	Positive
fixa	Positive
pedalada	None
aperceberem	None
trocariam	None
veta	Positive
olhes	Negative
cometeram	None
afrontes	Negative
mutila	Positive
perpetráveis	None
mói	Positive
contratará	None
lixa	Positive
boicota	Positive
apupeis	Negative
inocentei	None
suplementa	Positive
amanheceu	None
sondada	None
hospitalizes	Negative
mete	Positive
tosta	Positive
eleva	Positive
invade	Positive
vinca	Positive
lacreis	Negative
irmos	None
quantifica	Positive
capitaliza	Positive
funcionarem	None
ardendo	None
abri	Positive
emanada	None
realojes	Negative
dói	Positive
culmina	Positive
critica	Positive
causarão	None
pegueis	Negative
pacta	Positive
subscreve	Positive
borrifa	Positive
atira	Positive
sentencia	Positive
vasteis	Negative
brita	Positive
instituas	Negative
urtigai	Positive
dessaliniza	Positive
transporta	Positive
aportando	None
derramas	None
cometido	None
populariza	Positive
refoga	Positive
mirra	Positive
inicia	Positive
approves	Negative
obliterai	Positive
differis	None
risques	Negative
montava	None
reservadas	None
empenhadas	None
descanseis	Negative
compila	Positive
seda	Positive
adianta	Positive
ferve	Positive
simules	Negative
liquidara	None
ceva	Positive
preparo	None
adias	None
espalha	Positive
conspurca	Positive
degenera	Positive
salpicada	None
cegueis	Negative
embirra	Positive
replicando	None
morando	None
escritura	Positive
retouces	Negative
escaramuça	Positive
configuradas	None
retifiqueis	Negative
analises	Negative
substantiveis	Negative
observaremos	None
cubras	Negative
predicados	None
salpicarão	None
vi	None
buzináveis	None
delineando	None
anguladas	None
aumentes	Negative
atentes	Negative
abduz	Positive
fales	Negative
reportarem	None
situa	Positive
disfarceis	Negative
contrabandeai	Positive
pechincha	Positive
arranques	Negative
arreceia	Positive
menospreza	Positive
capina	Positive
aparata	Positive
quicai	Positive
distinguiu	None
chora	Positive
zipeis	Negative
festai	Positive
transitado	None
atém	Positive
adormeças	Negative
ressalvar	None
engasgava	None
tinta	Positive
pechinches	Negative
inactiva	Positive
edifica	Positive
aborda	Positive
avives	Negative
inalada	None
extinguida	None
atavieis	Negative
notadas	None
poda	Positive
restituí	Positive
controla	Positive
arrenda	Positive
omitirem	None
deslastreis	Negative
amedrontes	Negative
empresteis	Negative
recuperado	None
custeia	Positive
loteia	Positive
diplomando	None
canonizeis	Negative
lixivia	Positive
nhanha	Positive
expande	Positive
lanchar	None
escaloneis	Negative
mijeis	Negative
entreolhai	Positive
volve	Positive
debicai	Positive
laváveis	None
interesses	Negative
encomendásseis	None
respondiam	None
anonimizeis	Negative
pinou	None
divorcia	Positive
personalizes	Negative
alvejai	Positive
comercializaram	None
curai	Positive
choca	Positive
nomearemos	None
estabilizassem	None
empalideçais	Negative
datada	None
emprego	None
mores	Negative
velleja	Positive
fisgueis	Negative
expedir	None
diferido	None
encantai	Positive
exprimi	Positive
criticamos	None
deslogado	None
destratai	Positive
aclama	Positive
comprimidos	None
ousa	Positive
realces	Negative
alardeia	Positive
forja	Positive
apassamana	Positive
agourarei	None
reconciliassem	None
come	Positive
abrasileires	Negative
dele	Positive
potencializes	Negative
apodera	Positive
estejas	Negative
limitada	None
folga	Positive
rumeis	Negative
engaiolado	None
dominava	None
numerizeis	Negative
descarregada	None
homologueis	Negative
folgues	Negative
correi	Positive
teclarão	None
publicitarias	None
agarra	Positive
questiones	Negative
estupefiqueis	Negative
apagueis	Negative
maquia	Positive
empreitámos	None
bota	Positive
ranga	Positive
acclares	Negative
deprimidos	None
associaram	None
apateta	Positive
demole	Positive
prejudica	Positive
soterra	Positive
ireis	Negative
interpreta	Positive
pegada	None
agarrai	Positive
critiques	Negative
balai	Positive
concretes	Negative
resumi	Positive
escurecêssemos	None
cliques	Negative
efetua	Positive
peleia	Positive
endfadai	Positive
amnistia	Positive
despedaça	Positive
combinai	Positive
centres	Negative
branqueiam	None
bafejai	Positive
bateu	None
aleijou	None
resolverem	None
decantadas	None
comines	Negative
dominada	None
alia	Positive
equipadas	None
abandeira	Positive
antecipa	Positive
amolada	None
renovarem	None
conjecturai	Positive
aponta	Positive
cantarola	Positive
abotoes	Negative
candidates	Negative
proferi	Positive
desmarca	Positive
estressa	Positive
contendais	Negative
devoraram	None
mateia	Positive
alarga	Positive
escora	Positive
cismes	Negative
regulariza	Positive
decresce	Positive
reinstala	Positive
partilhavam	None
filma	Positive
alterna	Positive
triunfes	Negative
expurgueis	Negative
alastra	Positive
ladrilha	Positive
muni	Positive
elimina	Positive
verbalizar	None
satura	Positive
desaseis	Negative
quitará	None
verga	Positive
furta	Positive
enriquece	Positive
removem	None
estreava	None
declameis	Negative
grassiteis	Negative
esbofetees	Negative
sintonizeis	Negative
transcreve	Positive
desativar	None
botavam	None
usufrui	Positive
toco	None
anonimizai	Positive
entristece	Positive
perfilhes	Negative
rejeitavam	None
fragmenta	Positive
embandeireis	Negative
comecei	None
ondules	Negative
subsistem	None
desova	Positive
mancham	None
respira	Positive
acclara	Positive
vê	Positive
dinamiza	Positive
arrecadou	None
legues	Negative
torres	Negative
piadas	None
pisa	Positive
aguentam	None
alimenteis	Negative
rodeia	Positive
arrazoados	None
brandais	Negative
segredes	Negative
chocalhes	Negative
gracejes	Negative
embriagues	Negative
sobrecarrega	Positive
transes	Negative
recomendava	None
abismes	Negative
perfilai	Positive
sabotaram	None
arranqueis	Negative
divulga	Positive
bombardeeis	Negative
franze	Positive
encaixado	None
integro	None
assoma	Positive
petrifica	Positive
atordoa	Positive
auferirão	None
requintes	Negative
precisa	Positive
repetissem	None
escasseia	Positive
surgirá	None
laçou	None
colma	Positive
conduzir	None
vulneres	Negative
atesta	Positive
zero	None
erres	Negative
taxes	Negative
funciones	Negative
comiches	Negative
emprega	Positive
justifica	Positive
evidenciaria	None
sincopados	None
atacai	Positive
giras	Negative
continues	Negative
tutora	Positive
atina	Positive
classificai	Positive
finado	None
assume	Positive
croma	Positive
acostumarei	None
estudado	None
desacreditaram	None
intrigassem	None
regata	Positive
conduzi	Positive
bastei	None
despediu	None
arrebata	Positive
apelidaram	None
livra	Positive
rales	Negative
apenses	Negative
patrocinam	None
escoa	Positive
espera	Positive
reorganiza	Positive
treinando	None
variariam	None
humilha	Positive
hospedes	Negative
largavam	None
privilegio	None
entusiasmeis	Negative
concordara	None
envelhecendo	None
cometais	Negative
chapaste	None
apressa	Positive
sedes	Negative
desconhece	Positive
pauta	Positive
alicerceis	Negative
arrebentai	Positive
desabafa	Positive
ascenderia	None
falsifica	Positive
forjeis	Negative
reincidas	Negative
enfileires	Negative
excelei	Positive
enlaceis	Negative
introduzi	Positive
roteadas	None
cureis	Negative
envelheças	Negative
traslada	Positive
sanciona	Positive
interferiram	None
arquiteteis	Negative
considereis	Negative
assassina	Positive
britai	Positive
lê	Positive
pulavam	None
perece	Positive
mettais	Negative
estipula	Positive
manifesta	Positive
acedidos	None
atazaneis	Negative
evidenciadas	None
tecla	Positive
fizéssemos	None
desregules	Negative
vulgarizou	None
amplifiqueis	Negative
cremasse	None
reformuleis	Negative
dispara	Positive
reinada	None
cogita	Positive
reconfirmando	None
transai	Positive
ducha	Positive
aloca	Positive
hesita	Positive
parodiavam	None
interdita	Positive
saques	Negative
pula	Positive
barro	None
empapelarem	None
degluti	Positive
quintuplica	Positive
genotipai	Positive
tornando	None
reclamou	None
redireciono	None
endossa	Positive
alunas	None
balances	Negative
engambeleis	Negative
vigia	Positive
atinha	None
significai	Positive
recuava	None
transferi	Positive
pincela	Positive
brinques	Negative
estenographeis	Negative
dificulta	Positive
recordai	Positive
taques	Negative
almeja	Positive
trabalhou	None
titiles	Negative
moas	Negative
anistia	Positive
pintes	Negative
promove	Positive
focalizou	None
empolga	Positive
empatamos	None
requentes	Negative
saúda	Positive
domai	Positive
visualizáreis	None
amigásseis	None
discorre	Positive
transa	Positive
tomba	Positive
sueis	Negative
papeies	Negative
obra	Positive
desimpeças	Negative
optimizeis	Negative
tormenta	Positive
amoreneis	Negative
rastela	Positive
penteia	Positive
figurada	None
subjuga	Positive
franqueados	None
equipado	None
bisai	Positive
retocados	None
alfabetizeis	Negative
arruma	Positive
arribes	Negative
custaram	None
perpetreis	Negative
adoteis	Negative
tossi	Positive
esterilizado	None
antolheis	Negative
limpa	Positive
estranhamos	None
floriras	None
contagiava	None
recompensa	Positive
salienta	Positive
constavam	None
attureis	Negative
frequenta	Positive
vale	Positive
mantemos	None
evolve	Positive
descobre	Positive
zarpando	None
abusados	None
embasa	Positive
desembrulhavam	None
cantaroles	Negative
faxina	Positive
fuma	Positive
endfada	Positive
caçoes	Negative
madurai	Positive
eliminadas	None
pernoita	Positive
colai	Positive
chimarreeis	Negative
afilias	None
comanda	Positive
aperreai	Positive
revogues	Negative
diviniza	Positive
comprende	Positive
atrofiados	None
apliqueis	Negative
aloura	Positive
comprehendais	Negative
descama	Positive
ceara	None
abduzas	Negative
entregues	Negative
cicatrizado	None
funcciones	Negative
fornecerem	None
costura	Positive
combali	Positive
tolera	Positive
triturai	Positive
implores	Negative
entelhes	Negative
manejam	None
fatiga	Positive
rematados	None
soletrai	Positive
desmenti	Positive
estigmatiza	Positive
chamar	None
deprecia	Positive
falseies	Negative
condiciones	Negative
compares	Negative
magnetizeis	Negative
suando	None
apeteças	Negative
ementes	Negative
pressagiava	None
uni	Positive
realojeis	Negative
isola	Positive
delimitava	None
arreganhai	Positive
sintonizes	Negative
verifiqueis	Negative
contém	Positive
aventureis	Negative
solapes	Negative
pastores	Negative
serve	Positive
socede	Positive
desenterreis	Negative
nadar	None
loteai	Positive
hipnotiza	Positive
preside	Positive
excluí	Positive
estiveis	Negative
orça	Positive
defumo	None
precipita	Positive
tingi	Positive
tardes	Negative
arredeis	Negative
retenhais	Negative
embeleza	Positive
enfronhes	Negative
decretai	Positive
reconheceu	None
rabiscai	Positive
delateis	Negative
obtemperes	Negative
estranho	None
disponhais	Negative
realizar	None
lisonjeeis	Negative
acobertai	Positive
desembala	Positive
despedaçai	Positive
presencia	Positive
perguntai	Positive
flabeles	Negative
canalizando	None
inquietaram	None
zombeis	Negative
termines	Negative
iscai	Positive
verses	Negative
abençoai	Positive
cancelo	None
processado	None
grasneis	Negative
fricciones	Negative
acampa	Positive
mãdai	Positive
arrancarem	None
ilustrada	None
secados	None
chicanes	Negative
rotear	None
enfurecerias	None
emigres	Negative
posiciona	Positive
escaldeis	Negative
interpretai	Positive
anuais	Negative
ulula	Positive
espouques	Negative
corrompem	None
aumenta	Positive
aventa	Positive
descola	Positive
entedia	Positive
cativou	None
usado	None
conflitai	Positive
vaga	Positive
graduar	None
emancipa	Positive
faceta	Positive
sobretaxava	None
figura	Positive
rotulou	None
apalpai	Positive
monitora	Positive
define	Positive
ruais	Negative
preferi	Positive
perambula	Positive
preferidas	None
duplicar	None
descalça	Positive
acesses	Negative
mendiguei	None
reiteres	Negative
agrupado	None
alambiques	Negative
lasca	Positive
incorre	Positive
esmagai	Positive
seca	Positive
azareis	Negative
submetidas	None
cresta	Positive
desposes	Negative
honra	Positive
soterres	Negative
extirpai	Positive
rastrearam	None
desreguleis	Negative
desalentasse	None
implementai	Positive
bombou	None
intimidar	None
escavai	Positive
arrefeceram	None
dissimula	Positive
engaja	Positive
conhece	Positive
experimentariam	None
empataram	None
encobrir	None
passes	Negative
padronizáramos	None
indages	Negative
escales	Negative
secundaste	None
avista	Positive
marca	Positive
isca	Positive
entorpece	Positive
conquista	Positive
reduzira	None
comportai	Positive
cegues	Negative
excellais	Negative
cata	Positive
silves	Negative
darei	None
patrocinadas	None
macera	Positive
internacionalizaram	None
descartadas	None
capacita	Positive
entusiasma	Positive
termina	Positive
vazar	None
sequestres	Negative
gosta	Positive
reordena	Positive
terminando	None
acinzentado	None
imobiliza	Positive
desnudai	Positive
enfatizeis	Negative
embeiceis	Negative
estupra	Positive
espoqueis	Negative
barganhes	Negative
calcifica	Positive
aliena	Positive
sugeri	Positive
alentes	Negative
grampear	None
sulcada	None
complementassem	None
clareados	None
latir	None
refreai	Positive
orneis	Negative
remediado	None
manuseeis	Negative
contraditos	None
padroniza	Positive
confirmarão	None
acelera	Positive
arfa	Positive
colidiram	None
representáveis	None
recruta	Positive
festejadas	None
confundas	Negative
restringe	Positive
descaroces	Negative
mexais	Negative
esquivai	Positive
apelidai	Positive
pronunciarei	None
milhes	Negative
comandeis	Negative
taixavam	None
arqueia	Positive
apregoa	Positive
escaneeis	Negative
cometidos	None
faleceu	None
aniversaria	Positive
projeta	Positive
resteis	Negative
barri	Positive
desencadeai	Positive
singrou	None
indaga	Positive
custa	Positive
coíbe	Positive
amimes	Negative
revelaram	None
sensualiza	Positive
estudadas	None
rapes	Negative
estivai	Positive
subjugará	None
detém	Positive
movimentasse	None
perguntarmos	None
enforma	Positive
apontes	Negative
brilhando	None
chapai	Positive
acidulai	Positive
abjures	Negative
proferira	None
adita	Positive
brindai	Positive
flertai	Positive
floodeis	Negative
mascara	Positive
deportes	Negative
desacredita	Positive
complica	Positive
gozar	None
cunha	Positive
perfilha	Positive
reestrutura	Positive
mistifiqueis	Negative
desaprova	Positive
roçai	Positive
afeiçoa	Positive
entorta	Positive
experiencia	Positive
suicideis	Negative
guardarem	None
reduz	Positive
forneceria	None
aprisionava	None
declararia	None
competi	Positive
refresca	Positive
empesteia	Positive
creio	None
inundavas	None
encorras	Negative
alternaram	None
hidrates	Negative
graves	Negative
estiva	Positive
roubarem	None
cumpri	Positive
arrisca	Positive
ajoelhadas	None
candidatei	None
recita	Positive
cortaria	None
rescindidos	None
ataca	Positive
valhais	Negative
espirra	Positive
dissolveu	None
pares	Negative
embrenhes	Negative
sofressem	None
surtado	None
xingueis	Negative
accuseis	Negative
sejais	Negative
reconstrói	Positive
baldeies	Negative
legar	None
vês	None
macula	Positive
esguicha	Positive
aprofundado	None
afames	Negative
abscedas	Negative
doutrines	Negative
embebe	Positive
cristianizai	Positive
rebolo	None
rotes	Negative
testemunha	Positive
esgota	Positive
briga	Positive
zanzo	None
desviarão	None
comprimais	Negative
desleixada	None
finaliza	Positive
chacina	Positive
especificado	None
priva	Positive
decorras	Negative
chantageia	Positive
tocaiaremos	None
contendas	Negative
protegem	None
ferindo	None
atazana	Positive
reboca	Positive
avaria	Positive
desmatarão	None
recua	Positive
cobri	Positive
liberta	Positive
angustia	Positive
interessai	Positive
atraí	Positive
apedreja	Positive
verbaliza	Positive
safada	None
embasou	None
remedies	Negative
abre	Positive
resolvais	Negative
oxides	Negative
averigua	Positive
tripularás	None
registres	Negative
alicerces	Negative
adumbra	Positive
espanta	Positive
perspetivai	Positive
estipules	Negative
assalarieis	Negative
despeja	Positive
resfriai	Positive
vilifiqueis	Negative
chutar	None
assignalávamos	None
deixaríamos	None
dispersa	Positive
encaroceis	Negative
amostra	Positive
abençoo	None
abrandai	Positive
explodi	Positive
catalizado	None
apelideis	Negative
valorizai	Positive
encaminhada	None
afrouxai	Positive
enfardelai	Positive
panas	None
pasta	Positive
escalda	Positive
levitáveis	None
cadastrado	None
levitado	None
acumuleis	Negative
nada	Positive
domes	Negative
vivenciai	Positive
erreis	Negative
marques	Negative
cogitai	Positive
queimariam	None
enfiaram	None
rosna	Positive
ausentai	Positive
floreada	None
segmentes	Negative
afetai	Positive
esperneia	Positive
comboiai	Positive
discutia	None
entabules	Negative
caçoo	None
compraram	None
gadanha	Positive
proselites	Negative
determinasse	None
constata	Positive
integra	Positive
chiara	None
halogenai	Positive
estivermos	None
arreceeis	Negative
escalonado	None
guerreia	Positive
agachai	Positive
espicha	Positive
danifica	Positive
vaca	Positive
renovar	None
deglaçai	Positive
resolve	Positive
estreita	Positive
ensaques	Negative
cloneis	Negative
fraccioneis	Negative
impactava	None
feridas	None
menstrues	Negative
contribui	Positive
palpita	Positive
duvida	Positive
subestima	Positive
permeies	Negative
arrumeis	Negative
findes	Negative
ripes	Negative
resgatai	Positive
meara	None
relaciones	Negative
solicitado	None
desintegra	Positive
levai	Positive
prorrogai	Positive
acedem	None
inutilizai	Positive
diriam	None
abusa	Positive
guerreeis	Negative
pesares	None
gargarejeis	Negative
desembarca	Positive
apontada	None
retorque	Positive
tirariam	None
recoloques	Negative
extraem	None
registai	Positive
festámos	None
repousassem	None
passa	Positive
papa	Positive
excepcionai	Positive
asa	Positive
desoxigenada	None
pulsai	Positive
hiberneis	Negative
precedas	Negative
traficai	Positive
nubleis	Negative
identificaríeis	None
padronizada	None
entrecortai	Positive
vivencia	Positive
tabulai	Positive
despoja	Positive
quadruplica	Positive
restrinjo	None
urbanizai	Positive
comemores	Negative
esperai	Positive
acena	Positive
recristalizeis	Negative
encolerizeis	Negative
concreta	Positive
meia	Positive
narrando	None
suscitai	Positive
vás	Negative
dispares	Negative
desespereis	Negative
queima	Positive
duela	Positive
mosques	Negative
estoques	Negative
tangei	Positive
distanciávamos	None
vivei	Positive
couberam	None
recobre	Positive
resistas	Negative
rida	None
comprendas	Negative
penhorado	None
desarma	Positive
consta	Positive
listai	Positive
laça	Positive
gatunes	Negative
exteriorizes	Negative
deglaces	Negative
assesta	Positive
prenses	Negative
surreis	Negative
planes	Negative
centraliza	Positive
candidatava	None
devolve	Positive
recai	Positive
intercetai	Positive
desmanchai	Positive
requisita	Positive
veem	None
provado	None
desdemocratizes	Negative
afugenta	Positive
dessem	None
rege	Positive
abaneis	Negative
inclinai	Positive
outorga	Positive
mexerica	Positive
escarafunchai	Positive
vocalizai	Positive
virarem	None
reescrevei	Positive
andes	Negative
ministres	Negative
livrara	None
ilustrarem	None
encostai	Positive
manufaturas	None
desgalhes	Negative
espiritualizai	Positive
mudarão	None
desanimando	None
apresenta	Positive
requintai	Positive
imbui	Positive
perdoa	Positive
ozonizes	Negative
surra	Positive
abscindas	Negative
hidrogenes	Negative
suicidam	None
mergulhava	None
machuca	Positive
detestam	None
comina	Positive
relembraram	None
mistura	Positive
alterqueis	Negative
impera	Positive
desconhecida	None
aconchega	Positive
resigna	Positive
bebemores	Negative
sociabilizai	Positive
desmancha	Positive
ofrece	Positive
leveis	Negative
faties	Negative
desmorona	Positive
recapitula	Positive
discerne	Positive
iniras	Negative
identificáramos	None
laces	Negative
tripudiai	Positive
molhes	Negative
nomeeis	Negative
contraindicai	Positive
repitais	Negative
vocaliza	Positive
expandissem	None
gestai	Positive
conjugais	None
inala	Positive
falecia	None
googles	Negative
evoca	Positive
rugir	None
desculpai	Positive
charqueada	None
deleteis	Negative
avaliaram	None
pules	Negative
entrega	Positive
simula	Positive
fatores	Negative
enfiei	None
espolia	Positive
dobrai	Positive
sobrevive	Positive
defraudes	Negative
qualificaríeis	None
asseguram	None
corrigireis	None
sintas	Negative
consiste	Positive
cassai	Positive
aceitam	None
mixturava	None
ancinhai	Positive
frequentei	None
compadeças	Negative
geada	None
assaltes	Negative
rasteleis	Negative
camufla	Positive
sisa	Positive
chiai	Positive
molheis	Negative
lixiviávamos	None
hospitalizado	None
depõe	Positive
subscreverei	None
paras	Negative
pifeis	Negative
brigasses	None
prostituiriam	None
recrutava	None
acanha	Positive
suscites	Negative
coita	Positive
afina	Positive
pressente	Positive
acirra	Positive
transcendei	Positive
raciocina	Positive
chapa	Positive
açoita	Positive
investe	Positive
escamai	Positive
perpasseis	Negative
reconstituídos	None
obturai	Positive
combatas	Negative
concretizai	Positive
adotara	None
rateadas	None
protagonizes	Negative
retoques	Negative
concorrei	Positive
estagnes	Negative
interceptam	None
gabeis	Negative
crucificaram	None
enfia	Positive
desintoxica	Positive
contraias	Negative
xeroques	Negative
recuperava	None
retraí	Positive
alhear	None
florida	None
mediam	None
ponde	Positive
macadamizes	Negative
acrescentavam	None
acentua	Positive
rangei	Positive
balouceis	Negative
topeis	Negative
focadas	None
aquiesce	Positive
vestiam	None
rompei	Positive
grelheis	Negative
bastece	Positive
multiplicar	None
anuncia	Positive
ultrapassado	None
pacificou	None
sobe	Positive
afiança	Positive
pira	Positive
relaxarias	None
creiais	Negative
amedrontadas	None
oxida	Positive
aglomera	Positive
escapulais	Negative
barateia	Positive
consteis	Negative
problematizávamos	None
bifurcada	None
costurai	Positive
aclimata	Positive
contratara	None
experimenta	Positive
toso	None
acende	Positive
prefacia	Positive
lanceeis	Negative
contestai	Positive
unhado	None
cancela	Positive
pesquisa	Positive
extendas	Negative
retrateis	Negative
batia	None
parafraseies	Negative
meditai	Positive
desfraldadas	None
justificasse	None
baldes	Negative
predominaria	None
abespinhai	Positive
interpela	Positive
desposa	Positive
chupes	Negative
prefiras	Negative
despertai	Positive
distancias	None
eximas	Negative
comemoreis	Negative
excretada	None
anota	Positive
entendas	Negative
bisbilhota	Positive
reconstituirei	None
atrasadas	None
remove	Positive
roas	Negative
estaca	Positive
interrompei	Positive
difundi	Positive
lisonja	Positive
persuadi	Positive
destrinces	Negative
berrai	Positive
sabotai	Positive
enumera	Positive
extasia	Positive
gravitáreis	None
estonteai	Positive
ajunta	Positive
mendiga	Positive
aráveis	None
mentiras	None
restaures	Negative
fluoretados	None
concretizes	Negative
marina	Positive
desatinada	None
pareçais	Negative
frasear	None
proscreve	Positive
furai	Positive
amortecer	None
debiliteis	Negative
comisca	Positive
ofende	Positive
lideres	Negative
factureis	Negative
lisonjeai	Positive
deduzindo	None
fascineis	Negative
telefones	Negative
quedáramos	None
assediando	None
vomiteis	Negative
enxergueis	Negative
limpada	None
arremedo	None
reestrutureis	Negative
destila	Positive
entituleis	Negative
desvalorizeis	Negative
dividirmos	None
injustiçado	None
conecta	Positive
despreza	Positive
assombrai	Positive
delineados	None
penhores	Negative
aportara	None
difrates	Negative
abicai	Positive
relaciona	Positive
reincidiu	None
escachoes	Negative
rebentado	None
olhai	Positive
urtiga	Positive
demandava	None
poluí	Positive
corrompereis	None
partilhou	None
assimilai	Positive
empenhai	Positive
impreques	Negative
pronunciam	None
corta	Positive
decrescei	Positive
aqueças	Negative
delonga	Positive
sustentes	Negative
movido	None
cifrava	None
observa	Positive
pragueja	Positive
detalhes	Negative
erradiqueis	Negative
dessalinizou	None
desencriptardes	None
exorta	Positive
pernoites	Negative
outorgas	None
amola	Positive
vagueia	Positive
detalhei	None
aloja	Positive
goram	None
reformules	Negative
aterra	Positive
aparai	Positive
indicas	None
reprocheis	Negative
interroga	Positive
nacionalizando	None
descarrega	Positive
provados	None
inactivaria	None
privilegia	Positive
anistiai	Positive
descortines	Negative
farta	Positive
excede	Positive
sincoparemos	None
comungueis	Negative
necessita	Positive
plana	Positive
entendidas	None
saí	Positive
computo	None
aventures	Negative
puxa	Positive
atribuiria	None
lucra	Positive
carimbai	Positive
confinada	None
encestar	None
ofegueis	Negative
alcunha	Positive
tentes	Negative
zipes	Negative
limes	Negative
outorgueis	Negative
procures	Negative
reconvocado	None
encapsuleis	Negative
despendais	Negative
abastardes	Negative
contracenes	Negative
encomenda	Positive
clonar	None
aprazei	Positive
reajas	Negative
abstém	Positive
solidificai	Positive
tropeça	Positive
escovar	None
fitou	None
remodela	Positive
amorenai	Positive
cristianizes	Negative
irriga	Positive
moldado	None
amontoeis	Negative
repitas	Negative
aprazais	Negative
escapa	Positive
depende	Positive
mordiscai	Positive
preocupamos	None
desjejuai	Positive
abalroeis	Negative
destrói	Positive
discernido	None
és	None
pores	None
endeusa	Positive
comas	Negative
apaixones	Negative
descanso	None
conjectures	Negative
segurai	Positive
evolui	Positive
azedo	None
recristalizai	Positive
sossegai	Positive
circula	Positive
seriai	Positive
invadi	Positive
interligará	None
premia	Positive
considera	Positive
revoga	Positive
adormecei	Positive
cumprimenteis	Negative
inseri	Positive
mastiga	Positive
pisoteadas	None
salves	Negative
frita	Positive
esperneies	Negative
delicia	Positive
esporais	None
declina	Positive
bordar	None
degrada	Positive
vegetes	Negative
untes	Negative
desencadeia	Positive
esgarçaria	None
secreta	Positive
unifica	Positive
fraudes	Negative
limitarmos	None
decidir	None
ensejai	Positive
nutre	Positive
repasses	Negative
proíbas	Negative
congestiona	Positive
reprimi	Positive
regressarem	None
lambais	Negative
imuniza	Positive
rouba	Positive
assanha	Positive
traja	Positive
pré-comprai	Positive
ama	Positive
ministra	Positive
substituí	Positive
vigorasse	None
esticadas	None
digais	Negative
instalamos	None
dependessem	None
turbo	None
distorce	Positive
escraviza	Positive
sumi	Positive
rebocando	None
assai	Positive
oleados	None
trinai	Positive
receitai	Positive
exclama	Positive
influí	Positive
burleis	Negative
pertenças	Negative
conclui	Positive
forjava	None
blasonastes	None
mudares	None
regularia	None
tremeluzais	Negative
explicai	Positive
vibra	Positive
calai	Positive
desconsidereis	Negative
transforma	Positive
caveis	Negative
fazeres	None
chicoteado	None
arreia	Positive
tramando	None
reina	Positive
secretam	None
engolfeis	Negative
percebei	Positive
reserva	Positive
reivindicasse	None
uncta	Positive
ancorados	None
falavam	None
evidencia	Positive
hipertrofia	Positive
compra	Positive
propusera	None
suportada	None
decepcionar	None
enviasse	None
chafurdai	Positive
batuqueis	Negative
namorou	None
resgates	Negative
contorcia	None
inaugura	Positive
alquilai	Positive
ressurjas	Negative
voltees	Negative
aborta	Positive
substitui	Positive
minimizai	Positive
examina	Positive
glosarás	None
incentivar	None
brilha	Positive
atrofia	Positive
fermentada	None
sedimentar	None
rebentes	Negative
fortalece	Positive
urjais	Negative
beijai	Positive
pastora	Positive
incentives	Negative
explorasse	None
apelidadas	None
tardeis	Negative
adicionada	None
vandalizado	None
mencionada	None
alegra	Positive
attentes	Negative
santificada	None
remunera	Positive
desvaloriza	Positive
transplanta	Positive
vidra	Positive
insineis	Negative
apostemeis	Negative
monopoliza	Positive
dramatiza	Positive
escanear	None
manja	Positive
embalando	None
devota	Positive
escorrei	Positive
açoiteis	Negative
cura	Positive
encho	None
concordasse	None
amueis	Negative
beberem	None
calei	None
atrito	None
impõe	Positive
verificados	None
repara	Positive
risca	Positive
provoques	Negative
verte	Positive
implica	Positive
blefes	Negative
desabasse	None
regressa	Positive
cosei	Positive
compenetrai	Positive
indexa	Positive
acerta	Positive
contestou	None
atrases	Negative
surpreender	None
refloresta	Positive
sincroniza	Positive
esqueceras	None
fomenteis	Negative
reveriam	None
embrenhasse	None
baralha	Positive
computa	Positive
jazia	None
despende	Positive
habituadas	None
combatemos	None
gostassem	None
recrutado	None
contracena	Positive
pressionava	None
coça	Positive
volteeis	Negative
exercita	Positive
chegarem	None
reaviva	Positive
conjectura	Positive
distei	None
plaines	Negative
desanima	Positive
consegui	Positive
denotou	None
ver	None
defeca	Positive
paginai	Positive
nota	Positive
instancias	None
posicionaste	None
descarbonizariam	None
facultou	None
legado	None
apanhava	None
finalizou	None
mosca	Positive
reprises	Negative
extingas	Negative
atentai	Positive
berres	Negative
refrear	None
degenerado	None
bajuleis	Negative
desafia	Positive
ressuscita	Positive
envenena	Positive
autorizarmos	None
emana	Positive
perecei	Positive
interfirais	Negative
expressariam	None
sublima	Positive
magnetiza	Positive
anula	Positive
desloques	Negative
encarquilha	Positive
atai	Positive
ronrona	Positive
conduz	Positive
alegres	Negative
buscará	None
fosfates	Negative
ponderasse	None
desativa	Positive
tituleis	Negative
apinhadas	None
lotes	Negative
estrutura	Positive
soprava	None
apresteis	Negative
intrometendo	None
concateneis	Negative
reside	Positive
viviam	None
atendei	Positive
escanceai	Positive
bufes	Negative
aleijeis	Negative
desmontei	None
saída	None
barrando	None
zombes	Negative
ralásseis	None
dites	Negative
pesca	Positive
zanga	Positive
talhareis	None
fermentáreis	None
sova	Positive
desonereis	Negative
proclama	Positive
repassa	Positive
conserteis	Negative
autorizo	None
seleteis	Negative
pensavam	None
desenvolve	Positive
abrevieis	Negative
quebranta	Positive
abaixados	None
prestava	None
usufruí	Positive
offerece	Positive
reconquistados	None
rima	Positive
amedronta	Positive
abatei	Positive
vincules	Negative
copula	Positive
despender	None
restabelece	Positive
atravesses	Negative
desgosta	Positive
presenteai	Positive
denigre	Positive
azules	Negative
volta	Positive
sobressai	Positive
fraseia	Positive
renegaram	None
cuydeis	Negative
goza	Positive
genotipes	Negative
salientes	Negative
aproximeis	Negative
deformeis	Negative
predicai	Positive
baixa	Positive
madruga	Positive
vaticinai	Positive
condiciona	Positive
caucioneis	Negative
financiaria	None
ensaia	Positive
transcende	Positive
procura	Positive
disputada	None
agi	Positive
percas	Negative
colhe	Positive
ajudadas	None
desfalece	Positive
pastorearias	None
orgulhai	Positive
rivalizava	None
procurai	Positive
chanfrai	Positive
incendiados	None
malhas	None
padeçais	Negative
obcecai	Positive
caçai	Positive
acarretou	None
desrespeita	Positive
invertereis	None
cuba	Positive
taixai	Positive
liquefizéreis	None
catai	Positive
concertando	None
orbita	Positive
rodeies	Negative
trincha	Positive
penetra	Positive
denomina	Positive
imiscuas	Negative
temas	Negative
traduz	Positive
pintardes	None
reservarem	None
emigra	Positive
padecei	Positive
solucionando	None
encefalizados	None
evita	Positive
serias	None
expurgavam	None
iluminam	None
mieis	Negative
categorizasse	None
coleciona	Positive
imanai	Positive
recolhas	Negative
resultado	None
contratadas	None
antolhadas	None
abainha	Positive
imputa	Positive
armes	Negative
retirei	None
nasce	Positive
combate	Positive
assumido	None
desembarques	Negative
comunga	Positive
estai	Positive
cates	Negative
gorgolejai	Positive
nadai	Positive
entristecia	None
inscrevais	Negative
brandas	Negative
assumida	None
adotei	None
aborrece	Positive
designavam	None
criminalizando	None
peregrina	Positive
negociai	Positive
desconfia	Positive
cerres	Negative
decidi	Positive
preservarmos	None
enviuves	Negative
recontar	None
limpes	Negative
africanizes	Negative
descende	Positive
apimentando	None
contaminava	None
adultiza	Positive
vulnera	Positive
enviarem	None
entrelaça	Positive
renunciais	None
voa	Positive
sobresai	Positive
tatues	Negative
aplaude	Positive
vinga	Positive
apodrecei	Positive
interligai	Positive
desarrumai	Positive
entalhada	None
concretizavas	None
purificásseis	None
importes	Negative
comove	Positive
contorna	Positive
contagiada	None
acostuma	Positive
silvai	Positive
imitai	Positive
arma	Positive
despolariza	Positive
concentra	Positive
inicializai	Positive
efetivai	Positive
alinhai	Positive
palpado	None
buscai	Positive
aprovisiones	Negative
berrando	None
anuí	Positive
investirem	None
habitou	None
enverga	Positive
enlouquecidos	None
descongela	Positive
atrevia	None
inibiu	None
reenviado	None
arborizado	None
vislumbreis	Negative
arremateis	Negative
encampa	Positive
ajoelheis	Negative
mexesse	None
violentássemos	None
resolvera	None
soubermos	None
navega	Positive
rearrumai	Positive
ensejeis	Negative
modulai	Positive
alteres	Negative
soletra	Positive
niponiza	Positive
reconfirmados	None
iluminar	None
caibas	Negative
afogarem	None
revertais	Negative
timbra	Positive
colher	None
respondais	Negative
praticou	None
instruí	Positive
examinava	None
estudai	Positive
contraindica	Positive
plagieis	Negative
alude	Positive
batais	Negative
agradece	Positive
tomado	None
vinifiqueis	Negative
buzina	Positive
estrupides	Negative
pondero	None
espiritualizado	None
aterrai	Positive
maximizam	None
desesperai	Positive
lamenta	Positive
compara	Positive
vocifera	Positive
cromai	Positive
apregoada	None
servi	Positive
bivacarem	None
esterra	Positive
decantes	Negative
compulso	None
sanam	None
tenciona	Positive
reputa	Positive
apresentes	Negative
debocha	Positive
prorroga	Positive
piores	Negative
busca	Positive
tragais	Negative
predica	Positive
ri	Positive
esmurres	Negative
dissuadi	Positive
aflui	Positive
excelas	Negative
reocorrei	Positive
niveles	Negative
beires	Negative
ideia	Positive
maiuscula	Positive
acioneis	Negative
acedida	None
mergulha	Positive
falleis	Negative
sucedia	None
difunde	Positive
antidota	Positive
constrange	Positive
confisca	Positive
esbraseai	Positive
adiciona	Positive
encaixilhei	None
adia	Positive
cede	Positive
griteis	Negative
obscurece	Positive
bronzeeis	Negative
implanta	Positive
empanturres	Negative
poupa	Positive
flanqueaste	None
preenche	Positive
relves	Negative
retém	Positive
estampes	Negative
adiantaria	None
aliai	Positive
estabilizados	None
desembestai	Positive
degradássemos	None
logai	Positive
afogues	Negative
azarai	Positive
adota	Positive
tremula	Positive
aparece	Positive
dilata	Positive
alforria	Positive
conjuradas	None
polvilhada	None
tentaria	None
chames	Negative
insiste	Positive
trajai	Positive
gadanhes	Negative
agita	Positive
formigo	None
inscrevo	None
suscita	Positive
necessitai	Positive
oitaveis	Negative
fantasies	Negative
oferecei	Positive
rasteles	Negative
arrecades	Negative
sitiavam	None
disponibiliza	Positive
desobrigueis	Negative
tatua	Positive
baseado	None
alterca	Positive
homogeneizeis	Negative
rebatais	Negative
economiza	Positive
rascunhai	Positive
aderi	Positive
descontinueis	Negative
aparecidas	None
amaldiçoeis	Negative
procede	Positive
evoques	Negative
libera	Positive
fornece	Positive
carreados	None
suicidasse	None
broteis	Negative
desenterres	Negative
balouces	Negative
domina	Positive
ousai	Positive
adormecidas	None
traça	Positive
efectua	Positive
emmoldureis	Negative
batas	Negative
operassem	None
migreis	Negative
adormece	Positive
reinventar	None
encarna	Positive
roga	Positive
franja	Positive
contacteis	Negative
ofegares	None
construí	Positive
aleita	Positive
emboneca	Positive
invocai	Positive
ditou	None
derrames	Negative
dragará	None
aciona	Positive
guarda	Positive
apaga	Positive
escurecidos	None
blandicia	Positive
repete	Positive
salvaria	None
empata	Positive
regula	Positive
consterneis	Negative
prepares	Negative
consulteis	Negative
confecciona	Positive
arrependem	None
remates	Negative
interfere	Positive
retires	Negative
muda	Positive
ressecar	None
entusiasmarei	None
transpira	Positive
criminaliza	Positive
ruas	Negative
travaram	None
pipeta	Positive
configura	Positive
apropria	Positive
bebe	Positive
votou	None
anabolizes	Negative
destrinça	Positive
desfloresteis	Negative
abirrita	Positive
encomprides	Negative
rega	Positive
tostes	Negative
drena	Positive
força	Positive
suscitaria	None
florescerem	None
falecida	None
pedala	Positive
consigna	Positive
pregai	Positive
cruzados	None
passarás	None
fretes	Negative
pulules	Negative
anaboliza	Positive
judies	Negative
niveleis	Negative
prestai	Positive
surjas	Negative
impeli	Positive
agüentado	None
maximizes	Negative
manufaturai	Positive
enfies	Negative
sugerido	None
reúne	Positive
deslocalizáveis	None
alicerça	Positive
achates	Negative
valorizadas	None
embota	Positive
gradua	Positive
açoites	Negative
adestra	Positive
accorda	Positive
reparaste	None
moderes	Negative
acabrunharem	None
seles	Negative
grudai	Positive
desenganada	None
comuta	Positive
amputes	Negative
adultera	Positive
vira	Positive
orgulhes	Negative
tachai	Positive
informa	Positive
acates	Negative
patina	Positive
derrota	Positive
inocentou	None
repetiram	None
obcecadas	None
medísseis	None
porfies	Negative
decresças	Negative
ensaboa	Positive
reanimai	Positive
pindures	Negative
imponde	Positive
zune	Positive
captando	None
apropriai	Positive
subvencionado	None
entranha	Positive
gagueja	Positive
ceceeis	Negative
degusta	Positive
talha	Positive
simbolizeis	Negative
estancai	Positive
estralai	Positive
acrescentará	None
aerai	Positive
cites	Negative
comungues	Negative
abarca	Positive
empreende	Positive
aprovai	Positive
agredi	Positive
arquiva	Positive
rumia	Positive
grasnavam	None
desmistifica	Positive
burlar	None
despejeis	Negative
certifiqueis	Negative
espantes	Negative
crede	Positive
concretizei	None
antecede	Positive
juntasse	None
fricciona	Positive
devores	Negative
salvai	Positive
ignoreis	Negative
mosqueis	Negative
preocupes	Negative
desmitificardes	None
computes	Negative
transportados	None
chuvisques	Negative
reconstituí	Positive
empresta	Positive
planta	Positive
sirvais	Negative
avaliai	Positive
drapejai	Positive
consintas	Negative
missas	None
sobrasse	None
necessitarem	None
crescer	None
inocenta	Positive
soluceis	Negative
suprem	None
ausentas	None
rosnes	Negative
conforteis	Negative
maltes	Negative
fugi	Positive
entrevistes	Negative
desempenhara	None
animaria	None
viola	Positive
pagines	Negative
instiga	Positive
retinais	Negative
aflorada	None
reencontra	Positive
batalhas	None
cortes	Negative
prendas	Negative
desbloqueia	Positive
estonteia	Positive
bombeara	None
pautai	Positive
vereai	Positive
amanhados	None
ceveis	Negative
arremata	Positive
capitanees	Negative
enxergues	Negative
comicha	Positive
sujeitavam	None
adhirais	Negative
habitais	None
agoirenta	Positive
enfaixas	None
ventilai	Positive
detiver	None
derraba	Positive
vincar	None
disfarçam	None
expandas	Negative
pareis	Negative
soçobra	Positive
catando	None
relembrava	None
encolhidos	None
prescrevas	Negative
exumai	Positive
tresanda	Positive
grosa	Positive
transitada	None
assenta	Positive
reaviveis	Negative
alça	Positive
reconstruía	None
jorra	Positive
borrifar	None
zoneis	Negative
desistindo	None
gracitai	Positive
mesmerizeis	Negative
enerves	Negative
reocorre	Positive
tactees	Negative
guardai	Positive
enxoteis	Negative
patines	Negative
descontinua	Positive
recobriríeis	None
refuta	Positive
emboscaras	None
capes	Negative
desgastes	Negative
resguardar	None
selaria	None
devotam	None
importasse	None
empoai	Positive
sua	Positive
coagi	Positive
incomodar	None
anexa	Positive
fixara	None
relata	Positive
assalteis	Negative
idolatrar	None
perturbaram	None
azedarás	None
maxixes	Negative
afirmes	Negative
toparia	None
desfaze	Positive
negativa	Positive
faltes	Negative
topa	Positive
esmerai	Positive
vaza	Positive
convém	Positive
fusiona	Positive
mantiverem	None
deslastra	Positive
forces	Negative
tutoreis	Negative
afeta	Positive
poluas	Negative
acuminado	None
modules	Negative
encarregou	None
tremas	Negative
providencia	Positive
lati	Positive
aumenteis	Negative
maiusculizeis	Negative
babujes	Negative
transladadas	None
redobraram	None
ansiai	Positive
exonera	Positive
tentai	Positive
intimes	Negative
divide	Positive
attura	Positive
inquietai	Positive
problematiza	Positive
vermelheásseis	None
imita	Positive
escondei	Positive
actua	Positive
propaga	Positive
correlata	Positive
cogites	Negative
simplifica	Positive
cubamos	None
arroxeai	Positive
transmitia	None
escolteis	Negative
constranjais	Negative
engancha	Positive
verei	None
assopra	Positive
dês	Negative
lesados	None
rala	Positive
boicotes	Negative
assiste	Positive
imigrados	None
centrai	Positive
concerto	None
existais	Negative
agracia	Positive
diagnostiques	Negative
aprovisioneis	Negative
arejeis	Negative
competes	None
amarram	None
cabeceeis	Negative
minutes	Negative
alarma	Positive
avises	Negative
simplificaria	None
revises	Negative
vendeis	Negative
triplica	Positive
versai	Positive
estatuí	Positive
cursados	None
vindima	Positive
cintila	Positive
atendais	Negative
absorve	Positive
descobertos	None
onduleis	Negative
diverti	Positive
fosforesças	Negative
banqueteai	Positive
flanqueai	Positive
legisleis	Negative
intumesce	Positive
jorrai	Positive
detesta	Positive
ordenes	Negative
afrouxa	Positive
espasmai	Positive
abandones	Negative
inclina	Positive
obedece	Positive
prometei	Positive
exclames	Negative
ejeta	Positive
clorada	None
indexam	None
varies	Negative
transposta	None
volverá	None
secretai	Positive
protejas	Negative
pelejas	None
desbota	Positive
postularíeis	None
requeridas	None
sobrevivais	Negative
fantasia	Positive
gosteis	Negative
revitalizeis	Negative
arrecadeis	Negative
evoluída	None
assou	None
maturai	Positive
maximizado	None
activeis	Negative
estagiai	Positive
estiliza	Positive
arrouba	Positive
correspondais	Negative
acompanhes	Negative
discorda	Positive
clarifica	Positive
meleis	Negative
tresandes	Negative
fratureis	Negative
democratiza	Positive
sonhámos	None
irrigar	None
seqüestra	Positive
recorre	Positive
moldes	Negative
salvarmos	None
voltea	Positive
mencionando	None
prognostica	Positive
adoçada	None
saudou	None
provê	Positive
convalidar	None
cadastres	Negative
creceste	None
bombear	None
importa	Positive
areja	Positive
equiparando	None
presidi	Positive
chutes	Negative
inspiram	None
reproduzidos	None
desarticularão	None
entende	Positive
simbolizada	None
transmuda	Positive
pairai	Positive
apodizeis	Negative
descongelai	Positive
destacara	None
alteai	Positive
custeai	Positive
sonha	Positive
entravada	None
vades	Negative
arreigueis	Negative
ganha	Positive
dormes	None
caias	Negative
pintassem	None
encantada	None
reverte	Positive
reunais	Negative
tragueis	Negative
hibernar	None
subscrevo	None
engana	Positive
participes	Negative
reverberar	None
atreles	Negative
desfraldáreis	None
inactives	Negative
monitorizar	None
dinamitando	None
supurai	Positive
dignarás	None
semelha	Positive
bombardeou	None
suplementeis	Negative
difere	Positive
desencarna	Positive
colonizes	Negative
escarcha	Positive
distamos	None
leves	Negative
convalides	Negative
conceitua	Positive
caracteriza	Positive
contrasta	Positive
tabuleis	Negative
lamentado	None
espalhai	Positive
reconsidera	Positive
dessulfureis	Negative
sofisma	Positive
tensionadas	None
reafirma	Positive
existas	Negative
vaticina	Positive
metralha	Positive
afixa	Positive
tilintes	Negative
divulgassem	None
identifiques	Negative
correlacionado	None
volatiliza	Positive
encaçapai	Positive
espiona	Positive
identifiquei	None
approveis	Negative
arrota	Positive
pisca	Positive
transmiti	Positive
dubla	Positive
urgem	None
rearranjando	None
demarcavam	None
atordoeis	Negative
alquila	Positive
laves	Negative
desprendei	Positive
vertei	Positive
remite	Positive
exterminado	None
irrompiam	None
passarinha	Positive
ressuscites	Negative
explicou	None
contrastai	Positive
umedece	Positive
responsabilizada	None
numerizes	Negative
disfarça	Positive
aterroriza	Positive
nhanháveis	None
amedorentar	None
quadrupliqueis	Negative
ausenta	Positive
atormenta	Positive
inserisses	None
convenciona	Positive
indicava	None
acovardeis	Negative
agüenta	Positive
apites	Negative
começai	Positive
envolvas	Negative
alvorecei	Positive
escoltando	None
sulcado	None
paralizeis	Negative
trabalham	None
acomprides	Negative
profirais	Negative
ajuntai	Positive
prega	Positive
pensionai	Positive
arai	Positive
acalmai	Positive
aforou	None
composteis	Negative
exterminai	Positive
tunes	Negative
asileis	Negative
forra	Positive
dedures	Negative
consumi	Positive
terceirizados	None
encampes	Negative
amortalhes	Negative
esticasse	None
declines	Negative
despi	Positive
modernizado	None
vivai	Positive
indicam	None
lastima	Positive
abusaria	None
differe	Positive
zerai	Positive
ziqueis	Negative
afrancesada	None
decretava	None
oitava	Positive
sobre-estimáveis	None
citamos	None
conversa	Positive
salteai	Positive
rebaixeis	Negative
asfixiai	Positive
mimai	Positive
inteira	Positive
taixares	None
desencanta	Positive
espiado	None
vulcanizes	Negative
articuleis	Negative
dessulfuriza	Positive
urge	Positive
formes	Negative
mixa	Positive
imagines	Negative
albergues	Negative
cercai	Positive
mosquea	Positive
exagerados	None
agaches	Negative
afora	Positive
esfriai	Positive
heleniza	Positive
avistes	Negative
zarpa	Positive
ridicularizes	Negative
prestarmos	None
renomeia	Positive
comercializar	None
obstruais	Negative
ales	Negative
designeis	Negative
fantasiam	None
afineis	Negative
rasga	Positive
aprisiona	Positive
trotar	None
programaram	None
prevalecerão	None
chilreai	Positive
dobravam	None
balbucia	Positive
prepararam	None
solubiliza	Positive
digitaliza	Positive
amanhece	Positive
romaniza	Positive
visitado	None
filtra	Positive
depurada	None
lembra	Positive
ergais	Negative
narreis	Negative
abunda	Positive
colori	Positive
fofoca	Positive
chocai	Positive
trolles	Negative
propulsai	Positive
filtrando	None
instala	Positive
acostes	Negative
encobrindo	None
reagi	Positive
beliscas	None
cintilam	None
reprimenda	Positive
calha	Positive
igualados	None
apouqueis	Negative
querela	Positive
cansa	Positive
violenta	Positive
protegi	None
conotasses	None
amaldiçoa	Positive
rebentai	Positive
arterializes	Negative
apartaram	None
restarão	None
torneies	Negative
rearranja	Positive
folheeis	Negative
testemunhas	None
desempoes	Negative
pires	Negative
transformada	None
carda	Positive
retifico	None
embebedai	Positive
jogues	Negative
rescinde	Positive
requinta	Positive
socorrendo	None
ejacula	Positive
achata	Positive
ruído	None
anacronizai	Positive
organizassem	None
valideis	Negative
barrei	None
anima	Positive
descercai	Positive
diploma	Positive
posta	Positive
pouparam	None
rimes	Negative
baleia	Positive
volatilizeis	Negative
ofereças	Negative
amadureci	None
regenerados	None
acupuntureis	Negative
rotaciona	Positive
aches	Negative
basta	Positive
berreis	Negative
sequestra	Positive
empurra	Positive
ribombamos	None
votarão	None
vives	Negative
escalpes	Negative
corrijas	Negative
botaniza	Positive
compreendas	Negative
continua	Positive
derramarei	None
sediaria	None
originarias	None
rogues	Negative
frustreis	Negative
cozinha	Positive
omite	Positive
sobressaíram	None
lacrará	None
inteiro	None
encareçais	Negative
obstruí	Positive
equipou	None
descomplicada	None
quebra	Positive
travarem	None
arrebentadas	None
lançarão	None
abica	Positive
desculpas	None
reluta	Positive
compensai	Positive
ronronaram	None
pela	Positive
rodeava	None
sobrevém	Positive
deleta	Positive
interceptava	None
protubera	Positive
pavimenteis	Negative
aportuguesada	None
compreenderiam	None
figureis	Negative
sonheis	Negative
nobilita	Positive
soas	Negative
contrata	Positive
ovula	Positive
desfraldou	None
enfarinharas	None
hackeia	Positive
introduzas	Negative
tintes	Negative
embirreis	Negative
trazido	None
pausa	Positive
mudeis	Negative
corrigiram	None
canonizai	Positive
acovardar	None
punas	Negative
terceiriza	Positive
discai	Positive
aliando	None
publicita	Positive
engrosseis	Negative
agrega	Positive
estorva	Positive
caminhes	Negative
cruzes	Negative
divagai	Positive
outorgai	Positive
encalhar	None
ativados	None
retalia	Positive
efectives	Negative
correspondia	None
coloca	Positive
batiza	Positive
bebais	Negative
assalta	Positive
aliciada	None
conflita	Positive
floresteis	Negative
atritares	None
pulses	Negative
iça	Positive
coincidissem	None
preservasse	None
invalides	Negative
lesmo	None
embaraça	Positive
prefere	Positive
macadamizeis	Negative
fodais	Negative
expandi	Positive
citas	None
enternece	Positive
pega	Positive
toleram	None
arreda	Positive
nadeis	Negative
concatena	Positive
alistareis	None
lances	Negative
succedais	Negative
desvairai	Positive
chuteis	Negative
elogiai	Positive
imoleis	Negative
vilipendiados	None
xereta	Positive
encayxes	Negative
espreme	Positive
aconchegues	Negative
oneres	Negative
suporta	Positive
sarado	None
revitaliza	Positive
vingueis	Negative
mirando	None
relacionasse	None
agacha	Positive
entraves	Negative
embaralha	Positive
ribomba	Positive
grafita	Positive
sacrifiques	Negative
homenageai	Positive
vegeta	Positive
tributar	None
penaliza	Positive
ladeia	Positive
contacto	None
pulsa	Positive
torce	Positive
desempenhai	Positive
amontoa	Positive
vacila	Positive
tacha	Positive
troar	None
estenderão	None
checa	Positive
enclausureis	Negative
abafai	Positive
definheis	Negative
chocou	None
perfura	Positive
enviarão	None
profana	Positive
pifai	Positive
capotes	Negative
tendem	None
atreve	Positive
restringi	Positive
saca	Positive
equilibra	Positive
banqueis	Negative
bloga	Positive
sugadas	None
conforta	Positive
disfarçado	None
emenda	Positive
gora	Positive
armazena	Positive
pasmáveis	None
manjavam	None
tuneis	Negative
ardei	Positive
contactaras	None
atoles	Negative
sanado	None
ensopai	Positive
incendiava	None
curtindo	None
borra	Positive
vigorando	None
moscai	Positive
lajeastes	None
vitima	Positive
apupes	Negative
inverto	None
rarefaças	Negative
sacrifica	Positive
mascarai	Positive
aureoleis	Negative
lotear	None
ementa	Positive
invocar	None
embrulhas	None
ressaltes	Negative
ataviai	Positive
utilizar	None
voltes	Negative
reserves	Negative
tireis	Negative
favorece	Positive
sobrecarregues	Negative
contemples	Negative
importunados	None
estatuía	None
cremes	Negative
diverte	Positive
admoestai	Positive
direcciones	Negative
caies	Negative
desmata	Positive
deglacees	Negative
desvirgines	Negative
cassa	Positive
rebatizada	None
sobretaxai	Positive
ultraja	Positive
repetidos	None
vaporizeis	Negative
hospitaliza	Positive
engloba	Positive
afundirão	None
derrama	Positive
sejas	Negative
diferenciassem	None
desiludir	None
soccede	Positive
conjeturas	None
livres	Negative
parti	Positive
intercambia	Positive
tutelou	None
incinerai	Positive
tapai	Positive
absolvais	Negative
raia	Positive
realçados	None
revolve	Positive
recria	Positive
canalizai	Positive
apinhavam	None
fortifiques	Negative
contraponhais	Negative
presupõe	Positive
aguardam	None
conjecturaram	None
acumina	Positive
pulamos	None
tributeis	Negative
trazamos	Positive
rodadas	None
impacto	None
dilatado	None
lustres	Negative
sociabilizes	Negative
injunjais	Negative
enxaguar	None
desfere	Positive
assombra	Positive
centrarão	None
cativa	Positive
supervisa	Positive
arroxeeis	Negative
amaineis	Negative
corre	Positive
abaixa	Positive
bacharela	Positive
atempai	Positive
acamparem	None
suspeyta	Positive
mutileis	Negative
detectai	Positive
ornamenteis	Negative
malhai	Positive
libertava	None
flerta	Positive
secreteis	Negative
possas	Negative
romanizado	None
blogues	Negative
excetueis	Negative
cuida	Positive
rezai	Positive
argenta	Positive
aquentai	Positive
conhecemos	None
blogarás	None
recordava	None
pune	Positive
ligarmos	None
coligidos	None
fieis	Negative
estenographastes	None
ligadas	None
familiariza	Positive
santifica	Positive
asar	None
prognosticai	Positive
evangeliza	Positive
apelides	Negative
caçoa	Positive
sobretaxa	Positive
averbáramos	None
bainhes	Negative
viaja	Positive
aprecio	None
sustes	Negative
carbonizes	Negative
mama	Positive
apara	Positive
alista	Positive
fosseis	Negative
entrecortes	Negative
pegassem	None
buzineis	Negative
afrontai	Positive
encaracolai	Positive
opiniarás	None
voseando	None
magoa	Positive
desembarcado	None
apronta	Positive
portando	None
aclamai	Positive
marcai	Positive
bajula	Positive
minera	Positive
ganhai	Positive
desembarqueis	Negative
açuláveis	None
insistirem	None
rastreia	Positive
ilidi	Positive
draga	Positive
anuncies	Negative
libertam	None
contribuo	None
tenhais	Negative
forma	Positive
modernizareis	None
expliquei	None
ozonizastes	None
vendeu	None
tentará	None
subsistiríeis	None
decide	Positive
escachoai	Positive
espeta	Positive
repousa	Positive
deferi	Positive
expatriai	Positive
renegai	Positive
opera	Positive
manifesto	None
entusiasmando	None
percorre	Positive
recolocai	Positive
consultasse	None
dispenseis	Negative
batuca	Positive
escalpeis	Negative
inveja	Positive
capoteis	Negative
infiltra	Positive
resplendeceu	None
encontra	Positive
maltratai	Positive
exibais	Negative
forçou	None
fiscaliza	Positive
filia	Positive
gelar	None
ameigues	Negative
atribuais	Negative
adere	Positive
doei	Positive
coises	Negative
trepa	Positive
ripeis	Negative
incisa	Positive
grasna	Positive
descoroçoeis	Negative
caga	Positive
impactes	Negative
redigita	Positive
subsiste	Positive
aposta	Positive
configurarem	None
replicadas	None
legendai	Positive
prorrogaria	None
peneiras	None
mexido	None
empregara	None
estoleis	Negative
revelado	None
liberteis	Negative
realça	Positive
desconhecemos	None
triscásseis	None
precipitai	Positive
troca	Positive
rebatiza	Positive
tardará	None
capa	Positive
rufes	Negative
gozai	Positive
cavas	None
implementado	None
planeis	Negative
estuprado	None
tombes	Negative
instruas	Negative
qualificado	None
excretar	None
chefia	Positive
dedicai	Positive
aludindo	None
acobertando	None
refizesse	None
reconcilies	Negative
pressagia	Positive
contaminou	None
arredondarias	None
apercebem	None
afronta	Positive
flooda	Positive
influía	None
recaí	Positive
prossigas	Negative
garante	Positive
desfrutavam	None
renováveis	None
fuces	Negative
flanqueia	Positive
prives	Negative
surtarias	None
prolifera	Positive
remontai	Positive
desças	Negative
celebres	Negative
pila	Positive
grasnará	None
imaginadas	None
empobrece	Positive
logra	Positive
dedura	Positive
garantiam	None
averiguasse	None
perspectives	Negative
interagi	Positive
ampliarão	None
compreende	Positive
angariou	None
lembrariam	None
distraí	Positive
lega	Positive
estoura	Positive
publicitaria	None
respeita	Positive
estagnados	None
esmaltes	Negative
sobrecarregai	Positive
curtas	Negative
esmaecerás	None
sobrepasses	Negative
ornamenta	Positive
acusasse	None
enfeitiçai	Positive
recrudesce	Positive
filosofa	Positive
apostemai	Positive
providencies	Negative
destoa	Positive
indulta	Positive
prendais	Negative
catequizam	None
enfileireis	Negative
passai	Positive
secundes	Negative
déssemos	None
rasteja	Positive
pasteis	Negative
ingere	Positive
desata	Positive
orquestra	Positive
lembrou	None
seduz	Positive
aventurando	None
estima	Positive
dissemina	Positive
assoberba	Positive
liberam	None
percorreram	None
exultados	None
redefini	Positive
clones	Negative
processes	Negative
fere	Positive
guarnece	Positive
retoma	Positive
comporão	None
enoja	Positive
refrigerai	Positive
demite	Positive
sobrepassai	Positive
trovoeis	Negative
confessara	None
confines	Negative
azula	Positive
anuístes	None
catalogues	Negative
deixam	None
predominavam	None
sapeia	Positive
encarai	Positive
moderam	None
treinara	None
nega	Positive
preteriu	None
sairei	None
compactai	Positive
indemniza	Positive
cardar	None
divulgues	Negative
pensionara	None
escapes	Negative
aclarai	Positive
regressou	None
escurece	Positive
implementes	Negative
cooperado	None
abasto	None
associando	None
cultivou	None
comunica	Positive
amarela	Positive
inutiliza	Positive
desidrata	Positive
reinadas	None
marcariam	None
encolhe	Positive
deambula	Positive
figures	Negative
envergonha	Positive
solidificaram	None
expira	Positive
recompensadas	None
herdes	Negative
eclipsa	Positive
jurou	None
recaiais	Negative
depareis	Negative
exerce	Positive
sugeriram	None
reproduzi	Positive
plaineis	Negative
liberai	Positive
uses	Negative
gela	Positive
remes	Negative
sobre-estimai	Positive
facilita	Positive
deposita	Positive
incapacita	Positive
beija	Positive
automatizar	None
fabricar	None
engajeis	Negative
remedia	Positive
deponhas	Negative
cagues	Negative
libertassem	None
percorreu	None
palpitarmos	None
encampadas	None
desculpa	Positive
centralizes	Negative
fechas	None
veres	None
tinge	Positive
tocarmos	None
diagnostica	Positive
zelam	None
sospeyta	Positive
perpetuai	Positive
ames	Negative
conquistei	None
freta	Positive
foqueis	Negative
albergasse	None
reluz	Positive
torneadas	None
auxiliáveis	None
atormentou	None
reboques	Negative
realizes	Negative
limpeis	Negative
roei	Positive
colorado	None
detestai	Positive
vinculeis	Negative
galga	Positive
falai	Positive
saqueia	Positive
brandi	Positive
lambe	Positive
imperando	None
coa	Positive
comenda	Positive
acusa	Positive
esgravatáveis	None
alfaiata	Positive
fena	Positive
desmanchava	None
desbastes	Negative
renovando	None
investigueis	Negative
coletada	None
parasitai	Positive
pines	Negative
angustias	None
solucionava	None
difama	Positive
atua	Positive
vitimiza	Positive
defendiam	None
abisma	Positive
certifica	Positive
temei	Positive
restaurareis	None
objetar	None
permitas	Negative
atenuai	Positive
alisteis	Negative
fina	Positive
incita	Positive
engarrafes	Negative
redefine	Positive
captura	Positive
acrescei	Positive
analisa	Positive
lincha	Positive
mancha	Positive
classifica	Positive
tocaia	Positive
torcido	None
restaura	Positive
vandaliza	Positive
delegasse	None
vagueai	Positive
advocai	Positive
accordes	Negative
amassa	Positive
amontavas	None
assistiria	None
focalizai	Positive
habituariam	None
empoleires	Negative
venças	Negative
levantes	Negative
rebela	Positive
cruzei	None
emprehendais	Negative
desabafar	None
reassegures	Negative
verificado	None
pagueis	Negative
mascarmos	None
papai	Positive
insinuam	None
interditai	Positive
problematizeis	Negative
acateis	Negative
engrosses	Negative
começa	Positive
turba	Positive
apegues	Negative
desaponta	Positive
artilhes	Negative
quiqueis	Negative
comete	Positive
vexai	Positive
estraleis	Negative
contrapõe	Positive
afluí	Positive
manipula	Positive
soldeis	Negative
diplomai	Positive
aplica	Positive
olvides	Negative
escandi	Positive
prossegue	Positive
fotocopies	Negative
roais	Negative
googleai	Positive
debuxai	Positive
doaria	None
entrelaçando	None
atraques	Negative
sentai	Positive
fuça	Positive
bifurca	Positive
ara	Positive
velares	None
almoçou	None
ancora	Positive
chiou	None
recebe	Positive
credencies	Negative
pelejaremos	None
pastoreis	Negative
quedai	Positive
defenestreis	Negative
recebei	Positive
centralizeis	Negative
appliques	Negative
exorteis	Negative
quadriculai	Positive
oxidados	None
ressona	Positive
enmendeis	Negative
vulcanizai	Positive
afaças	Negative
reprimendes	Negative
arquejes	Negative
monitoriza	Positive
atrevais	Negative
desfraldes	Negative
vitimizai	Positive
dividirão	None
amputeis	Negative
fines	Negative
descarna	Positive
sobraçai	Positive
vagais	None
retificados	None
empacotai	Positive
inibe	Positive
contrabandeei	None
ornejes	Negative
dinamizado	None
digerindo	None
concentreis	Negative
fumes	Negative
esquentavam	None
realiza	Positive
furar	None
incomodes	Negative
cauterizes	Negative
vermelheies	Negative
afecta	Positive
ablegai	Positive
semelhei	None
visitas	None
vazia	Positive
creditai	Positive
acortina	Positive
sabotada	None
interpretes	Negative
alcances	Negative
conjugai	Positive
apimentasses	None
murai	Positive
acortines	Negative
supures	Negative
anui	Positive
ponderaram	None
antagonizeis	Negative
enfileira	Positive
molha	Positive
produziria	None
intimida	Positive
pesa	Positive
negligencieis	Negative
importuna	Positive
revelava	None
limai	Positive
friccionando	None
geres	Negative
desenrola	Positive
rejuvenesçais	Negative
ponderassem	None
regozijeis	Negative
abdica	Positive
aprendesse	None
data	Positive
deslizes	Negative
ultrapasseis	Negative
fosforila	Positive
irrompei	Positive
apoteotizaria	None
deliberes	Negative
sorride	Positive
conota	Positive
imana	Positive
estrangula	Positive
eclipses	Negative
rocas	None
esclarece	Positive
decai	Positive
renova	Positive
decretaste	None
aprovisiona	Positive
brocha	Positive
recusei	None
passeada	None
predico	None
aprontarás	None
impactaríamos	None
maltrata	Positive
desconsidera	Positive
maximizada	None
confirmes	Negative
emite	Positive
coloras	Negative
devotar	None
elucidai	Positive
fundirei	None
autentiques	Negative
reaproveites	Negative
envelhece	Positive
desconverses	Negative
diminuíra	None
ataques	Negative
aglutina	Positive
jungirão	None
recubrais	Negative
halogeneis	Negative
borboleteies	Negative
meditarem	None
escorregueis	Negative
hospedara	None
circunscrevessem	None
adquiras	Negative
chibateis	Negative
desafivela	Positive
evaporai	Positive
adrenalizai	Positive
estraçalha	Positive
pajeies	Negative
invoqueis	Negative
chega	Positive
aviva	Positive
commettas	Negative
subir	None
conturbes	Negative
saírem	None
existi	Positive
amayna	Positive
paleeis	Negative
comparei	None
polui	Positive
demitais	Negative
infirma	Positive
centrifuga	Positive
descamba	Positive
provisioneis	Negative
devolvias	None
doma	Positive
conectaram	None
adapta	Positive
publiqueis	Negative
condimenteis	Negative
aclarando	None
apadrinháramos	None
emprenheis	Negative
brigues	Negative
acontecerá	None
celebra	Positive
definissem	None
destroçadas	None
impugna	Positive
revelei	None
reparte	Positive
adestres	Negative
rejas	Negative
perpetra	Positive
povoa	Positive
obedeçais	Negative
sustentassem	None
acompanheis	Negative
embebei	Positive
inquieta	Positive
tampa	Positive
trinches	Negative
briseis	Negative
desaba	Positive
empalidece	Positive
estimulasse	None
fofocai	Positive
conteriam	None
dates	Negative
perguntes	Negative
possibilitasse	None
jejuai	Positive
concordes	Negative
equipes	Negative
estropeai	Positive
penes	Negative
participava	None
urgi	Positive
apanhássemos	None
lastimaríeis	None
descubrais	Negative
figurará	None
babuja	Positive
anunciai	Positive
reforces	Negative
tratavam	None
posiciones	Negative
pertencerá	None
presumi	Positive
arde	Positive
airo	None
codifica	Positive
adestreis	Negative
brincariam	None
solidifica	Positive
depureis	Negative
preceitua	Positive
arfai	Positive
impereis	Negative
escanea	Positive
irrita	Positive
preocupámos	None
secretes	Negative
does	Negative
alegorizai	Positive
agride	Positive
almejeis	Negative
hispanizes	Negative
enxadeis	Negative
deixes	Negative
sublinha	Positive
corresponde	Positive
criptografa	Positive
solai	Positive
encorpa	Positive
oleeis	Negative
empolgai	Positive
distrai	Positive
decores	Negative
desarmes	Negative
erige	Positive
almoça	Positive
parodiando	None
ajusta	Positive
digere	Positive
clores	Negative
palpites	Negative
notes	Negative
apodrecidos	None
diversificará	None
esfomeies	Negative
lanceai	Positive
descreve	Positive
cimenta	Positive
exclui	Positive
persevera	Positive
entram	None
transponhais	Negative
creças	Negative
usai	Positive
tuna	Positive
desonreis	Negative
engulas	Negative
peida	Positive
poriam	None
esforçava	None
aprendido	None
valida	Positive
compadece	Positive
regrado	None
assegurarem	None
penhorai	Positive
laminares	None
mascateai	Positive
desconta	Positive
combinar	None
acerbes	Negative
cercar	None
caluniai	Positive
aninha	Positive
lisonjeies	Negative
otimiza	Positive
empresto	None
tentas	None
empoes	Negative
analiza	Positive
referencia	Positive
estende	Positive
monologar	None
exercei	Positive
mixtura	Positive
obterem	None
acortineis	Negative
arrazoai	Positive
resfria	Positive
decendei	Positive
dialogueis	Negative
tomamos	None
negaram	None
humedeciam	None
profanes	Negative
deyxai	Positive
pernoitou	None
bloquearem	None
gripes	Negative
massacres	Negative
treta	Positive
viveis	Negative
esquadrinhastes	None
teclai	Positive
systematizai	Positive
saias	Negative
familiarizai	Positive
rebola	Positive
asses	Negative
gorgolejes	Negative
alçai	Positive
incorrei	Positive
descolores	Negative
esforça	Positive
incidais	Negative
acastelarmos	None
desabilitado	None
aqueceram	None
acompanhei	None
dessulfurizeis	Negative
extermines	Negative
supera	Positive
aligeirai	Positive
financiai	Positive
ocupa	Positive
pondera	Positive
exaspereis	Negative
afamai	Positive
panes	Negative
engodai	Positive
augurava	None
cercando	None
proselitiza	Positive
testa	Positive
constitui	Positive
estatuas	Negative
alicia	Positive
descaias	Negative
enxada	Positive
cochicha	Positive
acesseis	Negative
convencionar	None
arriba	Positive
comprado	None
intercambiar	None
vacina	Positive
segmenta	Positive
expusera	None
impacta	Positive
ilustreis	Negative
odiadas	None
assanhai	Positive
farda	Positive
distinguem	None
arrumamos	None
apedrejai	Positive
cora	Positive
toseis	Negative
palpai	Positive
incuba	Positive
cambarmos	None
apalpasse	None
estremecia	None
enruga	Positive
endereçai	Positive
transformamos	None
estufa	Positive
toma	Positive
provém	Positive
enrubesce	Positive
abominar	None
adorai	Positive
bordeis	Negative
chibata	Positive
corrida	None
personaliza	Positive
sepulteis	Negative
sobrepujai	Positive
proteger	None
suprime	Positive
entrelaceis	Negative
surpreendendo	None
trazei	Positive
estressávamos	None
debruçados	None
devais	Negative
compete	Positive
expulsa	Positive
abluí	Positive
ralha	Positive
entendei	Positive
reconstruí	Positive
arribeis	Negative
doutrina	Positive
condizer	None
enxerga	Positive
repeti	Positive
despeçais	Negative
augurieis	Negative
cota	Positive
fingi	Positive
deterioradas	None
mamai	Positive
antidotes	Negative
dizima	Positive
fenastes	None
participou	None
raspa	Positive
reassegura	Positive
desjejua	Positive
assoprai	Positive
comiscai	Positive
dobraria	None
ausculta	Positive
paira	Positive
oculta	Positive
divinizarias	None
engraxai	Positive
clona	Positive
ronronai	Positive
atarraxeis	Negative
encapsulou	None
estraçalhados	None
mimas	Negative
alfinetes	Negative
urbanizado	None
bailavam	None
rasca	Positive
subtraem	None
adora	Positive
cortejai	Positive
espelha	Positive
informes	Negative
ajudai	Positive
petisca	Positive
reprime	Positive
enamoreis	Negative
amanteigam	None
murcheis	Negative
trefila	Positive
suavizes	Negative
consola	Positive
morde	Positive
martiriza	Positive
botado	None
exilais	None
expires	Negative
designou	None
obteriam	None
erigi	Positive
dota	Positive
ferreis	Negative
prospera	Positive
mostreis	Negative
costumas	None
endereça	Positive
enfrentamos	None
peleija	Positive
estreiado	None
falará	None
replantai	Positive
chamuscara	None
chicana	Positive
fuzila	Positive
hospitalizeis	Negative
polvilho	None
tocaieis	Negative
revigora	Positive
acasalados	None
aparenta	Positive
resplandece	Positive
manda	Positive
compreendais	Negative
esfaqueia	Positive
irradiar	None
independe	Positive
prolonga	Positive
arremessadas	None
amplificam	None
desabilitar	None
temperam	None
cunhando	None
abrasa	Positive
demitindo	None
apologizeis	Negative
atocha	Positive
despejai	Positive
bebes	None
restabelecerem	None
mantende	Positive
deparando	None
escoves	Negative
calibres	Negative
rói	Positive
junge	Positive
hospeda	Positive
murcho	None
reconquista	Positive
começaremos	None
dominar	None
cumprimentando	None
lutei	None
pinta	Positive
perguntadas	None
macaqueies	Negative
esfaqueeis	Negative
injetai	Positive
legaliza	Positive
reconfortes	Negative
vaiava	None
afugentando	None
timbres	Negative
lucrara	None
especializai	Positive
dinamitastes	None
optimiza	Positive
estranha	Positive
convidam	None
enlaces	Negative
desmaia	Positive
anquilosai	Positive
redirecionados	None
aprovo	None
vomitou	None
obliterado	None
montassem	None
prostres	Negative
assobieis	Negative
emoldura	Positive
ramificai	Positive
grampeados	None
gostarmos	None
assinado	None
jardines	Negative
patrocinai	Positive
semeia	Positive
escala	Positive
subverte	Positive
petrificada	None
orbites	Negative
entediai	Positive
babou	None
acordamos	None
efetuai	Positive
planeja	Positive
engrandeçais	Negative
picota	Positive
publicaremos	None
emerges	None
desconsagraras	None
depara	Positive
lidera	Positive
ministrai	Positive
tencionardes	None
roles	Negative
conspurcar	None
eviteis	Negative
privatiza	Positive
constatado	None
boiai	Positive
descarrila	Positive
regulamenta	Positive
controlam	None
digitalizes	Negative
sossegues	Negative
oprime	Positive
denominai	Positive
randomizeis	Negative
engambela	Positive
minimizamos	None
vibrarem	None
baleados	None
veda	Positive
assenhorees	Negative
indenizareis	None
chocalheis	Negative
singra	Positive
encerradas	None
alargaram	None
retorna	Positive
possibilita	Positive
desencorajes	Negative
conhecei	Positive
tiques	Negative
antologizes	Negative
despidas	None
assobia	Positive
retesa	Positive
fomentai	Positive
apavoradas	None
desossa	Positive
corrobores	Negative
circuncida	Positive
complexada	None
abate	Positive
superai	Positive
desmitifiques	Negative
escrevestes	None
vençais	Negative
excluírem	None
integrai	Positive
anormaliza	Positive
ilude	Positive
festejando	None
evidenciada	None
despejasse	None
emprestai	Positive
confronteis	Negative
deis	Negative
esbulhes	Negative
usa	Positive
precisasse	None
injeta	Positive
escava	Positive
invadir	None
engrandece	Positive
aconchego	None
monopolizar	None
cobiçados	None
ladra	Positive
bulha	Positive
adapteis	Negative
pintalgasses	None
incentiva	Positive
hiberna	Positive
desandeis	Negative
desprendeu	None
concretizarem	None
inquire	Positive
ficáramos	None
certificando	None
amura	Positive
empacota	Positive
sumaria	Positive
ires	Negative
projeteis	Negative
relaciono	None
indicia	Positive
laçai	Positive
quantifiqueis	Negative
reunido	None
encorrei	Positive
cumprimenta	Positive
airai	Positive
esgueira	Positive
escolta	Positive
acereis	Negative
desseguisses	None
regozija	Positive
efetiva	Positive
escuita	Positive
coo	None
enfeia	Positive
brindes	Negative
licita	Positive
agraves	Negative
levantarmos	None
garanti	Positive
profanai	Positive
inverte	Positive
excellas	Negative
baseio	None
entrava	Positive
banalizes	Negative
cumules	Negative
pregues	Negative
difratados	None
reconcilieis	Negative
contra-ataques	Negative
tarda	Positive
cadeia	Positive
lasta	Positive
abençoa	Positive
peles	Negative
calculeis	Negative
estruturava	None
valses	Negative
automatiza	Positive
minimizes	Negative
ala	Positive
hidrata	Positive
penetrada	None
copiei	None
atas	None
frites	Negative
olvidai	Positive
parodies	Negative
utilizes	Negative
reuni	Positive
constaram	None
esconde	Positive
há	Positive
sombreada	None
abjureis	Negative
açodeis	Negative
empaca	Positive
abana	Positive
discernas	Negative
explanes	Negative
blasfema	Positive
instituí	Positive
impulsiona	Positive
elogia	Positive
estufeis	Negative
arrepieis	Negative
contraceneis	Negative
desagravar	None
suaviza	Positive
perdoados	None
sedimenta	Positive
habituada	None
reverteriam	None
acostumes	Negative
rasgues	Negative
vermelha	Positive
asfixiar	None
empeçonha	Positive
cominado	None
batei	Positive
estatuirias	None
solicitar	None
dizei	Positive
amua	Positive
assina	Positive
recolherem	None
rendas	Negative
decifra	Positive
ajeites	Negative
arranja	Positive
idolatrava	None
visualiza	Positive
revista	Positive
abaixando	None
gaseifica	Positive
seguiu	None
arborizes	Negative
encosta	Positive
caves	Negative
amanteigai	Positive
consubstanciando	None
descarrilhar	None
coordena	Positive
recalcitra	Positive
pilotes	Negative
baba	Positive
onerai	Positive
descontam	None
discriminou	None
confirmadas	None
refleti	Positive
empolgou	None
vibrai	Positive
desesperes	Negative
contribuíram	None
ride	Positive
focaliza	Positive
orna	Positive
padejareis	None
xinga	Positive
atrairá	None
recolhe	Positive
entregava	None
emociona	Positive
pressiona	Positive
encontrar	None
menstrua	Positive
limites	Negative
homenageastes	None
correlates	Negative
retaliai	Positive
preparados	None
golpeia	Positive
retarda	Positive
branqueai	Positive
moderasse	None
nanai	Positive
espantariam	None
empolgaram	None
empilha	Positive
transmitirem	None
fascinadas	None
desembestes	Negative
pendeu	None
desamarra	Positive
deram	None
arrulha	Positive
inebria	Positive
quebranteis	Negative
deporta	Positive
coexistais	Negative
combaterem	None
votes	Negative
reportavam	None
anexai	Positive
escalonada	None
censuro	None
mobilia	Positive
pospõe	Positive
ocasionará	None
declamai	Positive
disponde	Positive
acasalai	Positive
acastelai	Positive
declares	Negative
iluminai	Positive
amuralhado	None
perdei	Positive
fazias	None
considerai	Positive
digeri	Positive
delata	Positive
engraçados	None
chacinada	None
identifica	Positive
vogueis	Negative
esvai	Positive
catalisai	Positive
jaz	Positive
engendra	Positive
zuni	Positive
perseveramos	None
massageia	Positive
requisitai	Positive
ofendais	Negative
atraca	Positive
abastecei	Positive
coassines	Negative
inocentes	Negative
despertarão	None
corroborou	None
implementa	Positive
lisonjeia	Positive
servida	None
imprequeis	Negative
aceitareis	None
desapegueis	Negative
agasalhai	Positive
marreta	Positive
mente	Positive
infere	Positive
estipulas	None
cisma	Positive
aprofundes	Negative
volteis	Negative
dotai	Positive
janeles	Negative
alfabetizariam	None
extirpa	Positive
dispersasse	None
grampeeis	Negative
cerca	Positive
agoira	Positive
acomoda	Positive
caraterizeis	Negative
asfixiados	None
esboçai	Positive
sobresaí	Positive
desespera	Positive
dormido	None
baixeis	Negative
breca	Positive
dignai	Positive
embasada	None
balança	Positive
atirada	None
capteis	Negative
hackearam	None
enamores	Negative
centelha	Positive
rebelado	None
defendei	Positive
entrevista	Positive
suportáveis	None
subscrevas	Negative
bruniriam	None
vigora	Positive
remonta	Positive
melo	None
fertiliza	Positive
injustiçásseis	None
reza	Positive
contrataram	None
secava	None
compunham	None
oprimirmos	None
suados	None
empreita	Positive
rotacionar	None
modularemos	None
inteiram	None
convertem	None
mascateeis	Negative
havidos	None
incisais	None
tresandai	Positive
alugueis	Negative
incriminai	Positive
narra	Positive
salvava	None
retoca	Positive
bombeies	Negative
oferece	Positive
faculta	Positive
rebaixa	Positive
colaborando	None
combines	Negative
produzais	Negative
folega	Positive
padejai	Positive
misturai	Positive
blasfemes	Negative
cortejásseis	None
dessalinizai	Positive
alinhada	None
profetiza	Positive
falarão	None
graduando	None
penetrou	None
escusa	Positive
constituí	Positive
censura	Positive
vivas	Negative
tagarela	Positive
valora	Positive
ratifica	Positive
cambaleia	Positive
herda	Positive
sensualizavas	None
gravitastes	None
visadas	None
timbrariam	None
entendida	None
nascem	None
engomeis	Negative
esquia	Positive
colhais	Negative
brites	Negative
esquila	Positive
interessei	None
ocultes	Negative
purifiques	Negative
louves	Negative
desfiai	Positive
incorpores	Negative
chamusca	Positive
infla	Positive
inferi	Positive
recalcitrai	Positive
grafites	Negative
suscitasse	None
lisonjeada	None
entrincheireis	Negative
emboscou	None
offereças	Negative
sustende	Positive
evoluirias	None
tortura	Positive
violentarão	None
diferencieis	Negative
encoleireis	Negative
analogizes	Negative
determines	Negative
ruborizaremos	None
eletrocutasse	None
antitetiza	Positive
inculcai	Positive
acabassem	None
desaceleres	Negative
cadastra	Positive
acolherá	None
aguarda	Positive
engrossado	None
pastes	Negative
costumes	Negative
fraseados	None
intimideis	Negative
transita	Positive
consolida	Positive
olvida	Positive
executara	None
opta	Positive
jura	Positive
zonas	None
facultarão	None
aconchegando	None
puliques	Negative
soluciones	Negative
lamuriai	Positive
emudecei	Positive
bronzeassem	None
apostates	Negative
subjetives	Negative
conjura	Positive
cutuca	Positive
vencesse	None
esclareceria	None
homogeneizes	Negative
personifica	Positive
tascas	None
oponhais	Negative
mostrarmos	None
recordes	Negative
findai	Positive
empobrecei	Positive
seguida	None
ajuda	Positive
danai	Positive
paleia	Positive
esparrameis	Negative
ampliavam	None
abranda	Positive
aguçada	None
estiqueis	Negative
engarrafeis	Negative
fosforiles	Negative
confisqueis	Negative
passeis	Negative
exproprieis	Negative
pereçais	Negative
picaste	None
agourai	Positive
revigoreis	Negative
peques	Negative
permanecidos	None
inspirai	Positive
brises	Negative
desdemocratiza	Positive
rarefaze	Positive
hipotecai	Positive
ruborizai	Positive
cases	Negative
chaparias	None
excepcionaríamos	None
pede	Positive
reordenar	None
lisonjear	None
aduzi	Positive
antecederam	None
aventurei	None
provejas	Negative
subi	Positive
urina	Positive
caula	Positive
calado	None
arabiza	Positive
tarraxam	None
interferi	Positive
infringi	Positive
recrudescei	Positive
cicatrizasse	None
arrefeçais	Negative
reconstruiu	None
ducheis	Negative
desorganiza	Positive
reclamam	None
comercializa	Positive
anoitece	Positive
vesti	Positive
friteis	Negative
maldize	Positive
presenteiam	None
movimenteis	Negative
coevoluí	Positive
vellejeis	Negative
incitassem	None
acondiciona	Positive
encoraja	Positive
dobreis	Negative
aprofundeis	Negative
corrige	Positive
canta	Positive
supplanta	Positive
tipifiqueis	Negative
retrocedei	Positive
colabora	Positive
energizeis	Negative
disseram	None
destacariam	None
enveneneis	Negative
consentiu	None
reembolsa	Positive
esfregai	Positive
casquineis	Negative
amansa	Positive
resisti	Positive
valessem	None
espaireçais	Negative
babes	Negative
azares	Negative
pulula	Positive
transpõe	Positive
sabe	Positive
kickai	Positive
intensificai	Positive
focalizes	Negative
assinalai	Positive
considerar	None
reconforteis	Negative
exumeis	Negative
captures	Negative
mascarar	None
saibas	Negative
vidreis	Negative
podido	None
gadanhai	Positive
exonerar	None
lanceáveis	None
revogados	None
verseja	Positive
amalgames	Negative
protegei	Positive
rebenta	Positive
negligencia	Positive
suplantes	Negative
hidrogenasses	None
prohibe	Positive
tires	Negative
estuda	Positive
apoteoses	Negative
catalisarmos	None
cheires	Negative
attenteis	Negative
esquadrinhes	Negative
devises	Negative
aparafusado	None
conferiria	None
aflorado	None
resguarda	Positive
recolocando	None
recuses	Negative
tecleis	Negative
estendêsseis	None
blasones	Negative
excluirmos	None
ausenteis	Negative
chateies	Negative
ascende	Positive
suja	Positive
distribuí	Positive
lavareis	None
ronqueis	Negative
condecorarias	None
surge	Positive
fissurai	Positive
candidatai	Positive
discretea	Positive
repreendendo	None
compactes	Negative
ressurge	Positive
restariam	None
centrifugai	Positive
assentes	Negative
engravidar	None
senteis	Negative
inspeciona	Positive
geria	None
divinizado	None
sacrificai	Positive
derrapa	Positive
dilui	Positive
recurveis	Negative
desvaira	Positive
falece	Positive
honres	Negative
revogueis	Negative
curtida	None
andeis	Negative
exila	Positive
partilheis	Negative
deificai	Positive
parece	Positive
ardi	None
reflitas	Negative
retrai	Positive
rotula	Positive
desvincula	Positive
sorve	Positive
opina	Positive
esperará	None
aleatorizam	None
doteis	Negative
arcabuzes	Negative
subordinar	None
retifiques	Negative
desmontes	Negative
cadastrou	None
sói	Positive
despedaces	Negative
deporteis	Negative
vitoria	Positive
augures	Negative
aportes	Negative
ressoa	Positive
intensificados	None
sistematizou	None
firma	Positive
debuta	Positive
candidata	Positive
tacteai	Positive
urdida	None
engambeles	Negative
lanceia	Positive
parai	Positive
conspira	Positive
esqueçais	Negative
ingirais	Negative
escolhas	Negative
maltai	Positive
chovei	Positive
montai	Positive
reproduz	Positive
verea	Positive
mosqueai	Positive
depositada	None
xonai	Positive
mediteis	Negative
dispenses	Negative
atuo	None
embarcai	Positive
acatarem	None
convinde	Positive
legisles	Negative
lutava	None
interessada	None
televisa	Positive
eletrocuta	Positive
agua	Positive
crucifica	Positive
pastorai	Positive
desmoraliza	Positive
fixavam	None
manifestes	Negative
vinques	Negative
troveja	Positive
derrapai	Positive
invectiva	Positive
alisavas	None
enfronha	Positive
desprendendo	None
extraditado	None
sobressaias	Negative
ensopados	None
emocionai	Positive
engrossa	Positive
tentar	None
intrometais	Negative
figuram	None
mineraliza	Positive
dita	Positive
estanques	Negative
intrometas	Negative
coleta	Positive
coaxai	Positive
cindi	Positive
panai	Positive
ponhes	Negative
anexados	None
vais	None
aprenderia	None
poluídas	None
retira	Positive
escritureis	Negative
desiludi	Positive
seria	Positive
mordas	Negative
lajeia	Positive
coligida	None
calça	Positive
ricocheteeis	Negative
decifradas	None
emoldureis	Negative
prioriza	Positive
conturbado	None
esqueças	Negative
proíbi	Positive
pressurizada	None
notaria	None
pauteis	Negative
quantificai	Positive
curva	Positive
tumefizestes	None
refratámos	None
coexiste	Positive
estacionar	None
acarditeis	Negative
subvencionaríeis	None
degoleis	Negative
lança	Positive
soterraram	None
exigem	None
conjuga	Positive
aclara	Positive
abales	Negative
fagulhes	Negative
mixes	Negative
exterminam	None
engorda	Positive
refina	Positive
reiteram	None
retruca	Positive
recurva	Positive
franzi	Positive
cindiram	None
escorasses	None
homenageeis	Negative
estala	Positive
aparecerá	None
careçais	Negative
negara	None
fortaleçais	Negative
circunscreve	Positive
suplica	Positive
delegai	Positive
doireis	Negative
jacta	Positive
refugieis	Negative
mastigai	Positive
rui	Positive
lambas	Negative
perpassa	Positive
afilia	Positive
preocupa	Positive
acasaleis	Negative
tasca	Positive
separes	Negative
desposaria	None
dormida	None
socorre	Positive
efectiva	Positive
organiza	Positive
tipeis	Negative
comovei	Positive
capta	Positive
explode	Positive
diferenciava	None
galopar	None
descaroçai	Positive
ultrapassassem	None
rosnai	Positive
vesgueies	Negative
fita	Positive
fluora	Positive
cristaliza	Positive
finalizai	Positive
rangíamos	None
moderado	None
dissolvais	Negative
desnivelados	None
atea	Positive
cultuar	None
ores	Negative
acomodou	None
arrefece	Positive
lota	Positive
caules	Negative
votai	Positive
esgana	Positive
sega	Positive
apeles	Negative
trata	Positive
suspeiteis	Negative
diplomeis	Negative
devisado	None
fadiga	Positive
reportai	Positive
diminuírem	None
traçadas	None
tece	Positive
gani	Positive
condecora	Positive
metas	Negative
amedrontam	None
socorrei	Positive
coroa	Positive
atempareis	None
pari	Positive
largada	None
proponhais	Negative
escrutinizarem	None
acerca	Positive
remenda	Positive
vedes	Negative
assáveis	None
apodrece	Positive
explica	Positive
revistes	Negative
arrepia	Positive
games	Negative
reparai	Positive
postula	Positive
confesses	Negative
empolgues	Negative
vindimai	Positive
gerencia	Positive
vermelheja	Positive
abandonai	Positive
automatizai	Positive
envolve	Positive
pratiques	Negative
padecia	None
tutela	Positive
rarefazei	Positive
cries	Negative
estagna	Positive
tripudieis	Negative
dadiveis	Negative
adianteis	Negative
açodai	Positive
lambuceis	Negative
listamos	None
pulicai	Positive
imiscui	Positive
tela	Positive
encantar	None
amolga	Positive
industrializes	Negative
vazies	Negative
esmaga	Positive
empurrou	None
outorgáveis	None
esterreis	Negative
capitula	Positive
sucumbe	Positive
prezo	None
derrotes	Negative
posteis	Negative
guia	Positive
encortina	Positive
provenhais	Negative
pedisse	None
confundais	Negative
exibi	Positive
agisse	None
entretei	Positive
sabota	Positive
situará	None
bacharelai	Positive
descartes	Negative
manchadas	None
olvidado	None
enlaçam	None
desistais	Negative
ciseis	Negative
recoloca	Positive
tutores	Negative
soes	Negative
titula	Positive
fia	Positive
perspectiva	Positive
beijeis	Negative
creditarmos	None
descrevei	Positive
alarmando	None
comutes	Negative
sonhadas	None
elaborai	Positive
argumentavam	None
reconstituindo	None
participa	Positive
intercala	Positive
bebei	Positive
desentranha	Positive
traduzi	Positive
roda	Positive
exterioriza	Positive
irritando	None
sumirias	None
move	Positive
habita	Positive
confliteis	Negative
tipifica	Positive
decidas	Negative
tensiona	Positive
consultava	None
sorrias	Negative
metralhar	None
pudesse	None
coagula	Positive
cursarão	None
denotas	None
contrabandeia	Positive
sentes	Negative
torneia	Positive
transportamos	None
antecipou	None
instigues	Negative
decresçais	Negative
assentaram	None
cai	Positive
erra	Positive
empala	Positive
salvaguardados	None
caluniados	None
curte	Positive
preservando	None
luzi	Positive
administrarem	None
tanga	Positive
pensa	Positive
desabafes	Negative
desloca	Positive
deformai	Positive
agitava	None
bordes	Negative
sopres	Negative
renomeou	None
fallai	Positive
contribuirei	None
abriga	Positive
pratica	Positive
purificai	Positive
envergonhai	Positive
assemelhai	Positive
divididas	None
cortai	Positive
regules	Negative
demoli	Positive
reutilizes	Negative
ortiga	Positive
preza	Positive
aproveitei	None
respondas	Negative
operado	None
salvaguarda	Positive
economizai	Positive
acidificaram	None
merece	Positive
vai	Positive
mures	Negative
leva	Positive
extrates	Negative
encorajeis	Negative
irrigada	None
vislumbres	Negative
soca	Positive
engasga	Positive
milharias	None
regurgita	Positive
reafirmada	None
homenageasse	None
treina	Positive
casa	Positive
jantes	Negative
acromatizai	Positive
expressa	Positive
reaqueças	Negative
socorrido	None
rejoga	Positive
caches	Negative
aprumes	Negative
incorporada	None
rimados	None
estanho	None
criticardes	None
arrastai	Positive
admirar	None
distingas	Negative
moer	None
dispararas	None
palrais	None
dominou	None
presidais	Negative
ignoro	None
vínhamos	None
arrastaria	None
incitam	None
desinfleis	Negative
recupera	Positive
soltavam	None
estaciona	Positive
fabriques	Negative
domeis	Negative
repassava	None
papes	Negative
abirritassem	None
deseja	Positive
assenhoreeis	Negative
desembesteis	Negative
consideres	Negative
pautadas	None
fatorada	None
polinizadas	None
arrependeis	None
espojaria	None
pondereis	Negative
combalais	Negative
chuta	Positive
reincidirias	None
esmurra	Positive
estola	Positive
decola	Positive
subscreverem	None
compiles	Negative
executarmos	None
exumes	Negative
disporem	None
destaca	Positive
balanceia	Positive
sondes	Negative
intermedeia	Positive
desenhes	Negative
angliciza	Positive
assombres	Negative
convalescei	Positive
revitalizado	None
vigieis	Negative
fracassavam	None
mascavai	Positive
bisa	Positive
fala	Positive
toleres	Negative
misseis	Negative
malha	Positive
eleveis	Negative
gazeeis	Negative
ameis	Negative
causes	Negative
ocasiona	Positive
ferres	Negative
invocarem	None
dardeja	Positive
reserveis	Negative
estarreçais	Negative
converteríeis	None
dateis	Negative
reconta	Positive
catalisa	Positive
pedi	Positive
imobilizava	None
relampejasses	None
abalai	Positive
augura	Positive
ajoelhaste	None
regala	Positive
dramatizeis	Negative
enreda	Positive
impele	Positive
sexa	Positive
luto	None
nutri	Positive
atroeis	Negative
cavalga	Positive
entranharas	None
briguei	None
desfalecias	None
desobstrui	Positive
dobres	Negative
doares	None
corrói	Positive
equiparás	None
fixes	Negative
apaixonam	None
tapes	Negative
importadas	None
desflorestes	Negative
cumularem	None
apelidando	None
vigies	Negative
raies	Negative
revogar	None
calcula	Positive
lesmai	Positive
flanqueies	Negative
desfralda	Positive
banques	Negative
avassalai	Positive
contraria	Positive
encaminham	None
acidula	Positive
aquieta	Positive
diferencia	Positive
decantados	None
degoles	Negative
faltarão	None
tornai	Positive
retrucai	Positive
escrevei	Positive
aferventasse	None
trava	Positive
estigmatizes	Negative
ignores	Negative
avancei	None
mereçais	Negative
sedia	Positive
tira	Positive
revela	Positive
ressoásseis	None
dribles	Negative
imolou	None
tchove	Positive
boicotado	None
camba	Positive
desacelera	Positive
nutria	None
segregado	None
deteriora	Positive
exponhas	Negative
genuflecte	Positive
nascemos	None
atemorizar	None
exportáveis	None
rezados	None
desmembra	Positive
imaginarem	None
instancia	Positive
suprimiram	None
desbotes	Negative
besuntai	Positive
fomenta	Positive
rebenteis	Negative
proves	Negative
regenera	Positive
gravai	Positive
agastai	Positive
acaricies	Negative
rapa	Positive
atanazai	Positive
retornai	Positive
cavai	Positive
adultizeis	Negative
rumiarão	None
concebesse	None
assaltadas	None
ergue	Positive
escuta	Positive
generaliza	Positive
aparelhai	Positive
apaixonavam	None
franquieis	Negative
extinguido	None
encarcerai	Positive
emprehendas	Negative
morga	Positive
confronta	Positive
salpicado	None
provou	None
adula	Positive
rezes	Negative
trollai	Positive
atribui	Positive
pululadas	None
esgravatai	Positive
motivada	None
idealiza	Positive
acabando	None
peleja	Positive
ridiculariza	Positive
conceitueis	Negative
assovieis	Negative
accusa	Positive
espojes	Negative
categorizai	Positive
bomba	Positive
inicializam	None
imagináveis	None
drapejávamos	None
alisada	None
fatigada	None
desmistificai	Positive
alternados	None
atenta	Positive
prosperarem	None
optai	Positive
picotas	None
eletrocutando	None
escasseai	Positive
cozinhai	Positive
enquadra	Positive
correlateis	Negative
olhastes	None
relampejai	Positive
zoa	Positive
incumbe	Positive
disparai	Positive
desproporciones	Negative
decretaria	None
esgoteis	Negative
reclama	Positive
propagai	Positive
rescaldes	Negative
marteles	Negative
alavanques	Negative
acalentes	Negative
adumbres	Negative
subvencionados	None
galgo	None
cubes	Negative
arbitra	Positive
chamai	Positive
contendei	Positive
ilumineis	Negative
distorças	Negative
desencadeies	Negative
recusam	None
cochila	Positive
reanima	Positive
alardeiam	None
muro	None
lutes	Negative
sondou	None
questionai	Positive
resume	Positive
gomitai	Positive
salmoura	Positive
petrifiques	Negative
pirai	Positive
cruza	Positive
acopla	Positive
sugai	Positive
carecendo	None
xona	Positive
reorganizai	Positive
seduzi	Positive
vibram	None
listas	None
ranges	None
labuta	Positive
disques	Negative
jogarão	None
desarticula	Positive
pinceles	Negative
remateis	Negative
tremesses	None
discordavam	None
esgrime	Positive
reclamamos	None
pioradas	None
lidereis	Negative
forjai	Positive
mumifica	Positive
crê	Positive
mela	Positive
reconhecei	Positive
nascerem	None
taxa	Positive
deriva	Positive
coalesce	Positive
carregues	Negative
franquia	Positive
fiques	Negative
tergiversa	Positive
aleatorizes	Negative
exciteis	Negative
acoimai	Positive
escança	Positive
assegura	Positive
providenciai	Positive
breques	Negative
publiquei	None
entoa	Positive
relva	Positive
repoli	Positive
esgarça	Positive
frustraríamos	None
maculai	Positive
compenetrado	None
finjais	Negative
luta	Positive
combalas	Negative
entres	Negative
desemaranhai	Positive
reconstruais	Negative
algema	Positive
consoles	Negative
esquiai	Positive
menti	Positive
sexes	Negative
empeçonhai	Positive
caduca	Positive
taxado	None
devoram	None
simpatiza	Positive
desvaires	Negative
saboreies	Negative
desconversa	Positive
pacificados	None
vincai	Positive
escuites	Negative
obstrui	Positive
desfigures	Negative
reunirão	None
ofereçais	Negative
influencia	Positive
libertará	None
transtorna	Positive
trabalha	Positive
lacra	Positive
exercites	Negative
mendigo	None
desagrega	Positive
wikificaste	None
recrutou	None
escameis	Negative
debate	Positive
barganha	Positive
canalizo	None
pretenderam	None
aleis	Negative
cumula	Positive
dublavam	None
encaracolada	None
patrulha	Positive
choraminga	Positive
divorciando	None
abandonavam	None
calandra	Positive
condena	Positive
acerqueis	Negative
plantai	Positive
tunaste	None
destelhes	Negative
transcorrer	None
prevalecerem	None
acaricia	Positive
atinge	Positive
despacha	Positive
avermelha	Positive
acessa	Positive
raciocinava	None
pontua	Positive
controles	Negative
chanfres	Negative
orientasse	None
adoça	Positive
inibi	Positive
mumificáveis	None
dificultaria	None
rua	Negative
exiles	Negative
tranca	Positive
rufai	Positive
agrada	Positive
imbuí	Positive
alugam	None
surdais	Negative
comprometei	Positive
recusado	None
decepciona	Positive
duplica	Positive
doses	Negative
invadia	None
atenderão	None
resvaleis	Negative
denunciei	None
extende	Positive
transtorneis	Negative
supras	Negative
tensioneis	Negative
emagrece	Positive
incomodai	Positive
magnifica	Positive
teoriza	Positive
privando	None
distinguia	None
prostituas	Negative
escalona	Positive
halogenastes	None
prorrogou	None
obrai	Positive
adquire	Positive
designai	Positive
indiciados	None
analiseis	Negative
trina	Positive
fende	Positive
subornai	Positive
lideram	None
exprimida	None
segurado	None
processa	Positive
apega	Positive
interage	Positive
padece	Positive
integrara	None
despede	Positive
tripula	Positive
enche	Positive
inova	Positive
pagina	Positive
vexa	Positive
deslocarem	None
encerarias	None
desfia	Positive
aninhes	Negative
cola	Positive
alisa	Positive
paga	Positive
elaborada	None
cinteis	Negative
nomeia	Positive
consagrai	Positive
atribuí	Positive
carpe	Positive
contrafaçais	Negative
discavam	None
desmobilizeis	Negative
activai	Positive
predomina	Positive
comprometera	None
arruinados	None
julgueis	Negative
aligeirares	None
estudeis	Negative
presuponhais	Negative
mostra	Positive
alceis	Negative
aerossolizavas	None
reconheçais	Negative
desencadeadas	None
estresses	Negative
alimenta	Positive
apodrecida	None
excele	Positive
alavanca	Positive
agendai	Positive
cavouqueis	Negative
dinamita	Positive
arranjes	Negative
aprontastes	None
pastoreia	Positive
monitores	Negative
cataloga	Positive
moscado	None
grita	Positive
entornai	Positive
orientes	Negative
estupefica	Positive
sossegou	None
representes	Negative
reprovado	None
vendas	Negative
curves	Negative
reforceis	Negative
lagarteia	Positive
julgues	Negative
contamines	Negative
minimiza	Positive
imola	Positive
pulava	None
esquiva	Positive
abachareles	Negative
rendeu	None
contorce	Positive
imagineis	Negative
solicitávamos	None
profere	Positive
dialoga	Positive
arrancar	None
partilho	None
atices	Negative
azulejaria	None
evangelizai	Positive
estreiada	None
doara	None
sintetiza	Positive
reprimas	Negative
desliza	Positive
grelha	Positive
tunai	Positive
averiguadas	None
desistiam	None
descarrilhes	Negative
injuria	Positive
tramas	None
dribleis	Negative
suborna	Positive
ultrapasses	Negative
patenteeis	Negative
desabitueis	Negative
lingotai	Positive
estupeficai	Positive
manipulardes	None
digas	Negative
cultua	Positive
jungi	Positive
entrelinhai	Positive
desencadear	None
denuncia	Positive
removesse	None
chovido	None
devassar	None
estraçalharás	None
detestes	Negative
humedece	Positive
adotes	Negative
ondeias	None
comprova	Positive
mia	Positive
inscrevia	None
salteeis	Negative
lucta	Positive
engolidos	None
circulaste	None
justapor	None
benze	Positive
formava	None
picha	Positive
pichai	Positive
reagida	None
alastraria	None
confraternizaram	None
legitimeis	Negative
domestiques	Negative
invadiram	None
disputa	Positive
evangelizes	Negative
canonizou	None
ligues	Negative
jejueis	Negative
defende	Positive
googla	Positive
pertence	Positive
estalo	None
tipa	Positive
contraiais	Negative
embelezai	Positive
suava	None
renunciáveis	None
ganhas	None
dessulfurareis	None
emaranheis	Negative
chafurdes	Negative
vertais	Negative
calunia	Positive
sucedessem	None
apavora	Positive
fatia	Positive
bóia	Positive
rias	Negative
ajuntam	None
suicides	Negative
chanfra	Positive
magnetizámos	None
esmagues	Negative
custeies	Negative
dissente	Positive
contentes	Negative
manches	Negative
aturde	Positive
freieis	Negative
admitiu	None
replicado	None
insisto	None
grassita	Positive
acalmes	Negative
mede	Positive
recorta	Positive
gesticula	Positive
faciliteis	Negative
dissolver	None
funcionai	Positive
resolveremos	None
ceifes	Negative
decepa	Positive
zumbi	Positive
enamorando	None
distribuído	None
pretendes	None
burla	Positive
adulterai	Positive
praguejes	Negative
comerão	None
intitula	Positive
estiques	Negative
refugia	Positive
teima	Positive
esculpi	Positive
configures	Negative
alcançassem	None
leias	Negative
bradai	Positive
soluciona	Positive
treineis	Negative
duelaríeis	None
alertai	Positive
planejamos	None
igualeis	Negative
combinadas	None
mandes	Negative
reciclarmos	None
amolai	Positive
cria	Positive
secunda	Positive
cicatrizes	Negative
gabes	Negative
enegrece	Positive
coalheis	Negative
recusa	Positive
jazei	Positive
escarniriam	None
riscados	None
destrata	Positive
tomei	None
ementai	Positive
intima	Positive
engarrafai	Positive
suspeites	Negative
encalha	Positive
pasteurizai	Positive
cometiam	None
levantai	Positive
desagraves	Negative
restituas	Negative
arrecada	Positive
restes	Negative
conserta	Positive
recebais	Negative
polinizes	Negative
minuciai	Positive
opinies	Negative
rapelai	Positive
bafejeis	Negative
desenganeis	Negative
perfumeis	Negative
aluviai	Positive
substantives	Negative
projetai	Positive
ira	Positive
reagrupeis	Negative
entretas	Negative
enfatiza	Positive
poluídos	None
curtem	None
decoreis	Negative
inflameis	Negative
tributes	Negative
argumentasse	None
exulta	Positive
ecoa	Positive
cresce	Positive
peneira	Positive
supri	Positive
quites	Negative
rola	Positive
derrete	Positive
reformai	Positive
redefinas	Negative
prostrada	None
peca	Positive
privasse	None
curto-circuiteis	Negative
fotocopiado	None
rechaça	Positive
surpreendei	Positive
cimenteis	Negative
trefileis	Negative
mortificásseis	None
cimentai	Positive
refogado	None
sustenteis	Negative
largueis	Negative
regenerando	None
obrigarão	None
medita	Positive
realojámos	None
cultiva	Positive
arrastava	None
ricocheteies	Negative
mies	Negative
retomeis	Negative
rotules	Negative
escaldes	Negative
freqüenta	Positive
liquides	Negative
hesites	Negative
trombetearas	None
empacai	Positive
processavam	None
polvilha	Positive
empanturreis	Negative
sugeria	None
nocauteasse	None
demonstrou	None
acabrunha	Positive
divertisse	None
admira	Positive
relinchai	Positive
abandeireis	Negative
ribombares	None
respirado	None
embriaga	Positive
atrapalhes	Negative
ceifa	Positive
reconhece	Positive
desabares	None
desalentes	Negative
trapaceia	Positive
sorrindo	None
fluoreteis	Negative
condensa	Positive
compras	None
sedeis	Negative
estoca	Positive
perpetua	Positive
figurou	None
aquiesceu	None
evocai	Positive
esvoaçai	Positive
ansieis	Negative
colocares	None
contradize	Positive
fode	Positive
enfurece	Positive
homologas	None
forçaste	None
capitalizam	None
pré-compra	Positive
condicionai	Positive
adequa	Positive
desfigura	Positive
investi	Positive
interfiras	Negative
habitai	Positive
orçado	None
patenteia	Positive
apaixona	Positive
brades	Negative
ocorre	Positive
cobiça	Positive
desperdiçaram	None
mimetiza	Positive
massacra	Positive
vandalizou	None
namora	Positive
estraga	Positive
admite	Positive
escancarasses	None
aquaplanai	Positive
aparentes	Negative
chores	Negative
converte	Positive
preparei	None
coletai	Positive
ondulados	None
debita	Positive
intriga	Positive
engatinha	Positive
deambulai	Positive
investiga	Positive
observando	None
apunhales	Negative
intrigues	Negative
aberreis	Negative
obliterar	None
responde	Positive
agridas	Negative
dotes	Negative
alega	Positive
elogiada	None
observai	Positive
afasta	Positive
cortejes	Negative
ronca	Positive
vario	None
pavimenta	Positive
descansa	Positive
mija	Positive
certificai	Positive
esbanja	Positive
apegaras	None
operai	Positive
desalojai	Positive
ultimai	Positive
valsa	Positive
mecanizes	Negative
provoca	Positive
cegou	None
engolida	None
flutua	Positive
bica	Positive
desconfiai	Positive
expurga	Positive
finda	Positive
repises	Negative
inverna	Positive
reprimendai	Positive
relembra	Positive
desenterrai	Positive
condimentado	None
desmerece	Positive
rejuvenesce	Positive
sobres	Negative
excedei	Positive
sedai	Positive
postes	Negative
estreites	Negative
subjetivas	None
homogeneizasse	None
fosfata	Positive
circuncideis	Negative
vinde	Positive
acerto	None
antedato	None
embotelheis	Negative
impede	Positive
cheireis	Negative
produzi	Positive
elucida	Positive
dedicado	None
encortines	Negative
deixai	Positive
sospeitai	Positive
relatou	None
afirmai	Positive
tinham	None
fagulha	Positive
raptados	None
confiscava	None
sibila	Positive
aconselhes	Negative
pingando	None
esbombardeeis	Negative
abala	Positive
relaxa	Positive
padejaria	None
retorquas	Negative
cooperarem	None
constrói	Positive
erradiques	Negative
duvidai	Positive
defere	Positive
despeças	Negative
deslocaliza	Positive
extraí	Positive
prosseguidas	None
jejua	Positive
miscres	Negative
pulinhes	Negative
maximizai	Positive
mines	Negative
ajoelhai	Positive
desmonta	Positive
decapita	Positive
entraveis	Negative
empates	Negative
correlacionada	None
penses	Negative
remi	Positive
correlaciona	Positive
curveteai	Positive
delimita	Positive
mana	Positive
abatidas	None
desnuda	Positive
aterrissa	Positive
demanda	Positive
jubiles	Negative
somes	Negative
apetece	Positive
reutiliza	Positive
botes	Negative
frustra	Positive
cafetina	Positive
teclar	None
alertava	None
falla	Positive
metaboliza	Positive
aleatorizeis	Negative
penhora	Positive
penhorarmos	None
junta	Positive
delibera	Positive
rumina	Positive
geme	Positive
telha	Positive
ata	Positive
