առատներով	առատովդ	lemma
նիդերլանդերենից	նիդերլանդերենումս	lemma
սխտորի	գրյանքների	Case
կառկայծենք	չսգար	Tense
կօժանդակեմ	չպատկանեիք	Tense
չզառամանա	կարօտեց	Person
չխեղդեին	կկործանես	Tense
կարկանդակ	վերջնախաղերը	Case
զրահամորթումդ	մատենագիտություններիցդ	Possession
չանցգայացա	կհարբենամ	Person
ադամանդներից	օդանավակայանից	Case
մայիսյաններով	մայիսյանովդ	lemma
նեպտունիումներիս	կոկտեյլովս	Possession
չհուսալքեք	կհուսալքի	lemma
հայրերիդ	արջնի	Case
կհալածեք	չհրկիզեմ	Tense
կայուններովս	ավազակիս	Possession
տարածեմ	պաղատեցի	Person
խաշ	գնդակահարություններ	Case
չհազացիք	ընգնեիք	Person
կմարթեիր	շշնջա՛	Person
զոդին	ղազերի	Case
ապահովիցդ	տանուտիրոջով	Number
անդրկովկասցունս	բացահայտներով	Number
նորոգներիցդ	մշակույթներիս	Number
նետեց	նետի	lemma
կհղենանք	մղես	Tense
շինականներովս	ֆրանսերենս	Possession
կխոպոպացվեր	խօսէք	Tense
հմայենք	կտաղտկանայիր	Tense
տղամարդկանցս	ավազուտս	Possession
կհիասթափեցնեիք	հենեցիք	Person
բուսաբաններիդ	մրջյունին	Case
կհոսի	պոռոտախոսեց	Person
խաբեբայություն	մալթայերենները	Case
բուժումներից	սուտասանից	Case
հոնքերս	հոլանդերենիս	Possession
չաճես	գիտակցվի՛ր	Person
պատառի	ապահովեցրեց	Person
պանդոկներիդ	հոգնածությամբդ	Possession
լիանան	կկիրառվեի	Tense
խեղանդամիդ	կքաքեր	Number
ադամանդներից	զազրոտիիցս	Case
բամբասներիցս	պլուզումս	Possession
կելտեր	թաքցնեն	Number
մտավորս	շանթամբոխներովս	Possession
պատառի	չկերակրեց	Person
կտեղեկանայինք	ընդգծես	Tense
սուրահներումդ	անքաղաքավարությունում	Case
վախի	վախեցնել	lemma
դիսպաշերով	կտեղեկանամ	Number
կտնօրինենք	չխանդես	Tense
տես	չվիճեց	Tense
ճմռե՛ք	կկոշկոճեք	Person
ընթացաք	չապահովվեիք	Person
նամերով	նամերում	lemma
կգրադարձի	խմբագրենք	Tense
կախակապումդ	խցիկներում	Case
հատուներիս	հռովմայեցուդ	Case
չեղծեցիր	եղծող	lemma
միապետություններիցդ	լուսանկարչությունդ	Possession
թորիծ	հեստապարովս	Number
ֆրանսուհիներովս	ինքնահավանս	Possession
ռուսիցս	ուղիղդ	Number
ղայիշիս	հոբելյարներին	Case
բամբասներիցս	ֆրանսերենս	Possession
գեջերումս	սիեստայովս	Possession
երգեհոնիդ	գուղձերի	Case
հեռատեսներ	հումքերի	Number
մարզասրահումդ	հալվայից	Number
փոխարինումներովդ	խավարասերովդ	Possession
անդյաներից	ծաղկակաղամբներս	Number
հալումաշովդ	լեռնայիններովդ	Possession
իրականներից	գանգրափնջիցս	Case
ալպինիզմդ	լոլիկներովդ	Possession
արածեցնեին	արածեցրինք	lemma
սվին	ենիչարիիդ	Number
տեռորիզմին	հատուկներիդ	Case
չճանապարհորդեք	կճանապարհորդի	lemma
խայրիում	նավաստիդ	Number
ջերմիդ	սկանդիումներիցդ	Possession
կելտեր	պլոճիկներումդ	Number
կնախընտրեիր	ընդգծենք	Tense
խայրիում	կախով	Number
ֆրիզերեններումս	ամորձում	Case
կպայմանավորվեն	չբաժանվեիր	Tense
չլծեիր	կլանեցիր	Person
պահպաներ	պահպանեն	lemma
սուտասաններովս	ծափահարմանս	Possession
խօսայ	խօսացնել	lemma
փտած	ազգանուններ	Case
մանգուստներով	օթերին	Number
նքողակից	էջի	Number
աղորիքներովդ	մահկանացուներով	Number
զգուշաց	չծծեցիք	Tense
ձարխոտեր	փորձերից	Number
կկանխենք	կկանխես	lemma
ծնեցի	փքեի	Person
կփութանք	կփութաս	lemma
գոչերումս	բրոմիս	Possession
հայհոյեցիք	զեղծ	Tense
փորձառություններիցս	շնորհենք	Number
ուրուրդ	կոթողներովդ	Possession
նորապսակդ	սաղավարտներովդ	Possession
հոկտեմբերյաններումս	հոլանդերենիս	Possession
կբդկես	բեկտի՛ր	Person
կճանապարհորդեի	չծլարձակեն	Tense
կտնօրինենք	ծլարձակեիր	Tense
սինլքորովս	ձեւույթներս	Possession
կրոնականներովդ	շառաչյունովդ	Possession
գոնադովս	սրերովս	Possession
շանթամբոխիդ	թարխանաներդ	Possession
պատառեց	պատառի	lemma
գաղտնիքիցդ	չվերթներից	Case
կքաղցեմ	չբարբաջեն	Tense
նանիցդ	մետաղագործություններիդ	Possession
ամբարտավաններիցս	տրամագծումս	Possession
սխտորի	յոգուրտներին	Case
միեղջյուրներիցդ	թաթուլներովս	Number
ասպանդակով	լիրը	Number
սալորենիներդ	ցանկապատովդ	Possession
տառապի	կբարբառենք	Tense
ապառքիցս	առզելովդ	Number
նվազներովդ	խորթդ	Possession
կծուլանաք	չարաշահի	Tense
կեչուտիդ	ալեմաներենս	Number
տես	ուզեցի	Tense
արտասահմանցուցս	հայրատներիցդ	Case
թափվող	թափվի	lemma
ամպարներումդ	հաճախությունում	Case
կպահածոյանայի	չծլարձակեն	Tense
չխոստացա	զեղծ	Tense
չապահովվեց	կռիսովս	Number
արսեն	մզկիթներ	Case
օդապարիկդ	սուպերմարկետներովդ	Possession
բացականչումիցդ	թարխանաներդ	Possession
ցերեկույթներս	սառույցումս	Possession
ասպազեններ	աբսուրդը	Case
ծովատառեխներումս	ծափահարմանս	Possession
շենք	փաստեր	Case
սիբիրախտովս	փայտածխիդ	Number
չկռնչեն	կկանխամտածեմ	Tense
վավերագրականիս	թավաներս	Possession
գրգռ	հավելեցինք	Tense
խռմփանք	կբաղխի	Tense
մասրենուցս	ծախերիցդ	Case
տժվժիկի	նունուֆարներիդ	Case
չքցի	քցեիր	lemma
շտկեցինք	զեղծ	Tense
փորձեիր	կբխենք	Tense
մահմեդականներ	աբսուրդը	Case
աֆարերենը	ըմպակներդ	Case
այծերս	դանիականիս	Possession
չգործարկի	կորնչեց	Person
կուռեն	ունկնդրեմ	Tense
երկնչոտով	չբդկես	Number
քաջալերություններիցդ	կարծրերովս	Number
ծառայող	ծառայեցին	lemma
լաոսերենիդ	ճոճաթոռներին	Case
չստեք	կստի	lemma
արսեն	նախաճաշեր	Case
թթվի	ինքնավարների	Case
հուսահատեցնեիք	սիգացիք	Person
արդուկեք	չսիրուեցիք	Person
չածեք	կածի	lemma
կշտկեր	չզգենաք	Tense
միկրոօրգանիզմից	սկալդդ	Number
արդյունքը	ֆոտոնայինիցս	Number
կմերձենայիք	խոպոպեցնեմ	Tense
ախտորոշեմ	կմտմտան	Tense
կղբենիները	նախադասությունս	Case
գոհանային	կաղարտեմ	Tense
ծծիցդ	պրոլետարներիցս	Case
կողպեր	կողպեն	lemma
պարտատոմսերիդ	կուրծի	Case
կարտոֆիլը	փաստեր	Case
չպատառած	չպատառեմ	lemma
այլեւայլից	չշիկանաս	Number
հատապտղում	փայտածխիդ	Number
անվճռականություններումդ	խոպոպավորիդ	Possession
չկարեկցես	կկարեկցեիք	lemma
ինդիումներիցս	կաղկանձիցդ	Case
նանիներովդ	ձախիդ	Possession
գեղջուկիդ	աքերիս	Case
չհարեիք	կխածի	Tense
հասցնենք	կփութացնի	Tense
որորներից	գանգրափնջիցս	Case
ընտրվող	ընտրվի	lemma
ամբարտավանանաք	կսաղանայի	Tense
նենգի	ռեստորաններիս	Case
ցերիումը	աբուռներ	Case
խորխելիք	չխորխեցիր	lemma
ամորձուցս	ջանավարներս	Possession
չփոխարինեցիր	առողջացր	Tense
դելփինիս	ինքնավարների	Case
ծնծղայիցդ	ունիվերմագներից	Case
չկախարդեմ	գանգրվեցի	Person
անկվածներիդ	կչվեինք	Number
կթռնեք	պագեի	Tense
սիբիրախտերումս	ջրկոտեմում	Case
ցանկություններովդ	տոհմածառերը	Number
լաչառներովդ	լիգայումդ	Possession
գնոստիցիզմ	սպունգներդ	Case
անհանգստանանք	կփութացնի	Tense
սսկվեցին	եփեն	Person
ապահովեցնեիր	կկաշառենք	Tense
բիզնեսդ	խմածներիդ	Possession
կչորանայիք	ընկճեմ	Tense
թվահմայությունիցս	տանուտերերից	Case
ամուսնություններովս	փայտեղենիս	Possession
չերկբայեն	կքերծեիր	Tense
ափիոնիցս	խտղտանքներիցդ	Case
հոտոտեի	լուվերենում	Number
քեֆերին	դուզեր	Number
վերուվարներից	չափածոներումս	Number
շարունակ	տառապեցրեց	Tense
կշիջուցանեք	չհամբուրի	Tense
լաստենիդ	եկեղեցականներ	Case
պարաբոլիս	պիստակներին	Case
փախլավան	եկեղեցականներ	Case
չվեմ	չերկայնեցի	Person
արգելիցդ	որմնախորշերիցս	Case
կիսող	կիսի	lemma
ձախլիկ	ծովափղերը	Case
Թութունճեանին	գեղմերիս	Case
գգվեիք	կփութացնի	Tense
գեյզերս	վերջնախաղերը	Case
հարբենաս	ընտրվեցիր	Person
սխտորի	օգտագործումների	Case
պատվանդաններդ	աղջությունս	Case
կհեծեծենք	չբարեւեիր	Tense
օսմանցուցս	ամրոցներս	Possession
կողպեքներիցդ	վարշամակիդ	Possession
կգրադարձի	կեղտոտեիք	Tense
չքարշեցի	հագնեմ	Person
գլի	չմեկնեց	Person
ածանցդ	շնորհներիցդ	Possession
ափիոնիցս	ծախերիցդ	Case
եպերներովդ	վզանների	Number
բժշկումդ	իշղարներիդ	Possession
սվիտերներիցս	ճագարովս	Possession
ծածանեիք	դատապարտեցիք	Person
բուսաբաններիդ	ռազմի	Case
իրականներից	բաոբաբիցս	Case
երկիմաստներ	երկիմաստովդ	lemma
կատակագուսաններ	խորդս	Case
կոմսը	մզկիթներ	Case
մատյանիցս	կնյուններիս	Possession
կսփոփվեմ	սրճեց	Number
կախակապումդ	ոլորուններումս	Case
չդրսեւորվի	դրսեւորվեիր	lemma
մարսողությունը	անվճռականներ	Case
փութաջաններ	կհարսնացնենք	Number
կհղենանք	ձգտի	Tense
համբուրվեցիր	գիշատես	Person
ծծիցդ	արծվիներիցս	Case
կկարողանանք	կկարողանաս	lemma
բոցով	ինքնավարումս	Number
բրիչովս	էջի	Number
մեղքերումս	արթունս	Possession
կարեր	կարեն	lemma
նվագախմբերումդ	նազովդ	Possession
կենդանավետներով	կենդանավետներում	lemma
ամբարտավանանաք	կամբարտավանի	Tense
անդրկովկասցունս	կծանուցեք	Number
լաստենիդ	գիսակներս	Case
ոսկեղենդ	մալթայերենները	Case
չկթեմ	կսրտառեիք	Tense
արյունաքամներով	արյունաքամովդ	lemma
երկնչոտով	արքայախնձոր	Number
լոգացի՛ր	չտպեցիր	Person
չսահմանեք	կկարողանայի	Tense
էրեկվանից	պլատինդ	Number
հորդորանքներս	մեքսիկդ	Case
պոռոտախոսս	ֆրանսերեններդ	Case
չբեկտեինք	բեկտե՛ք	lemma
գեջերումս	տուբերկուլյոզս	Possession
արդյունքների	հերվան	Case
ինդոնեզերենովս	վերմիշելներումս	Possession
խալ	թաթում	Number
արծաթներից	ծաղկակաղամբներս	Number
հոկտեմբերյաններումս	որձաքարիս	Possession
հիմնավորե՛ք	խավարասերներից	Number
կախարդվածությամբդ	հիդրոլիզներիդ	Possession
պղինձներ	օտարոտիներովս	Number
ընգե՛ք	կհայտարարեք	Person
խորակիցդ	նախաճաշի	Number
կշարունակի	քերծեք	Tense
չանհանգստանայինք	անհանգստացե՛ք	lemma
կախակապերումս	բումերանգովս	Possession
հաղթի	կղմինդրների	Case
կքննարկենք	նախաճաշի	Tense
մեղկացան	չբղավեին	Person
գորշավունիս	ջրանցքներս	Possession
զավտրիկդ	մռայլներիցդ	Possession
ջազվեներիս	հնդեվրոպաբանիցս	Possession
կլողանամ	չլափեին	Tense
թլփատեցիր	գիշատես	Person
մոշիներիցդ	կոնքիցս	Case
պեդալներ	հունվարներումդ	Number
հափշտակումներդ	պնակ	Case
բաժանումովս	կկարենայի	Number
եղծանի՛ր	եղծանում	lemma
կշեշտեք	չհպարտանայի	Tense
դիսպաշերով	մարտահրավեր	Number
արձակուրդ	աբուռներ	Case
արտեւանունքովս	շորերումս	Possession
ապառքիցս	գահույքում	Number
մացառուտիցս	տանուտերերից	Case
հրաշակերտներովդ	խտիղների	Number
կսփոփվեմ	թեորեմից	Number
քաքեցիր	քաքեին	lemma
թեկնածուներին	օղակիս	Case
գանգրամազներովս	սերբերեններդ	Number
խոհեմներդ	էլեկտրոն	Case
ծափահարվեն	կխոցեիր	Tense
չկանչեցիր	նպաստի՛ր	Person
օգոստոսյանների	շաուրմայի	Case
անհույսումդ	ակորդեոններում	Case
վախկոտից	վախկոտը	lemma
մաքրող	մաքրի	lemma
պրոթեզներումդ	ազերիդ	Possession
վհատությունում	բացառիկներումս	Case
տանձերիցդ	տանձերիդ	lemma
չլքնի	կարկեինք	Tense
երկայնանայիր	կբխենք	Tense
միեղջյուրներիցդ	պետերը	Number
չպատկանեմ	պատկաներ	lemma
նեխեց	կխոպոպանար	Person
կվիճաբանես	ագուցավորեն	Tense
չբեկտած	չբեկտեմ	lemma
բաղձանքի	ձառերի	Case
նվագես	խալիս	Number
պեդալներ	պատառներումդ	Number
անվճռականություններումդ	աղվանիդ	Possession
չկոշկոճեք	կկոշկոճի	lemma
ճանդանովդ	ծերուններիցդ	Possession
պտղատուներդ	ճոռոմախոսություններումս	Number
փսխեց	նեղաց	Tense
թրթուրներումդ	նորվեգերենումս	Case
մասրենուցս	հռոմեականներից	Case
վերուվարներից	խտիղների	Number
հիր	չգեղգեղեցիր	Tense
աղավաղեն	կտշես	Tense
մեռելոտի	մեծատառովս	Number
աչերիցս	ուռենովս	Possession
ղեկավարությունների	անհեթեթին	Case
խանծերիցդ	լրատուիդ	Possession
գոչեր	կաճեցնենք	Tense
զոդող	զոդի	lemma
արեգակնային	ջերմուկներ	Case
ասպազեններ	թլփատություն	Case
կվարեք	չառկայծեի	Tense
բնորոշե՛ք	կլեպները	Number
խորտիկիդ	ջերմերովդ	Possession
քառյակը	եկեղեցականներ	Case
չագուցվեն	կկործանես	Tense
մարսողությունը	օդերեւութաբանականներս	Case
ձարխոտեր	խլություններում	Number
գեղջուկիդ	գուղձերի	Case
պարանիս	ճոճաթոռներին	Case
կագուցանենք	չսգար	Tense
չառողջացնեիք	կկանխամտածեմ	Tense
կալեիր	նվագեցիր	Person
հայեցակարգիցս	չաքուչներովս	Possession
կուսաթաղանթը	համաներումներ	Case
չխածանեին	խածանելիս	lemma
ապահովեցիք	չհառաչեք	Person
չընտրվեք	կընտրվի	lemma
բնակվելիք	չբնակվեցիր	lemma
աղավաղեն	կկախեի	Tense
ֆրիզերեններին	չբուսանեցին	Number
նարտովդ	քյանդրբազություններիցդ	Possession
նարտովդ	բրդյաներդ	Possession
հատուներիս	ճապոներենին	Case
խճուղիների	առիթի	Case
կհարկաներ	կորնչեց	Person
հերոսությանը	դատողություններիդ	Case
հապավմանը	նունուֆարներիդ	Case
կմատուցեինք	բացահայտներով	Number
կարծեիք	անորոշներդ	Number
կայսրությանդ	լոուրենսիումներովդ	Possession
քվեարկողիդ	հարսնապարերի	Case
պորտապարում	պոռոչագիններումդ	Case
պոռոչեմ	կգնահատեին	Tense
կտակը	անվճռականներ	Case
հրվանդանի	վաստակներին	Case
սրճենիներ	չերկայնեին	Number
հյուս	չտենչացիք	Tense
հիասթափություններովդ	շղթաներս	Number
կսիրվեք	սիգացիք	Person
չբարելավենք	կզոդի	Tense
տաջիկներիցդ	առակախոսովդ	Possession
չգործարկի	հեծավ	Person
ստիպեցիր	ընդարմանայիր	Person
սուջուխներդ	օյինբազս	Case
միկրոօրգանիզմից	տագալոգ	Number
չբարելավենք	կբաղխի	Tense
տիք	մոլեգնեցի	Number
անապեստիցս	ամբարտակներումս	Possession
դրվատեին	թաթուլներովս	Number
կագուցանենք	չաբսորբի	Tense
կմատուցեինք	խտիղների	Number
չտառադարձես	կախտորոշենք	Tense
ընթրիքով	կայսերապաշտին	Number
մղձուկներիդ	բախչադ	Possession
չմալեցիր	կմալես	lemma
կվարցիտների	տոռնիս	Case
աթեիզմիս	խաչակիրներիդ	Case
հմուտովս	կողպէքներս	Possession
սպիտակամորթս	ըմպակներդ	Case
շրջահայացիցդ	ունակներից	Case
ավելացնեինք	չվարանեցինք	Person
կախակապերումս	մարոժնիս	Possession
կագուցանենք	չարյունահոսես	Tense
ցունամիների	անհեթեթին	Case
տխմարները	խորդս	Case
հազիդ	ղազերի	Case
մետաքսեում	թանաքս	Number
չերկկտտացնեմ	երկկտտացներ	lemma
հրվանդանի	ագրեսիվներիս	Case
լիբրետոներիս	բիզոնս	Possession
չկաղկանձեցինք	հեռացնենք	Person
պահապանիս	նունուֆարներիդ	Case
չխրոխտար	կանխեց	Person
ցեղասպանություններից	բարբարոսներովդ	Number
վիրաբուժությունովս	գլխատառերիցս	Possession
կաշկանդից	արծվիներիցս	Case
կուռչես	ուռչի՛ր	lemma
զուլուումս	անձեռոցիկներում	Case
հոխորտային	հոխորտացինք	lemma
հղիովս	չաղոներս	Possession
տիեզերագնացների	կռվեցին	Number
ապուխտում	կոտորներումդ	Case
կշիկնենք	կշիկնես	lemma
չխնամեն	խնամեցիք	lemma
ռացիոնալներովդ	հոգնածությամբդ	Possession
վայրումդ	քալամներիդ	Possession
առհավատչեքներիցդ	գրատախտակդ	Possession
կխանձատեմ	չցտեցի	Person
նվազներովդ	պսակիցդ	Possession
նորվեգերենի	բարձրավանդակներիս	Case
յուաններով	մշակույթներիս	Number
մկնիկդ	մինարեթում	Number
տատիկ	աբստրակտներս	Case
չընդգծի	քերծեց	Person
չապահովվեց	մսագործովդ	Number
նորվեգերենի	մեծաշիթներին	Case
սսկվեցին	հեգնեն	Person
հացահատիկումս	վիկինգովդ	Number
փարթիովս	սխտորներումս	Possession
զայրուցների	նոճերիցս	Number
եպիսկոպոսներով	կպոռոտաբանեիք	Number
սուպերմարկետդ	պատրաստություններումդ	Possession
կամացիցդ	նախաճաշի	Number
թամադաներիցդ	թամադաներիդ	lemma
ջեբիդ	ինդիումներիս	Case
աթեիստներիցդ	բորբոքիցս	Case
սրճարանատերերիդ	կշիջուցանեիք	Number
հալումաշովդ	երախտիքներիդ	Possession
չակնածեք	կզոդի	Tense
մեռելոտի	երիկամունքիդ	Number
տուժվեիր	կհորջորջենք	Tense
լիզեցիր	հորդորի՛ր	Person
օծիցդ	գաղափարում	Number
կեպերեի	լրտեսդ	Number
չխոստանաք	կկատարեր	Tense
սիկտիրվե՛ք	խավարասերներից	Number
կուրումս	պանդոկներիս	Possession
անուրջներիցս	պայմանագրից	Case
կկիզեիք	շռեմ	Tense
կոստղաշատս	խրոխտություններդ	Case
լուծեցինք	չհղփանանք	Person
տունդրաներս	կովլակիցս	Possession
չթափվեցին	հեգեն	Person
սանտիմետրիցս	ժխտականներովս	Possession
ճմռե՛ք	չսաղանայիք	Person
չաբսորբեցիք	քչքչաց	Tense
մահմեդականներով	կփարվեինք	Number
ճոպանովս	մթարներս	Possession
փորի	պոռոտախոսեց	Person
չհայցի	կճախրեիք	Tense
լոգացաք	տաղտկացե՛ք	Person
չգնացող	չերթայիք	lemma
չխոպոպանան	ուսումնասիրեցին	Person
թերասնում	կարեկցությունները	Case
կհալածեք	չաբսորբի	Tense
խոնավավունիս	կոստղովդ	Number
կորոճաք	կալեմ	Tense
նշանաբաններ	ակնածալիցդ	Case
կէթամ	չտանջեին	Tense
աղարտեիք	չաղարտեցիք	lemma
մամուխիցս	խաչքարերիցդ	Case
դրսեւորենք	կհղփանայիր	Tense
ատաղձագործներովդ	չհամակարգեցին	Number
պլաստիկներիցս	բազազովս	Possession
սխտորի	ներարկիչների	Case
կարկանդակ	գնդակահարություններ	Case
ճանճերդ	լատվիերենումդ	Possession
լուսնումս	խորանարդներիս	Possession
չնիրհեցի	գոգ	Tense
ոլորանս	անվճռականներ	Case
կաղկանձենք	կբաղխի	Tense
ձայնարկություններիցս	պայմանագրից	Case
չկախարդվեցիր	սպերմատոզոիդիդ	Number
ֆալիսկերենի	կկարենայի	Number
շուշմայում	հեստապարովս	Number
կքաղցեմ	չտանջեին	Tense
վայրդ	պարտեզներս	Case
գոնադովս	աղիքներումս	Possession
առհավատչեքներիցդ	սիլիցիումիդ	Possession
հատապտղում	ճաճանչը	Number
փափախներիդ	տոհմածառերը	Number
շարունակ	ընթեռնեցի	Tense
մեծամիտներ	մեծամիտովդ	lemma
ավարերեններից	հելլենացուցդ	Case
քաղեցիր	չբարբանջես	Person
հոտոտեի	ունայնությունում	Number
քրոմներումդ	նիդեռլանդացիներին	Number
քանդակներ	թլփատություն	Case
լքնեի	կբզզաք	Tense
սվին	ալեկոծիս	Number
կբզզամ	խօսէք	Tense
կպայմանավորվեն	չառկայծեի	Tense
սուջուխներին	սեւականի	Case
չհարեիք	կկանխամտածեմ	Tense
հորդորանքներս	կետչուպ	Case
քաոսայինումդ	փարթամագեղներում	Case
կամեց	կամենաք	lemma
ցինկս	կարագները	Case
սուրահին	ինքնավարների	Case
սալորենիներդ	մրեժովդ	Possession
հնգամյաս	հայկականները	Case
կամարդ	նորվեգերեններումդ	Possession
չգոռային	կապուտները	Number
բողովդ	կուրսերդ	Possession
հյուս	չգնեցինք	Tense
լյարդի	նունուֆարներիդ	Case
գլխացավերիցդ	գլխացավերիդ	lemma
բոցով	գործիք	Number
չտարածեցի	կանիծեի	Person
հալումաշովդ	գրողներդ	Possession
խաշ	ծովափղերը	Case
մղմուղիցդ	խեչակներիցս	Case
կդարբնեք	ընկճեմ	Tense
վաշտիցս	խազի՛ր	Number
մեծությանը	երկաթգծում	Number
կփսխես	փսխի՛ր	lemma
փորի	չհոգաց	Person
մարտակառքի	ամորձիքներիս	Case
չարորեցինք	քամենք	Person
ցունամիների	մեխակիդ	Case
ակնածելիներին	թարխանությանս	Case
քեներիցդ	ձախիդ	Possession
ֆարերցուդ	օսեթերեններդ	Possession
կպատկերես	չճկեցիր	Person
կտակը	բորշչերդ	Case
չլուծեցինք	հատուցենք	Person
կզրնգայիք	հոտե՛ք	Person
նախարարին	ինքնավարների	Case
կծաղրեինք	չդարբնեցինք	Person
բրետոներեններիդ	չերկայնեին	Number
իրիդիումներդ	էլեկտրոն	Case
արուիդ	թեորեմից	Number
կրծքանշաններովդ	ուտելիքները	Number
եփեինք	լիտվաներեններիցս	Number
բոկից	բոկերին	lemma
պարտատոմսերիդ	վախկոտին	Case
համովներից	չմատնեք	Number
հարբածներս	ըղձականովս	Possession
քիմքը	ատակիս	Number
արսեն	հայկականները	Case
ղեկավարությունների	շաուրմայի	Case
քանդակներ	գինարբուքս	Case
հրշեջովս	հրշեջներիցդ	lemma
խիթաք	ավանդե՛ք	Person
դեղատներից	լիսեռից	Case
տխմարները	մեքսիկդ	Case
արեւմտյանիցդ	հավելվածներումդ	Possession
համբարձումներս	պլուզումս	Possession
թորիծ	փույթիցդ	Number
ջեռուցեցինք	հոգայինք	Person
մոլուցքներիցս	մարոժնիս	Possession
սամարիումներում	կշիջուցանեիք	Number
դալուկովս	թավաներս	Possession
հարցմանդ	շամպայնովս	Number
մտաբերեցի	չհոլանեի	Person
կթաղեն	տիեզերագնացներիս	Number
ձարխոտեր	գեղեցիկներումդ	Number
կասկածներում	կոմբայնումդ	Case
վաճառականումդ	բնակչությամբ	Number
կեպերենք	չգոգես	Tense
հացահատիկումս	սիրուհուդ	Number
կէթամ	չքաքեք	Tense
հմայենք	կթոթովեիր	Tense
կհուսալքես	նվագեցիր	Person
օժանդակեր	օժանդակեն	lemma
կորոճաք	չվերադառնամ	Tense
գոմաղբից	դելֆիններիցդ	Case
կատիոնումս	խոյերս	Possession
պառկեցիր	քչքչաց	Tense
լաոսերենիդ	պատկերասրահներին	Case
ոլորներումդ	ընդարձակիցդ	Possession
ծուռմուռներ	ընթրիքներիցդ	Number
բացականերովդ	ղափամաներիս	Number
չըղձաք	կավելացներ	Tense
նոճերումդ	կանաչազարդովդ	Possession
կհղեի	երկմտեք	Tense
կվրդովեին	սկզբնագրերում	Number
աժդահայիցդ	ունակներից	Case
ճմռե՛ք	չանիծեք	Person
հետազոտեցի	կեպերեի	Person
արշալույսումս	պոռոչագիններումդ	Case
հեռացնող	հեռացրին	lemma
մահմեդականներով	խտիղների	Number
ճոռոմախոս	ճոռոմախոսեք	lemma
հարգանքներիցս	չափագիտությանս	Possession
կայաններովս	պյուռոսյաններում	Number
մոդեմի	կղմինդրների	Case
խիտերը	օտարոտիներովս	Number
չհատեինք	հատե՛ք	lemma
վայրդ	փաստեր	Case
հափշտակումներդ	աբսուրդը	Case
գլխատառիս	պողովատիցդ	Number
խեթկեցիր	խեթկեին	lemma
կգլտորես	հողեղենովս	Number
չհիասթափվեն	հիասթափվեցիք	lemma
ամբարտավանանաք	կկախեի	Tense
աջարացին	պարտեզներս	Case
թորիծ	կոկաինիս	Number
չապացուցվեցիր	կծնեիր	Person
շփոթմունքը	սեքսիզմումս	Number
քվարցներս	բունոցիցս	Possession
համովիս	երկսայրիներիդ	Case
ամորձատեցինք	ընթրիքներիցդ	Number
բնույթից	ստադիոններիցս	Case
ջազվեներիս	բունոցիցս	Possession
կխոչընդոտեին	չարյունահոսես	Tense
գահավանդովդ	թաթում	Number
կյուրիումս	ազգանուններ	Case
կոտրի՛ր	կոտրում	lemma
նիրհովդ	մոլեգնեցի	Number
կմարթեիր	չփրթեցիր	Person
չկոշկոճեցի	ճամփորդեի	Person
ասպազեններ	հովազ	Case
գառնենիների	նիդեռլանդերենիս	Case
չընգնեք	կընգնի	lemma
պույտիդ	ճաճանչը	Number
շփոթեցին	կերդվեին	Person
կշփեի	գանգրվեցի	Person
լերդերովս	տգետները	Number
հռետորաբանություններ	հողակոշտ	Case
կհղեի	չջղայնացնեք	Tense
եկերդ	թեորեմիցդ	Possession
թխկուց	հայրատներիցդ	Case
ասքերովս	լահմաջոս	Possession
շառլատանս	կռինչներովս	Possession
մոդայումս	ճաքերում	Case
լյարդի	թացերին	Case
ըղձա՛	մյուոնում	Number
չգլորեք	կգլորի	lemma
կիմերի	կհալածես	Number
թեորեմիցդ	մոլեգնեցի	Number
քոշից	թեներից	Case
հոլդ	ձախողներիդ	Possession
հարբածներս	ափսոսովս	Possession
անօդաչուումս	ամրոցներս	Possession
չկախարդվեցիր	դեղաբույսովդ	Number
հունարեններովդ	անորոշները	Number
աղորիքներովդ	ոստանիկներովս	Number
ցունամիների	պուճուրին	Case
կահագնանաք	հարցազրույցներումդ	Number
սեւիդ	ինդիումներիս	Case
կաշկանդեմ	կկողպեիք	Tense
վիետնամերենից	վիետնամերեններդ	lemma
հնարքներումդ	այրուձիովդ	Possession
կախակապերումս	բանակցությամբս	Possession
սվին	միացար	Number
կայուններովս	ֆրանսերենս	Possession
տեղյակիցս	սաղմոններումս	Possession
կոլգոտկայիս	գուղձերի	Case
արտեւանունքովս	սաղմոններումս	Possession
սեւամորթիցդ	չվերթներից	Case
չհելնեին	խածեցին	Person
հեւքերում	օրթախներովս	Number
տարվող	տարվեցին	lemma
ժամկոչներիդ	գրչատուփիցդ	Possession
մալայերենիս	նժույգների	Case
չքարշեին	սառեցին	Person
մրցավարով	փույթիցդ	Number
փոխանակությանս	գուղձերի	Case
այրուկովս	ձեւույթներս	Possession
վերագրեիր	կապացուցեն	Tense
ուժեղանա	չմեկնեց	Person
տուկանիցդ	կոստներ	Number
նազեցինք	գոգ	Tense
անհանգստանանք	կճմլեիր	Tense
կպահածոյացնենք	տեղեկանայիր	Tense
աղեղնավորս	նմաններիցս	Possession
քայլ	քայլեք	lemma
կաշկանդիդ	ներարկիչների	Case
հապաղիցս	կարտերիս	Possession
սուսերամարտդ	հողմերս	Case
բուժումներից	գոչյունիցս	Case
գնոստիցիզմ	պոռոտախոսություններ	Case
հուլունքներիդ	անթերիիցդ	Possession
ցինկովս	խորովածում	Number
ուրուկներիցդ	դուզնաքյաներով	Number
ամբոխներումս	հունավորովս	Possession
շինարարներիցդ	սոուսիցս	Case
զրնգային	զրնգացինք	lemma
կուսաթաղանթը	ֆրանսերեններդ	Case
քենակալները	ուզբեկերեններովս	Number
անձնավորներիցդ	կհարսնացնենք	Number
չկաղկանձեցինք	հոգայինք	Person
ցեծերիցդ	պարսկականիդ	Possession
փականներումս	հունարենումդ	Case
սուրահին	նժդեհներիս	Case
կբողոքարկեին	չկիզես	Tense
կոկոսյանումդ	բեռնյաններովդ	Possession
պագնեիք	գանգրացե՛ք	Person
կսավառնի	քամեց	Person
հոլդ	մետաղագործություններիդ	Possession
ավազուտներիցս	ավազուտներ	lemma
պաշտեիք	չպաշտեցիք	lemma
կկիզեիք	ունկնդրեմ	Tense
սարավանդակներին	հակասեմիտականությանդ	Case
չտրամադրեինք	կփքվես	Tense
հավատայի	գանգրվեցի	Person
համբերեմ	քարփիջին	Number
շուշմայում	կանխամտածեց	Number
խալ	տատին	Number
ցողուններովս	տապակովս	Possession
կոկոսյանումդ	ձախողներիդ	Possession
թովեք	կտարամիտեր	Tense
ջրհորովս	ամլիկը	Number
կանտոններս	լաստենովս	Possession
վիրակապերից	հանդիցդ	Case
տնօրեններովդ	անանուխիցդ	Possession
չվխտացիր	կվխտաս	lemma
փոխարինումների	աբսոլյուտի	Case
մակաշերտիցս	տանուտերերից	Case
մզկիթդ	խաղամոլներիցդ	Possession
կեղեցի	չփորձեի	Person
ինքնահավանումս	իշառվույտներիցս	Possession
կերերաս	մարկիզի	Number
կշիկնեն	խածեցին	Person
չբարելավենք	կշիկանայիր	Tense
դեղատներից	պայմանագրից	Case
քեներիցդ	տարեկանումդ	Possession
գուժումներ	էլեկտրոն	Case
ասպանդակով	վերակացուիդ	Number
կարիք	տգետին	Number
թվահմայությունիցս	բժշկություններից	Case
գաղափարագրերում	կոմբայնումդ	Case
կռվի՛ր	կռվում	lemma
կտարամիտես	հողդողդի՛ր	Person
կպատկերես	լկստի՛ր	Person
չմատուցեր	պոռոտախոսեց	Person
տասերորդից	թաքթաքուրումս	Number
չկերտեին	կերտեին	lemma
կանկանս	ղայիշներդ	Case
գլխագրիդ	չկաշառեց	Number
չհնացող	չհնանայիք	lemma
օսերենիդ	գրավիտոնում	Number
չշիջուցանենք	կապշեր	Tense
ազնավորներիդ	խոպոպացմանս	Case
կվարեք	չշիջուցանեի	Tense
հայցե՛ք	արմերով	Number
զառամյալից	զառամյալներին	lemma
սուսերամարտդ	կարեկցությունները	Case
ասորիներովս	չերկայնեին	Number
կռինչը	պարտեզներս	Case
տագալերենով	նվաղեց	Number
շփոթեցրիք	կճոռոմաբանեք	Person
չկողոպտեինք	կողոպտե՛ք	lemma
ղսմաթդ	ազգանուններ	Case
նանիներովդ	ծանրաբեռդ	Possession
կռինչը	սուզանավերդ	Case
սանտիմետրիցս	ձեւույթներս	Possession
հոտեն	կշիկանայիր	Tense
կծուլանաք	չզանգահարեի	Tense
ահաբեկվենք	կզգածվի	Tense
վաճառի՛ր	վաճառում	lemma
լաստենիդ	աբուռներ	Case
մոդեմի	գեղմերիս	Case
տեղյակիցս	ամրոցներս	Possession
ուրախացրո՛ւ	բավարարես	Person
կչափես	նպաստի՛ր	Person
բարբարոսովդ	գոճիներդ	Possession
չշշնջացի	խարխլեմ	Person
երեւելիումս	կնճիթովդ	Number
բեգեմոնդովդ	գնաճերդ	Possession
պրոլյուվիալովս	մահմեդական	Number
սրճարանատերերիդ	կհարսնացնենք	Number
ռացիոնալներովդ	պալայերենդ	Possession
ցնծացի	կապուտս	Number
լերդերովս	հումքերի	Number
ակոսիս	կաղճիններին	Case
ենթակայականից	սիկղերիցս	Case
հելնեինք	պուպուլներից	Number
ընկերքներ	հարցազրույցներումդ	Number
արխիվներիցդ	օրթախներովս	Number
վախի՛ր	վախում	lemma
մոշիներիցդ	գոչյունիցս	Case
չոռնա	կաճեցնենք	Tense
ցունամիների	կուղբիս	Case
տրցակաձեւներով	տրցակաձեւի	lemma
ջրհորովս	տգետին	Number
ջաներովս	սազեն	Number
միկրոօրգանիզմից	կվասին	Number
խանությանս	լավերի	Case
խանծերիցդ	կրումդ	Possession
գոռանք	կայծքարերում	Number
չօժանդակեցիր	կօժանդակես	lemma
իրիդիումներդ	վարկածս	Case
վաճառականումդ	կտեղեկանամ	Number
լրջանար	կկաշառենք	Tense
թեորեմիցդ	գաղտնիովս	Number
քանդակներ	ռեգգին	Case
չհոլանեիք	կխռմփացնեմ	Tense
չեփեիր	կլրթանանք	Tense
նախամայրերիդ	հոգնածությամբդ	Possession
ծլեն	սառեցին	Person
կնախընտրեիր	քելենք	Tense
հիր	կանչեց	Tense
կերակրեցիք	հեկտարներում	Number
կպայմանավորվեն	ապահովեի	Tense
ալպինիզմդ	թեքումներիդ	Possession
կմոլեգնես	մոլեգնի՛ր	lemma
շիկամկնիցս	խուլիգաններովս	Possession
կվարցիտների	առիթի	Case
չգոգեն	կտրցակեմ	Tense
կօժանդակեմ	հատակեիք	Tense
կայաններովս	պուպուլներից	Number
քիմքը	հղիով	Number
կստիպեի	չծլարձակեն	Tense
ֆոտոնումդ	օրանգուտաններդ	Possession
մրմնջացիր	կկանխամտածես	Person
արթնանա	կորնչեց	Person
պագերի	կուղբիս	Case
թաթուլովդ	մռայլներիցդ	Possession
տապիոկայիցդ	սաղավարտներովդ	Possession
գնահատեինք	չգնահատեցի	lemma
փոխարինումների	օղակիս	Case
պարմեզանդ	ճամփորդներ	Case
նանիցդ	լոլիկներովդ	Possession
մեծացե՛ք	կվերագրեիք	Person
ապուշից	ապուշներին	lemma
սպրիչ	պամիրյանից	Number
վոլֆրամովդ	բրդյաներդ	Possession
անվճռականություններումդ	բրդյայիցդ	Possession
ծանոթներ	որոշումը	Case
մսացուիցս	ունակներից	Case
կշփոթվեք	զատեի	Tense
փութացե՛ք	վերծանեք	Person
ժանիքներդ	վաղնջահայերենիցդ	Possession
կկշռադատես	վանադիումումդ	Number
տարակուսեիր	բեկտի՛ր	Person
նախուտեստներին	կռնակի	Case
կհպարտանաք	չքայլեցիք	Person
կվարցիտների	բորշչիս	Case
փոխարինումների	հռովմայեցուդ	Case
նենգի	պատկերասրահներին	Case
սխտորի	հոբելյարներին	Case
կմատուցեինք	խլություններում	Number
ընգե՛ք	խօսէիք	Person
խմբագրեց	խմբագրի	lemma
մեծահանդեսներովդ	գերանդուցդ	Possession
հողեղենդ	չշիկանաս	Number
կհուզես	չնախաճաշենք	Tense
ֆոտոնումդ	շտանգաներիդ	Possession
արծաթներից	կչվեինք	Number
էգերով	էգիս	lemma
չապահովվեց	հալվայից	Number
կենտումդ	դանդաղկոտներիցդ	Possession
վայրումդ	թեքումներիդ	Possession
մեծաբանությունումդ	պարտեզներդ	Possession
չերկնչի	կներքինանանք	Tense
ակոսիս	մարդելույզների	Case
իրավից	դելֆիններիցդ	Case
ախտորոշեմ	կբդկեիք	Tense
չքանդեմ	քանդեր	lemma
նախածանցները	երգչուհիդ	Case
լաստենիներումս	ոսկեծաղկիս	Possession
հիասթափվի՛ր	կխուզես	Person
ջեռուցեցինք	քարշենք	Person
հոյաշենովս	ջաներիցս	Possession
գլխագրիդ	գաղտնիովս	Number
ընդգծեց	ընդգծի	lemma
բրիտանականումդ	սաղարթներում	Case
աքիլլեսյաններիս	ծիծառնուկին	Case
կիվին	ջերմուկներ	Case
ժանտափշերումս	շիվումդ	Case
հնախոսներիցդ	ներողությանդ	Possession
վայրդ	նիզակներս	Case
ենթակայականից	ունիվերմագներից	Case
չշնչեք	գանգրացե՛ք	Person
բրետոներեններիդ	գորտնուկներովս	Number
չպառկեր	կաներկյուղանանք	Tense
կազմերիս	կարեկցությանդ	Case
պեդալներ	պատառներով	Number
ըմպեք	գովե՛ք	Person
կլողանամ	ագուցավորեն	Tense
քեներիցդ	պալայերենդ	Possession
լումաներս	վզանների	Number
չմուրացին	քչքչաց	Tense
չլուծեցինք	կգոհանայինք	Person
հմայենք	կխռթայիր	Tense
հառաչալիներից	ճնշումիցս	Case
օգոստոսյաններիցդ	ձախից	Case
երկմտեցիր	համակարգ	Tense
կաշկանդեմ	կզոդեք	Tense
կբարբառի	մօտեցաւ	Person
սիբիրախտովս	կհալածես	Number
փոխարինումների	երշիկիս	Case
քանդակներ	սղոցս	Case
կարտոֆիլը	սուզանավերդ	Case
կգլդորեմ	չլափեին	Tense
պոռոչեմ	կքելեք	Tense
բռնաբարեցին	չհագնվեն	Person
կրաքարի	արտագաղթերի	Case
սավառնե՛ք	կողբայիք	Person
վերուվարներից	չցնծաք	Number
չկանխենք	ոստանիկներովս	Number
չմայեցի	առողջացր	Tense
նվազներովդ	հոգնածությամբդ	Possession
լվացքատներումս	անձրեւում	Case
փայլունացվ	փայլունացվեք	lemma
կախակապերումս	ծովահենս	Possession
չգովեինք	կկազմակերպի	Tense
պատմվածքդ	կակալաներիդ	Possession
կփլվեն	մղես	Tense
ձգտեին	ձգտեցինք	lemma
կմարթեիր	ջղայնացրիր	Person
եպերեինք	կկիսես	Tense
պղինձներ	պյուռոսյաններում	Number
կահագնանաք	ուտելիքները	Number
չկարենան	կարեցաք	lemma
չսաղացանք	կգոհանայինք	Person
խաժիդ	նանաներիս	Case
ռուբլում	ցիկլոններումդ	Case
կիբեռնետիկան	գնդակահարություններ	Case
ծիծաղացող	ծիծաղա	lemma
կսկիծումս	խիզախներս	Possession
քվարկներիս	տաջիկերենումս	Possession
մտաբերեցի	խարխլեմ	Person
ընկերքներ	չորոճայիք	Number
շերեփներումդ	վաղնջահայերենիցդ	Possession
կոնյակ	խրոխտություններդ	Case
չվեմ	չախտորոշեցի	Person
հորովելովդ	նախաճաշի	Number
նախապայմաններովդ	ուժեղանայիք	Number
տես	բլբլացիր	Tense
գրազներիցդ	պոռոտդ	Possession
ուրախացրո՛ւ	չերթայիր	Person
օսմանցուցս	արգանդափողերս	Possession
դատողություններիս	ճահճումս	Possession
հողեղենդ	աղբերակովս	Number
սնուցմամբ	չբդկես	Number
կծվերումս	նախաբազկիցս	Possession
չնվագեցին	կհոտեին	Person
թեղոշներում	ծայրերդ	Number
պահապանից	թոխորը	Number
ֆերմիոնիդ	խաղամոլներիցդ	Possession
կգուրգուրայի	չհամոզեն	Tense
հորջորջներիս	սառույցումս	Possession
ռուսիցս	կհալածես	Number
սխտորին	կիզանուտում	Number
աշտեներդ	ուշունցս	Case
կբացականչեինք	չաբսորբի	Tense
կհարկադրեիր	հողդողդի՛ր	Person
կլիզես	չսորացիր	Person
գուժումներ	ենիչարին	Case
էլեկտրոլիզիցդ	պարտեզներդ	Possession
ապիկներիցդ	պիցցադ	Possession
տպիչից	սիկղերիցս	Case
կտշես	բեկտի՛ր	Person
կռացող	կռացան	lemma
չհեգնեն	սառեցին	Person
լումաներս	պլոճիկներումդ	Number
ձուլող	ձուլեցին	lemma
ջրաղացներիդ	պիցցադ	Possession
ասորիներովս	ղեկավարություններդ	Number
պիլասոսիցդ	ժպիտներիցս	Case
կխրտնեմ	չծնեք	Tense
կկաշկանդենք	սրտաշարժի	Tense
խնամներից	կացարաններիս	Number
գործարկեցինք	չվանեինք	Person
ծանուցումը	ծանուցման	lemma
չմահանա	մօտեցաւ	Person
ադամանդներից	կտրոնից	Case
անսովորներիցս	ածանցումս	Possession
ջրաղացը	մզկիթներ	Case
մատյանիցս	խիզախներս	Possession
չերկնչի	կհրճվեիք	Tense
օդաչուներիցդ	գտածոյիդ	Possession
չերկնչի	կկաշառենք	Tense
կաշկանդից	չվերթներից	Case
կհուսալքես	թոռոմի՛ր	Person
գանգրիկի	մոլեգնեցի	Number
խաժիդ	ղազերի	Case
բորբոքեց	բորբոքի	lemma
կխոպոպացվես	չսրտառենք	Tense
ճանապարհորդիցդ	խորանարդովս	Number
հովիտս	ձկնաբանականներովս	Possession
գովի	քերծեց	Person
սումոյիցս	դարպասապահներս	Possession
կծիծաղայինք	գոհացանք	Person
չոռնա	կհրճվեիք	Tense
մամուխիցս	ավելուկներիցդ	Case
կերկմտես	երկմտի՛ր	lemma
կողպեինք	չկողպեցի	lemma
կազմերիս	պուճուրին	Case
գնոստիցիզմ	ջերմուկներ	Case
բեգեմոնդովդ	գրողներդ	Possession
աշխարհամասերին	քաբաբիս	Case
փտի	կանխեց	Person
հյուս	ճմռթեց	Tense
ծնեիր	չսորացիր	Person
չկանչեցիր	կխուզես	Person
ստիպեցիր	կահագնանաս	Person
կշեշտեք	կարմրանար	Tense
հուլունքներիդ	լոժբանումդ	Possession
թորիծ	թեորեմից	Number
ջերմաչափներիս	տաքավունս	Possession
կգրադարձեմ	կալնեք	Tense
չփչեիր	կլանեցիր	Person
կբզզամ	չճոռոմախոսեն	Tense
կամացներդ	սկզբնագրերում	Number
տժվժիկի	լավերի	Case
անդրկովկասցիներիցդ	տարեկանումդ	Possession
չանցգայացա	հորջորջեմ	Person
չկաղկանձեցինք	կգոհանայինք	Person
ավտոբուսս	կարագները	Case
հավաքածոյումդ	չինականներումս	Case
հաղթերով	հաղթի	lemma
այրուկովս	դարպասապահներս	Possession
խճողները	խոլորձներումդ	Number
ժանգոտ	պնչումդ	Number
կարտասվեին	չթլվատեցին	Person
կարտոֆիլը	աբստրակտներս	Case
գնեն	կուռչեի	Tense
պուպուլիցս	քառակուսիներովս	Possession
քչիցդ	երախներդ	Possession
քվարցներս	որձաքարիս	Possession
նշանաբաններ	տասերորդդ	Case
կվաճառենք	չտկռես	Tense
փորձառություններիցս	սկզբնագրերում	Number
պայտովս	հնոցներումս	Possession
բողոքարկեմ	գրավիտոնում	Number
մակաշերտիցս	խաչքարերիցդ	Case
ակնածելիներին	տոռնիս	Case
ալկոհոլների	կասպիդ	Case
կգլդորեմ	ունկնդրեն	Tense
կծնեն	հղենայի	Tense
նախապայմաններում	խոսունումդ	Case
մնացականիցս	ֆինլանդուհիներից	Case
ածանցդ	մետաղագործություններիդ	Possession
չվարեցի	գլտոր	Tense
ուղեբեռը	բորշչերդ	Case
գմբեթս	սաղմոններումս	Possession
տվյալներ	տվյալովդ	lemma
մկրատներիցդ	կահույքիցս	Case
չսահմանեք	կկանխամտածեմ	Tense
բոլշեւիկներին	անբանիդ	Case
հմայի	կցավեինք	Tense
ձողեր	որոշումը	Case
նախաբազկիդ	կղմինդրների	Case
խաշ	ջերմուկներ	Case
կտարվեին	բուսակերների	Number
կռացի՛ր	կռանում	lemma
յուաններով	սալորենիներում	Number
կկտակեին	երգիծեցին	Person
մատյանիցս	հիվանդներս	Possession
մուրուքիցդ	մեներեններիցս	Case
մոշավայրուցս	համերգասրահներս	Possession
կքննարկենք	չհամբուրի	Tense
նավահոս	ստորակետերը	Case
կաճապարեմ	չտառապեցի	Person
չգնչի	գնչեիր	lemma
տես	չսաղացրին	Tense
թանացի	կերկայնեմ	Person
կկասկածեն	կալեմ	Tense
նախապայմաններում	մարզասրահումս	Case
արսեն	փաստեր	Case
մանգաղներիս	կապահովենք	Number
ամիրայիս	խոյերս	Possession
դրսեւորեց	քչքչաց	Tense
հմուտով	սնդիկիցդ	Number
փոխանակեցինք	նեղաց	Tense
կենտումդ	տերտերներովդ	Possession
քարշելիք	չքարշեցիր	lemma
ձախլիկ	գիսակներս	Case
լազերայինս	զանգակածաղիկներովս	Possession
էթայի	կմտմտան	Tense
անսովորներիցս	ճիրանումս	Possession
պյուռոսյաններիդ	մեթոդներից	Number
սեղանատներ	ռեգգին	Case
չապաշխարեցիք	կողողվեիք	Person
չգոգեն	կաղարտեմ	Tense
ծովակալներդ	աղվանիդ	Possession
ուսդ	ջերմերովդ	Possession
ճանդանովդ	խարտոցներդ	Possession
մեռելոտի	ռուսաստանցուդ	Number
ձայնարկություններիցս	հանդիցդ	Case
կենտումդ	խնամքներիցդ	Possession
չողբաս	համբուրվի՛ր	Person
երկնչոտով	եռանդունովս	Number
չողբան	ողբացիք	lemma
չմոլորվի	քերծեց	Person
կքննարկենք	բաղբանջեիր	Tense
թխկուց	խտղտանքներիցդ	Case
ջրափոսում	ատակիս	Number
այսրկովկասյանը	թաքթաքուրումս	Number
կատապանիցս	կատապանիս	lemma
քոռում	ճաքերում	Case
ծովատառեխներումս	ճառագայթիս	Possession
ապահովիցդ	ամրոցումս	Number
կկռնչաս	կռնչա՛	lemma
հարբեց	չհամառեցիր	Tense
հերոսությանը	բամբասանքներիս	Case
գոնադովս	անհույսներս	Possession
մկրատներիցդ	բաոբաբիցս	Case
հոգնածությունիցդ	ալեմաներենս	Number
արեւելյաններիցս	արեւելյաններ	lemma
հեղուկիցդ	մեծավորով	Number
հրաշակերտներովդ	չհամակարգեցին	Number
նինջաներիցդ	երեւելիից	Case
մնացականներիս	արջնի	Case
շարժիչիցդ	ստադիոններիցս	Case
չդայլայլեցիր	դայլայլող	lemma
չխրոխտար	քերծեց	Person
տիբեթերենից	տիբեթերեններդ	lemma
անձեռոցիկները	օսմանցիներովս	Number
կթվարկեմ	չդատարկեցի	Person
ֆալիսկերենի	բառապաշարիցդ	Number
ձիրքերումդ	անձրեւում	Case
կվռնդենք	կվռնդես	lemma
տապիոկայիցդ	մետաղագործություններիդ	Possession
ամպար	հողմերս	Case
օգտագործումներումդ	բարուցդ	Possession
յանիչարից	ունիվերմագներից	Case
արուիդ	կքաքեր	Number
ընդելուզեիք	չընդելուզեցիք	lemma
չորոճած	չորոճեմ	lemma
գգվեիք	կկազմակերպի	Tense
խաբեբայություն	ակնոցներդ	Case
մետաքսեում	չխուզեիր	Number
հալելիք	հալեց	lemma
կիրառվենք	կխածի	Tense
վայրումդ	ձախողներիդ	Possession
հեցերովս	արմերով	Number
կկաշկանդենք	զառամանայիր	Tense
սրճարանատերերիդ	չմատնեք	Number
կենսալիրների	կուրծի	Case
արդյունքների	վարպետին	Case
գորշավունիս	միջածանցներս	Possession
կխոպոպացվես	զգենան	Tense
ենթակայականից	փաշաներիցս	Case
կուռեն	չապահովացնեի	Tense
շարունակեն	ուսումնասիրեցին	Person
չխիթա	կհամարեինք	Tense
բռնաբարեցին	կլողանան	Person
արևածաղկի	կողը	Number
ֆրանսուհիներովս	ֆրանսերենս	Possession
տպիչից	օղակներից	Case
մրսելիք	չմրսեցիր	lemma
ձկնկուլները	գրենա	Case
փախլավան	պորտվեյններդ	Case
բեկտեք	չսիրուեցիք	Person
թեորեմիցդ	կոպումս	Number
դալուկս	դալուկներովս	lemma
մաքրես	կհամարեինք	Tense
կհարկաներ	չհեղեղեց	Person
լոգանար	լոգանան	lemma
էրեկվանից	գաղափարին	Number
ուսդ	գանձարաններումդ	Possession
ընթացող	ընթացան	lemma
քեռայրիցդ	ունիվերմագներից	Case
տժվժիկի	ավազաքարերիդ	Case
աշտարակը	ծայրահեղականով	Number
կեղեցի	քչքչամ	Person
թեյնիկներդ	պսակիցդ	Possession
գորովեինք	չհյուծեցինք	Person
սրճեփներիդ	ոլորմոլորները	Number
վերուվարներից	փաշաներով	Number
գեյզերս	հուռթիները	Case
հումերդ	հիգիենայումդ	Possession
տնօրեններովդ	խուճուճումդ	Possession
մկնիկին	մինարեթում	Number
թեկնածուներին	ներկայացուցչության	Case
հմայենք	կկատարեր	Tense
սվիտերներիցս	արթունս	Possession
կայաններս	մոնղոլերենդ	Case
սիբիրախտովս	նախաճաշի	Number
հառաչալիներից	թավայիցս	Case
անհույսումդ	հարսանյացներումս	Case
կենսալիրների	ծուծին	Case
հոտոտեի	ֆոտոնայինիցս	Number
վերազգայինումդ	քարտեզագրականներում	Case
պագերի	տեղատվությանս	Case
մագնիսականությունների	նիդեռլանդերենիս	Case
գյուղերումդ	նորվեգերենումս	Case
չլկստվեմ	լկստվեր	lemma
շինարարներիցդ	թավայիցս	Case
չտաղտկացող	չտաղտկանայիք	lemma
չհերքվենք	կկազմակերպի	Tense
աշուններիս	կատարյալիցս	Possession
թորիծ	կարոտին	Number
ճրագովդ	ոսկյային	Number
հազիդ	նոյեմբերյաններիս	Case
կենդանացավ	առողջացր	Tense
թանացի	կլրթանամ	Person
ցենտներումդ	գամփռներիդ	Possession
չապահովանաս	կապահովանայիք	lemma
զավտրըկը	անվճռականներ	Case
չառողջացնեիք	կքորեմ	Tense
հրասայլին	կրկեսովդ	Number
արդյունումս	բորբերումդ	Case
գանգրամազներովս	ծերուններ	Number
նքողակից	պլատինդ	Number
հեգեք	թաթուլներովս	Number
խափանող	խափանի	lemma
ծովատառեխներումս	ըղձականովս	Possession
լվացքատներումս	խոսունումդ	Case
ապահովիցդ	շամպայնովս	Number
հաճախորդությանդ	ողորկություններովդ	Possession
զուգահեռագծիցս	թավուտներս	Possession
կփայփայեինք	խլություններում	Number
նքողես	կցավեինք	Tense
կառքերից	տեգրականայք	Number
չտարակուսես	կաճեցնենք	Tense
ջեբիդ	գեղմերիս	Case
չուղարկեն	ուսումնասիրեցին	Person
փապերիդ	տրցակիցդ	Possession
կմուրայի	չկարոտեցի	Person
կվերծանես	խոստանան	Tense
կղզիներից	սուսերամարտիկիցս	Case
մատյանիցս	սխտորներումս	Possession
լերկեր	քերականագիտությունս	Case
բանալիք	բանաց	lemma
իրականներից	չարաչարիցս	Case
իշխանափոխությունիցս	աշտեններիցդ	Case
բիզնեսդ	նորվեգերեններումդ	Possession
նախաբազկիդ	նոյեմբերյաններիս	Case
չնախընտրեցինք	կշիջուցանեիք	Number
պարաբոլիս	ավազաքարերիդ	Case
կղզիներից	կահույքիցս	Case
ապահովեցիք	փողոտե՛ք	Person
կխրախուսեն	չթլվատեցին	Person
կանաչավուններս	մսան	Case
մրմնջացիր	կմտադրես	Person
կամարդ	խաղամոլներիցդ	Possession
փախումս	կքաքեր	Number
ցողուններովս	ահաբերս	Possession
կստեք	չբղավեցիք	Person
պատմվածքդ	իշղարներիդ	Possession
հռչակավորներումդ	պարսկականիդ	Possession
գործարկեցինք	չպատրաստենք	Person
արծաթիներից	քեֆից	Case
համեստությունումս	ծերություններումդ	Case
կգողանանք	կգողանաս	lemma
նորույթումս	շակալներովս	Possession
չգոգեն	կուռչեի	Tense
համբարձումներս	թորիումիս	Possession
արծաթիներից	պայմանագրից	Case
լյարդի	զիբիլներին	Case
կգրադարձեմ	լողանայիք	Tense
մարտակառքի	քեռակիններիս	Case
ջեռուցեցինք	չհղփանանք	Person
ցանկացանք	հունվարներումդ	Number
չերկբայանայի	աղբերակովս	Number
հեղձամղձուկներիցդ	ալիբիումդ	Possession
նոճերումդ	վաղնջահայերենիցդ	Possession
չկոշկոճեցի	կբաղբանջեմ	Person
կարտոֆիլը	գնդակահարություններ	Case
կղբենիներս	ոտիցս	Possession
հատապտղում	ինքնությանը	Number
չըղձաք	կապշեր	Tense
էնցեֆալիտներդ	ղիամաթիցդ	Possession
վերուվարի	կվախեիք	Tense
չկոշկոճեցի	քչքչամ	Person
կեպերենք	կարմրանար	Tense
արարիչներովս	միամիտիս	Possession
չտուժվեմ	տուժվեր	lemma
տրցակող	տրցակի	lemma
չբողբոջած	չբողբոջեմ	lemma
ասպազեններ	մսան	Case
կթաղեն	պյուռոսյաններում	Number
զովերին	չաքուչի	Case
սսկվեցին	կզարթնեին	Person
համեղների	վինիս	Case
փալասիցդ	պրոլետարներիցս	Case
շանթամբոխիդ	գանձարաններումդ	Possession
պադյեզդներիս	պորտուգալերենիցս	Possession
հղենայիր	չսիրւեցիր	Person
թենիցդ	ճանկերիդ	Possession
ճոռոմախոսումդ	հեթանոսներիցդ	Possession
տագալերենով	սկալդդ	Number
տիբեթերենումս	շեֆխոհարարներս	Possession
չծփեմ	ծփեր	lemma
թեորեմիցդ	չբանտարկեմ	Number
թխկուց	ունիվերմագներից	Case
մարխիդ	վարչապետներովդ	Possession
մորաքրոջիցս	խտղտանքներիցդ	Case
կհալածեք	չվերադառնամ	Tense
քեներիցդ	ստարտափիդ	Possession
ստվարներդ	ադրբեջանցիս	Case
սնուցմամբ	մահմեդականիցս	Number
կղկղանքումդ	դրույլներումս	Case
ծխերի	քաբաբիս	Case
տանձենիներիդ	անվան	Case
մուրուքիցդ	եռանդուններից	Case
ալերգիայումդ	չոփերիցդ	Possession
առշերտերդ	բենզալցակայանումդ	Possession
քառյակը	ալմասներ	Case
արածեցնող	արածեցրին	lemma
կտակը	ըմպակներդ	Case
շարժիչիցդ	բլոջներից	Case
առհավատչեքներիցդ	սառցալեզվակումդ	Possession
ֆերմիոնիդ	աչալուրջներիցդ	Possession
լքնեի	կգլեք	Tense
տանձենիներիդ	մեծաքանակի	Case
քանդակներովս	հաճախորդամետս	Possession
մահմեդականներով	չխոպոպվեք	Number
կառքերից	բողոքենք	Number
պիլասոսիցդ	ապարանքներից	Case
փախումս	ինքնությանը	Number
ականծուղակիս	կկարենայի	Number
սնուցմամբ	կմայեի	Number
ցեծերիցդ	պիցցադ	Possession
համովիս	հատուկներիդ	Case
կանտոններս	ըղձականովս	Possession
տերեփուկովս	լվերովս	Possession
օդապար	կջղայնանայիր	Number
գոնադովս	գիտակցականություններս	Possession
արաբերենումս	ուռենիներիցս	Possession
երթեւեկումներիդ	ռուբլուցդ	Possession
թեկնածուներին	կուրծի	Case
տնօրինեք	կկարողանայի	Tense
աշուններիս	վագրիցս	Possession
ազնավորներիդ	կռնակի	Case
հակասեմիտականություններս	անագան	Case
դրսեւորվ	դրսեւորվեք	lemma
կհպարտանաք	կանխագրե՛ք	Person
զրահամորթումդ	արմունկոսկրերդ	Possession
հելնեինք	չհամակարգեցին	Number
աղավաղեն	կփքվես	Tense
չուղարկեն	խայթեցին	Person
կվարեք	չպատառեր	Tense
կդարբնեք	կարմրանար	Tense
հալեմ	կգնահատեին	Tense
փախցնես	կլանեցիր	Person
տիք	կարոտին	Number
պոռոտախոսիս	աղիքներումս	Possession
աջաբսանդալը	քեռիներս	Case
սանտիմետրիդ	հարսնապարերի	Case
կրոնականներովդ	ստախոսիցդ	Possession
մրեժովդ	կաղապարներումդ	Possession
սեգերիցս	լահմաջոս	Possession
յուաններով	խտիղների	Number
զավտրիկդ	սուպերմարկետներովդ	Possession
տժվժիկներովդ	առակախոսիդ	Possession
շարադրություններիդ	կուղբիս	Case
եկերդ	քյամանչայումդ	Possession
չմեղանչեմ	կսրտառեիք	Tense
արթնանայիր	չփրթեցիր	Person
առհավատչեքներիցդ	ստարտափիդ	Possession
կխօսամ	երկմտեք	Tense
բենզալցակայանների	չհամակարգեցին	Number
հապաղիցս	փախստյաներովս	Possession
կխօսամ	չտռեք	Tense
չապացուցվեցիր	գողացի՛ր	Person
ձախլիկ	քեռիներս	Case
տիք	չհորանջեցի	Number
կշտկեր	բաղբանջեք	Tense
քաղեցիր	կուսուցանես	Person
չըղձացիր	կըղձաս	lemma
թեշիկս	փայտածխիդ	Number
չբնակվեցիր	բնակվող	lemma
գործոններդ	տրցակիցդ	Possession
զվարճանաս	մաքրեցիր	Person
քեֆերին	չքանդեինք	Number
ահազանգերս	վագրիցս	Possession
արդյունքների	առիթի	Case
տեսիլներիցս	լատվիերենիցդ	Case
սոսինձներումդ	կռիչքներովս	Number
նիրհող	չնպաստող	Case
լինգալայումս	նավթադոլարներումդ	Case
համեղների	խոպոպացմանս	Case
կվհատեցներ	կորնչեց	Person
ապարոշին	կալեիր	Number
բացականչություններիդ	թեորեմիցդ	Possession
կուրախացնեինք	չփութացնես	Tense
հաղթի	գուղձերի	Case
ուրախացրո՛ւ	կլքես	Person
չօթի	կանխեց	Person
նարտովդ	պերճանքներդ	Possession
անցյալումդ	անցյալում	lemma
պարտիաներ	էլեկտրոն	Case
փոխարինումների	վինիս	Case
հրաշակերտներովդ	կշիջուցանեիք	Number
ապացուցեցի	չհոլանեի	Person
ապերախտություններդ	անդեորդս	Case
ցողուններովս	ինքնահավանս	Possession
շարունակ	բլբլացիր	Tense
կկակազենք	չըմպեցինք	Person
առհավատչեքներիցդ	հիգիենայումդ	Possession
արգելքները	սղոցս	Case
ինդիումներիցս	պատառաքաղիցդ	Case
ասքերովս	փայտեղենիս	Possession
առաջադրանքներիս	սեւականի	Case
զատերիս	չցնծաք	Number
ասպազեններ	լյոքշս	Case
ծնկոսկրիս	վերմիշելներումս	Possession
գորշավունիս	քառակուսիներովս	Possession
ընթացար	հորդորի՛ր	Person
մամուխիցս	հռոմեականներից	Case
բարվոքիցս	ֆիլմերս	Possession
ջազվեներիս	լաստենովս	Possession
ախտարարս	քրիստոնյաները	Case
սպասասրահը	քեռիներս	Case
չաբսորբեցիք	նեղաց	Tense
ընթացաք	կհայտարարեք	Person
վրդովեմ	չկարոտեցի	Person
չնվագենք	կտարամիտեր	Tense
կարծեիք	քոչերին	Number
հիր	մաղթեց	Tense
կխնկես	ունկնդրեն	Tense
առաջադիմականներդ	զառանցեք	Number
սիբիրախտովս	ունայնությունում	Number
աթեիզմիս	նժույգների	Case
կխրտնեմ	չփայլունանայիք	Tense
կինձիդ	արտագաղթերի	Case
քրթմնջա	կայացավ	Person
կլողանամ	չհամոզեն	Tense
բունոցից	բունոցը	lemma
գուժումներ	հողակոշտ	Case
ձարխոտեր	այլեւայլություններովդ	Number
ադամանդներից	սուտասանից	Case
դատողություններիս	ավազուտս	Possession
ուղեբեռը	եկեղեցականներ	Case
ջրափոսերումս	չցնծաք	Number
կիվին	ջհուդներդ	Case
աստվածաբաներդ	չխոպոպվեք	Number
ընթրիքով	չթրմեց	Number
չազդվեցի	կեպերեի	Person
ղայիշիս	ավազաքարերիդ	Case
հելնեինք	գորտնուկներովս	Number
գերմանականում	որոճներում	Case
խոնավավունիս	ծերունից	Number
կկաշկանդենք	չկտակեր	Tense
մտավորս	խորերումս	Possession
մկնիկդ	վայրագի	Number
կռինչը	թալիբներս	Case
գաղտնիքիցդ	բժշկություններից	Case
չհորդորի	պոռոտախոսեց	Person
ասպանդակով	ենիչարիիդ	Number
երկնակամարները	օտարոտիներովս	Number
մեղմերիս	ճահճումս	Possession
գլուխներդ	կփարվեինք	Number
կզանգահարեիք	դատապարտեցիք	Person
կտռզենք	չհյուծեցինք	Person
կցտես	բեկտի՛ր	Person
այրուկովս	նատրիումներս	Possession
բռնաբարեցին	չզվարճացնեն	Person
զոդող	զոդեցին	lemma
ֆիլիպիներեններում	նանաներովդ	Number
սաստիդ	ղազերի	Case
նամականիշներից	բորբոքիցս	Case
մահմեդականներ	շառաչ	Case
գեղոններիցդ	առակախոսովդ	Possession
նորվեգերենի	գուսաններիդ	Case
կոլգոտկայիս	փիլաքյաններիդ	Case
նորոգներիցդ	չերկայնեին	Number
բոցիցդ	չխուզեիր	Number
բնույթից	փաշաներիցս	Case
զովերին	օղակիս	Case
փենջաբիում	որոճներում	Case
ճմռե՛ք	կծղրտայիք	Person
կմխիթարեք	չկատաղեցիք	Person
հիր	ճմռթեց	Tense
պադեզդիցս	հայրատներիցդ	Case
չստամբակեմ	ստամբակեր	lemma
կաթնապուրներին	կալբասներովս	Number
տնատիրուհին	տնատիրուհու	lemma
բոցով	ոսկրաբանիցս	Number
մեղկս	մեղկերովս	lemma
ազատանում	աղեբեկներում	Case
անապատականս	սնդիկիցդ	Number
մթությունը	մթության	lemma
չտռեիք	կավելացնի	Tense
արքայություններին	հանելուկներումդ	Number
ծեփեցիք	կացարաններիս	Number
չարաչարիդ	հոբելյարներին	Case
տեղյակներդ	գտածոյիդ	Possession
սիկղերովդ	բռնությունումդ	Possession
աղատելիք	չաղատեցիր	lemma
թվահմայությունիցս	բլոջներից	Case
կոթողիս	ջաներիցս	Possession
չաճացնես	հորդորի՛ր	Person
կվաճառենք	չարյունահոսես	Tense
մեծանձնիցդ	կիզանուտում	Number
չբարելավենք	կթոթովեիր	Tense
ապենինյաններին	ապենինյանովդ	lemma
սանձահարեին	երգիծեցին	Person
խորդուբորդիդ	մեծատառովս	Number
վհատությունում	բակտերիաներումդ	Case
տեղեկացներ	ճմռթեց	Person
հիր	չճողոպրեցիք	Tense
չփնտրած	չփնտրեցի	lemma
սանտիմետրիդ	ներարկիչների	Case
ագահանացիր	ագահանային	lemma
թղթադրամ	կզոդեիր	Number
անդրկովկասցիներիցդ	կանաչազարդովդ	Possession
չմոռանային	մոռանալիս	lemma
կկամենային	ուսումնասիրեցին	Person
ստվարներդ	ուշունցս	Case
չնվագեմ	կգլեք	Tense
չկոշկոճեցի	կերկայնեմ	Person
տպիչից	ժպիտներիցս	Case
հորանջների	մրջյունին	Case
հրճվեին	կկործանես	Tense
կպոռոտաբանեք	կտակեցիք	Person
կերերաս	մեծաշենին	Number
կպոռոտաբանեք	ուղարկե՛ք	Person
չչաղացանք	քարշենք	Person
նանիցդ	կարիքներումդ	Possession
մետաքսեում	կմայեի	Number
ճանապարհորդիցդ	չշիկանաս	Number
չկոշկոճեցի	ցանկանամ	Person
խնչելիք	չխնչեցիր	lemma
խոպոպիքավորից	խոպոպիքավորներդ	lemma
մարտակառքի	գեղմերիս	Case
ճանդաններին	շարքայիններովս	Number
շիզիկներիցդ	թուրքմեներենից	Case
հասցնենք	կմրմնջայիր	Tense
սեւամորթիցդ	ունիվերմագներից	Case
հումիս	սրերովս	Possession
կթռնեք	կարմրանար	Tense
գտածոներումս	բայոցում	Case
համովներից	չուրախացրինք	Number
աֆարերենը	շեքերս	Case
ոստնեց	կռվի	Person
բնակչությունիցդ	ստամբակությանս	Number
պադեզդիցս	թեներից	Case
ջղայնացող	ջղայնանա	lemma
թղթադրամ	խալիս	Number
հեղեղեն	կփքվես	Tense
չսպասարկեցիր	սպասարկող	lemma
տաքերումդ	տաքերումս	lemma
մոգոնեիք	չմեղկացաք	Person
արքայություններին	հարցազրույցներումդ	Number
մնացականներիս	հավաքարարին	Case
կգլտորես	հալվայից	Number
ամբարտավաններիցս	հունավորովս	Possession
ցանկացանք	պոկերներից	Number
չզրնգացած	չզրնգացի	lemma
կեպերենք	վրդովեիր	Tense
ձկնկուլները	հովազ	Case
հակասեմականություններից	քեֆից	Case
մզկիթներիդ	լոժբանումդ	Possession
կպապանձվենք	չխրախուսեցինք	Person
տերեփուկովս	քառակուսիներովս	Possession
մաքուրներումդ	մաքուրներումս	lemma
հեգեք	անթայրները	Number
կզանգահարեիք	վառվեցիք	Person
ցանկություններովդ	բուրբոններով	Number
օթարաններիս	ստուգումումս	Possession
զոդին	քեռակիններիս	Case
որսացի	զեղծեի	Person
սավառնեն	կհրճվեի	Tense
չկաղկանձեցինք	բառնայինք	Person
շեներիցս	կապարումս	Possession
ֆերմիոնում	կռիսովս	Number
կքաղցեմ	չծլարձակեն	Tense
արեգակնային	գոսերդ	Case
օրականներից	սալորենիներում	Number
պղինձներ	կատեգորիաներումդ	Number
տառապող	տառապի	lemma
տժվժիկներովդ	պսակիցդ	Possession
պագ	պագնեք	lemma
թլփատ	ճոռոմախոսեցիր	Tense
օգոստոսյանների	ճոռոմաբանի	Case
օգոստոսյանների	սեւականի	Case
հանվելիք	հանվեց	lemma
դալուկներս	կատեգորիաներումդ	Number
չբլբլար	հեծավ	Person
քոշից	որմնախորշերիցս	Case
ինքնահավանումումդ	մահմեդականներովդ	Possession
կշփոթվեք	ձգտի	Tense
լաստենիդ	համաներումներ	Case
փքվենք	կհիասթափեցներ	Tense
նախաբազկիդ	նժդեհներիս	Case
հոյաշենովս	անտարբերություններիս	Possession
քանդող	քանդի	lemma
կթլփատի	պահպանեինք	Tense
չազդվեցի	ճամփորդեի	Person
զարմանար	զարմանան	lemma
շարունակ	շաչեցին	Tense
կողոպտեմ	կգնահատեին	Tense
բյուրս	ղայիշներդ	Case
փռշտոց	ջերմուկներ	Case
բնույթից	դելֆիններիցդ	Case
խրթեիք	չխրթեցիք	lemma
փքվենք	կկիսես	Tense
ժանրից	ժանրը	lemma
կչորանայիք	բռնաբարեմ	Tense
անգիրներովդ	կոլխոզումդ	Possession
սպասարկեր	չհոգաց	Person
չտեղեկանան	կխոցեիր	Tense
հայրենյացներում	շիվումդ	Case
կիզեիր	ընտրվեցիր	Person
սուսերամարտդ	գնդակահարություններ	Case
կոսմոսներովս	գուջարաթիիս	Possession
հովազս	կարտերիս	Possession
գրգռեր	գրգռեն	lemma
ուղեկցեիր	գողացի՛ր	Person
խանծերիցդ	գաղափարիդ	Possession
չուռեցինք	առողջացնենք	Person
վհատի	չմեկնեց	Person
հումիս	խորհերումս	Possession
կաշկանդիդ	մեծաշիթներին	Case
կրիս	կաղճիններին	Case
կոնյակ	ծովափղերը	Case
հերքելիից	հայրատներիցդ	Case
չինգաչունգի	անաղարտիցս	Number
սանտիմետրիցս	ամբարտակներումս	Possession
կեղ	կեղեք	lemma
ձաղե՛ք	չդարսեիք	Person
կողոպտեմ	կհեղուսեիք	Tense
չըմպենք	կմաքառեիր	Tense
կերդվեիր	չճկեցիր	Person
կտանջեիր	նվագեցիր	Person
արցունքներումդ	ջրկոտեմում	Case
չհագեցրած	չհագեցրի	lemma
լոգացի՛ր	բանեցրիր	Person
լաչառներովդ	պալայերենդ	Possession
մոդեմի	ռեստորաններիս	Case
տես	չմերկացաք	Tense
հակասեմականություններից	զազրոտիիցս	Case
փիլիսոփոսիս	նունուֆարներիդ	Case
բարձիթողիիցդ	հնդկընկույզներովդ	Possession
կհոշոտեն	չգիտակցեմ	Tense
քանդակներ	պնակ	Case
չհղիանան	սառեցին	Person
սպրիչներիդ	դեղձանումդ	Possession
հեծնեին	կկործանես	Tense
քվարկներիս	գառնարածիցս	Possession
բնույթից	վայելուչներիցդ	Case
հերքե՛ք	ղափամաներիս	Number
հղիովս	ձկնաբանականներովս	Possession
ռացիոնալներովդ	էներգիադ	Possession
կչարանան	քցեցին	Person
կփողոտենք	կփողոտես	lemma
չհայթայթեիր	կախտորոշենք	Tense
աջաբսանդալը	փաստեր	Case
քոռում	հեթանոսներումս	Case
անհավատին	գուսաններիդ	Case
թլփատեցիր	գիտակցվի՛ր	Person
կողբա	ճմռթեց	Person
մարտակառքերիս	թամբիդ	Case
չհրամայեցիր	հրամայող	lemma
անգիրներովդ	ծանրաբեռդ	Possession
կռինչը	պոռոտախոսություններ	Case
ուրուկներիցդ	վիզաներս	Number
օրհնյալներս	կետչուպ	Case
բոլշեւիկներին	կասպիդ	Case
պիլասոսներդ	գտածոյիդ	Possession
ցեծերիցդ	պարտեզիդ	Possession
կարանտիններովդ	ժամհարիցդ	Possession
կփլվեն	չզրնգայիր	Tense
չկարողանամ	կարողանար	lemma
հայցե՛ք	կլեպները	Number
լոուրենսիումներին	աքսորյալիդ	Case
դարսի՛ր	ածանցեիր	Person
հորանջների	խոպոպացմանս	Case
գելե՛ք	երթայիք	Person
ուրախացրո՛ւ	կպառկեիր	Person
հնարամտություններդ	խուճուճումդ	Possession
հեռացրո՛ւ	հեռացնում	lemma
աղավաղի՛ր	աղավաղում	lemma
ուսումնասիրեցիր	կոստներ	Number
չհոգաս	կհամարեինք	Tense
անձնավորս	անձնավորներովս	lemma
չազազեմ	ազազեր	lemma
հարազատը	հարազատի	lemma
թիռումդ	տերունիներիցդ	Possession
շարունակ	համակարգ	Tense
ամրակազմները	անագան	Case
երեւելիումս	չկաշառեց	Number
լողավազաններ	պատառներով	Number
անձնանունների	փետիս	Case
կհիասթափեցնեիք	չստեցիք	Person
կխօսամ	ճողոպրեին	Tense
նանիցդ	կոթողներովդ	Possession
քննություններովս	թամադայիս	Possession
ղեկավարությունների	կուղբիս	Case
արամերենիցդ	հաղարջենիներիցս	Case
մեծահանդեսներովդ	ավտովարորդդ	Possession
չհորջորջեցիր	կկենդանանաս	Person
կղզի	մեծավորով	Number
շիկամկնիցս	թավուտներս	Possession
մարտակառքի	մժեղներիս	Case
կթաղեն	ըմբիշներդ	Number
չերկբայանայի	ստամբակությանս	Number
կվհատեցներ	կարօտեց	Person
անդյաներից	դուզեր	Number
խոպոպացվեին	չլուցեցին	Person
թղթադրամ	թաթում	Number
գովի	պոռոտախոսեց	Person
ինքնահավանումումդ	խաղամոլներիցդ	Possession
չհորջորջեցիր	քոչես	Person
տեղիներ	անագան	Case
անզգայացուցիչներովս	չորոճայիք	Number
կխիթայի	քերծեք	Tense
ծառայությամբս	որթերս	Possession
կվերծանես	ունկնդրեն	Tense
նախապայմաններս	բարիքներից	Number
կոլորես	ոլորի՛ր	lemma
հիր	գնացինք	Tense
չտրամադրեինք	կզոդի	Tense
չհարբես	կհարբեիք	lemma
տեղիներ	ուշունցս	Case
աճապարես	հյուրասրահի	Number
սուրահին	կռիչքներիդ	Case
ասպազեններ	օյինբազս	Case
սեգերիցս	ինքնուրույնիս	Possession
կողքդ	նախաճաշեր	Case
հատուներիս	կռնակի	Case
պահապանից	խազի՛ր	Number
առաքինություններս	ընկճախտ	Case
լյարդի	մժեղներիս	Case
փտած	գոսերդ	Case
այծերս	թամադայիս	Possession
հեգեք	հեկտարներում	Number
վերմուտից	շագանակագեղձերից	Case
կոմսուհիդ	կուսանեմ	Number
չըղձաք	կհաճախեցնեի	Tense
ատոլներումս	ջրեղենիցս	Possession
մարտակառքի	սոուսներիս	Case
չըղձա	կախով	Number
կդայլայլեին	չթլվատեցին	Person
հերքվ	հերքվեք	lemma
ջեբիդ	պիստակներին	Case
լերկեր	գինարբուքս	Case
կքչքչայիք	չվերադառնամ	Tense
աբսոլյուտներիցդ	գտածոյիդ	Possession
կադմիումիդ	կալեիր	Number
լուցե՛ք	չհափափեցիք	Person
ամորձուցս	մեծատառերս	Possession
դատապարտի՛ր	դատապարտում	lemma
աբսորբենք	կճմլեիր	Tense
ռադիոյովս	կիզանուտում	Number
կարբիցդ	պատուհասներդ	Possession
թերասնում	արգատներս	Case
կծնգցնեք	կրակեր	Tense
սազայիք	կկանխամտածեմ	Tense
տեռորիզմին	ավազաքարերիդ	Case
լուսանկարներովդ	բարուցդ	Possession
կբդկեիք	կտակեցիք	Person
մղձուկներիդ	պիցցադ	Possession
կփրփրանք	կփրփրաս	lemma
ճանապարհից	ապարանքներից	Case
արկ	արկեք	lemma
կանկարներիս	թովիչներիցդ	Number
նախապայմաններովդ	շահնշահներով	Number
հաստատեք	կերկկտտացնեի	Tense
չկառավարի	կառավարեիր	lemma
քեռեկնոջովս	մոլեգնեցի	Number
ադամանդներից	գանգրափնջիցս	Case
սխտորի	վաստակներին	Case
վագրը	վագրի	lemma
կվարեք	չարդարացնի	Tense
կօժանդակեմ	գանգրացվեիք	Tense
աճացնի	նախաճաշեց	Person
չթրծեին	թրծեին	lemma
բողովդ	երիտասարդներդ	Possession
ջրաղացներիդ	ռուբլուցդ	Possession
հոռովելը	ահաբեկիչներս	Case
թվահմայություններովդ	անթերիիցդ	Possession
թուլիումներիցս	ճառագայթիս	Possession
հատուներիս	կուրծի	Case
չմտաբերեն	խայթեցին	Person
մաքսերը	գերմանիումներիցս	Number
հաճախություններիս	կոսմոպոլիտականումս	Possession
ուղեբեռը	ազգանուններ	Case
մեծանձնիցդ	քարփիջին	Number
կածանցեիր	բողբոջենք	Tense
չլքնի	կհեղուսեիք	Tense
ֆոտոնումդ	գնաճերդ	Possession
աֆարերենը	հողմերս	Case
տիք	մոշավայրու	Number
տուժվեիր	կներքինանանք	Tense
ջեբիդ	թացերին	Case
չարորեցինք	կողբանք	Person
դեղատներից	քեռակնոջիցդ	Case
փռթկացրո՛ւ	փռթկացնում	lemma
արշալույսումս	մտրակներումդ	Case
ձախլիկ	ստորակետերը	Case
չչաղացանք	փոխհատուցենք	Person
փայտյաներին	փայտյայովդ	lemma
զոդին	փիլաքյաններիդ	Case
գառնենիների	աքսորյալիդ	Case
չաղոթես	գողացի՛ր	Person
անապեստիցս	ձկնաբանականներովս	Possession
կոկոսյանումդ	հնարամիտներիդ	Possession
չվհատած	չվհատեցի	lemma
բոցով	պողովատիցդ	Number
խելոքներովդ	կոլխոզումդ	Possession
չխրոխտար	ճմռթեց	Person
մարսողությունը	եկեղեցականներ	Case
մեծաբաններում	բայոցում	Case
կգլտորես	թանգարանդ	Number
ծովափղեր	կշիջուցանեիք	Number
փտած	հայկազներ	Case
կանիծեիր	չոլորակենք	Tense
ձաղե՛ք	ընգնեիք	Person
չաղանայինք	չչաղացա	lemma
լոուրենսիումներին	տոռնիս	Case
պահապանիս	առէջներին	Case
խթանեցինք	չպահածոյացնենք	Person
կմոլեգնենք	կմոլեգնես	lemma
կպայմանավորվեն	խոխոջեիր	Tense
ասպազեններ	փուշդ	Case
չվերուվարեին	վերուվարելիս	lemma
գլի	չհոգաց	Person
հաճախորդությանդ	խեղություններիցդ	Possession
չհերքվենք	կտաղտկանայիր	Tense
չուղեկցի	քավումդ	Number
վրդովվեց	նեղաց	Tense
ընթացաք	կվերագրեիք	Person
գոչեր	կլրթանանք	Tense
կառաքեմ	արթնանան	Tense
առաջադրանքներիս	առիթի	Case
չգոգեն	կճմլեիր	Tense
իռլանդերեն	քեռիներս	Case
մտադրվեիք	չմտադրվեցիք	lemma
հելնեինք	խոլորձներումդ	Number
լողավազաններ	ձրերիդ	Number
մրսեիք	կնքեցիք	Person
գաղձերդ	չքանդեինք	Number
փութաջանությանդ	վրդովներիս	Case
իրիդիումներդ	շառաչ	Case
հարգանքներիցս	հունավորովս	Possession
կքցենք	չվարանեցինք	Person
թեյնիկներդ	շառաչյունովդ	Possession
կհոսեի	արթնանան	Tense
նորվեգերենի	ինքնավարների	Case
ճոռոմաբանականներիցս	շվեդից	Case
ժանտափշերումս	բայոցում	Case
ձողեր	հողակոշտ	Case
կեպերենք	չձգտեր	Tense
կսավառնի	չմեկնեց	Person
հետեւեին	հետեւեցինք	lemma
չափահասները	օտարոտիներովս	Number
նորոգներիցդ	տիեզերագնացներիս	Number
սենյակովդ	տունդրաներդ	Possession
հնախոսներիցդ	ծանրաբեռդ	Possession
երակներին	օսեթերենիս	Case
հոգար	հոգան	lemma
ղսմաթդ	նիզակներս	Case
ձրիովդ	բերիլիումիս	Number
ջերմություն	չկաշառեց	Number
թլփատեցիր	կբարեւես	Person
կդայլայլեին	հագնվեցին	Person
համբուրվեցիր	կհղփանաս	Person
չաղոթես	բեկտի՛ր	Person
չկատակող	չկատակեիք	lemma
նախարարին	գրյանքների	Case
հոնքերս	ժամադրությանս	Possession
ղեկավարությունների	մարկիզիդ	Case
ասվեղներով	ասվեղովդ	lemma
մահացաք	չապահովվեիք	Person
անապատականս	չբդկես	Number
ագարակացնեիք	չագարակացրիք	lemma
հիր	պագեցիր	Tense
կհեգնենք	կհեգնես	lemma
կգլտորես	քավումդ	Number
բրիչովս	գահույքում	Number
երգեհոնիդ	վրդովներիս	Case
հյուս	չազազեցիք	Tense
չարկանեցիր	մատիտով	Number
թլփատ	չարբեցիք	Tense
ինքնահավանումումդ	հրշեջներիդ	Possession
նորվեգերենի	տարածքներիդ	Case
տեղիներ	էլեկտրոն	Case
կհողդողդեիք	թեզնիքների	Number
պապանձվեի	կսգաք	Tense
կխրտնեմ	չտանջեին	Tense
կռնչեց	կռնչի	lemma
չկաղկանձեցինք	նպաստենք	Person
պագնեիր	կապացուցեն	Tense
ձուլի	կբդկեիք	Tense
պորտապարում	կաշկանդյալներում	Case
կէթաս	չագռավանանք	Tense
ուրուրդ	անթառամներիդ	Possession
չապացուցվեցիր	տարածես	Person
տիք	ցանկապատումս	Number
կցտի	ընդգծենք	Tense
արմավենիներովդ	բույնիդ	Possession
լոգարաններիս	պորտուգալերենիցս	Possession
ախտարարս	բորշչերդ	Case
մրմունջիս	ներարկիչների	Case
պատկանեի	կքելեք	Tense
առաջատարներումս	ոտիցս	Possession
չհոտոտեին	հոտոտեին	lemma
զովովս	զովերիցդ	lemma
չինգաչունգի	մետաղադրամումդ	Number
ապաշխարի՛ր	ապաշխարում	lemma
քենակալները	հեկտարներում	Number
ցունամիների	սեւականի	Case
կզառանցես	չբարբաջեն	Tense
հոկտեմբերյաններումս	տաքավունս	Possession
առաջադեմներ	կհղեք	Number
սրամտենք	չվարանեցինք	Person
ծովափղեր	բարիքներից	Number
պատմվածքդ	մետաղագործություններիդ	Possession
մահացավ	հետեւի	Person
հաստիչդ	թեքումներիդ	Possession
հափշտակումներդ	վարկածս	Case
չշիջուցանենք	կփքվես	Tense
փորձառություններիցս	չցնծաք	Number
լեզգիներիցդ	հացահատիկիդ	Possession
դեղատներից	մաճիցս	Case
ջազվեներիս	տապակովս	Possession
չարմացաք	ուղարկե՛ք	Person
մատյանիցս	թարշամներովս	Possession
այծերս	գեղանիիցս	Possession
մրմնջացիր	կկշռադատեիր	Person
ծծիցդ	բացառականներից	Case
թխկուց	ստվարաթղթերիցդ	Case
իռլանդերեն	ահաբեկիչներս	Case
խորակիցդ	չբանտարկեմ	Number
հումերդ	թեորեմիցդ	Possession
չակնածեք	կերկկտտացնեի	Tense
աթեիզմիս	կղմինդրների	Case
գրամեքենաներումդ	հոգնածությամբդ	Possession
կղզի	կոկաինիս	Number
նամականիշներից	շվեդից	Case
անձնանունների	հակասեմիտականությանդ	Case
կթլփատի	չճմռթեինք	Tense
կծղրտայիր	մոլեգնեցի	Number
ասպանդակով	մահմեդականիցս	Number
բաստուրմայից	արծվիներիցս	Case
այցելությամբս	շեֆխոհարարներս	Possession
թուրքմեներենովս	նատրիումներս	Possession
շփոթեցրիք	հոտե՛ք	Person
չմոլեգնի	մոլեգնեիր	lemma
վհատությունում	սաղարթներում	Case
թլփատ	չդարանակալեցինք	Tense
կքրթմնջային	չկշռես	Tense
վայրդ	գնդակահարություններ	Case
չահագնացար	կբուծանեիր	Person
կատակագուսաններ	թլփատություն	Case
վրդովվեց	համակարգ	Tense
շահեկաններիցդ	սոուսիցս	Case
կխոպոպացվեր	ընդգծենք	Tense
չքունեիր	ձվաձեղդ	Number
մահացավ	չօծի	Person
կպահածոյացնենք	չբաժանվեիր	Tense
մահմեդականներ	լյոքշս	Case
ճոռոմախոսումդ	դանդաղկոտներիցդ	Possession
մաքսերը	կացարաններիս	Number
չկանխամտածեի	կզրնգան	Tense
կառավարեն	փորձերից	Number
մտաբերեցի	բնակվեմ	Person
չուսուցանեիր	կզրնգան	Tense
ախտորոշեմ	կճախրեիք	Tense
ուսումներով	թողություններումս	Number
հղացանք	կկեղեքենք	Person
բաջաղեինք	չբաջաղեցի	lemma
առշերտերդ	հերվանիցդ	Possession
արդյունքների	թութակին	Case
լրջանար	կաճեցնենք	Tense
չլուծեցինք	հեռացնենք	Person
չլքեիք	հենեցիք	Person
նախածանցները	հովազ	Case
չջեռուցեմ	ջեռուցեր	lemma
չձգտեք	կանխագրե՛ք	Person
հակազդեր	կքելեք	Tense
աքսորումներումս	խեղկատակիս	Possession
չարկանեցիր	գողացի՛ր	Person
ժանյակը	ժանյակի	lemma
չուղեկցի	տատին	Number
կիրառվենք	կավելացնի	Tense
շփոթեցին	կսիրւեն	Person
համբերեմ	երիկամունքիդ	Number
մանգուստներով	չմտմտայինք	Number
իշխանափոխությունիցս	օղակներից	Case
ռուբլում	կաշկանդյալներում	Case
գործարկեցինք	չվերադառնանք	Person
կախարդվածություններդ	արշալույսումդ	Possession
ոսկեղենդ	պարտեզներս	Case
հերքելիից	հռոմեականներից	Case
գոչյունից	մեներեններիցս	Case
աղորիքներովդ	օսլաներումս	Number
օգոստոսյաններիցդ	գանգրափնջիցս	Case
խեղդեմ	չվառվեցի	Person
լումայովս	ծերունից	Number
հանգես	նվագեցիր	Person
կահագնանաք	կուլերովս	Number
տունդրաներս	ռուբիդիումումս	Possession
քիլերիդ	հիգիենայումդ	Possession
կորոճային	չհայեցին	Person
կուսաթաղանթը	շեքերս	Case
չքրտնած	չքրտնեմ	lemma
յուղալավաշ	հուռթիները	Case
կծնեն	չշիջուցանեի	Tense
կզննեինք	դուզեր	Number
հուլունքների	չստրկացնեն	Number
խաժիդ	հարսնապարերի	Case
մահմեդականներով	կպոռոտաբանեիք	Number
քանդակներ	ընկճախտ	Case
թորիծ	ծերունից	Number
նստարաններովս	անուշապուրիս	Possession
աբստրակցիայում	խալիս	Number
կփնտրեմ	չգնչեցի	Person
փոխհատուց	փոխհատուցեք	lemma
զվարճանաս	հորդորի՛ր	Person
սերմնահեղուկիցս	արմունկներիցդ	Case
լոուրենսիումներին	պատյանիս	Case
գուժումներ	սղոցս	Case
սխտորի	նժույգների	Case
ոլորանս	եկեղեցականներ	Case
մնացականիցս	օղակներից	Case
նքողակից	կուսանեմ	Number
կպոռոչեիր	չուզենան	Tense
սեղանատներ	կարտոֆիլս	Case
հարբեց	չգլեցի	Tense
փտած	հուռթիները	Case
սպասարկե՛ք	կերցնեիք	Person
ղեկավարությունների	անվան	Case
գլխատառիս	այծենիում	Number
գրառ	գրառեք	lemma
նորապսակդ	նորվեգերեններումդ	Possession
խրոխտանքներին	անվան	Case
կթռնեք	չգարշեի	Tense
կվիճաբանես	չկտղեին	Tense
մեներգերումդ	այրուքում	Case
չձգտեք	հոտե՛ք	Person
կբարբառի	չածեց	Person
տեղյակներդ	անթերիիցդ	Possession
քեֆերին	կատեգորիաներումդ	Number
դանդալոշը	երիկամունքիդ	Number
վրդովվեմ	գանգրվեցի	Person
լաստենիներումս	խեղկատակիս	Possession
հայտնեն	կկործանես	Tense
կխոչընդոտեին	չէտես	Tense
կկալնեն	չխանդես	Tense
լոգարաններիս	խմածիցս	Possession
սրճեցի	չսիրուեմ	Person
կթռնեք	մարթեմ	Tense
կախարդվածություններդ	հանդիսավորումդ	Possession
հայտնեն	կքերծեիր	Tense
թեղոշներում	հմուտներովդ	Number
չարաչքիցս	սլովակերենովդ	Number
կառոգանեիր	ջղայնացրիր	Person
թուլիումներիցս	բիզոնս	Possession
կախարդվածությամբդ	ձայնադարձերիցդ	Possession
չարկանեցիր	տարածես	Person
գլխարկովդ	ձայնադարձերիցդ	Possession
անկումներովդ	ուկրաինականիդ	Possession
կատարող	կատարեցին	lemma
ձայնադարձերիդ	գերանդուցդ	Possession
մթնշաղներդ	սղոցս	Case
կոթողիս	միջածանցներս	Possession
ձաղե՛ք	հենեցիք	Person
քեռեկնոջովս	կալեր	Number
մսալիներում	այրուքում	Case
ռուսիցս	կիզանուտում	Number
խարույկիցդ	ամրակազմներիցս	Case
գովասաններիս	ուրաններումդ	Number
սրճելիք	սրճեց	lemma
մորմենուցդ	թեքումներիդ	Possession
լումայովս	չհորանջեցի	Number
կկնքենք	կկնքես	lemma
չբեկտեմ	բեկտեր	lemma
հիասթափություններովդ	տգետները	Number
կօժանդակեմ	չահագնանաք	Tense
արվեստագետդ	եռանդունովս	Number
սվին	խազի՛ր	Number
սավառնե՛ք	կերցնեիք	Person
հեւքերում	խունտաներովդ	Number
անօդաչուումս	մորալիստներովս	Possession
մարգարեուհուդ	մարզիցս	Number
չերկբայեն	կկարողանայի	Tense
տես	կանչեց	Tense
ճոպանովս	գոյակցություններիս	Possession
չխեթկի	կաներկյուղանանք	Tense
զանգեինք	կզոդի	Tense
կշողայինք	ձգտի	Tense
համբարձումներս	կատարյալիցս	Possession
փարթիովս	լավաներիս	Possession
սազայիք	կճաքի	Tense
հորանջների	անթիդ	Case
մարսողությունը	գոսերդ	Case
ուժեղանա	կորնչեց	Person
արգատներումդ	ձեւանմուշումս	Case
դրդեք	կփութացնի	Tense
չբարբաջի	կկարմրեինք	Tense
ղեկավարությունների	հռովմայեցուդ	Case
տժվժիկի	գեղմերիս	Case
չծպտվեցիք	ավանդե՛ք	Person
ընթրիքով	գրավիտոնում	Number
կբողոքարկեին	չտկռես	Tense
չսահմանեց	բուսնի	Person
երախայրուցս	չթրմեց	Number
հանգես	մաքրեցիր	Person
փենջաբիում	ցիկլոններումդ	Case
գեղոններիցդ	կոլխոզումդ	Possession
այրուկովս	ջաներիցս	Possession
պարտիաներ	հովազ	Case
հայրերիդ	պատյանիս	Case
ժանտափշերումս	ջրկոտեմում	Case
հոլաթեւեինք	չհոլաթեւեցի	lemma
անթացուպիդ	հուռ	Number
Մխիթարովդ	օսեթերեններդ	Possession
փախերդ	թմրամիջոցիդ	Possession
սուսերամարտդ	համաներումներ	Case
սնուցմամբ	տհասիդ	Number
ձմեռայինիցդ	երախներդ	Possession
չխոստացա	գլտոր	Tense
ծայրակարմիրներումդ	ծայրակարմիրներումս	lemma
չնախընտրեցի	սավառնեմ	Person
կլողանամ	չճմռեն	Tense
թրթուրներումդ	սրբոսկրում	Case
աշխարհահռչակդ	մինարեթում	Number
բայոցներիցդ	շառաչյունովդ	Possession
գուժումներ	վարկածս	Case
փութացե՛ք	կոռնայիք	Person
ձախլիկ	եկեղեցականներ	Case
նախաբազկիդ	լավերի	Case
գթասիրտներումդ	գթասիրտներումս	lemma
գանգրվող	գանգրվեցին	lemma
կգրադարձի	չտրոհեիք	Tense
բեգեմոնդովդ	գանգուրներիցդ	Possession
գնոստիցիզմ	փաստեր	Case
մակաշերտիցս	հերոսություններից	Case
ծերունովս	հուռ	Number
հարբածս	հարբածներովս	lemma
զուգահեռագծիցս	լծակներումս	Possession
կզղջա	չահագնանաք	Tense
չտառապեիր	ցավի՛ր	Person
ձուլի	կճախրեիք	Tense
զանգելիք	զանգեց	lemma
կոպեռնիցիումս	սխտորներումս	Possession
թերասնում	ազգանուններ	Case
չծպտվեցիք	կհողդողդեիք	Person
կփլվեն	տարբերեի	Tense
կկասկածեն	չշիջուցանեի	Tense
շարժումներումդ	այրուքում	Case
բոսորներումս	գեղանիիցս	Possession
ծափահարվեն	կկարողանայի	Tense
աբուռիցդ	ստադիոններիցս	Case
ձախերիս	բազազովս	Possession
կզննեինք	հմուտներովդ	Number
մոխրագույնիս	բիոլոգիաներիդ	Case
կագուցանենք	չբարեւեիր	Tense
հումիս	գիտակցականություններս	Possession
մաքրես	կմտմտան	Tense
պատմվածքդ	էներգիաներիդ	Possession
գործարկեցինք	չպահածոյացնենք	Person
դարպասաձողումդ	չոփերիցդ	Possession
հոլդ	մահմեդականներովդ	Possession
հեռատեսներ	ճոռոմախոսություններումս	Number
նշանաբաններ	աղջությունս	Case
հակասեմականություններից	էներգիայիցդ	Case
քրիստոնյայից	վայելուչներիցդ	Case
ջեռուցեցինք	կկշռենք	Person
մահմեդականներով	անորոշներդ	Number
հաճախություններիս	ավազուտս	Possession
կմիացնես	միացրո՛ւ	lemma
փախլավան	մզկիթներ	Case
կշեշտեք	մարթեմ	Tense
հեռատեսներ	կացարաններիս	Number
մահացաք	կանխագրե՛ք	Person
զուլուումս	ծածկույթներումդ	Case
հորովելովդ	չբդկես	Number
վավերագրականիս	սիեստաներումս	Possession
հյուս	գիտակցեց	Tense
ուժգինովդ	յուղալավաշներումդ	Possession
հալումաշովդ	պերճանքներդ	Possession
կկանչեին	չհրկիզեմ	Tense
զիստում	կուսանեմ	Number
կվիճաբանես	պահածոյանանք	Tense
կտաղտկանա	մոռանանք	Tense
հերոսությունդ	տերունիներիցդ	Possession
կմոլորվես	մոլորվի՛ր	lemma
ոսկեղենդ	արգատներս	Case
որսացի	կհարեի	Person
մետաքսեում	կլիանամ	Number
տուժեր	տուժեն	lemma
մզկիթներիդ	ռուբլուցդ	Possession
քաջիցդ	միացար	Number
փոխարինի՛ր	չբարբանջես	Person
չհերքվեն	կխոցեիր	Tense
կարկանդակ	այլանդակությունները	Case
չկլանեցի	առողջացր	Tense
պալատականներիցս	ինքնուրույնիս	Possession
կշողայինք	ներբեռնես	Tense
համբուրվեցիր	չբարբանջես	Person
բյուրս	օգոստոսները	Case
համացանցով	համացանցումդ	lemma
կշեշտեք	պագեի	Tense
չկիրառեին	կիրառեին	lemma
չակնածեք	կուռչեի	Tense
բուժումներից	վերջակետիցս	Case
կէթամ	չտռեք	Tense
դրվատեինք	չդրվատեցի	lemma
քամովդ	սուպերմարկետներովդ	Possession
աբսուրդներումդ	տասնամյակում	Case
անմեռներից	սենդվիչներով	Number
հռետորաբանություններ	անագան	Case
մրցավարով	հղիով	Number
բողովդ	խայրիներումդ	Possession
շարժիչիցդ	ֆինլանդուհիներից	Case
չխիթացիր	խիթացող	lemma
պիլասոսներդ	թեորեմիցդ	Possession
ձախերիս	ածանցումս	Possession
քվարցներս	տաջիկերենումս	Possession
կոճկեինք	չկոճկեցի	lemma
հյուս	չգեղգեղեցիր	Tense
արշալույսումս	հեղձամղձուկներում	Case
չպագանես	կպագանեիք	lemma
ճանապարհից	թեներից	Case
առաքինություններս	լիտվերենը	Case
ընկերքներ	գորտնուկներովս	Number
Մխիթարովդ	գանգուրներիցդ	Possession
չցտած	չցտեմ	lemma
մեծություններս	հովազ	Case
արծաթներից	չափածոներումս	Number
քեռայրիցդ	փաշաներիցս	Case
չթքեցիք	հայթայթ	Tense
չտարակուսեմ	կապացուցեն	Tense
չբողոքարկեի	կսգաք	Tense
պարավանդդ	մետաղագործություններիդ	Possession
փականներումս	ստորագրությունում	Case
ապուխտում	քարտեզագրականներում	Case
բեկտեք	զրուցե՛ք	Person
մրեժովդ	կակալաներիդ	Possession
սուջուխներին	հակասեմիտականությանդ	Case
ավարներից	թեզանից	Case
երկնչոտով	խազի՛ր	Number
վրացականին	աքերիս	Case
կագուցանենք	չկտակեր	Tense
ալպինիզմդ	շիզոֆրենիկներովդ	Possession
մանգուստներով	թովիչներիցդ	Number
լուծեցինք	չհիանենք	Person
դեզօքսիռիբոնուկլեինաթթուներումս	փաշաներով	Number
չտրցակեցիր	կտրցակես	lemma
ասպազեններ	անագան	Case
գիտելիքներումդ	տերտերիդ	Possession
կհուսահատեցնեին	էտեմ	Tense
կառաքեմ	չզգենաք	Tense
կմերձենայիք	նախաճաշեմ	Tense
ջրհորովս	չափածոն	Number
չարմացաք	կանխագրե՛ք	Person
երկմտեցիր	զեղծ	Tense
փոխարինումների	մեխակիդ	Case
շինականներովս	թորիումիս	Possession
նորվեգերենի	սպերմաներիդ	Case
կքննարկենք	հաստատեր	Tense
կհողդողդեիք	խունտաներովդ	Number
գլխատառիս	աներկյուղովդ	Number
գոլանանք	գոհացանք	Person
կվերծանես	գիտակցվենք	Tense
չդրդի	կշարունակեիք	Tense
նախամայրերիդ	ենթակառուցվածքդ	Possession
տռեին	տռեցինք	lemma
խրոխտանքներին	փետիս	Case
փախլավան	վիթերս	Case
չծպտվեցիք	գովե՛ք	Person
բաոբաբումս	պանդոկներիս	Possession
ապահովիցդ	հղիով	Number
գմբեթս	լրատուներովս	Possession
սաստիդ	գուղձերի	Case
հառաչալիներից	սուսերամարտիկիցս	Case
թոռոմեց	չջանար	Person
նքողես	կկաշառենք	Tense
վաղերիցս	վաղեր	lemma
օթարաններիս	ղարաբաղցովս	Possession
կվիճաբանես	չհրկիզենք	Tense
հարիսայիս	պարմեզաններովս	Possession
չտառադարձես	կմտմտան	Tense
պատկանեին	պատկանեցինք	lemma
չփախցներ	ապահովեցրեց	Person
կցտի	չպաղատեիք	Tense
այտուցս	պարմեզաններովս	Possession
բռնաբարեցին	չպաճուճաբանեն	Person
հոլմիումներս	էլեկտրոն	Case
կիբեռնետիկան	ըմպակներդ	Case
ալտի	խորովածում	Number
կոլաժներս	ուռենովս	Possession
ազդուները	նոճերիցս	Number
կհարնչենք	փոխարինեիր	Tense
ապահովեցիք	կհուսահատվեք	Person
աբստրահվեիր	կկռանանք	Tense
գրգռ	եռաց	Tense
մոգոնեիք	դատապարտեցիք	Person
ձիրքերումդ	ադրբեջաներենումս	Case
ավարներից	գերքաղաքիցդ	Case
զրահամորթումդ	կպչուններիցդ	Possession
արորեր	արորեն	lemma
ֆրիզերեններումս	անթայրումդ	Case
չկիրառվես	նվագեցիր	Person
լուծեցինք	կգոհացնեինք	Person
կպահածոյանայի	չթովեք	Tense
կեչուցդ	մզկիթներ	Case
կհոսի	կանխեց	Person
նիստուկացերիս	մարկիզիդ	Case
խանությանս	պատկերասրահներին	Case
լիբրետոներիս	ծծովս	Possession
ճիրանդ	փայլումներումդ	Possession
կփլվեն	համոզես	Tense
տժվժիկի	նժույգների	Case
գրգռ	կախարդեցիք	Tense
խաժիդ	նոյեմբերյաններիս	Case
մահացաք	չքաքեիք	Person
նեպտունիումներիս	չափածոյովս	Possession
վիզաներիդ	էներգիադ	Possession
չհերքեցիր	պատկերես	Person
չփչեիր	բանեցրիր	Person
ուսումնասիրեցիք	յոգաներումդ	Number
կծնգցնեք	շիջեի	Tense
կփլեիք	չաղարտեցիք	Person
աթեիստներիցդ	բարիկադիցս	Case
չերկբայեն	կհաճախեցնեի	Tense
նենգի	համերգասրահներին	Case
հառաչալիներից	խարտոցից	Case
աժդահայիցդ	սիկղերիցս	Case
լյարդի	ներարկիչների	Case
հյուս	համակարգ	Tense
աբեղայակերպներիցս	աբեղայակերպներ	lemma
չկառավարեի	արմացա	Person
մանգաղներիս	ըմբիշներդ	Number
քառյակը	փաստեր	Case
հետազոտեցի	կհարեի	Person
փռշտոց	մզկիթներ	Case
ոստնեց	մրցեր	Person
ոստնեց	չապացուցեր	Person
ռազմիկների	հավաքարարին	Case
կէթաս	չտառապեին	Tense
խրոխտանքներին	վինիս	Case
կառկայծենք	նախաճաշի	Tense
արսեն	խրոխտագիններս	Case
չչաղացանք	ճողոպրենք	Person
ծերունովս	անագանով	Number
կերերաս	խորովածում	Number
չխածանած	չխածանեցի	lemma
օգոստոսյանների	պուճուրին	Case
գրազներիցդ	դեղձանումդ	Possession
զավտրըկը	մարդելույզներդ	Case
ուդ	մահմեդականներովդ	Possession
մագնիսականությունների	խիթին	Case
կծուլանաք	չվերադառնամ	Tense
արդյունքների	լիտվաներենին	Case
թրեր	քամեց	Person
օդապար	ստամբակությանս	Number
չթարգմանեք	վառվեցիք	Person
մավիներումդ	մավիներումս	lemma
վճիռներովս	միամիտիս	Possession
չգելեցիր	գելող	lemma
ջերմիդ	հավելվածներումդ	Possession
կգլտորես	արդիիցդ	Number
ընկճեց	քչքչաց	Tense
մահմեդականներ	ընկճախտ	Case
պարմեզանդ	մալթայերենները	Case
ընտիրներդ	խորդս	Case
վաշտիցս	հեռվով	Number
կիբեռնետիկան	խրոխտագիններս	Case
չագռավանար	կգլեք	Tense
կիզեիր	չունկնդրեցիր	Person
հերոսությանը	բարձրավանդակներիս	Case
չնվագենք	կկատարեր	Tense
մնացականներիս	մարկիզիդ	Case
կիսեին	կիսեցինք	lemma
արդյունքը	նախաճաշի	Number
անհանգիստս	անհանգիստներովս	lemma
թեյնիկներդ	դեղձանումդ	Possession
արքայություններս	պյուռոսյաններում	Number
շարունակ	գոգ	Tense
մսալիներում	անձրեւում	Case
կարտոֆիլը	արգատներս	Case
տապիոկայիցդ	տերտերներովդ	Possession
խճուղիների	անվան	Case
բանավեճիցդ	հռոմեականներից	Case
յանիչարից	ստվարաթղթերիցդ	Case
տեսակները	թլփատություն	Case
չարաչարիդ	կղմինդրների	Case
ձախլիկ	պատառները	Case
կհեծնեմ	չքաքեք	Tense
կնախընտրեիր	չճոռոմախոսեն	Tense
խաշումս	կջղայնանայիր	Number
հառաչալիներից	կտրոնից	Case
գրգռ	չմոլորվեցիք	Tense
խաբեբայություն	նախաճաշեր	Case
պուպուլիցս	ահաբեկչություններովս	Possession
սխտորի	տափաստանայիններին	Case
չապահովվի	ապահովվեիր	lemma
կծնվեիք	չվերընթերցեմ	Tense
պրոլյուվիալովս	քարփիջին	Number
մահմեդականներ	կարտոֆիլս	Case
գառնենիների	մանվածքիս	Case
չճոռոմախոսեցիր	ճոռոմախոսող	lemma
հապաղ	ահազանգումիցս	Number
խնամող	խնամի	lemma
չքցեցիր	քցող	lemma
ստվարաթղթյաներումդ	ուզբեկերեններովս	Number
կորնչեին	չըղձացին	Person
պարավանդին	լամաներիս	Case
ռացիոնալներովդ	մրեժովդ	Possession
ոսկեղենդ	աբստրակտներս	Case
հռչակավորներումդ	հացահատիկովդ	Possession
հարգանքներիցս	գուջարաթիիս	Possession
երգեհոնիդ	լամաներիս	Case
վրացերենս	բորշչերդ	Case
չբարբաջի	կքելեք	Tense
աղեղնավորս	խորհերումս	Possession
բայոցներիցդ	կաֆեդ	Possession
թլփատ	եռաց	Tense
խնամներից	չափածոներումս	Number
մեծացե՛ք	վառվեցիք	Person
կտակը	մզկիթներ	Case
վիճաբանեցիր	վիճաբանեին	lemma
թավուտդ	ստորակետերը	Case
չըմպենք	կխանդես	Tense
կհուսահատեցնեն	չարյունահոսես	Tense
սվին	արագացմանը	Number
թուլիումներիցս	արկիս	Possession
ջերմաչափներիս	պանդոկովս	Possession
վաճառասեղանումս	ռուսաստանցուդ	Number
ցինկս	մզկիթներ	Case
կողոպտեմ	կդողային	Tense
չգեղգեղած	չգեղգեղեցի	lemma
կզննեինք	թողություններումս	Number
ատոլներումս	պլորիս	Possession
վրացականին	նոյեմբերյաններիս	Case
հայցե՛ք	պատառներով	Number
կաշկանդից	խտղտանքներիցդ	Case
չտրամադրեի	կապացուցեն	Tense
կապտավունումդ	կուրսերդ	Possession
կատակագուսաններ	մեքսիկդ	Case
կարիք	գաղափարին	Number
ռադիոգալակտիկաներիցդ	ռադիոգալակտիկաներիդ	lemma
չմիացրիր	միացնող	lemma
իռլանդերեն	ծովափղերը	Case
ծոցատետրեր	փաշաներով	Number
սումոյիցս	համերգասրահներս	Possession
հեգեք	ղափամաներիս	Number
անդրկովկասցունս	յոգաներումդ	Number
օդաչուներիցդ	ջայվովդ	Possession
կեչուցդ	ճամփորդներ	Case
գոնադովս	վերմիշելներումս	Possession
տնօրեններովդ	միլիոնատերիցդ	Possession
չկիսեք	զրուցե՛ք	Person
կպայմանավորվեն	չհարգեիր	Tense
հելնեինք	տեգրականայք	Number
անկանելիք	չանկանեցիր	lemma
չսահմանեց	կփչեր	Person
գներ	գնեն	lemma
կպայմանավորվեն	չմիզեմ	Tense
դեղատներից	սեպից	Case
հեղուկներումդ	ոլործունիցդ	Possession
նեպտունիումներիս	թանս	Possession
թթվի	բամբասանքներիս	Case
նվազներովդ	բրդյայիցդ	Possession
շաքարներդ	մսան	Case
չսլանային	սլանալիս	lemma
լիբրացիաներիդ	թաքցնեն	Number
խանությանս	հոբելյարներին	Case
հանգես	չճկեցիր	Person
խոպոպավորներով	խոպոպավորովդ	lemma
մորալիստներովդ	բախչադ	Possession
վայելեմ	կօթեք	Tense
մեներեններիս	կատարյալիցս	Possession
խայրիում	գեղարդովդ	Number
քեֆերին	ազատութիւններումդ	Number
վրդովեմ	չփութացի	Person
մորաքրոջիցս	ունակներից	Case
ապրուստներս	ազատութիւններումդ	Number
բարվոքս	բարվոքներովս	lemma
հոգնակիներիդ	թեորեմիցդ	Possession
կխոչընդոտեին	ներբեռնես	Tense
չաղացի	սլովակերենովդ	Number
չափահասների	կալբասներովս	Number
շփոթեցրիք	կգոլանաք	Person
թեկնածուներին	վինիս	Case
մրմնջացիր	չծփես	Person
ազատանում	հեռուստաընկերություններումդ	Case
կցտի	խօսէք	Tense
լեռնայինովս	ուզբեկներս	Possession
հավաններիցս	հավաններ	lemma
փապերիդ	կենացումդ	Possession
էլեկտրոլիզիցդ	սաղավարտներովդ	Possession
արեգակնային	ֆրանսերեններդ	Case
ոլորներումդ	թմրամիջոցիդ	Possession
չմղձկացիր	մղձկացող	lemma
կհպարտանայիր	չճմռեն	Tense
կստիպեի	արթնանան	Tense
ծառայությամբս	սխտորներումս	Possession
լացերիցդ	լացերիդ	lemma
ժողովածու	անվճռականներ	Case
չաղացի	տանուտիրոջով	Number
լուսանկարներովդ	ձախիդ	Possession
ֆարերցուդ	լոլիկներովդ	Possession
ճիրանդ	պոռոտաբանություններիցդ	Possession
քարմանիցդ	թոթովներիցս	Case
կաշառեր	կնեխեք	Tense
պորտապարում	դրույլներումս	Case
ածանցդ	սկանդիումներիցդ	Possession
չերկնչի	կհորջորջենք	Tense
գանգրանմանիցս	մորալիստներովս	Possession
կառկայծենք	չպատկերեիր	Tense
չխօսես	կխօսէիք	lemma
շնորհեք	կկախեի	Tense
կպղծեր	կորնչեց	Person
արդուկեք	կտակեցիք	Person
չմալեցինք	նեղաց	Tense
չուղեկցի	սարքավորմանդ	Number
չկռթնող	չկռթնեիք	lemma
սաթերին	խոպոպացմանս	Case
կոկովներիդ	սառցալեզվակումդ	Possession
արդարացնեինք	չարդարացրի	lemma
ռազմիկների	ռազմի	Case
զորեղներդ	կոմունիստականս	Case
գտածոներումս	տասնամյակում	Case
քառյակը	ջերմուկներ	Case
կղկղանքումդ	սլավոնականներումս	Case
բրիչովս	ծայրահեղականով	Number
պրոլյուվիալովս	երիկամունքիդ	Number
մոդայումս	մտրակներումդ	Case
կցտի	հատակեիք	Tense
խաշումս	հալոցից	Number
նստարաններովս	լահմաջոս	Possession
հոլդ	հնդկընկույզներովդ	Possession
ռեֆորմներից	լիսեռից	Case
կէթաս	քոչեին	Tense
պարաբոլիս	մղոններին	Case
ճոռոմներիցդ	ծխնելույզից	Case
կհակազդես	չնախանձեին	Tense
ծերունովս	ճաճանչը	Number
կշարունակի	բողբոջենք	Tense
մոլեգնենք	կբաղխեիր	Tense
հուսալքելիք	չհուսալքեցիր	lemma
կչորանայիք	չարաշահի	Tense
չկանխամտածվեցին	հայթայթ	Tense
ապացուցեցի	չկարեկցեմ	Person
չգործարկի	գուրաց	Person
վերազգայինումդ	դրույլներումս	Case
կանկանս	բորշչերդ	Case
թանացի	չչորացնեմ	Person
մղձկան	երգիծեցին	Person
ժանտախտից	ժանտախտը	lemma
կշեշտեք	համակարգեր	Tense
գիտակցի՛ր	գիտակցում	lemma
կլիզես	շիջեցիր	Person
զգուշաց	զեղծեցի	Tense
չփախավ	նեղաց	Tense
մոխրագույնիս	կղմինդրների	Case
պրոտոններովդ	պարտավորություններումս	Number
տեւեք	կխռմփացնեմ	Tense
չաղատես	կաղատեիք	lemma
հոտոտեի	ամրոցումս	Number
լումայովս	կալեիր	Number
աջաբսանդալը	քարփիչներ	Case
ատելիք	չատեցիր	lemma
կտռզենք	ագռավացանք	Person
չծպտվեցիք	երթայիք	Person
սեղանատամներումդ	նորվեգերենումս	Case
վերնագրովս	լրատուներովս	Possession
սանտիմետրիդ	վաստակներին	Case
չուվաշերենով	տանուտիրոջով	Number
թեկնածուներին	գետաձիուս	Case
փքուններդ	աղվանիդ	Possession
շենք	աբստրակտներս	Case
չըղձա	վերակացուիդ	Number
հազիդ	քեռակիններիս	Case
առերեսվեի	կգլեք	Tense
փքվենք	կխածի	Tense
չափահասների	սալորենիներում	Number
չերկբայանայի	աներկյուղովդ	Number
եպիսկոպոսներով	խրատներիս	Number
մետաքսյաներումդ	մետաքսյաներումս	lemma
աքսորակցովս	չաթլախներս	Possession
կէթաս	բողբոջենք	Tense
գաղձերդ	կուլերովս	Number
բալետովդ	լուվերենում	Number
կհոսի	չկաշկանդեց	Person
գուժումներիցդ	ներողությանդ	Possession
կոկովներիդ	վուշիցդ	Possession
բոլշեւիկներին	աքսորյալիդ	Case
բաջաղեինք	կամբարտավանի	Tense
կտարվեին	մեթոդներից	Number
չփսխեցիր	փսխող	lemma
խրոխտանքներին	երշիկիս	Case
հեծանոցիցդ	կայսերապաշտին	Number
արսեն	ծովափղերը	Case
պարավանդին	ամորձիքներիս	Case
բեգեմոնդովդ	հատիկներիցդ	Possession
աբստրահվեիր	կաճեցնենք	Tense
ճոռոմաբանականներիցս	մեռելից	Case
դեղնավուններովդ	խուճուճումդ	Possession
օդանավակայաններդ	ոլործունիցդ	Possession
մորալիստներովդ	թմրամիջոցիդ	Possession
ալպինիզմդ	բեռնյաններովդ	Possession
մրեժովդ	անրջայիններդ	Possession
չսպանեն	սպանեցիք	lemma
էջից	էջը	lemma
լիբրետոներիս	հունավորովս	Possession
թեորեմիցդ	տանուտիրոջով	Number
քիմքը	կռթունքիդ	Number
հեծանոցիցդ	սեքսիզմումս	Number
ամպեղեններումդ	ամպեղեններումս	lemma
կվհատենք	կռկռացինք	Person
նախածանցները	անկվածդ	Case
թլփատեիք	կքորեմ	Tense
լուսնումս	իշառվույտներիցս	Possession
կնքեց	կնքի	lemma
օգտագործումներումդ	թնդյունդ	Possession
մսալիիցս	առաջավորում	Number
լոբիդ	քալամներիդ	Possession
գեղջուկիդ	գրյանքների	Case
պայտերումդ	գրատախտակդ	Possession
գլխատառերով	գլխատառերում	lemma
ցուցակիս	թացերին	Case
քանդակներ	ակնածալիցդ	Case
տապիոկայիցդ	մահմեդականներովդ	Possession
օդապարիկդ	կաղապարներումդ	Possession
սիբիրախտերումս	կոմբայնումդ	Case
ձայնադարձերիդ	քյամանչայումդ	Possession
կապտավունումդ	մահմեդականներովդ	Possession
դարսի՛ր	կլանեցիր	Person
բրուցելյոզներումս	երախայրում	Case
աժդահայիցդ	պոկերներիցս	Case
նախածանցները	պնակ	Case
կիրառվենք	կկատարեր	Tense
չվարեցի	գոգ	Tense
գեջերումս	կատարյալիցս	Possession
հոգնակիներիդ	մրեժովդ	Possession
հեղուկներով	հեղուկի	lemma
կխօսամ	լրջանայիք	Tense
համովիս	համերգասրահներին	Case
մորալիստներովդ	ալիբիումդ	Possession
փութացե՛ք	չմրցեիք	Person
կրիս	նադիրներիդ	Case
կպայմանավորվեն	չէտես	Tense
շռեց	հետեւի	Person
չշիջուցանենք	կբաղխեիր	Tense
նեխեց	կգարշի	Person
կպոռոչեիր	չագռավանանք	Tense
տժվժիկներովդ	զովումդ	Possession
բարվոքիցս	չեչեներեններս	Possession
հարցմանդ	ավետիսից	Number
ոլորանս	գնդակահարություններ	Case
անձնանունների	ռազմի	Case
շարժիչիցդ	տանուտերերից	Case
դարպասաձողումդ	անթառամներիդ	Possession
սխտորին	քարփիջովդ	Number
նախածանցները	մեքսիկդ	Case
կարճավունս	բույներումս	Possession
կհեռեր	պաճուճաբանին	Number
լիբրացիաներիդ	կճոռոմաբանեին	Number
պղնձիս	մյուոնում	Number
հայցե՛ք	չստրկացնեն	Number
հորդորանքներս	թլփատություն	Case
չխոցեինք	կամբարտավանի	Tense
սխալվեինք	կզգածվի	Tense
ամպարներից	թողություններումս	Number
ահաբեկվենք	կխոցեիր	Tense
կփայփայեինք	հարցազրույցներումդ	Number
չբացառեցի	տգետին	Number
հակասեմիտականություններս	փուշդ	Case
սպասարկեր	չհարեց	Person
չնազեցիք	գլտոր	Tense
կվհատեցներ	գուրաց	Person
մատյանիցս	նատրիումներս	Possession
փռշտոց	շեքերս	Case
մալդիվերեններիցդ	կտրոնից	Case
ոլորանս	ճամփորդներ	Case
մավիս	բույներումս	Possession
կօժանդակեմ	երկմտեք	Tense
խանձատեց	գլտոր	Tense
արձակուրդ	գոսերդ	Case
հյուս	չհրապուրեց	Tense
մահմեդականներ	բնակիչս	Case
չաճես	շշնջա՛	Person
տանձենիներիդ	օսեթերենիս	Case
բոցիցդ	ծլիկովս	Number
պիտույքովդ	որձաքարերիցդ	Possession
աբուռիցդ	հռոմեականներից	Case
գրգռ	չբռնաբարեցին	Tense
կհեծեծենք	չէտես	Tense
կամեցավ	համակարգ	Tense
անթացուպիդ	հալվայից	Number
կոլաժներս	պանդոկովս	Possession
փոխարինի՛ր	կծնեիր	Person
վիրաբուժությունովս	անհույսներս	Possession
գոչերումս	բանակցությամբս	Possession
վրացերենս	ազգանուններ	Case
սեղանատներ	շառաչ	Case
մուրուքը	մուրուքի	lemma
կկասկածեն	փոխարինեիր	Tense
հոտեն	կդատապարտեիր	Tense
չգիտակցեինք	գիտակցե՛ք	lemma
երկնչոտով	ենիչարիիդ	Number
խանձատեց	հայթայթ	Tense
չձգտեք	կտակեցիք	Person
համբարձումներս	արկիս	Possession
չպագած	չպագեմ	lemma
չաջակցեիր	կապացուցեն	Tense
համովիս	ներարկիչների	Case
չկռնչեն	կհաճախեցնեի	Tense
ապահովվեց	չկիրառվի	Person
կանչեր	կանչեն	lemma
տառապելիք	տառապեց	lemma
անհրաժեշտներում	անթայրումդ	Case
գբերս	կարելիդ	Case
բաստուրմայից	ժպիտներիցս	Case
բացառե՛ք	պատառներով	Number
խոշորացույցիցս	պարսավանքներումս	Possession
հորանջների	վախկոտին	Case
հեղձամղձուկներիցդ	մրեժովդ	Possession
կաբստրահվեիք	պետերը	Number
չքշեցիք	գոգ	Tense
մանգաղներիս	փաշաներով	Number
կխրտնեմ	չթաքցնեիք	Tense
հիասթափվի՛ր	չպարապեցիր	Person
կելտեր	բուսակերների	Number
կէթաս	քելենք	Tense
հապաղիցս	մորալիստներովս	Possession
չապաշխարեցիք	ծփեիք	Person
կեպերեի	մոռս	Number
չվրդովվեինք	կկործանես	Tense
կհրապուրենք	կհրապուրես	lemma
կանիծեիր	չճմռեն	Tense
չինգաչունգի	պողովատիցդ	Number
քվեարկողիդ	մանվածքայինների	Case
հմայի	կաներկյուղանանք	Tense
վայելեմ	կգնահատեին	Tense
բեգեմոնդովդ	գանձարաններումդ	Possession
կազազեիք	չստեցիք	Person
ձերբակալիցս	չվերթներից	Case
փալասիցդ	բլոջներից	Case
չեխերենը	բնակչությամբ	Number
հատապտղում	տագալոգ	Number
հավեսս	հավեսներովս	lemma
ախտարարս	կարագները	Case
կպոռոտաբանեք	կարեկցե՛ք	Person
կագուցանենք	չարաշահի	Tense
նվագախմբերումդ	առեղծվածիդ	Possession
միկրոօրգանիզմից	կոստղովդ	Number
տառապի	կսգաք	Tense
չմտադրեիք	կավելացնի	Tense
խռթացրեց	զեղծ	Tense
ձաղե՛ք	դատապարտեցիք	Person
նորույթումս	թույլերս	Possession
լուսնումս	չորերիցս	Possession
գրանիտներովդ	ցանկապատովդ	Possession
սեւամորթիցդ	տանուտերերից	Case
ճոռոմախոսեն	չլուցեցին	Person
պուպուլիցս	վհատականներիս	Possession
առաքինություններս	փականը	Case
չողջագուրեիք	դեւերիս	Number
սիգաներիս	լեհովս	Possession
ամբարտավանանաք	կխածի	Tense
կքաքեի	չցտեցի	Person
չկոշկոճեցի	օգտագործեի	Person
ապացուցեցի	կշիկանայի	Person
մոլեգնենք	կզգածվի	Tense
արամբիները	երգչուհիդ	Case
ցերիումը	զուգահեռագծեր	Case
թերասնում	ֆրանսերեններդ	Case
փարթամագեղներում	խեցգետիններս	Number
մարսողությունը	աբուռներ	Case
ազգականդ	կոստներ	Number
լեռնայինովս	լեցուններիցս	Possession
պղնձաձույլից	պղնձաձույլներդ	lemma
ձախլիկ	նվարտանները	Case
կհպարտանայիր	մոռանանք	Tense
առաքինություններս	էլեկտրոն	Case
խորովող	խորովի	lemma
կղզի	կզոդեիր	Number
երկնչոտով	կհալածես	Number
կթրեիք	օրթախներովս	Number
բոցով	ամլիկը	Number
չոլորակեցիր	կոլորակես	lemma
տաղտուկում	պոռոչագիններումդ	Case
հետազոտելիք	չհետազոտեցիր	lemma
նեխեց	կտրոհեր	Person
պահապանիս	համերգասրահներին	Case
մեծանձնիցդ	անագանով	Number
հալեմ	կսգաք	Tense
վիզաներիդ	պսակիցդ	Possession
փախլավան	ղայիշներդ	Case
պնդերով	պնդերում	lemma
աբսոլյուտներիցդ	խորթդ	Possession
օգոստոսյաններիցդ	օդանավակայանից	Case
զայրուցների	չստրկացնեն	Number
կծվերումս	մամբոյիս	Possession
տատիկ	ակնոցներդ	Case
տիեզերագնացների	օտարոտիներովս	Number
կարկանդակ	հանդերս	Case
չբուծանեցին	կլողանան	Person
կհեծեծենք	հեռացնես	Tense
հիասթափվի՛ր	չունկնդրեցիր	Person
չհերքվեն	կհաճախեցնեի	Tense
աբստրակցիայում	կվասին	Number
բաջաղեին	բաջաղեցինք	lemma
շարունակ	գիտակցեց	Tense
բեկտող	բեկտեցին	lemma
խանությանս	սպերմաներիդ	Case
արտասահմանումս	փայտածխիդ	Number
ցուցանակիդ	կախով	Number
հորդեց	հորդի	lemma
բարձիթողիիցդ	թարխանաներդ	Possession
ճանճերդ	խոնավավունիդ	Possession
կզանգահարեիք	զրուցե՛ք	Person
չդրսեւորվեք	կդրսեւորվի	lemma
տպիչից	արծվիներիցս	Case
պիտույքովդ	պերճանքներդ	Possession
բրուցելյոզներումս	կաղնումդ	Case
քոշից	աշտեններիցդ	Case
մացառուտիցս	դելֆիններիցդ	Case
թղթադրամ	տգետին	Number
լոուրենսիումներին	ներկայացուցչության	Case
աշակերտուհիներովդ	ավտովարորդդ	Possession
տասերորդից	այծենիում	Number
կլիմաների	չթլփատեին	Number
ցեծերիցդ	հիգիենայումդ	Possession
թոռոմեց	չկարծի	Person
քննություններովս	մարոժնիս	Possession
ռացիոնալներում	տիեզերագնացներիս	Number
աղբուտներիդ	սենդվիչներով	Number
փոխհատուցես	լկստի՛ր	Person
նստարաններովս	խմածիցս	Possession
տաղտկացավ	գոգ	Tense
չմտադրեիք	կկանխամտածեմ	Tense
կկանչեին	մղես	Tense
անհանգստանանք	կկիսես	Tense
կդիեիր	չպարապեցիր	Person
կշարունակի	դատապարտեիք	Tense
հեգող	հեգի	lemma
չշտապեք	կշտապի	lemma
փլեցին	նեղաց	Tense
աղբուտներիդ	կուլերովս	Number
չհայթայթեիր	կլրթանանք	Tense
ճոպանովս	ստորիններիս	Possession
կուրումս	ահաբեկչություններովս	Possession
լիանան	կմրմնջայիր	Tense
կծղրտայիր	մարքսիզմովդ	Number
բարձիթողիիցդ	հեշտոցներումդ	Possession
կարկանդակ	թալիբներս	Case
հոկտեմբերյաններումս	ոսկեծաղկիս	Possession
ջրաղացը	թալիբներս	Case
կծղրտայիր	դալարուտիցս	Number
մտաբերեցի	չամորձատեի	Person
օթոներիցդ	լիգայումդ	Possession
չարաչքիցս	նվաղեց	Number
կոմսը	պաճիճներդ	Case
գաղձերդ	չմատնեք	Number
կնախընտրեիր	պահածոյանանք	Tense
կփլվեն	ունկնդրեմ	Tense
չշարժվեիք	դատապարտեցիք	Person
հերոսականներդ	կարտոֆիլս	Case
հալումաշովդ	տերունիներիցդ	Possession
չտեղեկանան	կլողանայի	Tense
արգելոցներիցդ	օդանավակայանից	Case
թուլիումներիցս	չափածոյովս	Possession
բրիտանականումդ	ակորդեոններում	Case
նանիներովդ	ներողությանդ	Possession
գնոստիցիզմ	եկեղեցականներ	Case
հղիովս	չաքուչներովս	Possession
նախուտեստներին	թամբիդ	Case
չուսուցանեիր	կբարբառենք	Tense
հաճախություններիս	կաղապարս	Possession
դեզօքսիռիբոնուկլեինաթթուներումս	փորձերից	Number
կխիթայի	ունկնդրեն	Tense
չապշես	կապշեիք	lemma
կարիք	չթարթեց	Number
անձնավորներիցդ	երկայնաբանություններով	Number
խանծերիցդ	ձորիդ	Possession
տրամաբան	հիփհոփիցս	Number
գեջերումս	տապակովս	Possession
չագարակացնեի	բարձրաձայնեցի	Person
տես	տեւեցինք	Tense
չխոպոպեցին	հայթայթ	Tense
հումերդ	ներողությանդ	Possession
բնույթներից	կտրոնից	Case
փռշտոց	վիթերս	Case
մեղեխիդ	կապուտս	Number
կառավարեն	ծաղկակաղամբներս	Number
կկշռադատես	գաղափարում	Number
չքշեիր	սպերմատոզոիդիդ	Number
շիկանա	կվախեիք	Tense
բորբոքեինք	չբորբոքեցի	lemma
անհրաժեշտներում	հնդկերենումս	Case
մկնիկդ	կալեր	Number
չուղեկցի	տասերորդով	Number
կթռնեք	էտեմ	Tense
կքծնենք	չըմպեցինք	Person
ճոռոմներիս	մեռելոտումս	Possession
կարմրավունդ	կպչուններիցդ	Possession
մուրուքիցդ	հաղարջենիներիցս	Case
թրթուրներումդ	ձեւանմուշումս	Case
կահագնանաք	առջեւները	Number
մավիս	լվերովս	Possession
կզրնգար	չշպրտեք	Tense
թվահմայություններովդ	թնդյունդ	Possession
կգրադարձի	չճմռթեինք	Tense
փչացավ	փչանա	lemma
չխորովեմ	պաղատեցի	Person
անձնանունների	մանվածքիս	Case
չխոստանաք	կխածի	Tense
ղպտիականներովդ	դուզնաքյաներով	Number
օտարովդ	մահմեդականներովդ	Possession
արսեն	պորտվեյններդ	Case
կհոսի	լրտեսեց	Person
հրեղենիս	շակալներովս	Possession
կլքնենք	չջղայնացրինք	Person
ստիպեցիր	չբարբանջես	Person
ակնածելիներին	բորշչիս	Case
տես	նազեցին	Tense
բեգեմոնդովդ	պերճանքներդ	Possession
հարբեց	գոգ	Tense
կալեիր	բանեցրիր	Person
ծարավիի	կհալածես	Number
կայաններս	նախանձոտդ	Case
գազաններովդ	պարսկականիդ	Possession
կխօսամ	քերծեք	Tense
չգնահատեիք	փաշաներով	Number
անօդաչուումս	հսկաներովս	Possession
կկալնեն	չբաժանվեիր	Tense
մոգոնեիք	չկատաղեցիք	Person
գրգռեցի	գոգ	Tense
չնախընտրեցինք	օթեն	Number
ճոռոմաբանականներիցս	քեֆից	Case
չհատկացնեմ	հատկացներ	lemma
թաթուլովդ	խակերդ	Possession
կապտավունից	ամրակազմներիցս	Case
կշիջուցանեք	չհեռեի	Tense
խղճաց	խղճա	lemma
պղինձներ	ամորձապարկերից	Number
կտանջեիր	շիջեցիր	Person
ահաբեկվենք	կբաղխի	Tense
հելնեինք	դեկտեմբերներին	Number
գլտորեի	կբզզաք	Tense
ճավայերենումս	իշառվույտներիցս	Possession
կվարեք	չսգար	Tense
շարադրություններիդ	նիդեռլանդերենիս	Case
բռնաբարեցին	չորոճեին	Person
ենթակայականից	ֆինլանդուհիներից	Case
անդյաներից	աստղադիտակները	Number
ալկոհոլների	քաբաբիս	Case
արամերենիցդ	որմնախորշերիցս	Case
չփոխարինեիր	ջղայնացրիր	Person
հոտոտեի	մարզիցս	Number
մրսեիր	շշնջա՛	Person
փախլավան	ջերմուկներ	Case
կդարբնեք	տարբերեի	Tense
կամարդ	եղծերիդ	Possession
գանգուրիդ	հատիկներիցդ	Possession
չընդգծի	հեծավ	Person
ցեծերիցդ	ազերիդ	Possession
ցավացող	ցավա	lemma
անապատականս	չհորանջեցի	Number
մորալիստը	մորալիստի	lemma
սանտիմետրիցս	սաղմոններումս	Possession
աղքատներով	աղքատովդ	lemma
հերոսականներդ	աբսուրդը	Case
հաղթի	ինքնավարների	Case
կենսալիրների	հակասեմիտականությանդ	Case
չկախարդվեցիր	օմբուդսմենին	Number
ընթացաք	կերցնեիք	Person
ազգականդ	արագացմանը	Number
խիթաք	չստեցիք	Person
կախակապումդ	ակորդեոններում	Case
հապավմանը	գուսաններիդ	Case
կղզիներից	կոնքիցս	Case
շիկանա	կկռանանք	Tense
մարսողությունը	ակնոցներդ	Case
աջաբսանդալը	տղամարդիկս	Case
բեգեմոնդովդ	շտանգաներիդ	Possession
կծնեն	չհամակարգեի	Tense
ալտի	կսաղացներ	Number
զովերդ	զովիս	lemma
չեփեիր	կհորջորջենք	Tense
գաղափարագրերում	ղազախերենումս	Case
ամբոխներումս	բրոմիս	Possession
ծեփեցիք	պոկերներից	Number
յանիչարից	խեչակներիցս	Case
շարժիչիցդ	փաշաներիցս	Case
ապահովիցդ	չհատեմ	Number
տպիչից	հայրատներիցդ	Case
չխոստանաք	կկազմակերպի	Tense
հոգեբանությունների	փորձերից	Number
չնախընտրեցինք	կայծքարերում	Number
չթաղես	կբարբառենք	Tense
իրավազուրկումդ	սլավոնականներումս	Case
նավահոս	ազգանուններ	Case
անսովորներիցս	կոսմոպոլիտականումս	Possession
առաջադրանքներիս	կուրծի	Case
սեղանատներ	ֆրանսուհիս	Case
կսուզի	բառապաշարիցդ	Number
ցենտներումդ	լոլիկներովդ	Possession
կշրջվեիք	չհիմնավորեմ	Tense
կղբենիները	իրականությունս	Case
արաղով	բոսորումդ	Number
կտենչար	երկմտեք	Tense
մզկիթներիդ	կնյունումդ	Possession
չկենդանանայի	արմացա	Person
իրավից	խտղտանքներիցդ	Case
արածի՛ր	բանեցրիր	Person
ապուխտում	ցիկլոններումդ	Case
մկնիկդ	հայրենյացումս	Number
լինգալայումս	տակառներումդ	Case
կվրդովենք	կվրդովես	lemma
մասրենուցս	օղակներից	Case
ոլորներումդ	պսակիցդ	Possession
չփարթամանար	տգետին	Number
մարխիդ	լուսամուտներումդ	Possession
կկողոպտեք	գովե՛ք	Person
կապահովանայի	ունկնդրեն	Tense
աբսուրդներումդ	ջրկոտեմում	Case
տժվժիկի	արտագաղթերի	Case
զսպանակներին	ձեղնահարկերիցդ	Number
պարմեզանդ	համաներումներ	Case
չհեռեցիր	ցավի՛ր	Person
կքրթմնջային	չգիտակցեմ	Tense
կուռեն	չվերադառնամ	Tense
ընտիրներդ	պնակ	Case
աշխարհամասերին	փետիս	Case
ցեծերիցդ	ալիբիումդ	Possession
ապահովեցիք	լուտայիք	Person
հոգնածությունիցդ	կուսանեմ	Number
կթրեիք	ձուղբերին	Number
փորի	կանխեց	Person
ճոռոմներիցդ	բաոբաբիցս	Case
վաճառականումդ	չգարշեց	Number
կգրադարձեմ	քոչեին	Tense
կիբեռնետիկան	ազգանուններ	Case
կշփոթվեք	չշիջուցանեի	Tense
հեստապարերիս	բարիքներից	Number
Թութունճեանին	նունուֆարներիդ	Case
տաջիկներիցդ	ձախիդ	Possession
սսկվ	սսկվեք	lemma
գոչերումս	ճնշումս	Possession
կհարկաներ	կանխեց	Person
ոսկեղենդ	հայկականները	Case
արգելոցներիցդ	գոչյունիցս	Case
սազես	կբխենք	Tense
չազդվեին	ազդվելիս	lemma
թերասնում	պատառները	Case
կվերծանես	չծլարձակեն	Tense
արևածաղկի	չհատեմ	Number
կառկայծենք	չզրնգայիր	Tense
ոլորներումդ	դուզիցդ	Possession
վախենա	վախեցնել	lemma
բորբերումդ	բորբերումս	lemma
բավարարող	բավարարի	lemma
փակերում	դեկտեմբերներին	Number
էականիս	լվերովս	Possession
միլիմետրումդ	ակորդեոններում	Case
մորուդ	մեծատառովս	Number
հունքուբունքերիդ	հերվանիցդ	Possession
նանիներովդ	ժամհարիցդ	Possession
մեծաբաններում	ջրկոտեմում	Case
ջազվեներիս	պորտուգալերենիցս	Possession
չխթանես	շշնջա՛	Person
բենզալցակայանների	կողոպտեին	Number
զսպանակներին	քաղցրերովդ	Number
գազաններովդ	մեներենիդ	Possession
բարվոքիցս	ստորիններիս	Possession
հապաղ	չկաշառեց	Number
մանվածքայինումս	շակալներովս	Possession
ձկնկուլները	էլեկտրոն	Case
կոստղաշատս	օգոստոսները	Case
կգրադարձի	չսիկտիրվեինք	Tense
չգիտակցվեք	կգիտակցվի	lemma
ստիպեցիր	չհրահրես	Person
ուժգինովդ	գանգրահերներդ	Possession
կփլեիք	ավանդե՛ք	Person
չվանկարկեիք	զրուցե՛ք	Person
տեղյակներդ	տերտերիդ	Possession
գազաններովդ	բույնիդ	Possession
հունարեններովդ	չխոպոպվեք	Number
Թութունճեանին	գուղձերի	Case
ոսկեղենդ	ծովափղերը	Case
կալեիր	չսիրւեցիր	Person
չնվագեմ	կբզզաք	Tense
անհրաժեշտներում	հաճախությունում	Case
խաշ	խրոխտագիններս	Case
հիր	ուզեցի	Tense
չզարմանան	զարմացաք	lemma
կզրնգայիք	չմեղկացաք	Person
աքսորումում	կաշկանդյալներում	Case
չթաղես	ընտրվեցիր	Person
հաճախություններիս	լաստենովս	Possession
քվարկներիս	կոկտեյլովս	Possession
ցերեկույթներս	թզուկովս	Possession
չհրապուրեինք	կոչումներովս	Number
չխոստանաք	կամբարտավանի	Tense
աղեղնավորս	սխտորներումս	Possession
կպոռոտաբանեք	չբղավեցիք	Person
արգելեիք	չարգելեցիք	lemma
ձիրքերումդ	մարզասրահումս	Case
ավտոբուսս	մարդելույզներդ	Case
շենք	նիզակներս	Case
արգահատի	սարքավորմանդ	Number
չմահանայիր	գիտակցվի՛ր	Person
կիզեիր	չպարապեցիր	Person
կելտեր	մատյաններիցդ	Number
լազերի	գործիք	Number
խորդուբորդիդ	լուվերենում	Number
չգոռային	վիզաներս	Number
մոտից	ավելուկներիցդ	Case
լիանան	կտրցակեմ	Tense
ոլորանս	կարեկցությունները	Case
հոլդ	տորմիղներիդ	Possession
կշրջվեիք	չգիտակցեմ	Tense
բիբարում	աֆղաներենովդ	Number
ասուպից	հրահրի՛ր	Number
ժանիքներիցդ	շահնշահներով	Number
կսառի	ճմռթեց	Person
շերեփներումդ	ժամհարիցդ	Possession
մոլուցքներիցս	անուշապուրիս	Possession
վախենայիք	չվախեցաք	lemma
գովի	քամեց	Person
չխեթկի	կներքինանանք	Tense
անհրաժեշտներում	հունարենումդ	Case
բոլշեւիկներին	ամեհիիս	Case
կշեշտեք	չձգտեր	Tense
չմահանա	քամեց	Person
հոյաշենովս	չաղոներս	Possession
կպահածոյանայի	չտռեք	Tense
չտարակուսեմ	կմտմտան	Tense
ցերիումը	գնդակահարություններ	Case
անձնանունների	անթիդ	Case
չհորջորջեցիր	լկստի՛ր	Person
ձկնկուլները	օյինբազս	Case
չընդոստեին	ընդոստելիս	lemma
կոստղից	ստվարաթղթերիցդ	Case
չերկբայանայի	ֆոտոնայինիցս	Number
ծնեցի	կարեկցեմ	Person
մահացաք	չտպեիք	Person
ըմպեք	չմեղկացաք	Person
կվարցիտների	ծիծառնուկին	Case
ճարտարապետությունը	ճարտարապետության	lemma
կառոգանեիր	չպարապեցիր	Person
չխոստանաք	կփութացնի	Tense
ուրուրդ	չոփերիցդ	Possession
մոլուցքներիցս	ածանցումս	Possession
տղամարդկանցս	կովլակիցս	Possession
կչափես	չփրթեցիր	Person
բիբարում	ավետիսից	Number
անհանգստանայիր	նվագեցիր	Person
մոխրագույնիս	օգտագործումների	Case
կտակելիք	չկտակեցիր	lemma
ուղեպարկերումդ	նորվեգերենումս	Case
բաղբանջի՛ր	կկշռադատեիր	Person
շտկեին	շտկեցինք	lemma
փռշտոց	ծովափղերը	Case
խճուղիների	երշիկիս	Case
ցունամիների	հակասեմիտականությանդ	Case
շարադրություններիդ	մանվածքիս	Case
ծխերի	պանթուրքիզմին	Case
վերարտադրությունից	ավելուկներիցդ	Case
վաճառասեղանումս	ներցին	Number
թրջեցիք	գոգ	Tense
գրգռ	չխոսացին	Tense
գործառնականս	գոսերդ	Case
կհոխորտայի	չհանձնեք	Tense
կեչուցդ	եկեղեցականներ	Case
կառկայծենք	չձգտեր	Tense
լերկեր	շառաչ	Case
արխիվներիցդ	անվտանգություններիս	Number
ստվարաթղթյաներումդ	առջեւները	Number
փութաջանությանդ	մժեղներիս	Case
բլբլար	քերծեց	Person
սխտորի	վրդովներիս	Case
կերերաս	հյուրասրահի	Number
մասնագիտություններս	կարելիդ	Case
չպահածոյացրած	չպահածոյացնեմ	lemma
տաղտուկներումդ	տաղտուկներումս	lemma
սրճեցի	կրեմ	Person
կստամբակես	ստամբակի՛ր	lemma
պագերի	պուճուրին	Case
կաշկանդիդ	լամաներիս	Case
խաբեբայություն	ծովափղերը	Case
աշխույժներիցս	աշխույժներ	lemma
քրիստոնյայից	ստադիոններիցս	Case
չոլորես	կհամարեինք	Tense
կառաքեմ	սսկվեին	Tense
ձաղե՛ք	կհուսահատվեք	Person
չթաղես	կբխենք	Tense
կլիմաների	կլեպները	Number
սաթերին	ռազմի	Case
ողորմեին	ողորմեցինք	lemma
օղողեցիր	զեղծ	Tense
ռուբլում	խցիկներում	Case
չտառադարձես	կաճեցնենք	Tense
խճուղիների	վինիս	Case
լեռնայինովս	ֆիլմերս	Possession
պարավանդին	դատողություններիդ	Case
հոխորտար	հոխորտան	lemma
սուրահներումդ	լատիշերենումս	Case
աշտեներդ	շառաչ	Case
կրաքարի	օգտագործումների	Case
գեջերումս	սրճահատիկս	Possession
արգելքները	էլեկտրոն	Case
կխօսամ	տոկայիք	Tense
թեյնիկներդ	ջայվովդ	Possession
գառնենիների	կուրծի	Case
ռուբլում	պոռոչագիններումդ	Case
պրոտոններովդ	երկկտտացնեք	Number
կողքդ	գնդակահարություններ	Case
կխնկես	չլափեին	Tense
ալկոհոլների	չաքուչի	Case
ակնածությամբդ	ձախողներիդ	Possession
սսկվեցին	հեգեն	Person
փռթկացնեմ	չսորեցի	Person
ծխերի	հռովմայեցուդ	Case
մեղկացան	կշարունակեն	Person
չկթեմ	կապացուցեն	Tense
կհարկադրեիր	չպարապեցիր	Person
ծերունովս	տասերորդով	Number
վայելեմ	կհրճվեիք	Tense
ոնորոշացավ	կռվի	Person
կտակը	ղայիշներդ	Case
շուշմայում	չբդկես	Number
կծնգցնեք	ընդոստեր	Tense
նայվածքումդ	տերունիներիցդ	Possession
չհարնչեն	կխոյանայի	Tense
զոդին	վրդովներիս	Case
չհամառեմ	համառեր	lemma
կծուլանաք	չհպարտանայի	Tense
հեղուկներումդ	թեորեմիցդ	Possession
խանծերիցդ	վարշամակիդ	Possession
կշրջվեիք	նախաճաշի	Tense
դպրոցականիս	դպրոցականովդ	lemma
արաբերենումս	ֆտորներս	Possession
ծխերի	վախկոտին	Case
չվարեիր	կբարբառենք	Tense
այտուցս	ծորաներումս	Possession
դեղատներից	նհանգիցդ	Case
երկնակամարները	գեղեցիկներումդ	Number
բաժանումովս	խազի՛ր	Number
բնորոշե՛ք	տախտակամածներովդ	Number
ձուլի	կլրթանանք	Tense
դելփինիս	սպերմաներիդ	Case
թուլանայի	գանգրվեցի	Person
արծաթներից	սազեն	Number
աբսուրդներումդ	անքաղաքավարությունում	Case
ծպտ	ծպտեք	lemma
կաղկանձենք	կդատապարտեիր	Tense
հերքե՛ք	փորձերից	Number
ծնեցի	կփսխեի	Person
քոռում	զորեղներումդ	Case
լազերի	թեորեմից	Number
բուսաբաններիդ	քաբաբիս	Case
գնենք	կզոդի	Tense
բողոքարկեմ	ահազանգումիցս	Number
պարանիս	բունոցներիդ	Case
ալտի	անատոմիան	Number
կրոնականներդ	չափագիտությանդ	Possession
մեջտեղիդ	շարժումում	Number
բնակչությունիցդ	կջղայնանայիր	Number
չհերքվեն	կտշես	Tense
կկալնեն	տարբերեի	Tense
բնույթներից	թուրքմեներենից	Case
չվեցին	գլտոր	Tense
հայհոյեցիք	քչքչաց	Tense
կլիմաների	բարիքներից	Number
չկիրառվես	շշնջա՛	Person
լյարդի	գուղձերի	Case
չփլենք	կռկռացինք	Person
մխիթարեիք	չստեցիք	Person
կարողանային	կարողացանք	lemma
չարկանեցիր	բավարարես	Person
պերճանքում	աշխարհամասերումս	Case
հորդեցինք	նեղաց	Tense
չհեռեցիր	կուսուցանես	Person
հնարամտություններդ	բրդյայիցդ	Possession
խելոքներովդ	հերվանիցդ	Possession
երամակների	չաքուչի	Case
գոչի՛ր	գոչում	lemma
ինքնահավանեք	կարեկցե՛ք	Person
խճուղիների	ռազմի	Case
մոռացոնքներին	ոստանիկներովս	Number
ֆրիզերեններումս	տասնամյակում	Case
սանտիմետրիցս	շանթամբոխներովս	Possession
գանգուրիդ	խեղություններիցդ	Possession
չսփոփվեցիր	կսփոփվես	lemma
մկնիկին	սկալդդ	Number
կզղջա	լողանայիք	Tense
խմբագրող	խմբագրի	lemma
կառաքեմ	չլափեին	Tense
կուրախացնեինք	չարդարացնի	Tense
վերուվարներից	աչալուրջները	Number
գոչյունից	բլոջներից	Case
մեներեններիս	պորտուգալերենիցս	Possession
միջատաբանականումդ	խեղություններիցդ	Possession
հապավմանը	կռիչքներիդ	Case
կիվին	պորտվեյններդ	Case
մեներեններիս	գյոթովս	Possession
շարունակ	ծնվեցինք	Tense
ուլունքին	կղմինդրների	Case
խնամեր	խնամեն	lemma
պանդոկներիդ	երկաթեղենովդ	Possession
չփոխանակեին	կտշես	Tense
բողոքարկեմ	սլովակերենովդ	Number
եպերներովդ	ծաղկակաղամբներս	Number
կագուցեիր	շշնջա՛	Person
պուպուլիցս	փախստյաներովս	Possession
ապարոշին	վիկինգովդ	Number
կիվին	քարփիչներ	Case
խմբագրեիք	չխմբագրեցիք	lemma
թեղոշներում	պետերը	Number
կողբա	մօտեցաւ	Person
չկեղեին	կեղեին	lemma
ծովահեններին	չուռթանայինք	Number
լոգացաք	կերկնչեիք	Person
մահմեդականներով	շղթաներս	Number
ոսկուց	ոսկիներդ	lemma
չհագեցիք	կարեկցե՛ք	Person
չբուծանեցին	կկոճկեն	Person
կհանձնեիր	գիտակցվենք	Tense
կապտավունից	ծախերիցդ	Case
արծաթիներից	սուսերամարտիկիցս	Case
լուծեցինք	բառնայինք	Person
արթնանա	պոռոտախոսեց	Person
օթարաններիս	բունոցիցս	Possession
փախլավան	փաստեր	Case
զանգ	զանգեք	lemma
կուռեն	չհեռեի	Tense
չթափվեցին	կլողանան	Person
կհրահրենք	ծայրերդ	Number
սազայիք	կխռմփացնեմ	Tense
կողքդ	ճամփորդներ	Case
ամպար	պորտվեյններդ	Case
ինքնահավանումս	հիվանդներս	Possession
հնախոսներիցդ	տարեկանումդ	Possession
ստոծանիներիցս	զառանցեք	Number
մեծաբաններում	անձրեւում	Case
չերերանք	կտարամիտեր	Tense
ահաբեկվեիր	կապացուցեն	Tense
այլեւայլից	թանաքս	Number
եպերներովդ	սալորենիներում	Number
բարվոքիցս	չաղոներս	Possession
շարունակեն	սառեցին	Person
չտարամիտեր	լրտեսեց	Person
դեղատներից	հելլենացուցդ	Case
սպրիչ	կռթունքիդ	Number
ատաղձագործներովդ	Բագրատունյացներիս	Number
հմուտով	կեղծին	Number
կմերձենայիք	չծաղրեմ	Tense
կուսաթաղանթը	հանդերս	Case
չաղացի	էջի	Number
լուտանքներիդ	թուրքերենդ	Possession
հրահրեինք	չհրահրեցի	lemma
կթլփատի	չսրտառենք	Tense
բոկոտից	բոկոտներդ	lemma
չպապանձեցնես	կպապանձեցնեիք	lemma
խեղդեմ	չհափափեցի	Person
կխոչընդոտեին	չկթես	Tense
կորոճաք	չծաղրեմ	Tense
ջինջիլներիս	գյոթովս	Possession
կոպեռնիցիումս	սուսերներիցս	Possession
գալակտիկականից	գալակտիկականներին	lemma
նախընտրեցի	համակարգ	Tense
չվարեիր	կախտորոշենք	Tense
արդյունքների	անվան	Case
կկշռադատես	աներկյուղովդ	Number
բրիտանականումդ	տափակներում	Case
զեղծեք	չքայլեցիք	Person
կրոնականներովդ	դեղձանումդ	Possession
սորային	երգիծեցին	Person
չտարակուսեմ	կճախրեիք	Tense
խելոքներովդ	խոնավավունիդ	Possession
թվահմայությունիցս	հայրատներիցդ	Case
բողովդ	հեշտոցներումդ	Possession
աշխարհահռչակդ	թռներ	Number
սավառնե՛ք	կոռնայիք	Person
բդիցդ	հաղարջենիներիցս	Case
մույթերում	նորվեգերենումս	Case
խալ	փույթիցդ	Number
մալդիվերեններիցդ	խարտոցից	Case
միմոսովս	գիտակցականություններս	Possession
կիրառվենք	կկիսես	Tense
չգոգեն	կհաճախեցնեի	Tense
կհղանայիր	չնախաճաշենք	Tense
լողավազաններ	ձուղբերին	Number
զարթնեիք	հաճախե՛ք	Person
հռետորաբանություններ	կարտոֆիլս	Case
հունարեններովդ	չոստնենք	Number
չկռնչայինք	կխանդես	Tense
ջազվեներիս	հումուսումս	Possession
կոնյակ	ալաբաստրներս	Case
ցինկս	զուգահեռագծեր	Case
գուլպաներիցս	ըղձականովս	Possession
նեպտունիումներիս	փիճխս	Possession
թամիլերեններիցս	թամիլերեններ	lemma
ասորիներովս	գթասիրտներիդ	Number
կոլգոտկայիս	բիոլոգիաներիդ	Case
չբարբաջի	կհրճվեիք	Tense
օգտագործումներումդ	միապետությանդ	Possession
չխորխեի	պաղատեցի	Person
նշանաբաններ	անկվածդ	Case
քայլեր	քայլեն	lemma
ամբարտավանանաք	կլողանայի	Tense
հայրերիդ	բորշչիս	Case
արքայություններս	գեղեցիկներումդ	Number
կվիճաբանես	չծլարձակեն	Tense
չթափվեցին	կկայանային	Person
մրուրը	չոգեշնչեցի	Number
զեղծեք	գովե՛ք	Person
կխրտնեմ	չզրուցեն	Tense
ռուբիդիումներում	ջրկոտեմում	Case
չտառադարձես	կողորմեին	Tense
աղբանոցները	երգչուհիդ	Case
ապառքիցս	չբդկես	Number
խայրիում	պաճուճաբանին	Number
հնարքներումդ	ծանրաբեռդ	Possession
կտենչար	կալնեք	Tense
կհողդողդեիք	հեկտարներում	Number
մոշավայրուցս	աղիքներումս	Possession
ջինջիլներիս	թզուկովս	Possession
սոցիալիստականդ	լոլիկներովդ	Possession
հանձնեն	կկարողանայի	Tense
նորապսակդ	իշղարներիդ	Possession
կհոսեի	չտռեք	Tense
ազդվեցի	չզեղեմ	Person
աբեղայականներումդ	սերմնաբուշտներին	Number
թանացի	քաղցեի	Person
հակասեմականություններից	շվեդից	Case
մաշկյակներումս	դեկտեմբերներին	Number
քաղեցիր	չփայփայեիր	Person
ռուսիցս	քավումդ	Number
չտառապեիր	համբուրվի՛ր	Person
հապավմանը	հորաներիս	Case
մթնշաղներդ	անդեորդս	Case
հոռովելը	մարդելույզներդ	Case
բարձրահասակից	բարձրահասակներդ	lemma
կիցիցս	բլոջներից	Case
պեդալներ	խրատներիս	Number
ջրաղացը	տղամարդիկս	Case
կծղրտայիր	արքայախնձոր	Number
պիլասոսիցդ	ֆինլանդուհիներից	Case
տապիոկայիցդ	արմունկոսկրերդ	Possession
ֆիզիոլոգիականներիցս	քոչերին	Number
չբլբլար	նախաճաշեց	Person
փակերում	անվտանգություններիս	Number
բառնայիք	տիեզերագնացներիս	Number
կելտեր	խտիղների	Number
մկնիկին	թաթում	Number
շփոթվածություններիցս	հանդիցդ	Case
բաստուրմայից	չվերթներից	Case
պրոտոններովդ	կհարսնացնենք	Number
հոտեն	կտշես	Tense
մնացականիցս	հերոսություններից	Case
չերկբայանայի	սիրուհուդ	Number
փտած	ջերմուկներ	Case
դեղատներից	բարիկադիցս	Case
հոբելյանականներով	հոբելյանականներում	lemma
հաստիչդ	ճանկերիդ	Possession
բաղարջումս	ճաճանչը	Number
մոդեմի	նունուֆարներիդ	Case
ջեռուցեցինք	չհեռացնեինք	Person
պայտովս	խորհերումս	Possession
բարբարոսովդ	գամփռներիդ	Possession
կեպերեի	մեծավորով	Number
ժողովրդավարությանս	կռինչներովս	Possession
բոլշեւիկներին	տոռնիս	Case
կոչող	կոչի	lemma
ուռթացի՛ր	ուռթանում	lemma
խաշ	շեքերս	Case
ստիպեցիր	չզեռայիր	Person
մզկիթներիդ	ոզնիդ	Possession
թլփատեիր	բեկտի՛ր	Person
չարկի	արկեիր	lemma
ցավա	կքելեք	Tense
տես	չսպասարկեցիք	Tense
կագուցանենք	չբուսնեիր	Tense
կարկանդակ	հայկազներ	Case
չկրեր	կզոդեք	Tense
չըմպենք	կշիկանայիր	Tense
կբզզամ	կեղտոտեիք	Tense
տեսակները	փուշդ	Case
տաղտուկում	սլավոնականներումս	Case
չերկբայեն	կերկկտտացնեի	Tense
սավառնե՛ք	կերկնչեիք	Person
քաջիցդ	առաջավորում	Number
օթեցիր	օթեին	lemma
կապահովանայի	չզրուցեն	Tense
անվճռականություններումդ	մեներենիդ	Possession
ախտարարս	պաճիճներդ	Case
սուրահին	ամորձիքներիս	Case
լիանան	կսպասարկեիր	Tense
թզուկից	ամրոցումս	Number
չփախցներ	մօտեցաւ	Person
չծափահարեր	բերիլիումիս	Number
կճանապարհորդեի	չքաքեք	Tense
նախարարին	մժեղներիս	Case
ավարներիս	ծուծին	Case
քեֆերին	յոգաներումդ	Number
աքսորակցովս	խոյերս	Possession
գանգրածածկների	երշիկիս	Case
կէթաս	գիտակցվենք	Tense
հրկիզեր	հրկիզեն	lemma
ուժգինովդ	անրջայիններդ	Possession
չափահասները	հորդորեցուցիչներիս	Number
ուղեկցեիր	նվագեցիր	Person
հումիս	խիզախներս	Possession
կպայմանավորվեն	նախաճաշեմ	Tense
բոլշեւիկներին	տոհմիս	Case
աթեիզմիս	ճոճաթոռներին	Case
կեպերենք	չկշռես	Tense
պատառի	պոռոտախոսեց	Person
առակախոսներիդ	կպոռոտաբանեիք	Number
վհատի	կարօտեց	Person
չտառապեիր	նվագեցիր	Person
փոխանակեցինք	գլտոր	Tense
իրականներից	լատվիերենիցդ	Case
շարժումներումդ	անձրեւում	Case
հալեմ	կհեղուսեիք	Tense
ատոլներումս	պորտուգալերենիցս	Possession
ձրիովդ	կսարսափեի	Number
չծափահարեր	սնդիկիցդ	Number
զովերին	կարեկցությանդ	Case
չքաված	չքավեմ	lemma
տարածքը	հատկանշիցդ	Number
որորներից	կաղկանձիցդ	Case
աբեղայականներումդ	աշխարհայացքներիս	Number
չբարելավենք	կապշեր	Tense
նախաբազկիդ	ինդիումներիս	Case
տաղտուկում	մտրակներումդ	Case
մակաշերտիցս	բացառականներից	Case
լամաներիցդ	բաստուրմայիցս	Case
շենք	կարեկցությունները	Case
պագերի	կարեկցությանդ	Case
ռուսիցս	կրկեսովդ	Number
կուսաթաղանթը	ճոռոմախոսներդ	Case
մարխիդ	հեթանոսներիցդ	Possession
գոլանանք	չջղայնացրինք	Person
մարթեց	մարթի	lemma
չկոշկոճեցի	կարեկցեմ	Person
կքերծեի	չսորեցի	Person
կտակը	հողմերս	Case
չկանխենք	պյուռոսյաններում	Number
դարսի՛ր	նվագեցիր	Person
քնապարկերիցդ	չերկայնեին	Number
կուռթեին	չպոռոչեցին	Person
չաբստրահեմ	գանգրվեցի	Person
մակաշերտիցս	դելֆիններիցդ	Case
ինքնահավանումս	շեֆխոհարարներս	Possession
շառլատանս	գլխատառերիցս	Possession
տիբեթերենումս	պարսերում	Case
կցտես	չփրթեցիր	Person
չբարբաջի	կախտորոշենք	Tense
չկառչեն	խածեցին	Person
կշփոթվեք	հղենայի	Tense
ըմպեք	ավանդե՛ք	Person
չսպանես	կսպանեիք	lemma
գիտելիքներումդ	ներողությանդ	Possession
չագուցանեինք	ագուցանե՛ք	lemma
ակրոպոլիսովդ	կարիքներումդ	Possession
մորալիստներովդ	մորուքիցդ	Possession
քաոսայինումդ	տափակներում	Case
արամբիները	բնակիչս	Case
Թութունճեանին	մարդելույզների	Case
տառապի	կաճեցնենք	Tense
բաջաղող	բաջաղի	lemma
փորի	հեծավ	Person
սանտիմետրիդ	զիբիլներին	Case
ջինջիլներիս	սիգաս	Possession
կոլգոտկայիս	յոգուրտներին	Case
գովի	չհոգաց	Person
հոնքս	ահաբեկչություններովս	Possession
հնարամտություններդ	առակախոսովդ	Possession
ճմլեմ	կգնահատեին	Tense
կլորավունս	վարտիքներումս	Possession
մտաբերեիք	կտրցակեմ	Tense
հարցմանդ	ծլիկովս	Number
չգոգեն	կխոյանայի	Tense
կասկածներում	ջրկոտեմում	Case
չապաշխարեցիք	կողբայիք	Person
փութաջանությանդ	առէջներին	Case
կեպերենք	չառերեսվես	Tense
կհոսեի	խօսէք	Tense
չկռնչած	չկռնչեցի	lemma
չշարժվեիք	կտակեցիք	Person
չըղձա	վայրագի	Number
լաոսերենիդ	նժույգների	Case
թխկուց	ժպիտներիցս	Case
կեղեցի	խածանեմ	Person
հոգեբանությունների	անորոշներդ	Number
երկնակամարները	կհարսնացնենք	Number
մեներեններիս	ակրոպոլիսումս	Possession
ընգե՛ք	լուտայիք	Person
հերոսականներդ	շառաչ	Case
բաշկիրերենը	բորշչերդ	Case
ջեռուցեցինք	չագարակացնեինք	Person
չխեղդեին	կտարբերեմ	Tense
արտեւանունքովս	կողպէքներս	Possession
տարեցներով	տարեցի	lemma
վայելեմ	կքելեք	Tense
ճոպանովս	խրոխտագիններիցս	Possession
կարտոֆիլը	ճամփորդներ	Case
կհոխորտայի	չսրտառեն	Tense
կհղենանք	չբարեւեիր	Tense
մահմեդականներ	մեքսիկդ	Case
ձողեր	շառաչ	Case
հղացանք	քամենք	Person
հալոգեններիս	նավակայանին	Case
չթափվեցին	խարխալեն	Person
ձերբակալիցս	բացառականներից	Case
խնամուցս	հռոմեականներից	Case
օրհնյալներս	տասերորդդ	Case
բիզնեսդ	երախտիքներիդ	Possession
կհողդողդեիք	պոկերներից	Number
չկռթնի	կռթնեիր	lemma
բդիցդ	արծվիներիցս	Case
ունկնդրեի	կմտմտան	Tense
չարմացաք	կերցնեիք	Person
հոնքս	ջաներիցս	Possession
հարբեց	ծնվեցինք	Tense
գանգրածածկների	շաուրմայի	Case
կշփոթվեք	չհրկիզեմ	Tense
չհերքվենք	կքերծեիր	Tense
տատիկ	այլանդակությունները	Case
խոհեմներդ	շառաչ	Case
մատյանիցս	չաթլախներս	Possession
ճաղիցդ	համարակարը	Number
հարիսայիս	հսկաներովս	Possession
կստիպեի	չպատրաստեն	Tense
ազգականդ	թեորեմից	Number
ավարերեններից	կտրոնից	Case
կհարնչենք	ծլարձակեիր	Tense
իշխանափոխությունիցս	կաղերիցդ	Case
կախարդվածությամբդ	ողորկություններովդ	Possession
հոտեն	կտրցակեմ	Tense
ամուսնություններովս	ստուգումումս	Possession
աբսորբենք	կդատապարտեիր	Tense
չծպտվեցիք	խօսէիք	Person
խեղանդամներիցս	խեղանդամներ	lemma
չկաղկանձեցինք	կսանրեինք	Person
ասուպից	կնճիթովդ	Number
հերոսականներդ	ֆրանսուհիս	Case
գլխարկովդ	շնորհներիցդ	Possession
լուրթերով	լուրթովդ	lemma
ձաղե՛ք	չարբեիք	Person
կփնտրեմ	չդատարկեցի	Person
պարանիս	լավերի	Case
ապիկներիցդ	սիլիցիումիդ	Possession
չբրթեինք	բրթե՛ք	lemma
պարանիս	գուսաններիդ	Case
կհուզես	ագուցավորեն	Tense
կմուրայի	գանգրվեցի	Person
իրավազուրկումդ	կաշկանդյալներում	Case
կսուզի	էջի	Number
բնույթից	ունիվերմագներից	Case
փախլավան	ճոռոմախոսներդ	Case
դիսպաշերով	բառապաշարիցդ	Number
չտառադարձեինք	տառադարձե՛ք	lemma
արուիդ	տասերորդով	Number
կճանապարհորդեի	չթովեք	Tense
ցացիկիումդ	պերճանքներդ	Possession
վրացերենս	ակնոցներդ	Case
կախող	կախի	lemma
կարանտիններովդ	ծնողդ	Possession
որսացի	չշահագործեմ	Person
խաժիդ	վաստակներին	Case
խաշ	քրիստոնյաները	Case
կվերծանես	չդատարկեինք	Tense
կտարվեին	թողություններումս	Number
չափահասների	գեյզերներից	Number
ճոպանովս	խուլիգաններովս	Possession
հոլանդականումս	զանգակածաղիկներովս	Possession
չկառավարած	չկառավարեմ	lemma
թենիցդ	հեշտոցներումդ	Possession
կհեծեծենք	չզրնգայիր	Tense
կլողանանք	կլողանաս	lemma
ամրակազմները	պնակ	Case
գելե՛ք	դատապարտեցիք	Person
կբդկեիք	գանգրացե՛ք	Person
պարավանդդ	սկանդիումներիցդ	Possession
սազես	կպարտվեին	Tense
կենցաղումս	սրերովս	Possession
անկումներովդ	ձախիդ	Possession
չթաղես	շիջեցիր	Person
հոտեն	կխանդես	Tense
տրամաբան	փայտածխիդ	Number
տենչալիք	չտենչացիր	lemma
ընթացար	չվարեիր	Person
ֆիննականներումդ	չթլփատեին	Number
չազդվեցի	կերկայնեմ	Person
չինգաչունգի	երկաթգծում	Number
դրվատեին	լոգարիթմներին	Number
տնօրեններովդ	պարտեզիդ	Possession
անգլոսաքսոներեններ	անգլոսաքսոներենովդ	lemma
ակներեւներս	թովիչներիցդ	Number
որորներից	ձախից	Case
բաստուրմայից	եռանդուններից	Case
հիասթափվի՛ր	կուսուցանես	Person
ոլորներումդ	անթերիիցդ	Possession
հորդորեցին	առողջացր	Tense
կծվերումս	հաճախորդամետս	Possession
արածի՛ր	ածանցեիր	Person
կողպեքներիցդ	լոժբանումդ	Possession
առաջատարներումս	թամադայիս	Possession
չհայեք	կհայի	lemma
դարպասաձողումդ	մահմեդականներովդ	Possession
արեւմտյաններ	արեւմտյանովդ	lemma
սրամտենք	կռկռացինք	Person
չարաչքիցս	որթումդ	Number
տեռորիզմին	կղմինդրների	Case
պատվանդաններդ	կենսախինդը	Case
երգեհոնիդ	մղոններին	Case
շանթամբոխիդ	մոլորից	Number
մրմնջացիր	մատչեիր	Person
հնդկընկույզիդ	հեշտոցներումդ	Possession
չքշեիր	գետաձիուս	Number
չերերանք	կավելացներ	Tense
պերճանքում	տափակներում	Case
քյոխվաս	լեցուններիցս	Possession
զգուշացող	զգուշանա	lemma
արբանյակներովս	վհատիցս	Possession
միապետություններիցդ	խոպոպավորիդ	Possession
մանգաղներիս	թաթարերեններիցդ	Number
ուրախացրո՛ւ	պատկերես	Person
բնույթից	բացառականներից	Case
եպերներովդ	շնորհենք	Number
երկնակամարները	կշիջուցանեիք	Number
կհղանայիր	չբարբաջեն	Tense
սրճենիներ	ընթրիքներիցդ	Number
չագրեգատավորեինք	ագրեգատավորե՛ք	lemma
մակաշերտիցս	ավելուկներիցդ	Case
ծլեն	խայթեցին	Person
կզանգեք	չգիտակցեմ	Tense
զուգահեռագծիցս	կողպէքներս	Possession
հոնքերս	կցիս	Possession
ֆրանսուհիներովս	ոսկեծաղկիս	Possession
հունքուբունքերիդ	լիգայումդ	Possession
գոհանային	կխռմփացնեմ	Tense
հայհոյեց	մրցեր	Person
կվարեք	չհեռեի	Tense
չարհամարհեցին	հայթայթ	Tense
կվաճառենք	ներբեռնես	Tense
տեսիլներիցս	ծխնելույզից	Case
կիմերի	աներկյուղովդ	Number
հասցնենք	կկատարեր	Tense
որսացի	խածանեմ	Person
կթաղեն	առջեւները	Number
չապահովվող	չապահովվեիք	lemma
չվռնդած	չվռնդեմ	lemma
չբարելավենք	կհեգեր	Tense
ստվարաթղթյաներումդ	տիեզերագնացներիս	Number
ռեպիս	չարաշահեց	Number
գնաց	երթա	lemma
շառլատանս	ջաներիցս	Possession
հմայենք	կխածի	Tense
ածանցդ	կոթողներովդ	Possession
հիր	չուժեղացաք	Tense
գլի	չհարեց	Person
լիբրետոներիս	սառույցումս	Possession
ոլորանս	ալմասներ	Case
տպիչից	թոթովներիցս	Case
ըղձա՛	մոլեգնեցի	Number
անապատականս	կքաքեր	Number
կարտոֆիլը	ֆրանսերեններդ	Case
հրճվեին	կխռմփացնեմ	Tense
կռկռաք	չստեցիք	Person
սեւամորթիցդ	հաղարջենիներիցս	Case
լոբբիներիս	հղացքի	Case
չմոռանամ	մոռանար	lemma
ուղեբեռը	ջերմուկներ	Case
աքսորումում	խցիկներում	Case
վիզայիցս	գիտակցականություններս	Possession
չկանչեցիր	կխոպոպեցնեիր	Person
գյուղերումդ	մարզասրահումս	Case
սխալվող	սխալվի	lemma
գոհարներով	գոհարի	lemma
չվեց	գլտոր	Tense
կլողանամ	լրջանայիք	Tense
հավելվածներիցս	ճագարովս	Possession
չկորեմ	կորեր	lemma
անդրկովկասցունս	վզանների	Number
ազդուները	ծոցագրպաններումս	Number
բրդյայովդ	որձաքարերիցդ	Possession
կբողոքարկեին	մղես	Tense
հեղեղեն	կհղփանայիր	Tense
պալատականներիցս	ահաբերս	Possession
ապահովեցնեիր	նվագեցիր	Person
պարտատոմսերիդ	հերվան	Case
թրեր	կայացավ	Person
կքաքեի	չերկայնեցի	Person
ցնծացի	ճաճանչը	Number
կառկայծենք	համոզես	Tense
պահապանից	մսագործովդ	Number
ջեռուցեցինք	չպատրաստենք	Person
կխրոխտային	սառեցին	Person
գեյզերս	սուզանավերդ	Case
սայթաքեցի	քչքչաց	Tense
հետազոտեցի	չհանգստանամ	Person
կհոշոտեն	չփութացնես	Tense
կբդկես	գողացի՛ր	Person
լոգացաք	գովե՛ք	Person
չթրմենք	կռկռացինք	Person
հանգես	շշնջա՛	Person
առաջատարներումս	ոսկեծաղկիս	Possession
կռնակումդ	դրույլներումս	Case
ձողեր	գործարքս	Case
դատողություններումդ	ադրբեջաներենումս	Case
խաշումս	կայսերապաշտին	Number
շիզիկներիցդ	զազրոտիիցս	Case
մացառուտիցս	վայելուչներիցդ	Case
կելտեր	օրթախներովս	Number
վաճառեիք	կարեկցե՛ք	Person
քնապարկերիցդ	կոչումներովս	Number
ձախլիկ	փաստեր	Case
բուժումներից	բորբոքիցս	Case
հնարամտություններդ	ստախոսիցդ	Possession
չխնկեցին	հայթայթ	Tense
չբաջաղեին	բաջաղեին	lemma
թխկուց	ապարանքներից	Case
ստվարներդ	շառաչ	Case
պարավանդին	փիլաքյաններիդ	Case
կգլդորեմ	փլեիք	Tense
չմեղանչեմ	կողորմեին	Tense
կէթամ	չզգենաք	Tense
հապավմանը	սոուսներիս	Case
պոչուկից	թանաքս	Number
գբերս	փականը	Case
չբուծանեցին	ագրեգատավորեն	Person
ընգե՛ք	կնվագեք	Person
չներկայացրիր	նազեիր	Person
կառքերից	պատառներով	Number
կվարեք	մեղանչեի	Tense
չշիջուցանենք	կփռշտար	Tense
գանգրանմանիցս	շանթամբոխներովս	Possession
խթանումս	գիտակցականություններս	Possession
նվազներովդ	ձորիդ	Possession
կբողոքարկեին	ընկճեմ	Tense
կէթամ	երկմտեք	Tense
գործոններդ	սիլիցիումիդ	Possession
քաջալերանքներովդ	վերադարձդ	Possession
գոմաղբից	օղակներից	Case
նախընտրելիք	նախընտրեց	lemma
ալտի	մարտահրավեր	Number
կհղանայիր	փսխենք	Tense
չօժանդակեին	օժանդակելիս	lemma
կուսաթաղանթը	պարտեզներս	Case
ամիրայիս	ուռենիներիցս	Possession
կէթամ	կեղտոտեիք	Tense
ապահովեցիք	ուղարկե՛ք	Person
լոուրենսիումներին	առիթի	Case
սխտորի	ձառերի	Case
երկնակամարները	պոկերներից	Number
ավարերեններից	թեզանից	Case
ուլունքին	բարձրավանդակներիս	Case
լիզեցիր	կխոպոպեցնեիր	Person
մորուդ	հայրենյացումս	Number
կշտկեր	չարածեցնենք	Tense
տպիչից	չվերթներից	Case
չհանձնի	հանձնեիր	lemma
կերակրեին	կտրցակեմ	Tense
աբստրակցիայում	աֆղաներենովդ	Number
նվազներումս	լոգարիթմներին	Number
կթլփատի	գանգրացվեիք	Tense
մանվածքայինումս	թավաներս	Possession
տունդրաներս	չափագիտությանս	Possession
կհետեւենք	չխրախուսեցինք	Person
իրականներից	կաղկանձիցդ	Case
սաստիդ	ճոճաթոռներին	Case
չհայտարարեք	ուղարկե՛ք	Person
կհեծնեմ	ապացուցեիք	Tense
չսորան	կհրճվեի	Tense
ցուցակիս	խաչակիրներիդ	Case
քաջալերություններիցդ	զառանցեք	Number
կզեղես	զեղի՛ր	lemma
կառավարես	կթոռոմեինք	Tense
կէթաս	չհարնչեինք	Tense
կհողդողդեիք	պլոճիկներումդ	Number
սանտիմետրիցս	ջրանցքներս	Possession
սեւիդ	քեռակիններիս	Case
շամբուտիս	սաղմոններումս	Possession
կտաղտկանա	երկմտեք	Tense
չկանխենք	սկզբնագրերում	Number
տեռորիզմին	ձառերի	Case
լաստենիներումս	բիզոնս	Possession
կհակազդես	չգանգրանայինք	Tense
տժվժիկներովդ	ոլործունիցդ	Possession
գառնենիների	աբսոլյուտի	Case
համեղների	առիթի	Case
հոտոտեի	տանուտիրոջով	Number
աքսորումում	հեռուստաընկերություններումդ	Case
լումայովս	սարքավորմանդ	Number
հարբեց	բացառվեցին	Tense
արևածաղկի	մոլեգնեցի	Number
չակնածեք	կհիասթափեցներ	Tense
ռուբիդիումներում	այրուքում	Case
նավահոս	զուգահեռագծեր	Case
խանծերիցդ	հանգամանքումդ	Possession
չկիսեք	փողոտե՛ք	Person
արմավենիներովդ	ոզնիդ	Possession
հյուս	գոգ	Tense
կբողբոջեինք	չարաշահի	Tense
գրամեքենաներումդ	ստախոսիցդ	Possession
գնեն	կտռեմ	Tense
հակասեմականություններից	օդանավակայանից	Case
լյարդի	բամբասանքներիս	Case
մեծացե՛ք	չմեղկացաք	Person
գոռանք	ձուղբերին	Number
կկողոպտեք	չստեցիք	Person
արամերենիցդ	պոկերներիցս	Case
կպղծեր	լրտեսեց	Person
սաթերին	կասպիդ	Case
չհենի	հենեիր	lemma
եպիսկոպոսներով	կցորդներիս	Number
ֆոտոնումդ	ստամոքսներդ	Possession
խրտնեին	քցեցին	Person
կշեշտեք	շիջեի	Tense
ծափահարվեն	կտշես	Tense
անձնանունների	կռնակի	Case
չճաշեցիր	ճաշող	lemma
նարտովդ	լոուրենսիումներովդ	Possession
ռազմիկների	կռնակի	Case
փայլյունումդ	հեթանոսներումս	Case
շրջահայացիս	սուսերներիցս	Possession
հավելես	կլանեցիր	Person
տեսակները	էլեկտրոն	Case
խռմփանք	կկորնչեր	Tense
կվերծանես	պապանձեցնենք	Tense
հոլանդականումս	կնյուններիս	Possession
մտոցումդ	երիտասարդներդ	Possession
ուսումնասիրեցիք	տգետները	Number
կծղրտայիր	այծենիում	Number
հյուս	գնացինք	Tense
կհղենանք	չկիզես	Tense
ծպտվող	ծպտվի	lemma
փակերում	շահնշահներով	Number
ըղձա՛	վերակացուիդ	Number
ճավայերենումս	լավաներիս	Possession
կտնօրինենք	երթա	Tense
մեռելոտի	կքաքեր	Number
ղեկավարությունների	օսեթերենիս	Case
հումիս	պարսավանքներումս	Possession
անգիրներովդ	քյամանչայումդ	Possession
չերկնչի	կցտեինք	Tense
ծլեն	չլուցեցին	Person
չճմռի	ճմռեիր	lemma
ցունամիների	օղակիս	Case
գտածոներումս	սրբոսկրում	Case
կիվին	գնդակահարություններ	Case
ալկոհոլների	օսեթերենիս	Case
երգեհոնիդ	լավերի	Case
չտռեիք	կբաղխի	Tense
նախարարին	ռեստորաններիս	Case
թիռումդ	պերճանքներդ	Possession
չերերանք	կհիասթափեցներ	Tense
ակոսիս	թիթեղներիդ	Case
լումայովս	ենիչարիիդ	Number
կոկովներիդ	հարկահավաքովդ	Possession
հայեցակարգիցս	համերգասրահներս	Possession
մրսեիք	չաղարտեցիք	Person
անհանգստանանք	կապշեր	Tense
մահմեդականներով	չքչքչացիք	Number
հոռովելը	հողմերս	Case
կաղամ	չփայլունանայիք	Tense
տեռորիզմին	ամորձիքներիս	Case
ծառայությամբս	թույլերս	Possession
կօժանդակեմ	չքաքեք	Tense
չհեծնենք	կմրմնջայիր	Tense
աջաբսանդալը	հայկազներ	Case
մնացականիցս	հայրատներիցդ	Case
կքերծեի	չդատարկեցի	Person
բյուրս	ալմասներ	Case
փոխարինումների	չաքուչի	Case
գրազներիցդ	հոգնածությամբդ	Possession
ծնկոսկրիս	աղիքներումս	Possession
սաստիդ	բամբասանքներիս	Case
գանգրիկի	չարաշահեց	Number
ջրաղացներիդ	բարուցդ	Possession
ցինկս	նվարտանները	Case
դարպասաձողումդ	խաղամոլներիցդ	Possession
անշարժից	անշարժներդ	lemma
համբավիս	կուսանեմ	Number
կագուցավորեր	խոցեք	Tense
չողբաս	նպաստի՛ր	Person
ցերիումը	ջերմուկներ	Case
արոտավայրերիցդ	ծխնելույզից	Case
անուրջներիցս	նիլսբորիումից	Case
մնչեցի	համակարգ	Tense
մալայերենիս	ինքնավարների	Case
ակներեւներս	սազեն	Number
լուտանքներիդ	անթերիիցդ	Possession
գայլենիս	գայլենիներովս	lemma
չհայտարարի	հայտարարեիր	lemma
չբացատրեինք	բացատրե՛ք	lemma
արդուկեք	գովե՛ք	Person
չնախընտրեցի	կբաղբանջեմ	Person
պրոտոններովդ	չպառկեք	Number
կգեղգեղեիք	նախաճաշի	Tense
չինգաչունգի	ահազանգումիցս	Number
զովերին	բեկորիդ	Case
միջատաբանականումդ	գոճիներդ	Possession
մոլեգնենք	կավելացնի	Tense
կոստղաշատս	կարագները	Case
փութացե՛ք	խռմփայիք	Person
կմարթեիր	շիջեցիր	Person
փռշտոց	գնդակահարություններ	Case
չբացառեի	պաղատեցի	Person
քանդակներովս	կատարյալիցս	Possession
հապաղ	թոխումիդ	Number
հրեղենիս	լրատուներովս	Possession
դարսեինք	չդարսեցի	lemma
կխրտնեմ	չճոռոմախոսեն	Tense
սուջուխներդ	մսան	Case
գոլանանք	չերազեցինք	Person
կորսաք	չաղարտեցիք	Person
կտակեց	կտակի	lemma
ցինկս	ղայիշներդ	Case
չարաչարիդ	օգտագործումների	Case
բացականչումիցդ	տունդրաներդ	Possession
կշիջուցանեք	չսգար	Tense
թվահմայությունիցս	բացառականներից	Case
չխեթկի	կլրթանանք	Tense
սխտորի	հորաներիս	Case
ամբարտավանանաք	կկորնչեր	Tense
ձաղե՛ք	չսնգուրվեք	Person
ուղեկցեիր	չունկնդրեցիր	Person
ջայնիզմովդ	մեծավորով	Number
յանիչարից	ամրակազմներիցս	Case
ախտարարս	սպունգներդ	Case
ծնեցի	կագռավանամ	Person
հյուսեր	կաներկյուղանանք	Tense
ջեզվեիս	ջեզվեներումդ	lemma
աղբուտներիդ	չթլփատեին	Number
եկերդ	սիլիցիումիդ	Possession
չըղձաք	կկանխամտածեմ	Tense
կիբեռնետիկան	ղայիշներդ	Case
լերդերդ	լոժբանումդ	Possession
էականիս	ջրանցքներս	Possession
հառաչալիներից	չարաչարիցս	Case
գաղտնիքիցդ	հերոսություններից	Case
չհարբեցավ	տառադարձեր	Person
հավատայի	չվառվեցի	Person
ժողովածու	ջերմուկներ	Case
պատկանեի	կզրնգան	Tense
չսահմանեց	խղճար	Person
կթրեիք	ձեղնահարկերիցդ	Number
հակազդեր	հակազդեն	lemma
կտրամադրեր	լրտեսեց	Person
չկրեր	կլրթանանք	Tense
ինքնավարներիցդ	պալայերենդ	Possession
կպատկերեր	առաջավորում	Number
կճանապարհորդեի	չհանձնեք	Tense
սավառնե՛ք	վառվեցիք	Person
թլփատ	չքերծեցիք	Tense
ավարս	գոյակցություններիս	Possession
մահացավ	կռվի	Person
սխտորի	թացերին	Case
ջերմիդ	ծղոտներումդ	Possession
ծխերի	ճոռոմաբանի	Case
փենջաբիում	ակորդեոններում	Case
կրծքանշաններովդ	ուզբեկերեններովս	Number
արեգակնային	ծովափղերը	Case
անհավատին	լավերի	Case
կմաքառենք	չցուցանեցինք	Person
գոմաղբից	չվերթներից	Case
ուրուկներիցդ	թաթուլներովս	Number
աբսոլյուտներիցդ	ձախիդ	Possession
կաշկանդիչս	կաշկանդիչներովս	lemma
հայեցվածներովս	հայեցվածներիցս	lemma
չօթի	կարօտեց	Person
արձակներին	հմուտներովդ	Number
սիկղերովդ	զովումդ	Possession
կփլվեն	չառերեսվես	Tense
աքսորումներումս	որձաքարիս	Possession
ակներեւներս	հարցազրույցներումդ	Number
քամովդ	ողորկություններովդ	Possession
արգելիցդ	եռանդուններից	Case
չհրապուրեինք	քաղցրերովդ	Number
կպապանձվենք	չջղայնացրինք	Person
կհոխորտայի	խոցեք	Tense
ցողկ	գահույքում	Number
կաղոթեմ	չշարունակեցի	Person
չեխերենը	մատիտով	Number
թզուկի	մահմեդական	Number
մեծանձնիցդ	կալեիր	Number
երկչոտներից	ճնշումիցս	Case
կզանգահարեիք	հաճախե՛ք	Person
հուլունքների	չխոպոպվեք	Number
ալպինիզմդ	լուսամուտներումդ	Possession
շպարանյութերիդ	նեխածիցդ	Possession
խրտնեին	չթլվատեցին	Person
ենթակայականից	երկբայություններիցդ	Case
կիվին	մզկիթներ	Case
ջերմիդ	գանգուրներիցդ	Possession
ուսդ	շնորհներիցդ	Possession
ապացուցեցի	կհարբենամ	Person
ծովակալներդ	վերակացուովդ	Possession
ուդ	լոուրենսիումներովդ	Possession
տեղյակիցս	զանգակածաղիկներովս	Possession
կօժանդակեմ	լողանայիք	Tense
զսպանակներին	ղեկավարություններդ	Number
հուլունքներիդ	այրուձիովդ	Possession
սոցիալիստականդ	հավելվածներումդ	Possession
յուղալավաշ	շեքերս	Case
խաշ	եկեղեցականներ	Case
հոկտեմբերյաններումս	վհատիցս	Possession
չաճացրիր	կաճացնես	lemma
արեգակնային	աբստրակտներս	Case
մոշավայրուցս	չաթլախներս	Possession
կշփեի	չհափափեցի	Person
ահաբեկվեիր	կբարբառենք	Tense
բաստուրմայից	հռոմեականներից	Case
հռետորաբանություններ	մեքսիկդ	Case
փախցնես	չսիրւեցիր	Person
քոռում	հեղձամղձուկներում	Case
կընդոստեինք	համոզես	Tense
մահմեդականներ	հովազ	Case
փքվենք	կսպասարկեիր	Tense
հոտոտես	հողդողդի՛ր	Person
մեյդաններդ	հացահատիկովդ	Possession
չուռեցինք	հեռացնենք	Person
բնակչությունիցդ	վրացուս	Number
ծնկոսկրիս	ուզբեկներս	Possession
դատողություններիս	տողիցս	Possession
չտառադարձես	կհորջորջենք	Tense
նորույթումս	մեծատառերս	Possession
լյարդի	նոյեմբերյաններիս	Case
զավտրիկդ	ձայնադարձերիցդ	Possession
ջրափոսում	սարքավորմանդ	Number
չգնահատեիք	ըմբիշներդ	Number
խանձատեց	համակարգ	Tense
չպատառեին	պատառեին	lemma
խրճիթումդ	ջերմերովդ	Possession
ինդոնեզերենովս	ամրոցներս	Possession
գոչյունից	ունակներից	Case
չհեղուսեինք	հեղուսե՛ք	lemma
դարսի՛ր	չսորացիր	Person
կխրտնեմ	չկտղեին	Tense
սիբիրախտերումս	անձրեւում	Case
մկնիկին	հեստապարովս	Number
փրթեցի	գոգ	Tense
գյուղերումդ	երախայրում	Case
կպղծեր	պոռոտախոսեց	Person
դեղնավուններովդ	լատվիերենումդ	Possession
քչիցդ	թարխանաներդ	Possession
փտած	մարդելույզներդ	Case
մահմեդականներով	կծանուցեք	Number
ծովակալներդ	վուշիցդ	Possession
հարկադրի՛ր	հարկադրում	lemma
քչիցդ	պատրաստություններումդ	Possession
ազնավորներիդ	հավաքարարին	Case
անթացուպիդ	հիփհոփիցս	Number
զիստում	հատկանշիցդ	Number
շփոթվածություններիցս	ծխնելույզից	Case
քունենք	կմաքառեիր	Tense
ամբոխներումս	լահմաջոս	Possession
երամակների	երշիկիս	Case
ցողուններովս	դանիականիս	Possession
կիվին	եկեղեցականներ	Case
չնախընտրեցի	հագնեմ	Person
պարտիաներ	կինոն	Case
չարթնանային	արթնանային	lemma
լինգալայիցդ	գործիք	Number
որորներից	լիսեռից	Case
քվարկներիս	նախաբազկիցս	Possession
արգելիցդ	շագանակագեղձերից	Case
դարսի՛ր	կկշռադատեիր	Person
ողորմ	ողորմեք	lemma
պագնեիր	կլրթանանք	Tense
բալետովդ	սրճեց	Number
փութաջանությանդ	գուղձերի	Case
գորովեինք	չխրախուսեցինք	Person
ճավայերենովս	ճավայերենից	lemma
մնացականներիս	անհեթեթին	Case
այծերս	ծափահարմանս	Possession
գոգ	գոգեք	lemma
թաքչեին	թաքչեցինք	lemma
ձողեր	ուշունցս	Case
կճոռոմախոսենք	քուներ	Tense
չագռավանար	կներքինանանք	Tense
հղացանք	կսիրւէինք	Person
չլքեիք	գովե՛ք	Person
ձախլիկ	ջհուդներդ	Case
չգլդորող	չգլդորեիք	lemma
կմուրայի	պաղատեցի	Person
հոտոտեի	ռուսաստանցուդ	Number
կրող	կրեցին	lemma
անկվածներիդ	ուտելիքները	Number
խրոխտանքներին	բորշչիս	Case
մեղկանայիք	կնքեցիք	Person
մեներեններիս	ընտիրովս	Possession
սպիտակամորթս	խրոխտություններդ	Case
լացերումս	չուրախացրինք	Number
կխոպոպացվես	ճողոպրեին	Tense
միապետություններիցդ	ցարականումդ	Possession
ամբարտավաններիցս	պլորիս	Possession
հազիդ	մժեղներիս	Case
արեւմտյանիցդ	իշղարներիդ	Possession
կհրահրենք	գեղագանգուրներումդ	Number
ոլորներումդ	վարշամակիդ	Possession
սարսափենք	կճաքի	Tense
բարբարոսովդ	գրողներդ	Possession
կվրդովեին	անվտանգություններիս	Number
ընթացաք	կերկնչեիք	Person
չնախանձեն	կխոցեիր	Tense
կախարդվածություններդ	խավարասերովդ	Possession
խորակիցդ	ստամբակությանս	Number
ջերմաչափներիս	վհատիցս	Possession
լաոսերեններիս	չմատնեք	Number
կաշկանդիդ	քեռակիններիս	Case
զորեղներդ	վարկածս	Case
ախտորոշեին	ախտորոշեցինք	lemma
ձկնկուլները	գործարքս	Case
մեղկանայիք	հոտե՛ք	Person
սպասարկե՛ք	կամենաք	Person
հնգամյաս	այլանդակությունները	Case
ուրուկներիցդ	կփողոտենք	Number
քաղեցիր	տարածես	Person
ըմպեք	վառվեցիք	Person
չվրդովվեինք	կկիսես	Tense
ապահովվեց	չճոռոմաբանի	Person
չարաշահեցիր	չարաշահեին	lemma
ծարավիի	կլիանամ	Number
քանդակներովս	բումերանգովս	Possession
չհուսահատվեին	հուսահատվեին	lemma
խրտնեին	խածեցին	Person
կշփոթվեք	չօղողեր	Tense
մոդայումս	հեղձամղձուկներում	Case
ինքնյակը	հաստատակամներս	Case
հատապտղում	կանխամտածեց	Number
փոխարինի՛ր	չփրթեցիր	Person
թրթուրներումդ	այրուքում	Case
թեկնածուներին	մանվածքիս	Case
երախտամոռից	երախտամոռներդ	lemma
պագերի	կռնակի	Case
շտկեցինք	հայթայթ	Tense
միմոսովս	վարտիքներումս	Possession
հեստապարերիս	չթլփատեին	Number
արթնանա	կարօտեց	Person
տժվժիկներովդ	սառցալեզվակումդ	Possession
գերմանականում	բացառիկներումս	Case
ձկնկուլները	գինարբուքս	Case
չարկանեցիր	վայրագի	Number
խարդախներով	խարդախի	lemma
չհոլանեիք	կտարբերեմ	Tense
բառգրքերս	առակախոսովս	Possession
կհուսահատեցնեն	չզրնգայիր	Tense
փութաջանությանդ	կաղճիններին	Case
չըղձա	հղիով	Number
չկթեմ	կօթեք	Tense
խթանեցինք	կողբանք	Person
ձայնադարձերիդ	ջայվովդ	Possession
թխկուց	շագանակագեղձերից	Case
լերդերովս	մետաղագործություններում	Number
կղզի	կուսանեմ	Number
չագուցված	չագուցվեմ	lemma
մահացավ	թքի	Person
չխոսան	խոսացիք	lemma
չսրտառես	կսրտառեիք	lemma
քունենք	կկիսես	Tense
հողեղենդ	հեռվով	Number
կենդանացավ	հայթայթ	Tense
չպոռոտաբանեցիր	կպոռոտաբանես	lemma
կշեշտեք	նախաճաշի	Tense
բարվոքիցս	թավուտներս	Possession
աֆարերենը	անվճռականներ	Case
արծաթներից	չոստնենք	Number
չթքեցիք	զեղծ	Tense
ամպար	վերջնախաղերը	Case
կյուրիումս	քրիստոնյաները	Case
աչերիցս	մանվածքայինիս	Possession
կթռնեք	չվերադառնամ	Tense
կազդես	ազդի՛ր	lemma
կթլփատի	պահածոյանանք	Tense
վավերագրականիս	փախստյաներովս	Possession
պույտիդ	հեստապարովս	Number
մտաբերեցի	կագռավանամ	Person
նիրհովդ	գործիք	Number
չբուծանեցին	տենան	Person
դեղատներից	էներգիայիցդ	Case
վերմուտից	հերոսություններից	Case
լումայովս	կմայեի	Number
ցինկս	օգոստոսները	Case
չհարգեն	հարգեցիք	lemma
գեղջուկիդ	հարսնապարերի	Case
զուտերով	զուտի	lemma
մնացականներիս	անթիդ	Case
կպատկերես	մաքրեցիր	Person
գոչյունից	կանաչապատներիցդ	Case
դիի՛ր	դիում	lemma
կլողանամ	չնախանձեին	Tense
չխազեի	կքելեք	Tense
հողեղենդ	հաչաղկոտից	Number
չինքնահավանի	կորնչեց	Person
չբորբոքի	կկողպեիք	Tense
սավառնե՛ք	խռմփայիք	Person
չփոխարինեիր	համբուրվի՛ր	Person
պատվանդաններդ	գինարբուքս	Case
չփլախիս	սնդիկիցդ	Number
կշիջուցանեք	չգարշեի	Tense
առաջադրանքներիս	հղացքի	Case
խաշ	փաստեր	Case
չհերքվենք	կապշեր	Tense
կողքդ	ազգանուններ	Case
լաստենիդ	կարագները	Case
նորոգներիցդ	թաքցնեն	Number
տարածեմ	չդատարկեցի	Person
տժվժիկի	աքերիս	Case
խորտիկիդ	գոճիներդ	Possession
չմեծանաք	ուղարկե՛ք	Person
ճոպանովս	ջրանցքներս	Possession
բուժումներից	թեզանից	Case
շուշմայում	դալարուտիցս	Number
ակնեղենս	ակնեղեններովս	lemma
ընկերքներ	սազեն	Number
երամակների	ճոռոմաբանի	Case
ցանկություններովդ	աստղադիտակները	Number
չխածանեց	կկանգնի	Person
քաչալներով	քաչալի	lemma
հաստատեք	կավելացնի	Tense
արածի՛ր	մաքրեցիր	Person
փայլյունումդ	մանրէաբանականներում	Case
լոուրենսիումներին	վինիս	Case
գյուղերումս	տապակովս	Possession
անմեռներից	կապահովենք	Number
ազդվեցի	չկռթնեմ	Person
չահագնացար	ընդարմանայիր	Person
կախարդվեց	կգարշի	Person
կորոճային	չըղձացին	Person
ֆիննականներումդ	պատառներով	Number
անթացուպիդ	հղիով	Number
շփոթմունքը	կհալածես	Number
կչափես	կլանեցիր	Person
պատշաճներումդ	պիցցադ	Possession
հոգեբանությունների	փքուռույցներումդ	Number
մոտից	ճառագայթներիցդ	Case
հիասթափություններովդ	տոհմածառերը	Number
հավատայի	չցտեցի	Person
առաքինություններս	մոնղոլերենդ	Case
փոխարինումներովդ	լեհականումդ	Possession
կշփոթվեք	ընդոստեր	Tense
թեշիկս	սլովակերենովդ	Number
ենթակայականից	խտղտանքներիցդ	Case
օթարաններիս	կսկիծս	Possession
ծովափղեր	մեթոդներից	Number
արեւմտյանիցդ	անթառամներիդ	Possession
չհորջորջեինք	հորջորջե՛ք	lemma
լոգացաք	չանիծեք	Person
պտուտակահաններ	իրականությունս	Case
բաղբանջի՛ր	մատչեիր	Person
ուժգինովդ	բրդյաներդ	Possession
փապերիդ	ոզնիդ	Possession
գյուղերումս	ուռենովս	Possession
նքողակից	վայրագի	Number
թվահմայություններովդ	մեներենիդ	Possession
կգլտորես	հեռվով	Number
ավարներից	ծխնելույզից	Case
մեծաբանությունումդ	կաղամարներիցդ	Possession
դելփինիս	ներարկիչների	Case
հեգեք	խրատներիս	Number
գոմաղբից	ստվարաթղթերիցդ	Case
քաոսայինումդ	աշխարհամասերումս	Case
փենջաբիում	բակտերիաներումդ	Case
գրգռ	ընթեռնեցի	Tense
չխոյացած	չխոյանամ	lemma
ցուցակիս	ղազերի	Case
դրսեւորեց	համակարգ	Tense
բուսաբաններիդ	կռնակի	Case
մոխրագույնիս	ձառերի	Case
շենք	մալթայերենները	Case
ձետ	ծերունից	Number
չսորան	կփքվես	Tense
չսաղացանք	առողջացնենք	Person
փտի	կայացավ	Person
լիզեցիր	մատչեիր	Person
պոռոտախոսս	մզկիթներ	Case
չկանչեցիր	բեկտի՛ր	Person
ոլորներումդ	նեխածիցդ	Possession
կշտկեր	չհրկիզենք	Tense
շռեց	կգարշի	Person
եվրոյիցդ	ժպիտներիցս	Case
կհպարտանայիր	չհամոզեն	Tense
շինականներովս	վագրիցս	Possession
կատակագուսաններ	ծայրս	Case
սուրահին	գուսաններիդ	Case
ոլորանս	հայկազներ	Case
կսուզի	սրճահատիկի	Number
հոկտեմբերյաններումս	կաղապարս	Possession
պարտատոմսերիդ	ճապոներենին	Case
սավառնեն	կփքվես	Tense
ռուբլում	ջրանցքներում	Case
լազերի	արքայախնձոր	Number
զսպանակներին	սալորենիներում	Number
ժամանումներին	չմտմտայինք	Number
չհարբենայինք	հարբեցե՛ք	lemma
հեծանոցիցդ	գահույքում	Number
սիկղերովդ	միլիոնատերիցդ	Possession
հափշտակումներդ	նախադասությունս	Case
արգելոցներիցդ	մաճիցս	Case
կանաչավուններս	շառաչ	Case
կարկանդակ	տղամարդիկս	Case
չապահովացներ	կգլեք	Tense
կգլդորեմ	չսրտառեն	Tense
զխկտեցինք	ծոցագրպաններումս	Number
չխեղդած	չխեղդեմ	lemma
թեկնածուներին	թամբիդ	Case
մեռելոտի	բադակտուցից	Number
մասնագիտության	աներկյուղովդ	Number
թղթադրամ	ինքնությանը	Number
քաղեցիր	չաղատեիր	Person
նշանաբաններ	ծայրս	Case
ճոռոմախոսումդ	շիզոֆրենիկներովդ	Possession
կազմերիս	մրջյունին	Case
տժվժիկի	հոբելյարներին	Case
չնվագենք	կխռթայիր	Tense
գուժումներիցդ	հոգնածությամբդ	Possession
աշտարակումդ	խարտոցներդ	Possession
շիզիկներիցդ	թավայիցս	Case
կոմսը	փաստեր	Case
կընդոստեինք	չգոգես	Tense
կհուզես	չհարնչեինք	Tense
չարհամարհեցին	գլտոր	Tense
աղեբեկներովդ	կանաչազարդովդ	Possession
կաղամ	բաղբանջեք	Tense
չնվագեմ	կպարտվեին	Tense
զոդին	մանվածքայինների	Case
շառաչյուններումս	նիդեռլանդացիներին	Number
վերիններս	փականը	Case
տարածքը	չտառապեցնեիր	Number
չաբսորբեցիր	աբսորբող	lemma
զրահամորթումդ	լոուրենսիումներովդ	Possession
օսեթականներդ	նախադասությունս	Case
կվարեք	ապահովեի	Tense
կքննարկենք	խոխոջեիր	Tense
հմայենք	կշիկանայիր	Tense
կոնյակ	քրիստոնյաները	Case
վերարտադրությունից	կաղերիցդ	Case
ղեկավարությունների	անթիդ	Case
արոտավայրերիցդ	թեզանից	Case
հակասեմականություններից	նիլսբորիումից	Case
պադյեզդներիս	փիճխս	Possession
չպատրաստող	չպատրաստեիք	lemma
հիր	բացառվեցին	Tense
համեղների	ամեհիիս	Case
դրվատեին	հունվարներումդ	Number
չերազեինք	գովեցինք	Person
վերարտադրությունից	ունակներից	Case
բաստուրմայից	արմունկներիցդ	Case
մզկիթդ	դանդաղկոտներիցդ	Possession
շրջահայացիցդ	եռանդուններից	Case
ձախերիս	տաքավունս	Possession
լկստվեցիր	լկստվեին	lemma
մոռացոնքներին	գեղեցիկներումդ	Number
գոչյունից	կաղերիցդ	Case
կբողոքարկեին	ունկնդրեմ	Tense
ռուբիդիումներում	հնդկերենումս	Case
մահմեդականներ	կետչուպ	Case
հովիտս	ծորաներումս	Possession
խթանեցինք	կհիանեինք	Person
օգտագործեց	օգտագործի	lemma
որսացի	չփորձեի	Person
ժողովածու	հողմերս	Case
ասպազեններ	սղոցս	Case
չհերքեցիր	մատչեիր	Person
կծնեն	չվերընթերցեմ	Tense
չանզգայացնեին	անզգայացնեին	lemma
ստոծանիներիցս	ձառերում	Number
ասպազեններ	ընկճախտ	Case
հայեցակարգիցս	ֆիլմերս	Possession
աղեբեկներովդ	ջինդ	Possession
մրցավարով	սեքսիզմումս	Number
աղայիցս	ստորիններիս	Possession
որսացի	կբաժանվեմ	Person
թթվի	ներարկիչների	Case
ամբարիշտներիդ	ոլործունիցդ	Possession
կսուզի	ենիչարիիդ	Number
սուրահին	սոուսներիս	Case
կենցաղումս	խրոխտագիններիցս	Possession
կբողբոջեինք	չտկռես	Tense
չապաշխարեցիք	կնվագեք	Person
ֆարերցուդ	տերտերներովդ	Possession
բեւեռացույցներումդ	բրդյայիցդ	Possession
գողացող	գողանա	lemma
պագերի	աքսորյալիդ	Case
ճագարներին	վինիս	Case
չուվաշերենով	արագացմանը	Number
թուլիումներիցս	հունավորովս	Possession
երամակների	անվան	Case
հոգնակիներիդ	վերակացուովդ	Possession
մորուդ	նատրիումումս	Number
թլփատեցիր	չաղատեիր	Person
լուտանքներիդ	կաֆեդ	Possession
հովիտս	զանգակածաղիկներովս	Possession
վայրդ	եկեղեցականներ	Case
մոլուցքներիցս	ռուբիդիումումս	Possession
ապիկներիցդ	այրուձիովդ	Possession
ռացիոնալներում	չթլփատեին	Number
թթվի	յոգուրտներին	Case
գրամեքենաներումդ	բարուցդ	Possession
կեղերջականներով	կեղերջականովդ	lemma
չխոխոջաց	կծեր	Person
արդյունքների	փետիս	Case
մասնագիտության	մեծավորով	Number
ակնածալիցներին	աքսորյալիդ	Case
մոտեր	օսլաներումս	Number
հումիս	ծիլերս	Possession
ասպանդակով	միացար	Number
ձգտեր	ձգտեն	lemma
պիտույքովդ	դանդաղկոտներիցդ	Possession
թուրքմեներենովս	ծիլերս	Possession
թվահմայություններովդ	ավտովարորդդ	Possession
չհարբեցավ	կգարշի	Person
յանիչարից	ծախերիցդ	Case
մաքրես	կաճեցնենք	Tense
ընկերքներ	չաղերսեցին	Number
գարշումդ	օսեթերեններդ	Possession
կմարթեիր	բանեցրիր	Person
չալեկոծեի	արմացա	Person
չերկբայեցիր	կերկբայես	lemma
չգանգրվեցիր	կգանգրվես	lemma
դիպաշարերով	օթեն	Number
սպասարկեին	սպասարկեցինք	lemma
ուրուրդ	ջերմերովդ	Possession
կթլփատի	ապացուցեիք	Tense
սավառնող	սավառնեցին	lemma
չարկանեցիր	կոստներ	Number
կցտի	չջղայնացնեք	Tense
պագնեիք	դատապարտեցիք	Person
ջրաղացներիդ	վերակացուովդ	Possession
յուղալավաշ	կարագները	Case
խաբեբայություն	սուզանավերդ	Case
չգիտակցվեիր	կբխենք	Tense
չփրփրեն	կհրճվեի	Tense
նիստիդ	աներկյուղությունում	Number
չճկեցինք	կհեղեղենք	Person
վերագրեիր	կլրթանանք	Tense
ակնածելիներին	նիդեռլանդերենիս	Case
ֆերմիոնիդ	թարխանաներդ	Possession
վերարտադրությունից	ամրակազմներիցս	Case
մտաբերեցի	կատարեի	Person
ապարոշին	հղիով	Number
զարթնեիք	գանգրացե՛ք	Person
տես	համակարգ	Tense
մերկապարուհուցդ	արծվիներիցս	Case
լոբբիներիս	մարկիզիդ	Case
մխիթարեիք	զրուցե՛ք	Person
կագուցանենք	նախաճաշի	Tense
գրախոսությամբդ	ճանկերիդ	Possession
կլիմաների	երկկտտացնեք	Number
երակներին	հղացքի	Case
շարունակ	չհափափեցին	Tense
զատերիս	քաղցրերովդ	Number
շեներիս	բազազովս	Possession
ամորձակալներս	լիտվերենը	Case
ճոռոմաբանականներով	ճոռոմաբանականներում	lemma
կթուլանայիք	ուղարկե՛ք	Person
ամբոխներումս	պլորիս	Possession
լազերի	անատոմիան	Number
հոնքս	խրոխտագիններիցս	Possession
մղձուկներիդ	հիգիենայումդ	Possession
սպասարկե՛ք	չարդուկեք	Person
չմահանա	գնչեց	Person
հրվանդանի	ճոճաթոռներին	Case
կաղամ	չտառապեին	Tense
զրնգա	զրնգացնել	lemma
չըղձա	փույթիցդ	Number
սիբիրախտովս	հալոցից	Number
թեորեմիցդ	եռանդունովս	Number
վիրակապերից	ճնշումիցս	Case
անհույսումդ	սլավոնականներումս	Case
արգահատեիք	չարգահատեցիք	lemma
հեռուստատեսություններին	պյուռոսյաններում	Number
քենակալները	ամորձապարկերից	Number
սրճարանատերերիդ	շնորհենք	Number
ռեակցիաներիցս	պետերը	Number
փալասիցդ	փաշաներիցս	Case
չձաղեիք	դատապարտեցիք	Person
կոնյակ	եկեղեցականներ	Case
խթանեցինք	համակարգենք	Person
հնախոսներիցդ	զովումդ	Possession
լոլիկներովս	սրճահատիկս	Possession
շողալիք	շողաց	lemma
չշփոթեցնեմ	շփոթեցներ	lemma
տժվժիկի	ձառերի	Case
բոսորներումս	մանվածքայինիս	Possession
ենթակայականից	վայելուչներիցդ	Case
հղենայիր	հողդողդի՛ր	Person
մեղմերումդ	խորթդ	Possession
խանությանս	կղմինդրների	Case
չբորբոքի	կբզզաք	Tense
մահացավ	խղճար	Person
սիբիրախտովս	կմայեի	Number
կտռզենք	գովեցինք	Person
չգործարկեին	գործարկեին	lemma
բլբլար	չկաշկանդեց	Person
բաղբանջի՛ր	չճկեցիր	Person
գյուղերումս	բունոցիցս	Possession
վավերագրականիս	լծակներումս	Possession
կբողբոջեինք	չկշռես	Tense
ձմեռայինիցդ	տերտերներովդ	Possession
տեռորիզմին	նոյեմբերյաններիս	Case
կագուցանենք	չբաժանվեիր	Tense
կգանգրացվենք	գոհացանք	Person
սաստիդ	ռեստորաններիս	Case
չհերքվենք	կկորնչեր	Tense
ալյումինումում	կոտորներում	Case
արծաթներից	անորոշներդ	Number
չխայթեցիր	կխայթես	lemma
քնարահավիս	թավաներս	Possession
ձախլիկ	քրիստոնյաները	Case
պրոթեզներումդ	անանուխիցդ	Possession
բայոցներիցդ	ստարտափիդ	Possession
աթեիզմիս	ներարկիչների	Case
միապետություններիցդ	գրատախտակդ	Possession
գործառնականս	փաստեր	Case
կողքդ	հանդերս	Case
սուջուխներդ	ուշունցս	Case
ճանճերդ	ձորիդ	Possession
սպասասրահը	թալիբներս	Case
առաջադրանքներիս	արջնի	Case
ալերգիայումդ	հատիկներիցդ	Possession
հալոգեններիս	անբանիդ	Case
գուժումներ	անկվածդ	Case
պարտատոմսերիդ	ծուծին	Case
ջրհորովս	էջի	Number
կոսմոսներովս	ծովահենս	Possession
նշանաբաններ	կարտոֆիլս	Case
քիմքը	նախաճաշի	Number
խորակիցդ	նատրիումումս	Number
գեյզերս	ըմպակներդ	Case
մամուխիցս	հերոսություններից	Case
կխոչընդոտեին	ունկնդրեմ	Tense
կճանապարհորդեի	չպատրաստեն	Tense
մեղեխիդ	գաղտնիովս	Number
այծերս	խճողիս	Possession
հայցե՛ք	անվտանգություններիս	Number
քվեարկողիդ	աքերիս	Case
բաշկիրերենը	խրծիկներս	Case
տեռորիզմին	բիոլոգիաներիդ	Case
խիտերը	ունակներովս	Number
չփրփրեն	կճմլեիր	Tense
կհուսահատեցնեին	չառերեսվես	Tense
ապերախտություններդ	ենիչարին	Case
փռշտոց	փաստեր	Case
թլփատ	չքչքչացին	Tense
ազգականդ	քարփիջին	Number
նախապայմաններդ	չաղերսեցին	Number
ֆալիսկերենի	բնակչությամբ	Number
սումոյիցս	մորալիստներովս	Possession
օգտանունից	օգտանունը	lemma
չհերքվենք	կդատապարտեիր	Tense
կայաններս	թլփատություն	Case
կեպերենք	չտրամադրես	Tense
քվեարկողիդ	լամաներիս	Case
սորային	չթլվատեցին	Person
չոնորոշացա	խածանեմ	Person
ճմռե՛ք	կնքեցիք	Person
այտուցս	լվերովս	Possession
տնօրինեք	կերկկտտացնեի	Tense
փոխարինի՛ր	կմտադրես	Person
թուլիումներիցս	ժամադրությանս	Possession
կոմսը	շեքերս	Case
հարիսայիս	լծակներումս	Possession
չկաղկանձեցինք	թորշոմենք	Person
զառամելիք	չզառամեցիր	lemma
փտած	քրիստոնյաները	Case
գրգռ	չխազեցին	Tense
խոնավավուններումդ	խոնավավուններումս	lemma
գրգռ	չփտեց	Tense
լոուրենսիումներին	գետաձիուս	Case
բոլշեւիկներին	հղացքի	Case
ապացուցեցի	չստորագրեմ	Person
տուկանիցդ	գետաձիուս	Number
հոլանդականումս	նատրիումներս	Possession
յանիչարից	թեներից	Case
փախումս	երկայնաբանդ	Number
քեռայրիցդ	մեներեններիցս	Case
գոռանք	երկայնաբանություններով	Number
չբուծանեցին	կշարունակեն	Person
աբսուրդներումդ	մարզասրահումս	Case
գոյացաք	չարդուկեք	Person
չերկբայեն	կխռմփացնեմ	Tense
չփարթամանար	քավումդ	Number
վոլֆրամովդ	ջերմերովդ	Possession
ցացիկիումդ	մահմեդականներովդ	Possession
կհուսահատեցնեին	շռեմ	Tense
ծարավիի	ալեմաներենս	Number
կոմսը	ջերմուկներ	Case
փոխարինումներովդ	ջայվովդ	Possession
հրշեջներիս	հնդեվրոպաբանիցս	Possession
հռչակավորներումդ	պալայերենդ	Possession
մոլեգնենք	կհղփանայիր	Tense
չմատուցեր	քերծեց	Person
անվճռականություններումդ	անթերիիցդ	Possession
տարածքը	առզելովդ	Number
չփլախիս	ծայրահեղականով	Number
կշփոթվեք	չկտակեր	Tense
կասկածներում	մարզասրահումս	Case
պիտույքովդ	էներգիաներիդ	Possession
հայրենյացներում	այրուքում	Case
կոմսը	թալիբներս	Case
մրցավարով	մոշավայրու	Number
չբարելավենք	կտարամիտեր	Tense
կուսաթաղանթը	հայկազներ	Case
պաշտամունքումս	փախստյաներովս	Possession
կաղկանձեցիր	կաղկանձեին	lemma
մոխրագույնիս	մղոններին	Case
արծաթիներից	թուրքմեներենից	Case
չակնածեք	կապշեր	Tense
տժվժիկներովդ	ստախոսիցդ	Possession
ապահովեցնեիր	կներքինանանք	Tense
չզեղծեցիր	զեղծող	lemma
կղզի	կալեր	Number
սնդիկներովս	ծծովս	Possession
ցինկս	գոսերդ	Case
գմբեթս	իշառվույտներիցս	Possession
չսաղացանք	կկեղեքենք	Person
կանչեինք	չկանչեցի	lemma
լեռնայինովս	հիվանդներս	Possession
պոռոտախոսիս	իշառվույտներիցս	Possession
գերեզմանոցներդ	ընկճախտ	Case
դարպասաձողումդ	լեռնայիններովդ	Possession
ջեռուցեցինք	նպաստենք	Person
հովիտս	լծակներումս	Possession
չմեղանչեմ	կճախրեիք	Tense
գիտելիքներումդ	հերվանիցդ	Possession
ժողովածու	ազգանուններ	Case
չաթլախովս	չաթլախներիցդ	lemma
ավտովարորդս	խրոխտագիններիցս	Possession
կհոշոտեն	չենթարկեիր	Tense
խալ	գաղափարին	Number
խիտերը	կնճիթներիդ	Number
բուժումներից	սուսերամարտիկիցս	Case
գեյզերս	ճոռոմախոսներդ	Case
միացող	միացան	lemma
չբորբոքի	կբդկեիք	Tense
անհանգստանայիր	կլանեցիր	Person
լիզեցիր	կպառկեիր	Person
հղենայիր	չճկեցիր	Person
քիմքը	վերակացուիդ	Number
ցունամիների	չինարուն	Case
չապացուցվեցիր	քոչես	Person
բլղուրս	հյուրասրահի	Number
չործկայինք	ործկացե՛ք	lemma
աղեղնավորս	լավաներիս	Possession
կհուզես	չլափեին	Tense
ոստնեիք	չոստնեցիք	lemma
չկոչեիք	կանխագրե՛ք	Person
սադրեք	կհաճախեցնեի	Tense
իրականներից	նհանգիցդ	Case
կրակեինք	չկրակեցի	lemma
չճաշեին	ճաշելիս	lemma
չարկանեն	արկանեցիք	lemma
նվազներումս	արմերով	Number
հրապատումս	չաթլախներս	Possession
արարիչներովս	ընտիրովս	Possession
շեներիցս	բազազովս	Possession
քաղեցիր	ցավի՛ր	Person
կերակրեցիք	նանաներովդ	Number
թրթուրներումդ	պարասրահում	Case
նախապայմաններդ	կփարվեինք	Number
ամորձակալներս	անկվածդ	Case
արձակուրդ	փաստեր	Case
չհատակեր	կաճեցնենք	Tense
մոլեգնենք	կթոթովեիր	Tense
քունենք	կփութացնի	Tense
մեյդաններդ	լրատուիդ	Possession
կիրառվենք	կփռշտար	Tense
կառաքեմ	չտանջեին	Tense
կաշկանդից	ստադիոններիցս	Case
չուսուցանեիր	կաներկյուղանանք	Tense
արցունքներումդ	ադրբեջաներենումս	Case
տարածեին	տարածեցինք	lemma
ճանդանովդ	պերճանքներդ	Possession
կզանգեք	խոպոպեցնեմ	Tense
ձախլիկ	գնդակահարություններ	Case
չտպեցինք	գոգ	Tense
սեղանատներ	իրականությունս	Case
տուկանիցդ	թռներ	Number
աճացնի	գուրաց	Person
արձակներին	օտարոտիներովս	Number
կբողոքարկեին	չէտես	Tense
հայտնեն	կբաղխեիր	Tense
սոսինձներումդ	օթերին	Number
հոլդ	հատիկներիցդ	Possession
կգանգրացվեմ	չկարոտեցի	Person
չհորջորջեցիր	հողդողդի՛ր	Person
գինարբուներիս	թանս	Possession
բանավեճիցդ	ֆինլանդուհիներից	Case
խաշումս	սարքավորմանդ	Number
մսալիիցս	վանադիումումդ	Number
եվրոյիցդ	բացառականներից	Case
ձորը	ձորի	lemma
փախլավան	ֆրանսերեններդ	Case
ցնծացի	կնճիթովդ	Number
չառոգանող	չառոգանեիք	lemma
կզղջա	չապահովացնեիք	Tense
սիբիրախտովս	գաղափարին	Number
ասքերովս	ակրոպոլիսումս	Possession
հնգամյաս	ստորակետերը	Case
պրոլյուվիալովս	հղությունումդ	Number
փլեցին	քչքչաց	Tense
կծնգցնեք	չհամակարգեի	Tense
ագարակացրինք	գլտոր	Tense
գլխարկովդ	սուպերմարկետներովդ	Possession
դատողություններումդ	ջրկոտեմում	Case
ձախովս	ձախից	lemma
բիզնեսմեններիցդ	ծովահրեշտակիկդ	Possession
կբզզամ	չտանջեին	Tense
հայցեին	հայցեցինք	lemma
չսորան	կսաղանայի	Tense
ամպար	ջհուդներդ	Case
ազատանում	սաղարթներում	Case
սայթաքեցի	գլտոր	Tense
շարունակ	հավելեցինք	Tense
մորուդ	կարոտին	Number
զուլուումս	ցիկլոններումդ	Case
ծխերի	ռազմի	Case
չապահովվեց	մեծատառովս	Number
կառկայծենք	ընդոստեր	Tense
ճապոնականս	հսկաներովս	Possession
թիռումդ	օսեթերեններդ	Possession
կկողոպտեք	չբղավեցիք	Person
անհրաժեշտներում	այրուքում	Case
կճոռոմախոսենք	համակարգեր	Tense
ֆրանսուհիներիցդ	ֆրանսուհիներիդ	lemma
բլբլար	լրտեսեց	Person
արգելքները	պնակ	Case
կքննարկենք	չարդարացնի	Tense
վիրակապերից	էներգիայիցդ	Case
քարաքոսներիս	օֆիսներդ	Number
կամացիցդ	շամպայնովս	Number
ծնեցի	համեի	Person
պարավանդդ	երախտիքներիդ	Possession
հարբեց	չերկայնացաք	Tense
կղզիներից	նհանգիցդ	Case
վրացականին	տարածքներիդ	Case
կպահածոյացնենք	չօղողեր	Tense
քրթմնջա	քամեց	Person
քվարցներս	պորտուգալերենիցս	Possession
օսեթականներդ	անագան	Case
չհագնվեմ	հագնվեր	lemma
գրգռ	չփախցրի	Tense
երկչոտներից	ծխնելույզից	Case
դրդեք	կավելացներ	Tense
ձգտեք	տաղտկացե՛ք	Person
զխկտեցինք	չպառկեք	Number
նվարտաններիս	թանս	Possession
կերդվեիր	չտպեցիր	Person
կհոշոտեն	սնգուրվեի	Tense
կսուզի	մյուոնում	Number
քրոմներումդ	սերմնաբուշտներին	Number
ռեգգիիդ	բնակչությամբ	Number
գորովեինք	ագռավացանք	Person
ոստնեց	թարգմաներ	Person
պարանիս	թացերին	Case
շանթամբոխիդ	գահույքում	Number
ուղեբեռը	ճամփորդներ	Case
գրամեքենաներումդ	սիլիցիումիդ	Possession
սպրդեց	սպրդի	lemma
նանիներովդ	գտածոյիդ	Possession
գրենայիցդ	տերտերներովդ	Possession
կծղրտայիր	հիփհոփիցս	Number
համբերեմ	կեղծին	Number
նշանաբաններ	ուտիճդ	Case
կոմսը	աբուռներ	Case
աքսորումում	հեղձամղձուկներում	Case
աղբանոցները	արփենիս	Case
արտոնագրերումս	մեթոդներից	Number
կհարկադրեիր	չսիրւեցիր	Person
ցողուններովս	թզուկովս	Possession
աղաղակելիք	աղաղակեց	lemma
չցտեն	ցտեցիք	lemma
դիպաշարերով	չխռթացիք	Number
չվիճեցինք	տառադարձեինք	Person
հնդկընկույզիդ	երախներդ	Possession
գործարկեցինք	հեռացնենք	Person
հալումաշովդ	կուրսերդ	Possession
կմուրայի	չախտորոշեցի	Person
համբավիս	արքայախնձոր	Number
ձայնադարձերիդ	թնդյունդ	Possession
անզգայացուցիչներովս	կշիջուցանեիք	Number
մարսողությունը	խրոխտագիններս	Case
փապերիդ	կնյունումդ	Possession
մրեժովդ	վարչապետներովդ	Possession
փոխարինումների	մրջյունին	Case
նինջաներիցդ	ձախից	Case
կտեղեկանար	պապանձեցնենք	Tense
ճաղերիցս	օսմանիս	Possession
քրիստոնյայից	ստվարաթղթերիցդ	Case
նորապսակդ	քյանդրբազություններիցդ	Possession
մնացականիցս	ապարանքներից	Case
հեծնեին	կփքվես	Tense
շփոթվածություններիցս	երեւելիից	Case
չխեթկի	կբդկեիք	Tense
չխմեիք	կավելացնի	Tense
քաղեցիր	չերթայիր	Person
ճոռոմաբանականներիցս	թուրքմեներենից	Case
կատակագուսաններ	կենսախինդը	Case
կհուսահատեցնեն	տարբերեի	Tense
ջրաղացներիդ	թեորեմիցդ	Possession
չփոխարինեիր	բանեցրիր	Person
կթրեիք	օֆիսներդ	Number
հյուս	խռմփացինք	Tense
հանձնեն	կբաղխեիր	Tense
վարող	վարի	lemma
չվերագրեցիք	հումքերի	Number
իշխանափոխությունիցս	վայելուչներիցդ	Case
գուժումներիցդ	աղվանիդ	Possession
շարունակ	չթվարկեցինք	Tense
ցինկս	ջհուդներդ	Case
չգիտակցվեիր	կախտորոշենք	Tense
կառավարեն	արմերով	Number
կմատուցեինք	ձառերում	Number
ձրիովդ	մյուոնում	Number
չհուզեմ	հուզեր	lemma
ատոլներումս	լաստենովս	Possession
խանծերիցդ	դեղձանումդ	Possession
ձախերիս	գառնարածիցս	Possession
ջեբիդ	լամաներիս	Case
կհեծնեմ	չպատկանեին	Tense
կուրախացնեինք	ընդգծես	Tense
լոգարաններիս	հնդեվրոպաբանիցս	Possession
նախաբազկիդ	մեծաշիթներին	Case
գարշումդ	հեթանոսներիցդ	Possession
վիթերիցդ	վիթերիդ	lemma
մզկիթդ	գերքաղաքներումդ	Possession
թզուկի	պլատինդ	Number
ձախերիս	ըղձականովս	Possession
ստեիր	մաքրեցիր	Person
ալպինիզմդ	ձախողներիդ	Possession
կրոնականներովդ	ջինդ	Possession
մղձկացիր	մղձկային	lemma
ներկայացնող	ներկայացրին	lemma
շափյուղաներ	ադրբեջանցիս	Case
առշերտերդ	գրչատուփիցդ	Possession
շիզիկներիցդ	բորբոքիցս	Case
չտուժես	կարկեինք	Tense
կճանապարհորդեի	չբարբաջեն	Tense
գանգրածածկների	պուճուրին	Case
աշտարակը	գաղափարում	Number
սուպերմարկետդ	չոփերիցդ	Possession
ջիներից	մաճիցդ	Case
չհայտարարեցինք	առողջացր	Tense
կիբեռնետիկան	թալիբներս	Case
մրմնջացիր	նախանձես	Person
ցինկս	ծովափղերը	Case
հմայենք	կփռշտար	Tense
մզկիթդ	աչալուրջներիցդ	Possession
չերկնչի	կախտորոշենք	Tense
սամարիումներում	խնկեք	Number
կպոռոչեիր	չոլորակենք	Tense
օտարովդ	պատրաստություններումդ	Possession
սիբիրախտովս	կլիանամ	Number
կխիթայինք	սերմնաբուշտներին	Number
չահագնացար	կխուզես	Person
նքողակից	մահմեդական	Number
կփլվեն	չգիտակցեմ	Tense
չառաքի	առաքեիր	lemma
վիզայիցս	արգանդափողերս	Possession
կշնորհեիք	երթա	Tense
կտնօրինենք	չհամբուրի	Tense
տես	չհատեցիք	Tense
չթաղես	կշիջեին	Tense
չծափահարեր	կիզանուտում	Number
կէթամ	չերգիծեիք	Tense
մեղմերումդ	գաղափարիդ	Possession
խաժիդ	կաղճիններին	Case
խաբեբայություն	շեքերս	Case
բաշկիրերենը	պաճիճներդ	Case
մաքրես	կկարմրեինք	Tense
կարկանդակ	քրիստոնյաները	Case
շերեփներումդ	լրատուիդ	Possession
միմոսովս	պարսավանքներումս	Possession
պորտապարում	նավթադոլարներումդ	Case
ձգտեք	չհափափեցիք	Person
խղճացող	խղճացին	lemma
մոռացոնքներին	ունակներովս	Number
ագուցվեր	կայացավ	Person
չկառչեն	քցեցին	Person
ծափահարվ	ծափահարվեք	lemma
ռացիոնալներովդ	գերանդուցդ	Possession
ռուբլում	կոտորներումդ	Case
չթարգմանեք	կանխագրե՛ք	Person
կթլփատես	թլփատի՛ր	lemma
կթուլանայիք	չկատաղեցիք	Person
ադամանդումս	կաշկանդյալներում	Case
թենիցդ	անրջայիններդ	Possession
փապերիդ	քյամանչայումդ	Possession
ստվարներդ	արփենիս	Case
մարսողությունը	ազգանուններ	Case
չըմպենք	կնվար	Tense
ձերբակալիցս	ծախերիցդ	Case
տատիկ	պատառները	Case
կիմերի	կանխամտածեց	Number
քվարցներս	ռուբիդիումումս	Possession
տենայիր	կապացուցեն	Tense
խճուղիների	անթիդ	Case
աճապարես	ծայրահեղականով	Number
կահագնանաք	ուզբեկերեններովս	Number
նախընտրեցի	նեղաց	Tense
ինդոնեզերենովս	հասարակներիս	Possession
արևածաղկի	աղբերակովս	Number
չուղեկցի	հեռվով	Number
մաշկյակներումս	թաղերդ	Number
ճոռոմներիս	նախաբազկիցս	Possession
թավուտդ	վիթերս	Case
զոդեին	զոդեցինք	lemma
նամականիշներից	մեռելից	Case
անսովորներիցս	ավազակիս	Possession
պղինձներ	շնորհենք	Number
ագրեսիվներովդ	ղափամաներիս	Number
կպահածոյացնենք	չարդարացնի	Tense
հեղուկիցդ	խալիս	Number
չվերծանես	բեկտի՛ր	Person
վերուվարի	կհրճվեիք	Tense
փոխանակեցիր	փոխանակեին	lemma
լիզեցիր	լիզեին	lemma
գնոստիցիզմ	ծովափղերը	Case
պլաստիկներիցս	տաջիկերենումս	Possession
հարբեց	չտարածեցիր	Tense
մաքրես	կպարտվեին	Tense
ղպտիականներովդ	չքանդեինք	Number
վաճառասեղանումս	փույթիցդ	Number
կդարբնեք	գերծեմ	Tense
աշուններիս	հումուսումս	Possession
ձգտեր	քերծեց	Person
եփեինք	տախտակամածներովդ	Number
մատնություններս	առակախոսովս	Possession
ալպինիզմդ	որձաքարերիցդ	Possession
նարտովդ	թարգմաններիցդ	Possession
ռեֆորմներից	կահույքիցս	Case
կտրամադրեր	չկաշկանդեց	Person
ժանտափշերումս	անմիտումդ	Case
մուրուքիցդ	բացառականներից	Case
համովիս	նադիրներիդ	Case
տերեփուկովս	լավաներիս	Possession
չհարկանեք	կհարկանի	lemma
գոյացաք	չդարսեիք	Person
հասցնենք	կխածի	Tense
կխոչընդոտեին	չշնչես	Tense
կանտոններս	ճառագայթիս	Possession
արծաթիներից	սարդիցդ	Case
ավարներիս	աքսորյալիդ	Case
ռազմիկների	մրջյունին	Case
կբդկեիք	չսիրուեցիք	Person
հոտոտեի	մարտահրավեր	Number
համոզեինք	չհամոզեցի	lemma
մալայերենիս	մեծաշիթներին	Case
փքուններդ	ղիամաթիցդ	Possession
չկանչեցիր	նախանձես	Person
վաճառասեղանումս	երկայնաբանդ	Number
լուցե՛ք	կտակեցիք	Person
ակնածալիցներին	փետիս	Case
ջրաղացներիդ	ազերիդ	Possession
կաբստրահվեիք	անթայրները	Number
չփրփրեն	կխռմփացնեմ	Tense
թվահմայություններովդ	լրատուիդ	Possession
ծխերի	վարպետին	Case
իռլանդերեն	նվարտանները	Case
թալմուդները	կողոպտեին	Number
չծնգցնեն	ծնգցրիք	lemma
ողնաշարիցս	տողադարձերումս	Possession
կենսախինդներիցս	կենսախինդներ	lemma
ղայիշիս	թիթեղներիդ	Case
տագալերենով	վիկինգովդ	Number
աղեբեկներովդ	ենթակառուցվածքդ	Possession
որսացի	չհանգստանամ	Person
բանավեճիցդ	խեչակներիցս	Case
թխկուց	հաղարջենիներիցս	Case
հնարքներումդ	մրեժովդ	Possession
տերեփուկովս	ձկնաբանականներովս	Possession
կտաղտկանա	չարածեցնենք	Tense
պատկանեի	կնեխեք	Tense
ռեակցիաներիցս	հմուտներովդ	Number
ապուխտում	խցիկներում	Case
ցինկովս	կրկեսովդ	Number
տեւեք	կխածի	Tense
տագալերենով	չգարշեց	Number
մեծից	մեծերին	lemma
ընթացաք	կհորանջեք	Person
ընդարմանալիք	ընդարմացավ	lemma
խրճիթումդ	գնաճերդ	Possession
կքցենք	կռկռացինք	Person
ներդրումը	ներդրման	lemma
գովասաններիս	ֆայմերովդ	Number
ճանապարհորդիցդ	չոգեշնչեցի	Number
կգուրգուրայի	ագուցավորեն	Tense
չմիանա	պոռոտախոսեց	Person
կհոշոտեն	չխնամեիր	Tense
արամբիները	օյինբազս	Case
նախարարին	բարձրավանդակներիս	Case
կախարդվածություններդ	գերանդուցդ	Possession
մույթերում	մարզասրահումս	Case
մոդեմի	պիստակներին	Case
չաղարտած	չաղարտեցի	lemma
ձարխոտեր	ձեռնտուներիս	Number
իրավազուրկումդ	խցիկներում	Case
շփոթմունքը	քածիցդ	Number
նստարաններովս	շտանգիստիցս	Possession
փորձեիր	կախտորոշենք	Tense
աքսորումում	նավթադոլարներումդ	Case
չհամբուրող	չհամբուրեիք	lemma
կհղենանք	չշփես	Tense
էտրուսկյաններին	էտրուսկյանովդ	lemma
ցեղասպանություններից	ստվարաթղթերդ	Number
մոշիներիցդ	հղությունից	Case
չըղձա	կրկեսովդ	Number
չարմացաք	կհուսահատվեք	Person
չնախընտրեցինք	գեղեցիկներումդ	Number
ծնեցի	չկարեկցեմ	Person
խալ	գաղափարում	Number
փոխհատուցես	չսիրւեցիր	Person
բուժումներից	մաճիցդ	Case
աղեբեկներովդ	բուժքույրդ	Possession
ալեմաներեններից	կչվեինք	Number
պրոլյուվիալովս	մետաղադրամումդ	Number
ազնավորներիդ	պուճուրին	Case
ընթրիքով	կսարսափեի	Number
կցտես	շիջեցիր	Person
բաղարջումս	բնակչությամբ	Number
չբացառեցի	մինարեթում	Number
կանիծեիր	չսորանք	Tense
կվերծանես	դրսեւորեինք	Tense
մորալիստներովդ	երկաթեղենովդ	Possession
վառվեին	վառվեցինք	lemma
գիտակիցներ	գիտակիցովդ	lemma
ֆոտոնումդ	կոթողներովդ	Possession
դատողություններիս	ղսմաթովս	Possession
երկչոտներից	բարիկադիցս	Case
ռուբլում	մանրէաբանականներում	Case
չկքեինք	կռկռացինք	Person
կքծնենք	չփութացինք	Person
անզգայացուցիչներովս	չմտմտայինք	Number
միեղջյուրներիցդ	չբուսանեցին	Number
չկիրառվի	կիրառվեիր	lemma
բյուրս	հուռթիները	Case
լաոսերենիդ	արտագաղթերի	Case
բնորոշե՛ք	խորվաթները	Number
լիբրացիաներիդ	անորոշները	Number
հարգող	հարգի	lemma
թզուկից	չոգեշնչեցի	Number
կիզեն	յոգաներումդ	Number
սուջուխներդ	ֆրանսուհիս	Case
արդարացրեց	առողջացր	Tense
կուսաթաղանթը	արգատներս	Case
կշնորհեիք	չհրկիզեմ	Tense
զորեղներդ	կինոն	Case
կոլգոտկայիս	հոբելյարներին	Case
կախարդվեիք	չկախարդվեցիք	lemma
հորդորանքներս	փականը	Case
ռեֆորմներից	քեռակնոջիցդ	Case
սագերիդ	դեղձանումդ	Possession
ձախլիկ	ջերմուկներ	Case
ադամանդներից	սուսերամարտիկիցս	Case
լավաշներդ	ձախիդ	Possession
չսավառնեց	առողջացր	Tense
մասնագիտության	լիրը	Number
մահացավ	չբաղբանջեր	Person
կարօտենք	գովեցինք	Person
հրվանդանի	ինդիումներիս	Case
ապրուստներս	թեզնիքների	Number
սավառնե՛ք	չսնգուրվեք	Person
սեղանատներ	փականը	Case
ոսկիս	ոսկիներովս	lemma
կգոյանանք	կգոյանաս	lemma
գրենականներով	գրենականներում	lemma
խոպոպիներովս	խոպոպիներիցս	lemma
կճատս	ոսկյային	Number
չհարնչեն	կկանխամտածեմ	Tense
քաջալերանքներովդ	ստարտափիդ	Possession
ցացիկիումդ	երախներդ	Possession
երամակների	հղացքի	Case
կքաղցեմ	փլեիք	Tense
կուրումս	չեչեներեններս	Possession
տիբեթերենումս	կողպէքներս	Possession
չբարեւեցիր	նեղաց	Tense
կապտավունից	ժպիտներիցս	Case
փիլիսոփոսիս	կղմինդրների	Case
հրասայլին	առաջավորում	Number
շենք	ճոռոմախոսներդ	Case
չկանխենք	օրթախներովս	Number
հորանջների	օրիորդիդ	Case
կորսաք	կնքեցիք	Person
թլփատ	չկթոտեցին	Tense
կրիս	նունուֆարներիդ	Case
աթեիզմիս	ղազերի	Case
մրուրը	մյուոնում	Number
չզեռացիր	կզեռաս	lemma
մագնիսականությունների	հակասեմիտականությանդ	Case
ծխերի	թարխանությանս	Case
բրետոներեններիդ	փաշաներով	Number
չփոխարինեիր	շշնջա՛	Person
առաջատարներումս	հաճախորդամետս	Possession
սրճեփներիդ	փաշաներով	Number
կրաքարի	նունուֆարներիդ	Case
գանգրիկի	թոխորը	Number
մոլեգնենք	կապշեր	Tense
հետազոտեցի	չդարսեի	Person
զգուշաց	տառապեցրեց	Tense
կորսաք	վառվեցիք	Person
կարծեիք	կապուտները	Number
ահագնանան	չհայեցին	Person
բիբարում	չթաղեիր	Number
ղեկավարությունների	նիդեռլանդերենիս	Case
քվեարկողիդ	թացերին	Case
չփարվեինք	փարվե՛ք	lemma
զորեղներդ	արփենիս	Case
հափշտակումներդ	կենսախինդը	Case
կրիս	տափաստանայիններին	Case
ափիոնիցս	աշտեններիցդ	Case
բացականերովդ	կռվեցին	Number
չբացառեցի	սեքսիզմումս	Number
ատոլներումս	ինքնուրույնիս	Possession
կվարցիտների	չաքուչի	Case
մույթերում	ջրկոտեմում	Case
զովերին	ներկայացուցչության	Case
խորովածներ	պլոճիկներումդ	Number
շիզիկներիցդ	գանգրափնջիցս	Case
գաղձերդ	գեյզերներից	Number
համեղների	կուղբիս	Case
մատնություններս	շտանգիստիցս	Possession
հոռովելը	պարտեզներս	Case
արգելքները	ընկճախտ	Case
պատվանդաններդ	ռեգգին	Case
ներգաղթող	ներգաղթեցին	lemma
փոխանակությանս	դատողություններիդ	Case
բնույթից	օղակներից	Case
հատապտղում	երիկամունքիդ	Number
ֆոտոնումդ	եղծերիդ	Possession
բացառե՛ք	մատյաններիցդ	Number
մթնշաղներդ	իրականությունս	Case
հորջորջներիս	վհատիցս	Possession
բողովդ	գրողներդ	Possession
օդապար	ներցին	Number
չկանչեցիր	լկստի՛ր	Person
պագերի	պատյանիս	Case
չօթի	հեծավ	Person
փոխանակությանս	մանվածքայինների	Case
չափսիս	սրերովս	Possession
կահագնանաք	հորդորեցուցիչներիս	Number
չառկայծի	առկայծեիր	lemma
կծնեն	չշփես	Tense
չապաշխարեցիք	քելեք	Person
ավարներից	լիսեռից	Case
արբանյակներովս	խեղկատակիս	Possession
ճոպանովս	շորերումս	Possession
քառյակը	մզկիթներ	Case
սրճենիներ	ճոռոմախոսություններումս	Number
ձկնկուլները	տասերորդդ	Case
կտակը	ազգանուններ	Case
լոգացի՛ր	չզեռայիր	Person
կզրնգար	չահագնանաք	Tense
լիզեցիր	սորաս	Person
շիկանա	կկաշառենք	Tense
համովիս	խաչակիրներիդ	Case
հոգեբանությունների	թովիչներիցդ	Number
ուրանար	նախաճաշեց	Person
աֆղաներենը	աֆղաներենի	lemma
ձախերիս	նախաբազկիցս	Possession
ահաբեկվեիր	կախտորոշենք	Tense
բարձիթողիներին	բարձիթողիովդ	lemma
քսիլոֆոնիցդ	գանգրահերներդ	Possession
դատողություններիս	ընտիրովս	Possession
կստեք	ավանդե՛ք	Person
թեյնիկներդ	լոժբանումդ	Possession
սուտասաններովս	ափսոսովս	Possession
դանդալոշը	քածիցդ	Number
չամայացած	չամայացա	lemma
հաստիչդ	ծերուններիցդ	Possession
չմուրամ	արմացա	Person
կհալածեք	չզանգահարեի	Tense
բանավեճիցդ	բժշկություններից	Case
չմահանա	կարօտեց	Person
կեպերեի	կապուտս	Number
հակասեմիտականություններս	ակնածալիցդ	Case
նախապայմաններդ	մահկանացուներով	Number
կպղծեր	քամեց	Person
կճանապարհորդեի	չտռեք	Tense
կիրառվենք	կճմլեիր	Tense
նքողակից	խորանարդովս	Number
կաթնապուրներին	չափածոներումս	Number
թանային	հագնվեցին	Person
մանգուստներով	օթեն	Number
միացավ	միանա	lemma
բիզնեսմեններիցդ	աղվանիդ	Possession
կոլգոտկայիս	ավազաքարերիդ	Case
ալկոհոլների	ծիծառնուկին	Case
մարսողությունը	ջհուդներդ	Case
մոռացոնքներին	ըմբիշներդ	Number
աբսոլյուտներիցդ	թուրքերենդ	Possession
երկայնեցիր	երկայնեին	lemma
ալերգիայումդ	որձաքարերիցդ	Possession
չընդոստեցիր	կընդոստես	lemma
չկաղկանձեցինք	կսիրւէինք	Person
հակասեմիտականություններս	մեքսիկդ	Case
կարտոֆիլը	ազգանուններ	Case
մագնիսականությունների	շաուրմայի	Case
քաչալներիցս	կպոռոտաբանեիք	Number
ալբոմումդ	ֆերմիոններիդ	Possession
ձախլիկ	գոսերդ	Case
մատնություններս	նոյեմբերյանիցս	Possession
կոռներենովս	թավաներս	Possession
ապացուցեցի	ճամփորդեի	Person
սագերիդ	պալայերենդ	Possession
հոնքերս	գյոթովս	Possession
ճաղիցդ	սրճեց	Number
դարսի՛ր	ընտրվեցիր	Person
անձեռոցիկները	բարբարոսներովդ	Number
արխիվներիցդ	չքանդեինք	Number
ուրախացրո՛ւ	կկշռադատեիր	Person
փոխանակությանս	ավազաքարերիդ	Case
կամացիցդ	կռիսովս	Number
աքսորակցովս	միջածանցներս	Possession
աքսորականովդ	քալամներիդ	Possession
ախտարարս	խրոխտություններդ	Case
ասպազեններ	անկվածդ	Case
թովեք	կճաքի	Tense
չհոլանեիք	կաղարտեմ	Tense
մտոցումդ	տերտերներովդ	Possession
թթվի	կղմինդրների	Case
ականավորներումդ	ականավորներումս	lemma
հաճախորդությանդ	որձաքարերիցդ	Possession
ծանոթներ	ֆրանսուհիս	Case
չզվարճանայինք	կճաքի	Tense
նանիցդ	օսեթերեններդ	Possession
մետաքսեում	պողովատիցդ	Number
նվաղես	կհամարեինք	Tense
բուլղարերենից	բուլղարերենումս	lemma
կխրախուսեն	չլուցեցին	Person
ճոպանովս	ահաբեկչություններովս	Possession
կվաճառենք	չշփես	Tense
փոխարինումների	ֆինլանդացուն	Case
ցողկ	արդիիցդ	Number
ֆերմիոնում	չշիկանաս	Number
գեղեցկությունիցդ	ստադիոններիցս	Case
չուղեկցի	ծայրահեղականով	Number
ծանոթներ	փականը	Case
սիբիրախտերումս	ստորագրությունում	Case
կծվերումս	գուջարաթիիս	Possession
կզրնգար	չջղայնացնեք	Tense
մահացավ	կփչեր	Person
հարգանքներիցս	կայունումս	Possession
մագնիսականությունների	քաբաբիս	Case
կհուսահատեցնեն	չծաղրեմ	Tense
ճոռոմախոսումդ	խակերդ	Possession
չխոսանք	կռկռացինք	Person
չըղձաք	կերկկտտացնեի	Tense
մատնություններս	ափսոսովս	Possession
բառգրքերս	տողիցս	Possession
մոռացոնքներին	չմատնեք	Number
գտածոներումս	անձրեւում	Case
առաքինություններս	տասերորդդ	Case
կանկանս	մալթայերենները	Case
չերկնչի	կվախեիք	Tense
անգիրներովդ	խուճուճումդ	Possession
գահավանդովդ	այծենիում	Number
պոչուկից	խալիս	Number
անդրկովկասցիներիցդ	լիգայումդ	Possession
շեներիցս	ինքնուրույնիս	Possession
գոնադովս	խորերումս	Possession
չտեսաք	գանգրացե՛ք	Person
ճապոնականս	ձկնաբանականներովս	Possession
պեդալներ	չուրախացրինք	Number
կայուններովս	ծծովս	Possession
կոկոսյանումդ	լոուրենսիումներովդ	Possession
ասպազեններ	շառաչ	Case
հարգանքներիցս	սիեստայովս	Possession
կվիճաբանես	սսկվեին	Tense
զիստում	վայրագի	Number
կախս	կախերովս	lemma
չկրեր	կբխենք	Tense
կշրջվեիք	խոպոպեցնեմ	Tense
կհղանայիր	խոստանան	Tense
կվիճես	վիճի՛ր	lemma
ծառայությամբս	ցցունքներիս	Possession
սուջուխներդ	բնակիչս	Case
չազդվեց	նեղաց	Tense
կմեղադրեիք	վառվեցիք	Person
կհպարտանայիր	չճոռոմախոսեն	Tense
սուջուխներին	թարխանությանս	Case
կուռեն	բռնաբարեմ	Tense
կստիպեի	բաղբանջեք	Tense
արդյունքը	մետաղադրամումդ	Number
կկտակեին	սառեցին	Person
ծածանեիք	կարեկցե՛ք	Person
լիտվերենիդ	զիբիլներին	Case
քոռում	հաճախորդություններումդ	Case
կարմրավունդ	ջերմերովդ	Possession
մարսողությունը	սուզանավերդ	Case
հյուսներովդ	հարկահավաքովդ	Possession
կանիծեիր	փսխենք	Tense
ոսկեղենդ	ջերմուկներ	Case
կգեղգեղեիք	չհամբուրի	Tense
հերքե՛ք	հայթայթանքներիցդ	Number
պալատականներիցս	լահմաջոս	Possession
ճմռե՛ք	չարբեիք	Person
անձնանունների	շաուրմայի	Case
գիտելիքներումդ	վերադարձդ	Possession
զավտրըկը	գոսերդ	Case
լեռնայինովս	չաղոներս	Possession
տուկանիցդ	ծայրահեղականով	Number
չդրդի	կօթեք	Tense
պարասրահս	լրատուներովս	Possession
հեղձամղձուկներիցդ	լրատուիդ	Possession
ճանապարհից	օղակներից	Case
լումայովս	թռներ	Number
կխանձատեմ	պաղատեցի	Person
խելոքներովդ	բուժքույրդ	Possession
արաբերենումս	պարմեզաններովս	Possession
փախերդ	լոժբանումդ	Possession
փորի	չպոռոտաբանեց	Person
օդապարիկդ	կպչուններիցդ	Possession
կրաքարի	զիբիլներին	Case
քառյակը	խրոխտություններդ	Case
ծպտող	ծպտեցին	lemma
թեշիկս	երկաթգծում	Number
չկայանաս	կկայանայիք	lemma
կորոճաք	շռեմ	Tense
չբեկտի	կբխենք	Tense
ագրեսիվներովդ	սալորենիներում	Number
չզարմանայինք	զարմացե՛ք	lemma
ռազմիկների	անթիդ	Case
պուպուլիցս	վերմիշելներումս	Possession
չկիրառվեցիր	կիրառվող	lemma
երկչոտներից	չարաչարիցս	Case
չգլես	համբուրվի՛ր	Person
ազդվեցի	կշիկանայի	Person
չփչեինք	փչե՛ք	lemma
երկայնանայիր	կմտմտան	Tense
կերակրեցիք	դեւերիս	Number
ժամկետս	նմաններիցս	Possession
գանգուրիդ	օրանգուտաններդ	Possession
չտեսաք	կհուսահատվեք	Person
կընդոստեինք	նախաճաշի	Tense
ոլորանս	մալթայերենները	Case
կպահածոյացնենք	համակարգեր	Tense
նոբելիումներում	փաշաներով	Number
քաջալերություններիցդ	աչալուրջները	Number
աստվածաբաներդ	դուզնաքյաներով	Number
նվազներովդ	մորուքիցդ	Possession
ծովատառեխներումս	գեղանիիցս	Possession
մզկիթդ	հատորներովդ	Possession
գնոստիցիզմ	աբստրակտներս	Case
հոտոտես	համբուրվի՛ր	Person
հոյաշենովս	դարպասապահներս	Possession
ուսումնասիրեցիք	պուպուլներից	Number
կստիպեի	քերծեք	Tense
լոգացի՛ր	կբարեւես	Person
ասքերովս	բրետոներենումս	Possession
գրամեքենաներումդ	նազովդ	Possession
հեղեցին	կշարունակեն	Person
ասորիներովս	խոպոպաձեւներ	Number
չչաղացանք	առողջացնենք	Person
կրոնականներովդ	խուճուճումդ	Possession
սեւիդ	մանվածքայինների	Case
թեկնածուներին	հղացքի	Case
ծնկոսկրիս	սերմնաբջիջներս	Possession
կվրդովեին	օրթախներովս	Number
արգելիցդ	չվերթներից	Case
հակասեմականություններից	հելլենացուցդ	Case
ամորձուցս	թարշամներովս	Possession
լինգալայիցդ	չհորանջեցի	Number
կհոշոտեն	զառամանայիր	Tense
տասերորդից	չխուզեիր	Number
գոնադովս	ձկնաբանականներովս	Possession
պտղատուներդ	կցորդներիս	Number
կյուրիումս	ալմասներ	Case
տենայիր	կկաշառենք	Tense
ջերմություն	մյուոնում	Number
ծծիցդ	որմնախորշերիցս	Case
հասցնենք	կշիկանայիր	Tense
արգելիցդ	պոկերներիցս	Case
պարարտներով	պարարտի	lemma
կախարդվեց	չառաջադիմի	Person
շինականներովս	ճնշումս	Possession
մեղմերիս	բումերանգովս	Possession
սուրահին	ռեստորաններիս	Case
շիկամկնիցս	բույներումս	Possession
յուաններով	կայծքարերում	Number
կլքնենք	չըմպեցինք	Person
միանա	միացնել	lemma
հմայենք	կզոդի	Tense
պարտիաներ	կարելիդ	Case
փոխանակությանս	կաղճիններին	Case
դիսպաշերով	կսարսափեի	Number
խաբեբայություն	բորշչերդ	Case
թովեք	կսաղանայի	Tense
կհուսահատեցնեն	չշնչես	Tense
կախակապերումս	ուռենովս	Possession
միջատաբանականումդ	սաղավարտներովդ	Possession
սիկղերովդ	աղվանիդ	Possession
արդյունքների	պուճուրին	Case
կմղձկանք	կմղձկաս	lemma
բացառե՛ք	բարբարոսներովդ	Number
պարտիաներ	օյինբազս	Case
շարժիչիցդ	խեչակներիցս	Case
կճատս	բեւեռացույցից	Number
դալուկներս	կճոռոմաբանեին	Number
հնգամյաս	ալմասներ	Case
մավիս	սխտորներումս	Possession
չվիճեցինք	կտռեինք	Person
ագուցվեր	զվարճացավ	Person
այլատյացություններիցս	շվեդից	Case
հեղուկներումդ	բույնիդ	Possession
տատիկ	եկեղեցականներ	Case
չմրմնջացին	գլտոր	Tense
անկումներովդ	ծովահրեշտակիկդ	Possession
չմտաբերեն	հագնվեցին	Person
ակներեւներս	չմատնեք	Number
տեղյակիցս	ջրանցքներս	Possession
կկասկածեն	ներբեռնես	Tense
կկաշկանդենք	ծլարձակեիր	Tense
չապացուցվեցիր	թոռոմի՛ր	Person
ստիպեցիր	նախանձես	Person
դրվատեին	յոգաներումդ	Number
կօժանդակեմ	չհամոզեն	Tense
մոդեմի	բամբասանքներիս	Case
կփլեիք	չմեղկացաք	Person
կագուցավորեր	չաբստրահենք	Tense
ցողուններովս	հաճախորդամետս	Possession
ագուցվեր	չմեկնեց	Person
բաղձանքի	երկսայրիներիդ	Case
կպատկերեր	ոսկրաբանիցս	Number
ճոպանովս	չաքուչներովս	Possession
գրգռ	գիտակցեց	Tense
կանկարներիս	կպոռոտաբանեիք	Number
կվարցիտների	վինիս	Case
կարկանդակ	սուզանավերդ	Case
համբավիս	չկաշառեց	Number
չահագնացար	գիտակցվի՛ր	Person
բեւեռացույցներումդ	ելույթդ	Possession
ջրաղացը	վիթերս	Case
դրսեւորեց	գոգ	Tense
կիզեն	խոլորձներումդ	Number
կվարցիտների	վարպետին	Case
աքիլլեսյաններիս	սեւականի	Case
բարվոքիցս	շանթամբոխներովս	Possession
կիրառվենք	կպատառեիր	Tense
սառեցիր	սառեին	lemma
ուռեին	ուռեցինք	lemma
ցուցանակիդ	հրահրի՛ր	Number
տառապի	կհորջորջենք	Tense
ծափահարեին	կքորեմ	Tense
կառաքեմ	զգենան	Tense
ջերմաչափներիս	շտանգիստիցս	Possession
քրիստոնյայից	թեներից	Case
չաղավաղեցինք	զեղծ	Tense
ծածանեիք	ուղարկե՛ք	Person
մեծացե՛ք	չկատաղեցիք	Person
ամորձատեցինք	կատեգորիաներումդ	Number
անմիաբանություններդ	վուշիցդ	Possession
չխոպոպացրիր	խոպոպացնող	lemma
տասերորդից	կանխամտածեց	Number
հայհոյեց	թքի	Person
չբարձրաձայնեք	կբարձրաձայնի	lemma
կհակազդես	չհամոզեն	Tense
ճոռոմախոսումդ	երախներդ	Possession
լիբրացիաներիդ	չհամակարգեցին	Number
պագնեիք	չստեցիք	Person
փորի	քերծեց	Person
սոկումդ	ողորկություններովդ	Possession
հրեղենիս	խորերումս	Possession
գազաններովդ	կրումդ	Possession
ձայնարկություններիցս	անկածիցդ	Case
արսեն	համաներումներ	Case
ժողովածու	նիզակներս	Case
ընգե՛ք	չհափափեցիք	Person
կողքդ	վիթերս	Case
կգեղգեղեիք	սրտաշարժի	Tense
չնվագենք	կճմլեիր	Tense
կհոխորտայի	չճոռոմախոսեն	Tense
ուղարկող	ուղարկի	lemma
գնացող	էթա	lemma
կախակապերումս	շառավղիս	Possession
ֆիննականներումդ	եպերներով	Number
կռթն	կռթնեք	lemma
ստիպեցիր	թոռոմի՛ր	Person
հեցերովս	կշիջուցանեիք	Number
ոստնեց	կքայլի	Person
ամբարիշտներիդ	հացահատիկովդ	Possession
փախցնես	համբուրվի՛ր	Person
երկնչոտով	դեղաբույսովդ	Number
արգելքները	շառաչ	Case
խոպոպացվեին	խայթեցին	Person
կարող	կարի	lemma
կրիս	թացերին	Case
կէթաս	չսիկտիրվեինք	Tense
թռնեինք	չթռա	lemma
օրականներից	տգետները	Number
չոլորես	կպահպանեինք	Tense
թալմուդներդ	փաշաներով	Number
չվերծանես	նպաստի՛ր	Person
կշտկեր	չթովեք	Tense
կպատկանեինք	չհյուծեցինք	Person
դանդաղկոտներին	ճոռոմաբանի	Case
աշուններիս	ափսոսովս	Possession
չբարելավենք	կքերծեիր	Tense
վավերագրականիս	որթերս	Possession
ալբոմումդ	ստամոքսներդ	Possession
կբողոքարկես	բողոքարկի՛ր	lemma
թոռոմեց	չքոչի	Person
հառաչալիս	հառաչալիներովս	lemma
զվարճացնեինք	չըմպեցինք	Person
որորներից	ուռույցքիցդ	Case
մարտնչելիք	չմարտնչեցիր	lemma
ցանկություններովդ	կռիչքներովս	Number
լոգացաք	չհանձնեիք	Person
խիթքերիցդ	խիթքերիդ	lemma
գանգրանմանս	գանգրանմաններովս	lemma
մասնագիտության	թերահավատով	Number
հիր	մաքրեցիր	Tense
պլաստիկներիցս	տապակովս	Possession
չարկանեցիր	կցտեիր	Person
չազդվեցի	խթեի	Person
արսեն	քրիստոնյաները	Case
փոխարինումների	կուրծի	Case
կգլդորեմ	չտրոհեիք	Tense
կթրեիք	քոչերին	Number
տագալերենով	կտեղեկանամ	Number
շփոթմունքը	էջի	Number
ծոցատետրեր	չոստնենք	Number
հորդորող	հորդորեցին	lemma
այրիները	անագան	Case
կարծեիք	օֆիսներդ	Number
կղբենիներս	ծափահարմանս	Possession
ծանրաբեռներով	ծանրաբեռներում	lemma
կագարականանք	կագարականաս	lemma
հաղթի	ներարկիչների	Case
դալուկներս	ուժեղանայիք	Number
չհակազդող	չհակազդեիք	lemma
թղթադրամ	մարզիցս	Number
գառնենիների	տոռնիս	Case
տասերորդից	ենիչարիիդ	Number
ֆալիսկերենի	ձմերուկիցս	Number
կգրադարձի	չմաղթեիք	Tense
կսփոփվեմ	կոստղովդ	Number
ձարխոտեր	կշիջուցանեիք	Number
կայուններովս	ճահճումս	Possession
կշեշտեք	ընկճեմ	Tense
թիռումդ	անրջայիններդ	Possession
չօթի	ճմռթեց	Person
հուսահատեցնեիք	ավանդե՛ք	Person
վերմուտից	խաչքարերիցդ	Case
ձուլի	կօթեք	Tense
ստեիր	համբուրվի՛ր	Person
հանգստանայինք	չհանգստացա	lemma
վաճառեիք	կնքեցիք	Person
կդարբնեք	չապահովացնեի	Tense
անձնանունների	վարպետին	Case
կկալնեն	չհիմնավորեմ	Tense
հառաչալիներից	սուտասանից	Case
տագալերենով	չհատեմ	Number
տիք	կալեր	Number
խառնեցիր	խառնեին	lemma
կհոշոտեն	ապահովեի	Tense
չբուծանեցին	կկամենան	Person
պերճանքում	հեթանոսներումս	Case
քանդակներովս	տաքավունս	Possession
սպրիչ	դալարուտիցս	Number
օգոստոսյանների	ռազմի	Case
ճոռոմներիս	սառույցումս	Possession
բնակչությունիցդ	հեռվով	Number
թերասնում	խրոխտագիններս	Case
գոնադովս	ջաներիցս	Possession
կտնօրինենք	նախաճաշի	Tense
հասարակներիցդ	խոնավավունիդ	Possession
կոստղաշատս	մզկիթներ	Case
վանկարկեց	վանկարկի	lemma
աբրեշումեներ	աբրեշումեովդ	lemma
վիզաներիդ	տարեկանումդ	Possession
մսալիիցս	մոլեգնեցի	Number
պագերի	օղակիս	Case
ճոռոմներիս	կատարյալիցս	Possession
պայտերումդ	պոռոտդ	Possession
թորիծ	քավումդ	Number
թեղոշներում	թովիչներիցդ	Number
մարգարեուհուդ	հիփհոփիցս	Number
կենսալիրների	մարկիզիդ	Case
պորտապարում	զորեղներումդ	Case
գլխատառիս	արդիիցդ	Number
չքշեցիք	համակարգ	Tense
մահկանացուիցդ	ինքնությանը	Number
մացառուտիցս	չվերթներից	Case
կհեռեր	ֆոտոնայինիցս	Number
քանդեին	կաղարտեմ	Tense
կառավարեն	հայթայթանքներիցդ	Number
շենք	ազգանուններ	Case
կփայփայեինք	ճկույթներումդ	Number
չբեկտի	կարկեինք	Tense
կհեծնեմ	չհանձնեք	Tense
խոցոտի՛ր	խոցոտում	lemma
չհազացիք	երթայիք	Person
կարկանդակ	օդերեւութաբանականներս	Case
վերազգայինումդ	կաշկանդյալներում	Case
ձրիովդ	ատակիս	Number
ընգե՛ք	կծղրտայիք	Person
թավուտդ	աբուռներ	Case
համբուրվեցիր	կբուծանեիր	Person
սեղանատամներումդ	սրբոսկրում	Case
պղնձաձույլներդ	տիեզերագնացներիս	Number
հոխորտայի	չախտորոշեցի	Person
պայտովս	կռինչներովս	Possession
ձաղե՛ք	չհափափեցիք	Person
գոռաց	գոռա	lemma
չուռեցինք	գայթակղենք	Person
լատվիերենից	լատվիերենումս	lemma
կոկոսյանումդ	ձայնադարձերիցդ	Possession
ժամկետս	խուլիգաններովս	Possession
չգոչեինք	գոչե՛ք	lemma
չծածկեիր	թոռոմի՛ր	Person
սողդերենդ	սուպերմարկետներովդ	Possession
պիտույքովդ	սկանդիումներիցդ	Possession
նախամայրերիդ	գերանդուցդ	Possession
կկասկածեն	չբուսնեիր	Tense
զանգեինք	կբաղխի	Tense
կարօտենք	չերազեցինք	Person
կրեցի	առողջացր	Tense
միլիմետրումդ	որոճներում	Case
կաղամ	խոցեք	Tense
խնամուցս	բացառականներից	Case
բրիչովս	կքաքեր	Number
պտուտակահաններ	էլեկտրոն	Case
չարաչարիդ	տափաստանայիններին	Case
այսրկովկասյանը	չբանտարկեմ	Number
հայհոյեց	կքայլի	Person
մարզասրահումդ	մահմեդական	Number
կմեղադրեիք	կտակեցիք	Person
չափահասների	լիտվաներեններիցս	Number
շամբուտիս	խորհերումս	Possession
չազդվեցի	կխոյանամ	Person
գառնենիների	ճապոներենին	Case
իռլանդերեն	մարդելույզներդ	Case
որձերով	որձերում	lemma
բիզնեսդ	հավելվածներումդ	Possession
արարիչներովս	կաղապարս	Possession
ճագարներին	բեկորիդ	Case
հերքե՛ք	գրասեղաններին	Number
արեգակնային	հանդերս	Case
կադմիումիդ	մեծատառովս	Number
բարելավեցիր	քչքչաց	Tense
հեռուստատեսություններին	կճոռոմաբանեին	Number
բացառեց	առողջացր	Tense
օտարովդ	թարգմաններիցդ	Possession
արթնանա	չկաշկանդեց	Person
էլեկտրոլիզիցդ	մետաղագործություններիդ	Possession
կամացիցդ	կանաչազարդիս	Number
ձաղանքումդ	օսեթերեններդ	Possession
մատյանիցս	գիտակցականություններս	Possession
կաշառենք	չվարանեցինք	Person
չափսիս	նախասրտերումս	Possession
չմտադրեք	կմտադրի	lemma
չոռնա	կցտեինք	Tense
սրճեցի	չչորացնեմ	Person
չկոշկոճեցի	խթեի	Person
տապիոկայիցդ	կոթողներովդ	Possession
խազող	խազեցին	lemma
բաստուրմայից	փաշաներիցս	Case
կքրթմնջանք	կքրթմնջաս	lemma
լոուրենսիումներին	խոպոպացմանս	Case
վճարող	վճարեցին	lemma
ապրուստներս	յոգաներումդ	Number
մատներ	մատնեն	lemma
ճամփեին	սառեցին	Person
էնցեֆալիտներդ	մորուքիցդ	Possession
չվեց	հայթայթ	Tense
ազնավորներիդ	վինիս	Case
մկրատներիցդ	սոուսիցս	Case
աչերիցս	ինքնահավանս	Possession
ջեբիդ	սոուսներիս	Case
նախուտեստներին	առիթի	Case
համաձայն	համաձայնեք	lemma
չտարակուսես	կհամարեինք	Tense
ժողովածու	մզկիթներ	Case
գրախոսությամբդ	կարիքներումդ	Possession
պատկանեի	կկռկռաք	Tense
կծնեն	չկշռես	Tense
կծնգցնեք	մեղանչեի	Tense
մորաքրոջիցս	ապարանքներից	Case
զխկտեցինք	սերմնաբուշտներին	Number
փութաջաններ	օթերին	Number
խոխոջեցի	գոգ	Tense
հապավմանը	սպերմաներիդ	Case
լաչառներովդ	մեներենիդ	Possession
չհոգաս	կաճեցնենք	Tense
անապեստիցս	ջանավարներս	Possession
զոդին	ինդիումներիս	Case
կթվարկեմ	չշարունակեցի	Person
թլփատեցիր	չերթայիր	Person
տաղտուկում	սաղարթներում	Case
ըղձացող	ըղձա	lemma
մալայերենիս	թիթեղներիդ	Case
աշուններիս	ջրեղենիցս	Possession
մեծանա	մեծացնել	lemma
մրուրը	չարաշահեց	Number
սիկտիրվե՛ք	խտիղների	Number
կճոռոմախոսենք	չօղողեր	Tense
ձաղե՛ք	տպեիք	Person
չերկբայանայի	սարքավորմանդ	Number
իշխանափոխությունիցս	հայրատներիցդ	Case
սուտասաններովս	օսմանիս	Possession
չգոհացար	կգոհանաս	lemma
երամակների	հերվան	Case
կայուններովս	ճիրանումս	Possession
չհերքեցիր	ընդարմանայիր	Person
ժանտափշերումս	կոմբայնումդ	Case
տնօրեններովդ	հացահատիկիդ	Possession
կարիք	կհալածես	Number
շափյուղաներ	մսան	Case
նստարաններովս	բիզոնս	Possession
շարժումներումդ	ամորձում	Case
չկանչեցիր	սպրդեիր	Person
չըմպենք	կմրմնջայիր	Tense
սրճեփներիդ	չթլփատեին	Number
յուղալավաշ	բորշչերդ	Case
չհորդորի	նախաճաշեց	Person
կենտումդ	գրողներդ	Possession
հիր	չքերծեցիք	Tense
ծխերի	առիթի	Case
գանգրածածկների	պատյանիս	Case
լաչառներովդ	խորթդ	Possession
հարթերով	հարթերում	lemma
տես	գլդորեցին	Tense
քաքող	քաքեցին	lemma
թոռոմեց	մրցեր	Person
հեղեցին	չորոճեին	Person
կփլվեն	չծաղրեմ	Tense
չլուտան	լուտացիք	lemma
պահպանեց	պահպանի	lemma
բուժումներից	չարաչարիցս	Case
կվրդովեին	կոչումներովս	Number
թանացի	չամորձատեի	Person
ջրաղացներիդ	հանդիսավորումդ	Possession
բարբարոսովդ	գերքաղաքներումդ	Possession
տիեզերագնացների	թաքցնեն	Number
մասնագիտություններս	տասերորդդ	Case
հիմարիս	հիմարովդ	lemma
վրացերենս	հուռթիները	Case
լաոսերենիդ	պիստակներին	Case
մերկապարուհուցդ	ստադիոններիցս	Case
չվանկեցիր	հյուրասրահի	Number
ուժեղանա	պոռոտախոսեց	Person
կատակագուսաններ	լիտվերենը	Case
կմատուցեինք	պետերը	Number
չհեծնենք	կբաղխեիր	Tense
շարունակ	կախարդեցիք	Tense
կտենչար	չսրտառենք	Tense
չաղացի	բեւեռացույցից	Number
սխտորին	աներկյուղովդ	Number
շաքարներդ	ձունս	Case
տաղտուկում	դրույլներումս	Case
զվարճանաս	չճկեցիր	Person
ազդվեցի	աճապարեմ	Person
կրակեցիր	կրակեին	lemma
չըմպենք	կտշես	Tense
աղայիցս	ձկնաբանականներովս	Possession
պահապանից	չափածոն	Number
կաշկանդիդ	ձառերի	Case
անձեռոցիկները	կհղեք	Number
նիստիդ	երկաթգծում	Number
նորույթումս	անհույսներս	Possession
կայուններովս	տաջիկերենումս	Possession
նախուտեստներին	նիդեռլանդերենիս	Case
կհղենանք	հեռացնես	Tense
քվարցներս	ուռենովս	Possession
մահացաք	կհորանջեք	Person
բանավեճիցդ	օղակներից	Case
զարթնեիք	տաղտկացե՛ք	Person
չեխերենը	մարկիզի	Number
պայտովս	պարմեզաններովս	Possession
տեսակները	հովազ	Case
պատմվածքդ	վարչապետներովդ	Possession
կհալածեք	չառկայծեի	Tense
չխթես	կմտմտան	Tense
պոռոչի՛ր	պոռոչում	lemma
ղայիշիս	մարդելույզների	Case
գբերս	շառաչ	Case
կվհատեցներ	ապահովեցրեց	Person
չմատնեինք	մատնե՛ք	lemma
ցանկացանք	եպերներով	Number
սպասարկե՛ք	չծառայեիք	Person
ալերգիայումդ	կատալաներեններիդ	Possession
կհուզես	չագռավանանք	Tense
լորտուս	գլխատառերիցս	Possession
քաջիցդ	մարկիզի	Number
կտանջեիր	բանեցրիր	Person
չլուծեցինք	փոխհատուցենք	Person
կփռշտան	ուսումնասիրեցին	Person
կծնգցնեք	չսգար	Tense
հումերդ	կոլխոզումդ	Possession
կենսալիրների	սեւականի	Case
ֆերմիոնիդ	տունդրաներդ	Possession
կեչուցդ	ահաբեկիչներս	Case
ամբարտավաններիցս	ավազակիս	Possession
ցինկս	վերջնախաղերը	Case
թերասնում	վերջնախաղերը	Case
կխօսամ	խածնեին	Tense
գանգուրիդ	որձաքարերիցդ	Possession
զորեղներդ	ընկճախտ	Case
ոսկեղենդ	պատառները	Case
ավտոբուսս	պորտվեյններդ	Case
ուլունքի	հորաներիս	Case
սումոյիցս	հասարակներիս	Possession
ամորձուցս	ամբարտակներումս	Possession
սարավանդակներին	տոռնիս	Case
դարսի՛ր	կկենդանանաս	Person
մեգերումդ	այրուքում	Case
մարսողությունը	փաստեր	Case
չկիսի	կիսեիր	lemma
առույգներով	առույգներում	lemma
սիկղերովդ	ոլործունիցդ	Possession
օրհնյալներս	պնակ	Case
ամորձատեցինք	նիդեռլանդացիներին	Number
ժողովածու	ծովափղերը	Case
մահմեդականներ	խորդս	Case
տրամաբան	քածիցդ	Number
երթեւեկումներիդ	ցարականումդ	Possession
գանգրածածկների	քաբաբիս	Case
դեղատներից	նիլսբորիումից	Case
պահապանից	հսկայականով	Number
նվարտաններիս	ճնշումս	Possession
ցացիկիումդ	վիթերիցդ	Possession
ստրուկիդ	նժույգների	Case
քաջալերություններիցդ	եպերներով	Number
լոգացի՛ր	ածանցեիր	Person
որորներից	շվեդից	Case
չուռեցինք	կգոհանայինք	Person
չհայտարարեք	գանգրացե՛ք	Person
միացնեին	միացրինք	lemma
ղեկավարությունների	թարխանությանս	Case
մաքսերը	չաղերսեցին	Number
կոստղավորներիցդ	բաստուրմայիցս	Case
մոդայումս	փարթամագեղներում	Case
տեսակները	պնակ	Case
մարսողությունը	բորշչերդ	Case
բուժումներից	նիլսբորիումից	Case
ծխերի	ներկայացուցչության	Case
արձակուրդ	սուզանավերդ	Case
մահացավ	կկանգնի	Person
չերկբայանայի	խորովածում	Number
կխօսամ	չապահովացնեիք	Tense
լոգարաններիս	ակրոպոլիսումս	Possession
լերկեր	սղոցս	Case
կխիթայի	երկմտեք	Tense
սրտառեիր	ջղայնացրիր	Person
պատրաստող	պատրաստի	lemma
չներկայացրիր	պարապես	Person
զուգահեռագծիցս	փախստյաներովս	Possession
զովերին	հռովմայեցուդ	Case
չարորեցինք	կկշռենք	Person
հանգես	լկստի՛ր	Person
կծաղրեինք	չխրախուսեցինք	Person
կխրախուսի	գնչեց	Person
խաշ	ստորակետերը	Case
պարավանդդ	սաղավարտներովդ	Possession
դիեին	դիեցինք	lemma
գնոստիցիզմ	ալաբաստրներս	Case
կբարբառի	կայացավ	Person
վերազգայինումդ	սլավոնականներումս	Case
լոուրենսիումներին	տոհմիս	Case
կնախընտրեիր	փսխենք	Tense
սազայիք	կամբարտավանի	Tense
բլբլար	չմեկնեց	Person
պատվանդաններդ	ենիչարին	Case
տեռորիզմին	խաչակիրներիդ	Case
գրգռ	չքչքչացին	Tense
հյուսներովդ	միապետությանդ	Possession
քվարկներիս	ճիրանումս	Possession
ծածանեիք	հոտե՛ք	Person
հառաչալիներից	հղությունից	Case
տաղտուկում	ահազանգումներումս	Case
նստարաններովս	ճագարովս	Possession
կհոսի	գնչեց	Person
չմղձկի	գնչեց	Person
մրցավարով	չարաշահեց	Number
անմիաբանություններդ	թեորեմիցդ	Possession
բլոգերումս	չորոճայիք	Number
գեղջուկիդ	լավերի	Case
գոչերումս	հոլանդերենիս	Possession
շառաչեինք	չցուցանեցինք	Person
ավելացնեինք	չդարբնեցինք	Person
ազդուները	թաթուլներովս	Number
Թութունճեանին	հատուկներիդ	Case
ինքնահավանումս	ձեւույթներս	Possession
պատվանդաններդ	կարտոֆիլս	Case
կոլգոտկայիս	կաղճիններին	Case
շողացող	շողա	lemma
հղացանք	չփախնենք	Person
չսանրվող	չսանրվեիք	lemma
մեղկանայիք	չկատաղեցիք	Person
գեյզերս	ջհուդներդ	Case
կտենչար	չագռավանանք	Tense
աքսորումներումս	սիեստայովս	Possession
ճանապարհորդիցդ	հսկայականով	Number
առածներումս	թեզնիքների	Number
չսահմանեք	կհեգեր	Tense
կծնվեիք	գերծեմ	Tense
սավառնե՛ք	կհողդողդեիք	Person
հիր	զեղծ	Tense
խօսեցիր	նեղաց	Tense
ապահովեցնեիր	կբարբառենք	Tense
գայթակղեք	ավանդե՛ք	Person
տեգրականանցիցդ	կոնքիցս	Case
կհեծնեմ	հատակեիք	Tense
անգիրներովդ	անալիիդ	Possession
չգլես	շիջեցիր	Person
լաոսերենիդ	վրդովներիս	Case
առաջադրանքներիս	լիտվաներենին	Case
աղավաղեն	կթոթովեիր	Tense
ալյումինումում	նավթադոլարներումդ	Case
վրացերենս	օգոստոսները	Case
կլողանաս	լողացի՛ր	lemma
մեծահանդեսներովդ	վերադարձդ	Possession
կենցաղումս	ահաբեկչություններովս	Possession
ծիծիկիցդ	հեշտոցներումդ	Possession
անհավատին	նժդեհներիս	Case
ստեիր	թոռոմի՛ր	Person
նիստուկացերիս	մրջյունին	Case
ենթակայականից	կանաչապատներիցդ	Case
գազաններովդ	թեորեմիցդ	Possession
կմաքառենք	գովեցինք	Person
չձուլեմ	ձուլեր	lemma
մերկապարուհուցդ	հերոսություններից	Case
չբորբոքի	կկռկռաք	Tense
առաջադրանքներիս	ծուծին	Case
չկռնչացած	չկռնչացի	lemma
տեղյակներդ	խուճուճումդ	Possession
հոլմիումներս	լիտվերենը	Case
համենաք	փողոտե՛ք	Person
չերերանք	կզոդի	Tense
օգոստոսյաններիցդ	սուտասանից	Case
տեղիներ	ձունս	Case
վճիռներովս	տաջիկերենումս	Possession
թեշիկս	չարաշահեց	Number
սրճենիներ	ագահներովս	Number
խոշորացույցիցս	թավաներս	Possession
ճանապարհից	չվերթներից	Case
մանվածքայինումս	ծիլերս	Possession
ջազվաներդ	ձորիդ	Possession
կքերծեի	պաղատեցի	Person
ջրհորովս	գաղափարին	Number
կծվերումս	փոքրիկովս	Possession
գոմաղբից	շագանակագեղձերից	Case
ադամանդներից	թավայիցս	Case
գաղտնիքիցդ	հռոմեականներից	Case
չփոխանակեին	կաղարտեմ	Tense
ահաբեկվենք	կկատարեր	Tense
թուլիումս	գեղարդովդ	Number
չկալես	կկալեիք	lemma
ընդոստնեիք	չընդոստնեցիք	lemma
սկուտեղումդ	չբդկես	Number
մալայերենիս	արտագաղթերի	Case
թրջելիք	թրջեց	lemma
աթեիզմիս	հոբելյարներին	Case
տիբեթերենումս	անձեռոցիկներում	Case
ջազվաներդ	խոպոպավորիդ	Possession
կոմսը	ազգանուններ	Case
կծնեն	չբարեւեիր	Tense
առաջադիմականներդ	թաթուլներովս	Number
չտրամադրեինք	կկազմակերպի	Tense
չգերծի	գերծեիր	lemma
աքսորումում	բակտերիաներումդ	Case
հերոսականներդ	վարկածս	Case
ձետ	հեռվով	Number
կհուսալքեն	երգիծեցին	Person
ինքնահավանեք	չմեղկացաք	Person
կագուցանենք	չկշռես	Tense
սրճենիներ	մեթոդներից	Number
բացականերովդ	ջրածիններին	Number
չերկնչի	կլրթանանք	Tense
ջերմություն	հատկանշիցդ	Number
ծնեցի	չհոլանեի	Person
կալեր	կալեն	lemma
կզեռաս	զեռա՛	lemma
մեծահանդեսներովդ	լեհականումդ	Possession
մակաշերտիցս	հայրատներիցդ	Case
գլխագրիդ	անագանով	Number
տատիկ	փաստեր	Case
սիկտիրվե՛ք	ուտելիքները	Number
արաղով	կապուտս	Number
հետազոտեցի	օգտագործեի	Person
արդյունքը	գրավիտոնում	Number
կհպարտանաք	հաճախե՛ք	Person
կխնկես	չսրտառեն	Tense
չգոգեն	կլողանայի	Tense
օդանավակայաններդ	հացահատիկովդ	Possession
բտող	բտի	lemma
կարտոֆիլը	ջհուդներդ	Case
հովիտս	ստորիններիս	Possession
թալմուդները	պատառներումդ	Number
չհագնես	կհագնեիք	lemma
ճանճերդ	պարսկականիդ	Possession
չծպտվեցիք	առողջացր	Tense
կեչուտիդ	հալվայից	Number
նվաղես	կցտեինք	Tense
կեղեցի	քաղցեի	Person
մեծացե՛ք	ծփեիք	Person
կառավարեն	սկզբնագրերում	Number
հավելվածներիցս	սիեստայովս	Possession
հեղեղեն	կլողանայի	Tense
վերուվարի	կշատանայիք	Tense
կապտավունից	որմնախորշերիցս	Case
անդրկովկասցունս	չորոճայիք	Number
կայսրությանդ	պատրաստություններումդ	Possession
չխոխոջաց	ահաբեկվեր	Person
սիգաներիս	բանակցությամբս	Possession
նորվեգերենի	բամբասանքներիս	Case
ունկնդրելիք	չունկնդրեցիր	lemma
արդյունքը	կջղայնանայիր	Number
հոլդ	խնամքներիցդ	Possession
գորովեինք	չփութացինք	Person
խորդուբորդիդ	եռանդունովս	Number
նախապայմաններովդ	չափածոներումս	Number
շրջահայացիս	շեֆխոհարարներս	Possession
աբսոլյուտներիցդ	կնյունումդ	Possession
աճապարես	ռուսաստանցուդ	Number
մագնիսականությունների	մեխակիդ	Case
կիբեռնետիկան	ջհուդներդ	Case
վաշտիցս	մահմեդական	Number
կէթամ	չնախանձեին	Tense
գաղափարագրերում	կաղնումդ	Case
էրեկվանից	չբդկես	Number
հեստապարերիս	ղեկավարություններդ	Number
կէթամ	չտրոհեիք	Tense
ջիներից	կաղկանձիցդ	Case
չզղջայինք	զղջացե՛ք	lemma
սնուցմամբ	պաճուճաբանին	Number
փիլիսոփոսիս	պիստակներին	Case
պարավանդդ	շիզոֆրենիկներովդ	Possession
ինդիումներիցս	էներգիայիցդ	Case
ձախլիկ	ազգանուններ	Case
շարունակ	կանչեց	Tense
լյոքշերումս	շիվումդ	Case
մրցավարով	ամլիկը	Number
հղիովս	վհատականներիս	Possession
հղացանք	բաջաղենք	Person
ցերեկույթներս	բրետոներենումս	Possession
հաստիչդ	մետաղագործություններիդ	Possession
կհպարտանաք	հենեցիք	Person
կոլգոտկայիս	գուսաններիդ	Case
ծնծղայիցդ	թեներից	Case
սուտասաններովս	ինքնուրույնիս	Possession
կաշուբերեններումդ	կաշուբերեններումս	lemma
կցտի	գանգրացվեիք	Tense
կալավ	կալնի	lemma
կհոշոտեն	չտրամադրես	Tense
նորույթումս	ստորիններիս	Possession
մրմնջացիր	կտռեիր	Person
կոնյակ	փաստեր	Case
մահմեդականներով	շնորհենք	Number
ծիծաղալիք	չծիծաղացիր	lemma
համենաք	կարեկցե՛ք	Person
աժդահայիցդ	որմնախորշերիցս	Case
հապաղ	չհորանջեցի	Number
օդապարիկդ	հեթանոսներիցդ	Possession
ծնեիր	ընտրվեցիր	Person
կօժանդակեմ	չուզենան	Tense
ավտովարորդս	լավաներիս	Possession
չկոչեիք	գովե՛ք	Person
չփախցնի	փախցնեիր	lemma
թրեր	զվարճացավ	Person
հղացանք	կգոհանայինք	Person
կարտոֆիլը	պաճիճներդ	Case
գնահատող	գնահատեցին	lemma
խայրիումդ	սաղավարտներովդ	Possession
անդրկովկասցիներիցդ	այրուձիովդ	Possession
հարգանքներիցս	ըղձականովս	Possession
աշտարակումդ	երիտասարդներդ	Possession
գնեն	կխոյանայի	Tense
քննություններովս	ժամադրությանս	Possession
մտոցումդ	գնաճերդ	Possession
միմոսովս	պանդոկներիս	Possession
բարելավեցիր	համակարգ	Tense
ռեակցիաներիցս	չպառկեք	Number
կեղեցի	չծլարձակեմ	Person
լաոսերեններիս	չորոճայիք	Number
կգեղգեղեիք	մարթեմ	Tense
ծծիցդ	ապարանքներից	Case
հղիովս	չաթլախներս	Possession
պղինձներ	կշիջուցանեիք	Number
հորովելովդ	խալիս	Number
կարմրավունդ	լուսամուտներումդ	Possession
կախարդվածությամբդ	պատուհասներդ	Possession
չհագեցիք	հոտե՛ք	Person
նվագես	բոսորումդ	Number
կրկեսիդ	դանդաղկոտներիցդ	Possession
զուլուումս	տափակներում	Case
արեգակնային	գնդակահարություններ	Case
քրթմնջա	չածեց	Person
կանտոններս	գառնարածիցս	Possession
ասուպից	ատակիս	Number
բնորոշե՛ք	մատյաններիցդ	Number
կախարդվածությամբդ	հնարամիտներիդ	Possession
ասուպից	կսարսափեի	Number
մահմեդականներով	դուզնաքյաներով	Number
ճավայերենումս	ձկնաբանականներովս	Possession
ապահովեցիք	կնվագեք	Person
ժամկետս	վհատականներիս	Possession
աշխարհահռչակդ	աղբերակովս	Number
չվերագրեցիք	բարիքներից	Number
անուրջներիցս	մաճիցդ	Case
ղսմաթդ	օդերեւութաբանականներս	Case
շպարանյութերիդ	թեորեմիցդ	Possession
ցեծերիցդ	հացահատիկովդ	Possession
կվիճաբանես	գիտակցվենք	Tense
չխեղդեցիր	խեղդող	lemma
նոճերումդ	պարսկականիդ	Possession
չկլանեցի	հայթայթ	Tense
սիբիրախտովս	մարտահրավեր	Number
չդրդի	կլրթանանք	Tense
նվազներովդ	բռնությունումդ	Possession
թորշոմի՛ր	թորշոմում	lemma
չոռնա	կախտորոշենք	Tense
նախապայմաններդ	անվտանգություններիս	Number
չկառավարեի	բարձրաձայնեցի	Person
արարիչներովս	վագրիցս	Possession
մրսեիք	զրուցե՛ք	Person
հերքե՛ք	օսլաներումս	Number
արածի՛ր	կծնեիր	Person
թերասնում	շեքերս	Case
դանդաղկոտներին	մեխակիդ	Case
բրդյայովդ	թարգմաններիցդ	Possession
փռշտոց	հայկականները	Case
թոռոմեց	տառադարձեր	Person
աֆարերենը	փաստեր	Case
խթանեցինք	առողջացր	Tense
չքելեցին	կկոճկեն	Person
հերոսությանը	քեռակիններիս	Case
կբրթես	բրթի՛ր	lemma
պյուռոսյաններիդ	կլեպները	Number
ավելացնեինք	չըմպեցինք	Person
մահացաք	կհայտարարեք	Person
կգրադարձեմ	փլեիք	Tense
պոռոչեմ	կսրտառեիք	Tense
ֆիլիպիներեններում	գերմանիումներիցս	Number
աննկուններով	աննկունի	lemma
լոուրենսիումներին	օղակիս	Case
ասքերովս	բանակցությամբս	Possession
մորաքրոջիցս	չվերթներից	Case
շնորհներս	վագրիցս	Possession
չփրփրեն	կկախեի	Tense
հորանջների	ծիծառնուկին	Case
արդարեւից	արդարեւներդ	lemma
լկստեին	կտշես	Tense
հյուս	առողջացր	Tense
խալ	սարքավորմանդ	Number
ճմլեմ	կշարունակեիք	Tense
վերուվարներից	կայծքարերում	Number
պարավանդին	նոյեմբերյաններիս	Case
մարտակառքերիս	անթիդ	Case
խեղդեմ	արմացա	Person
չփչեիր	ցավի՛ր	Person
կրիպտոնները	կրիպտոնս	lemma
ուղեբեռը	պոռոտախոսություններ	Case
չհայցի	կթոռոմեինք	Tense
հեռուստատեսություններին	պոկերներից	Number
սպրիչներիդ	վերակացուովդ	Possession
ռացիոնալներում	խնկեք	Number
քվեարկողիդ	ձառերի	Case
չվհատեցիր	վհատող	lemma
կհարկադրեիր	կլանեցիր	Person
պլագիատորներիցդ	պլագիատորներիդ	lemma
չպառկեր	կախտորոշենք	Tense
շինականներովս	ղսմաթովս	Possession
կգեղգեղեիք	չգիտակցեմ	Tense
քչիցդ	սպիտակավուններդ	Possession
սուջուխներդ	գինարբուքս	Case
կանաչավուններս	անկվածդ	Case
քննություններովս	վհատիցս	Possession
կդարբնեք	չառկայծեի	Tense
բաստուրմայից	թոթովներիցս	Case
վերիններս	էլեկտրոն	Case
սպրիչներիդ	միլիոնատերիցդ	Possession
ապահովեցիք	կողբայիք	Person
ակոսիս	պատկերասրահներին	Case
սնդիկներովս	մամբոյիս	Possession
ապերախտություններդ	նախադասությունս	Case
ճմռե՛ք	կհուսահատվեք	Person
դիսպաշերով	բլոգերդ	Number
աբսոլյուտներիցդ	ցանկապատովդ	Possession
կքաքեի	բարձրաձայնեցի	Person
հեստապարերիս	խոպոպաձեւներ	Number
լափեին	լափեցինք	lemma
հրաշքներիդ	բռնությունումդ	Possession
ցունամիների	աբսոլյուտի	Case
աքսորակցովս	ցցունքներիս	Possession
ջեբիդ	տափաստանայիններին	Case
նախարարին	խաչակիրներիդ	Case
կկասկածեն	չխուզեիր	Tense
չբանային	բանալիս	lemma
կոմսը	ղայիշներդ	Case
աղորիքներովդ	չթլփատեին	Number
բեկտեք	չհափափեցիք	Person
ձերբակալիցս	բլոջներից	Case
հեծանոցիցդ	կախով	Number
օրհնյալներին	օրհնյալովդ	lemma
կշարունակի	չսառչեինք	Tense
կխրախուսեն	խածեցին	Person
կհոշոտեն	չէտես	Tense
պատվանդաններդ	վանկարկումս	Case
մեղմերիս	թանս	Possession
հունքուբունքերիդ	խավարասերովդ	Possession
փռթկացնեմ	չփութացի	Person
հոկտեմբերյաններումս	ոտիցս	Possession
հմայի	կարկեինք	Tense
կհուսահատեցնեն	չփութացնես	Tense
համովներից	կցորդներիս	Number
թավուտդ	պատառները	Case
ծուռմուռներ	կուլերովս	Number
աքսորումում	տակառներումդ	Case
այտուցս	սիեստաներումս	Possession
չզառամանա	գնչեց	Person
իրիդիումներդ	հովազ	Case
հուլունքների	փորձերից	Number
զայրուցների	օֆիսներդ	Number
մրմնջացիր	գիշատես	Person
ուզենալիք	ուզեցավ	lemma
ամբարիշտներիդ	սպասյակիցդ	Possession
փսխեց	գոգ	Tense
ցերիումը	ղայիշներդ	Case
անձնավորներիցդ	կցորդներիս	Number
կկշռադատես	թանաքս	Number
կխնկես	խածնեին	Tense
գուլպաներիցս	կոսմոպոլիտականումս	Possession
հայրենյացներում	ջրկոտեմում	Case
միապետություններիցդ	ներողությանդ	Possession
թուլանայի	չհափափեցի	Person
չցավեն	քցեցին	Person
կիվին	շեքերս	Case
պայթեց	պայթի	lemma
վրդովեմ	չշարունակեցի	Person
ազդեիր	կաճեցնենք	Tense
կգրադարձի	ամուսնացնեք	Tense
դեղատներից	անկածիցդ	Case
մղմուղիցդ	ապարանքներից	Case
կազմերիս	մարկիզիդ	Case
կօժանդակեմ	չփայլունանայիք	Tense
չզվարճանայինք	կփքվես	Tense
ձախլիկ	սուզանավերդ	Case
ուղեկցեիր	բանեցրիր	Person
ձախերիս	ռուբիդիումումս	Possession
սխտորին	հողեղենովս	Number
կշարունակի	փսխենք	Tense
հնդկականներիցդ	վերակացուովդ	Possession
լիանան	կսաղանայի	Tense
լողավազաններ	բուսակերների	Number
ամպար	ազգանուններ	Case
սալորենիներդ	հարկահավաքովդ	Possession
ռուբիդիումներում	երախայրում	Case
գահավանդովդ	ճաճանչը	Number
կհղենանք	չգոգես	Tense
սանտիմետրիցս	խորհերումս	Possession
զվարճանաս	չսորացիր	Person
քենակալները	նոճերիցս	Number
արքայություններին	նանաներովդ	Number
վաշտիցս	թերահավատով	Number
չհարեիք	կզգածվի	Tense
անկումներովդ	թմրամիջոցիդ	Possession
այցելությամբս	զանգակածաղիկներովս	Possession
չգործարկի	կարօտեց	Person
կհղենանք	չէտես	Tense
անգիրներովդ	բռնությունումդ	Possession
արամերենիցդ	ապարանքներից	Case
հիասթափություններովդ	երկայնաբանություններով	Number
ազգայնացումներովս	ազգայնացումներիցս	lemma
գինարբուներիս	բազազովս	Possession
սվին	կալեր	Number
կքննարկենք	համակարգեր	Tense
նեխեց	չբդկեր	Person
կպղծես	պղծի՛ր	lemma
հերքե՛ք	թեզնիքների	Number
դանդաղկոտներին	նիդեռլանդերենիս	Case
ժողովածու	խրծիկներս	Case
մագնիսականությունների	կռնակի	Case
կհուզես	սովորեինք	Tense
ուլունքի	նժդեհներիս	Case
մտցնեին	կխանդես	Tense
չքայլած	չքայլեմ	lemma
ժանգոտ	առաջավորում	Number
ընթրիքով	արքայախնձոր	Number
լիզեցիր	կահագնանաս	Person
լանջապանակիցս	բացառականներից	Case
կոսմոսներովս	բազազովս	Possession
չերկնչի	կճախրեիք	Tense
կհալածեք	չարաշահի	Tense
հասարակներիցդ	խուճուճումդ	Possession
կանկանս	ծովափղերը	Case
ջազվեներիս	կապարումս	Possession
հոնքերս	գառնարածիցս	Possession
փտած	սպունգներդ	Case
կկասկածեն	ունկնդրեմ	Tense
զուգահեռագծիցս	կնյուններիս	Possession
կէթամ	չպաղատեիք	Tense
չըղձա	թաքթաքուրումս	Number
կբողոքարկեին	ներբեռնես	Tense
կգլդորեմ	չզրուցեն	Tense
չհորդորեցիր	հորդորող	lemma
վայրդ	հանդերս	Case
կգլդորեմ	չզգենաք	Tense
խճուղիների	օսեթերենիս	Case
կխնկես	չպատկանեին	Tense
կմատուցեինք	մեթոդներից	Number
թավուտդ	տղամարդիկս	Case
փութացե՛ք	կվիճաբանեիք	Person
չլուծեցինք	կողբանք	Person
հորջորջներիս	տաջիկերենումս	Possession
հրվանդանի	փիլաքյաններիդ	Case
ապահովեցնեիր	կլանեցիր	Person
զովս	զովերովս	lemma
յանիչարից	ժպիտներիցս	Case
ֆերմիոնում	կոստներ	Number
կկաշկանդենք	չարդարացնի	Tense
չծփեիք	կզգածվի	Tense
ճմռե՛ք	խօսէիք	Person
կծնեն	չգիտակցեմ	Tense
ոնորոշացավ	կտրոհեր	Person
տատիկ	ծովափղերը	Case
արտագաղթեց	արտագաղթի	lemma
թիռումդ	ձաղանքներիդ	Possession
հրաշակերտներովդ	բացահայտներ	Number
հրաշակերտներովդ	փաշաներով	Number
կոլաժներս	հումուսումս	Possession
ճմլող	ճմլեցին	lemma
կտարվեին	տգետները	Number
գլուխներդ	ձառերում	Number
քչիցդ	տերտերներովդ	Possession
պատշաճներումդ	լուսանկարչությունդ	Possession
գրգռ	չուժեղացաք	Tense
հնոտիներ	հնոտովդ	lemma
պատրաստեր	պատրաստեն	lemma
առերեսեցիր	առերեսեին	lemma
աշակերտուհիներովդ	ելույթդ	Possession
հեռեն	երգիծեցին	Person
կրաքարի	խաչակիրներիդ	Case
սխտորի	ավազաքարերիդ	Case
վերմուտից	ունակներից	Case
հոտոտեի	ալեկոծիս	Number
կռվեցին	հեգեն	Person
նախուտեստներին	տոռնիս	Case
հոնքս	խորհերումս	Possession
զարմացնես	չպարապեցիր	Person
փոսուռայից	պաճուճաբանին	Number
կպայմանավորվեն	չխուզեիր	Tense
ինքնյակը	ահաբեկիչներս	Case
պարանիս	նունուֆարներիդ	Case
չեխերենը	ինքնավարումս	Number
չկայանամ	կայանար	lemma
քրիստոնյայից	ունակներից	Case
տխմարները	նախադասությունս	Case
կհալածեք	ապահովեի	Tense
հեծեծեց	զեղծ	Tense
կասկածներում	տասնամյակում	Case
հավելես	ցավի՛ր	Person
կկաշկանդենք	հաստատեր	Tense
հատուցող	հատուցի	lemma
հավետներով	հավետովդ	lemma
հայրենյացներում	պարասրահում	Case
աղեբեկներովդ	սպասյակիցդ	Possession
ռազմիկների	վարպետին	Case
շնորհեց	շնորհի	lemma
հեղեցին	չհագնվեն	Person
ջիներից	պատառաքաղիցդ	Case
կխօսամ	չպատրաստեն	Tense
կիբեռնետիկան	գիսակներս	Case
ալբոմումդ	հնդկընկույզներովդ	Possession
իռլանդերեն	զուգահեռագծեր	Case
չթոթովեք	կթոթովի	lemma
նորվեգերենի	ներարկիչների	Case
բաղարջումս	հյուրասրահի	Number
չխթանես	բեկտի՛ր	Person
չհեծնենք	կհիասթափեցներ	Tense
տառապի	կցավեինք	Tense
հունքուբունքերիդ	բուժքույրդ	Possession
կծնգցնեք	չգարշեի	Tense
կծնեն	չառերեսվես	Tense
տեղյակիցս	լվերովս	Possession
չծածկեիր	մաքրեցիր	Person
կհոխորտայի	արթնանան	Tense
խելոքներովդ	գրչատուփիցդ	Possession
արձակուրդ	նիզակներս	Case
չծաղրեցիր	ծաղրող	lemma
պապանձվեի	կքելեք	Tense
կբացականչեինք	չփութացնես	Tense
գեղեցկությունիցդ	պրոլետարներիցս	Case
հրեղենիս	ուռենիներիցս	Possession
ծնկոսկրիս	թույլերս	Possession
կլիզես	չտպեցիր	Person
կհակազդես	փսխենք	Tense
չտպեցինք	առողջացր	Tense
հապաղիցս	սրերովս	Possession
մզկիթներիդ	ոլործունիցդ	Possession
չըմպենք	կկազմակերպի	Tense
չապահովվեցիր	կապահովվես	lemma
ծծեցիր	համակարգ	Tense
տխմարները	թլփատություն	Case
խաշ	ազգանուններ	Case
չարկանեցիր	գրավիտոնում	Number
կապտավունից	ճառագայթներիցդ	Case
քվեարկողիդ	սոուսներիս	Case
մարտակառքերիս	հակասեմիտականությանդ	Case
չեփեցիք	գլտոր	Tense
բանավեճիցդ	որմնախորշերիցս	Case
շափյուղաներ	ծայրս	Case
կոթողիս	վարտիքներումս	Possession
անձնանունների	ամեհիիս	Case
ամպարներումդ	ստորագրությունում	Case
գնոստիցիզմ	մալթայերենները	Case
մեյդաններդ	ոլործունիցդ	Possession
փախցնես	ընտրվեցիր	Person
մահմեդականներ	փականը	Case
չափահասները	չմատնեք	Number
օգոստոսյաններիցդ	այտիցս	Case
չսաղացանք	շիկնենք	Person
կզառամենք	կզառամես	lemma
ուսումնասիրեցիք	կապահովենք	Number
տասերորդից	պայմանավորվածությունին	Number
կհարնչենք	չպատկերեիր	Tense
կաջակցես	աջակցի՛ր	lemma
ճողոպրեր	ճողոպրեն	lemma
չըմպենք	կհղփանայիր	Tense
թղթադրամ	դալարուտիցս	Number
քրիստոնյայից	խեչակներիցս	Case
կբողոքարկեին	չկշռես	Tense
օսեթականներդ	հովազ	Case
կճոռոմախոսենք	խոխոջեիր	Tense
իշխանափոխությունիցս	դելֆիններիցդ	Case
արածի՛ր	սպրդեիր	Person
շաքարներդ	անդեորդս	Case
չխթես	կողորմեին	Tense
լումաներս	գրասեղաններին	Number
կիվին	ազգանուններ	Case
կազազեիք	գանգրացե՛ք	Person
կբաջաղեինք	չաբսորբի	Tense
շփոթվածություններիցս	հղությունից	Case
երկնչոտով	ոսկրաբանիցս	Number
ամհարերեններումս	ըմբիշներդ	Number
քյոխվաս	հասարակներիս	Possession
փուտերովս	փուտերիցս	lemma
կվրդովեին	կայծքարերում	Number
կատակագուսաններ	ուշունցս	Case
չհեգնեց	գոգ	Tense
շենք	հողմերս	Case
նանիցդ	ջերմերովդ	Possession
ըլնելիք	էղավ	lemma
կորոճաք	չգիտակցեմ	Tense
մոռացոնքներին	թաղերդ	Number
զարթնեիք	չզարթնեցիք	lemma
մեռելոտի	մեծավորով	Number
գործառնականս	ճամփորդներ	Case
հաղթի	յոգուրտներին	Case
չխմեիք	կզոդի	Tense
կպայմանավորվեն	չբուսնեիր	Tense
աբսորբենք	կկազմակերպի	Tense
ֆալիսկերենի	պլատինդ	Number
մոխրագույնիս	գուղձերի	Case
պարմեզանդ	պատառները	Case
կխնկես	չհեղենք	Tense
փորի	մօտեցաւ	Person
ահաբեկվենք	կսպասարկեիր	Tense
նավահոս	ալմասներ	Case
ամպար	ճոռոմախոսներդ	Case
չահագնացար	կուսուցանես	Person
զգուշաց	հայթայթ	Tense
սրճենիներ	այլեւայլություններովդ	Number
կշեշտեք	չփքեի	Tense
արմավենիներովդ	ոլործունիցդ	Possession
մասնագիտություններս	գրենա	Case
չքաղեիք	հոտե՛ք	Person
հայրերիդ	ներկայացուցչության	Case
չըղձա	մյուոնում	Number
հատապտղում	ատակիս	Number
հրվանդանի	առէջներին	Case
սխալվեինք	կտշես	Tense
փրփր	փրփրեք	lemma
մեծացե՛ք	կերկնչեիք	Person
լողավազաններ	բարիքներից	Number
կենտումդ	երիտասարդներդ	Possession
մզկիթներիդ	պոռոտդ	Possession
կիմրերենից	կիմրերեններդ	lemma
ակնածալիցներին	օղակիս	Case
շռեց	թարգմաներ	Person
պանդոկներիդ	ռուբլուցդ	Possession
կհուսալքես	չունկնդրեցիր	Person
ընկճելիք	չընկճեցիր	lemma
կազմակերպող	կազմակերպի	lemma
աբեղայականներումդ	գեյզերներից	Number
փոխարինումներովդ	առեղծվածիդ	Possession
հոլմիումներս	մսան	Case
քնարահավիս	անհույսներս	Possession
չհասցնող	չհասցնեիք	lemma
համեղների	օրիորդիդ	Case
դանդալոշը	մարկիզի	Number
հնգամյաս	ջհուդներդ	Case
ալեմաներեններից	մահկանացուներով	Number
չխոցեինք	կխանդես	Tense
այտուցս	փամփուշտներումս	Possession
ուլունքին	տարածքներիդ	Case
գելե՛ք	չհափափեցիք	Person
ձայնարկություններիցս	ընթածիրիցդ	Case
տեւեք	կկազմակերպի	Tense
խոպոպաձեւներով	խոպոպաձեւներում	lemma
թոռոմեց	չդրսեւորի	Person
կփլվեն	զատեի	Tense
բայոցներիցդ	լիգայումդ	Possession
լոբբիներիս	ներկայացուցչության	Case
գլխարկովդ	աչալուրջներիցդ	Possession
ժողովածու	փաստեր	Case
կհալածեք	ընկճեմ	Tense
վոլֆրամովդ	պատուհասներդ	Possession
մեջտեղիդ	թաքթաքուրումս	Number
ճանդարով	ճանդարումդ	lemma
մագլցելիք	մագլցեց	lemma
չդարսեն	դարսեցիք	lemma
հեւքերում	զառանցեք	Number
ճրագովդ	ոսկրաբանիցս	Number
ամուսնություններովս	թանս	Possession
վրացերենս	նախաճաշեր	Case
չհամաձայնեմ	համաձայներ	lemma
կշփեի	չշարունակեցի	Person
խճուղիների	մեծաքանակի	Case
չկիսեք	կնքեցիք	Person
սվիտերներիցս	փայտեղենիս	Possession
պարտիաներ	նախադասությունս	Case
կզանգեք	չհպարտանայի	Tense
բիզնեսդ	խայրիներումդ	Possession
ընթրիքով	գործիք	Number
գարշումդ	պատուհասներդ	Possession
հաճախություններիս	սրճահատիկս	Possession
թենիցդ	բեռնյաններովդ	Possession
արգելքները	կարելիդ	Case
վայրդ	վերջնախաղերը	Case
լուծեցինք	չչորանայինք	Person
խճողները	հարցազրույցներումդ	Number
կլիզես	համբուրվի՛ր	Person
չկոշկոճեցի	զեղծեի	Person
արմավենիներովդ	ժամհարիցդ	Possession
հրճվեին	կաղարտեմ	Tense
ջրաղացը	փաստեր	Case
կմեկնենք	կմեկնես	lemma
փոսուռայից	վիկինգովդ	Number
չկանխամտածվեին	կքորեմ	Tense
ընտիրներդ	կոմունիստականս	Case
պադյեզդներիս	ճագարովս	Possession
բաժանվեն	ուսումնասիրեցին	Person
թանացի	զեղծեի	Person
չվիճեցինք	քամենք	Person
չհոլանեիք	կկանխամտածեմ	Tense
կոկիկներին	կոկիկովդ	lemma
ռադիոյովս	նախաճաշի	Number
պղնձիս	փույթիցդ	Number
նշանաբաններ	քերականագիտությունս	Case
հայհոյեինք	չհայհոյեցի	lemma
անգիրներովդ	նազովդ	Possession
կարմիրներումդ	կարմիրներումս	lemma
մանգուստներով	քաղցրերովդ	Number
բնույթից	սիկղերիցս	Case
եպերեինք	կկործանես	Tense
կշիջուցանեք	շռեմ	Tense
փոխարինումների	թամբիդ	Case
մահացավ	թարգմաներ	Person
լիանան	կդատապարտեիր	Tense
պտուտակահանդ	տանուտիրոջով	Number
կքաղցեմ	ագուցավորեն	Tense
պաշտամունքումս	ձկնաբանականներովս	Possession
բացականերովդ	ուզբեկերեններովս	Number
ումբրերենում	կոնֆետներումդ	Case
հրշեջներին	հրշեջովդ	lemma
կոկովներիդ	վաղնջահայերենիցդ	Possession
դրվատեին	դրվատեցինք	lemma
մրուրը	պողովատիցդ	Number
մահմեդականներով	տենդախտներումդ	Number
ջինջիլներիս	բրետոներենումս	Possession
հատուներիս	վարպետին	Case
խռմփանք	կփքվես	Tense
կվրդովեին	փորձերից	Number
ակոսիս	նադիրներիդ	Case
ճաշացուցակը	ղայիշներդ	Case
ռազմիկների	անվան	Case
չշիջուցանենք	կզգածվի	Tense
հյուսեր	կաճեցնենք	Tense
աֆարերենը	ջհուդներդ	Case
կթոթովենք	կթոթովես	lemma
մրցավարով	կոկաինիս	Number
բաշկիրերենումդ	բաշկիրերենում	lemma
կմեղադրեիք	չհափափեցիք	Person
կգեղգեղեիք	չարդարացնի	Tense
պտուտակահաններ	լյոքշս	Case
կախակապերումս	թամադայիս	Possession
կարանտիններովդ	գերանդուցդ	Possession
մասնագիտության	անատոմիան	Number
կարտասվեին	խայթեցին	Person
կհարնչենք	խոխոջեիր	Tense
գործոններդ	անալիիդ	Possession
շարունակ	չտարածեցիր	Tense
չհարնչեն	կկործանես	Tense
լերդերդ	կոլխոզումդ	Possession
կապահովանայի	չծափահարեն	Tense
եպերեինք	կբաղխի	Tense
կաբստրահվեիք	բարբարոսներովդ	Number
վհատող	վհատեցին	lemma
հասարակներիցդ	անալիիդ	Possession
քանդակներ	բնակիչս	Case
մեռելոտի	մոլեգնեցի	Number
տիբեթերենումս	գլխատառերիցս	Possession
երգեհոնիդ	առէջներին	Case
կտարամիտես	հորդորի՛ր	Person
սնգուրեինք	չսնգուրեցի	lemma
յանիչարից	կաղերիցդ	Case
վերագրող	վերագրի	lemma
կոսմոսներովս	բրետոներենումս	Possession
լերկեր	կենսախինդը	Case
կշիջուցանեք	չբավարարեր	Tense
օգտագործումներումդ	աղվանիդ	Possession
քաղցրեր	քաղցրովդ	lemma
չափսիս	իշառվույտներիցս	Possession
մոլուցքներիցս	մեռելոտումս	Possession
նախապայմաններս	չմատնեք	Number
ծանոթներ	վարկածս	Case
տագալերենով	անաղարտիցս	Number
գազաններովդ	վաղնջահայերենիցդ	Possession
չսահմանեք	կհաճախեցնեի	Tense
կողքդ	աբուռներ	Case
կորնչեին	չհայեցին	Person
յուղալավաշ	ակնոցներդ	Case
չուժեղանային	ուժեղանային	lemma
հումերդ	դուզիցդ	Possession
մտադրությունը	մտադրության	lemma
ոստնեց	կգուրգուրա	Person
կոմսը	պոռոտախոսություններ	Case
աղբուտներիդ	վիզաներս	Number
արդյունքը	վանադիումումդ	Number
կբարբաջես	բարբաջի՛ր	lemma
փրթեցի	գլտոր	Tense
հիր	ընթեռնեցի	Tense
հերքելիից	խտղտանքներիցդ	Case
չառողջացնես	կառողջացնեիք	lemma
մասնագիտություններս	ընկճախտ	Case
չհերքվեն	կդատապարտեիր	Tense
չճկեցինք	բառնայինք	Person
օդապար	տատին	Number
գոնադովս	խորանարդներիս	Possession
ագրեսիվներովդ	կպոռոտաբանեիք	Number
բուսաբաններիդ	ծուծին	Case
պուպուլիցս	ջրանցքներս	Possession
թլփատ	առողջացր	Tense
ռեակցիաներիցս	կփողոտենք	Number
սպիտակամորթս	ջերմուկներ	Case
ռազմիկների	վինիս	Case
պիլասոսիցդ	որմնախորշերիցս	Case
չհերքվեն	կկիսես	Tense
իռլանդերեն	հողմերս	Case
չտարակուսես	կպարտվեին	Tense
մտոցումդ	սկանդիումներիցդ	Possession
մոխրագույնիս	առէջներին	Case
կոստղավորներիցդ	գանգրափնջիցս	Case
արդարացրեց	գոգ	Tense
մոտեր	կճոռոմաբանեին	Number
կպահածոյացնենք	ընդգծես	Tense
հիասթափություններովդ	կապահովենք	Number
աքսորակցովս	ստորիններիս	Possession
մորմենուցդ	սուպերմարկետներովդ	Possession
չվերուվարող	չվերուվարեիք	lemma
չահագնացար	նախանձես	Person
չերկբայանայի	ամրոցումս	Number
բրիչովս	կալեիր	Number
արդյունքների	օրիորդիդ	Case
հոկտեմբերյաններումս	լահմաջոս	Possession
ձայնարկություններիցս	շվեդից	Case
ավտովարորդս	մորալիստներովս	Possession
մարզիկիցդ	տանուտերերից	Case
հակասեմիտականություններս	ռեգգին	Case
հոտեն	կապշեի	Tense
այտուցս	ձկնաբանականներովս	Possession
կսավառնի	չհեղեղեց	Person
բաջաղեինք	կխածի	Tense
զվարճանաս	շիջեցիր	Person
մոդայումս	անձեռոցիկներում	Case
զգուշաց	ծնվեցինք	Tense
ջրաղացը	ազգանուններ	Case
խորակիցդ	չգարշեց	Number
չտառապեիր	բեկտի՛ր	Person
նեխեց	չծպտվի	Person
աբուռիցդ	թոթովներիցս	Case
չքերծեն	քերծեցիք	lemma
բրիտանականումդ	հեթանոսներումս	Case
կխիթայինք	մշակույթներիս	Number
շփոթեցրիք	կարեկցե՛ք	Person
ջրհորովս	պնչումդ	Number
շփոթեցրիք	չսաղանայիք	Person
ճվատելիք	չճվատեցիր	lemma
եպիսկոպոսներով	տարտամներիդ	Number
կտանջեիր	կլանեցիր	Person
վիզայիցս	վարտիքներումս	Possession
բնակչությունիցդ	չտառապեցնեիր	Number
կթուլանայիք	սիգացիք	Person
բառացիներ	բառացիովդ	lemma
հավաքածոյումդ	կոտորներում	Case
ուռթեինք	չուռթեցի	lemma
բլղուրս	էջի	Number
խիտերը	օսլաներումս	Number
գաղտնիքիցդ	ունիվերմագներից	Case
չմղձկեր	լրտեսեց	Person
հարբածներս	հումուսումս	Possession
արեգակնային	բահերը	Case
կստիպեի	զգենան	Tense
ակնածելիներին	անբանիդ	Case
բարբարոսովդ	ծերուններիցդ	Possession
արծաթիներից	սուտասանից	Case
չթաքչեին	թաքչելիս	lemma
ուրուրդ	իշղարներիդ	Possession
տուտուզներ	տուտուզովդ	lemma
կթռնեք	չփքեի	Tense
կերակրեցիք	չքանդեինք	Number
հռետորաբանություններ	տասերորդդ	Case
ինքնյակը	շեքերս	Case
հրաշքներիդ	անանուխիցդ	Possession
կպատկերես	ջղայնացրիր	Person
արծաթներից	թաղերդ	Number
մոդեմի	բիոլոգիաներիդ	Case
չմտաբերեն	մտաբերեցիք	lemma
ծանոթներ	գործարքս	Case
փախումս	գործիք	Number
արդյունումս	հաստատուններում	Case
շփոթեցրիք	զրուցե՛ք	Person
քունեինք	չքունեցի	lemma
չտարածեցի	կկառավարեմ	Person
ալտի	թերահավատով	Number
սեղանատներ	հովազ	Case
հոխորտայի	չշարունակեցի	Person
խաշ	ըմպակներդ	Case
լաոսերեններիս	կհղեք	Number
մտոցումդ	ծերուններիցդ	Possession
սիկտիրվե՛ք	կացարաններիս	Number
սեպիդ	միացար	Number
վրացականին	քեռակիններիս	Case
էրկաթիցս	էրկաթիս	lemma
ստվարների	նանաներովդ	Number
սանտիմետրիդ	հոբելյարներին	Case
աբուռիցդ	ունիվերմագներից	Case
եկերդ	լեհականումդ	Possession
չկաղկանձեցինք	կակնածեինք	Person
ձողեր	հովազ	Case
աշտեներդ	ենիչարին	Case
ադամանդներից	պորտուգալերենիցդ	Case
շարադրություններիդ	ճապոներենին	Case
լերկեր	մոնղոլերենդ	Case
չսավառնեց	հայթայթ	Tense
ապահովիցդ	կապուտս	Number
ընթացար	կկշռադատեիր	Person
մարզասրահումդ	ծլիկովս	Number
կհալածեք	շռեմ	Tense
կթռնեք	չհեռեի	Tense
տուժեցիր	գոգ	Tense
ամհարերեններումս	երկկտտացնեք	Number
հապաղ	կոպումս	Number
ոսկեղենդ	թալիբներս	Case
կղզի	տգետին	Number
կողողվեին	չպոռոչեցին	Person
չտաղտկացար	տաղտկացող	lemma
նամականիշներից	սեպից	Case
չչաղացանք	կկեղեքենք	Person
լիբրետոներիս	խմածիցս	Possession
թորիծ	թռներ	Number
կէթամ	չջղայնացնեք	Tense
անթացուպիդ	ավետիսից	Number
պարավանդդ	տերունիներիցդ	Possession
ձողեր	կարելիդ	Case
ռուբիդիումներում	հաճախությունում	Case
կվաճառենք	չաղանար	Tense
չնեխող	չնեխեիք	lemma
հիասթափություններովդ	ծոցագրպաններումս	Number
կագուցեիր	չպարապեցիր	Person
լոբիդ	խեղություններիցդ	Possession
չկախարդվեցիր	շվեդերենիս	Number
նայվածքումդ	ջերմերովդ	Possession
չստամբակեին	ստամբակեին	lemma
չնախընտրեցի	կհարեի	Person
մասնագիտություններս	ռեգգին	Case
սադրեք	կխոյանայի	Tense
արտասահմանցուցս	թեներից	Case
ահազանգի՛ր	ահազանգում	lemma
հալոգեններիս	չինարուն	Case
պեդալներ	դուզնաքյաներով	Number
փախերդ	անալիիդ	Possession
անկվածներիդ	առջեւները	Number
մեծացե՛ք	չարբեիք	Person
ակնածելիներին	փետիս	Case
իրիդիումներդ	կետչուպ	Case
սոկումդ	տերունիներիցդ	Possession
թաթուլովդ	կուրսերդ	Possession
օսերենիդ	լիրը	Number
ամբոխներումս	բունոցիցս	Possession
չերկբայեն	կթոթովեիր	Tense
բազումս	բազումներովս	lemma
հաստերին	հաստովդ	lemma
կեչուտիդ	մարտահրավեր	Number
պարմեզանդ	այլանդակությունները	Case
կիվին	փաստեր	Case
սպրիչ	չոգեշնչեցի	Number
հաճախեցրիր	հայթայթ	Tense
թոռոմեց	կխոպոպանար	Person
կստիպեի	չզրուցեն	Tense
կհեռեր	թերահավատով	Number
առաքինություններս	մեքսիկդ	Case
կսիրվեք	չհափափեցիք	Person
չմաքրեք	կմաքրի	lemma
զուգահեռագծիցս	անհույսներս	Possession
երախտամոռումդ	ողորկություններովդ	Possession
լաստենիներումս	ինքնուրույնիս	Possession
բիբարում	կռթունքիդ	Number
ռացիոնալներովդ	գրչատուփիցդ	Possession
ջերմաչափներիս	կատարյալիցս	Possession
չըղձաք	կտռեմ	Tense
ֆերմիոնիդ	ողորկություններովդ	Possession
չարկանեցիր	նախանձես	Person
կզանգեք	էտեմ	Tense
արձակուրդ	քեռիներս	Case
զգուշաց	չկթոտեցին	Tense
լերդերովս	հունվարներումդ	Number
բրիտանականումդ	հարսանյացներումս	Case
առաջադրանքներիս	հերվան	Case
չհղփանայիք	վառվեցիք	Person
դանդաղկոտներին	մեծաքանակի	Case
քանդակներովս	խեղկատակիս	Possession
վայելող	վայելեցին	lemma
կկորեն	չըղձացին	Person
գովի	չկաշկանդեց	Person
չկռնչայինք	կկազմակերպի	Tense
ասորիներովս	պուպուլներից	Number
թարգմանելիք	թարգմանեց	lemma
ալտի	կողը	Number
ափիոնիցս	ավելուկներիցդ	Case
ավարներիս	նավակայանին	Case
բնույթից	ունակներից	Case
ժանգոտ	կարոտին	Number
քանդակներ	փականը	Case
շենք	քեռիներս	Case
կառավարես	կներքինանանք	Tense
տարածքը	ինքնավարումս	Number
գոնադովս	նեղուցներս	Possession
երկչոտներից	մեռելից	Case
հոտեն	կսպասարկեիր	Tense
հոլդ	թարգմաններիցդ	Possession
քրոմներումդ	զառամեք	Number
կհալես	հալի՛ր	lemma
քանդակներ	լյոքշս	Case
կծուլանաք	հաստատեր	Tense
չափահասների	չպառկեք	Number
չուղեկցեցին	գոգ	Tense
կչարանան	սառեցին	Person
խռմփանք	կդատապարտեիր	Tense
չհայտարարեք	հենեցիք	Person
ձաղանքումդ	երիտասարդներդ	Possession
սուսերամարտդ	ահաբեկիչներս	Case
ճանճերդ	սպասյակիցդ	Possession
խաբեբայություն	հայկազներ	Case
փութացե՛ք	կհորանջեք	Person
լաստենիներումս	վհատիցս	Possession
ակնածությամբդ	մահմեդականներովդ	Possession
օրականներից	խլություններում	Number
փքուններդ	սառցալեզվակումդ	Possession
հալեմ	կբդկեիք	Tense
ծիծիկիցդ	մետաղագործություններիդ	Possession
չհերքվենք	կկատարեր	Tense
ցուցակիս	պիստակներին	Case
ամպար	եկեղեցականներ	Case
փայլյունումդ	բացառիկներումս	Case
հավաքածոյումդ	ահազանգումներումս	Case
սավառնե՛ք	չպեղեք	Person
լրջանար	կբարբառենք	Tense
կվաճառենք	չգոգես	Tense
աբսորբենք	կկորնչեր	Tense
կախարդվածություններդ	աղվանիդ	Possession
հոնքս	վարտիքներումս	Possession
նեխեց	տառադարձեր	Person
կհակազդես	չսառչեինք	Tense
կկշռադատես	հսկայականով	Number
լոգացաք	կհուսահատվեք	Person
թզուկի	առյուծից	Number
տես	չգիտակցվեցիք	Tense
արտեւանունքովս	խորհերումս	Possession
կզանգեք	չշիջուցանեի	Tense
կառոգանեիք	դատապարտեցիք	Person
կենսալիրների	ծիծառնուկին	Case
նոբելիումներում	նպաստավորները	Number
օրականներից	սերբերեններդ	Number
շտկեցինք	գլտոր	Tense
զավտրըկը	համաներումներ	Case
շռեց	կքայլի	Person
ժողովածու	ճամփորդներ	Case
քեռայրիցդ	թոթովներիցս	Case
բարբաջելիք	չբարբաջեցիր	lemma
նախուտեստներին	երշիկիս	Case
կառավարող	կառավարեցին	lemma
