двојната	Feminine
сјајното	Neuter
касапот	None
бескорисно	Neuter
одржал	Masculine
животинската	Feminine
југословенска	Feminine
лице	None
дамнешна	Feminine
сенфови	None
фрлачу	None
загноел	Masculine
поддржал	Masculine
дарежлив	Masculine
комплицираниот	Masculine
изразите	None
безбедна	Feminine
минералниот	Masculine
предвиделе	None
часовничари	None
продавала	Feminine
америчкиот	Masculine
хетеросексуалците	None
банкарите	None
сино	Neuter
безгрижен	Masculine
рамнодушен	Masculine
целело	Neuter
основна	Feminine
приспособлива	Feminine
украинска	Feminine
општата	Feminine
внатрешниот	Masculine
избегнувавте	None
скриен	None
взаемно	Neuter
просечниот	Masculine
Словенка	None
морална	Feminine
надгробново	Neuter
белоруски	Masculine
собореше	None
терала	Feminine
духовито	Neuter
сочувствителниот	Masculine
солистите	None
теоретско	Neuter
млитавото	Neuter
исфрлале	None
ножна	Feminine
пресадувала	Feminine
слабото	Neuter
забележителни	None
додадеш	None
достапен	Masculine
определила	Feminine
бакнувал	Masculine
соодветна	Feminine
млечна	Feminine
брз	Masculine
задоволила	Feminine
изникнала	Feminine
колеблив	Masculine
португалското	Neuter
никнала	Feminine
шута	None
кочници	None
дели	None
делив	Masculine
пеколен	Masculine
религиозно	Neuter
боледување	None
шведскиов	Masculine
омилената	Feminine
посмртно	Neuter
понатамошна	Feminine
бездомна	Feminine
решителна	Feminine
јужна	Feminine
љубоморно	Neuter
забележуваа	None
спонтана	Feminine
милостивиот	Masculine
намесништвата	None
ладилници	None
воден	Masculine
сабја	None
дефектен	Masculine
припаднала	Feminine
костенливо	Neuter
убедувале	None
тешкиот	Masculine
изменевме	None
луто	Neuter
електрони	None
повела	Feminine
цимер	None
вообразил	Masculine
кралскиов	Masculine
обновил	Masculine
исклучителен	Masculine
рекламен	Masculine
паднеме	None
услужниот	Masculine
скокнал	Masculine
прецизното	Neuter
бесел	Masculine
престижен	Masculine
воспоставил	Masculine
јагуар	None
првенствена	Feminine
вирусниот	Masculine
удобен	Masculine
легендарнион	Masculine
алкохолно	Neuter
старогрчка	Feminine
мускулатура	None
надвојвода	None
накодошело	Neuter
босанската	Feminine
малтретирале	None
испржи	None
ракави	None
стерилноно	Neuter
тргнало	Neuter
бучен	Masculine
полнолетна	Feminine
божјото	Neuter
климатскион	Masculine
досегашниот	Masculine
доминирало	Neuter
морскава	Feminine
нејасен	Masculine
раздразлив	Masculine
спуштил	Masculine
литванскиот	Masculine
намалил	Masculine
најават	None
составил	Masculine
сегашен	Masculine
океански	Masculine
изместил	Masculine
должеле	None
плажа	None
прегрнела	Feminine
употреби	None
безобѕирен	Masculine
архитектонското	Neuter
азискава	Feminine
надминав	None
раширело	Neuter
волшебниот	Masculine
добра	Feminine
влегло	Neuter
опустошил	Masculine
усвои	None
шестото	Neuter
распарчил	Masculine
изјавила	Feminine
незгодно	Neuter
авионско	Neuter
убави	None
постојано	Neuter
меѓусебна	Feminine
кокетирал	Masculine
словачката	Feminine
споила	Feminine
смирил	Masculine
раскошен	Masculine
сиромашно	Neuter
црна	Feminine
ограничила	Feminine
фармацевт	None
пукотниците	None
турското	Neuter
носи	None
препишан	None
нервира	None
модерни	None
определена	Feminine
неизвесност	None
множат	None
викнеш	None
очигледна	Feminine
вградил	Masculine
џиновскиот	Masculine
интересирало	Neuter
корејскиот	Masculine
смешно	Neuter
овозможувала	Feminine
петаголноно	Neuter
описната	Feminine
долготрајното	Neuter
дворскион	Masculine
прекумерниот	Masculine
неточно	Neuter
темелноно	Neuter
борбено	Neuter
учтиво	Neuter
пливал	Masculine
значело	Neuter
агава	None
зајакнала	Feminine
ограбил	Masculine
арно	Neuter
зборувала	Feminine
бездомен	Masculine
трговски	Masculine
сакам	None
веродостојна	Feminine
симболичното	Neuter
неупотребливиот	Masculine
пробиен	None
дивјачки	Masculine
гарнизоните	None
шутирал	Masculine
трпеливата	Feminine
обопштува	None
вкупното	Neuter
пливачката	Feminine
саркастична	Feminine
незадоволна	Feminine
работлива	Feminine
духовно	Neuter
Германките	None
ограбувачите	None
зрела	Feminine
просело	Neuter
приказната	None
ѕвонел	Masculine
пченични	None
практично	Neuter
ладнокрвност	None
смртоносно	Neuter
влезело	Neuter
набил	Masculine
јазични	None
испитувала	Feminine
следни	None
осовременете	None
изненадила	Feminine
телевизиска	Feminine
недоволното	Neuter
промискуитетно	Neuter
лудиот	Masculine
фаќа	None
корејски	Masculine
проповедал	Masculine
влакнестата	Feminine
кутрава	Feminine
поигра	None
омекнува	None
големата	Feminine
срушило	Neuter
настапувал	Masculine
јапонска	Feminine
модриот	Masculine
обелоденел	Masculine
очигледното	Neuter
суштествена	Feminine
австриското	Neuter
управувало	Neuter
мандаринскиот	Masculine
магичен	Masculine
затегнат	None
надворешен	Masculine
велеа	None
дарувале	None
забарскион	Masculine
старинскава	Feminine
правилен	Masculine
грозд	None
изустете	None
партиите	None
препознала	Feminine
домородната	Feminine
процедурата	None
дотерувало	Neuter
присвојувало	Neuter
делумнион	Masculine
фантастичниот	Masculine
отворал	Masculine
љубљансконо	Neuter
главното	Neuter
делеа	None
хранливиов	Masculine
истакнатото	Neuter
загушело	Neuter
екскреторноно	Neuter
масирајте	None
самостојното	Neuter
фрлил	Masculine
свршен	None
шпанската	Feminine
негирала	Feminine
балканската	Feminine
воспоставувал	Masculine
разликуваа	None
уживанцијата	None
софистицираната	Feminine
првенствен	Masculine
грнчарски	Masculine
изложила	Feminine
педантна	Feminine
кучкарке	None
брзал	Masculine
јасно	Neuter
споредниот	Masculine
споредната	Feminine
католичкото	Neuter
заборавете	None
преткоморите	None
прикажала	Feminine
боледува	None
баскиско	Neuter
составниот	Masculine
тиркизна	Feminine
параграфи	None
запленила	Feminine
нервниот	Masculine
десното	Neuter
нежното	Neuter
усвоило	Neuter
италијанска	Feminine
телевизиско	Neuter
одбила	Feminine
повлекоа	None
страсна	Feminine
вариво	None
двобој	None
повеќекомпонентнана	Feminine
собрала	Feminine
месење	None
осетливи	None
рударската	Feminine
интересено	Neuter
божествена	Feminine
образ	None
градска	Feminine
живата	Feminine
упатило	Neuter
неквалитетна	Feminine
одземала	Feminine
мирното	Neuter
сериозен	Masculine
зелен	Masculine
незрел	Masculine
раскошнава	Feminine
сатен	None
лосос	None
овошен	Masculine
лабавата	Feminine
модерно	Neuter
зрело	Neuter
бунтување	None
приближни	None
соопштувајќи	None
агрегатното	Neuter
југоисточна	Feminine
подземен	Masculine
накурчила	Feminine
мачна	Feminine
купел	Masculine
медицинско	Neuter
инсистирало	Neuter
вискијава	None
јапонскиот	Masculine
хејтеру	None
доловил	Masculine
разнообразна	Feminine
одрекување	None
трошки	None
чворосаме	None
божественото	Neuter
стварна	Feminine
фонолошката	Feminine
престижна	Feminine
манифестирале	None
мома	None
пензионерско	Neuter
ништожните	None
чекот	None
распределиле	None
петицијата	None
правело	Neuter
папуча	None
закуска	None
поставувала	Feminine
невестинска	Feminine
писмениот	Masculine
разгален	None
песните	None
влошила	Feminine
капутите	None
надмоќната	Feminine
сплескајте	None
балетско	Neuter
викајќи	None
скапоцената	Feminine
фолии	None
одговарал	Masculine
оговарачот	None
подготвила	Feminine
домино	None
благословувала	Feminine
описниот	Masculine
розева	Feminine
наидувал	Masculine
пармезанон	None
кубен	None
чудниов	Masculine
месечниот	Masculine
разрешил	Masculine
молив	None
ароганција	None
надминаа	None
презело	Neuter
измативме	None
непотребното	Neuter
проветрувала	Feminine
црната	Feminine
рамнокрак	Masculine
варела	Feminine
проста	Feminine
осудила	Feminine
тежнеело	Neuter
гасовит	Masculine
разбирала	Feminine
монголското	Neuter
расизмот	None
изведувале	None
формалниот	Masculine
бранела	Feminine
разнообразен	Masculine
сексистичкиов	Masculine
навратил	Masculine
железна	Feminine
малтретирање	None
движело	Neuter
грижлив	Masculine
физичко	Neuter
македонсконо	Neuter
велигденското	Neuter
претпоставил	Masculine
дијамантско	Neuter
земјинион	Masculine
зачини	None
применил	Masculine
крлежите	None
креативно	Neuter
насамарел	Masculine
превозна	Feminine
легендарната	Feminine
дождливо	Neuter
ветерниците	None
теоретската	Feminine
надлежно	Neuter
издржувал	Masculine
уреди	None
удобна	Feminine
францускиот	Masculine
чудесното	Neuter
центрирав	None
можниот	Masculine
рефренот	None
пренел	Masculine
монголскиот	Masculine
велело	Neuter
долгнавеста	Feminine
масакрирала	Feminine
одговараа	None
лудата	Feminine
разрешат	None
стекнуваме	None
одмагал	Masculine
физичкиот	Masculine
невидливото	Neuter
јајцестиот	Masculine
бисерна	Feminine
спремнион	Masculine
пиело	Neuter
воспоставила	Feminine
забележливите	None
шпицот	None
изведувала	Feminine
наизменичен	Masculine
усложнило	Neuter
искрено	Neuter
вообичаена	Feminine
пијано	Neuter
објаснувало	Neuter
несвесно	Neuter
етничкото	Neuter
моралната	Feminine
работело	Neuter
пресечел	Masculine
митолошката	Feminine
наглувата	Feminine
вешон	None
обвини	None
дејствувал	Masculine
стрмното	Neuter
половна	Feminine
додавал	Masculine
борбениот	Masculine
преселник	None
страсноно	Neuter
наградила	Feminine
слаткион	Masculine
закопаат	None
микроскопскиов	Masculine
неодамнешен	Masculine
возможен	Masculine
размазувал	Masculine
поклопувал	Masculine
безволново	Neuter
непроменливоно	Neuter
случајниот	Masculine
вперувал	Masculine
брза	Feminine
еврејскиот	Masculine
лизгаво	Neuter
претреси	None
образовната	Feminine
бразилско	Neuter
зеленила	None
истребување	None
снаодливово	Neuter
совладување	None
скрбела	Feminine
сведоци	None
загубело	Neuter
внатрешната	Feminine
забележителново	Neuter
мила	Feminine
пропаѓала	Feminine
цел	Masculine
секојдневнава	Feminine
украсниот	Masculine
пресекла	Feminine
нихилистичка	Feminine
Полјаци	None
пренесувајќи	None
улицата	None
рогат	Masculine
одделна	Feminine
чешкава	Feminine
потенцирал	Masculine
зелено	Neuter
ненадејно	Neuter
помошното	Neuter
замавнал	Masculine
страшилото	None
умерено	Neuter
шминката	None
одвоил	Masculine
дезинфекција	None
уроку	None
висел	Masculine
неблагодарнана	Feminine
јаглерод	None
глумам	None
вкусна	Feminine
омаловажело	Neuter
печател	Masculine
оптималниов	Masculine
завладеала	Feminine
губиме	None
берберница	None
предно	Neuter
обединило	Neuter
мачешкиов	Masculine
океанска	Feminine
петгодишното	Neuter
фалел	Masculine
успокоевме	None
нормално	Neuter
внесен	None
бркал	Masculine
сончевиот	Masculine
релаксација	None
четкаа	None
постигнат	None
макотрпно	Neuter
бескорисното	Neuter
вага	None
моногамноно	Neuter
расистичко	Neuter
флекине	None
сварело	Neuter
умножил	Masculine
манекенска	Feminine
префрлање	None
забележителен	Masculine
благодушнана	Feminine
празна	Feminine
бизниси	None
пополитичкава	Feminine
ќосион	Masculine
расниот	Masculine
среќното	Neuter
симнеш	None
размазила	Feminine
психичково	Neuter
практикува	None
пишувала	Feminine
мизерноно	Neuter
истрча	None
автоматско	Neuter
сината	Feminine
ветровит	Masculine
латинично	Neuter
студена	Feminine
загадочен	Masculine
дотерувала	Feminine
тешиме	None
неуништливиот	Masculine
јазичари	None
официјалното	Neuter
мистериозното	Neuter
гризнал	Masculine
тренерската	Feminine
диеталната	Feminine
администрација	None
повредило	Neuter
уби	None
телесниот	Masculine
направил	Masculine
издлабил	Masculine
астроном	None
шила	None
испечатев	None
морската	Feminine
чудесно	Neuter
упат	None
елиминирале	None
угњавила	Feminine
добротворно	Neuter
сетила	Feminine
растурила	Feminine
стиснат	None
трет	Masculine
надживее	None
молекуларната	Feminine
фалејќи	None
арна	Feminine
тајно	Neuter
поздравивме	None
вредело	Neuter
превел	Masculine
одговорниот	Masculine
бомбардирам	None
грациозна	Feminine
влошил	Masculine
егзотичен	Masculine
објаснуваат	None
љубоморен	Masculine
изгледал	Masculine
прогресивниот	Masculine
третото	Neuter
двоен	Masculine
рамнокрака	Feminine
биолошкото	Neuter
тесноградион	Masculine
милостив	Masculine
етничко	Neuter
измамил	Masculine
целокупни	None
дознаеме	None
комплетен	Masculine
електрични	None
пијаната	Feminine
симболична	Feminine
пружил	Masculine
јапонски	Masculine
еволуцијата	None
ефикасниот	Masculine
непропорционално	Neuter
дебел	Masculine
фрази	None
изоставил	Masculine
пристојна	Feminine
младата	Feminine
муслиманската	Feminine
читнело	Neuter
претворат	None
специјалната	Feminine
древни	None
совладале	None
безбеден	Masculine
терористот	None
нервозата	None
зеленикава	Feminine
плашел	Masculine
мрзливо	Neuter
факултетска	Feminine
левак	None
деминутива	None
светска	Feminine
истовремен	Masculine
непроценливиов	Masculine
земјиниот	Masculine
вонредниот	Masculine
крвава	Feminine
бејзболот	None
предал	Masculine
работничка	Feminine
обележале	None
цврстината	None
комичниов	Masculine
наидувале	None
јарем	None
студија	None
медицинска	Feminine
искинат	None
шармантна	Feminine
станот	None
свеченоно	Neuter
дотурил	Masculine
поместат	None
царското	Neuter
претставен	None
дипломатската	Feminine
трчал	Masculine
храбриот	Masculine
синото	Neuter
новиот	Masculine
етничкиот	Masculine
лампи	None
кривично	Neuter
римското	Neuter
решивме	None
разбиело	Neuter
жртвуван	None
скрил	Masculine
либерална	Feminine
поволна	Feminine
јагнињава	None
судело	Neuter
моногамна	Feminine
интелигентна	Feminine
загрозувале	None
настанал	Masculine
летонски	Masculine
чувствителна	Feminine
разнородна	Feminine
железара	None
менувал	Masculine
славејќи	None
постепено	Neuter
момчешкана	Feminine
филозофските	None
врнежлив	Masculine
уживање	None
потчинетиов	Masculine
неменливи	None
хранлива	Feminine
стабилни	None
спротивно	Neuter
рогатион	Masculine
собери	None
географскиот	Masculine
митолошка	Feminine
исфалила	Feminine
сочен	Masculine
преобразила	Feminine
задржала	Feminine
дневниов	Masculine
тамошниот	Masculine
нуркачу	None
приспособив	None
трепкачи	None
ослабнал	Masculine
канцеларискион	Masculine
кисело	Neuter
женска	Feminine
креативната	Feminine
премислувало	Neuter
означувал	Masculine
префрла	None
храма	None
презела	Feminine
извршило	Neuter
Бугарите	None
доживеела	Feminine
нервноно	Neuter
исклучувало	Neuter
празнеле	None
измислувајќи	None
силен	Masculine
изборна	Feminine
настинело	Neuter
загубил	Masculine
бактерисконо	Neuter
гола	Feminine
топлиот	Masculine
патентирал	Masculine
мелело	Neuter
убедат	None
општине	None
преодните	None
кренал	Masculine
благодарност	None
опишала	Feminine
казнувала	Feminine
граматичко	Neuter
хеланки	None
руменава	Feminine
инспекторите	None
помагал	Masculine
плав	Masculine
телефонската	Feminine
згоден	Masculine
патологија	None
џигерон	None
походите	None
удрила	Feminine
чинам	None
праведноно	Neuter
преточил	Masculine
мамел	Masculine
памтело	Neuter
дочекот	None
фрески	None
произведувала	Feminine
онесвестил	Masculine
вкупна	Feminine
поларно	Neuter
полнион	Masculine
полнолетно	Neuter
лукавиот	Masculine
законската	Feminine
тежело	Neuter
свесна	Feminine
лансираат	None
неуспешната	Feminine
подарело	Neuter
заробел	Masculine
патолошкава	Feminine
средовечен	Masculine
одобрување	None
елена	None
доживувал	Masculine
вклучувала	Feminine
цветало	Neuter
даските	None
упропастела	Feminine
пуловери	None
последично	Neuter
убил	Masculine
тешкион	Masculine
изостави	None
уживало	Neuter
телевизиското	Neuter
надоградат	None
спортското	Neuter
словенското	Neuter
сувоземнана	Feminine
богата	Feminine
книжарниците	None
заработување	None
нанела	Feminine
појдовна	Feminine
глина	None
помислиле	None
пристоен	Masculine
рум	None
истакнувала	Feminine
срцевото	Neuter
концентрирал	Masculine
сериозност	None
нагла	Feminine
есенското	Neuter
тракторите	None
безнадежен	Masculine
тинејџерскиот	Masculine
отмениот	Masculine
археолошкото	Neuter
установил	Masculine
исфрлило	Neuter
вонредниве	None
неделен	Masculine
детскава	Feminine
портокаловово	Neuter
апостолов	None
преполните	None
дводелен	Masculine
искрениот	Masculine
правопропорционална	Feminine
прекраснана	Feminine
разбременела	Feminine
доминантното	Neuter
коцката	None
недоверливи	None
смешна	Feminine
новата	Feminine
половен	Masculine
пристапила	Feminine
општа	Feminine
светла	Feminine
бамјата	None
проститутки	None
архаичниот	Masculine
молел	Masculine
постмодерниот	Masculine
грдиот	Masculine
добредојдена	Feminine
нагодила	Feminine
дедото	None
текнувало	Neuter
наглото	Neuter
истакнато	Neuter
огромна	Feminine
дождливи	None
можните	None
вкупниот	Masculine
виновната	Feminine
честион	Masculine
неприфатлив	Masculine
воопштам	None
кисел	Masculine
интересен	Masculine
вознемиреноста	None
ранат	None
јајце	None
почнало	Neuter
преобратат	None
утврдуваме	None
двособен	Masculine
безбројниов	Masculine
есенскиот	Masculine
подводно	Neuter
игран	None
предупредил	Masculine
онтолошко	Neuter
признаело	Neuter
тапоглавиот	Masculine
потопевте	None
решавал	Masculine
морничаво	Neuter
меѓународното	Neuter
тестостеронине	None
обвинувал	Masculine
осамениот	Masculine
ловела	Feminine
прошетаме	None
разнороден	Masculine
дружељубива	Feminine
оригиналната	Feminine
возбудливиот	Masculine
кириличен	Masculine
одрекувајќи	None
деветти	Masculine
минералнава	Feminine
западнало	Neuter
закажеле	None
неизвесна	Feminine
зајачка	Feminine
дисциплинирање	None
кралскиот	Masculine
свињи	None
мугрите	None
вратарот	None
великодушно	Neuter
грациозната	Feminine
одминела	Feminine
собирање	None
умреа	None
домените	None
застапуваат	None
првенствената	Feminine
потегнал	Masculine
интелигентната	Feminine
доблеснана	Feminine
влошувала	Feminine
морепловецот	None
нечист	Masculine
црвеникава	Feminine
намалило	Neuter
тешките	None
Евреинот	None
снимила	Feminine
озлогласеново	Neuter
гради	None
гризе	None
творечка	Feminine
гравирало	Neuter
круниса	None
напнатана	Feminine
презакажан	None
површниот	Masculine
кружна	Feminine
запечатил	Masculine
преобратил	Masculine
бебешкана	Feminine
неуредно	Neuter
зафатило	Neuter
деловна	Feminine
отпишал	Masculine
детинестата	Feminine
рамнотежата	None
женственост	None
кикиве	None
спровело	Neuter
маркетинг	None
дијамантски	Masculine
верниов	Masculine
продавал	Masculine
високиов	Masculine
благо	Neuter
абдоменот	None
страсно	Neuter
будел	Masculine
гумена	Feminine
северозападна	Feminine
истражуваме	None
дневен	Masculine
непотребниот	Masculine
тажна	Feminine
тажниот	Masculine
практичен	Masculine
невино	Neuter
пуштала	Feminine
стивне	None
функционирало	Neuter
службена	Feminine
сопствена	Feminine
погодило	Neuter
актерите	None
гостољубив	Masculine
директна	Feminine
катастрофалново	Neuter
ропското	Neuter
подземно	Neuter
покорно	Neuter
ушното	Neuter
афричкото	Neuter
законско	Neuter
русово	Neuter
офицер	None
заколела	Feminine
препуштила	Feminine
интелигентно	Neuter
веројатен	Masculine
исфрлил	Masculine
јазичниот	Masculine
приклучила	Feminine
пречи	None
водената	Feminine
виолетова	Feminine
чувствителниов	Masculine
оков	None
соработувате	None
вгради	None
едноклеточен	Masculine
правел	Masculine
печатарот	None
сестринскиот	Masculine
крајново	Neuter
меѓуѕвездено	Neuter
ефикасно	Neuter
бесконечниот	Masculine
чувар	None
дополнителната	Feminine
грешна	Feminine
далекосежно	Neuter
пофалниов	Masculine
бледо	Neuter
простодушното	Neuter
напален	Masculine
мускулно	Neuter
куќниот	Masculine
ангела	None
државното	Neuter
розево	Neuter
изгубела	Feminine
монахињите	None
смеела	Feminine
скулптурата	None
вечен	Masculine
огромното	Neuter
контролирало	Neuter
служевте	None
милион	Masculine
железниот	Masculine
попречел	Masculine
семрежје	None
едногласната	Feminine
жолто	Neuter
ограбила	Feminine
програмско	Neuter
подвижната	Feminine
заборавиле	None
надоградеше	None
телефонско	Neuter
макотрпната	Feminine
стаклен	Masculine
долната	Feminine
прачка	None
централнион	Masculine
празнични	None
шестиов	Masculine
пензионерска	Feminine
симетрична	Feminine
недоволен	Masculine
нежно	Neuter
корисен	Masculine
обесат	None
битното	Neuter
погинал	Masculine
неприспособливоно	Neuter
кажала	Feminine
телефонски	Masculine
променливата	Feminine
доследната	Feminine
последователен	Masculine
фабричниве	None
правоаголен	Masculine
чесниот	Masculine
народна	Feminine
пребришела	Feminine
ироничниот	Masculine
гордана	Feminine
изгубила	Feminine
петгодишниот	Masculine
генерализирање	None
нојот	None
детенце	None
опеал	Masculine
кафениот	Masculine
донаторот	None
психичкиот	Masculine
уникатната	Feminine
копало	Neuter
целодневно	Neuter
историскиот	Masculine
обезбедило	Neuter
сложениот	Masculine
останала	Feminine
манекенскиов	Masculine
ширело	Neuter
кокосов	None
старогрчко	Neuter
возможното	Neuter
неприспособливата	Feminine
залога	None
дебелина	None
гневот	None
меѓучовечки	Masculine
можнана	Feminine
ланскава	Feminine
мрзливиот	Masculine
различен	Masculine
развивал	Masculine
грузиско	Neuter
темниот	Masculine
поседувало	Neuter
семиња	None
измрсулавил	Masculine
забот	None
друштвена	Feminine
надоместил	Masculine
националисти	None
рангирала	Feminine
личело	Neuter
сетив	None
будилниците	None
патриотски	Masculine
месечните	None
отсвирела	Feminine
чувствителната	Feminine
полн	Masculine
подреди	None
вечната	Feminine
изводлива	Feminine
избувнувало	Neuter
прекинало	Neuter
поздравил	Masculine
ефективното	Neuter
неделната	Feminine
окна	None
истакната	Feminine
кучешко	Neuter
карактеристичните	None
материјален	Masculine
модернистон	None
камениот	Masculine
пореметел	Masculine
авторитетен	Masculine
палав	Masculine
сестран	Masculine
комплетнион	Masculine
незабележително	Neuter
романски	Masculine
вработувала	Feminine
симнал	Masculine
нелогичново	Neuter
прифатила	Feminine
прекрасна	Feminine
мазен	Masculine
нешто	None
дувнал	Masculine
реонон	None
депресивна	Feminine
секојдневниот	Masculine
претел	Masculine
привлекувала	Feminine
долготраен	Masculine
практикувала	Feminine
лачење	None
задна	Feminine
четиригодишниот	Masculine
растурал	Masculine
отсутна	Feminine
несвесната	Feminine
заборавила	Feminine
насилно	Neuter
множен	None
злобен	Masculine
запалението	None
преобразил	Masculine
питомион	Masculine
маските	None
згинал	Masculine
неодоливоно	Neuter
додавала	Feminine
пробав	None
ливчиња	None
лична	Feminine
претпазлив	Masculine
дополнителните	None
оттргал	Masculine
лепење	None
натпросечно	Neuter
америчката	Feminine
модерен	Masculine
опуштени	None
бурната	Feminine
имитации	None
изразило	Neuter
албанска	Feminine
кутар	Masculine
мешала	Feminine
открил	Masculine
искористил	Masculine
темпераментна	Feminine
добротворниот	Masculine
релативната	Feminine
вработувал	Masculine
изведувал	Masculine
припишал	Masculine
месечниов	Masculine
вработи	None
болнана	Feminine
доследна	Feminine
храни	None
населил	Masculine
слегува	None
осети	None
замислило	Neuter
тресев	None
незначајнава	Feminine
забавната	Feminine
клеточното	Neuter
уверила	Feminine
подготвувала	Feminine
дисертацииве	None
инвестирала	Feminine
позајми	None
назначило	Neuter
спуштам	None
омекнал	Masculine
дознало	Neuter
применила	Feminine
чудам	None
заразил	Masculine
недостојно	Neuter
гердан	None
дознаат	None
уплата	None
пожртвуваноста	None
полињата	None
скратила	Feminine
занимлив	Masculine
спомнувало	Neuter
грбниот	Masculine
неутрализирале	None
оставала	Feminine
сценарист	None
годишното	Neuter
спасиме	None
незначајна	Feminine
најавам	None
потрошил	Masculine
софистицирано	Neuter
пороти	None
нацисти	None
магарешко	Neuter
долготрајниот	Masculine
полнолетноно	Neuter
бугарски	Masculine
дрвена	Feminine
хаотична	Feminine
молчел	Masculine
трнлив	Masculine
клеточна	Feminine
претпоследниот	Masculine
изневерувал	Masculine
фармата	None
живописното	Neuter
финансирала	Feminine
повиеја	None
австралискиот	Masculine
променливиот	Masculine
длабоко	Neuter
факултетското	Neuter
повторила	Feminine
грнчари	None
дознале	None
казнувале	None
крштевката	None
доживеало	Neuter
друштвената	Feminine
повторил	Masculine
возеше	None
прибран	None
молекуларна	Feminine
бурното	Neuter
ситно	Neuter
разгледувало	Neuter
проценувајќи	None
поставувало	Neuter
финансиска	Feminine
биолози	None
престижнион	Masculine
расеан	Masculine
досушила	Feminine
владика	None
куќната	Feminine
слична	Feminine
запалил	Masculine
именскиот	Masculine
Грузијката	None
плетела	Feminine
поранешниот	Masculine
голем	Masculine
мало	Neuter
менгемињана	None
тивка	Feminine
демоните	None
издашната	Feminine
сељачкиот	Masculine
циркусантите	None
трофеите	None
влезеш	None
измачен	None
искенираат	None
полската	Feminine
прекуморски	Masculine
јужните	None
препознавала	Feminine
дизајнеркава	None
потемните	None
двосмислено	Neuter
доближувал	Masculine
пречник	None
цврстоно	Neuter
наметнете	None
достојно	Neuter
финансиско	Neuter
бунтовниците	None
кандидата	None
натприродно	Neuter
излегло	Neuter
рамноправни	None
одвратново	Neuter
разрушен	None
австрискиот	Masculine
молекуларното	Neuter
поминала	Feminine
целодневното	Neuter
успешно	Neuter
разгледуваше	None
дворското	Neuter
склоп	None
пробам	None
петле	None
утрински	Masculine
зборувате	None
пренасочила	Feminine
окрвавила	Feminine
бедно	Neuter
тешко	Neuter
прифатило	Neuter
дамнешното	Neuter
чувствувал	Masculine
ќор	Masculine
додатен	Masculine
лебен	Masculine
симболизирал	Masculine
крајбрежја	None
процедура	None
непокорните	None
свесен	Masculine
цимерот	None
фалеа	None
илјадитиов	Masculine
појадувало	Neuter
адекватната	Feminine
синиот	Masculine
поминеме	None
средни	None
триаголниот	Masculine
стомаци	None
преварантот	None
диктирал	Masculine
последична	Feminine
навредила	Feminine
манипулирање	None
мистериозниот	Masculine
поделба	None
забележала	Feminine
оженила	Feminine
откриен	None
очна	Feminine
судски	Masculine
голо	Neuter
бурно	Neuter
попален	Masculine
западна	Feminine
паричниот	Masculine
делотворниот	Masculine
странскава	Feminine
формулираме	None
дувал	Masculine
специјален	Masculine
смешливото	Neuter
средновековноно	Neuter
танчерката	None
магнетното	Neuter
опева	None
наследно	Neuter
јадното	Neuter
одбегнат	None
патетичен	Masculine
сферине	None
лупнеа	None
ѕенѕај	None
простачкава	Feminine
наводна	Feminine
настроениот	Masculine
издвојат	None
последователно	Neuter
зинува	None
граматичкото	Neuter
горко	Neuter
донесел	Masculine
финскион	Masculine
чашите	None
констатираат	None
отсутно	Neuter
заработил	Masculine
просечното	Neuter
туристичката	Feminine
припаѓала	Feminine
пчеларка	None
пламневте	None
занимлива	Feminine
бугарска	Feminine
тежок	Masculine
желудник	None
божествената	Feminine
морало	Neuter
изговорил	Masculine
чаршиски	Masculine
вандалската	Feminine
потчинел	Masculine
панично	Neuter
згоднион	Masculine
сештојад	None
исчистат	None
филолошкото	Neuter
бисерон	None
бавно	Neuter
вежбаат	None
наредниве	None
разгледувал	Masculine
разгорила	Feminine
наглиот	Masculine
тренерскиот	Masculine
голема	Feminine
лут	Masculine
оградиме	None
шишаркана	None
метална	Feminine
опејте	None
добрата	Feminine
склопот	None
апсолутното	Neuter
фина	Feminine
сфаќам	None
зборлестана	Feminine
пребирлив	Masculine
детскиот	Masculine
квачело	Neuter
патолошка	Feminine
вратила	Feminine
новородено	Neuter
нацистичкото	Neuter
адекватен	Masculine
остро	Neuter
етимолошкото	Neuter
ефектите	None
нормативнион	Masculine
балетски	Masculine
вкрстам	None
додркај	None
отпаднала	Feminine
одложувал	Masculine
зимскиот	Masculine
бучно	Neuter
бесмислената	Feminine
горниот	Masculine
дипломатска	Feminine
понесе	None
казнила	Feminine
средувала	Feminine
навредува	None
кириличното	Neuter
воспоставило	Neuter
пројави	None
својствен	Masculine
коњско	Neuter
внимателен	Masculine
електричните	None
ретко	Neuter
катастрофално	Neuter
естрогените	None
изминала	Feminine
ненадејниот	Masculine
војувала	Feminine
неправеден	Masculine
груб	Masculine
сеопшто	Neuter
гасела	Feminine
грбна	Feminine
поштите	None
надуела	Feminine
размислувај	None
отседнал	Masculine
неупотреблив	Masculine
споредил	Masculine
правилно	Neuter
мрсната	Feminine
притиснал	Masculine
неверојатнана	Feminine
старовремската	Feminine
наставно	Neuter
дамнешно	Neuter
сопрен	None
прилагодувале	None
субјективна	Feminine
невидливата	Feminine
филозофскиот	Masculine
плашлив	Masculine
здравиов	Masculine
судско	Neuter
отиде	None
израмнил	Masculine
режимиве	None
заедничкана	Feminine
кривични	None
сјајниот	Masculine
неуништлива	Feminine
велшкото	Neuter
општиот	Masculine
благодат	None
купечка	Feminine
розевата	Feminine
мрачно	Neuter
бесмислениов	Masculine
комичниот	Masculine
целосно	Neuter
ноќното	Neuter
уживал	Masculine
пармезанов	None
внимавало	Neuter
растргнат	None
повратноно	Neuter
запознавале	None
упростиле	None
ушен	Masculine
должел	Masculine
прејдат	None
растечи	None
немото	Neuter
десен	Masculine
коментирала	Feminine
класите	None
вљубена	Feminine
злобново	Neuter
навивач	None
избираа	None
пукнала	Feminine
поединечната	Feminine
качил	Masculine
заколел	Masculine
немово	Neuter
брачен	Masculine
спасувал	Masculine
воздушните	None
праската	None
рамен	Masculine
струмичката	Feminine
визбите	None
среќна	Feminine
колонијата	None
законито	Neuter
осмиот	Masculine
свадбен	Masculine
еснаф	None
угледна	Feminine
налутило	Neuter
северно	Neuter
дискутирајќи	None
закони	None
дигестивниот	Masculine
кожно	Neuter
весело	Neuter
печат	None
склучел	Masculine
печатен	Masculine
разјасни	None
диригирал	Masculine
болен	Masculine
напнатиот	Masculine
избелила	Feminine
религиозниот	Masculine
лавовската	Feminine
најавило	Neuter
ширела	Feminine
определувал	Masculine
беспомошно	Neuter
клукајдрвец	None
разумниов	Masculine
изрезбарела	Feminine
духовното	Neuter
тврдото	Neuter
повикаме	None
куца	Feminine
лишел	Masculine
ограбен	None
превенцијава	None
долгнавестово	Neuter
бреза	None
изопачил	Masculine
сакаат	None
чест	Masculine
паскалов	None
златникон	None
интернационалниот	Masculine
расположенион	Masculine
грабнал	Masculine
прекинува	None
отклучување	None
соопштуваат	None
нелогично	Neuter
минијатурен	Masculine
пенов	None
заемната	Feminine
пророчкиот	Masculine
женското	Neuter
атмосферски	Masculine
заклучила	Feminine
спуштила	Feminine
масакрите	None
гаден	Masculine
дворски	Masculine
активна	Feminine
невестински	Masculine
настанувале	None
запеал	Masculine
преземало	Neuter
прашуваш	None
замолчил	Masculine
недостојново	Neuter
невидливиот	Masculine
направила	Feminine
своеволно	Neuter
асално	Neuter
промашил	Masculine
трпение	None
лакомоста	None
учителската	Feminine
побожниот	Masculine
правопропорционален	Masculine
веројатниот	Masculine
чувствувала	Feminine
одмазднициве	None
кутриот	Masculine
сатана	None
економско	Neuter
инспирирал	Masculine
туркал	Masculine
клеточниот	Masculine
морското	Neuter
активно	Neuter
остварувала	Feminine
скромноста	None
препрека	None
лизгалките	None
седело	Neuter
плашливата	Feminine
разумнава	Feminine
јаваат	None
гласниот	Masculine
тригодишен	Masculine
етимолошко	Neuter
викање	None
толерантното	Neuter
патела	Feminine
пијана	Feminine
одбележал	Masculine
површни	None
усложнила	Feminine
запалив	Masculine
читам	None
повеќекратново	Neuter
судбоносен	Masculine
ерменските	None
обесчестела	Feminine
велшката	Feminine
констатирал	Masculine
врамен	None
гатала	Feminine
човечкото	Neuter
пропаднала	Feminine
женската	Feminine
величествено	Neuter
столарсково	Neuter
нерешителново	Neuter
потпишала	Feminine
волен	Masculine
бука	None
прасечко	Neuter
релјефите	None
претпоследното	Neuter
припадник	None
понатамошниот	Masculine
обработувале	None
препознавајќи	None
детски	Masculine
патувал	Masculine
здодевен	Masculine
јасен	Masculine
запишувало	Neuter
гони	None
растителен	Masculine
овоземен	Masculine
очен	Masculine
вртлог	None
дијареја	None
верници	None
строг	Masculine
зајдело	Neuter
словенсково	Neuter
домородна	Feminine
капиталистичкиот	Masculine
осветлил	Masculine
безграничното	Neuter
ѓон	None
структурен	Masculine
етика	None
таблица	None
неразумно	Neuter
неделно	Neuter
неморално	Neuter
мандарински	Masculine
зема	None
костенливи	None
тестирајќи	None
план	None
декларација	None
штетна	Feminine
затворил	Masculine
душевно	Neuter
далечна	Feminine
прилегнала	Feminine
компромитирање	None
среќава	None
останавме	None
претставувало	Neuter
безделничел	Masculine
празноглавово	Neuter
штоснава	Feminine
раѓаат	None
глаткион	Masculine
дијамантска	Feminine
округло	Neuter
касапа	None
смеѓион	Masculine
истакнувал	Masculine
комунистичкана	Feminine
слабата	Feminine
племе	None
доаѓала	Feminine
внела	Feminine
несреќна	Feminine
фотелја	None
дисциплиниравме	None
намесништво	None
заменил	Masculine
акција	None
наставен	Masculine
невината	Feminine
граделе	None
вечното	Neuter
разјаривме	None
горел	Masculine
копал	Masculine
непожелни	None
попречувал	Masculine
стрмна	Feminine
основач	None
вечерното	Neuter
минувале	None
самоуверената	Feminine
шеснаесетгодишната	Feminine
брановитите	None
залудна	Feminine
незабележлива	Feminine
португалско	Neuter
одговорнион	Masculine
конечното	Neuter
накажела	Feminine
достигнала	Feminine
седмиот	Masculine
тензија	None
доаѓал	Masculine
крилестиот	Masculine
килограми	None
двогодишноно	Neuter
грдава	Feminine
невкусните	None
употреблив	Masculine
оптеретело	Neuter
показател	None
досадно	Neuter
нотари	None
млечен	Masculine
итрата	Feminine
претпазливо	Neuter
види	None
куцана	Feminine
инсистирала	Feminine
приспособливоно	Neuter
лево	Neuter
укажувал	Masculine
создал	Masculine
балкон	None
црногорско	Neuter
годишната	Feminine
избило	Neuter
пристојнана	Feminine
бавниот	Masculine
суштинска	Feminine
гестикулација	None
одгледувала	Feminine
измислените	None
нечесново	Neuter
страшен	Masculine
нужно	Neuter
цртал	Masculine
весела	Feminine
осветил	Masculine
продаден	None
темелот	None
грешнана	Feminine
сеопфатната	Feminine
комичното	Neuter
воздухопловство	None
археолошки	Masculine
бидел	Masculine
пристигнала	Feminine
мачешкион	Masculine
расцепило	Neuter
горен	Masculine
размислувала	Feminine
налутил	Masculine
доживеал	Masculine
медитира	None
сува	Feminine
поткласа	None
споредлив	Masculine
крувчиња	None
монашкиот	Masculine
телесното	Neuter
укинала	Feminine
црно	Neuter
обработувала	Feminine
водено	Neuter
контрасти	None
чесно	Neuter
снесело	Neuter
раскрвавил	Masculine
‘ржани	None
обвил	Masculine
кратки	None
словачкото	Neuter
миг	None
фризерка	None
кучешкото	Neuter
вишна	None
растеретил	Masculine
распнело	Neuter
смокви	None
покренал	Masculine
прометен	Masculine
спроведувало	Neuter
изострел	Masculine
нисково	Neuter
документарец	None
интернационално	Neuter
збирниот	Masculine
прегази	None
спремен	Masculine
суштинската	Feminine
докаже	None
викнел	Masculine
изгмечило	Neuter
залудно	Neuter
поместил	Masculine
испаѓаат	None
легендарен	Masculine
успеела	Feminine
почнела	Feminine
финалињата	None
караванот	None
привлекуваат	None
плитката	Feminine
јазици	None
економска	Feminine
одбило	Neuter
распуштено	Neuter
непристоен	Masculine
оценат	None
продажната	Feminine
учествувало	Neuter
смрдело	Neuter
ослабнала	Feminine
воспитува	None
сеопшт	Masculine
прикажи	None
ламја	None
одложила	Feminine
побудило	Neuter
говедското	Neuter
белезите	None
благородно	Neuter
изразувала	Feminine
глумецот	None
докопам	None
собирало	Neuter
геолошконо	Neuter
памучно	Neuter
избегаш	None
џиновска	Feminine
практичното	Neuter
шугава	Feminine
макотрпна	Feminine
цветање	None
сребрениот	Masculine
споменувајќи	None
стеснувало	Neuter
несвесниот	Masculine
бујниот	Masculine
тркнало	Neuter
наредно	Neuter
нежна	Feminine
нормативен	Masculine
залиел	Masculine
наросивте	None
багрем	None
расчленат	None
хипотетичка	Feminine
вработил	Masculine
оставил	Masculine
тезга	None
арапска	Feminine
магацините	None
мизерно	Neuter
многубројниот	Masculine
вљубениот	Masculine
дигиталната	Feminine
потекнувал	Masculine
слободна	Feminine
подобна	Feminine
топол	Masculine
невин	Masculine
меден	Masculine
егзотичната	Feminine
магнетно	Neuter
обично	Neuter
обична	Feminine
блиско	Neuter
шпекулирал	Masculine
докторирала	Feminine
забен	Masculine
достигнувала	Feminine
волненава	Feminine
жолта	Feminine
етичката	Feminine
послала	Feminine
куќното	Neuter
потонало	Neuter
црниов	Masculine
зрнеста	Feminine
црковното	Neuter
надменана	Feminine
набој	None
рамна	Feminine
непотребна	Feminine
благословот	None
издржлив	Masculine
босанското	Neuter
честиот	Masculine
мизеријата	None
евидентира	None
софра	None
покривал	Masculine
осветело	Neuter
хомоген	Masculine
орелот	None
меана	None
растурела	Feminine
опфаќаат	None
комунист	None
бибер	None
блеснала	Feminine
виолетовава	Feminine
републиканците	None
приоритети	None
својствениот	Masculine
забележителниот	Masculine
престолонаследникот	None
културно	Neuter
комплетниот	Masculine
женствен	Masculine
овозможил	Masculine
достоен	Masculine
сфатил	Masculine
престрелке	None
тешката	Feminine
конкретни	None
среќа	None
волна	Feminine
бега	None
вулгарниот	Masculine
образованата	Feminine
католичко	Neuter
современото	Neuter
козина	None
генијалниот	Masculine
измислено	Neuter
бојкотирала	Feminine
краткорочната	Feminine
патетичнана	Feminine
интервјуата	None
количествена	Feminine
заробат	None
преводливава	Feminine
сребренион	Masculine
споменувало	Neuter
опколил	Masculine
денешниов	Masculine
изјавувајќи	None
огорчениот	Masculine
пакосен	Masculine
знаев	None
влакната	None
закитила	Feminine
годен	None
ферментирала	Feminine
умерениот	Masculine
искорнало	Neuter
нервен	Masculine
Хрватите	None
извонредно	Neuter
симболично	Neuter
бактеријата	None
монолозите	None
најмел	Masculine
избезумуваат	None
собнион	Masculine
издржливо	Neuter
откршивме	None
меѓусебниот	Masculine
тесна	Feminine
дизајнирала	Feminine
продолжила	Feminine
учтива	Feminine
училиштен	Masculine
оспособувал	Masculine
недостижно	Neuter
простила	Feminine
зафаќала	Feminine
холандското	Neuter
цркнело	Neuter
директното	Neuter
докажете	None
таинствен	Masculine
толерирала	Feminine
насочија	None
војната	None
решавате	None
ориентирајте	None
изборното	Neuter
лабораториски	Masculine
почнал	Masculine
џелатот	None
осетливо	Neuter
заколам	None
шестаголно	Neuter
лебнана	Feminine
рачна	Feminine
гугате	None
тромбоцити	None
луда	Feminine
испрашувал	Masculine
одбил	Masculine
електричниот	Masculine
техничка	Feminine
долгорочниот	Masculine
гордата	Feminine
ефикасното	Neuter
мутирање	None
нестабилната	Feminine
гласал	Masculine
доверливото	Neuter
влегов	None
сирењето	None
дрдореше	None
бенко	None
подучуваше	None
констатира	None
строгото	Neuter
интернационална	Feminine
тркалезна	Feminine
леопардов	None
надуен	None
архиепископите	None
феномени	None
условна	Feminine
бакарна	Feminine
недопирливана	Feminine
дарувал	Masculine
кусото	Neuter
накривеше	None
разрешило	Neuter
компромитирал	Masculine
јасмин	None
ветерот	None
патолошки	Masculine
правното	Neuter
горенаведенион	Masculine
забременело	Neuter
единственото	Neuter
проколнала	Feminine
латиничната	Feminine
непропорционалнион	Masculine
напредувала	Feminine
опуштање	None
луд	Masculine
официјалните	None
често	Neuter
разнел	Masculine
памучен	Masculine
внатрешно	Neuter
скараниве	None
задната	Feminine
непожелнион	Masculine
разгледуван	None
средното	Neuter
подметнел	Masculine
нашло	Neuter
поседувала	Feminine
озлогласената	Feminine
наговорил	Masculine
телевизиски	Masculine
пропустов	None
бајата	Feminine
наредил	Masculine
опколило	Neuter
преправал	Masculine
костенливион	Masculine
исплашат	None
крајната	Feminine
посочил	Masculine
општо	Neuter
безначајнана	Feminine
свири	None
оставила	Feminine
угледниот	Masculine
праќал	Masculine
норма	None
разговорниот	Masculine
жици	None
раководење	None
повеќенаменско	Neuter
нервозно	Neuter
инсталирал	Masculine
реалистичниот	Masculine
избришала	Feminine
посветело	Neuter
ироничноно	Neuter
факултетско	Neuter
основниот	Masculine
зборовен	Masculine
сувиот	Masculine
билка	None
привремен	Masculine
делумната	Feminine
настинка	None
протоните	None
избегнувал	Masculine
гласна	Feminine
мислеа	None
струмички	Masculine
основа	None
итро	Neuter
пренела	Feminine
шестиот	Masculine
старата	Feminine
римската	Feminine
ужасниот	Masculine
данската	Feminine
неопходно	Neuter
напрегневме	None
намалувало	Neuter
побожно	Neuter
осамено	Neuter
задева	None
шведско	Neuter
избавувало	Neuter
ментална	Feminine
симболичната	Feminine
патолошконо	Neuter
подобрило	Neuter
масакрирал	Masculine
раздолжила	Feminine
латинскиот	Masculine
забниот	Masculine
клучниов	Masculine
карактеризирало	Neuter
данскиот	Masculine
писателки	None
читлив	Masculine
ослонет	None
најавите	None
џаболебарите	None
грнчарот	None
доведувала	Feminine
малубројната	Feminine
холандско	Neuter
шпенагли	None
дождовната	Feminine
отфрлило	Neuter
психолошки	Masculine
лековита	Feminine
уценувал	Masculine
прекини	None
реализиран	None
попуштил	Masculine
фрлиме	None
прекипевме	None
управуван	None
кадрине	None
создаваме	None
интимниот	Masculine
намалија	None
естетска	Feminine
внатрешните	None
безбедносна	Feminine
забележало	Neuter
сфаќања	None
зајачко	Neuter
наметнал	Masculine
жилавиов	Masculine
нацистичка	Feminine
жешки	None
народен	Masculine
спила	None
сослушајте	None
соседството	None
црвеникав	Masculine
вонбрачниот	Masculine
дојди	None
значајно	Neuter
грошовиве	None
несреќно	Neuter
помогнала	Feminine
полскиот	Masculine
потфрлила	Feminine
преправаше	None
зоните	None
безумно	Neuter
беснеела	Feminine
лебедовион	Masculine
мечтае	None
зоолошкиот	Masculine
гордо	Neuter
отсутново	Neuter
сниман	None
споредила	Feminine
украсно	Neuter
завел	Masculine
обединувајќи	None
зголемуваат	None
индиректниот	Masculine
пасивниве	None
паралелнана	Feminine
разновидното	Neuter
мртво	Neuter
механичкото	Neuter
школи	None
жестоко	Neuter
надминувала	Feminine
угледноно	Neuter
анонимна	Feminine
темното	Neuter
речниот	Masculine
океанскиот	Masculine
возвратил	Masculine
кафеав	Masculine
заработила	Feminine
злокобното	Neuter
бисексуалноно	Neuter
сакатиот	Masculine
благословело	Neuter
скапоцениот	Masculine
струен	Masculine
полнолетен	Masculine
корејско	Neuter
одбојкарска	Feminine
католичка	Feminine
надгробната	Feminine
лажната	Feminine
уништила	Feminine
земјиното	Neuter
важниве	None
округ	None
учителска	Feminine
пристрасно	Neuter
бело	Neuter
анонимниот	Masculine
заразен	Masculine
ублажил	Masculine
запросувало	Neuter
придружувала	Feminine
проценувал	Masculine
доблесноно	Neuter
крајниот	Masculine
многуброен	Masculine
имам	None
тврдоглав	Masculine
окното	None
напиши	None
милосливиот	Masculine
зафатила	Feminine
режисерот	None
желно	Neuter
неприкосновениот	Masculine
тече	None
заварело	Neuter
дивјакот	None
нацистички	Masculine
егзотично	Neuter
чаен	Masculine
кружен	Masculine
меланхоличнион	Masculine
читаат	None
правоаголноно	Neuter
проповедавте	None
внуцине	None
безбедносната	Feminine
пивница	None
фино	Neuter
вџашен	None
прашалникот	None
признавал	Masculine
раструбело	Neuter
матново	Neuter
нареднава	Feminine
доверила	Feminine
прераскажувајќи	None
добродушна	Feminine
густиот	Masculine
трговско	Neuter
социјалната	Feminine
големото	Neuter
расееш	None
горки	None
исландски	Masculine
необработенана	Feminine
успивала	Feminine
пријатниот	Masculine
загреел	Masculine
душнеле	None
волшебно	Neuter
византиската	Feminine
развило	Neuter
квалитативна	Feminine
периодон	None
даден	None
модерната	Feminine
аметистот	None
сексистички	Masculine
жанровине	None
елегантниот	Masculine
прекрасен	Masculine
градскиов	Masculine
централа	None
смртна	Feminine
злобна	Feminine
катастаре	None
елегантен	Masculine
несовршената	Feminine
земјоделското	Neuter
понатамошен	Masculine
творечки	Masculine
подробен	Masculine
емотивно	Neuter
повеќекратното	Neuter
инсистира	None
магарешки	Masculine
вчерашнава	Feminine
нудам	None
заробил	Masculine
јужно	Neuter
возможна	Feminine
заминале	None
билко	None
целат	None
историчарите	None
загадувал	Masculine
целосните	None
специјалното	Neuter
полуголоно	Neuter
пазарното	Neuter
доброволен	Masculine
српскохрватската	Feminine
пустата	Feminine
жаргони	None
искривен	None
завршувало	Neuter
главна	Feminine
поканата	None
нарачаат	None
именска	Feminine
совпадливите	None
шпанска	Feminine
створовите	None
дивото	Neuter
пропорционалниот	Masculine
горкото	Neuter
Американецон	None
расположен	Masculine
накезен	None
зависело	Neuter
претпочита	None
морала	Feminine
инјекцијо	None
младо	Neuter
сончевата	Feminine
продажен	Masculine
обесценам	None
сивото	Neuter
заробело	Neuter
спуштило	Neuter
придружувале	None
фатила	Feminine
розов	Masculine
интересенава	Feminine
горенаведеното	Neuter
обвинувам	None
унгарско	Neuter
еднолична	Feminine
нечесно	Neuter
спортски	Masculine
морфолошкана	Feminine
ракописен	Masculine
празнична	Feminine
условно	Neuter
стимулирала	Feminine
точката	None
придвижила	Feminine
елегантна	Feminine
меката	Feminine
брачноно	Neuter
испушив	None
тежнеење	None
светлата	Feminine
извеснана	Feminine
куферот	None
маршира	None
драматурзи	None
средно	Neuter
впечатливо	Neuter
погалело	Neuter
спречил	Masculine
потрес	None
приберело	Neuter
непристојниов	Masculine
повторете	None
морален	Masculine
поврзувал	Masculine
технолошката	Feminine
завршил	Masculine
издржаа	None
разумното	Neuter
латинско	Neuter
самовилски	Masculine
одмрзнам	None
нечистата	Feminine
современата	Feminine
пик	None
истекло	Neuter
доведе	None
чифлигот	None
прифатливото	Neuter
црковен	Masculine
помошно	Neuter
означил	Masculine
семоќниот	Masculine
словенски	Masculine
своевидна	Feminine
припаѓаат	None
поштуваал	Masculine
геноциди	None
употребливо	Neuter
школската	Feminine
суштествениве	None
отмената	Feminine
богобојазливиов	Masculine
известат	None
невидлива	Feminine
ставило	Neuter
островсконо	Neuter
побиен	None
обиколни	None
цуфнало	Neuter
куклени	None
мирисливиов	Masculine
германски	Masculine
реален	Masculine
нежниот	Masculine
реков	None
славно	Neuter
бесконечно	Neuter
световниот	Masculine
окрвавивте	None
обврзале	None
мрзеливост	None
живеел	Masculine
површно	Neuter
сталожниот	Masculine
хемофилија	None
австралиското	Neuter
холандската	Feminine
остварувало	Neuter
меѓуѕвездена	Feminine
установиле	None
пријавиле	None
скромната	Feminine
скусело	Neuter
гладната	Feminine
евидентирање	None
застанала	Feminine
кима	None
лепливото	Neuter
сервисите	None
истовремена	Feminine
еластично	Neuter
посвоил	Masculine
мачел	Masculine
вонбрачна	Feminine
резервоарот	None
туристичкото	Neuter
катастрофалната	Feminine
доцнела	Feminine
постепената	Feminine
карпата	None
жестокото	Neuter
истакнатиот	Masculine
дамнешната	Feminine
аморфно	Neuter
волшебната	Feminine
моќнион	Masculine
зачуваат	None
вградува	None
свршувал	Masculine
типично	Neuter
дотогашен	Masculine
ветувал	Masculine
видеото	None
префинет	Masculine
парчето	None
црвениот	Masculine
прекумерното	Neuter
приморале	None
складирајќи	None
донираше	None
снисходливине	None
розовава	Feminine
неупотреблива	Feminine
розова	Feminine
доволен	Masculine
малиот	Masculine
слаткото	Neuter
видливото	Neuter
модро	Neuter
скромна	Feminine
употребувало	Neuter
осомничен	None
друштвеново	Neuter
великодушниот	Masculine
сиромашна	Feminine
англиски	Masculine
исправил	Masculine
зоолошки	Masculine
вистинска	Feminine
просветител	None
проценило	Neuter
исклучила	Feminine
заживеал	Masculine
првични	None
доаѓало	Neuter
страсната	Feminine
зајакнал	Masculine
стоглава	Feminine
господарела	Feminine
креативна	Feminine
железната	Feminine
порцелан	None
раздиплила	Feminine
свеченото	Neuter
взаемна	Feminine
комплетна	Feminine
пофалете	None
бескрајните	None
поштуваа	None
оптимална	Feminine
јадат	None
домашен	Masculine
државната	Feminine
бунтот	None
вртела	Feminine
јавил	Masculine
навалуван	None
челенка	None
порочново	Neuter
издвоела	Feminine
благата	Feminine
присвоила	Feminine
законска	Feminine
пазарската	Feminine
потекло	Neuter
сферите	None
инвестира	None
менталното	Neuter
скинат	None
постмодерноно	Neuter
чешки	Masculine
праќала	Feminine
задавајќи	None
млечно	Neuter
филолошка	Feminine
искорнеше	None
разлутил	Masculine
цртање	None
рекламно	Neuter
постоеле	None
двосмислена	Feminine
постоиме	None
демократите	None
неважна	Feminine
естонски	Masculine
текилине	None
стигал	Masculine
дивиот	Masculine
биолошкиот	Masculine
физичка	Feminine
атентат	None
костенот	None
брегот	None
тромавите	None
ситниот	Masculine
авторитетон	None
зависниов	Masculine
напразно	Neuter
трпеливо	Neuter
предвидувал	Masculine
разнообразново	Neuter
задавал	Masculine
тамошното	Neuter
тревен	Masculine
постојаната	Feminine
секојдневниов	Masculine
географска	Feminine
заминало	Neuter
танцот	None
служела	Feminine
смешан	None
значејќи	None
фудбалска	Feminine
американската	Feminine
восочнана	Feminine
фиксирање	None
простата	Feminine
пијан	Masculine
првакот	None
честота	None
чајнава	Feminine
традиционалниот	Masculine
летал	Masculine
стабилниот	Masculine
југословенски	Masculine
погодија	None
тенкото	Neuter
метла	None
пропаднале	None
дерело	Neuter
стареел	Masculine
неодамнешениов	Masculine
настапувала	Feminine
архаична	Feminine
пропустлива	Feminine
хирурзи	None
виновен	Masculine
стресен	Masculine
изгледало	Neuter
мели	None
суштинското	Neuter
срцевата	Feminine
виновна	Feminine
поклопувале	None
килавоно	Neuter
ткаело	Neuter
испазарил	Masculine
настапил	Masculine
плати	None
безжичен	Masculine
заработувал	Masculine
научниот	Masculine
еднаква	Feminine
рударскиот	Masculine
извоз	None
раскина	None
нанесен	None
испитуваме	None
описна	Feminine
присилила	Feminine
ироничната	Feminine
пернав	None
насилен	Masculine
неелегантниов	Masculine
пресметка	None
снабдуваат	None
војување	None
полнач	None
живееја	None
населила	Feminine
пораснал	Masculine
рачната	Feminine
излегување	None
чешко	Neuter
геометрија	None
охрабрувавте	None
заклучил	Masculine
незгоднион	Masculine
влегувало	Neuter
малолетната	Feminine
коска	None
праведен	Masculine
последицата	None
забранувал	Masculine
водел	Masculine
наполнил	Masculine
мали	None
згрижеше	None
белодробната	Feminine
маснотиите	None
магарешкиот	Masculine
расно	Neuter
насочувал	Masculine
активното	Neuter
словенечка	Feminine
веродостоен	Masculine
глувава	Feminine
минатава	Feminine
реагирала	Feminine
честото	Neuter
навратат	None
кукавичкана	Feminine
изјавувале	None
погазил	Masculine
содржел	Masculine
учителки	None
количественион	Masculine
итниот	Masculine
археолошката	Feminine
складен	Masculine
кукавички	Masculine
ловците	None
одземајќи	None
стане	None
пронајдел	Masculine
покачат	None
своеглавиов	Masculine
автоматското	Neuter
проценил	Masculine
сериозноста	None
татковци	None
досаднана	Feminine
казнувал	Masculine
третата	Feminine
оковите	None
наизменичниот	Masculine
шатор	None
кравјиот	Masculine
произведат	None
подоцнежното	Neuter
распоредила	Feminine
максимална	Feminine
деловниот	Masculine
вентили	None
сегашно	Neuter
примитивнава	Feminine
првобитен	Masculine
замаглило	Neuter
пластично	Neuter
било	Neuter
мрежо	None
генијално	Neuter
ординацијата	None
турил	Masculine
настојувала	Feminine
покривала	Feminine
одвело	Neuter
потопил	Masculine
моркови	None
условната	Feminine
ѕенѕало	Neuter
шарм	None
потопила	Feminine
глупавава	Feminine
илузијава	None
истрелите	None
мускулна	Feminine
грбната	Feminine
пластична	Feminine
многубоштвото	None
инсекти	None
фонетско	Neuter
посебното	Neuter
вмешаа	None
засушило	Neuter
брцнав	None
зависниот	Masculine
реалистично	Neuter
перспективи	None
среќно	Neuter
непожелно	Neuter
нагостел	Masculine
излажало	Neuter
направел	Masculine
појаснувал	Masculine
јајценосниов	Masculine
моделираат	None
веслаше	None
љубознајна	Feminine
беќара	None
кутрата	Feminine
кинеската	Feminine
ситен	Masculine
мноштвото	None
чесната	Feminine
самоуверени	None
сликарството	None
несовршен	Masculine
британскиот	Masculine
ехидна	None
физиолошкото	Neuter
починел	Masculine
изразувало	Neuter
научило	Neuter
пројавил	Masculine
одлучна	Feminine
зимзелена	Feminine
психолошка	Feminine
животна	Feminine
далечни	None
оживеале	None
задала	Feminine
зимзелени	None
бразилски	Masculine
запоставил	Masculine
нечиста	Feminine
телефонскиот	Masculine
дискутирало	Neuter
прател	Masculine
уморно	Neuter
алчен	Masculine
смелите	None
меѓународниот	Masculine
разложува	None
муслиманскиот	Masculine
физиолошки	Masculine
обратнопропорционална	Feminine
сувомеснатион	Masculine
умреме	None
квасевме	None
опсесијава	None
лековитото	Neuter
требала	Feminine
крстил	Masculine
кројачка	Feminine
создавајте	None
пупава	None
скиселило	Neuter
карактеристичен	Masculine
јужното	Neuter
социјална	Feminine
царско	Neuter
попуштаат	None
влакнесто	Neuter
млечниот	Masculine
постепеното	Neuter
фармацевти	None
туристичкиот	Masculine
добоите	None
мрачната	Feminine
кловн	None
заговорници	None
гласното	Neuter
вкупната	Feminine
беспрекорното	Neuter
зборувало	Neuter
ограничената	Feminine
посебниот	Masculine
угушила	Feminine
високо	Neuter
лондонски	Masculine
пуштал	Masculine
груби	None
чинела	Feminine
плачел	Masculine
оправдувал	Masculine
нерамно	Neuter
бугарскион	Masculine
неудобниот	Masculine
чуло	Neuter
судскиот	Masculine
претпоследна	Feminine
добивала	Feminine
лабава	Feminine
птичјо	Neuter
старо	Neuter
осми	Masculine
таранава	None
образовниов	Masculine
немала	Feminine
опијанел	Masculine
плашеа	None
задржал	Masculine
византиско	Neuter
повеќестепена	Feminine
небитна	Feminine
претвориме	None
ризици	None
истекувал	Masculine
умирање	None
понижување	None
извесен	Masculine
звучело	Neuter
хранливиот	Masculine
одложив	None
незадоволително	Neuter
шушка	None
заградила	Feminine
суров	Masculine
билетарницата	None
листопадна	Feminine
усвоија	None
заменливо	Neuter
неформалнион	Masculine
отвораме	None
потчинета	Feminine
репризирал	Masculine
празната	Feminine
злобната	Feminine
грчко	Neuter
данско	Neuter
сметководството	None
обвиткувала	Feminine
кристален	Masculine
чилеанското	Neuter
природна	Feminine
уплашил	Masculine
маневрирање	None
величаа	None
образовно	Neuter
ефикаснион	Masculine
свирела	Feminine
симулација	None
пилиња	None
запишувала	Feminine
котлини	None
опустошила	Feminine
претепале	None
творечкион	Masculine
градините	None
овозможило	Neuter
делувала	Feminine
претставила	Feminine
осуденици	None
рамниот	Masculine
тантелите	None
доцната	Feminine
древното	Neuter
неправилните	None
соопштиле	None
логичен	Masculine
отсутниот	Masculine
прикачела	Feminine
скопската	Feminine
бизнисмен	None
граѓанки	None
стомачната	Feminine
челиста	None
мрзи	None
пукало	Neuter
егзотичнана	Feminine
потчинила	Feminine
потрај	None
подметнала	Feminine
си	None
програмо	None
монархиите	None
нацистичко	Neuter
деформиран	None
афиони	None
сама	Feminine
британско	Neuter
објасниле	None
врзал	Masculine
живописен	Masculine
личното	Neuter
завршувал	Masculine
изведуваат	None
копнеел	Masculine
ровка	None
покрил	Masculine
побелил	Masculine
вечно	Neuter
краткорочен	Masculine
плитка	Feminine
земјината	Feminine
срцево	Neuter
странското	Neuter
продажна	Feminine
престижното	Neuter
бобинкана	None
мекото	Neuter
пустош	None
искинал	Masculine
свирола	None
поддржала	Feminine
збрлавевме	None
птичји	Masculine
кимала	Feminine
полуголана	Feminine
конопот	None
дополнително	Neuter
лажниот	Masculine
достигнаа	None
изборниот	Masculine
сложила	Feminine
мјузиклу	None
одговорни	None
постојаното	Neuter
бајатана	Feminine
хетерогеново	Neuter
распнев	None
места	None
светската	Feminine
израснев	None
актуелните	None
олесните	None
мрачна	Feminine
вкусен	Masculine
малолетнички	None
нагризело	Neuter
текнувал	Masculine
денешен	Masculine
прекинал	Masculine
земајќи	None
сорта	None
пламнело	Neuter
именски	Masculine
комплетирање	None
отмена	Feminine
дофрлил	Masculine
бессилниов	Masculine
варијацијата	None
општественото	Neuter
оригинално	Neuter
извела	Feminine
седнуваат	None
шепнал	Masculine
наредило	Neuter
врнежлива	Feminine
наврати	None
привлечност	None
основната	Feminine
поврзало	Neuter
поклопуваат	None
крута	Feminine
формулата	None
ѓаволскана	Feminine
бистрата	Feminine
одвои	None
разјаснуваат	None
психопат	None
гинеколошката	Feminine
чудесниот	Masculine
дигитален	Masculine
сивана	Feminine
измерил	Masculine
допиело	Neuter
старомодниов	Masculine
јавните	None
поттикнало	Neuter
размислат	None
караш	None
земјин	Masculine
дигал	Masculine
квалитетно	Neuter
употребило	Neuter
успеете	None
преобратила	Feminine
денешниот	Masculine
горам	None
минералното	Neuter
канибалот	None
непропустливоно	Neuter
оддалечувал	Masculine
привлекла	Feminine
лузна	None
расен	Masculine
ангелски	Masculine
слушне	None
необично	Neuter
честата	Feminine
јагнешка	Feminine
уживала	Feminine
повторило	Neuter
повредуваат	None
сеприсутни	None
почетниот	Masculine
словенечкото	Neuter
шведскиот	Masculine
ништожно	Neuter
нормативно	Neuter
комунистички	Masculine
промашен	None
некултурноно	Neuter
истекла	Feminine
реткана	Feminine
архаично	Neuter
пречело	Neuter
пријатен	Masculine
рекламиран	None
темелна	Feminine
наводното	Neuter
одговорно	Neuter
споредбениот	Masculine
поларен	Masculine
тригодишните	None
хранела	Feminine
изнајмат	None
самиот	Masculine
богатствата	None
макате	None
оставивме	None
здрав	Masculine
плима	None
одложило	Neuter
архитектонската	Feminine
временско	Neuter
невестинско	Neuter
грозјето	None
пијаното	Neuter
куќиштето	None
видливиот	Masculine
миел	Masculine
минувало	Neuter
птичја	Feminine
шведското	Neuter
планинското	Neuter
слично	Neuter
домашно	Neuter
забележителната	Feminine
оригиналното	Neuter
влијаел	Masculine
цареви	None
пародирало	Neuter
италијанската	Feminine
одрекувал	Masculine
лимонов	None
невидливо	Neuter
раскрвавило	Neuter
лебедовата	Feminine
практичнине	None
скокале	None
љубимото	Neuter
испечатил	Masculine
качува	None
магнетска	Feminine
истава	Feminine
суштествено	Neuter
поплавил	Masculine
кусиот	Masculine
неограниченото	Neuter
реагирајќи	None
онтолошки	Masculine
битот	None
саделе	None
дејствувала	Feminine
сфаќаш	None
белките	None
жалосно	Neuter
впечатливиот	Masculine
взаемната	Feminine
претпоследниов	Masculine
пораните	None
напаѓала	Feminine
скитал	Masculine
психолошкиов	Masculine
преубедела	Feminine
долгава	Feminine
присилив	None
забрзувал	Masculine
вешта	Feminine
скапоценоно	Neuter
небесно	Neuter
социјални	None
граѓанска	Feminine
деветта	Feminine
лактозата	None
збрлавивте	None
рамноправна	Feminine
поматила	Feminine
воочливава	Feminine
изрезбарил	Masculine
крајно	Neuter
разговарал	Masculine
смолине	None
раскостат	None
патолошко	Neuter
врачува	None
муслиманско	Neuter
подробно	Neuter
бугарско	Neuter
успеел	Masculine
понудил	Masculine
срушил	Masculine
сложеното	Neuter
непроценливиот	Masculine
вдахнала	Feminine
искористи	None
поврзувале	None
сквернавела	Feminine
наглата	Feminine
литвански	Masculine
белка	None
забележал	Masculine
расположено	Neuter
читање	None
напредувало	Neuter
отсликувала	Feminine
посебно	Neuter
сопствениот	Masculine
откинел	Masculine
конци	None
мисла	None
заварување	None
неплоден	Masculine
небесното	Neuter
свечено	Neuter
изборнана	Feminine
готов	Masculine
мускулест	Masculine
мачела	Feminine
комисии	None
разоткриете	None
разрушила	Feminine
четириаголна	Feminine
лута	Feminine
разоткрил	Masculine
мотики	None
будалестата	Feminine
завршило	Neuter
лоша	Feminine
збуневте	None
пукнал	Masculine
удави	None
карпо	None
срамежливиот	Masculine
подозриво	Neuter
свилна	Feminine
обработил	Masculine
закана	None
двојниот	Masculine
одвоиле	None
загушил	Masculine
издадоа	None
седнало	Neuter
потопа	None
загубило	Neuter
амбициозно	Neuter
дискретна	Feminine
оловнана	Feminine
малолетно	Neuter
едноклеточниот	Masculine
досадувал	Masculine
толкувачи	None
несоодветниот	Masculine
јавила	Feminine
безимен	Masculine
рангираат	None
болниот	Masculine
ветувања	None
надминало	Neuter
исечел	Masculine
предизвикувале	None
неизлечливата	Feminine
идеал	None
комична	Feminine
домашна	Feminine
качувале	None
изигра	None
ограничувајќи	None
правиот	Masculine
празно	Neuter
пијаници	None
сиже	None
плаќало	Neuter
банкротирал	Masculine
норвешко	Neuter
стварало	Neuter
тежнеел	Masculine
жлезда	None
додатниот	Masculine
послужила	Feminine
вработевте	None
филолошкиов	Masculine
запрегнавте	None
ирски	Masculine
круто	Neuter
налагал	Masculine
кратково	Neuter
простодушново	Neuter
цврста	Feminine
банкротираше	None
седнал	Masculine
терапиите	None
автономијата	None
нерамна	Feminine
гумено	Neuter
натумпанела	Feminine
стварно	Neuter
уролошка	Feminine
сензори	None
безвласното	Neuter
искажала	Feminine
надворешна	Feminine
сметководствово	None
афричко	Neuter
спречувала	Feminine
вчерашниов	Masculine
пребоел	Masculine
примитивна	Feminine
мрзливата	Feminine
игра	None
хомосексуално	Neuter
шиптарскиот	Masculine
посмртната	Feminine
неделниот	Masculine
наизменично	Neuter
изразила	Feminine
сексуалното	Neuter
божјиот	Masculine
одземал	Masculine
изнеле	None
прва	Feminine
мирната	Feminine
прелистувачов	None
немоќна	Feminine
древен	Masculine
заљубениот	Masculine
штетната	Feminine
пропаднал	Masculine
месниот	Masculine
продолжетокот	None
рикал	Masculine
необработена	Feminine
влезел	Masculine
симболизирало	Neuter
екскреторниот	Masculine
агол	None
забораван	None
сакало	Neuter
грабнатата	Feminine
згрешил	Masculine
преврзавме	None
беспомошна	Feminine
убедила	Feminine
лабавоно	Neuter
зрнесто	Neuter
оживеал	Masculine
улично	Neuter
одлучила	Feminine
здравата	Feminine
достигнев	None
рамнодушниот	Masculine
шаблони	None
жолтиот	Masculine
овозможила	Feminine
протона	None
психичката	Feminine
поучно	Neuter
менувачине	None
шарено	Neuter
планско	Neuter
полупречници	None
овошно	Neuter
интернетската	Feminine
современиот	Masculine
розевите	None
поклониците	None
пружал	Masculine
спроведувала	Feminine
спогодба	None
транспонирање	None
сваќа	None
потпадна	None
наврапитово	Neuter
освојувал	Masculine
оладија	None
внатрешна	Feminine
бактерии	None
градиш	None
безволно	Neuter
впиело	Neuter
шкотската	Feminine
сварат	None
обединувал	Masculine
дробело	Neuter
грбни	None
карактеризираат	None
возможно	Neuter
претворил	Masculine
своерачно	Neuter
чешкиот	Masculine
фунта	None
ножната	Feminine
шармантнава	Feminine
одминел	Masculine
бесцелните	None
жива	Feminine
опседнал	Masculine
избрало	Neuter
погодила	Feminine
подвижно	Neuter
покојната	Feminine
качувајќи	None
раскажувал	Masculine
повратниот	Masculine
пријателско	Neuter
староседелец	None
балетското	Neuter
верска	Feminine
бојкотираше	None
зоолошката	Feminine
зафаќало	Neuter
засадел	Masculine
погребела	Feminine
минималнана	Feminine
малтоза	None
изградело	Neuter
природната	Feminine
словенската	Feminine
побожна	Feminine
златниот	Masculine
неприродност	None
ѕвездениот	Masculine
фашистичката	Feminine
грбнава	Feminine
запомнете	None
математички	Masculine
научил	Masculine
наканила	Feminine
постмодерно	Neuter
коњскиот	Masculine
надминал	Masculine
продажново	Neuter
детиште	None
влошувањево	None
искажало	Neuter
црковниот	Masculine
бивша	Feminine
сеопшта	Feminine
отежнувала	Feminine
исфалела	Feminine
хранливата	Feminine
безмилосен	Masculine
пишал	Masculine
мирољубивата	Feminine
поднесувал	Masculine
диктирала	Feminine
германска	Feminine
реткиот	Masculine
соседства	None
судското	Neuter
ненормално	Neuter
безопасно	Neuter
недокваканата	Feminine
споро	Neuter
важело	Neuter
љубоморниот	Masculine
неразделноно	Neuter
железното	Neuter
компатибилно	Neuter
грдо	Neuter
дочеку	None
неоргансконо	Neuter
алергичната	Feminine
крикет	None
населува	None
драгоценово	Neuter
реалниов	Masculine
запросило	Neuter
временскион	Masculine
истоветно	Neuter
поставуваа	None
спротивната	Feminine
дворскиот	Masculine
користело	Neuter
избил	Masculine
идеолошките	None
забележително	Neuter
стипендии	None
целиот	Masculine
квантитет	None
преместило	Neuter
грнчарската	Feminine
Црногорцине	None
достапната	Feminine
астматичарките	None
шпанско	Neuter
истребувала	Feminine
апчиња	None
оловно	Neuter
нечистите	None
џентлменов	None
афрички	Masculine
јавен	Masculine
завчерашноно	Neuter
киднел	Masculine
неподвижен	Masculine
мотоцикла	None
тонел	Masculine
идеолошконо	Neuter
вратија	None
депресија	None
коњаника	None
варирало	Neuter
порничиве	None
мирниот	Masculine
ракописното	Neuter
клиниките	None
капиталистичкото	Neuter
избегнал	Masculine
мускулеста	Feminine
неправедната	Feminine
чувај	None
зафатени	None
кочница	None
сафира	None
прифатил	Masculine
лири	None
тесното	Neuter
инекција	None
кирилична	Feminine
исплакнел	Masculine
фети	None
ангажирајќи	None
пренело	Neuter
легендарното	Neuter
реона	None
напишеме	None
гонела	Feminine
лесна	Feminine
структурниот	Masculine
излет	None
пружило	Neuter
блазонирање	None
наследни	None
прераскажело	Neuter
лингвистиката	None
самостојниот	Masculine
вртлозиве	None
крстење	None
меѓународно	Neuter
патријархално	Neuter
пристигнало	Neuter
пуст	Masculine
ковала	Feminine
преноќевала	Feminine
опивал	Masculine
образувал	Masculine
првобитно	Neuter
наредново	Neuter
патријархалната	Feminine
покојноно	Neuter
полудувале	None
обратнопропорционалново	Neuter
ирско	Neuter
стоела	Feminine
здрава	Feminine
неверојатна	Feminine
безгрешна	Feminine
присутна	Feminine
еластичната	Feminine
еколошка	Feminine
шармантно	Neuter
уличен	Masculine
добронамернион	Masculine
поседи	None
бујните	None
диши	None
војникот	None
геноми	None
награди	None
подарила	Feminine
галеријата	None
екватор	None
подзатвореле	None
раскажување	None
составев	None
третиран	None
единствената	Feminine
менталниот	Masculine
метеоролошката	Feminine
рашират	None
месечното	Neuter
светлото	Neuter
ирска	Feminine
појаснил	Masculine
глумен	None
докторската	Feminine
земјоделската	Feminine
бесконечна	Feminine
крзна	None
катедрите	None
печатноно	Neuter
течниот	Masculine
органскион	Masculine
вперен	None
невообичаено	Neuter
вајарство	None
учел	Masculine
воздушното	Neuter
броел	Masculine
облог	None
цврстата	Feminine
кротка	Feminine
напишеш	None
разновидниот	Masculine
раскажувала	Feminine
громогласно	Neuter
свилното	Neuter
проштален	Masculine
исправново	Neuter
калуѓерки	None
млечнава	Feminine
умствено	Neuter
неморален	Masculine
босонога	Feminine
простодушно	Neuter
израснаа	None
пасивноно	Neuter
дејствата	None
снабдувала	Feminine
неограничениот	Masculine
анатомски	Masculine
чистосрдечното	Neuter
облози	None
безгрешно	Neuter
значајното	Neuter
искривил	Masculine
излегле	None
деловно	Neuter
внатрешноно	Neuter
обработило	Neuter
проследеле	None
чавка	None
рунтавион	Masculine
црното	Neuter
малолетна	Feminine
кривичен	Masculine
сочно	Neuter
проблематичното	Neuter
малечкиот	Masculine
елкана	None
тресок	None
интимната	Feminine
поробен	None
еколошката	Feminine
глупион	Masculine
неморалнана	Feminine
ангина	None
избувни	None
капиталистички	Masculine
конечноно	Neuter
пријателската	Feminine
износам	None
актуелната	Feminine
прозборат	None
прсти	None
жилав	Masculine
ќелав	Masculine
јазол	None
вжештен	None
дречлива	Feminine
превод	None
помошна	Feminine
целулоза	None
малоумниот	Masculine
бавна	Feminine
решил	Masculine
татковото	Neuter
предбрачен	Masculine
измил	Masculine
лекоумното	Neuter
одбранбено	Neuter
поранешно	Neuter
растеглив	Masculine
дајте	None
изработил	Masculine
решила	Feminine
кревале	None
решителната	Feminine
непожелен	Masculine
поединечниот	Masculine
важното	Neuter
домородец	None
проверка	None
чачнавме	None
убедија	None
скромниот	Masculine
омажиш	None
стапици	None
езерата	None
жлебови	None
надоградило	Neuter
сончева	Feminine
лудило	None
исекла	Feminine
сочинувал	Masculine
излажела	Feminine
достоинственото	Neuter
наредното	Neuter
филолошки	Masculine
америчкото	Neuter
војните	None
непристрасна	Feminine
оптимален	Masculine
безбедни	None
обилен	Masculine
загрозувајќи	None
пресна	Feminine
училишната	Feminine
рогата	Feminine
влашкото	Neuter
бамбусот	None
докторско	Neuter
изгнило	Neuter
истоштеност	None
вирусните	None
значителноста	None
втората	Feminine
одбивале	None
вештиот	Masculine
неформалното	Neuter
суштествен	Masculine
некултурното	Neuter
обединила	Feminine
неразделниов	Masculine
суредило	Neuter
подржала	Feminine
посетил	Masculine
пригодна	Feminine
порача	None
лаку	None
селанката	None
различното	Neuter
недостижниов	Masculine
итриот	Masculine
блиските	None
расрдевте	None
незадоволно	Neuter
посвоел	Masculine
бради	None
грчкана	Feminine
католици	None
исушат	None
дејностите	None
рекламната	Feminine
умртвела	Feminine
недостижен	Masculine
скрати	None
повеќекратниов	Masculine
петгодишната	Feminine
сретнала	Feminine
конфискува	None
јарешкиов	Masculine
кренала	Feminine
активираат	None
ракописно	Neuter
лондонскиот	Masculine
бездомната	Feminine
сурова	Feminine
формулите	None
кралско	Neuter
карфиоли	None
претходно	Neuter
животински	Masculine
добротворен	Masculine
мачната	Feminine
соодветен	Masculine
белодробниот	Masculine
калливите	None
можната	Feminine
несреќнана	Feminine
примерна	Feminine
невролошки	Masculine
насилнава	Feminine
недостојна	Feminine
хлор	None
полезна	Feminine
хранливото	Neuter
пријавила	Feminine
значајната	Feminine
неутралната	Feminine
стомнава	None
дошла	Feminine
дерматолошки	Masculine
концептот	None
предложете	None
третираат	None
сладок	Masculine
квалитетниот	Masculine
спречи	None
примамливана	Feminine
оперирал	Masculine
гнасен	Masculine
тренд	None
неелегантнине	None
користеше	None
угледен	Masculine
паѓал	Masculine
предвидеше	None
огладнувал	Masculine
неразумни	None
белиот	Masculine
фокусирало	Neuter
клекнал	Masculine
монашката	Feminine
ушниот	Masculine
тркалезнава	Feminine
закачува	None
канцелариските	None
долното	Neuter
организираше	None
барокниот	Masculine
пост	None
сочинувало	Neuter
коритата	None
фашизмот	None
мрсулавиот	Masculine
валкана	Feminine
тврдата	Feminine
богаташите	None
претресе	None
џитнал	Masculine
малечок	Masculine
позеленуваат	None
волнен	Masculine
азискиот	Masculine
вегетаријанска	Feminine
недоразбирање	None
уникатното	Neuter
мелодиите	None
спротивна	Feminine
тужел	Masculine
великодушнава	Feminine
пораснало	Neuter
внимателното	Neuter
осмата	Feminine
капсуливе	None
налививе	None
хокеариве	None
ручање	None
осмо	Neuter
тринаесетгодишен	Masculine
сестринскава	Feminine
хранат	None
мртвиот	Masculine
ограничат	None
техничкиот	Masculine
квалитетна	Feminine
подвижен	Masculine
споредно	Neuter
умерен	Masculine
грабнатите	None
прекитил	Masculine
телефонирало	Neuter
гладниот	Masculine
писмено	Neuter
запеала	Feminine
изведуван	None
стерилна	Feminine
ножнана	Feminine
грациозен	Masculine
ѕидал	Masculine
нормативниот	Masculine
вечерал	Masculine
сиромашноно	Neuter
учителски	Masculine
како	None
лажеш	None
непроменливиот	Masculine
разнообразноно	Neuter
стара	Feminine
колеле	None
намалила	Feminine
дводневна	Feminine
замислил	Masculine
покажала	Feminine
сторил	Masculine
тан	None
премија	None
измениле	None
огромно	Neuter
понела	Feminine
прекрасноно	Neuter
драгоцениов	Masculine
зимува	None
меланхолична	Feminine
пофална	Feminine
бледата	Feminine
неуредново	Neuter
изнајмен	None
беџови	None
избувливана	Feminine
вкупно	Neuter
потврдило	Neuter
разликувала	Feminine
замрзнала	Feminine
мрднатиов	Masculine
починал	Masculine
занаетчии	None
потребно	Neuter
струјни	None
последичниот	Masculine
израмнило	Neuter
југословенско	Neuter
избувнала	Feminine
белетристика	None
настапуваат	None
преведување	None
поворки	None
печеле	None
преносната	Feminine
вдомувал	Masculine
гласала	Feminine
католички	Masculine
месна	Feminine
неопходната	Feminine
шпекулираа	None
прогресивен	Masculine
завладеало	Neuter
пазарски	Masculine
бескрајниот	Masculine
прагматика	None
ана	None
апстрактна	Feminine
засенил	Masculine
константите	None
влегувал	Masculine
бурните	None
меѓучовечкото	Neuter
фрлачи	None
преработил	Masculine
отворен	Masculine
објавило	Neuter
итната	Feminine
легендарниот	Masculine
неверојатен	Masculine
чуваат	None
логично	Neuter
проценила	Feminine
комичната	Feminine
смалеа	None
земјина	Feminine
ропскион	Masculine
досетлива	Feminine
железно	Neuter
раситните	None
истражувал	Masculine
посвоила	Feminine
повремен	Masculine
еврејска	Feminine
побожен	Masculine
тивко	Neuter
војувале	None
отфрлил	Masculine
телепатски	Masculine
биолошко	Neuter
Украинка	None
искористија	None
обиколен	Masculine
бледово	Neuter
задушил	Masculine
тврда	Feminine
опашот	None
лупнал	Masculine
наследниот	Masculine
утрешната	Feminine
заден	Masculine
потребната	Feminine
агенциите	None
пролог	None
смирила	Feminine
следело	Neuter
обложил	Masculine
манџијана	None
лижневме	None
догребеле	None
пасивно	Neuter
приметил	Masculine
простете	None
дувало	Neuter
луксузниов	Masculine
смртоносната	Feminine
смеело	Neuter
набљудувала	Feminine
вредно	Neuter
меѓуѕвездената	Feminine
предложило	Neuter
издржал	Masculine
распишал	Masculine
волната	Feminine
програмер	None
службениот	Masculine
волнено	Neuter
доброволниот	Masculine
показателите	None
конкретен	Masculine
меѓународен	Masculine
проба	None
змијата	None
златото	None
склоното	Neuter
зеницава	None
главно	Neuter
чилеански	Masculine
мечка	None
недохранетион	Masculine
автоматски	Masculine
позајмува	None
гневното	Neuter
наострил	Masculine
мотивациите	None
српското	Neuter
пророчка	Feminine
повеќегодишново	Neuter
осамена	Feminine
разбрала	Feminine
сфаќањата	None
безимена	Feminine
ушни	None
сексизам	None
ножот	None
канцелариското	Neuter
загубите	None
конкретна	Feminine
пресретливоно	Neuter
стројнана	Feminine
левата	Feminine
јавниот	Masculine
предизвикување	None
скапоценана	Feminine
пропуштал	Masculine
загрозувала	Feminine
помагало	Neuter
свинското	Neuter
постмодерната	Feminine
средната	Feminine
накалемел	Masculine
анална	Feminine
капело	Neuter
проблематичниот	Masculine
трнлива	Feminine
фонтана	None
земјоделско	Neuter
алова	Feminine
завивај	None
спознавте	None
манифестирала	Feminine
ефективна	Feminine
работничкиот	Masculine
избричат	None
подвижното	Neuter
берзи	None
промовирал	Masculine
клеточен	Masculine
настојувало	Neuter
украинската	Feminine
вториот	Masculine
грбен	Masculine
утрината	None
семејниот	Masculine
меѓународните	None
броело	Neuter
илустриран	None
наркоманите	None
шестоно	Neuter
крвнички	Masculine
паничното	Neuter
фашистички	Masculine
неверојатните	None
јаден	Masculine
дискретен	Masculine
воскреснал	Masculine
стерилно	Neuter
ладнокрвниов	Masculine
подмирија	None
услова	None
повлечел	Masculine
вегетацијата	None
фраерска	Feminine
спомнале	None
забоболка	None
очигледната	Feminine
распуштеното	Neuter
закрпам	None
потпаднала	Feminine
конкурирал	Masculine
католичката	Feminine
брдо	None
уништувал	Masculine
стапнал	Masculine
разрешување	None
возможнана	Feminine
доградело	Neuter
свинско	Neuter
незгодна	Feminine
деленик	None
формален	Masculine
украсувале	None
сеприсутно	Neuter
момата	None
повлекла	Feminine
хаотично	Neuter
вредниот	Masculine
блеснал	Masculine
пливачки	Masculine
реткоста	None
флертува	None
анонимен	Masculine
зготвела	Feminine
камен	Masculine
раширил	Masculine
нормален	Masculine
посветил	Masculine
неграциознана	Feminine
бронхија	None
кожен	Masculine
светел	Masculine
навикнал	Masculine
почетната	Feminine
исправите	None
централна	Feminine
раскошниот	Masculine
согласен	Masculine
охриѓаниве	None
занаетчиите	None
слушала	Feminine
следново	Neuter
пливала	Feminine
нужен	Masculine
денешнава	Feminine
изборен	Masculine
изгледаше	None
Босанци	None
бакнал	Masculine
поразил	Masculine
азиска	Feminine
опфаќала	Feminine
обработливото	Neuter
робување	None
физичката	Feminine
растеа	None
потемни	None
книжевната	Feminine
осрамотиле	None
секојдневен	Masculine
шпекулациите	None
унгарската	Feminine
уредно	Neuter
пријатно	Neuter
дворската	Feminine
пуши	None
грабливци	None
правно	Neuter
осветлела	Feminine
унгарскиот	Masculine
наметнала	Feminine
привлекувал	Masculine
тамошните	None
коскеното	Neuter
нељубезниов	Masculine
стилистика	None
болежливиов	Masculine
недоволната	Feminine
кандидирал	Masculine
премиите	None
обоила	Feminine
широко	Neuter
детинест	Masculine
спонтан	Masculine
исчисти	None
догмечила	Feminine
копајќи	None
настроеноно	Neuter
неблагородниот	Masculine
колковите	None
застанал	Masculine
кастрирала	Feminine
охрабрил	Masculine
паметен	Masculine
стрчевме	None
свечен	Masculine
телевизиската	Feminine
едноставно	Neuter
лукав	Masculine
долгиот	Masculine
утринското	Neuter
покажаа	None
благородното	Neuter
маската	None
рерна	None
генерализираат	None
целокупна	Feminine
орадине	None
разбиран	None
религиозен	Masculine
пипки	None
белорускиот	Masculine
пројавиле	None
научната	Feminine
постоело	Neuter
ненадеен	Masculine
гледиштето	None
гимнастиката	None
жилава	Feminine
Швеѓанецот	None
закупеле	None
магнетен	Masculine
пофалите	None
барокната	Feminine
беспрекорен	Masculine
чувствуваме	None
кликнало	Neuter
привремено	Neuter
фашистичкиве	None
љубљанската	Feminine
непријатниот	Masculine
дефинитивна	Feminine
верската	Feminine
животинското	Neuter
имала	Feminine
незаменлив	Masculine
неверојатниот	Masculine
пилотскион	Masculine
лабораторискион	Masculine
образовново	Neuter
запознав	None
приоритет	None
водена	Feminine
пурпурната	Feminine
подводново	Neuter
бурињата	None
агресивна	Feminine
стоевте	None
суровото	Neuter
наградил	Masculine
терале	None
велосипеди	None
народниот	Masculine
подметнале	None
ножново	Neuter
современ	Masculine
робо	None
горделивана	Feminine
заиграле	None
поткрепела	Feminine
бодликаво	Neuter
пријатната	Feminine
држеа	None
вториов	Masculine
амерички	Masculine
оцрнила	Feminine
православна	Feminine
разбере	None
сондиран	None
активен	Masculine
очекувала	Feminine
навредувал	Masculine
стресно	Neuter
бистар	Masculine
изеде	None
одминал	Masculine
морскиот	Masculine
горчлив	Masculine
привлечните	None
бисерен	Masculine
комбинираат	None
диското	None
земаат	None
невообичаеното	Neuter
товарен	Masculine
истоветниот	Masculine
идел	Masculine
сликовит	Masculine
сребрени	None
собноно	Neuter
проектов	None
насамарам	None
посетата	None
вторична	Feminine
надворешнион	Masculine
плачливиот	Masculine
компјутерското	Neuter
волкот	None
страшна	Feminine
проучел	Masculine
ораме	None
растегнело	Neuter
средношколски	Masculine
отпорна	Feminine
илјадити	Masculine
соочувало	Neuter
истото	Neuter
бесплатната	Feminine
врзувал	Masculine
меѓучовечка	Feminine
алтернативи	None
отстапувал	Masculine
конзервативен	Masculine
спремевте	None
независниот	Masculine
грмеле	None
замка	None
изникнел	Masculine
израснало	Neuter
трудољубивиот	Masculine
бојкотирало	Neuter
љубовно	Neuter
бегаме	None
реагирало	Neuter
самана	Feminine
закускине	None
ќелава	Feminine
батеријата	None
чесен	Masculine
издавачи	None
наполнила	Feminine
наоѓала	Feminine
белото	Neuter
легендарна	Feminine
ужасната	Feminine
параноичариве	None
досаден	Masculine
загинала	Feminine
вријат	None
отфрлала	Feminine
дозволило	Neuter
хомогеното	Neuter
свртен	None
езерцето	None
слаткарница	None
верско	Neuter
пропише	None
куклено	Neuter
двојна	Feminine
незнабошци	None
џиновската	Feminine
доверлив	Masculine
правоаголна	Feminine
заклучував	None
благословил	Masculine
старовремско	Neuter
комбе	None
истакнатиов	Masculine
непожелна	Feminine
мрсноно	Neuter
неуреднава	Feminine
наместил	Masculine
минливо	Neuter
сплетело	Neuter
содржи	None
куклениот	Masculine
ќелавата	Feminine
дигитално	Neuter
измислениот	Masculine
хрватските	None
несмасен	Masculine
одредиле	None
забранила	Feminine
ветровите	None
ѕвездено	Neuter
забарската	Feminine
висела	Feminine
зависните	None
хаотичното	Neuter
одвоило	Neuter
палел	Masculine
тенок	Masculine
репризиран	None
споредба	None
суштински	Masculine
објавам	None
измерат	None
цвеќариве	None
братската	Feminine
зимско	Neuter
драг	Masculine
формална	Feminine
денешната	Feminine
лековерното	Neuter
горела	Feminine
лупнел	Masculine
официјална	Feminine
ефективно	Neuter
одобрело	Neuter
крала	None
одобрија	None
хромот	None
напнат	Masculine
советувале	None
прасечки	Masculine
вртел	Masculine
образовано	Neuter
подвижниот	Masculine
папка	None
архитектонскиот	Masculine
метеоролошка	Feminine
челенката	None
открие	None
попречувале	None
необичен	Masculine
метален	Masculine
судење	None
предвремената	Feminine
љубовџискава	Feminine
месечен	Masculine
оженат	None
обесправен	None
зајдел	Masculine
издробела	Feminine
виолетовион	Masculine
рангирајте	None
опасниот	Masculine
розевиот	Masculine
ефикасната	Feminine
наследил	Masculine
достигнува	None
лижнело	Neuter
третите	None
квалитативниот	Masculine
правилново	Neuter
марихуано	None
фудбалски	Masculine
доверливо	Neuter
семка	None
недостижнана	Feminine
поучен	Masculine
деветтото	Neuter
половично	Neuter
злонамерна	Feminine
паралелнава	Feminine
ветил	Masculine
фината	Feminine
волчиот	Masculine
комуникативна	Feminine
образован	Masculine
романтични	None
карпите	None
геномине	None
побегнале	None
природно	Neuter
мозочен	Masculine
сафири	None
утврдувал	Masculine
блесавиов	Masculine
потврдувал	Masculine
оладен	None
стихозбирките	None
укажувало	Neuter
теолошка	Feminine
атмосферскиот	Masculine
запечатевме	None
осетлива	Feminine
сјајно	Neuter
јанабџијава	None
смачкувала	Feminine
фантастичните	None
промислен	Masculine
средила	Feminine
послужило	Neuter
попиздете	None
несовршенана	Feminine
боледувал	Masculine
коњските	None
промовирала	Feminine
доставиле	None
нарекувајќи	None
откинат	None
вадел	Masculine
неподвижна	Feminine
спортскана	Feminine
скромно	Neuter
геолози	None
левото	Neuter
објавив	None
човечки	Masculine
мајчина	Feminine
тажен	Masculine
белоруското	Neuter
благословување	None
пурпурен	Masculine
огромниот	Masculine
шампионите	None
велигденска	Feminine
вечерната	Feminine
грбно	Neuter
разбирав	None
поела	Feminine
скопскиот	Masculine
стрмнион	Masculine
тетовската	Feminine
изедначуваат	None
достоинствена	Feminine
настроени	None
осудил	Masculine
претпоследната	Feminine
љубљанскиот	Masculine
плина	None
налудничавиот	Masculine
петтини	None
ласана	None
веродостојно	Neuter
бесчувствителен	Masculine
практичниот	Masculine
црногорскиот	Masculine
одблесоци	None
запирка	None
изострил	Masculine
закачен	None
биолошки	Masculine
живо	Neuter
челична	Feminine
манијјава	None
неодговорно	Neuter
русокосата	Feminine
убедило	Neuter
полетај	None
шетал	Masculine
колвал	Masculine
механичка	Feminine
навлезело	Neuter
забарскава	Feminine
тивката	Feminine
бугарското	Neuter
венчала	Feminine
паднав	None
отворало	Neuter
мазна	Feminine
образованава	Feminine
стаклоно	None
боксер	None
авторитетно	Neuter
кубело	Neuter
шират	None
брачното	Neuter
светскиот	Masculine
непристрасно	Neuter
утринската	Feminine
запеј	None
единственово	Neuter
инженер	None
точнине	None
одделило	Neuter
скај	None
проѕирна	Feminine
собирала	Feminine
здогледуваат	None
напреднеше	None
безгрижното	Neuter
распнал	Masculine
прикрило	Neuter
приближната	Feminine
сопствен	Masculine
интелигентен	Masculine
одговорила	Feminine
смрдливото	Neuter
појдовната	Feminine
љубовниот	Masculine
млечната	Feminine
старогрчкиот	Masculine
зависно	Neuter
симнала	Feminine
занемарел	Masculine
астролошка	Feminine
допушела	Feminine
витканото	Neuter
Хрват	None
ранет	None
депресивното	Neuter
измислен	Masculine
физиолошка	Feminine
предложив	None
повредил	Masculine
возрасната	Feminine
удирајќи	None
спремаат	None
десеттата	Feminine
еп	None
скарано	Neuter
презимињата	None
дехидрирала	Feminine
ерменскиот	Masculine
тропска	Feminine
внимавајте	None
турел	Masculine
Украинец	None
покажувала	Feminine
сочувството	None
техничко	Neuter
вредната	Feminine
видливата	Feminine
фараонот	None
претставите	None
уметничкана	None
прозрачна	Feminine
кус	Masculine
престанала	Feminine
газлестана	Feminine
огномет	None
означите	None
неспособнион	Masculine
чудовишноно	Neuter
отцепил	Masculine
чудна	Feminine
распуштил	Masculine
пронашло	Neuter
виола	None
опремила	Feminine
водело	Neuter
спречило	Neuter
проблематична	Feminine
добредојдено	Neuter
презел	Masculine
засенила	Feminine
пишуваше	None
шпоретот	None
инзакупивме	None
улична	Feminine
сенилност	None
југозападен	Masculine
избрал	Masculine
атомски	Masculine
божја	Feminine
надменине	None
скршил	Masculine
световни	None
отворив	None
трепери	None
косела	Feminine
рекламниот	Masculine
лансира	None
носачине	None
карневали	None
месечната	Feminine
немири	None
љубезноста	None
смешливава	Feminine
морски	Masculine
неопростливото	Neuter
привлечен	Masculine
битниот	Masculine
спонтаното	Neuter
олеснило	Neuter
селска	Feminine
полупречникот	None
иглолисните	None
втор	Masculine
ружа	None
добротворните	None
бунтовна	Feminine
плодниот	Masculine
припаднало	Neuter
приземниот	Masculine
релативново	Neuter
убила	Feminine
залепат	None
неизбежноста	None
калливо	Neuter
колосална	Feminine
умнион	Masculine
лековитион	Masculine
зграпчи	None
утврдила	Feminine
печатно	Neuter
подметнал	Masculine
надмоќниот	Masculine
комплетнине	None
решавале	None
патриотската	Feminine
наковална	None
фалење	None
куќиште	None
задоволителен	Masculine
проповедајќи	None
ќелави	None
очната	Feminine
помислете	None
мирна	Feminine
книжевниот	Masculine
произвело	Neuter
умерените	None
порочниов	Masculine
речна	Feminine
бујна	Feminine
светскава	Feminine
дизајнерката	None
вообразениот	Masculine
клучното	Neuter
идеали	None
употребила	Feminine
зборовниот	Masculine
личен	Masculine
адекватна	Feminine
заостриле	None
етнолошкииов	Masculine
издробел	Masculine
римскиот	Masculine
задниот	Masculine
известувал	Masculine
ќелавана	Feminine
згрутчувала	Feminine
останувала	Feminine
пукнатината	None
флотите	None
нервни	None
парабродот	None
упростил	Masculine
мозочната	Feminine
поврзал	Masculine
напредната	Feminine
бесниот	Masculine
запленил	Masculine
непоколебливо	Neuter
трнливово	Neuter
погазело	Neuter
мозочниот	Masculine
заживеала	Feminine
страшната	Feminine
разварил	Masculine
доживеала	Feminine
примерен	Masculine
беспрекорно	Neuter
обесценела	Feminine
внимавај	None
држите	None
грозна	Feminine
годишниот	Masculine
влажен	Masculine
Украинке	None
грав	None
склопил	Masculine
следнава	Feminine
судницата	None
нестабилна	Feminine
царската	Feminine
отпишел	Masculine
последователното	Neuter
собно	Neuter
заборавиме	None
тренерска	Feminine
платнената	Feminine
еднолично	Neuter
течело	Neuter
рударското	Neuter
полнела	Feminine
вонбрачно	Neuter
престапи	None
обѕирното	Neuter
растопело	Neuter
безначајно	Neuter
здравото	Neuter
потчинетиот	Masculine
кошаркарска	Feminine
допирање	None
поранешен	Masculine
зимски	Masculine
најмило	Neuter
спомнуваат	None
дупчалкиве	None
грбавеца	None
избришам	None
наебело	Neuter
џем	None
испаднала	Feminine
поделби	None
старечка	Feminine
карал	Masculine
сфаќате	None
направило	Neuter
душевната	Feminine
посвоеникон	None
необичното	Neuter
недостасуваа	None
зграпчило	Neuter
слободното	Neuter
просела	Feminine
кажувал	Masculine
веш	None
канцелариски	Masculine
сакавме	None
речен	Masculine
агрегатна	Feminine
умен	Masculine
заверка	None
одделите	None
тек	None
теоретска	Feminine
потсетат	None
употребил	Masculine
купило	Neuter
печурките	None
мимолетново	Neuter
средувам	None
цигански	Masculine
невролошка	Feminine
кило	None
крукчиња	None
странско	Neuter
подмолно	Neuter
прогресивното	Neuter
спортскиот	Masculine
формирајќи	None
саатчијана	None
велевте	None
усовршувала	Feminine
роденденската	Feminine
еколошки	Masculine
тон	None
зафатил	Masculine
каллив	Masculine
свинска	Feminine
складната	Feminine
предзнак	None
еднакво	Neuter
проповедала	Feminine
полските	None
моќен	Masculine
ангажирај	None
има	None
јаремот	None
опаснине	None
балканска	Feminine
вегетаријански	Masculine
сториш	None
типичен	Masculine
идеолошка	Feminine
заробеник	None
знаела	Feminine
кристално	Neuter
онесвестела	Feminine
поставило	Neuter
згужваш	None
разбирате	None
влашкиот	Masculine
запирки	None
средновековното	Neuter
галерии	None
нарекување	None
виолетовиот	Masculine
пожолти	None
половово	Neuter
праг	None
ушната	Feminine
погрешно	Neuter
памучна	Feminine
затворал	Masculine
заменила	Feminine
среќни	None
мрчело	Neuter
летен	Masculine
подала	Feminine
носителите	None
охридски	Masculine
оптималната	Feminine
поработиме	None
бистра	Feminine
бранител	None
штетно	Neuter
скопско	Neuter
другарсконо	Neuter
крива	Feminine
изгласаме	None
гитарист	None
огромен	Masculine
застапувал	Masculine
дозволувало	Neuter
алкохоличари	None
првичниот	Masculine
фонетска	Feminine
безопасна	Feminine
собарка	None
изгасел	Masculine
користела	Feminine
речник	None
кривичниот	Masculine
престолонаследник	None
забило	Neuter
одговорното	Neuter
смешното	Neuter
бесконечната	Feminine
нема	Feminine
непроценливо	Neuter
превозно	Neuter
бесплатно	Neuter
памучното	Neuter
дополнителен	Masculine
мртвото	Neuter
помогнало	Neuter
подобрија	None
подоцнежно	Neuter
наизменична	Feminine
мерење	None
шитнала	Feminine
образовал	Masculine
тегла	None
зависното	Neuter
уличниот	Masculine
турнеа	None
косел	Masculine
нервна	Feminine
шие	None
српскиот	Masculine
шанкер	None
буквалниот	Masculine
излечил	Masculine
траела	Feminine
телесната	Feminine
тромава	Feminine
мазната	Feminine
босанско	Neuter
основнава	Feminine
засилил	Masculine
металниот	Masculine
издржлива	Feminine
спровел	Masculine
гол	Masculine
вошливиов	Masculine
плиток	Masculine
оловен	Masculine
трговскиот	Masculine
расположена	Feminine
загризел	Masculine
холандскиот	Masculine
наивниот	Masculine
бреговите	None
морфолошките	None
изолацијата	None
измисленото	Neuter
можела	Feminine
длабокиот	Masculine
посветиме	None
слободен	Masculine
повлеченото	Neuter
истовремената	Feminine
тренерски	Masculine
виолетовата	Feminine
извадила	Feminine
скапата	Feminine
сврзната	Feminine
љубам	None
запишете	None
алкохолната	Feminine
нагласил	Masculine
шкотска	Feminine
пропаѓал	Masculine
значела	Feminine
географското	Neuter
разделила	Feminine
горно	Neuter
потонале	None
добродетел	None
вик	None
дефинитивен	Masculine
полагала	Feminine
компјутерски	Masculine
наставничка	None
одвикнеа	None
зеленикавион	Masculine
конечниот	Masculine
дружел	Masculine
лижавчиња	None
литванскана	Feminine
актуелен	Masculine
идеалниот	Masculine
прашување	None
државен	Masculine
слушнала	Feminine
слатководна	Feminine
уличнава	Feminine
изгасија	None
деветтата	Feminine
летно	Neuter
разменувал	Masculine
нездрав	Masculine
диетална	Feminine
водоотпорната	Feminine
дозволи	None
кенгури	None
јаболкова	Feminine
должно	Neuter
подбуцнала	Feminine
новороден	Masculine
уморниот	Masculine
примило	Neuter
оревокршачкиве	None
чуден	Masculine
непропорционалново	Neuter
погрешното	Neuter
минатото	Neuter
демонстрирала	Feminine
споредуваме	None
пристапиме	None
избувнува	None
замрзнел	Masculine
наминавте	None
архаичната	Feminine
сиромашниот	Masculine
неуспешнана	Feminine
усмртил	Masculine
чешково	Neuter
месестине	None
илустрираме	None
аналната	Feminine
навлегле	None
длабоката	Feminine
црвена	Feminine
зоолошка	Feminine
фраерсконо	Neuter
умереното	Neuter
безбојноно	Neuter
побегнала	Feminine
прост	Masculine
понудила	Feminine
црниот	Masculine
заедничкиот	Masculine
затворило	Neuter
нарекло	Neuter
неприродно	Neuter
цистерната	None
овековечил	Masculine
изненадило	Neuter
постигнала	Feminine
сончевото	Neuter
пријавил	Masculine
променила	Feminine
ѓаволско	Neuter
опременост	None
црепната	None
дискретната	Feminine
див	Masculine
обезбедил	Masculine
сведочел	Masculine
стабилна	Feminine
реткото	Neuter
повратела	Feminine
испаднал	Masculine
симетричнава	Feminine
еластични	None
усмртело	Neuter
недоличново	Neuter
изеден	None
православниот	Masculine
второто	Neuter
вторичен	Masculine
сточарство	None
распуштен	Masculine
опфатила	Feminine
запрепастував	None
мачкара	None
вечерен	Masculine
литванскине	None
занимавала	Feminine
лента	None
прикаски	None
стапнала	Feminine
осветило	Neuter
љубопитни	None
недоволна	Feminine
растеретило	Neuter
јасни	None
влегла	Feminine
враќала	Feminine
суштинскиот	Masculine
бразилското	Neuter
збунило	Neuter
уверува	None
преувеличување	None
расчленел	Masculine
неприфатливо	Neuter
оригинала	None
збунуваат	None
украсувал	Masculine
утринскиот	Masculine
ѕверското	Neuter
цицо	None
фудбалската	Feminine
само	Neuter
напнеше	None
преобразува	None
првичен	Masculine
седумнаесетгодишна	Feminine
братско	Neuter
запаливо	Neuter
открила	Feminine
мек	Masculine
тропскиот	Masculine
соперништвово	None
рецитира	None
секта	None
ѕвонело	Neuter
заострила	Feminine
гневна	Feminine
главниот	Masculine
изиграјте	None
пазарната	Feminine
дејствуваа	None
ретка	Feminine
пропуштило	Neuter
повлекувало	Neuter
статиите	None
трогнала	Feminine
анализирање	None
апсолутниот	Masculine
внимавал	Masculine
предложуваат	None
забрзувавте	None
носталгијата	None
попладневна	Feminine
поддржувал	Masculine
накапевме	None
пренесел	Masculine
утврдило	Neuter
длабело	Neuter
пронајдоа	None
четиригодишна	Feminine
отсвирел	Masculine
воочлив	Masculine
посевите	None
срцевиот	Masculine
наведеме	None
тенката	Feminine
споредувал	Masculine
особена	Feminine
садел	Masculine
физичките	None
кадрав	Masculine
одолевала	Feminine
зазело	Neuter
логична	Feminine
догмечеа	None
незгоден	Masculine
створило	Neuter
доминира	None
непријатната	Feminine
деленикот	None
шведската	Feminine
идентитети	None
согласнава	Feminine
непокор	None
чајна	Feminine
истоштен	Masculine
добата	None
крикетот	None
половичен	Masculine
климатско	Neuter
геолошкиот	Masculine
органско	Neuter
американските	None
немо	Neuter
честица	None
замолчи	None
клучен	Masculine
сфаќал	Masculine
чардака	None
интерпункцијата	None
пропуштен	None
фрлала	Feminine
неелегантниот	Masculine
тенкиот	Masculine
манастирите	None
праведниов	Masculine
натераале	None
хетерогена	Feminine
дизајнери	None
раскошно	Neuter
археологот	None
основачи	None
астролошкиот	Masculine
благородната	Feminine
зафаќал	Masculine
фиоките	None
дански	Masculine
продолжиле	None
американска	Feminine
желна	Feminine
скалиште	None
боцнавте	None
тужеа	None
истакнување	None
гледала	Feminine
избувлив	Masculine
прометна	Feminine
поларниот	Masculine
гмечела	Feminine
вештачки	Masculine
карактеристичното	Neuter
жртвувајќи	None
курвинсково	Neuter
описот	None
гнасни	None
врнежливион	Masculine
подмолен	Masculine
бистро	Neuter
долготрајно	Neuter
побараа	None
преценело	Neuter
адекватно	Neuter
своерачен	Masculine
русокос	Masculine
затемнивме	None
наградувал	Masculine
спаѓал	Masculine
готвачката	None
ветеринарската	Feminine
поединечното	Neuter
наглув	Masculine
сечејќи	None
одбранил	Masculine
нишки	None
стварното	Neuter
средновековно	Neuter
претставничка	None
розевана	Feminine
велел	Masculine
загадило	Neuter
телевизискана	Feminine
приближно	Neuter
складна	Feminine
промовирајте	None
дадеме	None
довлечкаше	None
лепел	Masculine
отсликан	None
бактериски	Masculine
опишувала	Feminine
тенковите	None
комплетното	Neuter
пречека	None
подоцнежна	Feminine
стотка	None
термити	None
муслимански	Masculine
паѓала	Feminine
одржала	Feminine
преправила	Feminine
измислил	Masculine
потонала	Feminine
анален	Masculine
неважни	None
совршена	Feminine
преоден	Masculine
религиозна	Feminine
раси	None
британска	Feminine
свечените	None
подобрила	Feminine
поставувавме	None
силиконот	None
врвела	Feminine
сиви	None
дојка	None
совршен	Masculine
гриз	None
итрана	Feminine
присутни	None
стриконо	None
вградувал	Masculine
карактеристично	Neuter
елегантното	Neuter
допираат	None
генијална	Feminine
северозападното	Neuter
козјо	Neuter
итар	Masculine
забележливо	Neuter
затегнал	Masculine
добивало	Neuter
холандска	Feminine
бандоглавава	Feminine
азиската	Feminine
населувала	Feminine
озбилно	Neuter
мозочно	Neuter
отшрафило	Neuter
ферментиран	None
зимзелената	Feminine
традиционално	Neuter
старечки	Masculine
наврнете	None
полов	Masculine
сликовито	Neuter
огорчен	Masculine
предизвикувало	Neuter
добротворна	Feminine
губела	Feminine
островски	Masculine
рекламна	Feminine
префарбате	None
предложил	Masculine
донираат	None
четириаголен	Masculine
безвласнион	Masculine
образованиот	Masculine
раболепнион	Masculine
пребродување	None
филозофската	Feminine
пот	None
извадел	Masculine
дополнителниот	Masculine
земало	Neuter
патувала	Feminine
среќен	Masculine
испаднат	None
ограничена	Feminine
намами	None
циганската	Feminine
осудувало	Neuter
петката	None
населеници	None
човечкиот	Masculine
сонливи	None
бришел	Masculine
грчката	Feminine
одобрувал	Masculine
задолжителниот	Masculine
наивно	Neuter
злобно	Neuter
основан	None
многубројната	Feminine
достигнувам	None
општествен	Masculine
проповедам	None
македонски	Masculine
бомбардирала	Feminine
стилска	Feminine
распоредил	Masculine
воспитувале	None
сонило	Neuter
испратило	Neuter
ќос	Masculine
надградби	None
услужна	Feminine
белата	Feminine
раскршила	Feminine
молекуларните	None
лутиче	None
споредбените	None
пронајдов	None
мекост	None
правилното	Neuter
раскажувало	Neuter
кусата	Feminine
сошивте	None
врнежливо	Neuter
скудно	Neuter
применувало	Neuter
конечни	None
гребенон	None
арогантен	Masculine
уверил	Masculine
измерило	Neuter
матурирал	Masculine
лавовско	Neuter
запалива	Feminine
кулену	None
меѓуѕвезденоно	Neuter
арапската	Feminine
вонбрачната	Feminine
фашистичкиот	Masculine
истражуван	None
надлежната	Feminine
изводливана	Feminine
конкретната	Feminine
белодробна	Feminine
торба	None
силна	Feminine
смешните	None
вообичаено	Neuter
утврдуваат	None
тенко	Neuter
ментално	Neuter
уреден	Masculine
асоцира	None
перница	None
отсликаат	None
етички	Masculine
јадел	Masculine
градски	Masculine
терминологија	None
облачно	Neuter
гласно	Neuter
климатската	Feminine
подводното	Neuter
неудобно	Neuter
толкувал	Masculine
седмо	Neuter
заработи	None
северница	None
наседнете	None
убивме	None
дружељубивиов	Masculine
одделно	Neuter
снел	Masculine
успешен	Masculine
платнена	Feminine
остроумен	Masculine
ладилникот	None
подводен	Masculine
родителскиов	Masculine
сојузнициве	None
неправилен	Masculine
будната	Feminine
мумифициравме	None
грлици	None
прекинувајте	None
мала	Feminine
избегнало	Neuter
миленициве	None
робинките	None
пишував	None
неподвижната	Feminine
основајќи	None
возела	Feminine
малтретирал	Masculine
уникатен	Masculine
релативен	Masculine
вродена	Feminine
творел	Masculine
сериозно	Neuter
кривоверство	None
легендарни	None
семејното	Neuter
обожавам	None
мачно	Neuter
саго	None
стаса	None
загадочниот	Masculine
настанок	None
објаснувавме	None
кривата	Feminine
привлечат	None
зашиете	None
облакодерите	None
задржувала	Feminine
горенаведената	Feminine
четврти	Masculine
глува	Feminine
прекршила	Feminine
шепотев	None
заминувал	Masculine
плаќала	Feminine
опнал	Masculine
влошат	None
актуелно	Neuter
декларирал	Masculine
копнеело	Neuter
скопскион	Masculine
порекнуваш	None
стрелите	None
белодробен	Masculine
гробиштата	None
растопела	Feminine
исто	Neuter
влошен	None
стариот	Masculine
финските	None
романско	Neuter
наречеме	None
тепал	Masculine
прашална	Feminine
напреднал	Masculine
избирало	Neuter
витезот	None
аналните	None
предала	Feminine
фрлал	Masculine
изневерува	None
проценуваат	None
божјата	Feminine
златното	Neuter
надминувал	Masculine
кобно	Neuter
живороден	Masculine
’рѓосувала	Feminine
разгатнаа	None
поставувал	Masculine
збил	Masculine
учествувал	Masculine
драга	Feminine
механичкиот	Masculine
видете	None
јагнешкион	Masculine
краткотрајниот	Masculine
срамно	Neuter
операторката	None
суетна	Feminine
деклариран	None
покачил	Masculine
анатомскиов	Masculine
сестрана	Feminine
сиромашен	Masculine
округли	None
маскенбалов	None
напорниот	Masculine
бисерната	Feminine
избричил	Masculine
негирал	Masculine
иглолисни	None
скинал	Masculine
словачка	Feminine
живописната	Feminine
зафатениот	Masculine
одличната	Feminine
законското	Neuter
безначаен	Masculine
совесно	Neuter
ослабнало	Neuter
трагична	Feminine
ставил	Masculine
посебна	Feminine
привикнам	None
усовршила	Feminine
изливи	None
чекаат	None
надигра	None
неуредниот	Masculine
воочливо	Neuter
настрадаш	None
империите	None
средам	None
моќниот	Masculine
буби	None
приредување	None
површен	Masculine
грчки	Masculine
крут	Masculine
полицајкава	None
вкусно	Neuter
влегувајќи	None
имал	Masculine
мешало	Neuter
устана	None
опуштен	Masculine
песни	None
комплициран	Masculine
зачленил	Masculine
забиела	Feminine
идеалното	Neuter
родителската	Feminine
дедовскиов	Masculine
сомнениено	None
прилагодила	Feminine
откупнина	None
мирољубиво	Neuter
неиздржливи	None
селела	Feminine
монголски	Masculine
сочуваме	None
историска	Feminine
хронолошки	Masculine
силувам	None
плодноно	Neuter
продлабочувавте	None
усвоила	Feminine
кисели	None
русокоси	None
зачините	None
тежела	Feminine
волови	None
значел	Masculine
татково	Neuter
влакнеста	Feminine
принудила	Feminine
обилниот	Masculine
светски	Masculine
југоисток	None
гитарата	None
освојувала	Feminine
сештојади	None
прифатиш	None
тивкиот	Masculine
припишан	None
бабичката	None
приватен	Masculine
земала	Feminine
изгубил	Masculine
идентичен	Masculine
тужела	Feminine
агресивно	Neuter
островскиот	Masculine
откријте	None
непромислен	Masculine
традициите	None
архиепископине	None
долгорочното	Neuter
самоуверена	Feminine
воочил	Masculine
специјалниот	Masculine
корејсково	Neuter
раздвоиле	None
грешниот	Masculine
тропајќи	None
безобѕирниов	Masculine
смените	None
усовршувал	Masculine
сина	Feminine
лизгавиов	Masculine
промовирало	Neuter
болежлив	Masculine
мајмунче	None
физичкото	Neuter
портокалово	Neuter
проблематично	Neuter
занимливо	Neuter
догмечиме	None
поништувал	Masculine
препуциуми	None
пружете	None
вметнало	Neuter
човечка	Feminine
заслужел	Masculine
рангирал	Masculine
мугри	None
разумен	Masculine
висок	Masculine
краткиот	Masculine
менувала	Feminine
ѕвонела	Feminine
подучувал	Masculine
сегашното	Neuter
етничкава	Feminine
српскохрватскиот	Masculine
секојдневното	Neuter
евтаназија	None
дијамантската	Feminine
минерално	Neuter
воздушно	Neuter
испраќан	None
пчелар	None
пишала	Feminine
магичниот	Masculine
несреќниот	Masculine
неверојатната	Feminine
четвртото	Neuter
пластичната	Feminine
дресовите	None
ќебапа	None
помислила	Feminine
дотурила	Feminine
хемиското	Neuter
стекнувала	Feminine
математичкото	Neuter
формалното	Neuter
пакосниов	Masculine
возрасното	Neuter
свежо	Neuter
филозофијата	None
неудобен	Masculine
зачнала	Feminine
Циганите	None
декларира	None
делотворноно	Neuter
просечно	Neuter
мислел	Masculine
покојна	Feminine
љубен	Masculine
остроумно	Neuter
крастава	Feminine
праведниот	Masculine
средновековен	Masculine
јаки	None
безбедносниот	Masculine
ослободувал	Masculine
присилил	Masculine
светли	None
среќавало	Neuter
накривуваше	None
листа	None
пријатнион	Masculine
натажел	Masculine
наврапита	Feminine
нареден	Masculine
женкарска	Feminine
шеснаесетгодишно	Neuter
современа	Feminine
надгледувал	Masculine
невротична	Feminine
рамно	Neuter
слободнана	Feminine
лековитите	None
секира	None
запрегнал	Masculine
авторитетна	Feminine
палми	None
канцелариската	Feminine
стерилнион	Masculine
матното	Neuter
сунѓерестото	Neuter
довел	Masculine
галии	None
настапуваа	None
диктатори	None
велела	Feminine
ловец	None
готват	None
додал	Masculine
гледаш	None
широките	None
пуштајќи	None
предвидат	None
создавал	Masculine
арапско	Neuter
зимска	Feminine
криво	Neuter
топлата	Feminine
избегнел	Masculine
грузискиот	Masculine
вонреден	Masculine
патријархална	Feminine
расипано	Neuter
законскиот	Masculine
неизвесно	Neuter
видео	None
газлестион	Masculine
портретите	None
населило	Neuter
напуштила	Feminine
летна	Feminine
еластична	Feminine
успиваше	None
наследното	Neuter
љубим	Masculine
продажно	Neuter
омекнавте	None
изминам	None
владеат	None
леплив	Masculine
графикон	None
пулсирало	Neuter
преземи	None
држела	Feminine
преувеличил	Masculine
полована	Feminine
запамети	None
древно	Neuter
наврапит	Masculine
стотиот	Masculine
повеќекратен	Masculine
култовите	None
поетско	Neuter
камшикување	None
искомплицира	None
дебело	Neuter
метнал	Masculine
беспрекорнана	Feminine
ѕвезденото	Neuter
скокови	None
изводливо	Neuter
вирусот	None
афродизијак	None
сети	None
малакса	None
запаметат	None
напаѓал	Masculine
големо	Neuter
проблематичен	Masculine
количествениот	Masculine
пурпурнана	Feminine
мачешкото	Neuter
уредил	Masculine
автоматскиот	Masculine
пазарско	Neuter
задржувал	Masculine
мјаукал	Masculine
изнајмил	Masculine
одмагала	Feminine
тензииве	None
побегнало	Neuter
соблекувална	None
отровници	None
пробив	None
наметнало	Neuter
личел	Masculine
гумен	Masculine
решителен	Masculine
комунистичкава	Feminine
одело	Neuter
прекитела	Feminine
непристојна	Feminine
првото	Neuter
дробнана	Feminine
чул	Masculine
чувствителен	Masculine
потекла	Feminine
бриши	None
успеало	Neuter
осмислил	Masculine
запнела	Feminine
малото	Neuter
перничиња	None
медитации	None
глупав	Masculine
простото	Neuter
битно	Neuter
вешти	None
поединечнана	Feminine
поканила	Feminine
астролошки	Masculine
славел	Masculine
мравјалници	None
растурило	Neuter
интимно	Neuter
кожна	Feminine
вредела	Feminine
меѓусебното	Neuter
претпочитал	Masculine
официјално	Neuter
следното	Neuter
масакрирале	None
неми	None
проклета	Feminine
несоодветно	Neuter
соблечев	None
откорнела	Feminine
обратно	Neuter
шумски	Masculine
сувоземна	Feminine
јавувала	Feminine
привлекло	Neuter
шупливо	Neuter
блиски	None
стоело	Neuter
харингата	None
простодушен	Masculine
дваесетидвегодишната	Feminine
соблазниле	None
едноставен	Masculine
слабо	Neuter
пронашла	Feminine
дигнавте	None
глупо	Neuter
шуплив	Masculine
обновувал	Masculine
лупавте	None
милостива	Feminine
временскиот	Masculine
ставила	Feminine
горна	Feminine
школско	Neuter
настојувал	Masculine
утврдување	None
среднион	Masculine
избиев	None
спазми	None
едногласно	Neuter
комплицирана	Feminine
пресуди	None
латиничен	Masculine
уживале	None
речното	Neuter
погрешен	Masculine
закачувате	None
косион	Masculine
школското	Neuter
молекуларно	Neuter
преведувал	Masculine
летната	Feminine
бисерно	Neuter
фотокопирале	None
кревал	Masculine
хомосексуална	Feminine
кафено	Neuter
подозривата	Feminine
почетник	None
губел	Masculine
искуси	None
верување	None
завчерашен	Masculine
заборавило	Neuter
таинствена	Feminine
преживеала	Feminine
коњушници	None
дефинирала	Feminine
банкари	None
безвучен	Masculine
стабилен	Masculine
бесшумново	Neuter
бесцелно	Neuter
денешна	Feminine
теоретски	Masculine
срамежливите	None
безначајна	Feminine
розовиот	Masculine
ползело	Neuter
шкотското	Neuter
дејствувајќи	None
анализирајќи	None
склононо	Neuter
шашава	Feminine
покривот	None
мекиот	Masculine
лижавчињата	None
избувнел	Masculine
мистериозно	Neuter
вратник	None
слаба	Feminine
холограми	None
дождалците	None
водиме	None
петтиот	Masculine
ослободувајте	None
причините	None
средновековна	Feminine
трагичната	Feminine
доверил	Masculine
градел	Masculine
древната	Feminine
стрижење	None
виси	None
темелново	Neuter
пристрасен	Masculine
настанала	Feminine
миротворецот	None
исфрлила	Feminine
фонолошкиот	Masculine
правниот	Masculine
брановитана	Feminine
чувствителните	None
препорачувало	Neuter
злиот	Masculine
гугала	Feminine
поетскиот	Masculine
женствениов	Masculine
долгнавесто	Neuter
дрвениот	Masculine
контролирала	Feminine
зеленилото	None
пукале	None
свеченион	Masculine
штетни	None
одбивен	Masculine
поројнана	Feminine
кодексот	None
должен	Masculine
материјално	Neuter
одредел	Masculine
исклучил	Masculine
штетнана	Feminine
изјавило	Neuter
половиот	Masculine
мокра	Feminine
едногодишна	Feminine
седел	Masculine
обликувал	Masculine
припишува	None
безделенана	Feminine
чудотворна	Feminine
блиската	Feminine
македонска	Feminine
охридско	Neuter
напуштил	Masculine
врачен	None
пасивен	Masculine
достигнувал	Masculine
шупливите	None
студениот	Masculine
вешто	Neuter
вообразенава	Feminine
експериментирал	Masculine
кловновската	Feminine
првобитното	Neuter
изјавува	None
цитирало	Neuter
темен	Masculine
стаклена	Feminine
јавнион	Masculine
витко	Neuter
отстранило	Neuter
непознато	Neuter
протоци	None
качела	Feminine
фудбалерот	None
несвесното	Neuter
зглоби	None
училишно	Neuter
традиционалното	Neuter
повлечен	Masculine
советува	None
самоуверенана	Feminine
ладнокрвни	None
непреоден	Masculine
етичкиот	Masculine
верно	Neuter
беспредметен	Masculine
полукруг	None
кошаркарски	Masculine
докажал	Masculine
вложил	Masculine
ѕвоно	None
забранило	Neuter
портокалова	Feminine
делотворен	Masculine
подлактица	None
вандалска	Feminine
отмени	None
потпросечниов	Masculine
прецизната	Feminine
претпоставувало	Neuter
разјаснува	None
смеел	Masculine
некомпатибилниот	Masculine
суштественине	None
неподвижно	Neuter
исклучувала	Feminine
годишна	Feminine
алергичен	Masculine
учело	Neuter
смешлив	Masculine
лежело	Neuter
подготвил	Masculine
вроденото	Neuter
разговорен	Masculine
капетан	None
сликовити	None
јазичното	Neuter
бурниов	Masculine
потврдувало	Neuter
доминантниот	Masculine
латвиската	Feminine
нерастворлива	Feminine
прочитате	None
најмен	None
румена	Feminine
остроумноно	Neuter
благородново	Neuter
штетен	Masculine
грозен	Masculine
ефективната	Feminine
составнана	Feminine
омилениот	Masculine
лебдел	Masculine
интернационален	Masculine
навредуваше	None
необработениот	Masculine
малолетниот	Masculine
стресни	None
амбициозниот	Masculine
фашистичко	Neuter
десниот	Masculine
завидува	None
ниското	Neuter
пазарно	Neuter
нервозниот	Masculine
продадел	Masculine
чекора	None
ковал	Masculine
теолошката	Feminine
ебаното	Neuter
вечнава	Feminine
невообичаен	Masculine
незнаењето	None
ќелавиот	Masculine
маса	None
пушење	None
набавеле	None
надживеј	None
еластичниов	Masculine
корејското	Neuter
безвредно	Neuter
небесниов	Masculine
расцепел	Masculine
валканиот	Masculine
бесконечен	Masculine
семејно	Neuter
дипломираше	None
зграпчат	None
мирољубив	Masculine
виновно	Neuter
преносен	Masculine
ограничувало	Neuter
модерното	Neuter
исечат	None
заменуваме	None
чинело	Neuter
сочинувала	Feminine
засебната	Feminine
Бугарке	None
одличен	Masculine
наслонувало	Neuter
прехранбена	Feminine
именската	Feminine
кивнете	None
спроведување	None
шпекулираше	None
изустело	Neuter
озлогласениот	Masculine
пасивна	Feminine
ладното	Neuter
црногорската	Feminine
актуелниот	Masculine
невозможната	Feminine
напредна	Feminine
народнана	Feminine
антилопи	None
базени	None
смален	None
полетале	None
подземна	Feminine
претставувал	Masculine
топлиов	Masculine
одвлекoл	Masculine
северозападниот	Masculine
третман	None
распарчило	Neuter
бунтовноно	Neuter
државниот	Masculine
главо	None
сочуваат	None
идентичната	Feminine
ергенско	Neuter
четиригодишно	Neuter
глаголското	Neuter
полезен	Masculine
бере	None
џелати	None
безобѕирно	Neuter
докажувајќи	None
ублажила	Feminine
бакарното	Neuter
подобрен	None
постмодерното	Neuter
борачот	None
обработливи	None
студирал	Masculine
мекала	Feminine
осигуран	None
добредојден	Masculine
губи	None
гневниот	Masculine
аморфен	Masculine
сирова	Feminine
кожната	Feminine
избувнал	Masculine
кафулињата	None
пишувал	Masculine
југоисточнана	Feminine
благиот	Masculine
прекрасниот	Masculine
филозофска	Feminine
министерката	None
идеолошко	Neuter
вечниот	Masculine
каллива	Feminine
истрелот	None
дождалецов	None
хемиско	Neuter
лабораториска	Feminine
прашуми	None
оригинална	Feminine
грофицата	None
можело	Neuter
укажувала	Feminine
стоплил	Masculine
ликвидира	None
капсула	None
ќурки	None
разоружила	Feminine
активната	Feminine
охридскиот	Masculine
додатните	None
интелигентниот	Masculine
островската	Feminine
принудил	Masculine
мршавава	Feminine
густ	Masculine
пишуваа	None
свеж	Masculine
дедо	None
блиското	Neuter
борбен	Masculine
соединете	None
обратното	Neuter
складирав	None
дигиталниот	Masculine
личела	Feminine
деталните	None
метел	Masculine
женствената	Feminine
округлата	Feminine
смртната	Feminine
оревокршачкине	None
обезбедувал	Masculine
лесното	Neuter
рано	Neuter
законитана	Feminine
десеттото	Neuter
префрлал	Masculine
капиталистичко	Neuter
жанровски	Masculine
сложиле	None
крстопат	None
чекало	Neuter
балетска	Feminine
насочило	Neuter
обединиле	None
отстрани	None
сакал	Masculine
префрлен	None
избила	Feminine
австралиски	Masculine
привлечело	Neuter
добротворната	Feminine
зависна	Feminine
рефлексите	None
убило	Neuter
микроскопската	Feminine
терал	Masculine
култ	None
полнат	None
омаловажувал	Masculine
признала	Feminine
закажал	Masculine
интернационалното	Neuter
неправилната	Feminine
манифестирало	Neuter
потписите	None
данска	Feminine
коскениот	Masculine
боцкавион	Masculine
влошувало	Neuter
шпионка	None
клекнела	Feminine
последниот	Masculine
борбена	Feminine
куциот	Masculine
кафен	Masculine
средновековново	Neuter
гласачи	None
став	None
жолтеникав	Masculine
чворови	None
свирепо	Neuter
убиствената	Feminine
предавала	Feminine
подигнала	Feminine
безболно	Neuter
душевна	Feminine
неприродна	Feminine
овошјето	None
одразила	Feminine
одличното	Neuter
забавното	Neuter
норвешка	Feminine
младото	Neuter
златна	Feminine
отворено	Neuter
источно	Neuter
итна	Feminine
слепило	None
чистана	Feminine
белодробните	None
исчезнал	Masculine
отфрлал	Masculine
нагости	None
развијам	None
финансиското	Neuter
примитивната	Feminine
префрливме	None
неподвижниот	Masculine
битен	Masculine
минималното	Neuter
психичка	Feminine
гарнизон	None
делумен	Masculine
паднал	Masculine
крцнаа	None
одобрила	Feminine
слатка	Feminine
колонизирал	Masculine
одгатнете	None
накодошил	Masculine
останало	Neuter
извинувањето	None
сместило	Neuter
умствената	Feminine
наплатела	Feminine
подржат	None
покажал	Masculine
медениот	Masculine
гудало	None
лемур	None
лопати	None
финското	Neuter
непоколеблива	Feminine
згодниот	Masculine
очекувало	Neuter
поткрепел	Masculine
триаголен	Masculine
смреки	None
хиперболана	None
типичното	Neuter
темпераментната	Feminine
електрично	Neuter
настојчивово	Neuter
скала	None
издадел	Masculine
сториле	None
дивтаров	None
средил	Masculine
косини	None
крпење	None
поставела	Feminine
развил	Masculine
писмен	Masculine
осквернела	Feminine
сочувства	None
чистиот	Masculine
заслужил	Masculine
сливата	None
сестраното	Neuter
суштинско	Neuter
готвел	Masculine
остварувал	Masculine
испраќала	Feminine
филозофски	Masculine
тринаесетгодишна	Feminine
почитуваат	None
чистата	Feminine
чудотворнава	Feminine
дозволил	Masculine
чудесната	Feminine
впечатливата	Feminine
крстителот	None
побуните	None
рачното	Neuter
опцуел	Masculine
седела	Feminine
јапонско	Neuter
верната	Feminine
завршувале	None
подучел	Masculine
неменлив	Masculine
мократ	None
мајчин	Masculine
неправилно	Neuter
напише	None
изложил	Masculine
пача	None
задржуваат	None
наговорел	Masculine
исквачило	Neuter
опсада	None
долго	Neuter
утрешниот	Masculine
метело	Neuter
кимал	Masculine
внукот	None
верувал	Masculine
затвореникот	None
советувалиштево	None
дводневнава	Feminine
пишам	None
куц	Masculine
разореа	None
безживотното	Neuter
безжична	Feminine
комичарот	None
плашен	None
куќишта	None
структурна	Feminine
лавовски	Masculine
саксијата	None
старана	Feminine
значенска	Feminine
суровата	Feminine
пораневме	None
командувала	Feminine
гладен	Masculine
лакот	None
неразумнана	Feminine
наредниов	Masculine
злонамерен	Masculine
максималното	Neuter
белодробното	Neuter
ласкав	None
свињарникот	None
љубопитното	Neuter
световно	Neuter
мештани	None
продолжил	Masculine
атмосферското	Neuter
наводен	Masculine
преплашевте	None
докторскиот	Masculine
снашла	Feminine
тигрест	Masculine
куќно	Neuter
прекумерен	Masculine
јунакот	None
товарниот	Masculine
скелетон	None
поништил	Masculine
проучило	Neuter
неодговорен	Masculine
непроменливата	Feminine
применувала	Feminine
формално	Neuter
острата	Feminine
велигденската	Feminine
одгледувало	Neuter
казниво	Neuter
брачниот	Masculine
ниската	Feminine
елегии	None
обилна	Feminine
регулирал	Masculine
азбучно	Neuter
озборувало	Neuter
потопуван	None
бокс	None
модели	None
плеснел	Masculine
штетното	Neuter
проучен	None
запознае	None
спасила	Feminine
есенски	Masculine
пуста	Feminine
граѓанската	Feminine
ограничувањето	None
царскиот	Masculine
карактеризирајќи	None
откажал	Masculine
безбедно	Neuter
манекенки	None
сопственото	Neuter
подземнана	Feminine
строгиот	Masculine
преодниов	Masculine
косо	Neuter
силно	Neuter
гладно	Neuter
широк	Masculine
патријархалните	None
осумнаесетгодишниот	Masculine
саркастичнана	Feminine
внатрешен	Masculine
испуштав	None
вознемирувало	Neuter
усната	Feminine
соедини	None
лансирал	Masculine
претрпила	Feminine
наштетило	Neuter
нарекла	Feminine
преместила	Feminine
спремна	Feminine
учествува	None
трајното	Neuter
килограм	None
фин	Masculine
каубоецот	None
изразуваа	None
прекрасната	Feminine
самовилското	Neuter
недостиг	None
одобрил	Masculine
одразувала	Feminine
усложни	None
руса	Feminine
железен	Masculine
издало	Neuter
гостољубиво	Neuter
низок	Masculine
растворил	Masculine
пристрасниов	Masculine
мазно	Neuter
питома	Feminine
триаголнион	Masculine
чачневме	None
нервното	Neuter
душкал	Masculine
молитвеник	None
пресушило	Neuter
теоретското	Neuter
тврдоглавана	Feminine
снаодлив	Masculine
стомачен	Masculine
испеала	Feminine
војвотката	None
телето	None
молби	None
несправедливово	Neuter
козја	Feminine
безобразноно	Neuter
подоцнежниот	Masculine
нерамен	Masculine
досегашен	Masculine
агресивен	Masculine
славеj	None
известел	Masculine
одредувало	Neuter
подоцнежен	Masculine
зборовна	Feminine
снежниот	Masculine
голиов	Masculine
фонолошко	Neuter
покровителон	None
напнало	Neuter
продолжувала	Feminine
товарни	None
северозападно	Neuter
потење	None
тренирала	Feminine
пофално	Neuter
исцрпил	Masculine
ефикасен	Masculine
шепнала	Feminine
југословенските	None
вирусна	Feminine
скопска	Feminine
цуцла	None
војвотка	None
заљубена	Feminine
двоспратноно	Neuter
честитавме	None
разбирлив	Masculine
јасност	None
најала	Feminine
драгоцените	None
стакленото	Neuter
лимон	None
безгрижно	Neuter
удвоил	Masculine
австралиската	Feminine
темната	Feminine
старомоден	Masculine
правилнава	Feminine
матно	Neuter
загинал	Masculine
шприцал	Masculine
примил	Masculine
пченкарен	Masculine
единствени	None
тетовско	Neuter
плодно	Neuter
безвезната	Feminine
новогодишна	Feminine
влажна	Feminine
излажала	Feminine
мајчиното	Neuter
сврзното	Neuter
убавиот	Masculine
хомосексуалната	Feminine
правилниците	None
наизменичното	Neuter
гарантирал	Masculine
докторирал	Masculine
чесноно	Neuter
усложнело	Neuter
избришете	None
пропорционалното	Neuter
повлекло	Neuter
глупана	Feminine
охридската	Feminine
кобен	Masculine
личниот	Masculine
почекам	None
способно	Neuter
случајно	Neuter
користите	None
шминки	None
забавила	Feminine
азиски	Masculine
приватизиран	None
затресол	Masculine
сеопштата	Feminine
модерните	None
романот	None
добивал	Masculine
мазните	None
крофна	None
видовит	Masculine
развила	Feminine
стасаат	None
хомосексуален	Masculine
селаниве	None
занемарлива	Feminine
бивш	Masculine
борбената	Feminine
омилен	Masculine
свесното	Neuter
кабинетот	None
спалново	Neuter
бесшумна	Feminine
планинскиот	Masculine
братски	Masculine
милувате	None
крошнине	None
волшебна	Feminine
ловци	None
арното	Neuter
сметката	None
бричело	Neuter
уролошката	Feminine
извршила	Feminine
југословенското	Neuter
македонскиот	Masculine
охридсконо	Neuter
роденденскиот	Masculine
просветителите	None
објавуваа	None
вонземна	Feminine
проблематичните	None
наметнувала	Feminine
општествени	None
пенушките	None
комбинирал	Masculine
изложби	None
глумеа	None
жени	None
типична	Feminine
волнена	Feminine
тенекиине	None
драгана	Feminine
проценат	None
разно	Neuter
фонолошки	Masculine
пантери	None
пејачки	None
режиран	None
почитувало	Neuter
запушил	Masculine
празничните	None
разболувало	Neuter
досегашна	Feminine
осакатевме	None
високите	None
поддржувала	Feminine
срамниот	Masculine
знамиња	None
отплатило	Neuter
стилската	Feminine
семејна	Feminine
додало	Neuter
писмената	Feminine
узурпираав	None
тестирал	Masculine
привремениот	Masculine
изневерувала	Feminine
замав	None
велосипедисти	None
извесно	Neuter
инфарктот	None
заслужувал	Masculine
црвеникаво	Neuter
украсите	None
станала	Feminine
мистериозната	Feminine
голото	Neuter
колонизирала	Feminine
паричново	Neuter
летале	None
механички	Masculine
’ржеле	None
шутирање	None
опстаноков	None
пропорционални	None
минимално	Neuter
братскиот	Masculine
детална	Feminine
пријатна	Feminine
ждргинал	Masculine
венчаа	None
забавниот	Masculine
напорно	Neuter
леплива	Feminine
трчајте	None
прекрасното	Neuter
материјалната	Feminine
отмен	Masculine
дневничкиот	Masculine
безмилосно	Neuter
последнава	Feminine
измачи	None
неважно	Neuter
несоодветен	Masculine
раширила	Feminine
љубљанскиов	Masculine
Бугарката	None
ќерката	None
добродушни	None
можел	Masculine
повеќекратната	Feminine
залаци	None
непријатното	Neuter
невработени	None
фаќање	None
различна	Feminine
животен	Masculine
тркалајќи	None
одвеле	None
кафениве	None
прогонството	None
дланка	None
одбранбен	Masculine
безусловно	Neuter
стабилноно	Neuter
искоренило	Neuter
припишуваат	None
врзала	Feminine
разбудиме	None
забранувала	Feminine
практична	Feminine
вкуснава	Feminine
располагало	Neuter
дуелов	None
обработуваат	None
доближувала	Feminine
известил	Masculine
непријателски	Masculine
додржела	Feminine
стрмно	Neuter
неупотребливоно	Neuter
субвенционирање	None
безбојнион	Masculine
пајажинестата	Feminine
шамарајте	None
шармиран	None
плачела	Feminine
здивот	None
хемискиот	Masculine
арапското	Neuter
малтретирало	Neuter
детаљ	None
безвучна	Feminine
таткова	Feminine
субјективниот	Masculine
огреви	None
напуштал	Masculine
недохранетото	Neuter
разликувал	Masculine
кошулите	None
прифатлива	Feminine
астматичаров	None
ружи	None
компатибилни	None
лажноно	Neuter
современите	None
исклучителниот	Masculine
говедска	Feminine
географско	Neuter
дводневниве	None
проработел	Masculine
полно	Neuter
врачил	Masculine
осакатил	Masculine
громобранон	None
секојдневна	Feminine
станиците	None
величествена	Feminine
сафирот	None
погледнам	None
агрегатен	Masculine
празничнион	Masculine
органски	Masculine
раскажала	Feminine
мимолетното	Neuter
дневна	Feminine
бесмислен	Masculine
прескокнал	Masculine
неорганско	Neuter
компјутерската	Feminine
сплела	Feminine
смртниот	Masculine
бумбари	None
понизноста	None
растело	Neuter
рударски	Masculine
хрватското	Neuter
тропал	Masculine
дебелеење	None
играла	Feminine
чемреело	Neuter
пречекавте	None
идентично	Neuter
врапче	None
руското	Neuter
дополнителна	Feminine
лажна	Feminine
битната	Feminine
безусловна	Feminine
продупчи	None
еднаквово	Neuter
закитил	Masculine
потфатил	Masculine
епон	None
запознала	Feminine
мокро	Neuter
облекoл	Masculine
мазниот	Masculine
следната	Feminine
острото	Neuter
тетовска	Feminine
можна	Feminine
либерален	Masculine
препис	None
психичкото	Neuter
влегуваме	None
монголската	Feminine
гонел	Masculine
задолжително	Neuter
цено	None
копнеела	Feminine
беспрекорната	Feminine
југоисточен	Masculine
навлекла	Feminine
преместиме	None
одвратен	Masculine
сивкаста	Feminine
прописите	None
меѓусебната	Feminine
привлекувало	Neuter
предложел	Masculine
рамнокракото	Neuter
финалиња	None
умира	None
долготрајна	Feminine
продолжувал	Masculine
чилеанскиот	Masculine
ниска	Feminine
црвот	None
подземната	Feminine
променил	Masculine
сегашниот	Masculine
кирилица	None
учтивоно	Neuter
руски	Masculine
преувеличило	Neuter
пречел	Masculine
бунтовен	Masculine
технолошки	Masculine
љубљанска	Feminine
целосна	Feminine
читај	None
наметнат	None
среќавал	Masculine
преземала	Feminine
духовните	None
претпоследен	Masculine
авионсково	Neuter
влечат	None
предзнаењана	None
забната	Feminine
дарежливо	Neuter
моќно	Neuter
ангелска	Feminine
правион	Masculine
буквалната	Feminine
друштвено	Neuter
издишував	None
љубезно	Neuter
глупавана	Feminine
баскискиот	Masculine
целокупната	Feminine
стихозбирка	None
разгорел	Masculine
ефикасна	Feminine
тесноградана	Feminine
лажела	Feminine
наивната	Feminine
еретиците	None
зрелиот	Masculine
долниот	Masculine
планската	Feminine
тревниот	Masculine
пазарен	Masculine
бизарниов	Masculine
кораб	None
држел	Masculine
аптеките	None
најдете	None
учителско	Neuter
еровите	None
математичкиот	Masculine
едноставни	None
јаката	Feminine
добронамерна	Feminine
несоодветна	Feminine
северниот	Masculine
механичкана	Feminine
наведнал	Masculine
изгребел	Masculine
вклучил	Masculine
додева	None
коња	None
растаеше	None
силното	Neuter
седнувале	None
француски	Masculine
изговарал	Masculine
крајното	Neuter
созреала	Feminine
вонредната	Feminine
преземеме	None
неподвижнана	Feminine
изобилната	Feminine
повремени	None
мрачниот	Masculine
извинила	Feminine
управувале	None
внимателните	None
самион	Masculine
зграпчел	Masculine
повел	Masculine
шикнал	Masculine
изгужвавте	None
зголемувал	Masculine
малата	Feminine
салепот	None
живописниот	Masculine
намокрил	Masculine
шепотат	None
поранешните	None
нагласувале	None
средниот	Masculine
