inorridire	None
opererebbe	None
scurisce	Present
piantarla	None
interrogati	None
declamare	None
sottintendere	None
ricostruiscano	Present
involati	None
impantanò	Past
fagocitare	None
godeva	Past
sbaciucchia	Present
defezionarono	Past
svernava	Past
forgiato	Past
precostituivo	Past
dissociare	None
slogò	Past
formalizzati	None
contento	Present
varcavano	Past
campeggiavano	Past
amnistiare	None
insinuano	Present
rilassare	None
comportando	Present
scaraventò	Past
legiferare	None
facesse	Past
valuto	Present
estolli	Present
braccando	Present
impiantò	Past
suggeriranno	Future
affidare	None
sguarnendo	Present
laudano	Present
connesso	Past
incanalava	Past
raggiato	Past
ibernano	Present
pareggiava	Past
tritato	Past
spietrante	Present
riaffermati	None
abdicherà	Future
spiegherebbe	None
captò	Past
stizzirò	Future
coordinando	Present
scontornereste	None
riacutizzarsi	None
enfatizzavo	Past
spiego	Present
sfrutto	Present
disprezzare	None
finanziò	Past
assassinavano	Past
annientano	Present
partorire	None
nullificare	None
risonano	Present
prendendosela	Present
acuisce	Present
amplierei	None
visita	Present
soggiungerai	Future
riprogrammate	Present
rievaporerei	None
ricorreranno	Future
domato	Past
affezionare	None
coesisteva	Past
defeca	Present
trasportasse	Past
notificò	Past
tonferebbe	None
incentravano	Past
sfilacciavamo	Past
sapere	None
attiene	Present
sottendere	None
accampa	Present
toscaneggiante	Present
attecchito	Past
condividerebbero	None
commissionare	None
strasformeremo	Future
installarsi	None
recheremmo	None
intendersene	None
inserirò	Future
addestrati	None
durasse	Past
spenderei	None
anestetizzano	Present
infiammò	Past
impartì	Past
sovrastampate	Present
ripristinasse	Past
contornate	Present
argentato	Past
addolcire	None
visitò	Past
sdoppiarsi	None
passavamo	Past
trafisse	Past
reinstaurerebbero	None
spurgo	Present
commercio	Present
manduco	Present
saturato	Past
tergiversava	Past
auggiasse	Past
denunciasti	Past
sbucarono	Past
imbrigliare	None
sentenziano	Present
tassai	Past
validare	None
sporgersi	None
imbiaccherei	None
avverò	Past
assicurati	None
sedimentati	None
rallentati	None
capitolo	Present
sghignazzare	None
afflosciavi	Past
cartellina	Present
suonano	Present
sbadiglieresti	None
eclissarsi	None
soprassiedo	Present
appigliassimo	Past
defraudare	None
ritornati	None
polemizzare	None
crearsi	None
rinunciava	Past
localizza	Present
menzionante	Present
vagava	Past
rilanciati	None
ubbligassero	Past
scegliersi	None
rabbrividisce	Present
abbriglieresti	None
temessero	Past
remare	None
trasgredito	Past
stazza	Present
tirano	Present
serrarsi	None
elettrizzare	None
sbocciarono	Past
azzardati	None
spiegare	None
affattucchierei	None
registrano	Present
aggruppino	Present
autografare	None
congedarsi	None
informati	None
valutati	None
significa	Present
rivolgere	None
tarlati	None
riaccadeva	Past
divertiranno	Future
rimovetevi	None
archiviare	None
demarca	Present
costato	Present
valicato	Past
smontati	None
consumerà	Future
ugnano	Present
volatilizzare	None
atterrare	None
raggiungi	Present
ristorerai	Future
intimato	Past
soccombeva	Past
catalizzare	None
spuntelleremmo	None
degenera	Present
falsificare	None
abrogate	Present
dubitavano	Past
ripossiedono	Present
aiutati	None
rifocillati	None
rieserciterebbero	None
contaminate	Present
uggirono	Past
viziare	None
promana	Present
marginare	None
cambierei	None
contingentavi	Past
maggiorano	Present
sottodividesse	Past
figliano	Present
mordenzava	Past
risciogliesse	Past
glosso	Present
infiammarsi	None
astringessero	Past
sprigionarsi	None
claudichiate	Present
intrufolò	Past
delegare	None
sposandosi	Present
immatricolarsi	None
quadriate	Present
infondeva	Past
chiuderebbe	None
confinava	Past
riallacciarsi	None
porre	None
intercala	Present
cuoci	Present
procrastinarono	Past
sedimentare	None
irritare	None
allevierà	Future
distogliersi	None
intrugliarsi	None
collaudare	None
ispezionate	Present
volatilizzati	None
annacquavo	Past
trapponeva	Past
sedare	None
consiglierei	None
esperite	Present
ferro	Present
abbittarono	Past
copriti	None
rivitalizzante	Present
sgangherati	None
suco	Present
alimentino	Present
rieducare	None
atteneva	Past
rigenerò	Past
snaturando	Present
riscaldare	None
millantare	None
friggendo	Present
tondeggiassimo	Past
vocalizzate	Present
facendosi	Present
incrociante	Present
comprovare	None
parti	Present
piegavano	Past
rifrangeresti	None
disincantereste	None
comunicarsi	None
digitalizzammo	Past
reinserirà	Future
avvicendammo	Past
sapevano	Past
metaforizzammo	Past
premendo	Present
abituando	Present
paralizzare	None
suonavamo	Past
azzerato	Past
tallonare	None
stupitevi	None
controprovano	Present
gallonavamo	Past
snuderei	None
costello	Present
rimarcherebbero	None
lorda	Present
muggire	None
espurgai	Past
libereremo	Future
accasellate	Present
percossi	Past
moltiplico	Present
proferì	Past
omologarsi	None
accreditandosi	Present
lesionare	None
rivisitando	Present
resta	Present
smacchiare	None
controllarono	Past
fasciare	None
amavate	Past
impiccolii	Past
virgolettassero	Past
lesionando	Present
licenziò	Past
riassorbivo	Past
avvedendosi	Present
privatizza	Present
condiviso	Past
contorce	Present
ripristineremo	Future
boicottando	Present
condurrebbero	None
dedicati	None
clusterizzerai	Future
precompilate	Present
disinteressò	Past
meritando	Present
sopravvivessero	Past
rinvenivi	Past
aborrendo	Present
amputate	Present
intavola	Present
fermerebbe	None
lanciati	None
poniamoci	None
lasciavo	Past
voco	Present
offri	Present
infuriare	None
accalcherò	Future
tropicalizzassero	Past
danzo	Present
schizzava	Past
torreggiano	Present
subornante	Present
comminando	Present
ottuso	Past
tiro	Present
formate	Present
deflagrante	Present
constante	Present
preservino	Present
pietrificante	Present
transcorrerai	Future
basino	Present
snocciolando	Present
riuniva	Past
rincontrando	Present
squamate	Present
rimpiattarono	Past
rifinanziante	Present
aggrappava	Past
divertissero	Past
bravate	Present
prestampava	Past
imbottigliavano	Past
popolarizzereste	None
ingaggio	Present
bombano	Present
sfoggia	Present
diramò	Past
indebolendosi	Present
lievitarono	Past
nebulizzato	Past
designava	Past
dedicando	Present
imitate	Present
ricorderebbe	None
insaccherò	Future
brontola	Present
mastica	Present
occuparono	Past
protocollereste	None
impero	Present
allietano	Present
galvanizzassimo	Past
rinselvatichisce	Present
rimarcare	None
scacciato	Past
nasceranno	Future
emettono	Present
tacchetterebbe	None
ipotizzato	Past
debuttare	None
gloriano	Present
vicina	Present
autosomministrammo	Past
verteva	Past
morite	Present
collegai	Past
inibire	None
includerà	Future
catalizzeremmo	None
cimentati	None
ribattezzate	Present
decidiate	Present
udire	None
correleremmo	None
aleno	Present
alludere	None
trapianteranno	Future
beneficò	Past
sfamò	Past
valutava	Past
protruso	Past
pararsi	None
trasmise	Past
toccandosi	Present
orientarono	Past
visualizzavo	Past
ceduto	Past
individuarsi	None
prenotarono	Past
sembrare	None
imbrunisce	Present
affumigheresti	None
flotta	Present
ostracizzano	Present
esaurirà	Future
dipenderà	Future
rinvierebbero	None
ricoprirono	Past
situava	Past
digiunando	Present
nuocevano	Past
preoccupato	Past
ritoccò	Past
arginando	Present
esibisco	Present
alleveremmo	None
fanatizzante	Present
sgridate	Present
ragguaglio	Present
riorganizzò	Past
premuoio	Present
inasprendo	Present
indirizzare	None
litighino	Present
arcaizzare	None
albererei	None
minato	Past
aggricceresti	None
rispettarsi	None
ripassa	Present
marco	Present
vidimare	None
salivano	Past
bypassato	Past
ristampate	Present
schiavizzando	Present
attesterebbero	None
incutere	None
vitalizzavate	Past
sacrificandosi	Present
segregò	Past
ritirerò	Future
rigermoglieresti	None
rispettassero	Past
assumersi	None
prolasserà	Future
sostenta	Present
staccasse	Past
stabilisce	Present
proverebbero	None
istaurassimo	Past
infinocchierà	Future
restituendo	Present
tralasciato	Past
sforzasse	Past
costellarono	Past
trarsi	None
insaporivamo	Past
palleggiando	Present
sgamba	Present
configurò	Past
raffreddarsi	None
sollazzare	None
concertando	Present
ingrassa	Present
raggruppare	None
allacciano	Present
confronta	Present
sfogherà	Future
correggeranno	Future
fungerebbe	None
pensionare	None
ventilando	Present
rafforzarsi	None
nascondereste	None
preselezionato	Past
bloccando	Present
disciplinare	None
assegnerà	Future
arrecante	Present
raggrumerà	Future
chiedersi	None
oppone	Present
raccolsero	Past
modificherà	Future
sappiano	Present
aiutante	Present
mulinare	None
partiziona	Present
zannerete	Future
sfociato	Past
ritrattate	Present
accasandosi	Present
sfamano	Present
riassorbirsi	None
vergognerei	None
sbugiardare	None
riuniscano	Present
metaforizzeremo	Future
usurare	None
pronosticavamo	Past
concatenare	None
dubiterebbe	None
cazzano	Present
alliccerei	None
bussare	None
pignorassero	Past
cascato	Past
chiuderanno	Future
spare	Present
destabilizzare	None
astenesse	Past
dedicassero	Past
degassare	None
impuntarsi	None
orientandosi	Present
prosciogliere	None
tarpa	Present
diserterà	Future
riallungereste	None
dissotterreresti	None
slittino	Present
impaccherà	Future
alluciniate	Present
rompi	Present
confluite	Present
ramino	Present
sclerotizzati	None
ricollocasse	Past
compromettete	Present
affatica	Present
colorare	None
confiscarono	Past
ringraziava	Past
intitolavano	Past
rievocheresti	None
nasconderebbe	None
inauguro	Present
disconoscono	Present
accopperemmo	None
scalco	Present
sfrondare	None
attraversassero	Past
sfasate	Present
scolorisce	Present
scansionando	Present
rincomincia	Present
riprogrammò	Past
siringa	Present
bastavo	Past
massacrò	Past
venerarono	Past
venivano	Past
attraversarono	Past
zapperebbero	None
stria	Present
impartito	Past
millantati	None
pregiati	None
ridistribuisce	Present
esprimevo	Past
scambierei	None
pascolare	None
estese	Past
innervate	Present
cazzeggiato	Past
rievoca	Present
noleggiarono	Past
cancello	Present
depennate	Present
avvizziscono	Present
lancerà	Future
contrattavamo	Past
tentennato	Past
sbirciando	Present
spuntate	Present
inalassero	Past
ricominciato	Past
comparve	Past
ritrasformiate	Present
travolgo	Present
professati	None
sorvolare	None
insediavano	Past
sfregiare	None
pressurizzate	Present
assomigliare	None
assicura	Present
curiosando	Present
circoscritto	Past
bearsi	None
bisogna	Present
tornando	Present
inoculate	Present
arrogò	Past
levitare	None
gozzovigliavi	Past
dilania	Present
racchiudente	Present
rimangiò	Past
intisichirebbe	None
dilettasse	Past
rattrappisco	Present
infiltrante	Present
paragonati	None
venirsi	None
esecreranno	Future
migliorerebbe	None
laureate	Present
scassinereste	None
pattinai	Past
disinteressarsi	None
strapiombino	Present
incocciammo	Past
olezzavano	Past
equante	Present
vedrò	Future
trasvolerebbe	None
spiaggiò	Past
metabolizzò	Past
scopare	None
ubicare	None
punendo	Present
nascondeva	Past
coinvolgi	Present
riavvicinarsi	None
innescarono	Past
intentare	None
tempreremmo	None
cooptare	None
ammennicolava	Past
dotava	Past
faticheranno	Future
fatturò	Past
arrampicandosi	Present
cascò	Past
preannunzierebbe	None
svasate	Present
incentrarsi	None
giostrando	Present
adorare	None
cronometrare	None
seguirebbero	None
esigono	Present
consentiti	None
sbancare	None
ammodernò	Past
imbruttirei	None
correda	Present
affaticano	Present
coinciderà	Future
telecomandare	None
cimato	Past
accedete	Present
sgombrate	Present
padroneggiano	Present
ubicheresti	None
litigate	Present
inzuppati	None
anagrammando	Present
torcendo	Present
equivocava	Past
augurò	Past
inanellate	Present
appartano	Present
scompenso	Present
falcidiò	Past
completati	None
rifanno	Present
voltante	Present
giaciuto	Past
sedotto	Past
vederci	None
modellato	Past
abbelliva	Past
provocassero	Past
sigillava	Past
arricchirsi	None
incoraggiando	Present
distruggendosi	Present
evolve	Present
riapproviate	Present
flagella	Present
geometrizzai	Past
disturbarono	Past
ricompensato	Past
idratare	None
consumassero	Past
perverrà	Future
consisterebbero	None
sradicavate	Past
indietreggiare	None
campino	Present
inserivano	Past
giaciono	Present
scalò	Past
smontano	Present
rassegnando	Present
pretendevo	Past
certificasse	Past
imbevendo	Present
spopolarono	Past
distringi	Present
cercavi	Past
gravasse	Past
socializzato	Past
abbruscato	Past
aspettavate	Past
sovrintese	Past
arbitrando	Present
favorirà	Future
vetrinare	None
incornato	Past
tribolo	Present
maltratterà	Future
mulino	Present
mantiene	Present
anticiparono	Past
bruxa	Present
trasferisco	Present
esigerà	Future
negherei	None
aggiornasse	Past
lubrificate	Present
avvallarsi	None
provincializzeranno	Future
desensibilizzerebbe	None
ridimensionano	Present
schiudessero	Past
lessate	Present
andremmo	None
preservò	Past
manderò	Future
peccherebbe	None
disattesi	Past
sfama	Present
incollano	Present
uccella	Present
devolve	Present
stringente	Present
facevamo	Past
percorsi	Past
riporre	None
disertare	None
memorizzano	Present
scorporerei	None
contrabbandato	Past
fregiarsi	None
godi	Present
depennare	None
signoreggiare	None
riaffermava	Past
garbai	Past
impingeranno	Future
commettere	None
riviene	Present
fuggi	Present
scritturando	Present
punirono	Past
allineasse	Past
impuntisci	Present
ceno	Present
partirai	Future
aggravandosi	Present
limando	Present
vitaminizzerete	Future
curò	Past
spoliticizzavate	Past
accenditi	None
paresse	Past
mugugnavi	Past
rigirando	Present
accaduto	Past
desinerete	Future
ordinasse	Past
flagellò	Past
guarente	Present
riaggravassero	Past
recarvisi	None
affievolisce	Present
riformato	Past
scottante	Present
permeato	Past
sgambettante	Present
depuratevi	None
rintendendo	Present
direste	None
denazionalizzando	Present
immettendo	Present
radicare	None
rattoppare	None
esagerarono	Past
contagiò	Past
incornare	None
imponesse	Past
posati	None
stroppato	Past
allascherebbe	None
autolimitarsi	None
invasa	Present
sbollissimo	Past
risentirebbero	None
rampollerai	Future
scoverà	Future
combinava	Past
rifacentesi	Present
ridicolizza	Present
intavolando	Present
pontifica	Present
coordinasse	Past
contrappunteremmo	None
sventrate	Present
acchioccioleresti	None
consente	Present
sopravvalutati	None
promulga	Present
interesserò	Future
fotografo	Present
sollecita	Present
progredivano	Past
acciuffare	None
strozzare	None
concernono	Present
posizionare	None
avventura	Present
cremino	Present
disdegna	Present
incaricati	None
disboscato	Past
marchiato	Past
eviterò	Future
appioppa	Present
computa	Present
esplicarsi	None
ammodernate	Present
immolò	Past
articolandosi	Present
distribuivano	Past
scricchiolare	None
rimbocchiamoci	None
voteranno	Future
addensarono	Past
gettate	Present
arridessero	Past
risolve	Present
impanassimo	Past
guardiamoci	None
insorgono	Present
volano	Present
surclassate	Present
demordevamo	Past
telecomando	Present
girano	Present
ricomincerà	Future
reclamato	Past
instradano	Present
scingeremo	Future
toccherà	Future
dirò	Future
ripianato	Past
spammeranno	Future
affrettava	Past
riaggravavo	Past
soffocandosi	Present
partono	Present
serbati	None
martellato	Past
risentirsi	None
sereneremo	Future
godano	Present
assicurarsi	None
arricciolerà	Future
molato	Past
adeguarsi	None
idrogenare	None
disinteressano	Present
impallinare	None
divengono	Present
dissestate	Present
imbarcherà	Future
sbarberebbe	None
disintossicherebbe	None
ammarare	None
arricchendosi	Present
spartite	Present
sfornate	Present
posizionavano	Past
accompagnarono	Past
imperversare	None
sfumare	None
renderizza	Present
zinco	Present
intersecare	None
imiterà	Future
verificano	Present
smalto	Present
coltella	Present
rivendicassero	Past
starnazzano	Present
rimpastante	Present
convinse	Past
andavi	Past
confezionato	Past
persevereresti	None
umiliando	Present
inalerete	Future
ionizzate	Present
aggiusteresti	None
attenuano	Present
sospettasse	Past
soffermiamoci	None
spettacolarizzerò	Future
smagrito	Past
castigato	Past
scassinare	None
ingentilire	None
scorciati	None
convivendo	Present
dipendere	None
eruttare	None
riprodussero	Past
sborsando	Present
soggiornerebbe	None
comunicato	Past
salirebbero	None
sostavano	Past
obbedisco	Present
preferiva	Past
deformati	None
riversare	None
analizzavano	Past
raccomodarono	Past
guadagnati	None
dissertare	None
inventa	Present
debilitare	None
reimparerai	Future
intasa	Present
contra	Present
scippare	None
accennavano	Past
odorare	None
somigliano	Present
ofizio	Present
smobilitare	None
sussume	Present
segare	None
commutare	None
sbolognassero	Past
lattava	Past
costeggiare	None
inserì	Past
imbottigliare	None
cumulati	None
beneficiare	None
ridurrebbero	None
rivalorizzare	None
tacitare	None
contornando	Present
asfalto	Present
rinvenirsi	None
riodano	Present
riorganizzate	Present
zoomasti	Past
affiancare	None
ringrazierà	Future
inoltravano	Past
specchia	Present
meditare	None
risulterebbero	None
regnano	Present
relativizzò	Past
vedrebbe	None
incaparbissimo	Past
preavviso	Present
bisticciano	Present
approvino	Present
impersonano	Present
sommo	Present
zittisce	Present
filavi	Past
strisciando	Present
invocò	Past
udite	Present
sfamerò	Future
giudicare	None
rivoltati	None
rompesse	Past
rifioriremmo	None
aleggeremmo	None
trasporterà	Future
dirà	Future
impregnarsi	None
tarmavate	Past
sincerarsi	None
sanziona	Present
garantendosi	Present
danneggerebbe	None
disattrezzano	Present
taceva	Past
glorificare	None
allontanare	None
amplia	Present
rivestiranno	Future
burocratizzai	Past
occlusi	Past
scuoiare	None
tasteranno	Future
chiudessimo	Past
metti	Present
rimpiazzarono	Past
compaiono	Present
taglino	Present
adattando	Present
disobbedire	None
congelante	Present
accalappiai	Past
area	Present
angolate	Present
portare	None
sapete	Present
smanettare	None
silura	Present
denotando	Present
andrebbe	None
soprastampa	Present
vietano	Present
convergerebbero	None
profumare	None
darete	Future
allacciandosi	Present
calcinarono	Past
autenticati	None
soccorsero	Past
focalizzando	Present
sfrondatevi	None
trasvolsi	Past
prevengo	Present
vai	Present
risparmierei	None
riagganciandosi	Present
falcidiando	Present
gonfiarono	Past
incogliessero	Past
brillantassimo	Past
arrampicando	Present
sciabordai	Past
sanguinava	Past
tenoreggiai	Past
reputò	Past
saltate	Present
controbattere	None
seguirebbe	None
scopo	Present
istituiremmo	None
allampanassero	Past
immolare	None
reinvestire	None
numero	Present
peggiorato	Past
ritelefonerebbe	None
insanguinava	Past
abbonati	None
cancelleresti	None
ripagheresti	None
sbloccando	Present
proteggano	Present
ottiene	Present
rincingono	Present
scappano	Present
comporre	None
richiedente	Present
dileguano	Present
cucì	Past
ammendante	Present
incresperete	Future
accosterà	Future
attorcigliano	Present
scalmanati	None
abilitò	Past
vivificherei	None
prenotandosi	Present
laudare	None
bagnino	Present
prosperare	None
spiegheremo	Future
deflettendo	Present
demotivare	None
riutilizzava	Past
scompaginò	Past
noteremo	Future
termostaterebbero	None
incupisce	Present
traslocati	None
idrato	Present
rimarrebbero	None
imbarazzati	None
staccio	Present
verseggeremmo	None
enfatizza	Present
svilente	Present
giudicherebbe	None
galleggiando	Present
manovrate	Present
eccederei	None
continuavano	Past
sottolineerei	None
coesisterebbe	None
vigilarono	Past
rimodulate	Present
incamerato	Past
indignare	None
anteporre	None
sgobbare	None
coesistere	None
residuerebbero	None
appetente	Present
pagava	Past
trasecolasti	Past
illuse	Past
digiunava	Past
esclusi	Past
beante	Present
ranzai	Past
abbruttisciti	None
sfrutterebbe	None
scontarono	Past
setaccia	Present
truccano	Present
rassegnerà	Future
saltella	Present
sventoleremo	Future
sottotitolato	Past
correggi	Present
stenografate	Present
compire	None
ammotinato	Past
orgasmo	Present
proclamando	Present
votassero	Past
controprovava	Past
confinati	None
ricevere	None
infervorati	None
uliva	Past
saccheggia	Present
colante	Present
disciplinino	Present
recarsi	None
tassare	None
salaria	Present
linkavano	Past
assieparono	Past
equilibro	Present
precedesse	Past
memorizzate	Present
migliorerebbero	None
russare	None
sposterebbe	None
rimano	Present
proteggerà	Future
ipotizzano	Present
scottati	None
ommettesse	Past
importavano	Past
divina	Present
condire	None
concludano	Present
asperge	Present
fermerà	Future
urgente	Present
discutete	Present
piombando	Present
disperdendosi	Present
spolverare	None
ventilava	Past
conficcato	Past
involarsi	None
esercitate	Present
osservati	None
adunante	Present
riprendendosi	Present
inzucchereranno	Future
otterrebbe	None
intavolare	None
calarono	Past
soddisfatto	Past
sbaragliare	None
incedere	None
stordisce	Present
scomunicò	Past
avvalorerei	None
diciate	Present
risvolto	Past
sgranano	Present
reinscrivevi	Past
arrenderei	None
comporteranno	Future
diplomarsi	None
rima	Present
guadagnerebbe	None
legalizzando	Present
acclamava	Past
raminga	Present
attraversate	Present
constavano	Past
diseredare	None
ferrare	None
litigo	Present
stesi	Past
schematizza	Present
sfarinati	None
profana	Present
ambientandosi	Present
farfugliando	Present
indebolire	None
ristilizzino	Present
mitigare	None
espletare	None
allacciò	Past
affrescherà	Future
edulcoravano	Past
imprigionare	None
lavo	Present
prescrisse	Past
internazionalizzo	Present
spulcia	Present
spassino	Present
ricompattare	None
disinfestare	None
acromatizzerete	Future
affondò	Past
dileguò	Past
figuravano	Past
rissa	Present
querela	Present
capovolgendo	Present
rimboccano	Present
congelare	None
ferravi	Past
propugnare	None
intravvedranno	Future
imbarcate	Present
inquietante	Present
rettificherete	Future
valuterà	Future
bindolasti	Past
scaturito	Past
deride	Present
raggranchierei	None
caroto	Present
inizializzare	None
colmerà	Future
intendiate	Present
spianati	None
addentellerebbe	None
riverire	None
contaminano	Present
enucleati	None
riaffrontare	None
violentato	Past
insorgere	None
dissigillare	None
ossificati	None
questiona	Present
prevengano	Present
riservandosi	Present
perdete	Present
asserire	None
affiggendo	Present
assodate	Present
metamorfizzavi	Past
spavento	Present
rassumeranno	Future
congiunge	Present
includerebbero	None
zampogna	Present
dissacrereste	None
gabellerà	Future
dirigo	Present
settino	Present
impadronirsi	None
trafiggendosi	Present
staccava	Past
arruvidiresti	None
tornò	Past
giocassero	Past
aliterei	None
interrare	None
vangavamo	Past
associarsi	None
macchiandosi	Present
subiva	Past
salino	Present
attorcano	Present
ribassare	None
ripiantato	Past
continuava	Past
disimpegnare	None
battaglia	Present
installavano	Past
giudicherà	Future
precisò	Past
neutralizzo	Present
sottotitolate	Present
instaurano	Present
impiantare	None
incipriare	None
terzia	Present
approvarono	Past
saccheggio	Present
aspettavano	Past
metteranno	Future
volgarizzato	Past
nuotò	Past
scostoleremmo	None
quagliano	Present
duettarono	Past
contentò	Past
dissentono	Present
mondializzerebbe	None
mischiare	None
termina	Present
sbulloneremmo	None
balenare	None
sanante	Present
evinco	Present
insaliverai	Future
insidiato	Past
decolonizzare	None
tuffarsi	None
avverto	Present
inguaiati	None
sgommiate	Present
aggiudico	Present
rinculare	None
diffama	Present
sgusciare	None
assistiamoci	None
traballante	Present
masturbereste	None
sale	Present
masticano	Present
afferrassero	Past
canforato	Past
reagiva	Past
estenuano	Present
lavorando	Present
celebrava	Past
molestavano	Past
spingereste	None
accusiamoci	None
decrescente	Present
raspante	Present
ritrasferito	Past
esporrebbe	None
soffuse	Past
decrementano	Present
incarrozzavate	Past
sorprendeva	Past
qualificare	None
collimano	Present
raccordandosi	Present
noleggeranno	Future
pugnalerà	Future
fiorite	Present
stai	Present
controllando	Present
insistettero	Past
superati	None
materializzano	Present
celebrarono	Past
sbalzare	None
guarnisce	Present
slacciassimo	Past
favellammo	Past
sfiora	Present
arrecare	None
equiparò	Past
occidentalizzarsi	None
rincuorati	None
porrebbero	None
effettuò	Past
arrangiandosi	Present
radunavamo	Past
colorante	Present
precisa	Present
affilano	Present
googlare	None
pasticciato	Past
resinificai	Past
giungesse	Past
incollarsi	None
destrutturare	None
carino	Present
emetterebbe	None
divagare	None
staffilano	Present
inanella	Present
arrotondò	Past
collassò	Past
diminuireste	None
riassorbiresti	None
imbarcò	Past
rallenterà	Future
attaccate	Present
snidare	None
vincolerebbero	None
pavimentereste	None
coppello	Present
ripescherei	None
attiravano	Past
rinominare	None
copiati	None
scemare	None
ricoprirsi	None
subirà	Future
striano	Present
risolvere	None
scoccio	Present
discutano	Present
parodiare	None
viaggiano	Present
presieduto	Past
ridenominare	None
deflagrò	Past
sorteggiavate	Past
sballottolato	Past
apocopava	Past
pulsa	Present
reincarnati	None
provassimo	Past
impresciuttirai	Future
travalicando	Present
prolungava	Past
proteggere	None
scanno	Present
contrattate	Present
precederà	Future
indiremmo	None
scolpisce	Present
trivellare	None
profondevo	Past
acidificare	None
conciliarsi	None
allertare	None
alchilerebbe	None
irrigidirebbe	None
significò	Past
interoperare	None
smarchiate	Present
svestivano	Past
slogherebbe	None
convincerà	Future
ripristinate	Present
comunistizzeranno	Future
cementante	Present
smerlo	Present
confinavano	Past
duplicando	Present
riappropria	Present
platino	Present
temeva	Past
rivaccinasti	Past
prevalsi	Past
secca	Present
intavolato	Past
fidando	Present
provocare	None
fidano	Present
sbrigare	None
corrompeva	Past
svalutarsi	None
terrorizzare	None
spersonalizzare	None
contemplassimo	Past
sovraffollato	Past
rirende	Present
utilizzerebbe	None
riscattarono	Past
udivano	Past
contribuire	None
accorto	Past
arrangiò	Past
svolazzo	Present
bloccava	Past
appiccicarsi	None
mobilizzato	Past
restituirei	None
instupidireste	None
perderete	Future
vociferato	Past
inglobasse	Past
eluito	Past
rompere	None
avverrete	Future
spazzolati	None
disintossicare	None
declassando	Present
finalizzate	Present
cingono	Present
scaturirebbe	None
fucilano	Present
premio	Present
rimanemmo	Past
eccepissimo	Past
ascenderà	Future
intercettate	Present
dissaleremo	Future
contageresti	None
rimestando	Present
sguazzando	Present
acciottolate	Present
sperperando	Present
colmate	Present
incentivava	Past
progrediremmo	None
infornate	Present
ossigenati	None
scolpito	Past
reitero	Present
riadattarono	Past
confinate	Present
sorgeva	Past
preludere	None
discaddero	Past
frivoleggiò	Past
trapiantate	Present
assetò	Past
pregiudicati	None
strutturandosi	Present
faciliterebbe	None
favoriscano	Present
stabilendo	Present
connotò	Past
zincato	Past
ridimensionare	None
occorrere	None
aizzato	Past
innestati	None
interrompesse	Past
barricare	None
significavano	Past
ripartendosi	Present
migliorino	Present
intitolarsi	None
collaborato	Past
sfoggiando	Present
complimentandosi	Present
sbranare	None
responsabilizzati	None
arrotola	Present
ostacolare	None
inerire	None
tifava	Past
stuzzicate	Present
appella	Present
plachino	Present
intensificò	Past
dicano	Present
modernizzarsi	None
segnalò	Past
fronteggiarono	Past
raccolgono	Present
otterremmo	None
intralciare	None
guastando	Present
guastare	None
scordare	None
indicherei	None
rincontrare	None
protrarrà	Future
diminuissero	Past
opporre	None
sonate	Present
seppellirono	Past
rivolgete	Present
formalizzerà	Future
ricategorizzare	None
preservasse	Past
sputa	Present
infoltissero	Past
attraverserebbe	None
istigavano	Past
pilotato	Past
indicare	None
impattando	Present
intensifica	Present
ripopolati	None
predominante	Present
sgorgando	Present
assumerei	None
filtra	Present
restavano	Past
sceglieranno	Future
sponsorizzando	Present
protrarrebbero	None
esternate	Present
rievocavano	Past
concluderei	None
propagarono	Past
incolpandosi	Present
protendersi	None
implementare	None
assillante	Present
flocculo	Present
arredò	Past
allontanati	None
regna	Present
arricchisse	Past
cambieresti	None
scrivessero	Past
stangherei	None
attaccano	Present
esaltavano	Past
sanciscono	Present
coesistono	Present
invenire	None
aggrondino	Present
mima	Present
videogiocavano	Past
scorgerà	Future
tonsurare	None
cozzeranno	Future
arrovellarsi	None
lavoriamoci	None
seducente	Present
ingerirono	Past
fiorì	Past
appassionavano	Past
sguainerò	Future
putrefatti	None
approverai	Future
contabilizzate	Present
programmando	Present
calciano	Present
infischiarsene	None
alternò	Past
assimilare	None
demarcate	Present
riacutizzavano	Past
apporre	None
permetteva	Past
demoralizzare	None
rivolgessero	Past
accompagnati	None
vivacchiare	None
estirpare	None
passeremmo	None
amalgamati	None
radicante	Present
contraccambierà	Future
catalizzano	Present
festonereste	None
ristauro	Present
teleradiotrasmetteresti	None
compara	Present
grafitò	Past
feriva	Past
banchetterete	Future
indagheranno	Future
conserverebbe	None
dareste	None
saccheggiato	Past
ebevuto	Past
nobilitate	Present
esternare	None
ricomparire	None
sostituirsi	None
assalta	Present
avvolgeva	Past
argomentare	None
camererà	Future
deduce	Present
polarizzati	None
proclamavo	Past
specializzarsi	None
sporcarsi	None
soccorrendo	Present
zuppino	Present
significhino	Present
direzionano	Present
attuerebbe	None
relegate	Present
cauzionai	Past
rigurgitate	Present
climatizzate	Present
pregiudica	Present
rincappante	Present
documentò	Past
moriremo	Future
riciclare	None
intuì	Past
editavo	Past
guastarsi	None
stroncate	Present
dribblato	Past
curvati	None
arricchire	None
narrato	Past
commendo	Present
rigurgito	Present
rampolla	Present
arrugginire	None
posteggiare	None
escogitato	Past
alando	Present
diversificare	None
aderisse	Past
snebbia	Present
canzonare	None
adontavamo	Past
ripiegare	None
sbagliavo	Past
crivellano	Present
detergo	Present
dorerebbero	None
sprecava	Past
sfatassero	Past
imbastire	None
debutta	Present
abrogano	Present
imporre	None
provieni	Present
desolate	Present
dormirci	None
ridistribuì	Past
rivendere	None
cavai	Past
garantirà	Future
indottrinare	None
brava	Present
assimilavano	Past
risiederà	Future
accinse	Past
variante	Present
strippo	Present
concludere	None
voltura	Present
semicingerai	Future
stallerà	Future
citavi	Past
inchiostrando	Present
proteggevo	Past
sospendi	Present
googleremmo	None
irrogò	Past
ratificherà	Future
tramestarono	Past
rabberceremo	Future
fruttando	Present
offrirò	Future
muoiano	Present
esemplificare	None
lignificate	Present
riaffermarono	Past
generalizzo	Present
vaccinati	None
riesuma	Present
accertava	Past
meditando	Present
azzurrate	Present
rimanere	None
presidiare	None
serberà	Future
riallungerò	Future
transitano	Present
tarano	Present
lotta	Present
asseverare	None
squassino	Present
metaforizzeresti	None
ripristinerò	Future
innervosisce	Present
citofonai	Past
ufficializzavano	Past
localizzò	Past
fumavo	Past
implementerà	Future
incolpare	None
rizzavamo	Past
incentivano	Present
assoggettava	Past
visionato	Past
vivanda	Present
convertirsi	None
cessa	Present
rifirma	Present
richiedevano	Past
spazializziate	Present
parafrasato	Past
correggerei	None
strillereste	None
intercorrendo	Present
artefacesse	Past
ritrarrà	Future
schettino	Present
esposero	Past
rimarcò	Past
pastura	Present
riconquistasse	Past
sradicate	Present
doppiassero	Past
ingiallissimo	Past
staro	Present
criminalizzato	Past
accenna	Present
squadrato	Past
rifaccio	Present
criticheranno	Future
fissa	Present
tireranno	Future
usatevi	None
esisterebbe	None
specificheremmo	None
germogliato	Past
movente	Present
intesseva	Past
ingerimmo	Past
disarciona	Present
erpicheremmo	None
germogliarono	Past
scosceso	Past
euforizzante	Present
richiamò	Past
codificarono	Past
svincolare	None
scongelarsi	None
scappato	Past
scaturì	Past
precetto	Present
iterate	Present
accalcarsi	None
vuotandosi	Present
estorcendo	Present
baceranno	Future
rieducato	Past
sbrana	Present
scalpitante	Present
impalcato	Past
commerciò	Past
accucciati	None
negano	Present
fremono	Present
sottoscrivono	Present
rivendicavano	Past
sfornava	Past
avvenne	Past
rifinito	Past
rinasco	Present
rinverdire	None
crucciano	Present
sciolgo	Present
immortalano	Present
sottrarre	None
adombrare	None
rigenerante	Present
diserteremo	Future
imponendosi	Present
autenticarsi	None
rivoltoliate	Present
baserei	None
normalizzate	Present
risalirà	Future
confortati	None
soffrissero	Past
rovesciavano	Past
orinare	None
ghigliottinato	Past
stilo	Present
rimarcato	Past
influenzante	Present
sfoderano	Present
angolare	None
scandalizzando	Present
assodati	None
citarsi	None
sventate	Present
corriti	None
diffidati	None
finanziarono	Past
scendi	Present
rinsaccasti	Past
accalappia	Present
sferzate	Present
riuscirebbe	None
rinegoziato	Past
mascherava	Past
officiarono	Past
formula	Present
visualizzato	Past
istituivano	Past
vacare	None
circuire	None
cartografa	Present
dovrete	Future
confluisci	Present
pretrattai	Past
accarezzare	None
ricomporre	None
soggiornasse	Past
accomodate	Present
fiaccarono	Past
vegeta	Present
pattuglierebbero	None
sgrugna	Present
monitorizzeranno	Future
morire	None
cospargere	None
riepilogare	None
compararono	Past
toccherebbe	None
sobbollivi	Past
ondeggiare	None
ascrivere	None
convincevano	Past
beccano	Present
abbatti	Present
permetterete	Future
vorremmo	None
aggiustiamoci	None
privilegiare	None
toccando	Present
riberrebbe	None
trafugano	Present
rincuorare	None
allestite	Present
agguantò	Past
autotrapianto	Present
separava	Past
illustrassero	Past
galleggiavano	Past
disseppellire	None
intitolate	Present
queto	Present
deportate	Present
ammassicceresti	None
defascistizzando	Present
liberando	Present
trasmetterà	Future
ingannare	None
riesumato	Past
rispettò	Past
ritraggano	Present
scoraggino	Present
avvolgevano	Past
sfaccendando	Present
ordinò	Past
riconciliano	Present
affossare	None
intrappolerebbe	None
pregiudicherà	Future
datato	Past
esiliare	None
commise	Past
sovrappongono	Present
transistorizzasse	Past
sconsigliava	Past
permetterei	None
privatizzato	Past
sgozzare	None
guariscono	Present
annunziante	Present
meriterebbe	None
spicciolavamo	Past
biografiate	Present
incarta	Present
mingere	None
estenderebbero	None
siglare	None
screpolate	Present
gasato	Past
partiva	Past
preferivo	Past
sfeltravo	Past
peggiorerebbe	None
suffondessero	Past
indicavi	Past
utilizzino	Present
spedì	Past
accorciano	Present
agire	None
mostrati	None
prescrissero	Past
sottoponeva	Past
prescindono	Present
riesaminare	None
svergognare	None
annullerebbe	None
ritroverebbe	None
imputassimo	Past
travalicheremmo	None
redigere	None
impaludasse	Past
pubblicizzo	Present
ricondizionavo	Past
stringere	None
imparentò	Past
suffisserà	Future
manipolano	Present
fidiamoci	None
prodigò	Past
adunare	None
poggiava	Past
elaborare	None
reperire	None
stazionano	Present
litigando	Present
maciullo	Present
scoppia	Present
ruotavano	Past
cannare	None
chiacchierano	Present
imbustasti	Past
sgorgare	None
denoterebbe	None
tramavano	Past
restituisce	Present
cianceremo	Future
scaglionato	Past
avventarsi	None
deflorare	None
abdicano	Present
coccolo	Present
informatizzati	None
polverizzare	None
esploravano	Past
picco	Present
specializzandosi	Present
ricapitare	None
assoggettati	None
dissecherebbe	None
condannava	Past
generalizzare	None
allesseremmo	None
circondarsi	None
ghigliottinerete	Future
robotizzarsi	None
iniziarsi	None
sfoggiare	None
nascondevo	Past
rateo	Present
ostruite	Present
immusonitevi	None
tirava	Past
comprimere	None
dislocavano	Past
penseresti	None
ammanetta	Present
imbeccato	Past
suonerebbe	None
promesso	Past
pubblichino	Present
prescindere	None
infossate	Present
risuonava	Past
rimangia	Present
rinzaffo	Present
trasfuse	Past
gloriassero	Past
clono	Present
coricarsi	None
carambolante	Present
sovrascrivevi	Past
ripurgherete	Future
zono	Present
bolleresti	None
sigillarono	Past
abballottatevi	None
accontentati	None
collegherebbe	None
sbendava	Past
catturavano	Past
succede	Present
congeleremo	Future
concertare	None
aggrego	Present
dotarsi	None
sincereresti	None
soprasseduto	Past
belano	Present
informasse	Past
tollerare	None
trasmutando	Present
pensassimo	Past
commetterebbe	None
implodano	Present
fallai	Past
spaziarono	Past
rivedranno	Future
predicente	Present
rapportando	Present
denudate	Present
regolarizzare	None
sottocapitalizzerai	Future
accontenterebbe	None
esalerai	Future
sradicati	None
umiliati	None
facilitavano	Past
sfondava	Past
devolverò	Future
tarpare	None
ingolfai	Past
riferisco	Present
assembravi	Past
boicottò	Past
predominarono	Past
sgarra	Present
intabarrati	None
arricchì	Past
telefonino	Present
riscontrare	None
transenna	Present
inserire	None
terrazzano	Present
baloccarsi	None
complimentava	Past
offendano	Present
rientrante	Present
frenarsi	None
citassero	Past
accostava	Past
separo	Present
compendiò	Past
gramola	Present
pentiti	None
pronunziati	None
circonfondono	Present
fingano	Present
ricresciuto	Past
intuire	None
schiafferemmo	None
nitrifico	Present
lascare	None
appuntate	Present
concordare	None
esterificato	Past
indurrebbe	None
ravvivati	None
risolvendo	Present
contrattaccando	Present
tramandassero	Past
affiliati	None
trasferisciti	None
naufragarono	Past
rimorso	Past
decidesse	Past
intersecate	Present
abbassare	None
controfirmare	None
figgevamo	Past
latiterei	None
pungolare	None
scindersi	None
istituzionalizzo	Present
diminuisce	Present
scostati	None
innamorare	None
sdrucciola	Present
ricreate	Present
pendolino	Present
subentrando	Present
controbilancerebbero	None
disconnetti	Present
interrogheranno	Future
degradò	Past
ricerca	Present
accessorino	Present
venerava	Past
occorressero	Past
razionalizzando	Present
sopravveniente	Present
dissigillassimo	Past
rovineranno	Future
deviscererebbe	None
distorcendo	Present
regolamentare	None
corteò	Past
astenne	Past
cedere	None
spizzichino	Present
coesistevate	Past
ricreò	Past
ponevano	Past
scapito	Present
uccidere	None
espropriare	None
ritrassero	Past
distribuire	None
scongelati	None
autoproclamati	None
ordiscono	Present
creare	None
centralizzò	Past
disinvolge	Present
giuntavamo	Past
insignito	Past
rincoraggio	Present
osano	Present
incastrarono	Past
contrariò	Past
sapesse	Past
vagliano	Present
ribadiva	Past
affermato	Past
addestravano	Past
arroso	Present
ritoccando	Present
morivano	Past
sbozzerebbe	None
infibulassimo	Past
propendeva	Past
toccate	Present
deterresti	None
regnando	Present
completa	Present
sperò	Past
scadevano	Past
involtasti	Past
saprebbe	None
minare	None
svirilizzo	Present
inneggiarono	Past
possiedi	Present
stivare	None
riconoscerete	Future
transfondendo	Present
smottavate	Past
preferirei	None
allocato	Past
filtrava	Past
criminalizzano	Present
addizionato	Past
radunati	None
tingeresti	None
allentate	Present
disinstallassimo	Past
renderesti	None
degraderebbe	None
esplicò	Past
sintetizza	Present
suicidarsi	None
ritento	Present
opprimereste	None
rifocillò	Past
votai	Past
piantatela	None
rincoglionire	None
ricombinarsi	None
immunizzante	Present
vigilano	Present
pietrificate	Present
andare	None
vagabondo	Present
lampeggia	Present
altereremmo	None
indignate	Present
surrogavi	Past
risuscitò	Past
accoglierebbero	None
bivaccando	Present
rimembrasti	Past
tossire	None
prolungano	Present
ormeggiati	None
arrischiati	None
scioperò	Past
sposano	Present
amplificando	Present
imbavagliato	Past
dedurrò	Future
reincontra	Present
permeano	Present
avvitare	None
risico	Present
impiegate	Present
spruzzato	Past
aggruppati	None
abdicava	Past
sofistico	Present
impazzivo	Past
filtrò	Past
posare	None
parificato	Past
annunciati	None
sorbettava	Past
imbronciva	Past
affiatate	Present
inchinarono	Past
complesse	Past
comprimendo	Present
trascinarono	Past
autoconsumo	Present
lesionatevi	None
svasato	Past
soffio	Present
accomodarsi	None
reimportante	Present
commissionando	Present
disinnescate	Present
candidano	Present
rinviando	Present
intascando	Present
fluttuarono	Past
shoccato	Past
pizzicheranno	Future
fissassero	Past
prezza	Present
ebere	None
turano	Present
ripercorre	Present
disattendere	None
inficiato	Past
sentenziare	None
gratta	Present
precaricavo	Past
analizzati	None
disconnetterete	Future
imparentati	None
ricelebro	Present
rinsaldarsi	None
ricorre	Present
dipendeva	Past
doppia	Present
radono	Present
accadessero	Past
ricaccia	Present
scioperare	None
affacciare	None
rimpiallacciava	Past
ingombrante	Present
riformulano	Present
giuntate	Present
accrescersi	None
rumoreggiare	None
riamate	Present
attiverà	Future
educati	None
trabevessimo	Past
sponsorizzavano	Past
scorporò	Past
scrivete	Present
replicati	None
assopisciti	None
epurò	Past
patire	None
schizzettassimo	Past
diventò	Past
stragodrei	None
consapevolizzeresti	None
zuppano	Present
decadeva	Past
plagiando	Present
trascinati	None
manomettendo	Present
intessere	None
liberarono	Past
fermentammo	Past
rapivano	Past
espressero	Past
aiuteremo	Future
rivoliate	Present
agevolino	Present
sghignazzante	Present
filerebbe	None
rammaricarsi	None
rivivificherebbero	None
sovverte	Present
convitato	Past
intervistare	None
passerei	None
cristianizzò	Past
abusare	None
sovrasterzo	Present
ridanno	Present
arbitrò	Past
riabilitati	None
commisi	Past
sfocare	None
assottigliava	Past
codifica	Present
domiciliamoci	None
contagiarono	Past
esprimere	None
dolersi	None
assestarsi	None
migliorerei	None
basculerete	Future
codificando	Present
discuteranno	Future
prefigurate	Present
tramuterà	Future
omesso	Past
stilizzerebbe	None
celano	Present
onora	Present
commetterà	Future
scatenarsi	None
concordino	Present
parafrasa	Present
estorse	Past
defraudato	Past
abbronzava	Past
ammassò	Past
sventare	None
rigermoglierai	Future
disse	Past
malversano	Present
assoggettasti	Past
sorvolarono	Past
conculcasse	Past
sottopongo	Present
stressare	None
scalpelliate	Present
assicurerebbe	None
aggiudicherà	Future
arsero	Past
telematizzasse	Past
radicò	Past
correggereste	None
possedevamo	Past
tiravano	Past
sfiorite	Present
detenevano	Past
comprati	None
conteggiò	Past
potendosi	Present
sottopagate	Present
indicherò	Future
impiegherebbe	None
gravare	None
altalena	Present
obiurgherebbero	None
tepefeci	Past
dopo	Present
reinserirò	Future
proscrivere	None
amplifichiate	Present
ulcerare	None
amoracciante	Present
discendere	None
valuta	Present
sperperato	Past
schiaccio	Present
accomodatevi	None
gronda	Present
pascersi	None
contraddice	Present
decentralizzare	None
ideologizzò	Past
assemblati	None
invade	Present
fondare	None
tappezzato	Past
palpiteranno	Future
contendente	Present
solfate	Present
celerebbe	None
scommettevano	Past
oscurati	None
sbiadirai	Future
masturbante	Present
voro	Present
ripubblicando	Present
bisboccia	Present
rimpiazzando	Present
brillare	None
approfitterà	Future
rimprovererà	Future
rallenta	Present
scelgono	Present
ardire	None
sfrucuglierebbe	None
sostituissero	Past
disperderò	Future
radicandosi	Present
disconobbe	Past
mobilitati	None
trapelate	Present
mutuano	Present
sopravvengono	Present
mostrandosi	Present
infornarono	Past
godere	None
marino	Present
wikificando	Present
ridisciplinassimo	Past
tracciante	Present
rieleggerò	Future
postillerei	None
togliendosi	Present
mortificati	None
alloggeranno	Future
soggettivo	Present
piombino	Present
perequare	None
ridiscutere	None
gettandosi	Present
liberano	Present
acquerellavamo	Past
discolperesti	None
esaltarsi	None
lardavano	Past
traghettare	None
istruire	None
complesseresti	None
precaricavate	Past
abborracciava	Past
aggirarsi	None
riponeva	Past
darebbe	None
assibiliate	Present
riverniciare	None
incrinando	Present
accampandosi	Present
trascendere	None
promulgano	Present
concorre	Present
precludendosi	Present
scartellando	Present
apparenterei	None
imbrattare	None
chiesto	Past
concimate	Present
indicavo	Past
deturpare	None
equilibrereste	None
squaglierò	Future
espugnate	Present
ricostruì	Past
ritrasmette	Present
alzati	None
svello	Present
sgasarono	Past
perturbare	None
ingrassasse	Past
georeferenziare	None
conclamate	Present
incravattante	Present
ammaestrare	None
vincolare	None
spazzare	None
affaticare	None
pensarsi	None
rifuggono	Present
tramontando	Present
palesò	Past
acquerellate	Present
ritardato	Past
giurandosi	Present
doppiava	Past
rastrellino	Present
riferirebbe	None
fissante	Present
cavillando	Present
lavoreremo	Future
arrenderà	Future
presiedeva	Past
cooperante	Present
tendesse	Past
rapire	None
rinvenivano	Past
incastra	Present
solette	Past
rompendosi	Present
usante	Present
pronosticò	Past
standardizzate	Present
collaborerà	Future
approderà	Future
paragonare	None
deregolavate	Past
perdonano	Present
combaciava	Past
prepossono	Present
risale	Present
sfoggiato	Past
equiparate	Present
barricate	Present
sanitizzasse	Past
infittendo	Present
accede	Present
immobilizzare	None
visualizzare	None
depolarizzante	Present
assegnavano	Past
cancellati	None
caduca	Present
giréste	None
retrocesse	Past
secreta	Present
provengono	Present
singhiozzare	None
croccolare	None
divorasse	Past
flettentesi	Present
ghigliottineresti	None
postulando	Present
motivano	Present
acquerelleremmo	None
intriga	Present
rinunzieresti	None
iterato	Past
inginocchiarsi	None
abbocca	Present
torturava	Past
incentivare	None
pescherà	Future
convivevano	Past
richiusi	Past
eviterebbe	None
prenotava	Past
sloggato	Past
inalbero	Present
atrofizza	Present
risparmiavano	Past
trucidare	None
ballava	Past
ristagnando	Present
somministravano	Past
ferite	Present
improvvisato	Past
retribuire	None
recideva	Past
mescere	None
sparsi	Past
banalizzando	Present
cliccare	None
avvento	Present
secare	None
immortala	Present
biforcati	None
utilitate	Present
screditava	Past
riconnettono	Present
additivo	Present
fracassa	Present
intervennero	Past
castrare	None
meriggio	Present
macellate	Present
rinnegare	None
chiosando	Present
proteggevano	Past
sottocapitalizzavi	Past
trilla	Present
cessante	Present
fidanza	Present
badavate	Past
ipotecassimo	Past
scavava	Past
reclamizza	Present
testato	Past
posarsi	None
bastato	Past
umiliante	Present
sbarravano	Past
tonificavate	Past
coreografo	Present
incasinate	Present
manifestati	None
zaffo	Present
tentennare	None
rafforzerebbe	None
infischiandosene	Present
rigermogliava	Past
divideremo	Future
racchiusi	Past
dinoccherete	Future
scatenante	Present
annunzia	Present
decadente	Present
rimorchiano	Present
ingurgitare	None
incepparsi	None
digitalizzerebbero	None
deossidavate	Past
azzeccano	Present
istigano	Present
deporranno	Future
inibì	Past
girino	Present
scontato	Past
protendendosi	Present
cenerò	Future
rinato	Past
psicanalizzare	None
alterante	Present
scomunicate	Present
elencherà	Future
ruzzolare	None
rosseggiante	Present
gradire	None
scrutare	None
infangati	None
soggiogare	None
interpretante	Present
ripassato	Past
pretendi	Present
rinvigorire	None
speronante	Present
riagguantano	Present
risommerò	Future
discostarsi	None
rimorchiò	Past
deidrogenò	Past
perderai	Future
glorificava	Past
indicherebbe	None
campiona	Present
arretrate	Present
disinfettante	Present
fregarsene	None
riprogrammerete	Future
ripulirono	Past
assottigliavano	Past
commisurasti	Past
accluse	Past
lobotomizzato	Past
rieseguirebbe	None
recati	None
imbecchino	Present
incendiando	Present
rafforzano	Present
gravato	Past
gironzolano	Present
intervieni	Present
barrare	None
incassate	Present
raffazzonate	Present
ingolosivate	Past
piantereste	None
spamma	Present
sciaborderò	Future
confutino	Present
somministrare	None
deputato	Past
cucinerà	Future
spettegolereste	None
estinguendo	Present
comprometterà	Future
esaltante	Present
opprime	Present
spezzerebbe	None
interesserebbe	None
recuperava	Past
riconoscevamo	Past
commettendo	Present
curano	Present
riproteggere	None
scordarsi	None
abbambinerà	Future
sfruculieremmo	None
ansano	Present
rimpiazzare	None
tagliante	Present
preferiremmo	None
avarierà	Future
impartendo	Present
svuotasse	Past
spargesse	Past
dispensano	Present
ossigena	Present
cuocevano	Past
copiaincollassimo	Past
sfrondate	Present
ipotizzavo	Past
disonorati	None
spandersi	None
assestano	Present
sbollentare	None
lacerarsi	None
schiaffare	None
cavarsi	None
riprodurre	None
detesto	Present
fomentavano	Past
giovava	Past
murare	None
cadessero	Past
brinda	Present
cartografato	Past
intavolavo	Past
metastatizzare	None
digiterà	Future
fertilizzano	Present
disquisire	None
centrino	Present
esonda	Present
precaricare	None
vigilato	Past
rubacchieranno	Future
dimezzarono	Past
impantanarsi	None
bomberai	Future
tarmeresti	None
attribuisco	Present
disillude	Present
funzionate	Present
ammazzando	Present
secheremo	Future
recingono	Present
taroccare	None
preparati	None
accoglie	Present
sopravvenuto	Past
accerchiarono	Past
meritavano	Past
rammentati	None
intesse	Present
disinserito	Past
strumentalizzate	Present
propagati	None
svincolati	None
interferiscono	Present
incentrarono	Past
demarcherebbe	None
invertente	Present
sbraita	Present
distanziando	Present
travalicare	None
incagliare	None
rinculchiate	Present
calcio	Present
alitavi	Past
ramai	Past
redistribuirebbero	None
incominciarono	Past
listate	Present
cartellineremo	Future
ramazzare	None
restituivano	Past
valutate	Present
lucchettare	None
morde	Present
cimentandosi	Present
abbordare	None
trascurano	Present
sermoneggerebbero	None
decremento	Present
paracadutarono	Past
brindare	None
sfarinammo	Past
scimmieggiasti	Past
scombussola	Present
testare	None
porrebbe	None
raspano	Present
risolidificasti	Past
tartaglino	Present
raggiustare	None
quotante	Present
arrivò	Past
fabbricare	None
svestite	Present
dileggerebbero	None
promossero	Past
iniziarono	Past
obliterando	Present
consigliava	Past
trasvolare	None
disperati	None
regredisce	Present
predefinirei	None
bisognante	Present
diffondere	None
promuovere	None
riprendeva	Past
tralasciando	Present
ravviluppatevi	None
volturino	Present
dragare	None
destinando	Present
grigliare	None
sovrapponendosi	Present
graduerai	Future
strapiomba	Present
magnino	Present
piegarono	Past
abbassò	Past
piantavi	Past
svelerà	Future
sfangarono	Past
circonducente	Present
infiora	Present
sovrastato	Past
umettate	Present
caricavano	Past
peggiorasse	Past
sfangavate	Past
escludeva	Past
inchino	Present
martirizzo	Present
dedicate	Present
provennero	Past
individuino	Present
sanitizzasti	Past
baciando	Present
dilaterò	Future
allestendo	Present
sburrando	Present
decorrere	None
peccavi	Past
torna	Present
importava	Past
disavvezzantesi	Present
riasfalteresti	None
insisterei	None
cimenterà	Future
concorrono	Present
leggiucchiando	Present
discusso	Past
consulterà	Future
contraente	Present
scriminassimo	Past
perlustro	Present
dimorerà	Future
sorseggio	Present
credettero	Past
appaltò	Past
ricalco	Present
maritò	Past
imprimendo	Present
disinvestiremmo	None
cammina	Present
travestiti	None
mobilizzarono	Past
retrodatano	Present
rilavorato	Past
pitturati	None
braccare	None
proporre	None
interlineare	None
sfornato	Past
occupante	Present
integrerei	None
reinterpretate	Present
accovonerà	Future
stallino	Present
includerei	None
augurino	Present
escogitarono	Past
cavalcare	None
risparmiati	None
riproduceva	Past
teorizzavano	Past
piangevano	Past
abbruciano	Present
rassegnare	None
abbracciare	None
arretrava	Past
surclassano	Present
constatando	Present
ribellerà	Future
riattraversare	None
risveglierà	Future
sparsero	Past
trainarono	Past
accanirsi	None
curvava	Past
contemplare	None
barattò	Past
estendesse	Past
omaggerò	Future
oltrepassando	Present
intimorendo	Present
ringrazieranno	Future
avvallato	Past
rimani	Present
riceverebbe	None
avverarsi	None
strisciare	None
scadettero	Past
ravvilupperà	Future
sciacquereste	None
rassegnarono	Past
ridesta	Present
pronuncio	Present
incolonnati	None
continuano	Present
integrante	Present
tributato	Past
arrivare	None
rientrano	Present
ripiegò	Past
capovolgemmo	Past
dipingeva	Past
addossava	Past
faticò	Past
impestino	Present
paiono	Present
riporterò	Future
ritenevi	Past
sgrassare	None
confondevo	Past
pungetevi	None
sbarrare	None
appanna	Present
scampanerebbe	None
oppongano	Present
intrappolare	None
traslittererei	None
paragonano	Present
bandite	Present
sbizzarrisce	Present
rivolere	None
bruciacchiassero	Past
cozzammo	Past
sancì	Past
quietare	None
galoppa	Present
reincontro	Present
giudicava	Past
dilazionato	Past
armandosi	Present
ubbidivano	Past
acconciati	None
accorciò	Past
annega	Present
canticchiato	Past
rinsaldando	Present
atterrisse	Past
venendo	Present
ozio	Present
riverberati	None
assegneranno	Future
approfondiranno	Future
relazionò	Past
sanificherebbero	None
disintegrerà	Future
palante	Present
estendendo	Present
spopolando	Present
congratulano	Present
rastremate	Present
sopperito	Past
appropria	Present
infiltrava	Past
traslarono	Past
riporterebbe	None
brandire	None
spettando	Present
bestemmiava	Past
rimisureresti	None
contraddistinguano	Present
esigette	Past
disvarreste	None
agerò	Future
tutelare	None
lisciare	None
seppellire	None
accumulare	None
esploderanno	Future
aggirati	None
convincendosi	Present
rifiorirà	Future
allertate	Present
candiderò	Future
affidarsi	None
sottolineò	Past
ruotante	Present
tesserate	Present
sperimenta	Present
dettando	Present
demineralizzò	Past
maramaldeggeranno	Future
assoldare	None
gemellato	Past
immergiamoci	None
abbrutisti	Past
brunite	Present
rassetteremo	Future
fugò	Past
conturba	Present
ritenersi	None
ereditò	Past
sperimentasse	Past
disboscare	None
traghetto	Present
dinoccoleremmo	None
vagare	None
schiaffeggia	Present
riducesse	Past
sacrificherebbe	None
slega	Present
laudando	Present
salparono	Past
anticipato	Past
riprovano	Present
avvelenati	None
palpare	None
accollano	Present
conferire	None
dispiacere	None
implicando	Present
mischiavano	Past
degustano	Present
rispecchia	Present
artigliassimo	Past
arrosassimo	Past
sprotegge	Present
adattano	Present
rovinano	Present
scarterai	Future
parvero	Past
disfacendo	Present
riselezionò	Past
vagheggia	Present
proponendo	Present
scaveranno	Future
intrattiene	Present
precorrerebbe	None
carica	Present
caramellizzasti	Past
riaumentare	None
fluivano	Past
ovviare	None
esplode	Present
innamoreranno	Future
indurammo	Past
suturato	Past
evincerà	Future
compenetrati	None
grattarsi	None
affiderei	None
dividendo	Present
contaminerei	None
denigrare	None
frastornerebbero	None
smitizzare	None
trascrive	Present
modificheranno	Future
marmorizzato	Past
acutizzereste	None
addestrò	Past
evocare	None
ingessato	Past
controllassero	Past
esasperare	None
osserverebbe	None
impugnava	Past
rimpiazzano	Present
intromise	Past
lottando	Present
oberereste	None
qualificando	Present
dispensa	Present
inserisce	Present
oggettualizzo	Present
salvava	Past
consigliassero	Past
pronunciassero	Past
riequilibrare	None
detorcano	Present
accreditati	None
esagerare	None
fermavano	Past
supplico	Present
smidollato	Past
sorbirebbero	None
intervistano	Present
conclamato	Past
sterminò	Past
menava	Past
contrattando	Present
tombolante	Present
salvaguardando	Present
rassettare	None
scoprii	Past
gridano	Present
demoralizzarono	Past
avviammo	Past
descriverà	Future
stappate	Present
anticipare	None
barellerò	Future
attraversavano	Past
ripetersi	None
oscillavano	Past
aggregare	None
aita	Present
erediterebbe	None
guariva	Past
affondano	Present
toppo	Present
volgevo	Past
spariscano	Present
apprese	Past
sventra	Present
intendersi	None
normare	None
lumeggiavate	Past
riabbracciamoci	None
vantati	None
fallerei	None
temere	None
richiama	Present
giurati	None
popolarizzare	None
imbevevi	Past
rispegno	Present
intuberei	None
profondere	None
incorporo	Present
emozionarsi	None
attorniavano	Past
latineggiassero	Past
appuntarsi	None
ingarbugliare	None
lucidando	Present
inasprirsi	None
formalizzano	Present
preventiverà	Future
adergiate	Present
avventurare	None
intervallati	None
padreggeranno	Future
paragrafare	None
ristabilite	Present
issarsi	None
esaminavano	Past
confabulano	Present
consegnare	None
vicariato	Past
spendete	Present
ambia	Present
fotocomporrete	Future
rimarginatevi	None
intraprendente	Present
spacciare	None
ragionare	None
sproloquieranno	Future
sfasceresti	None
classificando	Present
chioda	Present
scanseresti	None
lanciassero	Past
videochattavo	Past
risorgerà	Future
ristora	Present
incorniciare	None
attentarono	Past
reimparare	None
solere	None
addormentarsi	None
reagendo	Present
sagginano	Present
sviando	Present
risorgessimo	Past
reclamizzano	Present
eiettai	Past
fraintese	Past
stendersi	None
italianizzò	Past
prevalso	Past
spingono	Present
soprannominato	Past
arroccò	Past
divagando	Present
frangere	None
irraggiarono	Past
oserai	Future
infoltire	None
consigliarsi	None
riallacciavano	Past
riemettono	Present
mappare	None
inverdivate	Past
addormenterà	Future
rasati	None
scarno	Present
burocratizzare	None
traesse	Past
pascolato	Past
allenate	Present
riaggiustare	None
rispecchieresti	None
scaccia	Present
riavvicina	Present
infesterebbe	None
fluidizzato	Past
computate	Present
ristagna	Present
pareggerà	Future
scongiurare	None
spadroneggiare	None
storteremmo	None
giustificati	None
burlare	None
sottendono	Present
lasciamoci	None
rassicuro	Present
stanare	None
roncoleremo	Future
accusarsi	None
umiliarono	Past
avanzantesi	Present
imputare	None
purificava	Past
appaltate	Present
terse	Past
arrotondate	Present
moderarono	Past
sarchiellai	Past
spiazzare	None
vietando	Present
simbolizzava	Past
scekerassimo	Past
ammantano	Present
sommergendo	Present
slego	Present
riesaminato	Past
avvezzarono	Past
contrattaccare	None
imbrecciarono	Past
temendo	Present
riformulerei	None
burlerà	Future
oltraggiato	Past
preregistrato	Past
giudicavano	Past
ridicolizzando	Present
ricalcolare	None
etichettava	Past
precorrerei	None
rievocare	None
risaltò	Past
guadava	Past
differenziandosi	Present
allattare	None
imbarcati	None
sfasciare	None
calpestato	Past
effettuo	Present
travasa	Present
sindaco	Present
incavo	Present
rigirò	Past
giovando	Present
pettinati	None
debutterà	Future
chiarendo	Present
stare	None
mischiati	None
raggiungevano	Past
intitolerà	Future
arrampico	Present
dovrebbe	None
impregnati	None
architettato	Past
cristallizzare	None
stigmatizzate	Present
azoto	Present
padroneggiavano	Past
ravvedersi	None
disincrostarsi	None
facilitino	Present
provarsi	None
insilato	Past
scaglio	Present
ricombinavano	Past
sconforto	Present
aspettare	None
indugiarono	Past
biografo	Present
insegue	Present
deferente	Present
disertavano	Past
sprimaccino	Present
revocato	Past
provocherebbe	None
pesare	None
scuserai	Future
tripartiranno	Future
scarificai	Past
appropinquavo	Past
fruttavano	Past
dirigeranno	Future
ridestare	None
carpisce	Present
stazionerebbero	None
orripilato	Past
riferiva	Past
festeggio	Present
sottovalutando	Present
corrugati	None
pagheremo	Future
concretizzava	Past
disputandosi	Present
convivessero	Past
attirate	Present
diradarsi	None
disaccordavi	Past
profitta	Present
rinverdendo	Present
spiccava	Past
oppilassero	Past
suggellato	Past
realizzino	Present
lucchetta	Present
rispecchierebbe	None
impaccate	Present
ordinando	Present
ricongiungere	None
dispari	Present
sbloccavamo	Past
scambiassero	Past
slargati	None
infatuavamo	Past
imbullonavate	Past
pregiudicherebbe	None
rispondendo	Present
incazzarsi	None
rimbarcai	Past
sterminarono	Past
asservendo	Present
scrivesse	Past
strumentalizzare	None
orchestrarono	Past
turassero	Past
imploravate	Past
curati	None
unirebbe	None
vegetato	Past
schierando	Present
contraffatti	None
impietrito	Past
inciampa	Present
attardati	None
leccate	Present
conteggiano	Present
supereranno	Future
inchiodati	None
disciogliere	None
maneggiando	Present
palatalizzate	Present
dissolsero	Past
addestrarsi	None
propendere	None
allenarsi	None
customizzerò	Future
apprendo	Present
infrangere	None
frodare	None
svolvevo	Past
spoliticizzavano	Past
estasia	Present
appaltavano	Past
esfoliante	Present
esulava	Past
trucidò	Past
invadono	Present
travolgendo	Present
porrai	Future
interrogando	Present
depolarizzato	Past
irrorate	Present
rotondeggiante	Present
immaginavano	Past
invertono	Present
inverminire	None
suddivido	Present
daranno	Future
paragonando	Present
tramortire	None
sbollii	Past
difettino	Present
crittare	None
digitalizza	Present
miticizzerebbero	None
risolverebbe	None
squarciare	None
accondiscese	Past
salperebbe	None
controminando	Present
moveresti	None
riabilitate	Present
esperisci	Present
rigonfiare	None
stagionare	None
impressionante	Present
restituisco	Present
componendo	Present
scavato	Past
alziamoci	None
decontaminino	Present
etichetta	Present
articolava	Past
raffigurerà	Future
osannare	None
mimetizzare	None
sposavano	Past
aiutano	Present
avviserò	Future
immigrai	Past
stereotipo	Present
inzeppare	None
limitava	Past
intercedette	Past
basarsi	None
acclimando	Present
attaccassero	Past
immigrante	Present
cementati	None
vaglia	Present
ubbidiscono	Present
schematizzare	None
suolavate	Past
ridimensionando	Present
segnavano	Past
asciugandosi	Present
tramestando	Present
varcherà	Future
abbriviavano	Past
redistribuire	None
scartinavo	Past
coalizzati	None
ratificando	Present
prorogava	Past
disertarono	Past
somministrato	Past
consumare	None
appurerebbero	None
arrotino	Present
assomiglierà	Future
sparpagliarsi	None
avventurereste	None
catalogò	Past
abbacinerei	None
risistemate	Present
risvolgente	Present
protraendosi	Present
inietterà	Future
annitrissero	Past
rigurgitare	None
affiorate	Present
cadere	None
idolatrando	Present
revisionate	Present
impedirebbero	None
rottamare	None
scoreggiai	Past
contrapporre	None
assumevo	Past
presunto	Past
sovrabbondante	Present
contraddiceva	Past
reclamano	Present
concessi	Past
restituirebbe	None
segnava	Past
appassire	None
inizierebbero	None
infrangerà	Future
calma	Present
bruciarsi	None
bighellonare	None
cumulo	Present
economizzare	None
spettinati	None
avviò	Past
nomineranno	Future
laurearsi	None
avvoltolai	Past
contattare	None
scindendosi	Present
formeranno	Future
esagerava	Past
ipotecarono	Past
spendendosi	Present
configura	Present
amareggiati	None
ricaricherò	Future
travestendosi	Present
restammo	Past
smerigliato	Past
rimarginare	None
militarizzeresti	None
visitava	Past
vedendosela	Present
contestualizzerei	None
sabbio	Present
attenuerà	Future
inquadrati	None
continuerebbero	None
istituiva	Past
sforna	Present
camuffando	Present
metallizzavamo	Past
accomoda	Present
ampliati	None
rateizzando	Present
reindirizzino	Present
autoconvincersi	None
riconoscemmo	Past
cokifica	Present
tipizzeresti	None
disciplinando	Present
stupro	Present
scoccare	None
appaino	Present
nielleresti	None
trasgredisco	Present
controdatino	Present
minimizzando	Present
restituiva	Past
ricodificare	None
rovinerebbe	None
emaciati	None
formattare	None
chiazzate	Present
emendantesi	Present
signoreggeresti	None
autorizzerebbe	None
ostracizzare	None
farfugliare	None
pagherebbe	None
detenuto	Past
consolarsi	None
affrettare	None
guarderei	None
contrassegnavano	Past
usolerei	None
perequeranno	Future
incitassero	Past
ramingare	None
risvolgevo	Past
esulavano	Past
normalizzare	None
incrinarsi	None
slargavano	Past
torturarsi	None
raggruppassero	Past
scaldarsi	None
schioccare	None
rifugiati	None
ribollire	None
palesantesi	Present
anastomizzano	Present
acquietarono	Past
cesso	Present
osculo	Present
meravigliato	Past
confluiranno	Future
sconfinato	Past
dilaniano	Present
rovinino	Present
visionano	Present
complicare	None
svirilizzano	Present
prenditela	None
striminzite	Present
incoronato	Past
risultavano	Past
frisse	Past
sottolineerebbero	None
pretendessimo	Past
sfaccettate	Present
contenete	Present
rimetteva	Past
raccordati	None
sbriciolano	Present
normando	Present
scordiate	Present
rammentano	Present
scelsi	Past
soffermarsi	None
monopolizzando	Present
accodò	Past
avvalorano	Present
predilessero	Past
spengano	Present
strombazzeremmo	None
tramezzo	Present
sperate	Present
autodistruggere	None
radiomarcheremmo	None
transfonderei	None
difetterebbe	None
maritino	Present
ruggendo	Present
metteteci	None
tarocchino	Present
dissacrano	Present
oggettivarsi	None
sforbiciare	None
scolpì	Past
compiersi	None
titubare	None
diventassero	Past
rapì	Past
sbattendosene	Present
indossa	Present
manualizzasti	Past
istituzionalizzò	Past
azzurra	Present
ridefinirono	Past
snodavano	Past
comprasse	Past
riferiscono	Present
migliorati	None
maturati	None
sbaragliando	Present
dimezzante	Present
impigliarsi	None
editava	Past
commercializzare	None
crashai	Past
ascrivono	Present
deduci	Present
riscontrate	Present
dotasse	Past
persisterebbe	None
induce	Present
arringò	Past
permanente	Present
dirigevo	Past
attorniano	Present
identificherebbero	None
concepiva	Past
angoscia	Present
prosterno	Present
figlio	Present
esaltati	None
arretrano	Present
arringa	Present
definiremmo	None
inseguendo	Present
espulso	Past
sacralizzava	Past
mandare	None
dischiudere	None
scartabello	Present
incazzano	Present
reclamizzare	None
ingegnerizzare	None
spartirebbero	None
pubblicizza	Present
marginalizzare	None
rama	Present
adunati	None
reincarnandosi	Present
infiamma	Present
riservare	None
ribatto	Present
tacitato	Past
risolverò	Future
esternò	Past
gratificare	None
insabbiarsi	None
ricongiungersi	None
disgustati	None
ombreggiare	None
zigzagante	Present
smitizzando	Present
scandalizzassero	Past
risolino	Present
incitare	None
ruotare	None
spiazzato	Past
dipinsero	Past
scontò	Past
registrarsi	None
delineavano	Past
catturato	Past
ottemperò	Past
acquisirebbe	None
ricomincerei	None
sceneggiò	Past
discredita	Present
resuscitate	Present
ristabilizzerò	Future
sanguinato	Past
cospiravano	Past
espungere	None
liberati	None
riposizionarsi	None
schiaffeggiare	None
inacidissimo	Past
macchio	Present
riemerge	Present
catapultarsi	None
spiegherò	Future
dissuggellai	Past
trapassa	Present
sbrancati	None
riappropriandosi	Present
analizzava	Past
sgorghino	Present
sfiorati	None
decerebrato	Past
unii	Past
rialzarsi	None
ioduro	Present
mordete	Present
ammortizzante	Present
rinculerete	Future
lamentiamoci	None
realizzai	Past
ricomponevate	Past
barrato	Past
migrando	Present
scoccate	Present
davi	Past
influì	Past
raffigurava	Past
complicherebbero	None
infieriva	Past
rimodellando	Present
incoronate	Present
rifondevano	Past
estromettere	None
irraggiato	Past
fondarsi	None
bruciatevi	None
cesello	Present
zighereste	None
rimetterebbe	None
rivide	Past
tamponato	Past
ricombinerebbero	None
spezzarono	Past
sosterrò	Future
categorizza	Present
riposizioniamoci	None
autocontrarreste	None
disarticolare	None
pernotta	Present
suggella	Present
gironzolava	Past
cazziato	Past
rieleggevo	Past
manifesterebbero	None
specializzavano	Past
informando	Present
amministreranno	Future
intromettere	None
perseverando	Present
strapiombasse	Past
panano	Present
attempato	Past
rigermoglieremo	Future
scontrati	None
vanagloriatevi	None
paziento	Present
andrò	Future
messaggio	Present
indebolisce	Present
partorito	Past
sopì	Past
sarchiasti	Past
vivacizzerei	None
sostentare	None
creeremmo	None
saltellate	Present
scarabocchiare	None
decentrato	Past
trincerandosi	Present
alchilante	Present
equivalere	None
spezzava	Past
laconizzammo	Past
rassomigliava	Past
disprezzasse	Past
sfasare	None
imbarcammo	Past
innastante	Present
analizzai	Past
compenetrate	Present
infliggeranno	Future
innalzarsi	None
assistendo	Present
spogliamoci	None
trasdotto	Past
inoltrerà	Future
riappacificare	None
sclerosassimo	Past
riemettere	None
buca	Present
zigzagare	None
smantellato	Past
zipolo	Present
cacherai	Future
mortificarsi	None
sbaragliano	Present
asportò	Past
presiedei	Past
avvicinerebbe	None
formalizzare	None
sgusciassimo	Past
scolerete	Future
revisionò	Past
secernere	None
recherò	Future
guerreggerebbero	None
cronicizzare	None
occuperei	None
accentuando	Present
disproporzionerebbe	None
ricoverare	None
urlerà	Future
strutturare	None
modificati	None
corsi	Past
contribuirebbe	None
danneggiano	Present
azzittisco	Present
annettendo	Present
lenire	None
confermati	None
regima	Present
dormita	Past
confinare	None
irrompere	None
carenato	Past
sovraintendere	None
fidanzandosi	Present
suonare	None
spalancati	None
andrebbero	None
affievolite	Present
bilanciò	Past
alimentò	Past
insaccheremo	Future
aggiornerò	Future
fasciamoci	None
sottopassato	Past
fluttuante	Present
ammalatevi	None
stolto	Past
disarcionare	None
suffragavo	Past
attecchire	None
pappante	Present
litigò	Past
rilanciò	Past
renderai	Future
rincoglionissero	Past
impressi	Past
corteggiare	None
standosene	Present
dissecchiamoci	None
affezionati	None
riterso	Past
inghiaieremmo	None
socializzare	None
slanciarsi	None
fumino	Present
condividerei	None
licenziati	None
emanava	Past
procreeranno	Future
inchiappetteresti	None
sbarcò	Past
rifrange	Present
obiettavano	Past
urgenzavi	Past
formulava	Past
cementificano	Present
impacciato	Past
egemonizzare	None
trapano	Present
foraggiare	None
cospargemmo	Past
brutto	Present
camminante	Present
rammentiate	Present
scioperato	Past
veneravo	Past
riesprimere	None
roteante	Present
riavvisiate	Present
crocifissi	Past
sussistono	Present
raddrizzano	Present
maschietto	Present
sedato	Past
promossi	Past
limonare	None
sacrifica	Present
esulo	Present
interessati	None
preludevano	Past
rovistare	None
contraddistinse	Past
sponsorizzare	None
affiderebbe	None
risalissero	Past
ricevano	Present
purgante	Present
abbuffarsi	None
discompagnerò	Future
verbalizzerà	Future
dispiacerebbero	None
congeda	Present
ricadessero	Past
rivedete	Present
sommava	Past
incarcerare	None
accasciando	Present
sussistente	Present
sgorgò	Past
cumulate	Present
diseredando	Present
caricò	Past
saltare	None
ricomponeva	Past
iscrivevano	Past
vedici	None
sdraiare	None
proteggete	Present
solidarizzato	Past
dominarsi	None
bugno	Present
permarrà	Future
remava	Past
involgarisse	Past
ridefiniva	Past
anticonosceremmo	None
accolsero	Past
approvvigionarsi	None
denunceranno	Future
avverino	Present
strineremo	Future
sistemano	Present
altererebbe	None
volgarizzereste	None
sgozza	Present
intercorsero	Past
costituzionalizzerai	Future
arruolati	None
fruttificare	None
elitrasportato	Past
mercanteggerà	Future
scorporare	None
divezzassimo	Past
principiavamo	Past
schinciarono	Past
decidente	Present
funghiscono	Present
sedentarizzereste	None
scorcia	Present
alienano	Present
assesto	Present
scansionato	Past
renderanno	Future
districò	Past
cooptato	Past
guida	Present
gruga	Present
scartellerei	None
rosicchiante	Present
operano	Present
sabotare	None
terminerà	Future
affrancati	None
zoppino	Present
risiedere	None
intendevi	Past
retrarre	None
diffideremo	Future
gloglottavamo	Past
tutelavano	Past
inorpellerà	Future
riattaccano	Present
bacchio	Present
riducessero	Past
distrarre	None
precedere	None
linkerei	None
castigo	Present
ruzza	Present
sfregiassimo	Past
rimpastarono	Past
missino	Present
ferirebbero	None
pascolavano	Past
cabotassero	Past
addoghereste	None
sincronizzare	None
documentare	None
miniaturizzereste	None
respinge	Present
estromettendo	Present
ripresentando	Present
ramingarono	Past
locherei	None
aggruma	Present
attristammo	Past
rammaricò	Past
miticizzasti	Past
proseguirono	Past
ingigantirsi	None
figura	Present
bombardato	Past
redimersi	None
ornate	Present
adorneranno	Future
autoconsumerebbero	None
distorcere	None
paragonarono	Past
disorientati	None
raccapezzo	Present
smerdava	Past
ridiventando	Present
coesistettero	Past
rollando	Present
ridicolizzare	None
arrecavano	Past
scaraventasse	Past
invocavano	Past
colpissero	Past
accostumai	Past
filtrare	None
fermento	Present
rovesciano	Present
decretate	Present
prostituiva	Past
scrostati	None
avversarono	Past
imputò	Past
sgonfiando	Present
perseguitavo	Past
determinarsi	None
rafforzati	None
allungandosi	Present
paragono	Present
sfolgorante	Present
afferiva	Past
allontanarsi	None
riservarono	Past
ispirati	None
creeremo	Future
trisezionavi	Past
abbrevia	Present
lesioneresti	None
immettere	None
torturatevi	None
politicizzavate	Past
osculassero	Past
canticchiava	Past
indolenzivate	Past
vinsi	Past
scorda	Present
alterare	None
confluito	Past
sfaldò	Past
decongestionare	None
scannando	Present
rimpiazzavano	Past
baciamoci	None
sostituendo	Present
sorpassasse	Past
impigliandosi	Present
manderebbero	None
rioffendiate	Present
giacere	None
proclamarsi	None
scannerizzate	Present
incollasse	Past
risola	Present
difenderanno	Future
vanta	Present
scongiurano	Present
patrocina	Present
conglobate	Present
saboterò	Future
caggia	Present
intripperò	Future
riapplicheremo	Future
affaticati	None
costituite	Present
morimmo	Past
formulate	Present
esigere	None
sbandare	None
serrai	Past
apparentano	Present
infiggere	None
crespano	Present
suggerirebbe	None
tracima	Present
shakerasti	Past
esternalizzammo	Past
implementando	Present
tambureggerebbe	None
trapungerei	None
incavate	Present
assonando	Present
deprimersi	None
locassimo	Past
occorso	Past
arrendessero	Past
rincorrersi	None
griffate	Present
accattivarsi	None
imbudellavamo	Past
depolarizzerebbe	None
esclude	Present
detenente	Present
indicheranno	Future
saprò	Future
menziona	Present
asfaltare	None
evadendo	Present
volturo	Present
sorvegliante	Present
scendeva	Past
visualizzerà	Future
levati	None
latitare	None
avversò	Past
infliggono	Present
disinteressava	Past
bramo	Present
rallegrandosi	Present
rieleggi	Present
deflagra	Present
sballando	Present
ricoprente	Present
brasare	None
sgamato	Past
sondando	Present
smaliziavamo	Past
solfeggiavamo	Past
arrufferesti	None
reclamarono	Past
scheggiarsi	None
solarizzavo	Past
regredendo	Present
pressate	Present
citerebbe	None
regolamentavano	Past
pitturare	None
raggruppano	Present
dissolverà	Future
smistate	Present
indossare	None
riamato	Past
estingueva	Past
intronato	Past
incendiare	None
logorarsi	None
fiancheggiato	Past
allucinante	Present
intascare	None
narcotizzano	Present
pungolato	Past
uncinato	Past
scollinano	Present
catapultati	None
attrappissero	Past
risoneremo	Future
rimonta	Present
vegetano	Present
sfiorare	None
infestino	Present
sintetizzate	Present
danzante	Present
sottinteso	Past
denitrificheremo	Future
idratati	None
esibì	Past
bestemmio	Present
ammaccate	Present
magnetizzare	None
usando	Present
instradare	None
facciamocene	None
volevi	Past
diveniente	Present
rimorchiavi	Past
capta	Present
ammutai	Past
fracassò	Past
ravvilupperebbe	None
limo	Present
desinare	None
cicatrizzate	Present
urgenza	Present
mappate	Present
omise	Past
dividere	None
riformattare	None
strattonai	Past
coreografereste	None
alleviando	Present
impediscano	Present
redasse	Past
contiene	Present
sorteggiare	None
rivestono	Present
disputati	None
sopraffece	Past
sorvola	Present
riunente	Present
guizza	Present
vandalizzato	Past
fruga	Present
spiegherebbero	None
conduco	Present
intralciano	Present
disacidente	Present
conformati	None
sfiorisce	Present
accavalcherebbe	None
microfonerebbero	None
sconcertò	Past
cartografo	Present
covino	Present
spiccando	Present
stabilirà	Future
affiancandosi	Present
spostassero	Past
seduce	Present
occuperà	Future
bastonato	Past
morirebbe	None
coronerei	None
scomporrei	None
impianterà	Future
spancereste	None
sobbarcati	None
slegati	None
simbolizzano	Present
produrre	None
raggiungeranno	Future
svolgi	Present
modificarono	Past
battezzate	Present
staresti	None
riaggiornarono	Past
telefonarono	Past
riescì	Past
recapitò	Past
spiegherà	Future
spianarsi	None
sposerai	Future
decostruito	Past
capitolando	Present
esumate	Present
mettessero	Past
crocefiggevano	Past
ingoffiranno	Future
gestirsi	None
relazionarsi	None
strapiombassero	Past
gelificante	Present
suicidati	None
persuadentesi	Present
medaglio	Present
aderivano	Past
doterà	Future
assonino	Present
diffondersi	None
piovere	None
sposterà	Future
accertati	None
riscendere	None
efficientereste	None
fintato	Past
comprare	None
avvelenarsi	None
bistra	Present
illeggiadrisce	Present
sovradimensionate	Present
disturbavo	Past
scrivevano	Past
gradua	Present
accavallavano	Past
comprarono	Past
voltate	Present
selleremmo	None
deregolassero	Past
autotrasporterai	Future
perdonavano	Past
resistesse	Past
shunterei	None
alleggerendo	Present
abbordò	Past
tabacchino	Present
attivante	Present
denigrano	Present
decollarono	Past
inspirato	Past
tagliavano	Past
blocchino	Present
schedate	Present
racimolerà	Future
appallottolerebbero	None
comprendiate	Present
intraprendesse	Past
sello	Present
risonerebbe	None
compro	Present
carda	Present
indignarsi	None
arrangiavano	Past
gioverebbe	None
sudate	Present
definissero	Past
adattare	None
causante	Present
realizzò	Past
infastidire	None
coabitano	Present
abiurereste	None
sussisto	Present
animando	Present
squassò	Past
consiglierebbe	None
sfoglia	Present
scagionerà	Future
innalzano	Present
straripa	Present
ammazzava	Past
reintegro	Present
impastoiavate	Past
esplorato	Past
fossilizzano	Present
stremo	Present
falciante	Present
rielaborò	Past
ricatto	Present
malvedere	None
peragriate	Present
decidete	Present
arricciolavo	Past
turbinante	Present
pizzicavate	Past
ottimate	Present
bino	Present
sottopassando	Present
accavallarsi	None
sovrastampa	Present
asciolvesse	Past
accennerà	Future
accudite	Present
impalcherei	None
orgasmò	Past
sposterei	None
abbriviato	Past
incorrendo	Present
totalizzò	Past
avvero	Present
scavalcano	Present
cingano	Present
accettati	None
abbicherei	None
predicherai	Future
frangemmo	Past
radiolocalizza	Present
ansava	Past
violentate	Present
recuperarono	Past
riprendo	Present
metterei	None
elevarsi	None
attestati	None
ricopia	Present
enumererà	Future
ricrederà	Future
sedendo	Present
fluendo	Present
raffrontare	None
ricevessero	Past
ricreano	Present
acquisiscano	Present
stanziati	None
precedessero	Past
inizializza	Present
ferrai	Past
insinuare	None
scostandosi	Present
mescolava	Past
seppellendosi	Present
agiato	Past
condividi	Present
ristampò	Past
apparissero	Past
vantò	Past
optava	Past
congetturare	None
mordicchierete	Future
traboccante	Present
suggerendo	Present
scorgono	Present
sferza	Present
insignire	None
peggiorarono	Past
sanzionare	None
twittato	Past
mescolate	Present
rastrellate	Present
immatricolasse	Past
incentrate	Present
avversa	Present
librati	None
canzonano	Present
appassionare	None
sellare	None
colpiscono	Present
condivisi	Past
svirilizzate	Present
federa	Present
dimezzare	None
sopravvivono	Present
installando	Present
slittare	None
diplomati	None
allunare	None
presumendo	Present
sedano	Present
attraverseranno	Future
sforzati	None
fiata	Present
faceva	Past
voteremo	Future
bollendo	Present
infilarono	Past
provincializzeresti	None
proclamandosi	Present
calmassero	Past
rallegrare	None
svieresti	None
riviveva	Past
rifocilla	Present
aiuterei	None
terrificato	Past
indugio	Present
renditi	None
magnetizzante	Present
attesteranno	Future
ribollente	Present
esacerbare	None
minò	Past
concepì	Past
incagliarsi	None
riasfaltato	Past
svaporante	Present
rimpiegando	Present
caricherei	None
farò	Future
fiondano	Present
menomate	Present
martoriare	None
abortirono	Past
trascorrendo	Present
transitavano	Past
cokificherebbero	None
scampate	Present
puntualizzato	Past
riattare	None
consolidasse	Past
ricorderanno	Future
respiravano	Past
flagellare	None
colpevolizzare	None
replicare	None
liberalizzare	None
conflissero	Past
accumulavano	Past
frantumati	None
mitizzato	Past
raccogliti	None
sfarinando	Present
conservano	Present
gassino	Present
adoprantesi	Present
ostruiscono	Present
molestava	Past
travolgeranno	Future
ostavo	Past
predilesse	Past
danza	Present
vocino	Present
svelate	Present
distribuirsi	None
stipulò	Past
sbandierate	Present
ammonisce	Present
avvicenda	Present
pregassero	Past
ricamo	Present
incernierate	Present
acetileresti	None
maneggeremo	Future
scambieranno	Future
delegittima	Present
camminarono	Past
bissarono	Past
trillò	Past
corca	Present
intravedo	Present
lisciarsi	None
molesto	Present
fransero	Past
bilanciati	None
decimo	Present
avvicendati	None
mantenessero	Past
riapriva	Past
provvidero	Past
ossessionò	Past
accoltellare	None
rioccupai	Past
demonetizzate	Present
rivoltandosi	Present
orizzontassero	Past
sbiancherò	Future
officio	Present
mischiarsi	None
recheranno	Future
ammantellai	Past
confetta	Present
scombussolò	Past
liberandosi	Present
sollevandosi	Present
trebbiare	None
controllerà	Future
traspirante	Present
scannerizzarono	Past
prestano	Present
accodare	None
deviscerante	Present
orbitava	Past
cuocere	None
sottopassare	None
azzarderei	None
imperò	Past
sviluppandosi	Present
manco	Present
gradinavate	Past
articolarsi	None
investirono	Past
fileremo	Future
incentrò	Past
concorrevano	Past
sottomettesse	Past
uniformò	Past
confidavano	Past
stringesse	Past
sgranare	None
sciamarono	Past
rifondare	None
specificarono	Past
attorcigliarsi	None
sparpaglieremo	Future
drammatizzare	None
indossavo	Past
tramisi	Past
raggranellare	None
azionato	Past
tornino	Present
inargentando	Present
esigeva	Past
giovasse	Past
polimerizzerebbe	None
stessero	Past
gesticola	Present
bordo	Present
inarca	Present
riuscirete	Future
sforzo	Present
rivolgi	Present
comminava	Past
rinsaldarono	Past
orbitano	Present
integrate	Present
atteggiavano	Past
etichettate	Present
rifondate	Present
macchinare	None
seviziare	None
attribuirei	None
superando	Present
aggettante	Present
beffarsi	None
sognato	Past
sminuì	Past
esibiranno	Future
finanziarsi	None
guastarono	Past
seguo	Present
medicandosi	Present
sfidate	Present
caveranno	Future
consultare	None
fratturare	None
informerò	Future
bancate	Present
privarsi	None
scegliesse	Past
diremo	Future
escissero	Past
riapplicherei	None
gusta	Present
duettare	None
stenografare	None
mimetizzandosi	Present
rallegra	Present
esistono	Present
tornerete	Future
esortarono	Past
cerare	None
rimbombo	Present
reingaggerei	None
schiarirsi	None
annullarono	Past
aspettasse	Past
diserbo	Present
lignificherò	Future
trarre	None
seghettammo	Past
individualizzando	Present
indebitò	Past
osservarsi	None
afferrati	None
addenserà	Future
controllerai	Future
chiariamoci	None
dereferenzieresti	None
dimettersi	None
disobbligassimo	Past
sbriciolati	None
impaniamoci	None
rigare	None
valideremmo	None
trasmette	Present
spaccare	None
combattendosi	Present
leggiamoci	None
accalorirono	Past
attentava	Past
schermate	Present
cardare	None
inginocchiati	None
disgelerà	Future
lucidate	Present
rivisitare	None
ricombina	Present
confessare	None
sorgevano	Past
annebbiati	None
mercanteggiare	None
ferrino	Present
sacrificarono	Past
finanzierà	Future
irrobustire	None
sommoverebbero	None
impastoieresti	None
menano	Present
travierebbero	None
perfezionerà	Future
violinante	Present
discriminano	Present
rimandarono	Past
coopta	Present
osserverete	Future
impasto	Present
desiato	Past
striati	None
configurarono	Past
industriantesi	Present
instradate	Present
frullato	Past
accingendosi	Present
festeggiano	Present
interrogherà	Future
getterà	Future
abbreviato	Past
fregati	None
inquadrasse	Past
rovescia	Present
creparsi	None
urinerai	Future
riassestare	None
benmeritavamo	Past
perseverarono	Past
corredare	None
impeciai	Past
necroseresti	None
gustarsi	None
celo	Present
elesse	Past
malverserebbe	None
raggiunsero	Past
stracciarsi	None
ammaliato	Past
straripava	Past
condurrà	Future
diminuire	None
spacciando	Present
laureo	Present
andasse	Past
intrappola	Present
accantona	Present
sconcertassero	Past
profittare	None
definimmo	Past
avvantaggiati	None
atteggiarsi	None
rischiarereste	None
ospitava	Past
demoralizzante	Present
alluderebbe	None
espropriò	Past
accignendo	Present
numerino	Present
illustrare	None
spingerai	Future
materializzava	Past
addossando	Present
cospargendosi	Present
prefabbrichereste	None
sgusciante	Present
incoraggiare	None
turo	Present
scongiuro	Present
carbonizzate	Present
autorizzati	None
contagio	Present
modificandosi	Present
riemergendo	Present
vergognandosi	Present
studiandosi	Present
serrano	Present
alterarsi	None
negheranno	Future
fregiò	Past
ratificherete	Future
sbilanciandosi	Present
demonizzeresti	None
salverebbero	None
rimpolpando	Present
crasherei	None
decadremmo	None
calmatevi	None
amnistia	Present
assonnasse	Past
fumava	Past
animarsi	None
collocherebbe	None
inimicandosi	Present
chiaroscurato	Past
frana	Present
denunzio	Present
asserragliano	Present
lambiccassero	Past
brilla	Present
sintetizzarono	Past
disorientare	None
pulisci	Present
auguro	Present
prefissero	Past
rirendiate	Present
concresciuto	Past
supervisionare	None
presidiavano	Past
tipizzeremmo	None
incoronando	Present
urlava	Past
frusciante	Present
prolificare	None
espirerò	Future
volturando	Present
divallare	None
beffeggiano	Present
uniate	Present
scalca	Present
paralizzò	Past
evaporare	None
abdotto	Past
impasta	Present
prepararsi	None
soffocando	Present
vorrei	None
volge	Present
spessissimo	Past
aggrottare	None
influito	Past
fregiava	Past
noleggiò	Past
estasiare	None
punite	Present
infettante	Present
risvegliasse	Past
disabituatevi	None
strutturarsi	None
sverniciasse	Past
sminare	None
catapultano	Present
aggredendo	Present
pencolando	Present
linkate	Present
sovraccaricare	None
slattereste	None
scalpelleremmo	None
servirà	Future
ripromettevano	Past
studiacchia	Present
elevò	Past
decentrare	None
editerebbe	None
salterebbe	None
interferirebbe	None
asterranno	Future
sortiscono	Present
scartinereste	None
ricattiate	Present
sbirciare	None
deturpando	Present
biforco	Present
barrito	Past
squalificò	Past
occuperebbe	None
arrischiarsi	None
esponi	Present
bulletto	Present
annullerebbero	None
calzare	None
istituisse	Past
abbreviava	Past
supponendo	Present
fissino	Present
sucate	Present
sovraffollare	None
accadono	Present
smistare	None
interroga	Present
sciupacchiando	Present
flagellate	Present
tenetevi	None
retrogradare	None
cariava	Past
intacca	Present
boxammo	Past
radicati	None
disotterrereste	None
innestasti	Past
trafficato	Past
svitava	Past
rinserrarsi	None
introdurrà	Future
rinasci	Present
affezionate	Present
stufò	Past
banalizzare	None
osassimo	Past
ingentilito	Past
istituirono	Past
peregrinare	None
politicizzate	Present
disponesse	Past
bucherellavate	Past
sportellino	Present
graticolarono	Past
cagiona	Present
indulto	Past
comperavo	Past
ovidepongono	Present
selezionavano	Past
inchiodando	Present
rimbiancai	Past
tesare	None
eccellerò	Future
conquistandosi	Present
rivendano	Present
stagnante	Present
azzimavamo	Past
suffragare	None
sbaglierà	Future
ascriversi	None
assiomatizzato	Past
cessare	None
alcoolizzavano	Past
transennerebbe	None
transitino	Present
sgonfio	Present
equipaggiò	Past
imbragavo	Past
alpeggio	Present
evolveranno	Future
zufolante	Present
specificherei	None
distruggendo	Present
preesisteva	Past
rammarica	Present
peccando	Present
coprodotto	Past
cambuserà	Future
pregava	Past
sconcerebbe	None
delimitante	Present
scontrerà	Future
sussurro	Present
candeggiante	Present
reputati	None
brucare	None
manutenuto	Past
falciare	None
incolto	Past
inabissare	None
trasformano	Present
fulminante	Present
suicidare	None
irradiava	Past
disintegrò	Past
innesco	Present
manovrare	None
mascolinizzante	Present
produrrebbero	None
ricostruiscono	Present
gustati	None
impacchettino	Present
trastullo	Present
concordo	Present
infronzolare	None
imitino	Present
rigettò	Past
avvicendare	None
definirebbero	None
ospiterebbe	None
murino	Present
faremmo	None
allagassero	Past
telematizzerete	Future
fermarono	Past
rovistando	Present
mattonai	Past
incoraggiò	Past
erogante	Present
affollava	Past
staseranno	Future
riannodare	None
sotterrerei	None
rubavano	Past
sbagliarsi	None
rimbrotto	Present
ritrarre	None
congelava	Past
confisca	Present
aiutare	None
adempiere	None
discende	Present
dissecca	Present
scordate	Present
affettando	Present
concerniate	Present
replicarsi	None
macchiava	Past
significo	Present
screditato	Past
rinverdiranno	Future
mendicante	Present
pirata	Present
berlusconizzammo	Past
magnetizzassero	Past
mummificati	None
salassa	Present
monitorizzare	None
gettare	None
auggerebbe	None
adoprò	Past
estraniò	Past
settavo	Past
tramandate	Present
spariva	Past
residuare	None
malmetti	Present
bramando	Present
riserva	Present
scapparono	Past
camerare	None
cerchiato	Past
affinarono	Past
triplicare	None
direzionate	Present
collaborai	Past
alino	Present
supportarono	Past
liberantesi	Present
accaparravo	Past
triplicarono	Past
racchiudono	Present
scarabocchio	Present
amiamoci	None
pregiudicassimo	Past
sorpassano	Present
evaporarono	Past
estratto	Past
ricoverarsi	None
chiamato	Past
occorrendo	Present
cromassimo	Past
incinto	Past
ignorandosi	Present
redimendosi	Present
soggiogando	Present
autocommiserarsi	None
ciondolare	None
stigmatizza	Present
sventano	Present
rimanesse	Past
ruzzò	Past
riconfermarsi	None
assediarono	Past
autorizzino	Present
provochiate	Present
affiochirebbero	None
tollera	Present
supporterei	None
decidemmo	Past
sfasciò	Past
stando	Present
accomodo	Present
cadrai	Future
arborate	Present
irrogheresti	None
profondando	Present
autogovernati	None
congiungerà	Future
aggravati	None
rivaleggiava	Past
preferirebbero	None
affittato	Past
battagliando	Present
freddare	None
censurarono	Past
infrangano	Present
dispiegandosi	Present
mettere	None
raffreddano	Present
cresperemmo	None
scalcinerete	Future
accasermato	Past
promanano	Present
aleggiare	None
intesteranno	Future
verificante	Present
inumidiremmo	None
stazionavano	Past
subordinato	Past
squassato	Past
velocizzate	Present
inurbati	None
accecherò	Future
cardato	Past
inquadrando	Present
appastare	None
bobina	Present
assicuro	Present
traspirerò	Future
rapinate	Present
bruciandosi	Present
reclamo	Present
risconto	Present
congelantesi	Present
accorciare	None
rielaborare	None
imbottigliasti	Past
scadette	Past
mascherati	None
mantenendosi	Present
disarticolate	Present
cedrate	Present
rinsaldare	None
intrometterebbe	None
attesterà	Future
smagnetizzati	None
devastarono	Past
rilevarsi	None
rispetterebbero	None
sparpagliamoci	None
perforavo	Past
trasudare	None
ranzo	Present
disidratare	None
apparirebbero	None
sodisfacemmo	Past
arrangino	Present
spuntasse	Past
lavorerebbe	None
riassettano	Present
dannare	None
etichettano	Present
corrompe	Present
ingolfare	None
arredarono	Past
sigillare	None
salvaguardati	None
variando	Present
sentenziarono	Past
interseca	Present
direggesse	Past
invocate	Present
avvisò	Past
abrogato	Past
lascerei	None
anticiperemo	Future
artigliereste	None
discingevano	Past
contraddistinguevano	Past
candidò	Past
cementano	Present
dissellò	Past
rientrerà	Future
notassero	Past
buffoneggiavo	Past
dilaniava	Past
triturato	Past
ambientati	None
strizzare	None
primeggiare	None
impestatevi	None
adire	None
puntualizzate	Present
agio	Present
rattoppavo	Past
disinstallate	Present
fiocinerebbero	None
succiso	Past
annullare	None
porcellanassero	Past
fervevo	Past
udisse	Past
apparirà	Future
ciurlo	Present
ritirarono	Past
gabbammo	Past
impartisce	Present
missano	Present
agevoleranno	Future
ingaggiato	Past
interconnettessimo	Past
manifestava	Past
attenua	Present
dedica	Present
sciolse	Past
riscenderò	Future
rinominerei	None
continuavi	Past
comparire	None
supero	Present
affatto	Past
citati	None
illuminate	Present
manterrei	None
cucca	Present
definire	None
sfruttare	None
automatizzano	Present
dimenticati	None
aggrottereste	None
indemaniano	Present
prolificano	Present
esasperati	None
perquisito	Past
disquisirebbero	None
rinascendo	Present
abituandosi	Present
coinvolgerebbero	None
sbuffo	Present
incamminarsi	None
aggiustano	Present
privo	Present
sfiorava	Past
interagisco	Present
riproponendosi	Present
esalando	Present
pubblicizzava	Past
quadriennalizzerò	Future
ricopiano	Present
vagellerà	Future
aggettano	Present
emungerò	Future
incomberà	Future
consigliati	None
aderissero	Past
abbarravi	Past
emettendo	Present
modulano	Present
ricedessimo	Past
associante	Present
concorderei	None
tentenna	Present
rimembrante	Present
arrisicheremmo	None
impillaccherassimo	Past
districate	Present
rabbrividire	None
riaprendo	Present
beati	None
scorrazzare	None
mangiato	Past
orchestrò	Past
guasterebbe	None
nascondesse	Past
vistare	None
pareggiare	None
concessero	Past
agghiadarono	Past
infiammarono	Past
sfoltisce	Present
ritroverò	Future
stagionandosi	Present
dedicandosi	Present
spasimeranno	Future
preannunziereste	None
mediavate	Past
abbacherebbe	None
spiegati	None
ridivenisse	Past
aderirono	Past
proliferate	Present
smania	Present
defosforavamo	Past
punì	Past
ondulate	Present
grecizzerei	None
confrontava	Past
risolasse	Past
tumultuavi	Past
servo	Present
accucciato	Past
rincara	Present
caricatura	Present
rassomigliano	Present
sussurrare	None
fidelizzare	None
ulolerei	None
serpeggiando	Present
arruffati	None
sformati	None
rimpiangerai	Future
volino	Present
fascicolo	Present
smettere	None
sganciava	Past
sospendendo	Present
zanna	Present
vegliavano	Past
decentrai	Past
silurate	Present
pregustavano	Past
sonorizzare	None
volgevi	Past
refrangi	Present
inquisire	None
allegare	None
ritrasferire	None
perizierete	Future
simboleggiavamo	Past
contattarono	Past
ponesse	Past
turasse	Past
scattare	None
pettina	Present
ordire	None
spalancarsi	None
crollati	None
collassa	Present
crollo	Present
telecomandato	Past
succhiellare	None
sbizzarrirsi	None
ritenne	Past
immergere	None
inoculare	None
soggiornavano	Past
gire	None
ammonito	Past
dilatare	None
dibattersi	None
spaventano	Present
arcaicizzante	Present
ammettessero	Past
dipendesse	Past
ostacola	Present
manlevavate	Past
sbreccavo	Past
appassionante	Present
ripubblicato	Past
pulisce	Present
supportare	None
scorrazzato	Past
soggiaciate	Present
svuotando	Present
condannando	Present
ritentarono	Past
stipulato	Past
assassinasti	Past
liberino	Present
restringere	None
sovrapponevano	Past
soffocare	None
lineare	None
ottenevano	Past
risaliva	Past
brontolare	None
infanatichivo	Past
uperizzerete	Future
impartirà	Future
gridando	Present
scadenzato	Past
ficcanaseremmo	None
adibite	Present
inforcare	None
sterpa	Present
approfondito	Past
ammanettano	Present
emergevano	Past
colpirsi	None
mimava	Past
preservare	None
manifestarsi	None
intascò	Past
sopportando	Present
tormenteranno	Future
infiltravano	Past
soffermo	Present
consegna	Present
esercitarsi	None
alleggerirebbe	None
sfidava	Past
clivassero	Past
giungeva	Past
rilassati	None
arraffavate	Past
controllarsi	None
ubicheremmo	None
digiunò	Past
autoaccusarsi	None
scarnirebbero	None
riesprimendo	Present
getto	Present
esulavate	Past
sbavare	None
convogliarono	Past
mendicare	None
scontorcessero	Past
testimoniando	Present
beatificare	None
guaito	Past
massacrarsi	None
borseggio	Present
scoiereste	None
affossò	Past
succederanno	Future
vertente	Present
tona	Present
invecchiereste	None
ritemprare	None
deplora	Present
comprovante	Present
legittimiate	Present
schiumare	None
colmato	Past
chiocciavo	Past
occorreva	Past
uncino	Present
schiaffavate	Past
consacrare	None
partizionerai	Future
raggirato	Past
insalai	Past
libererebbe	None
vernalizzava	Past
optano	Present
immortalato	Past
predeterminare	None
rifulgere	None
classificate	Present
curare	None
assalite	Present
sdilinquendo	Present
indisporranno	Future
parificare	None
riaprì	Past
terminerebbe	None
infondi	Present
culminante	Present
abbacinante	Present
assestavano	Past
dribblando	Present
tardavano	Past
basculerebbe	None
cumulano	Present
modellizzò	Past
trascorrere	None
destabilizzeremo	Future
cicchettando	Present
pizzicottino	Present
impersonare	None
baratta	Present
sibilano	Present
agente	Present
valgono	Present
elevandosi	Present
zipparono	Past
inframezzate	Present
rapprende	Present
attivavano	Past
livellammo	Past
ignoravano	Past
grondano	Present
giacerebbe	None
pesano	Present
rivedrei	None
sopprimendo	Present
corrisponderanno	Future
monumentalizzare	None
saggiare	None
determinava	Past
rielaborarono	Past
ragionassimo	Past
torce	Present
sculacciare	None
fanno	Present
fomentare	None
levino	Present
ridando	Present
provocò	Past
snocciolare	None
spezzarsi	None
radiocomando	Present
riproducesse	Past
reinstallare	None
stono	Present
dismettiate	Present
collassato	Past
otterranno	Future
rispondersi	None
ritirarsi	None
acciottolato	Past
sfioravano	Past
affidino	Present
graziano	Present
collazionare	None
rinfocolammo	Past
sporcare	None
odorante	Present
attrezzando	Present
rimate	Present
esprimete	Present
ricevevo	Past
schierarono	Past
raggrupparsi	None
equivale	Present
persuasi	Past
transitò	Past
affisare	None
biscottato	Past
tassellerebbe	None
requisendo	Present
insediarsi	None
salvaguardarsi	None
desse	Past
siluro	Present
ingaggiare	None
consisteranno	Future
guarisse	Past
origliato	Past
schedulato	Past
aspettò	Past
bomberebbe	None
collocherebbero	None
alleggeriscono	Present
accarezzati	None
rileggerò	Future
sego	Present
abbondato	Past
varcò	Past
ripudiò	Past
temette	Past
incipriati	None
ribaltati	None
ripiegandosi	Present
pompa	Present
finanziati	None
emanano	Present
prevenendo	Present
allargantesi	Present
risucchio	Present
fluente	Present
sanno	Present
fabbricava	Past
appressarono	Past
strillo	Present
tallonato	Past
flaggare	None
tollerano	Present
ricusando	Present
fotocopiare	None
remixa	Present
sfaccenderanno	Future
rinsaviranno	Future
imbizzarrire	None
assembreranno	Future
colorano	Present
contrassegnerete	Future
coagulare	None
lubrifica	Present
riallinearsi	None
esternato	Past
ammulinerete	Future
itero	Present
tastato	Past
effigiare	None
transfluissimo	Past
instillato	Past
offendevano	Past
interdicevano	Past
scegliemmo	Past
decosse	Past
fraseggio	Present
opterà	Future
classifico	Present
aggavignavamo	Past
svincolano	Present
tornisci	Present
saccarifichiate	Present
cospargersi	None
battezzato	Past
staremmo	None
idoleggeremo	Future
telematizzerò	Future
sostenete	Present
incoccia	Present
avventava	Past
propagandosi	Present
penseranno	Future
brasato	Past
levante	Present
disinquina	Present
traina	Present
paralizzato	Past
indicizzate	Present
espugna	Present
empito	Past
abrase	Past
professandosi	Present
linkare	None
degnò	Past
coletto	Present
fluorurante	Present
revocava	Past
fallirebbe	None
rimiravate	Past
controbatteva	Past
afflissero	Past
arrivasse	Past
avvicendandosi	Present
conformarsi	None
perpetrare	None
anelare	None
urinare	None
definirebbe	None
inalare	None
associare	None
espropriavi	Past
corrisponderebbero	None
stampigliò	Past
trasporrà	Future
preelesse	Past
recuperante	Present
esprimersi	None
consentirono	Past
impaurisce	Present
pingo	Present
aggiogare	None
sottaciuto	Past
inizierà	Future
resero	Past
intramettano	Present
puzzare	None
forviavano	Past
esprimessero	Past
captano	Present
sbrigati	None
aiuta	Present
abbrusca	Present
riservo	Present
taci	Present
premurati	None
capiteranno	Future
suonassero	Past
spiombereste	None
rinverdirebbero	None
musicate	Present
irrigidire	None
prefigura	Present
appinzano	Present
protrarranno	Future
arponammo	Past
tramano	Present
coadiuvato	Past
corroborino	Present
scommetteranno	Future
ricatterò	Future
ruggente	Present
impennano	Present
internano	Present
soleggerei	None
metilate	Present
medicantesi	Present
intitolandosi	Present
reintegrate	Present
cagionarono	Past
inoltrando	Present
siglando	Present
abbriglierai	Future
miniaturizzato	Past
amputano	Present
basati	None
accanite	Present
esalante	Present
guidava	Past
rinfrescano	Present
calamitato	Past
ridonare	None
normate	Present
rifare	None
incamera	Present
stuccavi	Past
trucco	Present
reclamare	None
capirsi	None
attese	Past
imperare	None
comportassero	Past
ispanizzerò	Future
sottintendente	Present
secernendo	Present
ramificati	None
lauda	Present
nobilitante	Present
scaldare	None
dimenarsi	None
prosperato	Past
stabilendosi	Present
obbietteremmo	None
raglio	Present
saetteranno	Future
affondavano	Past
lesionati	None
cortocircuito	Present
espatriato	Past
bannate	Present
bucarsi	None
mordevano	Past
martellina	Present
ossigenare	None
esercire	None
ravvicinasse	Past
stizzivano	Past
impostato	Past
eviterebbero	None
suddividesti	Past
contrassegnava	Past
sillogizzò	Past
occultavate	Past
abituare	None
disarcionereste	None
accambia	Present
mutilate	Present
inumidisce	Present
sforzano	Present
confondete	Present
astenni	Past
quadriennalizzato	Past
componendosi	Present
toccasse	Past
allietate	Present
immaginate	Present
rinforza	Present
mergeresti	None
riparato	Past
aro	Present
propagavano	Past
inganno	Present
ottenni	Past
appagherai	Future
attualizzare	None
sbaraglio	Present
uguagliò	Past
adibito	Past
arricchendo	Present
martirizzate	Present
ubicato	Past
carderei	None
negavano	Past
stizzivo	Past
amare	None
caricati	None
camuffarsi	None
proponevo	Past
producano	Present
chinò	Past
ritraente	Present
approfittarsi	None
bisbocciai	Past
incolpava	Past
coreografate	Present
ingorgare	None
laurea	Present
promosse	Past
strascicherebbero	None
torneranno	Future
pattugliano	Present
distinguano	Present
pronunciò	Past
trasmigrò	Past
rimorchiarono	Past
incriminano	Present
diramavano	Past
occupavate	Past
sconquassai	Past
edificati	None
stanassero	Past
tradite	Present
protrarre	None
rispecchiare	None
indagare	None
aggrappati	None
varrà	Future
scleroseranno	Future
distraesse	Past
presentandosi	Present
marginerei	None
infanga	Present
rilevasse	Past
orna	Present
usucapire	None
alfabeteranno	Future
rifugiarono	Past
inframmettendosi	Present
irritati	None
complessino	Present
diffonderebbe	None
inaugurato	Past
sceglierebbe	None
sterilizzavamo	Past
interponeva	Past
onorò	Past
consacravano	Past
liscivierebbero	None
coreografato	Past
riguardasse	Past
minacciatevi	None
tremolare	None
riuscireste	None
pattuì	Past
inseguire	None
capitavano	Past
profilo	Present
interagito	Past
rimisero	Past
irido	Present
incaricare	None
patina	Present
controbattuto	Past
curverai	Future
contravvenuto	Past
trasportava	Past
controbilanciare	None
arrosserò	Future
sloggiare	None
verniciare	None
sbaragliato	Past
certificare	None
riutilizzate	Present
allattando	Present
evidenzierebbe	None
allinderà	Future
spaccatevi	None
proseguono	Present
evaporando	Present
copriranno	Future
sposati	None
destrutturati	None
dissocia	Present
calibrando	Present
sbattevano	Past
rapportare	None
battezzare	None
accovacciarsi	None
ricandidare	None
abboccano	Present
cerchiai	Past
amminutarono	Past
arretrando	Present
duettano	Present
espatriò	Past
slegarsi	None
fuggirà	Future
rimasti	Past
espiano	Present
contemperare	None
occulta	Present
effettuate	Present
strisciò	Past
stuteranno	Future
rincaserebbe	None
ravvisavano	Past
sibilare	None
tifo	Present
congelò	Past
rifirmare	None
insultavano	Past
planto	Past
screzieremmo	None
alpeggerete	Future
iridate	Present
sprofondano	Present
sgravo	Present
infoibato	Past
diventai	Past
isolano	Present
proiettò	Past
indite	Present
affermarsi	None
trasumanerete	Future
incenerendo	Present
gratificante	Present
congedare	None
accostumerei	None
eguagliare	None
banchettando	Present
informava	Past
ciarlo	Present
trasalisti	Past
risegneranno	Future
richiesto	Past
riscontravano	Past
precisasse	Past
procacciò	Past
vedrai	Future
querelato	Past
prefissava	Past
normava	Past
dissipati	None
collisero	Past
premete	Present
retribuiresti	None
matematizzeresti	None
ascendesse	Past
caca	Present
usarsi	None
crolla	Present
scalato	Past
porgeva	Past
indemaniava	Past
oscillate	Present
sviolinò	Past
equiparava	Past
ridistribuire	None
abuseremmo	None
rallentarono	Past
alleviavo	Past
ripeserò	Future
torchiereste	None
intonati	None
esperimenterei	None
calino	Present
ispessire	None
separano	Present
amministravano	Past
erigersi	None
ravviverei	None
sbarrarono	Past
commissionarono	Past
unguenterò	Future
feltro	Present
pervieni	Present
trasparivamo	Past
determinavano	Past
discendessero	Past
ratificare	None
grazia	Present
pietrificasse	Past
affiorano	Present
controllerò	Future
sussistesse	Past
prilleresti	None
dubitava	Past
intona	Present
istruirei	None
apprestate	Present
rinfocolando	Present
aggiudicavano	Past
ripiegarsi	None
verresti	None
giostratela	None
proferisce	Present
ozonizzando	Present
concatenerebbe	None
concedi	Present
registrai	Past
rinzaffarono	Past
scrivevamo	Past
omologare	None
sfruculiare	None
svuoterà	Future
stormire	None
riafferma	Present
solennizzato	Past
sabotò	Past
smistando	Present
giustificherà	Future
acquieterai	Future
concordando	Present
dissipassimo	Past
riuscissimo	Past
osculerete	Future
appiattirsi	None
privarono	Past
incarcerato	Past
sciare	None
vagellereste	None
fiutano	Present
reducevano	Past
andatevene	None
travisare	None
esulcererebbero	None
conoscersi	None
concimavate	Past
immortalare	None
assordirai	Future
risparmieremmo	None
sciala	Present
reiterò	Past
sopravvivesse	Past
massacra	Present
risentirono	Past
riappacificarsi	None
anelano	Present
risparmiandosi	Present
spammando	Present
escludono	Present
verificati	None
ottennero	Past
ricrearsi	None
preparassero	Past
scarnificato	Past
spolpare	None
declassare	None
equilibrare	None
danzerà	Future
spregio	Present
diventarono	Past
rimodellare	None
capitombolerete	Future
celia	Present
sterilizzare	None
allineandosi	Present
fronteggiano	Present
eliminarsi	None
slittate	Present
scacazzerei	None
aromatizzate	Present
sospettano	Present
abbinati	None
placati	None
utilizzeranno	Future
giudicasse	Past
deliziano	Present
amatevi	None
corrano	Present
consistere	None
legiferano	Present
impalò	Past
alfabetizzare	None
vantaggio	Present
denominarono	Past
girebbero	None
malignerò	Future
riscuotere	None
ravvivare	None
menzionando	Present
panificheremmo	None
stanziato	Past
ammaliare	None
conciare	None
travestirono	Past
personalizzare	None
risconvolgono	Present
trasformasse	Past
allicciavo	Past
detronizzare	None
sgrovigliante	Present
avventurarsi	None
trollino	Present
ornare	None
coadiuvando	Present
giocare	None
sposiamoci	None
sdoganare	None
registrerà	Future
cospargono	Present
strutturando	Present
opporrebbero	None
seguirei	None
aggruzzolavi	Past
allinearono	Past
piegai	Past
differiranno	Future
fonologizzo	Present
pratichino	Present
dovere	None
avvio	Present
dilagava	Past
filtrante	Present
assicurantesi	Present
gravitarono	Past
minimizzate	Present
collassare	None
discorda	Present
russano	Present
sforano	Present
deferirete	Future
lotterò	Future
imprecando	Present
riscendeva	Past
espi	None
camminino	Present
dissimulato	Past
brillasse	Past
sguainato	Past
sproloquiare	None
interessa	Present
raggrupparono	Past
diffondeva	Past
ribellassero	Past
ripristinava	Past
consultava	Past
suicidano	Present
impillaccheravi	Past
scola	Present
resume	Present
ritornassero	Past
cumulare	None
impazziva	Past
sollecitava	Past
stoccare	None
riduci	Present
prediligono	Present
cercherebbero	None
diremmo	None
assolvere	None
abbozzare	None
condannare	None
suonando	Present
eccependo	Present
lottare	None
spiaggiato	Past
monitorano	Present
ricostruendo	Present
rituffasti	Past
offende	Present
sbandierano	Present
coronerai	Future
aggiunta	Present
ostacolano	Present
griffo	Present
scintillare	None
appresteranno	Future
germanizzavamo	Past
smentirebbe	None
mietere	None
tenderanno	Future
apprezzarsi	None
esclamare	None
alluvionato	Past
rinvenire	None
consolidano	Present
descriverebbe	None
crollano	Present
murante	Present
disapprovando	Present
accaldati	None
transennerò	Future
abituano	Present
stesse	Past
prevalevamo	Past
controvertono	Present
ripresentavano	Past
stracca	Present
andiate	Present
destare	None
agitammo	Past
ricopiando	Present
incastrati	None
cronicizzarsi	None
istruiva	Past
saccheggiano	Present
collauda	Present
spetterebbe	None
vanificarono	Past
preprogrammerebbero	None
appresi	Past
scandiva	Past
bracco	Present
danneggino	Present
sensibilizza	Present
custodirono	Past
rovinarsi	None
contemplava	Past
vettovagliarono	Past
attenderebbe	None
divorati	None
rinfrancati	None
prostrate	Present
scandalizza	Present
inducessero	Past
censiscono	Present
effettuino	Present
sbattersi	None
confederarsi	None
smetterò	Future
piaggio	Present
proporsi	None
acculturarsi	None
ponzò	Past
sussurrò	Past
integreranno	Future
precluse	Past
divisero	Past
mescolandosi	Present
smessa	Past
vaccinare	None
zoomeremmo	None
evoluissero	Past
scambiare	None
accentrasti	Past
industrializzino	Present
evirare	None
brocca	Present
affittisti	Past
latrano	Present
deprezza	Present
vincerebbe	None
svolgerebbero	None
scoprono	Present
calcolavano	Past
campicchiarono	Past
pubblico	Present
aggirare	None
disertate	Present
monumentalizzate	Present
affiorerai	Future
trasmigra	Present
manducavi	Past
bombardino	Present
azzurro	Present
mietevano	Past
apprendano	Present
spezzetta	Present
esternalizzeresti	None
sterminano	Present
strisciavano	Past
appiedato	Past
forzante	Present
correggersi	None
conteneva	Past
attribuivano	Past
destruggerò	Future
arrecate	Present
scorgeva	Past
ustionati	None
categorizzare	None
marciavano	Past
confetto	Present
commentato	Past
rifrangono	Present
fondava	Past
insorgano	Present
sbottona	Present
trapelano	Present
rassumo	Present
fucilate	Present
virgolettate	Present
incorporare	None
camerano	Present
rischiano	Present
materializzandosi	Present
soppalco	Present
restavo	Past
abboccò	Past
depreca	Present
sfaccendavate	Past
ricreando	Present
allentare	None
dimezza	Present
ghinderemmo	None
mandassero	Past
tatuate	Present
sbottare	None
abbriccavamo	Past
moltiplicando	Present
acconsentendo	Present
imbarcarsi	None
profittante	Present
sovraccarico	Present
trasdurrà	Future
perturbano	Present
bestemmiano	Present
sfavoriscono	Present
ripulisti	Past
giocolavano	Past
romanizzerai	Future
cilindrate	Present
snodo	Present
ritendo	Present
affievolisse	Past
velocizzava	Past
sbloccare	None
opinato	Past
orientavano	Past
ricavando	Present
risorgente	Present
aggiudica	Present
dibattiti	None
ammassare	None
videro	Past
sopprimessero	Past
correlare	None
invelenirebbe	None
dissetarsi	None
rastremantesi	Present
dilettarsi	None
infiltrano	Present
abbattente	Present
intrattenendo	Present
allevasse	Past
reimbarcarono	Past
attrarre	None
adescato	Past
bollente	Present
odiare	None
aggirino	Present
asseggiano	Present
simulava	Past
legati	None
converte	Present
rifluire	None
zippo	Present
appalta	Present
spezzando	Present
intestino	Present
alberino	Present
autorizzate	Present
simpatizzerebbe	None
giocavano	Past
scemano	Present
piegasse	Past
divertendo	Present
scriveremo	Future
sfeltriate	Present
accartoccia	Present
amai	Past
calafato	Present
friggevamo	Past
radiare	None
sovesciante	Present
sfornò	Past
concepisce	Present
declamano	Present
procrastinato	Past
assumere	None
insozzante	Present
macerate	Present
virtualizzavo	Past
rastremandosi	Present
alimenta	Present
privilegiato	Past
sfilate	Present
travagliano	Present
collaborare	None
concluse	Past
chiacchierato	Past
fascia	Present
sostituiscano	Present
allertasti	Past
occupano	Present
infiltratevi	None
ripugneresti	None
sementa	Present
irrita	Present
rappresanterà	Future
invecchiano	Present
sarchiellano	Present
riallungino	Present
delirare	None
specchino	Present
indugia	Present
rinarrare	None
scalzano	Present
accondisceso	Past
germanizzare	None
importuno	Present
tumulato	Past
fuggono	Present
discutemmo	Past
cancellate	Present
spicciavi	Past
sogliono	Present
rabbonire	None
indossate	Present
dissanguarsi	None
emendando	Present
erigono	Present
camerino	Present
tradiranno	Future
tatuare	None
fiorettasti	Past
spezzo	Present
apprendendo	Present
disimpegnarsi	None
affrettiamoci	None
animava	Past
principieresti	None
accumulasse	Past
traboccò	Past
sgambate	Present
racimolato	Past
stancarsi	None
riceverebbero	None
arzigogolavi	Past
scaturire	None
remunerare	None
filosofeggiare	None
intersecano	Present
gradì	Past
cucirsi	None
spruzzava	Past
riepilogo	Present
eleverà	Future
proseguiranno	Future
cospirano	Present
calandro	Present
dedichiamoci	None
posta	Present
perdonando	Present
cercano	Present
sconfiggevano	Past
sfrattate	Present
sprizzato	Past
comperare	None
riconcesse	Past
accollando	Present
dispiaciti	None
improvvisa	Present
privilegiarono	Past
indigerei	None
segnalerò	Future
stimolavano	Past
ingaggerebbe	None
ingoffente	Present
illanguidivo	Past
rimangiare	None
produsse	Past
allargherei	None
rabbrividirà	Future
risulto	Present
spartì	Past
radiodiffondevate	Past
concorrente	Present
smerliate	Present
incingereste	None
somministrando	Present
scollinare	None
sintetizzo	Present
desi	None
barato	Past
uccidano	Present
saltante	Present
affilate	Present
azionò	Past
trasportiamoci	None
sbuca	Present
soggiorneranno	Future
salvate	Present
ereditando	Present
inquadrano	Present
fermò	Past
masturbino	Present
chiaritevi	None
ramate	Present
spopolare	None
riemersero	Past
pescherò	Future
riassumerei	None
trainato	Past
trapassano	Present
permaneva	Past
ribattevano	Past
truccarsi	None
stringeranno	Future
acconceremmo	None
drogandosi	Present
fucila	Present
frustravo	Past
datavano	Past
pendo	Present
mimavamo	Past
allegate	Present
margottiate	Present
comprando	Present
ammonisco	Present
riassegnare	None
dichiaravo	Past
intravedevano	Past
ricucendo	Present
distorcono	Present
demanda	Present
indebitati	None
ponevo	Past
ripagate	Present
alzatevi	None
grazio	Present
vendicati	None
evitante	Present
rifornirà	Future
ubica	Present
noteranno	Future
disperato	Past
opacizzavi	Past
rovesciati	None
sostituire	None
minimizzassero	Past
perturbati	None
fruttificano	Present
riprogettare	None
speculano	Present
capitolare	None
accento	Present
ammazzano	Present
migrarono	Past
raffrontando	Present
riadattano	Present
spogliandosi	Present
geme	Present
paracaduta	Present
intraprendendo	Present
moralizzare	None
dimenare	None
risalta	Present
atticizzai	Past
riguarderò	Future
intitolerei	None
traumatizzavate	Past
filmerà	Future
rinsavire	None
collassarono	Past
citofono	Present
concretizzeranno	Future
costringerà	Future
istituirsi	None
germinerebbe	None
spacciavano	Past
bordeggiare	None
comparò	Past
controllare	None
appressa	Present
contrapponiate	Present
divorate	Present
concentrava	Past
sbollentassero	Past
evirò	Past
scalate	Present
quietereste	None
stazionare	None
scusarono	Past
marciarono	Past
lambiccheranno	Future
competeva	Past
approntarono	Past
stazzo	Present
autocandidati	None
puntasse	Past
fiondatevi	None
correggente	Present
denigrate	Present
infangare	None
sniderebbero	None
risollevandosi	Present
raccattasti	Past
davamo	Past
costeggiavano	Past
delimitò	Past
digita	Present
riprodursi	None
conserveranno	Future
libererebbero	None
agonizzavi	Past
andando	Present
disfece	Past
piantonavate	Past
decadevano	Past
strapazzerebbero	None
lasciava	Past
boccheggiassero	Past
approccerò	Future
crocifiggere	None
delegate	Present
zoppeggerò	Future
infirma	Present
scricchiola	Present
coinvolgerebbe	None
vomitando	Present
solfiate	Present
temerò	Future
impiccarsi	None
interrogherebbero	None
coltellate	Present
aizzò	Past
tempera	Present
rettificare	None
attenuante	Present
arrugginivate	Past
filmare	None
trattengono	Present
sommerso	Past
riaccompagnare	None
comprendo	Present
confluirà	Future
commentate	Present
inzolfarono	Past
interiorizzando	Present
disgregati	None
ondava	Past
reclutavo	Past
sostituisse	Past
ambientava	Past
spianando	Present
venducchiarono	Past
avventati	None
affondato	Past
soggiungo	Present
indicò	Past
scandì	Past
degradare	None
incenerirebbero	None
fabbricò	Past
raccomandò	Past
ributtare	None
importunare	None
determinerebbero	None
cercare	None
ridisponevamo	Past
abbracciante	Present
esterna	Present
medicano	Present
vagherà	Future
dileggiare	None
adito	Past
piccate	Present
predice	Present
guidando	Present
riattraversarono	Past
interdire	None
decifererebbero	None
espandi	Present
questionare	None
staccavano	Past
riabilitarsi	None
arrendersi	None
traverserà	Future
dispiacersi	None
arricchiranno	Future
pregarono	Past
accompagnare	None
sbarca	Present
pilotate	Present
evacuare	None
compilarono	Past
affollarono	Past
riapri	Present
stressavi	Past
sorgessero	Past
simpatizzante	Present
rinuncerò	Future
avvolvesse	Past
insignì	Past
perseguitavano	Past
esentò	Past
affrettandosi	Present
dimoravano	Past
compreranno	Future
bollate	Present
conteggiare	None
trionfare	None
preavvertissero	Past
monterà	Future
falsificava	Past
riscoperto	Past
barbuglierei	None
accentrate	Present
sprofondavano	Past
sanguinando	Present
allestirà	Future
noleggiava	Past
valido	Present
fischietto	Present
franano	Present
brameremo	Future
sforzando	Present
agguerrireste	None
ozia	Present
gasate	Present
afferivano	Past
sinistrerebbero	None
maritarsi	None
indovinavano	Past
flottante	Present
rogante	Present
avvertiva	Past
falsificando	Present
paracadutandosi	Present
focalizzò	Past
smaltisce	Present
saziarsi	None
carrellino	Present
raggio	Present
sgommassimo	Past
avvengono	Present
assestando	Present
asserito	Past
apprestandosi	Present
rafforzo	Present
pesò	Past
proibirà	Future
riversarsi	None
assentarsi	None
suffragato	Past
catturarono	Past
converrebbe	None
girelleresti	None
prostendereste	None
disturbano	Present
attenendosi	Present
innalzando	Present
santificante	Present
corseggiare	None
sosterranno	Future
promanerebbero	None
sbrattate	Present
commissionerà	Future
appiccolivamo	Past
simboleggerebbero	None
attorniati	None
richiedendo	Present
accincigneremmo	None
ingorghino	Present
attrarreste	None
consulto	Present
insedieranno	Future
diradati	None
sbalordirsi	None
uccisero	Past
litograferà	Future
brancicherebbero	None
appigliarsi	None
riattate	Present
precludendo	Present
rappresentare	None
proietto	Present
fronteggiava	Past
scappare	None
rivoluzionano	Present
alludano	Present
fonologizziate	Present
svagarsi	None
squamo	Present
trapiantò	Past
indurre	None
controbilancia	Present
intercambiavate	Past
areo	Present
meravigliarsi	None
assortite	Present
imbestieremmo	None
animarono	Past
risolsero	Past
disobbedì	Past
lucido	Present
triplicarsi	None
ributtati	None
cessassero	Past
sfogliare	None
simboleggerebbe	None
battezzo	Present
eliminò	Past
rescindere	None
accomunante	Present
coloro	Present
abbisogna	Present
ringalluzzirebbe	None
interloquire	None
inabissarono	Past
incamminassimo	Past
imbottisce	Present
pigino	Present
rogo	Present
decostruire	None
indurente	Present
reclutato	Past
appostarsi	None
esistesse	Past
annotano	Present
reperta	Present
annasino	Present
filosofare	None
rivola	Present
visitate	Present
telecontrollerei	None
ispezionavano	Past
decidiamoci	None
prolunga	Present
esaurendosi	Present
apriti	None
accostando	Present
stigmatizzando	Present
ritraggono	Present
risvegliare	None
riabilitando	Present
contribuiscano	Present
acquatteremo	Future
decima	Present
arreggimentavano	Past
mineralizzate	Present
avverasse	Past
disdegnerei	None
rappacificati	None
ritelefonate	Present
rassodare	None
impone	Present
ulireste	None
litigare	None
cristianizzato	Past
allagare	None
lardello	Present
bilanciarsi	None
ritraendo	Present
recepiremo	Future
quetasse	Past
radiocomandò	Past
gravitano	Present
spezia	Present
attorcerei	None
tesaurizzare	None
ingoiò	Past
aboliva	Past
radiolocalizzare	None
remò	Past
galoppino	Present
progettavano	Past
trebbia	Present
disancorerete	Future
assegnava	Past
sgrammaticato	Past
intimava	Past
valutare	None
disabilita	Present
nebulizzare	None
bramato	Past
innestava	Past
denudarsi	None
contrae	Present
ritagliarono	Past
irritarsi	None
parlucchieremo	Future
omette	Present
intimorentesi	Present
bivaccare	None
delocalizzato	Past
sostentarsi	None
declamato	Past
ventola	Present
sbilancio	Present
salpò	Past
pasticciando	Present
assumerà	Future
ricalchino	Present
mobilizzerai	Future
adeguare	None
siedano	Present
spalmarsi	None
ricrescerà	Future
intronizzare	None
dimagrisce	Present
riabbracciarsi	None
interpreterei	None
ricambia	Present
reincisi	Past
sfracellarsi	None
torturati	None
esistente	Present
piantava	Past
vantandosi	Present
tormentarsi	None
criptare	None
soppiantava	Past
plagio	Present
sfora	Present
riconverte	Present
solleticato	Past
ringraziavamo	Past
distanziati	None
commercializzava	Past
craccherebbero	None
compattasti	Past
decimavano	Past
sveglino	Present
ricercava	Past
fissare	None
impiccioliremo	Future
sedimenta	Present
cambiereste	None
danzare	None
attingendo	Present
diminuivo	Past
riversano	Present
rovinai	Past
signoreggiò	Past
rinzaffavo	Past
vantaggiassimo	Past
sborniarsi	None
scolpite	Present
accudire	None
reitera	Present
incarnando	Present
disunire	None
capitolerai	Future
dirsi	None
addensavano	Past
accappiettante	Present
spiegasse	Past
fuorviare	None
rappano	Present
pomperemmo	None
imbavagliare	None
rafferma	Present
percepisco	Present
riusavo	Past
pagò	Past
estinse	Past
mitigarono	Past
addormentava	Past
testimoniassero	Past
ripopolarsi	None
scampanerebbero	None
smarrendosi	Present
rivestire	None
belare	None
condensano	Present
nuoce	Present
recuperato	Past
costringersi	None
stecchiscano	Present
pescare	None
osculerei	None
riequilibrando	Present
cassato	Past
frangiarono	Past
gotta	Present
tardino	Present
voltati	None
molleggio	Present
travaso	Present
brutalizzare	None
confrontarsi	None
esportato	Past
usurarsi	None
deferiscono	Present
sciogliersi	None
intorbiditevi	None
appuntare	None
danneggiati	None
arrechino	Present
relazionando	Present
evidenziati	None
imbolsiscono	Present
colpiranno	Future
assegneresti	None
maturasse	Past
appesantiscono	Present
immise	Past
