isceli	iscelim	Person
razmnožio	razmnožen	Voice
faksirali	faksirala	Gender
stočiću	stočića	Case
nauke	nauko	Number
najpohlepnijima	najgnjusnijima	lemma
potražila	dočekala	lemma
nestala	nestalo	Gender
vodičima	vodiču	Number
prokleta	proklete	Gender
reklamama	reklami	Number
pijanistu	pijanist	Case
dodale	dodane	Voice
štićenika	štićenike	Case
impulsnih	fleksibilnih	lemma
rizika	rizike	Case
domaćinu	domaćin	Case
obavezan	obavezao	Voice
izvođeni	izvodili	Voice
jednoruka	uključiva	lemma
projekta	projektu	Case
išara	prsnu	lemma
konstantne	borbene	lemma
hrapave	uzvišene	lemma
najljenjega	najanarhističkijega	lemma
блиједи	плаузибилни	lemma
samuje	samuješ	Person
ekosistemu	ekosistemima	Number
eshatologom	eshatolozima	Number
uveličani	uveličane	Gender
kalkulatorima	kalkulatoru	Number
osnovana	osnovani	Gender
nadvladavaše	suprotstavljaše	lemma
zaslonjeno	zaslonilo	Voice
prebačeno	prebačen	Gender
pribrojiš	pribrojite	Number
doštampan	doštampano	Gender
kolektivnoj	blistavoj	lemma
patine	patina	Number
psovana	psovani	Gender
oličenja	oličenje	Number
multilateralìzma	multilateralizam	Case
otarasila	otarasilo	Gender
zulumi	zulume	Case
parna	besadržajna	lemma
samoće	samoćom	Case
prebrođeni	prebrodili	Voice
nekritičnima	blagonaklonima	lemma
iscrpljena	slomljena	lemma
izvrsno	zlobno	lemma
kompletnu	vrtoglavu	lemma
opomenula	zastupila	lemma
pobijen	pobio	Voice
prevozila	prevozio	Gender
proteran	proterano	Gender
zakopavali	zakopavani	Voice
kraćeni	kraćena	Gender
odvajalo	odvajao	Gender
bare	baro	Number
kameru	kamere	Number
konstruira	ustvrdi	lemma
pripovijedano	pripovijedalo	Voice
hudi	tužni	lemma
igumanu	igumanima	Number
kasnu	raznovrsnu	lemma
sakupljala	sakupljalo	Gender
podmićivane	podmićivale	Voice
labilne	dalekovidne	lemma
popisana	popisala	Voice
kotoripski	kotoripska	Gender
otpočinuh	otpočinu	Person
iseljene	iselile	Voice
imperatori	imperator	Number
raspletana	raspletala	Voice
uprava	upravama	Case
hrtovi	hrte	Number
veznika	veznik	Case
plural	brusnica	Case
povrijedila	povrijeđena	Voice
blebećimo	blebeći	Person
hranjivom	voštanom	lemma
ispaćeni	ispaćene	Gender
razapinjaše	razapinjasmo	Person
ventilatorom	ventilator	Case
jasan	topljiv	lemma
djelah	djelaše	Person
ispisana	ispisala	Voice
smotasmo	smotaše	Person
neprocjenjive	gorive	lemma
uvrstila	uvrštena	Voice
prilagođene	afektirale	lemma
odjahivale	odjahivali	Gender
utvrdile	utvrdila	Gender
nepokretne	sferične	lemma
uočio	uočen	Voice
privezali	privezani	Voice
vjereno	vjerilo	Voice
najavljivali	najavljivani	Voice
poduzećem	poduzećima	Number
adenskima	arheološkima	lemma
bezobraznije	najbezobraznije	Comparison
lipove	lipova	Gender
glase	glasi	Person
isecana	isecala	Voice
inflacijskima	biološkima	lemma
dublji	dublja	Gender
razgovorljivijemu	najrazgovorljivijemu	Comparison
prefekturi	prefektura	Case
pobunilo	pobunjeno	Voice
nejasnima	bezuvjetnima	lemma
maorske	fosilne	lemma
apostolu	apostolima	Number
premlaćivala	premlaćivana	Voice
odmjeravala	odmjeravalo	Gender
povoljno	ugledno	lemma
cvjetovima	cvjetovi	Case
odolijevaše	zabuši	lemma
mršavi	golemi	lemma
nedohvatljivima	nedohvatljiva	Case
istjerali	istjerale	Gender
sačekali	sačekani	Voice
običavaste	tamnjaste	lemma
predgrađe	predgrađem	Case
zraci	zrače	Number
ljubavničkim	australskim	lemma
nasilnici	nasilnik	Number
veridbe	vèridābā	Case
zaslužio	zaslužen	Voice
antifašistu	antifašistima	Number
vresovima	vresu	Number
razasut	razasuta	Gender
žònglēr	žongleri	Number
proricana	proricala	Voice
polumesečnu	slovenačku	lemma
ukrcala	ukrcana	Voice
brine	brinem	Person
narađa	zadesi	lemma
istupile	istupili	Gender
rešahu	rešaše	Person
matematičarom	matematičaru	Case
neadekvatnih	živopisnih	lemma
koeficijente	koeficijentu	Case
gazele	gazela	Case
nameravala	nameravali	Gender
početkom	početka	Case
crtao	crtan	Voice
šatiraš	šatiram	Person
prigodni	aluvijalni	lemma
obrtom	obrtima	Number
osiromašen	osiromašio	Voice
dočekivani	dočekivali	Voice
paprenijima	animalnijima	lemma
kljove	kljovom	Case
tetrarsi	tetrarše	Number
administrativna	spiritualna	lemma
prdnem	prdnemo	Number
tovari	tovare	Number
planirana	planirano	Gender
ustupilo	ustupljeno	Voice
namaknuli	glorificirahu	lemma
mladost	mladosti	Case
lovine	lovino	Number
rakije	rakijom	Case
prigrizana	prigrizala	Voice
preplašeno	preplašilo	Voice
investicije	fosili	lemma
najljenjim	ljenjim	Comparison
groteskan	опсежан	lemma
dodirivala	dodirivao	Gender
dignuti	dignut	Number
kreda	krede	Number
obračunavah	obračunavasmo	Number
pit	pita	Gender
oštećene	oštetile	Voice
imperijalni	goveđi	lemma
zanimala	zanimalo	Gender
grebijaše	grebijasmo	Person
vodi	vodo	Case
naseljavaju	naseljavaš	Person
pozdrave	pozdrav	Case
opozvani	opozvali	Voice
zavojnici	zavojnica	Case
opravdane	opravdale	Voice
najžešće	žešće	Comparison
doušnika	doušnike	Number
potencijalne	spektralne	lemma
djelovale	djelovali	Gender
iskoristive	atraktivne	lemma
likvide	likvidi	Case
proznoga	carskoga	lemma
najneumjerenijoj	najapatičnijoj	lemma
patroni	patrone	Case
žigu	žigovima	Number
ponesu	ponesemo	Person
nenaviđaše	čekaše	lemma
osvanjivale	osvanjivala	Gender
javljala	javljali	Gender
gegam	gega	Person
dugajlije	dugajlija	Case
saborskomu	saborskima	Number
utoku	utocima	Number
prostranstvom	prostranstvu	Case
zamaknule	zamaknute	Voice
nabavljene	nabavljeni	Gender
završih	završiše	Person
kozjih	kozje	Case
ispričani	ispričali	Voice
mrkih	univerzalnih	lemma
bezbožništvo	bezbožništva	Case
inteligencije	inteligencija	Number
apsorbirali	apsorbirala	Gender
podcrtavao	podcrtavan	Voice
zakazujemo	zakazujem	Person
ukrštena	ukršteni	Gender
zahtijevan	zahtijevao	Voice
osedlali	osedlala	Gender
rastvorilo	rastvorio	Gender
uspijevale	uspijevali	Gender
jelše	jelšama	Case
nastanjivale	nastanjivane	Voice
prenesene	prenele	Voice
utopljena	utopila	Voice
sastadoše	sastadoste	Person
onanirala	onanirali	Gender
tucijaše	tucijaste	Person
zalazila	zalazio	Gender
ispraznite	isprazne	Person
bremenu	breme	Case
održivijega	spontanijega	lemma
usađeno	usadilo	Voice
imovinskome	državnome	lemma
najosvetoljubivijega	najslobodoumnijega	lemma
prodavaste	prodavah	Person
uspostavljena	uspostavila	Voice
inicijatora	uboda	lemma
strpela	strpeo	Gender
procenjena	procenila	Voice
rubno	gotsko	lemma
probijala	probijali	Gender
judejske	trojanske	lemma
opila	opio	Gender
sarkazma	sarkazmu	Case
nezaštićena	reprezentativna	lemma
jestivom	čudnom	lemma
zvan	zvani	Number
jurisdikcijama	jurisdikciji	Number
uzletelo	uzleteo	Gender
neistinitijima	bjednijima	lemma
osetna	rijetka	lemma
sintezi	sinteza	Case
teologiji	teologijom	Case
podizana	podizala	Voice
rovarahu	rovarasmo	Person
podmićuje	podmićuješ	Person
odeljenja	odeljenje	Number
optužnica	optužnice	Case
dopremana	dopremala	Voice
izranilo	izranjeno	Voice
sekretari	sekretar	Number
elektromagnetnu	elektromagnetne	Number
uturalo	uturala	Gender
najosećajnijom	najbezosećajnijom	lemma
kalemi	kalemimo	Person
oživlena	oživlene	Gender
kotačima	dnevnicima	lemma
televizor	televizori	Number
zasjenjen	zasjenio	Voice
zauzdavane	zauzdavana	Gender
bebu	bebe	Case
privezivani	privezivana	Gender
jezivima	pokvarljivima	lemma
zakonikom	zakoniku	Case
bečaše	bečahu	Person
patriotski	genetički	lemma
pretila	pretilo	Gender
raspuštale	raspuštali	Gender
trojke	trojkama	Case
povezivala	povezivale	Gender
čȁša	čašom	Case
arapska	arapski	Gender
sukobila	sukobilo	Gender
primoram	primorate	Person
najjezovitijega	najdramatičnijega	lemma
preriji	prerijama	Number
potpis	potpisu	Case
gruba	složna	lemma
narodima	narodu	Number
izgonile	izgonjene	Voice
jajca	jajce	Number
opušcima	stidljivostima	lemma
saveznikom	savezniku	Case
ukrcavani	ukrcavali	Voice
hetitske	hetitski	Case
krševitih	sedih	lemma
ukrcala	ukrcao	Gender
izrače	izračite	Person
marte	martom	Case
mastima	masti	Case
kultura	kulture	Number
pročitana	pročitala	Voice
kvartu	kvartovima	Number
Bosance	Bosanca	Number
litvanska	susjedna	lemma
kalifu	kalifom	Case
sređivan	sređivano	Gender
najpametniji	najdrastičniji	lemma
imperijalistički	teološki	lemma
obuče	obučem	Person
otkaze	otkazi	Number
zamjereni	zamjerene	Gender
mineralne	epidemijske	lemma
pojmiste	pojmi	Person
izopačivali	izopačivani	Voice
šampionima	šampionom	Number
pojedu	pojede	Person
islandska	islandske	Gender
rupi	rupu	Case
povoljne	aglutinativne	lemma
ukrasi	ukrasima	Case
ispletosmo	proveravasmo	lemma
miliji	najmiliji	Comparison
najneproduktivnijima	neproduktivnijima	Comparison
pohlepnijim	glupavijim	lemma
krepani	krepana	Gender
meridijanima	meridijana	Case
polazim	polazi	Person
jahače	jahača	Number
pratilo	praćeno	Voice
utopljena	utopljene	Gender
korporativne	rigorozne	lemma
osumnjičeni	osumnjičene	Gender
odbijala	odbijana	Voice
kalaju	kalaja	Case
cepali	cepala	Gender
grudu	grudi	Case
prišla	prišao	Gender
baštinilo	baštinjeno	Voice
indoeuropska	spavaća	lemma
opor	opori	Number
krekećem	krekećemo	Number
demagogije	demagogiju	Number
kruga	krugova	Number
centimetara	centimetra	Number
cirkulacijo	cirkulacije	Number
provjerila	provjerena	Voice
prokopavala	prokopavalo	Gender
vrednošću	vrednostima	Number
morfologije	morfologija	Case
rasiste	rasist	Case
publicirah	publiciraše	Person
bamiju	bamijom	Case
traktate	traktatu	Case
trudile	trudila	Gender
pokopane	pokopana	Gender
razotkrila	razotkrio	Gender
najnemilosrdnijima	najuobraženijima	lemma
octom	octu	Case
omogućilo	omogućeno	Voice
radnički	cvjetni	lemma
ovčaru	ovčarima	Number
pashalni	takmičarski	lemma
ucjeno	ucjeni	Case
kolikima	bezuspješnima	lemma
grješke	arheolozi	lemma
avàtār	avatarom	Case
medalji	medaljom	Case
fluktuacije	fluktuacijama	Case
mestimična	tekstualna	lemma
modernizacija	modernizacije	Case
lelekalo	lelekao	Gender
izrekom	izreci	Case
zabilježio	zabilježen	Voice
licemjerniji	licemjernije	Case
naručujem	razbolevam	lemma
hiponimi	hiponime	Number
nacionalizmima	nacionalizmi	Case
opskurnijima	sentimentalnijima	lemma
ubadalo	ubadala	Gender
hidrauličkim	turističkim	lemma
haploidna	rekurzivna	lemma
imperativa	imperative	Case
ukrštava	ukrštavam	Person
gipkija	najgipkija	Comparison
okradana	okradani	Gender
pohod	pohodu	Case
gvozdenima	vitalnima	lemma
lepa	alkoholizirana	lemma
obrtana	obrtala	Voice
slivom	sliv	Case
pravoslavcima	pravoslavci	Case
masovnim	bujnim	lemma
najklimavijih	najsavremenijih	lemma
litanije	litaniji	Case
ispunimo	ispune	Person
mujezinom	mujezinima	Number
polagale	polagane	Voice
pomoćnice	pomoćnici	Case
izbrisao	izbrisan	Voice
feljtone	feljtoni	Number
carevi	carevima	Case
sònār	sonarom	Case
mušičavijim	tajanstvenijim	lemma
jezični	tarifni	lemma
šnauceri	šnaucer	Number
likvidaciju	likvidacije	Number
најделотворнији	најсрдачнији	lemma
povjereni	povjerili	Voice
nemoćnih	čitavih	lemma
pojedinačnih	začaranih	lemma
jahtom	jahtama	Number
stisnute	stisnuta	Gender
izraslinama	izrasline	Case
najmoćnijih	najslabijih	lemma
svecima	svecu	Number
rubriku	rubrike	Number
dosljednijega	najdosljednijega	Comparison
kurdska	serijska	lemma
preračunato	aludiralo	lemma
hirovitijih	tajanstvenijih	lemma
parole	parolo	Number
malicioznijima	zahvalnijima	lemma
temperaturama	temperature	Case
razuzdanijima	čuvenijima	lemma
pokvarila	pokvarena	Voice
bezuspešnosti	bezùspešnosti	Case
snabdjeli	snabdjeveni	Voice
tramontana	tramontane	Number
predomislili	predomislio	Number
nezamenjiva	stroga	lemma
kićen	suptilan	lemma
epidemija	epidemijama	Case
jajovode	jajovodu	Case
mirisnih	šarenih	lemma
naslikala	naslikana	Voice
tvrđeno	tvrdilo	Voice
dale	dane	Voice
transfuzija	transfuzije	Case
popraćen	popraćeno	Gender
konceptualna	vesela	lemma
najhumanijemu	najekscentičnijemu	lemma
klešta	kleštima	Case
razorili	razoreni	Voice
kruće	varvarskije	lemma
talasi	talas	Number
obodena	obodeno	Gender
tròbōjkā	trobojke	Case
izrastaše	zvaše	lemma
cvjetaše	cvjetaste	Person
pojasevima	sredstvima	lemma
željeza	željezima	Case
izboren	izborio	Voice
legalizirala	legaliziralo	Gender
privole	privoli	Person
razastrta	razastrti	Gender
otegotnijima	ushićenijima	lemma
obnavljane	obnavljana	Gender
nevelike	severne	lemma
tkale	tkane	Voice
propisima	propisa	Case
klempavima	retardiranima	lemma
prelistavale	prelistavali	Gender
statističarima	statističaru	Number
labuđe	divovske	lemma
portalima	portala	Case
junačkom	benediktinskom	lemma
najћоравијe	najћоравијa	Case
koščatijima	zlovoljnijima	lemma
zanemarivala	zanemarivana	Voice
ubijana	ubijala	Voice
teleskopi	teleskopima	Case
ispunih	transformirah	lemma
saharskom	donjom	lemma
lojalnima	zanesenima	lemma
naslućeni	naslutili	Voice
ispunite	ispune	Person
ruj	rȗj	Case
pravih	srbijanskih	lemma
zlodjelima	zlodjela	Case
fondacije	fondaciji	Case
heteroseksualnosti	heteroseksualnost	Case
pučanstva	pučanstvom	Case
povećavano	povećavalo	Voice
kolebaš	računaš	lemma
izgorjela	izgorjelo	Gender
marsovskoga	transmisijskoga	lemma
hermetičkih	filoloških	lemma
jeknula	jeknuo	Gender
funkcijom	funkciji	Case
kamerunski	briselski	lemma
prešao	pronašao	lemma
krstu	krstovima	Number
prisebnih	flegmatičnih	lemma
ovčarske	drugačije	lemma
toplica	toplicama	Case
opisani	opisana	Gender
podmitljivi	претворљиви	lemma
predvideo	predviđen	Voice
pretpostavilo	pretpostavljeno	Voice
zimovanje	zimovanjem	Case
fascinirate	fasciniraju	Person
tkivu	tkivima	Number
izrodili	izrodila	Gender
križeve	križevima	Case
најчовекољубивији	човекољубивији	Comparison
prisutnost	prisutnosti	Number
nabusite	riđobrade	lemma
tradiciju	tradicije	Number
dopusti	dopust	Number
sabotiraše	uzmaknuo	lemma
gorštaku	gorštacima	Number
prekršena	prekršeni	Gender
anarhije	anarhijom	Case
održala	održana	Voice
prilagođeni	prilagodili	Voice
jahačke	atomske	lemma
slapu	slap	Case
popravljene	popravile	Voice
najrazgovjetniji	najbalaviji	lemma
osušene	osušeni	Gender
karanfiliću	karanfilići	Number
uzorale	uzorane	Voice
razmjenjivana	razmjenjivano	Gender
најталентиранији	талентиранији	Comparison
telefone	telefoni	Number
cimnuše	cimnuste	Person
nepravednim	svježim	lemma
pigmentacijom	pigmentaciji	Case
teretanom	teretanu	Case
nebitna	eliptična	lemma
ljudskomu	uzgrednomu	lemma
tetrarsi	tetrarhe	Case
potrošena	potrošila	Voice
sukobljene	sukobile	Voice
predviđena	predviđen	Gender
skrenuti	skrenuli	Voice
narječjem	narječje	Case
pretopljen	proslavljen	lemma
kalkirali	kalkirala	Gender
trsa	trsu	Case
deizam	deizma	Case
nikaragvanski	čehoslovački	lemma
šeširićem	šeširić	Case
ponavljao	ponavljan	Voice
književnici	geniju	lemma
razna	atička	lemma
prihvaćao	prihvaćalo	Gender
zapažana	zapažala	Voice
nude	nudite	Person
rađeni	radili	Voice
učila	učile	Gender
karpatske	arterijske	lemma
pedagogijom	pedagogiju	Case
rukopisima	rukopisu	Number
anarhije	anarhija	Case
najjalovijega	najtrivijalnijega	lemma
eshatologija	eshatologiji	Case
isplivana	isplivala	Voice
nasilni	sagledivi	lemma
sokaka	sokak	Case
podsjećeno	podsjećen	Gender
pustinjske	urugvajske	lemma
procuri	dopliva	lemma
hrvačkih	armenskih	lemma
jemenska	večerašnja	lemma
sahranili	sahranjeni	Voice
verzima	verzu	Number
inozemstva	inozemstvom	Case
tvrtke	tvrtka	Number
kukavnijoj	dugoročnijoj	lemma
sekularnu	sekularnoj	Gender
ocenilo	ocenjeno	Voice
dominirala	dominirale	Gender
gnjiliš	gnjilimo	Person
tuševi	tuševima	Case
predvodile	uzgajale	lemma
dani	dali	Voice
odmamljivaše	odmamljivah	Person
jezivijima	čujnijima	lemma
zahtevali	zahtevala	Gender
propuštah	propuštaste	Person
posrtala	posrtao	Gender
godina	godinom	Case
najjestiviji	najzluradiji	lemma
ispiraste	upozoriste	lemma
porušile	porušene	Voice
poimala	poimao	Gender
granula	granule	Number
nagodili	nagodio	Number
koaksijalnim	bistrim	lemma
udaja	udajama	Case
uteši	uteše	Person
spisateljici	spisateljicom	Case
leme	lemu	Number
podvalile	podvaljene	Voice
pluralistički	čelični	lemma
tajimo	tajiš	Person
nadograđivali	protjerali	lemma
nacrt	nacrti	Number
karaše	karaste	Person
intrigantnijemu	glupavijemu	lemma
glancu	glančevima	Number
otporna	tiha	lemma
sile	sili	Number
akropolom	akropolu	Case
maramice	maramici	Case
patku	patke	Number
banovima	bánōvā	Case
pročitala	pročitao	Gender
nagodimo	nagodiš	Person
postojeći	postojeća	Gender
prepoznata	prepoznala	Voice
spušteno	spušten	Gender
obaveštava	obaveštavaju	Person
izražavana	izražavano	Gender
radijalnu	radijalno	Gender
spiritizme	spiritìzam	Case
očeličila	očeličilo	Gender
neprobavljeno	slabo	lemma
odvijale	odvijali	Gender
kvašena	kvasila	Voice
najpovršnijim	najautoritativnijim	lemma
fluor	fluorom	Case
spasiteljem	spasitelja	Case
pozitivnije	savitljivije	lemma
sprdaše	sprdahu	Person
simbolizirah	simbolizirahu	Person
plijenori	zjenice	lemma
povij	upotrijebi	lemma
tamilski	tamilska	Gender
najoblija	oblija	Comparison
poljubaca	poljupci	Case
usađena	usadila	Voice
planiran	planirano	Gender
službeniku	službenikom	Case
paradoksalnijega	šarenijega	lemma
oglođete	oglođe	Person
naborima	naborom	Number
ovjeren	ovjerena	Gender
krhao	krhan	Voice
zvana	zvala	Voice
isporučiš	isporuči	Person
ubijale	ubijane	Voice
napadaji	napadaja	Case
najparadoksalnijoj	najsličnijoj	lemma
prihvatilište	prihvatilišta	Number
izbačeno	izbačen	Gender
parobrodima	parobrode	Case
posvetila	posvećena	Voice
најглађи	глађи	Comparison
lovorovo	bivše	lemma
idolopokloniku	idolopoklonicima	Number
vertikalama	vertikalom	Number
srušili	srušile	Gender
kuvala	pušila	lemma
snimila	snimile	Gender
zgrijavaste	zgrijavah	Person
marka	marke	Number
poštama	pošte	Case
gruzijska	daljinska	lemma
најмагнетичнији	магнетичнији	Comparison
proizvoljniji	senovitiji	lemma
odbile	odbijene	Voice
ujedate	ujedaš	Person
rafiniraj	šarmiraj	lemma
uručivan	uručivano	Gender
pravdano	pravdalo	Voice
projekciji	projekcije	Case
najkoherentnije	najbujnije	lemma
spuštao	spuštala	Gender
leksikološkima	beloruskima	lemma
idejnoga	idejne	Gender
osporavana	osporavala	Voice
ogledalu	ogledalo	Case
umiljenicama	umiljenici	Number
neuobičajenije	vitalnije	lemma
veseljáci	veseljaka	Case
nagodbe	nagodbama	Case
medicini	medicina	Case
najkrhkijih	najgordijih	lemma
granična	graničnim	Case
volumen	volumene	Number
uzdržljivu	uzdržljive	Case
tužitelju	tužiteljima	Number
karboksilna	karboksilne	Gender
maorskih	seizmoloških	lemma
postigli	balansirasmo	lemma
nepromijenjena	providna	lemma
lave	lava	Case
aerodrom	aerodrome	Number
počinjeni	počinjena	Gender
kruta	sapunasta	lemma
izbijali	izbijala	Gender
izvjesne	vješte	lemma
okolinama	okoline	Case
rasrdio	rasrdilo	Gender
namočimo	namočite	Person
zatvaralo	zatvarano	Voice
pupale	pupala	Gender
rastužuju	rastužujemo	Person
razorena	razoreno	Gender
poplašite	poplaši	Person
obišla	obišli	Gender
nazdravljaše	sprdaše	lemma
sinagoge	sinagoga	Case
imaginarnih	veselih	lemma
neloše	zdrave	lemma
spoznaja	spoznaje	Case
zatočen	zatočio	Voice
bilabijala	bilabijalima	Case
svršene	svršeni	Gender
porušili	porušeni	Voice
zavodničku	zavodničke	Case
sabismo	sabi	Person
ubožnicu	ubožnice	Number
nazivale	nazivali	Gender
johe	joha	Number
prerijskih	besmrtničkih	lemma
katovi	kate	Number
ožujskoga	bavarskoga	lemma
toljagu	toljaga	Case
tavo	tavi	Case
osunčale	osunčala	Gender
odbijena	odbijene	Gender
okrene	protječe	lemma
ispravljen	ispravljeno	Gender
formalnosti	formalnost	Number
otvorila	otvorilo	Gender
specijaliteta	specijalitéta	Number
kemijskih	sirijskih	lemma
sprečavale	sprečavali	Gender
kadionicama	kadionici	Number
emocija	emocije	Number
amnestija	amnestije	Number
lakovjernijih	zvučnijih	lemma
izvodljive	granične	lemma
plavuša	plavuše	Number
razoružajmo	razoružaj	Person
poboljšale	poboljšane	Voice
elektranama	elektrane	Case
gurao	guran	Voice
fontani	fontanom	Case
upaljivaste	upaljivaše	Number
tesao	tesala	Gender
cenzurirala	cenzuriralo	Gender
nepisani	snažni	lemma
polagali	polagani	Voice
odjebale	odjebane	Voice
severnoameričko	severnoamerička	Gender
nenavide	nenavidimo	Person
nepotpunim	stidnim	lemma
borovnicu	borovnice	Number
vodopadom	vodopada	Case
savijate	savijaš	Number
najnebogije	najuobičajenije	lemma
najneumjerenije	najudaljenije	lemma
magijsku	antifašističku	lemma
konvencionalnu	bilateralnu	lemma
podnela	podnesena	Voice
ambiciju	ambicija	Case
apstrakciju	apstrakcijom	Case
meki	rezidencijalni	lemma
platom	plati	Case
kršćanskoj	franačkoj	lemma
straže	stražama	Case
kovkijih	bezvrednijih	lemma
shvaćeno	shvatilo	Voice
najaktivnije	najaktivnija	Gender
stražu	straže	Number
tjestenine	tjestenina	Number
nezasitnijima	bubuljičavijima	lemma
povezivalo	snimilo	lemma
najšarolikiji	najbesposleniji	lemma
nužnih	sretnih	lemma
prepoznatljive	ekonomične	lemma
okultnim	službenim	lemma
trikovi	trikovima	Case
kosturu	kosturom	Case
ubrali	ubrani	Voice
pukovnije	dresovi	lemma
monolitnim	gotovim	lemma
maknulo	maknula	Gender
loncima	čaušima	lemma
anektirali	anektirala	Gender
ženjene	ženjena	Gender
začarani	začarana	Gender
ostala	alpska	lemma
promijenjena	promijenila	Voice
lanjska	zoološka	lemma
unesen	uneseno	Gender
priličilo	priličio	Gender
nedužnima	anacionalnima	lemma
letonskoga	bubrežnoga	lemma
govoriš	govorite	Person
hiperbolična	zadovoljna	lemma
osporila	osporilo	Gender
oslabela	oslabeo	Gender
zapaljena	zapaljeni	Gender
nepokretni	univerzalni	lemma
priopćila	priopćena	Voice
ispričana	ispričane	Gender
plavokrvnoj	uvaženoj	lemma
kolebljive	blagonaklone	lemma
snabdevena	snabdevene	Gender
sluge	slugu	Case
dupinima	dupini	Case
prikradala	prikradali	Gender
izvijesti	izvijestiš	Person
profesoru	profesorima	Number
krasile	krasila	Gender
njihale	njihala	Gender
ispitni	finansijski	lemma
zalog	zalogu	Case
grdima	širokima	lemma
dizajnere	dizajnera	Case
impliciraste	asfaltiraste	lemma
vapite	vape	Person
smatrale	smatrala	Gender
gomili	gomilom	Case
muzikologiji	muzikologiju	Case
prestanite	razdružujte	lemma
isticale	isticali	Gender
srijedi	srijedo	Case
kršćanskima	smeštajnima	lemma
tečniji	критичнији	lemma
zanos	zanosu	Case
iskrčeni	iskrčena	Gender
gorivima	gorivom	Number
sipila	sipio	Gender
lèpilo	standardizacija	lemma
promišljaste	promišljaše	Person
jesnima	tolerantnima	lemma
čuvstva	čúvstvo	Number
robusne	robusnih	Case
čišćasmo	čišćah	Person
otplivam	otplivaš	Person
pomogao	pomognut	Voice
barela	barele	Case
crepe	crepu	Case
nasljednici	nasljednica	Case
pizdite	pizdim	Person
sastavite	sastave	Person
šljapnule	šljapnula	Gender
shvaćale	shvaćala	Gender
prestigli	želi	lemma
ponižavan	ponižavana	Gender
antičke	antičkoga	Gender
porama	pori	Number
plivačkima	šleskima	lemma
ešeke	ešeka	Number
jajolike	zloćudne	lemma
prtljažnikom	prtljažnik	Case
matica	maticama	Case
obukla	razgazila	lemma
sadistički	voćni	lemma
koncizan	rodoljubiv	lemma
pila	pita	Voice
izgreboše	spjevaše	lemma
stoliću	stolići	Number
malariji	malariju	Case
raznežiste	razneži	Person
najučinkovitija	najučinkovitije	Gender
popravljala	popravljana	Voice
nojeve	zaštitne	lemma
iskvarile	iskvarene	Voice
toga	togom	Case
mame	mamo	Number
izazivala	izazivalo	Gender
usisivačima	usisivače	Case
naoblačismo	naoblačih	Person
zašiljili	zašiljeni	Voice
eskimskome	eskimski	Case
kreću	zriju	lemma
regijama	dućanima	lemma
kristijanizira	kristijaniziraste	Number
zabavismo	zabavih	Person
rubrika	rubrike	Number
izdajnici	izdajnike	Case
nedavan	муљевит	lemma
razvedenijih	bjednijih	lemma
papirnica	učesnik	lemma
cvetale	cvetala	Gender
potraženi	potražili	Voice
popraćivano	popraćivalo	Voice
značila	značili	Gender
најимпресивнији	импресивнији	Comparison
ornitološkima	žabljima	lemma
marokanske	trodnevne	lemma
pregrejavao	pregrejavalo	Gender
župani	župana	Case
provokativnija	bombastičnija	lemma
nerazdvojna	trajna	lemma
masiv	masivom	Case
prijaznijima	simpatičnijima	lemma
heterogenu	ekonomičnu	lemma
rastavu	rastavi	Case
porušena	porušila	Voice
trigonometriji	trigonometrijom	Case
praznovjernih	slatkorečivih	lemma
pripremana	pripremala	Voice
prepoznatljiv	čovekoljubiv	lemma
najlagodnija	najsjenovitija	lemma
svađa	svađate	Person
ispostavio	ispostavljen	Voice
javljena	zapovedana	lemma
ventilirah	ventilirasmo	Person
natjerana	natjerala	Voice
prezirano	preziralo	Voice
darovao	darovalo	Gender
pobijedilo	pobijeđeno	Voice
bliještaše	bliještasmo	Person
izračunalo	izračunato	Voice
prepisao	prepisan	Voice
usvajan	usvajao	Voice
nemaru	nemara	Case
iznela	iznesena	Voice
praktičnoj	svijetloj	lemma
kompromitirali	kompromitirala	Gender
ispravke	ispravak	Number
hrapavih	srčanih	lemma
luđaku	luđacima	Number
civile	civila	Number
nizovima	nizu	Number
oksidaciju	oksidacije	Number
psećoj	bravarskoj	lemma
cvatove	cvatovi	Case
odvrtaste	dodijeliste	lemma
rupiji	rupijom	Case
најтраљавији	траљавији	Comparison
sili	silo	Case
sušeno	sušen	Gender
pitoma	slavna	lemma
bubuljičastoga	bubuljičastim	Case
ohlađivah	ohlađivaste	Person
prespavah	prespavaste	Person
okvirnoj	egzaktnoj	lemma
biheviorizme	biheviorizmu	Case
ispitivah	zatajih	lemma
podsećena	podsetila	Voice
kamilom	kamile	Case
okupljano	okupljalo	Voice
umak	umaka	Case
dlane	dlanovi	Number
isključivane	isključivale	Voice
karanfilići	karanfilićima	Case
porušila	porušena	Voice
posmatračima	posmatrače	Case
uložilo	uložio	Gender
paneliraj	ateriraj	lemma
pojavljivala	pojavljivalo	Gender
ukrštavam	ukrštavaš	Person
највлажнији	влажнији	Comparison
modelirasmo	telefonirasmo	lemma
ateljei	atelje	Number
adresirali	adresirala	Gender
najprotivnije	najbrže	lemma
januarskima	alkoholnima	lemma
oružani	gnevni	lemma
upijaš	upijate	Number
popušta	popuštaju	Number
najlabilnije	najcelovitije	lemma
zanimale	zanimala	Number
razoružani	razoružana	Gender
ideološka	ideološkoj	Case
okrenut	okrenuti	Number
iskoristila	iskorištena	Voice
nužnim	bezličnim	lemma
poklonilo	poklonio	Gender
diktirali	diktirale	Gender
gravitacijska	automobilistička	lemma
rukavne	babilonske	lemma
priči	priče	Case
primorao	primorala	Gender
poništen	poništio	Voice
leđnima	unutrašnjima	lemma
vereničkima	vereničke	Case
odnela	odnesena	Voice
jedinjen	jedinio	Voice
tornjevima	tornju	Number
sakupljačkoj	sakupljačkomu	Gender
križaline	križalinu	Case
otpušta	otpuštaju	Person
pravljena	pravila	Voice
mrvili	mrvile	Gender
ijekavčeva	ijekavčevoj	Case
klecala	klecao	Gender
intelektualce	intelektualca	Number
rostfraju	rostfraj	Case
nasljednom	točnom	lemma
azbesta	azbestom	Case
obvezom	obvezama	Number
pupkom	pupcima	Number
najjednostavnija	najbučnija	lemma
aktivaciju	aktivacijo	Case
posteljom	posteljo	Case
sipala	sipali	Gender
kresan	kresao	Voice
povereni	poverena	Gender
podjarmi	podjarmismo	Person
poreče	porekoše	Person
humorèska	humoresku	Case
snežila	snežio	Gender
neparno	uvetno	lemma
nemogućnosti	nemogućnost	Case
osobna	bosa	lemma
ledenijima	glazbenijima	lemma
zvona	zvono	Number
rascepa	rascep	Case
bačena	bačeno	Gender
katehetama	kateheti	Number
tješile	tješili	Gender
dvòsmislenosti	dvosmislenosti	Case
odabrali	odabrani	Voice
izvidi	razdjeljuje	lemma
proljetne	vlastelinske	lemma
preli	prele	Gender
tunele	tunelima	Case
razradi	razradih	Person
izmicale	izmicala	Gender
umetnošću	umetnosti	Case
proširivala	proširivana	Voice
nanišani	utrnu	lemma
odnarodimo	odnarodite	Person
razlikovao	razlikovalo	Gender
finskima	finskim	Number
obavijate	obavijamo	Person
razmirica	razmirice	Number
pȁrtnerstāvā	partnerstva	Case
merio	merila	Gender
razmatrala	razmatrao	Gender
ovenčana	ovenčala	Voice
vrednoće	vrednoćom	Case
otapala	otapana	Voice
temelje	temelji	Case
učiteljem	učitelju	Case
karoserije	karoserija	Number
pomaknuta	pomaknut	Gender
svrstane	svrstana	Gender
region	fenjer	lemma
sastav	sastave	Case
најмаштовитији	маштовитији	Comparison
obišlo	obišao	Gender
smak	smakom	Case
priljubite	uhapsite	lemma
nadmašili	nadmašeni	Voice
čȗvstāvā	čuvstvima	Case
divljam	divljaju	Person
kolektivnim	zatvorenim	lemma
grozdova	grozda	Number
dogovorio	dogovoren	Voice
ušteđivala	ušteđivao	Gender
raspisivah	raspisivaste	Person
boginjama	boginje	Case
pošteđivano	pošteđivan	Gender
oličava	oličavaš	Person
jednakosti	jednakostima	Number
erozijama	erozijom	Number
neženje	neženja	Number
jahalo	jahao	Gender
svjećicu	svjećica	Case
napasti	napast	Case
rasuli	rasuti	Voice
smrznula	smrznuo	Gender
parlamente	parlament	Case
izgrizu	izgrizem	Person
kolektivne	trudne	lemma
lučonoše	lučonošo	Case
granitima	granite	Case
neopravdani	suvremeni	lemma
vežban	vežbao	Voice
omogućivani	omogućivali	Voice
republikanske	republikanskoj	Case
ispitivanje	ispitivanja	Number
gadile	gadili	Gender
najortodoksnijoj	najdijaboličnijoj	lemma
prijetila	prijetili	Gender
dozvoljeno	dozvolilo	Voice
minutima	minuti	Case
nadoknadio	nadoknađen	Voice
kristalna	čudesna	lemma
mekšala	mekšana	Voice
žarištu	žarištem	Case
pritvarao	pritvarali	Number
dočekali	dočekale	Gender
listiće	listićima	Case
putovale	putovala	Gender
pelcom	pelčevima	Number
idolopokloničkima	ciničkima	lemma
dojku	dojke	Number
ometala	ometalo	Gender
presahnete	presahnemo	Person
ozlijedimo	umejmo	lemma
nabavljale	nabavljane	Voice
pneumatskih	pneumatske	Case
seljaštva	seljaštvom	Case
rutenskima	bočnima	lemma
navezala	navezao	Gender
afektirate	afektiraš	Person
represijama	represiji	Number
teškoća	teškoće	Number
predložena	predložila	Voice
spomenuo	spomenut	Voice
uznemirili	uznemireni	Voice
najiskusnija	najvrelija	lemma
mezi	meze	Case
plàvōjka	uživalac	lemma
najmukotrpnijih	najsputanijih	lemma
neugodnijim	bezglavijim	lemma
procijenio	zabliještio	lemma
mljeveni	mljevene	Gender
usmerena	usmereno	Gender
dozvoljene	dozvolile	Voice
kružila	kružilo	Gender
pojmili	pojmila	Gender
pristašom	pristaša	Case
radar	radari	Number
razvijeno	razvilo	Voice
zgrejalo	zgrejao	Gender
neprestanu	sadržanu	lemma
pozivana	pozivani	Gender
izračunavan	izračunavano	Gender
pedagoška	sirijska	lemma
rajskim	zdravstvenim	lemma
čalabrcnuto	čalabrcnuta	Gender
kićahu	rasteraše	lemma
naseljavana	naseljavano	Gender
savjetnik	savjetnici	Number
množena	množeno	Gender
kriptičnim	cijenjenim	lemma
tešile	tešene	Voice
zrcaljene	zrcaljena	Gender
komentatorom	komentator	Case
najnerazumnija	najbezglavija	lemma
broji	brojim	Person
zabavište	zabavišta	Number
zbližila	zbližili	Gender
stegnima	stegna	Case
psihoterapije	psihoterapiju	Number
slasticama	slastica	Case
presudnih	svečanih	lemma
doživjeli	doživjela	Gender
svjetlu	svjetlima	Number
paranoičnima	rečitima	lemma
nalomljene	nalomljena	Number
sačuvale	sačuvane	Voice
istrebljuješ	istrebljuju	Person
elektranu	elektrani	Case
rasplakivala	rasplakivali	Gender
imućnim	transparentnim	lemma
ukopamo	ukopam	Person
inauguralni	svježi	lemma
interpretacijo	interpretaciju	Case
spasili	spašeni	Voice
pristupali	pristupao	Number
špiljama	špiljom	Number
piša	pìšām	Person
skvrčene	skvrčena	Gender
simulirani	simulirali	Voice
klasnoga	skeptičkoga	lemma
prihvaćeni	prihvaćena	Gender
lažljivcu	làžljivac	Case
izložila	izložena	Voice
njišu	njiše	Person
најдражи	дражи	Comparison
carice	caricu	Case
nacisti	naciste	Case
primenjen	primenio	Voice
susret	susretu	Case
avokada	avokado	Number
namenjivalo	namenjivano	Voice
blogove	blogu	Number
reportažu	reportaže	Case
nogometno	tjelesno	lemma
bukva	bukvi	Case
proučena	proučen	Gender
rasterivali	rasterivale	Gender
zaklonjena	zaklonila	Voice
skupljáča	skupljača	Case
gonila	gonjena	Voice
gradili	građeni	Voice
utječeš	utječemo	Person
sudstvo	sudstva	Case
lakovernijih	sistematičnijih	lemma
interpretacijom	granom	lemma
stripova	stripovima	Case
dijamante	dijamanti	Number
hipotezi	hipotezu	Case
dodeljivane	dodeljivana	Gender
načitanoj	sukladnoj	lemma
popraćeni	popratili	Voice
izmjerio	izmjeren	Voice
proizvođač	proizvođačem	Case
sačekivali	sačekivani	Voice
antrakse	antraksu	Case
opljačkan	opljačkao	Voice
saprao	sapralo	Gender
ublažavale	ublažavala	Gender
doštampa	doštampate	Person
neprofitnu	difuznu	lemma
snižen	snizio	Voice
zagrejavana	zagrejavan	Gender
zaslona	zasloni	Case
neukusne	egzotične	lemma
donošene	donosile	Voice
obrazložio	obrazložila	Gender
članku	članak	Case
čarolijama	čarolije	Case
izbacila	izbačena	Voice
nabasavani	nabasavali	Voice
ubrizgavali	ubrizgavani	Voice
iznenađen	iznenadio	Voice
prekršili	prekršile	Gender
trčkarala	trčkarao	Gender
cilindrima	cilindara	Case
anotirahu	anotiraste	Person
redukcije	redukcijama	Case
izbio	izbila	Gender
odnijela	odnesena	Voice
pokrstila	pokrstile	Number
vodomerima	vodomere	Case
pečena	punktualna	lemma
sardelama	sardele	Case
udarena	udarila	Voice
nasilno	snažno	lemma
preteči	pretečama	Number
najliberalnijim	najbalavijim	lemma
raskinuti	raskinuli	Voice
pogubni	ceremonijalni	lemma
uveličala	uveličali	Gender
načeli	načeti	Voice
nepremostiva	rodjena	lemma
hvalisava	antropoidna	lemma
federalista	federalisti	Case
kritizirana	kritizirala	Voice
razmaknute	razmaknuta	Gender
ukopavano	ukopavalo	Voice
izazvane	izazvana	Gender
dojilje	dojilja	Case
impresivna	uspješna	lemma
indijanskoj	srbijanskoj	lemma
trojke	trojka	Number
smanjivala	smanjivana	Voice
oblikovao	oblikovalo	Gender
keramičarom	keramičarima	Number
najravnomernije	najbalavije	lemma
počasti	počastima	Number
glumica	glumici	Case
omalovažavala	omalovažavana	Voice
poduzela	poduzeli	Gender
poslano	poslan	Gender
vlasnice	vlasnici	Case
začinjena	začinjeno	Gender
pogođeni	pogodili	Voice
osnivaču	osnivačem	Case
zagrlili	zagrljeni	Voice
babama	babom	Number
nepisana	nepisani	Gender
hagiografski	hagiografske	Gender
korena	korila	Voice
izbušeno	izbušilo	Voice
poslužila	poslužio	Gender
neurastenične	revolucionarne	lemma
patnicama	patnici	Number
informacija	informacije	Number
kratkovalnim	etiopskim	lemma
presenetio	presenećen	Voice
nadevah	nadevaše	Person
popušilo	popušeno	Voice
kriminologijskima	vladarskima	lemma
krovopokrivača	krovopokrivačima	Case
džungli	džungle	Case
kovrčastome	vetrovitome	lemma
spojena	spojeno	Gender
zamicala	zamicana	Voice
uvrstile	uvrštene	Voice
najmalobrojnijima	najzaslužnijima	lemma
spužve	spužvu	Number
majica	majice	Number
ježevo	slovačko	lemma
heterozigotno	ekonomično	lemma
mrskim	skeptičnim	lemma
raskošnije	življe	lemma
majčino	majčina	Gender
prosincima	prosince	Case
spiker	spikera	Case
odgovori	odgovoriše	Person
satiričkim	satiričkom	Gender
helikopterom	helikoptera	Case
proćerdao	proćerdala	Gender
banalniji	najbanalniji	Comparison
raširila	raširena	Voice
revniju	zrnatiju	lemma
proteravano	proteravana	Number
razlaže	razlažu	Person
najprovokativnije	najšiljatije	lemma
ples	plesu	Case
izljubljivale	izljubljivane	Voice
karipski	božji	lemma
pljuvane	pljuvale	Voice
šiparicu	šiparicom	Case
krunice	krunicu	Case
poslovanje	poslovanju	Case
kirurški	разносачки	lemma
unela	unesena	Voice
krijepljen	krijepljena	Gender
prevladan	prevladao	Voice
urotismo	uroti	Person
moćno	zlonamerno	lemma
ublaživao	ublaživan	Voice
postolaru	postolara	Case
slave	slavimo	Person
zlorabite	zlorabimo	Person
poprasmo	poprah	Person
zabetonirali	zabetonirani	Voice
porobljivan	porobljivao	Voice
kristijanizirao	kristijaniziralo	Gender
upravljala	upravljana	Voice
prigovoriste	zasenjivaste	lemma
fiskalnom	fiskalnoj	Case
istrošenijega	beščasnijega	lemma
šahove	šah	Number
rotacijske	bratoubilačke	lemma
izgovorena	izgovorila	Voice
adijabatske	fosforne	lemma
smirni	smirna	Case
prostire	prostiru	Number
mirisnima	savetodavnima	lemma
iskrcane	iskrcale	Voice
pripadah	pripadaše	Person
dodijeljeni	dodijeljene	Gender
kobilici	kobilicom	Case
kolokvijalni	dopunski	lemma
najprimetljivije	najselektivnije	lemma
najmaloumnijima	najuvjerljivijima	lemma
pretpostavljeni	pretpostavili	Voice
nomenklaturo	nomenklaturom	Case
kompjutorima	kompjutorom	Number
srcastu	srcastom	Case
pregrejalo	pregrejano	Voice
najpribranija	najtečnija	lemma
pravovremeno	superiorno	lemma
čitan	čitao	Voice
doseljeníci	doseljènīk	Number
nazdraviše	nazdravi	Person
procenom	supervizijom	lemma
dominirala	dominiralo	Gender
nerazdvojivima	gojaznima	lemma
neumesne	prosečne	lemma
ropstva	ropstvu	Case
krojioče	krojioca	Case
nastanilo	nastanila	Gender
nesuđen	brižljiv	lemma
aminokiseline	aminokiselinama	Case
agresore	agresora	Case
pridružila	pridružilo	Gender
svekrvu	svekrve	Number
priračunala	priračunao	Gender
preštampavana	preštampavano	Gender
nedosledni	bezlični	lemma
oduzet	oduzeo	Voice
sugrađanima	sugrađane	Case
održavala	održavao	Gender
presecali	presecala	Gender
sustava	sustavu	Case
lisnata	spojena	lemma
najnostalgičniji	najskromniji	lemma
logaritamska	logaritamske	Gender
odvodimo	odvodim	Number
mišje	artističke	lemma
neparnu	socijalnu	lemma
kanabisa	kanabis	Case
odstranjivaste	prožderaste	lemma
provalnicima	provalnikom	Number
prenosu	prenosa	Case
pridruživano	pridruživalo	Voice
pričvršćeno	pričvršćena	Gender
најгњилији	гњилији	Comparison
tvorca	tvorce	Number
pretvorivima	pretvorivu	Number
najpatrijarhalnije	najdestruktivnije	lemma
kompozitore	travestije	lemma
najmanju	manju	Comparison
smatrale	smatrali	Gender
ravnoteže	ravnoteža	Number
ukrcavala	ukrcavalo	Gender
razini	razina	Case
najotvorenijega	najdugovječnijega	lemma
taktove	takt	Number
iskazivana	iskazivala	Voice
plašljivosti	šiljku	lemma
držano	držana	Gender
kobiljima	eparhijskima	lemma
pitahu	sagnuše	lemma
intervale	intervalu	Case
leksikografsko	enciklopedijsko	lemma
kažnjivoj	svežoj	lemma
најсвесрднији	свесрднији	Comparison
sukobljavala	sukobljavao	Gender
zabilježilo	zabilježio	Gender
njegovateljica	njegovateljice	Number
izjednačeni	izjednačena	Gender
strahote	strahota	Case
odbačena	odbačene	Gender
rabotaju	rabota	Person
plemenitima	cjelokupnima	lemma
suradniku	suradnicima	Number
oštrila	oštrile	Gender
snimile	snimljene	Voice
najrodoljubnije	najspornije	lemma
odah	oda	Person
najnabusitije	najuviđavnije	lemma
miješane	miješale	Voice
labavijim	slasnijim	lemma
kozera	kòzēr	Case
proučavan	proučavano	Gender
anarhist	anarhisti	Number
oborena	oborila	Voice
pržunu	pržunima	Number
razlabaviš	razlabavim	Person
ugovoreni	ugovorena	Gender
kronične	transcendentne	lemma
pomeša	pomešamo	Person
podstavu	podstave	Case
pȇtākā	petka	Number
proizvodnu	proizvodne	Number
omiškima	trubadurskima	lemma
izvedivi	šumoviti	lemma
lagane	anarhične	lemma
prijetnje	prijetnju	Case
brije	brijem	Person
počinila	počinjena	Voice
praistoriju	praistorije	Number
jedincatima	treznima	lemma
korelativna	šaljiva	lemma
smetali	smetale	Gender
monstruoznu	punašnu	lemma
nogometaška	fonetička	lemma
porozne	ushićene	lemma
plasmane	plasmána	Case
radnicu	radnicom	Case
limenoga	uzetoga	lemma
crknuta	crknula	Voice
neslanoga	generalnoga	lemma
koščato	definitivno	lemma
prisili	prisile	Number
trovala	trovalo	Gender
rastvarano	rastvarana	Gender
slučajnosti	slučajnostima	Number
tranzistori	tranzistore	Case
prerušismo	preruši	Person
prevodili	prevodila	Gender
susjedstvima	susjedstva	Case
patologija	patologije	Number
intravenozna	privržena	lemma
sumnjala	sumnjali	Gender
knjižničara	furundžije	lemma
hladnoratovski	bjeloruski	lemma
dostigla	dostignuta	Voice
palimpsesta	palimpseste	Case
prilagodiše	prilagodi	Person
valovi	valovima	Case
mumije	mumija	Case
užurba	užurbam	Person
udarile	udarila	Gender
harale	harali	Gender
podobnima	bespredmetnima	lemma
termopilske	termopilski	Gender
ago	silo	lemma
plućna	ženska	lemma
zamerke	zamerkama	Case
veseljacima	veseljaku	Number
garantovala	garantovale	Gender
usavršavala	usavršavana	Voice
međusobne	dijagonalne	lemma
kožnu	vražju	lemma
paprati	paprat	Case
ekstremìzma	ekstremizam	Case
transformaciju	transformacijo	Case
nošen	nošena	Gender
jednoglasna	rječita	lemma
nesavjesnijih	sanjivijih	lemma
završila	završio	Gender
izdanjem	izdanja	Case
neuništive	raznobojne	lemma
rabljena	rabila	Voice
rubu	rub	Case
prošasmo	prošahu	Person
dođe	dođu	Person
terapiju	terapija	Case
fagoti	fagote	Number
prljana	prljani	Gender
čaplji	čȁplja	Case
najprašnjavijemu	najgorčemu	lemma
odvođena	odvođeni	Gender
bogoslov	bogoslovi	Number
aparatčikima	aparatčiku	Number
lovina	lovine	Case
alegorije	alegorija	Number
smilovala	smilovali	Gender
najpotištenijoj	najsurovijoj	lemma
minutu	minuta	Case
probavila	probavio	Gender
glavnica	glavnice	Number
najmelankoličnije	najfragilnije	lemma
usvajaše	usvajahu	Person
rodne	budimpeštanske	lemma
sućutima	sućuti	Number
belasala	belasali	Gender
mota	motamo	Person
limarski	božiji	lemma
pljačke	pljačka	Case
vrtovima	vrtu	Number
krivih	spornih	lemma
dodatke	dodacima	Case
ucenismo	uceni	Person
bazalo	bazao	Gender
vrednošću	vrednosti	Case
policijske	tokijske	lemma
letećemu	dravskome	lemma
smela	smeo	Gender
obećanjima	dugajlijama	lemma
pravilniku	pravilnicima	Number
nulama	nulom	Number
crvenjaše	crvenjah	Person
mišićaviji	atraktivniji	lemma
bajtama	bajtom	Number
kapricima	kaprice	Case
preskočila	savladavala	lemma
nadvojvode	ucene	lemma
iskazale	iskazali	Gender
komunikativna	ruševna	lemma
presecah	presecasmo	Person
jašile	jašila	Gender
svjedòdžba	svjedodžbi	Case
jednoimenoga	jednoimeno	Case
priručniku	priručnik	Case
deranu	dèran	Case
vunena	vunene	Gender
didaktiko	didaktike	Case
sunulo	sunula	Number
iznjedrio	iznjedrilo	Gender
upotrebljavane	upotrebljavani	Gender
nezaboravno	radosno	lemma
dogovoreni	dogovorena	Gender
izbijala	bubala	lemma
zalutala	zalutali	Gender
reporterima	reportere	Case
zimujte	zimuj	Person
koristiš	koristim	Person
rastavljena	rastavljeno	Gender
strijelcu	strijelcem	Case
litici	liticama	Number
realnija	zlobnija	lemma
novijima	šaljivijima	lemma
verige	vȅrīgā	Number
privole	dozvoljavaše	lemma
preokretima	preokreti	Case
trapezistu	trapezistima	Number
uočljivi	genijalni	lemma
zahteva	zahtevu	Case
objavljivan	objavljivao	Voice
istarska	takozvana	lemma
zavisila	zavisili	Gender
izdavale	izdavala	Gender
udvostručila	udvostručena	Voice
gurnuo	gurnulo	Gender
ušteđeno	uštedjelo	Voice
svlada	svladaše	Person
isticala	isticale	Gender
istine	istinama	Case
izlete	izleti	Case
postolje	postolja	Number
rebalansa	rebalans	Case
sašilo	sašila	Gender
trgovačkih	trgovačke	Number
pretpostavio	pretpostavilo	Gender
ženino	ženina	Number
uveneš	uvenu	Person
olimpijskom	olimpijskim	Gender
trȁūmā	traumama	Case
središtima	središtem	Number
amputira	amputirah	Person
cepeline	cepelini	Number
revnijima	gnjilijima	lemma
runi	runama	Number
mjerljive	srčane	lemma
naslijediš	naslijedi	Person
obradive	probojne	lemma
zupce	zubac	Number
tromeđe	tromeđa	Case
varan	varana	Gender
otmenijima	vještijima	lemma
spriječena	spriječeno	Number
bilijune	bilijun	Case
operatoru	operatore	Case
strukama	strȕci	Number
nepobedivu	rođenu	lemma
nuklearke	nuklearko	Number
škatula	škatulu	Case
poremetila	poremetile	Gender
paranoičnijemu	taktičnijemu	lemma
meleke	melecima	Case
pozvana	pozvala	Voice
obrnuta	obrnula	Voice
julskim	belgijskim	lemma
zašla	zašao	Gender
gladne	gladna	Number
blefovima	blefovi	Case
rezistentnija	drastičnija	lemma
apstrakcije	apstrakcija	Case
pustite	puste	Person
pobili	pobijeni	Voice
nervoznim	raskošnim	lemma
sustizalo	sustizano	Voice
isijecana	upućivana	lemma
nanerviralo	nanervirano	Voice
navlažila	navlažio	Gender
kapitalističke	kapitalistički	Case
nestabilnosti	nestabilnost	Case
pripravljala	pripravljale	Gender
dozvah	dozvaše	Person
zadovoljena	zadovoljila	Voice
termometri	termometar	Number
vodi	vodama	Number
razvilo	razvila	Gender
kotačem	kotačima	Number
sadašnje	finalne	lemma
skutom	skutima	Number
nastavljala	nastavljana	Voice
umišljeno	umišljena	Gender
odvijaču	odvijač	Case
teista	teist	Case
tlakove	tlakovi	Case
uvodila	uvođena	Voice
preseklo	presečeno	Voice
sadržavale	sadržavala	Gender
pregreja	zaštićivaše	lemma
najinventivnijemu	najzlobnijemu	lemma
pišaše	sjedaše	lemma
iskustveni	talentirani	lemma
kreditnih	središnjih	lemma
sazrevaju	sazreva	Person
ispituje	učlanjuje	lemma
најдостојнији	достојнији	Comparison
namnažane	namnažana	Gender
ozlijeđene	ozlijedile	Voice
rešetao	rešetan	Voice
neočekivane	suptilne	lemma
nemoći	nemoć	Number
kaši	kašu	Case
iskustvena	spretna	lemma
uzvikivani	uzvikivali	Voice
nogometnih	sanskrtskih	lemma
pornografijom	pornografiju	Case
rasporedilo	rasporedio	Gender
teoretičaru	teoretičar	Case
hrapavijega	voljnijega	lemma
smeštena	smešteno	Gender
nesumnjiva	razbludna	lemma
zaokruživane	zaokruživale	Voice
dojavljen	dojavio	Voice
најнеотесанији	неотесанији	Comparison
vozan	vozao	Voice
predvodio	predvođen	Voice
izgrizete	izgrizemo	Person
irealne	riskantne	lemma
uteši	utešimo	Person
bodrena	bodreni	Gender
osnovala	osnovana	Voice
izručili	izručile	Gender
strijelu	strijela	Case
krolavala	krolavali	Gender
umetnici	umetnice	Case
izmjerivih	učinkovitih	lemma
palatalni	bakteriološki	lemma
najracionalnijima	racionalnijima	Comparison
drške	drškama	Case
rasječena	rasječeni	Gender
zauzimam	zauzimaju	Person
uzgajala	uzgajana	Voice
otputovala	otputovali	Gender
komentiralo	komentirala	Number
ispunilo	ispunjeno	Voice
vezivalo	vezivano	Voice
tabletama	tableti	Number
iskazani	iskazali	Voice
zanimljivosti	zanimljivostima	Number
gaza	gazu	Case
mašinom	mašinama	Number
izorem	zašiljim	lemma
hrčak	hrčci	Number
nesimetrične	nesimetrični	Gender
ubacivali	ubacivani	Voice
krovna	bugarska	lemma
vȃljākā	váljka	Number
probuđivali	probuđivani	Voice
utrošili	utrošeni	Voice
porobljivaste	usisaste	lemma
pokušale	pokušali	Gender
posjećeni	posjetili	Voice
sporazumima	sporazuma	Case
izoštren	izoštrena	Gender
pristupila	pristupilo	Gender
uradila	urađena	Voice
razdvajan	razdvajani	Number
kružah	kružasmo	Number
jalov	tegoban	lemma
tekućine	tekućina	Number
primerenijom	beznačajnijom	lemma
neminovne	uvjerene	lemma
organskima	beograđanskima	lemma
cariniku	carinicima	Number
vesternima	vesternom	Number
plural	visibabe	Case
pastama	paste	Case
prognao	prognan	Voice
numeričkoj	bogataševoj	lemma
ostajala	ostajao	Gender
sliza	slizaste	Number
feminizmom	feminizam	Case
najkakofoničniji	najsenzualniji	lemma
ispunili	ispunila	Gender
pribavljao	pribavljalo	Gender
rezahu	rezaše	Number
testa	testova	Number
vrijedna	vrijednoj	Case
ovisile	ovisila	Gender
izbačeni	izbačene	Gender
okrutne	raznolike	lemma
oprječni	zorni	lemma
odlučno	tendenciozno	lemma
osporila	osporena	Voice
digresije	digresijama	Case
prekršila	prekršena	Voice
carici	caricama	Number
posetitelja	posetiteljima	Case
krhka	životna	lemma
kobna	srčana	lemma
nezamijećenima	suhima	lemma
shema	shemi	Case
resurs	resursi	Number
prihvatljiviji	svirepiji	lemma
muškima	vlastelinskima	lemma
bacanjem	bacanju	Case
logičkim	vrhunskim	lemma
brojano	brojalo	Voice
nekakve	bistre	lemma
proglasilo	udarilo	lemma
podčinile	podčinjene	Voice
bogataša	bogatašem	Case
parovima	parovi	Case
kišnijemu	svjesnijemu	lemma
seminaru	seminarima	Number
poništavam	poništavate	Person
presađeni	presađena	Gender
minutima	minutom	Number
bajbuka	bajbukom	Case
kapelici	kapelica	Case
pobledi	zavrijedi	lemma
zanemaren	zanemario	Voice
uvidi	uvide	Person
nježan	zanimljiv	lemma
šuštala	šuštao	Gender
tuđine	tuđinu	Case
albini	albine	Case
svrdlima	svrdla	Case
saborne	tiranske	lemma
izljućena	izljutila	Voice
prodajama	tradicijama	lemma
najmudrijima	mudrijima	Comparison
nerealne	uzajamne	lemma
poručile	poručene	Voice
politička	političkoj	Case
sagradio	sagrađen	Voice
osvježava	puzi	lemma
jedrenjak	jedrenjaku	Case
koprive	koprivama	Case
etnologijo	etnologije	Case
nezasićena	senilna	lemma
pravilnik	pravilniku	Case
odsecah	odsecahu	Person
kozmičke	štokavske	lemma
himbeni	vrletni	lemma
oduzeta	oduzeto	Gender
navodio	navodila	Gender
biokemijo	biokemije	Number
očevidnija	svečanija	lemma
nebogima	toplima	lemma
najprofesionalnija	najustrajnija	lemma
otpočinula	otpočinulo	Gender
iskoristila	iskoristio	Gender
osamljeno	arbitrarno	lemma
sređivao	sređivan	Voice
lemurima	lemuru	Number
stranci	stranče	Number
iskazale	iskazala	Gender
mineralna	mineralni	Gender
osvaja	osvajaju	Person
neizlečivih	venoznih	lemma
šakale	šakala	Number
obaoobla	bujanbujna	lemma
profitiraste	smaknuli	lemma
neuverljivijima	daljima	lemma
posrkana	farbana	lemma
odmotan	odmotana	Gender
rešene	rešile	Voice
komplementarnomu	samoproglašenomu	lemma
ružama	ruže	Case
ispitane	ispitale	Voice
predbačen	predbacio	Voice
rakije	rakiju	Case
intuiciji	intuicija	Case
namenjivana	prospavana	lemma
barci	barku	Case
odbačeni	odbacili	Voice
најприсебнији	присебнији	Comparison
atmosferama	atmosferi	Number
neiscrpiva	analitična	lemma
ortodoksija	ortodoksije	Number
rize	rizo	Number
opisivala	opisivale	Gender
legalnih	legalna	Number
amane	amana	Case
svršena	svršeni	Gender
kovačnicu	kovačnici	Case
istosmjerna	simptomatična	lemma
koherentna	trijumfalna	lemma
štrajku	štrajk	Case
probijala	probijao	Gender
urađen	urađeno	Gender
tranzistori	tranzistorima	Case
budite	budi	Person
tajile	tajili	Gender
severozapadna	severozapadni	Gender
regulirali	regulirala	Gender
donesla	donesli	Gender
malaksah	malaksasmo	Person
tlače	tlaku	Case
naslućivali	naslućivala	Gender
incestu	incestom	Case
koščatu	spekulativnu	lemma
minaret	minarete	Case
označavale	označavali	Gender
poručnikom	poručniku	Case
izabrani	izabrane	Gender
raskrsnica	garancija	lemma
kućne	zakonske	lemma
rastopljeni	rastopljena	Gender
sušicom	sušici	Case
uvidela	uvideo	Gender
pridodano	pridodan	Gender
okupljate	okuplja	Person
babilonske	babilonskima	Case
obrijali	obrijani	Voice
opaskama	opaskom	Number
ohola	ohole	Gender
opredijelite	upoznate	lemma
ispuštali	ispuštao	Number
muzejskome	muzejsko	Case
tračeru	tračera	Case
uvređene	uvređena	Gender
nadmašila	nadmašile	Number
efikasnošću	efikasnosti	Case
čalabrcnite	čalabrcni	Person
linearna	saberiva	lemma
plavetna	znamenita	lemma
pripomenem	pripomenete	Person
poštovao	poštovalo	Gender
bacah	bacasmo	Person
osifikacije	divljakuše	lemma
cenzura	cenzuru	Case
potvrđivali	potvrđivale	Gender
barbara	barbaru	Case
pticama	pticom	Number
naručeno	naručena	Number
oficijelna	stalna	lemma
cenjen	cenio	Voice
sasečena	sasečeno	Gender
zasjenjene	zasjenile	Voice
etnologija	etnologiju	Case
značila	značio	Gender
udaljavana	udaljavala	Voice
korporativnima	uzaludnima	lemma
najplemenitijima	najdvoličnijima	lemma
vraćana	vraćala	Voice
prikupljeno	prikupljena	Gender
dosegnula	dosegnuta	Voice
vučići	vučiću	Number
tiskale	tiskali	Gender
hortikulture	hortikulturu	Case
istraživane	istraživana	Gender
probijaj	probijajte	Person
potraje	samoupravlja	lemma
mokraćama	devetinama	lemma
objesim	objesite	Person
najosetnijom	najromantičnijom	lemma
paneliraše	digao	lemma
autoportretom	autoportretima	Number
najingenioznijima	najsistematičnijima	lemma
saprana	saprano	Gender
stanovima	stanu	Number
sušila	sušilo	Gender
obaveštajnih	akademskih	lemma
novorođenčeta	novorođenče	Case
ražesti	ražestiš	Person
staroslavensko	staroslavenskim	Case
osnivala	osnivana	Voice
poštovana	poštovane	Gender
spominjan	spominjao	Voice
kratkovida	šašava	lemma
nečovječna	sužena	lemma
kovrdžava	raznobojna	lemma
bljeskale	bljeskali	Gender
osiromašio	osiromašila	Gender
prirodnijemu	skromnijemu	lemma
dragajte	dragajmo	Person
cenzuro	cenzurom	Case
potrošnje	dešnjáci	lemma
okrenuo	okrenut	Voice
značile	značila	Gender
plugove	plugovima	Case
stabilizaciji	stabilizaciju	Case
prći	prće	Number
lepi	refleksivni	lemma
palili	paljeni	Voice
domišljamo	domišljam	Person
istraživačka	aztečka	lemma
vozani	vozane	Gender
sneg	snegom	Case
klekne	skija	lemma
najpouzdanijom	najtrjeznijom	lemma
dislokacijo	dislokacijom	Case
plješivima	bezglasnima	lemma
netačni	certificirani	lemma
kritičnijim	zamamnijim	lemma
ložačkoj	šampanjskoj	lemma
iseljenicima	iseljenike	Case
kredi	kredu	Case
nabola	zagrizla	lemma
identičnu	bledu	lemma
slobodoumljima	slobodoumlju	Number
muftije	muftiju	Number
kriminalni	diskretni	lemma
susede	suseda	Number
pravodobnijega	crvljivijega	lemma
ugašeni	ugasili	Voice
zgusnuo	zgusnula	Gender
železnice	železnicu	Case
vrancima	vrancu	Number
najmobilnijom	najsitničavijom	lemma
predočen	predočeni	Number
isjekao	isječen	Voice
popularizatori	popularizatore	Number
lanci	lance	Case
rascijepio	rascijepljen	Voice
suzdržavane	suzdržavana	Gender
dètešce	detéšca	Case
razorilo	razoreno	Voice
dobivala	dobivao	Gender
astenosfera	astenosferi	Case
omotala	omotale	Gender
podseti	suzdrži	lemma
granicu	granica	Case
špenglere	špengleri	Case
stupce	stupac	Number
lombardirala	lombardiralo	Gender
sažimaš	sažima	Person
terenom	terenima	Number
iskrala	iskrali	Gender
plodoredi	plodoredima	Case
nebogijima	detaljnijima	lemma
plećkama	plȅćki	Number
panjevi	panjeva	Case
stopila	stopljena	Voice
kamionski	automobilski	lemma
tektonike	tektonici	Case
obustavljen	obustavio	Voice
ešekom	ešeku	Case
utopio	utopljen	Voice
zapada	zapadaju	Person
prisjećalo	prisjećao	Gender
osporene	osporile	Voice
obujmio	obujmljen	Voice
prepoznala	prepoznata	Voice
pravopise	pravopisi	Number
plaćale	plaćali	Gender
doneseno	donesen	Gender
uvriježila	uvriježena	Voice
kratkovalne	kratkovalnoj	Case
anglikanci	anglikancima	Case
benzinu	benzin	Case
rešilo	rešila	Gender
uticalo	uticao	Gender
spljoštile	spljoštili	Gender
okrali	okradeni	Voice
simulirala	simulirali	Gender
kreševska	zjenična	lemma
nalazi	spomeni	lemma
izvještavali	izvještavale	Gender
susrela	susreo	Gender
zemljoradnja	zemljoradnjom	Case
očevidne	bljutave	lemma
olakšavana	olakšavano	Gender
paljen	palio	Voice
polugodišta	sile	lemma
obuhvaćeno	obuhvaćen	Gender
lokalima	lokalu	Number
reinkarnirasmo	aktualizirasmo	lemma
mnijenja	čitatelji	lemma
ukusu	ukusima	Number
interesa	sofizma	lemma
traumu	traumom	Case
најинфериорнији	инфериорнији	Comparison
ponašale	ponašala	Gender
nepostojanu	šupljikavu	lemma
sazvani	sazvan	Number
pokvarene	nesumnjive	lemma
srednje	srednja	Gender
oglodavali	oglodavani	Voice
fetusa	fetusu	Case
napadali	slabili	lemma
izvučeni	izvukli	Voice
rudničke	elektromagnetske	lemma
podmiti	bojuje	lemma
oborile	oborene	Voice
predsednica	predsednici	Case
utoljivahu	utoljivasmo	Person
razne	sarajevske	lemma
šokirali	šokirala	Gender
razlomljeno	razlomljen	Gender
masivna	apstraktna	lemma
gonili	gonile	Gender
pukotine	pukotina	Case
umetnika	umetniku	Case
nesložna	znatna	lemma
prikazivan	prikazivano	Gender
dolikuju	dolikuješ	Person
kartografi	kartografe	Number
nepovoljniji	sramotniji	lemma
nadahnjivala	rastala	lemma
poplavile	poplavljene	Voice
snȋmci	snimkama	Number
alibi	alibija	Case
iscrpnije	skrovitije	lemma
razbiti	razbili	Voice
stagnirala	stagnirao	Gender
priboru	priborom	Case
ponovnima	drvenima	lemma
imenica	imenici	Case
obrazlažimo	obrazlažite	Person
pričaj	pričajmo	Person
identična	umna	lemma
međusobnima	tugaljivima	lemma
moliš	molim	Person
vješano	vješana	Gender
naslikane	naslikani	Gender
ustrojiš	ustrojite	Person
participirale	participirala	Gender
egzil	egzilu	Case
kriptičke	bečke	lemma
omogućen	omogućio	Voice
dopune	dopuni	Case
glistama	gliste	Case
ovcom	ovcama	Number
buknula	buknuli	Gender
azbučnih	azbučni	Case
obrazuj	skiciraj	lemma
odsečen	odsekao	Voice
geometrijska	geometrijske	Gender
nebeskih	vaseljenskih	lemma
ingenioznije	najingenioznije	Comparison
krivotvorine	krivotvorina	Case
kidaše	kidahu	Person
mlađoj	strašnijoj	lemma
pubertetskom	crkvenoslovenskom	lemma
limunovima	zagrebačkima	lemma
mučilo	mučeno	Voice
zapaljen	zapalio	Voice
izrazitijima	bodrijima	lemma
poglavara	poglavarima	Case
očistili	očistio	Number
izračunavale	izračunavali	Gender
fotonom	fotone	Case
napunile	napunili	Gender
savezništava	savezništva	Case
najprominentnije	najuočljivije	lemma
zapušteno	zapušten	Gender
pogledamo	zanoćamo	lemma
odnosio	odnosila	Gender
primećivali	primećivani	Voice
paljene	svrstane	lemma
odabirima	odabirom	Number
oboreno	oborilo	Voice
zanimanju	zanimanjima	Number
knjigama	skloništima	lemma
naslikana	naslikala	Voice
neprekinutima	večnima	lemma
mržaše	mržaste	Number
prevladana	prevladala	Voice
labilnu	prsatu	lemma
inspiracije	inspiracija	Number
mekšana	spjevana	lemma
bede	bedo	Number
jordanske	godišnje	lemma
imenu	ime	Case
neprocjenjiva	regionalna	lemma
lakat	laktu	Case
kratkoročna	slavna	lemma
odvjetnicima	odvjetniku	Number
primijenio	primijenjen	Voice
udaljilo	udaljeno	Voice
učlanjen	učlanio	Voice
najnemoralnijim	najzloglasnijim	lemma
racionalizirali	racionalizirala	Gender
saginjana	saginjan	Gender
grotesknije	čišće	lemma
doprinijeli	doprinijela	Gender
cijenila	cijenio	Gender
pripremih	pripremi	Person
klasika	klasikom	Case
maloljetnom	čuvenom	lemma
germaniziraste	germanizirah	Person
smognete	smognem	Person
sticali	sticala	Gender
strogošću	strogosti	Case
sipala	sipana	Voice
besposličare	besposličari	Person
neprobojnomu	beživotnomu	lemma
orgije	orgija	Number
stiglo	stigao	Gender
guraše	guraste	Person
antitezu	antitezom	Case
napeti	napeta	Gender
nadevala	nadevali	Gender
sezala	sezali	Gender
vjeruje	vjeruju	Number
čistilo	čišćeno	Voice
klevete	kleveta	Case
pazarila	pazario	Gender
diktirala	diktirao	Gender
izgnani	izgnali	Voice
nadimali	nadimani	Voice
lojalna	fundamentalna	lemma
lišen	lišio	Voice
jugoistoka	jugoistok	Case
najprevashodnijima	najglasnijima	lemma
gusarila	gusarili	Gender
nosne	nosnoj	Case
isprani	isprane	Gender
praznòglāvci	praznòglavac	Number
droge	drogom	Case
podaniku	podanik	Case
krvavica	krvavice	Case
posveti	posvete	Number
unuku	unucima	Number
bolesnica	bolesnice	Number
nečujno	sarkastično	lemma
delu	delom	Case
nadograđivana	nadograđivani	Gender
kratkonoge	gnjile	lemma
snabdesmo	snabde	Person
napornu	grandioznu	lemma
mistične	receptivne	lemma
opstala	opstalo	Gender
proletersko	sintetsko	lemma
anektiramo	anektiraju	Person
botunom	botúna	Case
zavređivale	zavređivane	Voice
nadobudnoga	produktivnoga	lemma
ćerale	ćerala	Gender
gricnu	sviđaju	lemma
zasluzi	zaslugama	Number
odana	tmurna	lemma
kukove	kuk	Number
kristologijskoga	siječanjskoga	lemma
iskopana	iskopala	Voice
homoseksualcima	homoseksualcu	Number
prodane	prodale	Voice
prognozirala	prognoziralo	Gender
osetih	osetiše	Person
zavređuje	zavređuješ	Person
zalila	zalilo	Gender
duvanu	duvan	Case
otvoreni	otvorene	Gender
najnesložniji	najuverljiviji	lemma
prepeku	zabole	lemma
izmislili	izmislila	Gender
prodori	prodore	Case
stavljalo	stavljano	Voice
iskrvari	iskrvarih	Person
osramotismo	osramotiše	Person
lažna	svojeglava	lemma
snabdje	snabdjesmo	Person
pojedinačni	transcendentni	lemma
gluhoćom	gluhoću	Case
sačinjeno	sačinjena	Gender
iznenadilo	iznenađeno	Voice
kozačkom	kozačkoj	Case
implicitnih	trpkih	lemma
kvartetima	sinovcima	lemma
mršavijega	apstraktnijega	lemma
markama	maraka	Case
ponižavasmo	ponižavah	Number
priveo	priveden	Voice
izložbe	snajperi	lemma
imovinska	umjetnička	lemma
aferi	afera	Case
hidrate	hidrat	Number
sazvano	sazvana	Gender
zvano	zvan	Gender
pretapala	pretapali	Gender
primetila	primetili	Gender
refleksivnija	veća	lemma
homoseksualaca	homoseksualci	Case
doktorskih	doktorski	Case
čestitali	čestitale	Gender
zijale	zijala	Gender
dobijete	dobiješ	Person
rascepite	rascepimo	Person
razmatrale	razmatrane	Voice
poštedjeli	pošteđeni	Voice
obogaćeno	obogatilo	Voice
kradljivima	bučnima	lemma
rusofili	rusofile	Number
ukazivalo	ukazivala	Gender
pretučen	pretukao	Voice
noćašnje	tarifne	lemma
vonj	vònja	Case
škveranine	škverani	Number
humanističkoga	donjega	lemma
časovniku	časovnik	Case
tabelu	tabele	Number
moderna	besramna	lemma
kemikalijama	kemikalija	Case
difuzije	difuzija	Number
mirisni	sedi	lemma
dugoročnih	dugoročni	Case
izbegla	izbegao	Gender
rubeola	rubeolom	Case
mandarinski	barokni	lemma
brvno	brvnu	Case
incestuozna	generalna	lemma
nejasnoćama	nejasnoći	Number
podržao	podržala	Gender
најизбирљивији	избирљивији	Comparison
opasano	opasan	Gender
riznica	riznice	Case
ljudožderstvom	ljudožderstvu	Case
pita	pite	Gender
bezjaci	bezjake	Case
kotlinom	kotlinu	Case
nelojalniji	značajniji	lemma
obarana	obarano	Gender
guši	gušom	Case
utvrđena	utvrdila	Voice
husitskih	dvoličnjačkih	lemma
ojačana	ojačani	Gender
konvencionalnijega	najkonvencionalnijega	Comparison
obezglavili	obezglavljeni	Voice
najkišniju	najbešćutniju	lemma
dokazana	dokazala	Voice
dikcija	dikciji	Case
nelagodnima	cjelokupnima	lemma
punile	punjene	Voice
rat	ratovi	Number
zracima	zraku	Number
uzmicalo	uzmicao	Gender
peščaniku	peščanik	Case
presretne	presretnete	Person
bariton	baritoni	Number
invazijske	germanske	lemma
kritizeri	kritizeru	Number
olakotnosti	olakotnost	Case
naslućivaše	raznošaše	lemma
redosled	redosledom	Case
katastrofalna	delikatna	lemma
ciljao	ciljalo	Gender
baladu	balade	Number
spljošteni	spljoštena	Gender
kovačićkima	telesnima	lemma
zijevnuše	zijevnu	Person
najdetinjastijima	detinjastijima	Comparison
odjeven	odjenuo	Voice
advokatske	analitičke	lemma
toksína	tòksīn	Case
smještali	smještani	Voice
šnofala	šnofalo	Gender
hlapjahu	hlapljaste	Person
mehanici	mehaniku	Case
ruđaste	ruđah	Person
opremila	opremljena	Voice
značkom	značkama	Number
odličnima	grabljivima	lemma
zabunkerirane	zabunkerirana	Gender
pritiscima	pritisku	Number
čestitahu	čestitaste	Person
poklonilo	poklonjeno	Voice
tonulo	tonuo	Gender
starešina	starešine	Case
lojalnijima	najlojalnijima	Comparison
pištolj	pištolju	Case
oživjelo	oživljeno	Voice
bjelkinje	bjelkinja	Number
naporna	dugačka	lemma
otpisan	otpisao	Voice
prevrnuti	prevrnuta	Gender
proterana	proteran	Gender
mlađima	tajnovitijima	lemma
posveta	posvete	Number
latinizacije	latinizacijama	Case
lomljavama	lomljavom	Number
kućnima	suglasničkima	lemma
okupljasmo	okupljah	Person
stvorilo	stvoreno	Voice
kijah	kijaše	Person
otporu	otpora	Case
donje	donja	Number
beatifikaciji	beatifikacije	Case
kožarstvo	kožarstvom	Case
roditelju	roditeljima	Number
poslužilo	poslužio	Gender
smenilo	smenio	Gender
neurotična	zlonamjerna	lemma
hodžo	hodžom	Case
predavanje	predavanja	Number
rascjepljivana	rascjepljivala	Voice
napadnima	savremenima	lemma
medvjeđe	alpsko	lemma
ponosnije	brzopletije	lemma
afroazijska	anorganska	lemma
upijemo	upijete	Person
izolira	saplete	lemma
kupovao	kupovan	Voice
bogalji	bogaljima	Case
zamjereno	zamjerilo	Voice
bombarderi	bombarderima	Case
klizile	klizila	Gender
nadgledala	nadgledale	Gender
malobrojne	dlakave	lemma
šali	šalu	Case
hoćete	hoćeš	Number
pivarske	armenske	lemma
zaviđale	zaviđala	Gender
ćuprijama	ćȕprījā	Case
kopani	kopan	Number
nužne	blage	lemma
nepogrešiv	sferičan	lemma
teste	testa	Case
nemoderna	skupocjena	lemma
otpiljena	otpiljeni	Gender
oživljena	cjelivana	lemma
najpasivniji	najbrzopletiji	lemma
suzbijeni	suzbijena	Gender
najnaivnije	najgolišavije	lemma
dečacima	dečaka	Case
izlizivani	izlizivana	Gender
kajkavska	elektronska	lemma
srednjoškolce	srednjoškolca	Number
osetljivije	veselije	lemma
odgovorima	odgovorom	Number
retora	retor	Case
koštale	koštala	Gender
stvarana	stvarane	Gender
ukrašena	ukrašeni	Gender
potpisivali	vozili	lemma
progovorili	progovorile	Gender
nesnosnija	suženija	lemma
nemoći	nemoćima	Number
ostvarivale	ostvarivali	Gender
strpele	strpela	Gender
popravljivom	popravljivima	Number
kovnica	kovnici	Case
vojuješ	vojujem	Person
akceptoru	akceptor	Case
proteran	proterao	Voice
odlučena	odlučen	Gender
jajna	starinska	lemma
šamani	šaman	Number
snáhā	snahe	Case
abrazivne	smislene	lemma
redukcijama	redukcije	Case
skarabeje	skarabeju	Case
prebačena	prebacila	Voice
nadopunjeno	nadopunjena	Gender
topologiji	topologije	Case
neuništiva	cjelokupna	lemma
okradana	okradala	Voice
provaljivane	provaljivale	Voice
promaknut	promaknuo	Voice
mandarina	mandarino	Case
vermuti	vermute	Number
izranila	izranjena	Voice
zadimljene	zadimile	Voice
isprobana	isprobala	Voice
ispravnima	besputnima	lemma
uklonile	uklonjene	Voice
imućnijega	dokonijega	lemma
nestabilna	nestabilnoj	Case
stvorenja	stvorenje	Number
ograničeni	ograničena	Gender
neprestanu	društvenu	lemma
fiskalnima	fiskalnome	Number
izvodljivijemu	gracioznijemu	lemma
ekspedicije	ekspediciji	Case
variolo	variolom	Case
istopljene	istopljeni	Gender
učesnicu	učesnici	Case
dvojniku	dvojnika	Case
svojine	svojinu	Number
opsednuta	opsednuti	Gender
preventivnu	apsolutnu	lemma
svrdlo	svrdla	Number
sukobili	sukobljeni	Voice
grbovi	grbovima	Case
tačerizmu	tačerizmom	Case
povećao	povećalo	Gender
kapelice	kapelica	Case
brojah	brojaste	Person
luetičnima	crvenkastima	lemma
razmnožava	razmnožavaju	Person
pobije	pobiju	Number
visibabo	visibabe	Number
pošteđivala	vijećala	lemma
iznijele	iznesene	Voice
izvadismo	apsorbirasmo	lemma
radiološkima	unutarnjima	lemma
taljen	taljeno	Gender
ruska	sumerska	lemma
zakonike	zakonik	Number
pobijedila	pobijeđena	Voice
kratkodometnih	domaćinskih	lemma
prikazivaše	prikazivaste	Person
pakirajmo	pakirajte	Person
rječitije	zauzetije	lemma
kamerama	kameri	Number
pretopili	pretopljeni	Voice
zdravstva	zdravstvom	Case
nicale	nicala	Gender
otpočinite	škripite	lemma
obučio	obučen	Voice
psihijatrijskih	psihijatrijske	Number
podstanarke	podstanarkama	Case
boravilo	boravio	Gender
popraćivani	popraćivali	Voice
zastrli	zastrle	Gender
odleđivala	odleđivana	Voice
homogene	senzualne	lemma
uočilo	uočeno	Voice
izgrađivane	izgrađivana	Gender
polagala	polagali	Gender
raznošene	raznosile	Voice
hvalevrijedno	savitljivo	lemma
zadržavamo	zadržavaju	Person
prihvaćene	prihvatile	Voice
mobilnih	čvrstih	lemma
dodijelimo	dodijelite	Person
bubnjeve	bubnjevima	Case
најгладнији	гладнији	Comparison
glagoljici	glagoljicu	Case
utemeljena	utemeljila	Voice
teokracija	teokracije	Case
smȇr	smeru	Case
poljodjelstva	poljodjelstvom	Case
adresirala	adresirao	Gender
kupalištima	kupalištu	Number
varijacijama	varijaciji	Number
infracrveni	aktivni	lemma
marelice	marelicu	Number
pukao	pukla	Gender
naslijeđen	naslijeđena	Gender
runu	runo	Case
istovaren	istovareno	Gender
opredelilo	prošlo	lemma
tvoraca	tvorcima	Case
rimokatolike	rimokatolici	Case
zastrašivala	zastrašivana	Voice
dodjeljivalo	dodjeljivala	Gender
paukovima	beskamatnima	lemma
tiskarom	tiskaro	Case
komadiću	komadići	Number
upropaštavano	upropaštavalo	Voice
iskazivalo	iskazivano	Voice
gravitacijske	torzijske	lemma
razvijala	razvijalo	Gender
poslužilo	posluženo	Voice
opečen	opekao	Voice
odbacile	odbačene	Voice
paradigmi	paradigme	Case
srednjoafričku	srednjoafričke	Number
poletela	poleteo	Gender
životinjskim	životinjskoga	Case
oštroumne	vječne	lemma
slovenačko	slovenačku	Gender
izbirljivi	definitivni	lemma
opravdanom	simptomatičnom	lemma
idealizirasmo	besjeđasmo	lemma
nuđena	nudila	Voice
odustala	odustao	Gender
zelenilima	zelenilu	Number
najodmornijih	najbezbrižnijih	lemma
praznika	praznici	Case
hotelskima	šetačkima	lemma
dlijetima	dlijetom	Number
tisućljećima	tisućljeću	Number
izazvane	izazvale	Voice
dragocenosti	dragocenostima	Number
nuli	nulu	Case
smjerovi	smjeru	Number
pronađeno	pronašlo	Voice
uputstva	upùtstvo	Number
rasijecane	rasijecale	Voice
raje	raji	Case
predane	predana	Gender
sprovedeš	sprovedem	Person
dotrčite	dotrči	Number
opasivala	opasivana	Voice
pljačkala	pljačkana	Voice
najneuverljivijega	najsiromašnijega	lemma
nepotpunomu	slinavomu	lemma
neprobojne	vrsne	lemma
prilaza	učenja	lemma
најкарактернији	карактернији	Comparison
šoku	šok	Case
sjekiretina	sjekiretine	Case
izopačene	izopačeni	Gender
izumrijeste	izumrijesmo	Person
primese	primesa	Number
upravljalo	upravljao	Gender
posebno	vjerodostojno	lemma
bezosećajnosti	bezosećájnōst	Case
navici	navikama	Number
neovisnoj	bezuspešnoj	lemma
para	par	Case
nepažljivo	apsolutno	lemma
prebacivala	prebacivana	Voice
progutana	progutan	Gender
proizvodni	телесни	lemma
spominjala	spominjalo	Gender
izlaže	izlažu	Person
pozivala	pozivana	Voice
sečen	sekao	Voice
kladi	kladu	Case
neznatne	sadržajne	lemma
uvježbane	uvježbale	Voice
proprano	propralo	Voice
srknulo	srknuto	Voice
ponovljena	ponovila	Voice
veselijemu	najveselijemu	Comparison
nedjeljni	strateški	lemma
priznalo	priznao	Gender
nastavljalo	nastavljala	Gender
štovaoca	štòvalac	Case
ljudožderstvo	ljudožderstvu	Case
prebacivala	prebacivale	Gender
manekenka	manekenke	Number
gusto	ambijentalno	lemma
rascepu	rascep	Case
imućniji	tuplji	lemma
presahnut	presahnuta	Gender
zavjete	zavjetima	Case
izneseno	iznesen	Gender
želucima	želudaca	Case
reakcionarnim	reakcionarnom	Gender
ušteđen	ušteđena	Gender
praroditelje	praroditelji	Case
okruži	okruže	Person
napuštaju	napušta	Person
zahtjev	zahtjeve	Number
dokazano	dokazana	Gender
točaka	točke	Case
neprecizni	radikalni	lemma
smeši	smeše	Number
aždahama	aždahom	Number
upropaštavana	upropaštavala	Voice
niska	ravnomerna	lemma
ubrizgan	ubrizgao	Voice
obiđe	trošaše	lemma
izopačeno	agresivno	lemma
urotom	urota	Case
pravovernima	dostižnima	lemma
pojačali	pojačala	Gender
kovačevačka	kovačevačko	Gender
brojači	brojaču	Number
dodirivao	dodirivalo	Gender
најпродорнији	продорнији	Comparison
vere	veremo	Person
zadužbine	zadužbinu	Number
jadranske	jadranska	Gender
izdvojeno	izdvojen	Gender
osvrtom	osvrta	Case
izmamljeno	izmamilo	Voice
povoljno	tajanstveno	lemma
uputilo	upućeno	Voice
ispražnjene	rastuživane	lemma
ostajalo	ostajao	Gender
odbijte	odbijmo	Person
opozvani	opozvana	Gender
nenormalna	razdražljiva	lemma
prelazi	prelaze	Person
premalenima	tamnoputima	lemma
ovolikima	žednima	lemma
koštalo	koštao	Gender
nesloge	nesloga	Number
prebrođivan	prebrođivano	Gender
dopuštaju	dopuštate	Person
transferu	transferi	Number
nezávisnōst	nezávisnosti	Case
dočekale	dočekane	Voice
opredeljivano	opredeljivalo	Voice
savinuo	savinuli	Number
izbjegao	izbjegla	Gender
petljo	petlje	Number
golicano	golicalo	Voice
kapiran	kapirana	Gender
nadležnim	razumnim	lemma
ispušismo	ispuši	Person
redatelja	redatelje	Case
mješovite	bezimene	lemma
zaustavljeni	zaustavljena	Gender
ispišem	ispišete	Person
imperijalnih	takmičarskih	lemma
najkapricioznija	najsitničavija	lemma
cementirala	cementiralo	Gender
minimalnoga	minimalno	Case
najblještavije	blještavije	Comparison
pribrajaju	zabavljaju	lemma
nepoželjnom	uvrijeđenom	lemma
strelce	strelca	Number
razvèdenosti	razvèdenōst	Case
svrstavala	svrstavana	Voice
patuljkom	patuljcima	Number
grano	grana	Case
okomiti	tečni	lemma
dopremili	dopremljeni	Voice
premìjēr	premijeri	Number
bludničenja	bludničenje	Case
primjereni	srodni	lemma
iseljene	iseljena	Gender
gušimo	guše	Person
nazdravili	nazdravile	Gender
moskovski	ganski	lemma
etaži	etažama	Number
katoličanstvo	katoličanstva	Case
liturgijom	liturgijo	Case
najlascivnijima	najelastičnijima	lemma
povrću	povrće	Case
mućeni	mućena	Gender
popuste	popusti	Case
totalitarističke	totalitarističkima	Case
podcrtavani	štemovani	lemma
slađaše	slađaste	Person
preostala	preostalo	Gender
krvavome	ubitačnome	lemma
učesniku	učesnicima	Number
uzbuđivana	uzbuđivala	Voice
kornjačama	arhitektima	lemma
plijenu	plijenom	Case
sakrivano	sakrivana	Gender
namijene	namijeni	Person
napadajima	napadaja	Case
suočavalo	suočavala	Gender
krajcaraškima	brazilskima	lemma
sastojalo	sastojao	Gender
venule	venuli	Gender
stupnjeve	stupanj	Number
riječi	šefa	lemma
zagasila	zagasili	Gender
prekrivano	prekrivana	Gender
zastala	zastali	Gender
smrskavao	smrskavan	Voice
porotnoga	šetačkoga	lemma
nedefiniranoga	sputanoga	lemma
isključite	isključi	Person
žito	žita	Number
skupila	skupljena	Voice
riječi	riječ	Number
oplemenili	oplemenile	Gender
otrovne	sočne	lemma
mučenika	mučeniku	Case
izdašna	bezlična	lemma
odredite	odrediš	Person
najlicemernije	najsklonije	lemma
krapinska	libijska	lemma
uspostavljale	uspostavljali	Gender
potkova	potkovaše	Person
navožen	navožena	Gender
polagani	polagane	Case
vozila	vožena	Voice
istrebio	istrebljen	Voice
ispleten	ispleteni	Number
pr̀vāk	prvaku	Case
kročismo	kroči	Person
zaljubljivali	zaljubljivani	Voice
ogrijao	ogrijalo	Gender
kazan	kazana	Gender
probijane	probijale	Voice
zona	zone	Case
preplašilo	trznulo	lemma
konkretnih	zaslužnih	lemma
nestrpljivije	dobronamjernije	lemma
pokrenulo	pokrenuto	Voice
raspravi	raspraviš	Person
sađena	sadila	Voice
trajnijima	najtrajnijima	Comparison
gnječilo	gnječeno	Voice
pridruži	pridružiste	Person
obespravite	obespravimo	Person
banjice	banjicu	Case
leksikòlozi	leksikolozima	Case
potpunima	riđima	lemma
određivala	određivana	Voice
zatočila	zatočena	Voice
upaljivala	upaljivao	Gender
puzi	puzimo	Person
žici	žicom	Case
razvalila	razvaljena	Voice
tvrdnju	tvrdnje	Number
bubnule	bubnuli	Gender
poruzi	porugu	Case
teraj	terajte	Person
koškalo	koškano	Voice
pribavljamo	belasamo	lemma
reljefa	reljef	Case
ljetine	ljetina	Case
kamenu	kamena	Case
mezopauze	mezopauzi	Case
inspektore	inspektorima	Case
botaničaru	botaničari	Number
grublje	slaboumnije	lemma
leteća	žablja	lemma
banci	bankom	Case
klijenti	dojave	lemma
osuđene	osudile	Voice
zakonu	zakona	Case
iscrpe	iscrpoše	Number
ovladale	ovladane	Voice
lišajevi	lišajeve	Case
narodile	narođene	Voice
banko	banci	Case
sreću	srećete	Person
ispričana	ispričala	Voice
zbivala	zbivao	Gender
nabrale	ucijenile	lemma
duhan	duhana	Gender
podstrek	podstreku	Case
nakupila	nakupljena	Voice
međusobno	redovno	lemma
obmanjivana	obmanjivane	Gender
daunloudala	daunloudali	Gender
osiromašivana	osiromašivala	Voice
stilovima	stilovi	Case
prekrilo	prekrio	Gender
najplahijemu	najtraumatičnijemu	lemma
spremaš	sprema	Person
pišu	pišemo	Person
gospodo	gospodine	Number
preprekama	prepreci	Number
privoljena	privoljela	Voice
neveštim	bešavnim	lemma
šleperima	šleperi	Case
heterozigotna	dohvatljiva	lemma
početak	početke	Number
faraonu	faraonima	Number
lojalnijih	tananijih	lemma
piskaste	piskaše	Person
најмагичнији	магичнији	Comparison
suzdržani	suzdržane	Gender
pasivni	slijepi	lemma
čekan	čekao	Voice
razrađen	razrađena	Gender
imperijalnu	akrobatsku	lemma
namljeli	namljeveni	Voice
domoljublje	domoljublja	Number
naoružao	naoružan	Voice
baždarila	baždario	Gender
sjašilo	sjašila	Number
kitila	kićena	Voice
oduzimale	oduzimali	Gender
lijepu	tananu	lemma
driblalo	driblao	Gender
neusporediva	socijalna	lemma
zapostavljen	zapostavljena	Gender
opraštamo	opraštaš	Person
podstavljen	podstavio	Voice
pažnjom	pažnjo	Case
obučen	obučeni	Number
kontaktima	kontaktu	Number
kopito	kopita	Number
obeščašćivala	obeščašćivao	Gender
odbojkaških	odbojkaška	Case
bȗk	bukom	Case
akademijama	akademiji	Number
alèrgičnōst	alergičnost	Case
litvanski	урагански	lemma
smatraš	smatram	Person
prikrala	prikradena	Voice
koncentracijama	koncentracije	Case
neuralgičnima	retrofleksnima	lemma
prepao	prepala	Gender
најплоднији	плоднији	Comparison
sojevi	soju	Number
trake	trakama	Case
jednolični	spojeni	lemma
naduta	nadula	Voice
најмрачнији	мрачнији	Comparison
pȁkosnīk	pȁkosnīče	Case
komadi	komada	Case
susrete	susretoše	Number
plašljivijega	sporednijega	lemma
zapitao	zapitala	Gender
torlačkoga	torlačkomu	Case
sreo	sreli	Number
najmudrija	najdosetljivija	lemma
presječeni	presječena	Gender
preživela	preživljena	Voice
kleknuo	tro	lemma
jednačio	jednačilo	Gender
ugađaste	ugađaše	Person
poroznima	umišljenima	lemma
najprivrženije	najvalovitije	lemma
azilante	azilanta	Number
debijem	debi	Case
egzosferama	egzosfera	Case
kneževu	sestrinu	lemma
materinjih	trezvenjačkih	lemma
sinonimiji	sinonimijo	Case
koaksijalnome	entuzijastičnome	lemma
inertnijima	samouverenijima	lemma
ravnodušnijega	ekskluzivnijega	lemma
umovalo	umovala	Number
lepilima	lepilu	Number
rekle	rečene	Voice
tavo	tave	Number
jamčila	upropastila	lemma
stavljeno	stavilo	Voice
glagoljala	glagoljalo	Gender
morževima	morževa	Case
objektivne	čuvene	lemma
tvorca	tvoraca	Number
dovodile	dovodila	Gender
konoplje	konopljama	Case
povjerene	povjereni	Gender
rastavljali	rastavljani	Voice
umovala	umovali	Gender
izašao	zaposlio	lemma
tradicijama	tradiciji	Number
uključivah	uključivaše	Person
sanjao	sanjala	Gender
pronađena	pronašla	Voice
statiste	statistima	Case
regresivnijim	sklonijim	lemma
uvređen	uvredio	Voice
portali	portal	Number
prijavljena	prijavila	Voice
posjetu	slami	lemma
autopòrtrēt	autoportréta	Case
prelistano	prelistalo	Voice
krajnjima	djetinjima	lemma
preliminarna	simetrična	lemma
nakanjivah	ulizivah	lemma
komplementarno	golobrado	lemma
pripojeno	pripojilo	Voice
prepuštaše	ženjaše	lemma
korektnijemu	elokventnijemu	lemma
sise	sisi	Case
zaustavljao	zaustavljali	Number
ospice	ružo	lemma
pridržalo	pridržao	Gender
izišle	izišla	Gender
grožahu	grožaše	Person
košmarnima	astmatičnima	lemma
prolazu	prolaza	Case
dopremila	dopremili	Gender
čoporima	čopore	Case
raspoloženje	raspoloženja	Number
ušice	ušicama	Case
preprekama	ulogama	lemma
navikama	banjama	lemma
inkarnaciji	inkarnacijama	Number
omotom	omotima	Number
najpohlepnije	najbezglavije	lemma
interesantnija	najinteresantnija	Comparison
lijeka	lijeku	Case
najprotivnije	najgladnije	lemma
Srpkinje	Srpkinjom	Case
barbarom	barbare	Case
podsjetilo	podsjetio	Gender
prožela	prožeta	Voice
upropašćuje	upropašćuju	Person
provalile	provalila	Gender
morskih	trigonometrijskih	lemma
komandanti	komandante	Number
najgrješnijemu	najbezosećajnijemu	lemma
posuđena	posuđeni	Gender
losionima	losionom	Number
најнедостижнији	недостижнији	Comparison
autocesti	autocestama	Number
najnežniji	najsmeoniji	lemma
nestabilna	elementarna	lemma
procenio	procenjen	Voice
knjižena	razjedinjavana	lemma
sudijama	sudija	Case
osvrtu	osvrtom	Case
najvarvarskijemu	najvarvarskijima	Number
migoljile	migoljili	Gender
oborene	oborena	Gender
neopozivome	formalnome	lemma
isušila	isušena	Voice
karijerama	karijera	Case
pečati	pečatima	Case
pametna	staklasta	lemma
neostvarene	radosne	lemma
osumnjičilo	osumnjičio	Gender
učvršćena	učvršćen	Gender
historičarima	historičara	Case
individualistički	terminološki	lemma
onaniram	onanirate	Person
uvalama	uvale	Case
najpjenušavija	najšlampavija	lemma
pisahu	pisah	Person
nagrade	nagrada	Number
modne	telefonske	lemma
meko	uverljivo	lemma
invalidska	ulazna	lemma
otklonjena	otklonila	Voice
kretanju	kretanje	Case
susjeda	susjede	Number
preokrenula	preokrenuta	Voice
napominjane	napominjale	Voice
preslikavalo	preslikavano	Voice
kooperativan	esencijalan	lemma
progonila	bacala	lemma
granjavalo	granjavano	Voice
svagdašnjemu	svagdašnji	Case
ograničenim	voljnim	lemma
alveoli	alveolu	Case
mineralima	minerali	Case
proleterskih	gitarskih	lemma
prilično	sluzavo	lemma
podsjećala	podsjećana	Voice
konduktéra	konduktera	Case
cesto	ceste	Number
osiromašena	osiromašeni	Gender
nabacilo	nabacila	Gender
epileptičara	epileptičar	Case
medicine	medicinom	Case
nahuškana	nahuškane	Gender
privukla	privučena	Voice
namjerno	namjerna	Case
sesijama	sesije	Case
usporile	usporili	Gender
torziji	torziju	Case
akreditive	akreditivima	Case
neposlušnije	efikasnije	lemma
bris	brȋs	Case
drȁma	dramom	Case
hotentotskih	almaatskih	lemma
zadužio	zadužen	Voice
pripremili	pripremljeni	Voice
aukcijama	aukciji	Number
vagnu	vagne	Number
okretalo	okretala	Gender
usmjerene	usmjerile	Voice
odsustvom	odsustvu	Case
upotrebljavano	upotrebljavalo	Voice
otrove	tezgo	lemma
kristalnome	caričinu	lemma
južnjače	južnjaci	Number
traćena	tratila	Voice
baht	bahtove	Number
rukavcem	rukavcima	Number
prašumi	prašumama	Number
pacifičko	pacifička	Gender
mršava	dragocena	lemma
praška	sezonska	lemma
pevačem	pevaču	Case
useljena	uselila	Voice
најснисходљивији	снисходљивији	Comparison
darujete	darujemo	Person
morbili	morbilima	Case
izostavljaj	izostavljajmo	Person
stanovale	stanovala	Gender
razotkriti	razotkrili	Voice
rastjerana	rastjerala	Voice
prognoze	prognozu	Number
pripreme	zavjetrine	lemma
uništi	uništite	Person
skokovi	skok	Number
kovkijima	bezdušnijima	lemma
birokraciji	birokracijama	Number
toljagom	toljage	Case
nameravaše	nameravah	Person
patrijarhalni	turobni	lemma
kolonijalnima	transverzalnima	lemma
izgovori	izgovore	Person
otrcanija	vrednija	lemma
verzija	verziji	Case
najrazumljivijemu	najsvježijemu	lemma
smeštene	smešteni	Gender
dolazila	dolazili	Gender
uprljano	uprljalo	Voice
utrošila	utrošio	Gender
alotrope	alotrop	Number
kovrdžastima	besputnima	lemma
kolektivizaciji	kolektivizacijom	Case
hinduìzam	hinduizmom	Case
primernije	sumnjivije	lemma
mutacijom	mutacije	Case
sastanku	sastancima	Number
svedodžbi	svedodžbo	Case
trudne	trudna	Gender
crtasmo	crtahu	Person
pritiskano	pritiskalo	Voice
Buzet	Buzetu	Case
libidinoznome	buntovnome	lemma
dijetama	dijeti	Number
prikazima	prikazom	Number
singular	brdo	Case
porušila	porušile	Gender
dovozile	dovožene	Voice
objavljivana	objavljivala	Voice
porobljavam	porobljavaju	Person
plural	žaruljama	Case
neslavna	samoproglašena	lemma
podmazivan	podmazivao	Voice
iznenađeni	iznenađena	Gender
najprostijemu	najbudalastijemu	lemma
promaknuli	stegnuli	lemma
rušena	rušila	Voice
izoravala	izoravana	Voice
nuklearna	egipatska	lemma
adoptirana	razvidna	lemma
činjenici	činjenica	Case
detektive	detektivi	Number
zajahali	zajahani	Voice
pramcima	pramci	Case
dodjeljivan	dodjeljivao	Voice
rođake	rođaci	Case
homoseksualac	homoseksualcem	Case
prerezivana	prerezivano	Gender
hranjen	hranjeni	Number
unesena	unijela	Voice
izjednačivasmo	izjednačivaste	Person
odolela	odoleo	Gender
ofenzivna	bucmasta	lemma
križištu	križišta	Case
leptirići	leptiriću	Number
nojeva	nojevi	Case
ponošah	ponošasmo	Person
vojne	vojnu	Number
polovici	polovice	Case
scenu	scene	Case
uključilo	uključeno	Voice
nagovešćivah	nagovešćivasmo	Number
geografska	geografskih	Case
posvemašnjih	torzijskih	lemma
grebeno	greblo	Voice
dojavljene	dojavile	Voice
učvršćivali	učvršćivale	Gender
izlečiste	izlečih	Person
nesumnjiva	profinjena	lemma
napravite	napraviš	Person
kongregacionalizmom	kongregacionalizam	Case
mjesečnoj	vučjoj	lemma
rukovodioci	rukovodilac	Number
suzbijena	suzbila	Voice
ìznjedreno	iznjedrilo	Voice
nesvakidašnjih	čeličnih	lemma
ohrabrilo	ohrabrila	Gender
investiraše	investirah	Person
krševitima	sumanutima	lemma
uskraćene	uskratile	Voice
čupan	čupao	Voice
jabučastome	sistematičnome	lemma
zgurismo	zguri	Person
prikazu	prikaz	Case
sniman	snimao	Voice
podrazumevalo	podrazumevano	Voice
kreolskih	daljnjih	lemma
zapisivana	zapisivala	Voice
nepogodnom	gorkom	lemma
pijane	demokratske	lemma
maksimalnoga	autoritarnoga	lemma
lovištima	antilogaritmima	lemma
najpristranijemu	najvlažnijemu	lemma
neustrašivim	razdeljivim	lemma
proždreh	proždreste	Person
ispuštene	ispušteni	Gender
razorile	razorili	Gender
bregu	bregovima	Number
pokrajinskoj	pokrajinsku	Case
voštio	vošten	Voice
preseljene	preseljeni	Gender
sumerskih	sumerska	Case
preliminarnih	sjajnih	lemma
potakla	potaknuta	Voice
nabasam	nabasamo	Person
uvidjela	uvidio	Gender
tonova	tona	Number
mjesto	mjesta	Number
palači	palaču	Case
kronologija	kronologije	Case
ubožnici	ubožnicom	Case
pokopani	pokopali	Voice
sjebala	sjebena	Voice
sprečene	sprečile	Voice
oružana	oružala	Voice
imaginarnih	beskompromisnih	lemma
djelatnostima	djelatnosti	Number
prisluškuje	prisluškuju	Person
zadržavale	zadržavali	Gender
junačne	svadljive	lemma
besede	besedu	Number
omoforima	tavama	lemma
mamite	mame	Person
iga	igo	Number
pjenušavoj	živopisnoj	lemma
uzdisasmo	uzdisaše	Person
ljuljuškala	ljuljuškana	Voice
nacionalistička	sekretarska	lemma
oštećen	oštetio	Voice
dala	dao	Gender
troškovima	troškom	Number
porozno	sveže	lemma
toksikologija	toksikologiju	Case
napustio	napustilo	Gender
nevjeste	nevjesta	Number
osvetljiva	aktivna	lemma
mramoru	mramora	Case
navikavan	navikavao	Voice
izbečila	smestila	lemma
države	država	Case
treme	trema	Number
utjehe	utjehu	Number
nagrdila	nagrdio	Gender
oštrima	spontanima	lemma
mesnati	dodatni	lemma
prepisalo	prepisala	Gender
pristupi	pristupe	Number
lomljene	lomile	Voice
ispunio	ispunila	Gender
primila	primilo	Gender
zaprezali	zaprezale	Gender
drogira	drogirate	Person
smijenio	smijenjen	Voice
batinale	batinala	Gender
slikara	slikaru	Case
imitator	imitatora	Case
neurotičnoj	upadljivoj	lemma
usmjerili	usmjereni	Voice
popunili	popunila	Gender
krucijalne	ambivalentne	lemma
iranski	bizantinski	lemma
shvaćene	shvatile	Voice
štovala	štovalo	Gender
osećajnim	doslovnim	lemma
mrzimo	mrzi	Person
lovočuvarskih	tadžikistanskih	lemma
suši	sušama	Number
pokrivana	pokrivan	Gender
snižavaš	snižavam	Person
zastajaste	zastajah	Person
arhipelazi	arhipelage	Case
ambasadora	ambasadoru	Case
penušava	bodljikava	lemma
navodnima	sekretarskima	lemma
izabirala	izabirali	Gender
najimpresivniju	najtopiviju	lemma
onesposobljene	onesposobljeni	Gender
svešću	svesti	Case
uda	udaju	Number
dalo	dala	Gender
najpohotniju	najsuptilniju	lemma
prednost	prednosti	Case
sevèrnjāk	severnjače	Case
најлукавији	лукавији	Comparison
dȃr	dȁrove	Number
šmrknete	šmrknemo	Person
klasnoga	klasni	Case
masturbacijama	masturbaciji	Number
najosećajnijoj	najslaboumnijoj	lemma
kotrljaste	kotrljahu	Person
agrotehničko	čovječje	lemma
mnim	mniš	Person
otvorene	uvjerene	lemma
pomoćnima	pomoćna	Case
energije	energiju	Number
kvadratni	carinski	lemma
ubijane	ubijana	Gender
kuhinji	kuhinjama	Number
kolektivna	različita	lemma
najneškodljivijima	najznojnijima	lemma
islandske	turske	lemma
kovrčastoj	glibavoj	lemma
anuliraš	anulirate	Person
grabe	grabom	Case
štrajkaša	štrajkašima	Case
mešovitijih	gojaznijih	lemma
antene	antenama	Case
detektor	detektori	Number
makedonski	šekspirijanski	lemma
predviđena	predvidela	Voice
spojena	spojene	Gender
propovijedajmo	propovijedajte	Person
neodgovorna	ekstatična	lemma
usađivana	usađivan	Gender
rečena	rečene	Gender
posrednih	prvenstvenih	lemma
anateme	anatema	Number
badnjake	badnjaci	Case
majóra	majorom	Case
vatre	vȁtārā	Case
agitacijom	susnježicom	lemma
melodija	melodijama	Case
odgrizli	odgrizla	Gender
programu	programe	Case
smaragdi	smaragd	Number
odreda	odredi	Case
smišljena	smišljen	Gender
izlučujem	izlučujete	Person
pozitiva	pozitiv	Case
podstrižena	podstrižene	Number
mala	efikasna	lemma
maramu	marame	Case
njegovateljice	njegovateljicama	Case
prebijani	prebijana	Gender
općine	općina	Case
istinita	certificirana	lemma
oblicima	obliku	Number
historije	historija	Case
najedeno	propušteno	lemma
citoplazme	citoplazmama	Case
dohvaćao	dohvaćan	Voice
bljedoći	bljedoćom	Case
presrela	presreo	Gender
priče	priča	Number
povećanjima	povećanju	Number
posolile	posolili	Gender
srednjoškolcima	srednjoškolci	Case
istrošene	biserne	lemma
češalj	češljevi	Number
istražene	istražile	Voice
primljena	primila	Voice
izgubila	izgubljena	Voice
bebama	bebom	Number
brojila	brojilo	Number
dužnicima	dužniku	Number
izolirana	gnusna	lemma
ohlađivao	ohlađivan	Voice
tjesnac	tjesnacem	Case
paragrafima	paragrafa	Case
planinsko	planinska	Number
potajnima	represivnima	lemma
njemačka	divovska	lemma
ulazile	ulazila	Gender
poremećena	poremetila	Voice
nahrupljivano	nahrupljivan	Gender
najnekorisnijih	najšupljikavijih	lemma
ozlijeđena	ozlijedila	Voice
zanemarene	zanemareni	Gender
rutinskima	talijanskima	lemma
neusporedivome	emocionalnome	lemma
prednošću	prednostima	Number
korektne	tuđe	lemma
lovorova	danonoćna	lemma
havajskomu	bivšemu	lemma
platneni	platnena	Gender
malograđanske	zakonodavne	lemma
promera	promeri	Case
sastojkom	sastojcima	Number
ljepotici	ljepoticom	Case
oduzimana	oduzimala	Voice
kupcima	kupcu	Number
najkišnijih	najvarvarskijih	lemma
zaglibljuju	zaglibljuje	Person
grube	sarkastične	lemma
obeščašćujemo	obeščašćuju	Person
imperiji	zakupi	lemma
držala	držana	Voice
pomagala	pomagale	Gender
umetnusmo	umetnuše	Person
mitološki	slatkovodni	lemma
starahu	staraše	Person
sektaški	sektaška	Gender
ovlastima	ovlasti	Case
најљубоморнији	љубоморнији	Comparison
notornoj	septičnoj	lemma
izoštravali	izoštravale	Gender
poroznih	taktičnih	lemma
isplaćeni	isplatili	Voice
neograničene	vatrene	lemma
pogrešna	sveobuhvatna	lemma
štiglićima	štiglići	Case
ukrasu	ukrasima	Number
suočene	suočeni	Gender
embriji	embrija	Case
rubrike	rubrika	Number
mediteranski	austrougarski	lemma
utrošena	utrošila	Voice
zagrijao	zagrijan	Voice
izdisaše	izdisahu	Person
macu	maco	Case
opise	opisima	Case
iskušavahu	iskušavaste	Person
kratkoća	kratkoćom	Case
ujedinjeni	ujedinjene	Gender
suprotstavljali	suprotstavljale	Gender
izoravaj	izoravajmo	Person
razabirana	razabirane	Gender
emigracija	emigracije	Number
pažljivija	tromija	lemma
provokativnijoj	vjetrenjastijoj	lemma
idealna	rođena	lemma
vraćeno	vraćena	Gender
otvoren	otvoreni	Number
vrhu	vrhovima	Number
poravnamo	poravnaju	Person
kozmografiji	kozmografiju	Case
okrala	okrali	Gender
otkazala	otkazana	Voice
plastičnu	svojstvenu	lemma
izbacivali	izbacivani	Voice
primijenjeno	primijenjena	Gender
rastužuju	rastužuješ	Person
križara	križare	Case
reinkarnaciju	reinkarnacija	Case
banji	banjama	Number
potakla	potakao	Gender
misteriozni	silni	lemma
najranjivijoj	najčvršćoj	lemma
lažljivcima	lažljivci	Case
kraćajte	raseljavajte	lemma
zemljopise	zemljopisi	Number
nacionalne	azijske	lemma
galamljasmo	galamljahu	Person
hvastavijoj	slavohlepnijoj	lemma
nesposobni	svestrani	lemma
prepirah	prepirahu	Person
habana	habala	Voice
jarče	velikodušnije	lemma
uporabila	uporabilo	Gender
krvaraše	zaluta	lemma
babe	babi	Case
pretvarali	pretvarani	Voice
koketnijima	sanjivijima	lemma
istrošile	istrošila	Gender
rukovodilačkom	flamanskom	lemma
trenirana	trenirala	Voice
ariji	arija	Case
razložen	razložio	Voice
napomenem	napomenu	Person
osvećeni	osvećena	Gender
uznemireno	uznemiren	Gender
krsnoj	takmičarskoj	lemma
izvjesno	besplatno	lemma
nadgleda	nadgledaju	Number
dodani	dodana	Gender
kompletno	elementarno	lemma
zauzeo	zauzet	Voice
klimatologije	klimatologija	Case
nastanjen	nastanio	Voice
cevima	cevi	Number
svrbahu	svrbasmo	Person
konstitutivna	sveobuhvatna	lemma
skraćeno	skratilo	Voice
krinom	krinu	Case
riblje	argentinsko	lemma
lokalna	bestjelesna	lemma
rasprodane	rasprodale	Voice
najhvalisavijemu	najakustičnijemu	lemma
blažena	blažene	Gender
križa	križaju	Number
ubijem	ubijete	Person
napomenuto	napomenut	Gender
cara	careve	Number
oblikovala	oblikovale	Gender
sabotiraše	anticipiraše	lemma
tjemenima	tjemenu	Number
žabare	žabari	Case
povjeravasmo	zagadismo	lemma
lude	ludi	Person
nirvana	nirvane	Number
shemama	shemom	Number
ȉmūćnosti	ȉmūćnōst	Case
nadmašen	nadmašio	Voice
dotiskana	dotiskane	Gender
planktonskih	dravidskih	lemma
neutralna	vrištava	lemma
viđaš	viđamo	Person
uzlijetalo	uzlijetao	Gender
izostajaše	škiljaše	lemma
najplačljivija	najdefektnija	lemma
maglovito	bespolno	lemma
sedlasta	sedlaste	Gender
pokrajinskim	srednjovekovnim	lemma
suptilnu	suptilan	Case
obrazuju	obrazuje	Person
sudanske	sudanska	Gender
krijumčarstvom	krijumčarstvima	Number
најнеподобнији	неподобнији	Comparison
tinjala	tinjao	Gender
podjarmljivala	podjarmljivana	Voice
okružilo	okruženo	Voice
odlikovao	odlikovalo	Gender
jednosmjernu	aktualnu	lemma
razboritiji	slobodoumniji	lemma
kvarkove	kvarkovima	Case
omogućivaste	omogućivahu	Person
smrtnosti	smrtnost	Number
tòmahāvkā	tomahavcima	Case
stave	stavi	Person
bakteriologijo	bakteriologiji	Case
posetioca	brača	lemma
izabrana	izabrano	Gender
hrabra	željna	lemma
činila	činilo	Gender
nizinskim	vrhunskim	lemma
pripravnomu	tvrdomu	lemma
pjevale	pjevali	Gender
odsječen	odsjekao	Voice
raširilo	raširio	Gender
udara	udarima	Case
doživljavala	doživljavali	Gender
okrivljeni	okrivili	Voice
obnavljasmo	obnavljaše	Person
kičmena	stanična	lemma
podudariš	podudarimo	Person
brkovima	brku	Number
nagib	nagibom	Case
zavod	zavodu	Case
anketa	ankete	Number
mekša	siromašnija	lemma
policijsko	futurističko	lemma
nepuna	sklona	lemma
mlijeko	mlijeku	Case
zadremale	zadremala	Gender
polarne	surove	lemma
upućeni	uputili	Voice
rvam	rva	Person
pozvane	pozvana	Gender
bruko	bruke	Case
optika	optici	Case
školovao	školovala	Gender
klasama	klase	Case
ispostavljani	ispostavljana	Gender
obrazložena	obrazložen	Gender
prikrio	prikrila	Gender
navezah	naveza	Person
komesarima	komesaru	Number
sastave	sastavu	Case
posetila	posetili	Gender
glasa	glasamo	Person
stanju	stanje	Case
skuhali	skuhala	Gender
ograniči	ograničimo	Person
ljubimci	ljubimce	Case
kožar	kožara	Case
jarcima	jarci	Case
sposobnosti	sposobnostima	Case
inženjerima	tuševima	lemma
ciljana	ciljano	Case
sažétak	sažétci	Number
nostalgičnija	bezobraznija	lemma
sudio	suđen	Voice
mladencima	mladence	Case
rezidenciju	rezidencije	Number
političko	politički	Gender
stignut	stigao	Voice
mislila	mišljena	Voice
greza	stečajna	lemma
imigracija	imigracije	Number
senatoru	senatore	Case
dopremila	dopremljena	Voice
karikature	karikaturu	Case
nabavila	nabavljena	Voice
prikazujmo	prikazuj	Person
nerazdvojivima	ambigvitetnima	lemma
mjènjāč	mjenjač	Case
kategoriju	kategoriji	Case
muljem	mulja	Case
oženjeni	oženili	Voice
osmanske	osmanski	Gender
obojio	obojilo	Gender
jantarima	anatemama	lemma
ženskoga	ženski	Case
muljevima	muljevi	Case
dorađivana	dorađivala	Voice
gladiš	gladim	Person
dominirao	dominiralo	Gender
materinske	anđeoske	lemma
povučenih	apatičnih	lemma
mirovale	mirovala	Gender
krševitomu	začaranomu	lemma
punktovi	punkt	Number
nepalskima	transportnima	lemma
kreditorom	kreditorima	Number
psihijatrijski	stilski	lemma
kartonska	bošnjačka	lemma
posredovala	posredovana	Voice
dohvaćaše	dohvaćaste	Person
postizala	postizali	Gender
iznenadile	iznenađene	Voice
onkologijom	onkologiju	Case
tranzitni	tranzitnih	Case
najhitnijom	najzloslutnijom	lemma
načinjeni	načinjena	Gender
limarskoj	anglističkoj	lemma
uspavanku	uspavanke	Case
grdila	grđena	Voice
redukciji	redukciju	Case
nordijske	amaterske	lemma
povjerljivim	amorfnim	lemma
pevala	pevale	Gender
potopljen	potopio	Voice
neznan	zaseban	lemma
dopremani	dopremali	Voice
tuširalo	tuširala	Gender
nepromišljena	vešta	lemma
skloni	sklonim	Person
materiju	direktora	lemma
aritmetičkima	aritmetička	Case
lole	elektrode	lemma
kitovi	kitovima	Case
uvećavamo	uvećavaš	Person
pripremni	ružni	lemma
indoeuropska	bolesnička	lemma
počni	počnimo	Person
zastrašen	zastrašio	Voice
kvadratne	toponimske	lemma
odeljivane	odeljivale	Voice
pogrbljivani	pogrbljivane	Gender
amfora	amfori	Case
oplodimo	umivajmo	lemma
atletikom	atletici	Case
neodređeno	žestoko	lemma
škrobljeni	škrobljene	Gender
londonska	ekvadorska	lemma
najkomičnija	najdebilnija	lemma
ispisali	ispisala	Gender
neprihvatljiva	refleksivna	lemma
osjećaj	osjećajem	Case
isplivao	isplivala	Gender
pogodnoga	rumenkastoga	lemma
paketi	paket	Number
šapće	šapćeš	Person
gledalo	gledala	Gender
žumanaca	žumanca	Case
vójska	vojske	Number
pokorne	uspravne	lemma
sardelo	sardele	Number
engleski	engleska	Gender
ohlađeno	ohladilo	Voice
foajeima	foajei	Case
sipi	sipo	Case
pretila	pretio	Gender
frajerima	frajeri	Case
naklonila	naklonjena	Voice
harmonijskomu	zabušantskomu	lemma
sposobnost	sposobnosti	Number
sakrivana	sakrivala	Voice
rekreacija	rekreacije	Number
kištre	kȉštārā	Number
sredstva	sredstvo	Number
kaljužo	kaljuže	Number
obnavljana	obnavljala	Voice
grozna	ezoterična	lemma
psiha	psihe	Number
metala	metalo	Gender
cvećarstva	cvećarstvu	Case
raširivane	raširivale	Voice
apostrofi	apostrofe	Number
iskaljivao	iskaljivalo	Gender
krotiteljima	krotitelje	Case
najoštrije	najvjernije	lemma
nezamijećene	nezamijećeni	Gender
saveze	savezi	Number
pojavljivali	pojavljivale	Gender
predvođeni	predvođene	Gender
izjuri	izjurismo	Person
dani	dane	Gender
okončano	okončalo	Voice
ćeraste	ćeraše	Person
kočije	kočiji	Case
proklela	prokleo	Gender
poverljive	strpljive	lemma
zapažale	zapažane	Voice
imitatoru	sprezanju	lemma
teoretsku	teoretsko	Gender
posetioče	posetiocu	Case
impulzivnijih	bezuspešnijih	lemma
pismenom	pismenima	Number
obuka	obuke	Case
kovani	kovali	Voice
samurovinama	samurovine	Case
trilere	trileri	Case
arheološkoga	arheoloških	Number
označena	označen	Gender
nastavljena	nastavila	Voice
melodramatične	žučljive	lemma
prerađen	prerađeno	Gender
severoistočnu	severoistočnom	Case
zadavili	zadavila	Gender
jurnu	jurnusmo	Person
zimskom	zimsku	Case
nedostižna	prkosna	lemma
sudelovala	sudelovao	Gender
najrazbludniji	најсуморнији	lemma
palme	palmu	Case
nezaštićeni	fini	lemma
zamenom	zameno	Case
shvatala	shvatali	Gender
škȑtācā	škrtce	Case
postizali	postizani	Voice
podržava	podržavaju	Person
knjižničarstvo	knjižničarstva	Case
umišljene	umišljeni	Gender
novosadske	uredničke	lemma
improvizacije	improvizaciji	Case
mladim	spontanim	lemma
primjerom	primjera	Case
suzbile	suzbijene	Voice
proširivala	proširivao	Gender
odolimo	odoli	Person
petlovima	petlu	Number
sinonim	sinonimom	Case
gotska	gotsko	Gender
granati	granatama	Number
inteligentne	topljive	lemma
entomologijom	entomologiji	Case
најбљеђи	бљеђи	Comparison
lukrativnijima	sićušnijima	lemma
obrađeni	obradili	Voice
ustanovljeni	ustanovljene	Gender
kremiramo	kremiram	Person
ocjenjujete	ocjenjuje	Person
nedostižnome	senilnome	lemma
odosmo	tršasmo	lemma
razgrabilo	razgrabio	Gender
stočići	stočićima	Case
pijetlovi	pijetlovima	Case
raspala	raspale	Gender
traka	trake	Number
sprovođena	sprovođen	Gender
okovi	tabakere	lemma
naklonjena	aluvijalna	lemma
buncaše	buncasmo	Person
pošla	pošao	Gender
rehabilitiraste	avanziraste	lemma
hvalisavima	bledima	lemma
најригорознији	ригорознији	Comparison
spletko	spletku	Case
fiziologije	fiziologijom	Case
pučanina	akropolu	lemma
spisi	spise	Case
lansirate	zapalite	lemma
kozmopolita	kozmopolitu	Case
nepropusni	analitični	lemma
nekadašnje	nekadašnja	Gender
okrivile	okrivila	Number
nekakvo	suvremeno	lemma
neotuđivoj	spinalnoj	lemma
iseci	isecite	Person
mutavije	besramnije	lemma
amuleti	amulet	Number
prepolovio	prepolovljen	Voice
otplovila	otplovio	Gender
požara	požar	Case
reljefu	reljefima	Number
nazvan	nazvao	Voice
prepisivan	prepisivao	Voice
složile	složili	Gender
iznajmljeno	iznajmilo	Voice
zaglavio	zaglavljen	Voice
prijevremenoj	želatinastoj	lemma
neosporivo	zdepasto	lemma
otmici	otmice	Case
preventivnim	celokupnim	lemma
rezimèa	rezimea	Number
radijaciju	radijacijom	Case
obrađivani	obrađivana	Gender
soje	soju	Case
prestonica	prestonice	Number
kamerunskomu	automatskomu	lemma
primenjivano	primenjivalo	Voice
biofizici	biofiziku	Case
zakopaju	zakopate	Person
najimbecilniji	najdarežljiviji	lemma
reprezentacije	reprezentacija	Number
záštitnīci	záštitnīk	Number
pivarska	pivarske	Gender
pokaza	proradi	lemma
odstranila	odstranile	Gender
iskažimo	zgušnjavajmo	lemma
konstruktivne	steone	lemma
hvalevrijedni	bistroumni	lemma
deli	delimo	Person
smicala	smicana	Voice
autopsijama	autopsijom	Number
amperima	amperu	Number
bodulima	bodula	Case
pritiskaše	dobaci	lemma
očistile	očišćene	Voice
potpredśednice	potpredśednica	Number
lunarno	razborito	lemma
zemljama	zemlji	Number
sjenci	sjenka	Case
poznavana	poznavani	Gender
žabljima	žablje	Case
dòdātākā	dodacima	Case
kozake	kozaci	Case
uzmicala	uzmicalo	Gender
prenosile	prenošene	Voice
obrukane	stišavane	lemma
jedine	jedini	Case
isplativija	senzacionalnija	lemma
biljožderom	biljožderima	Number
novorođenčetu	novorođenčadi	Number
slao	slan	Voice
strelcu	strelcima	Number
primjernoj	bubuljičastoj	lemma
vrata	vratom	Case
posvećena	posvećeni	Gender
količine	količínā	Number
kombajne	kombajnu	Case
raspravljale	raspravljala	Gender
neumjerenijega	dražega	lemma
pokorna	rijetka	lemma
proizvodile	proizvođene	Voice
šupljoglavcu	šupljòglavac	Case
primoran	primorao	Voice
nepokretnijima	najnepokretnijima	Comparison
izbegao	izbegnut	Voice
uzgajana	uzgajan	Gender
izdvojilo	izdvojeno	Voice
iznenađivale	iznenađivala	Gender
zanimalo	zanimao	Gender
lepila	lepili	Gender
raso	rase	Number
protjerane	protjerana	Gender
ukleli	uklela	Gender
keve	škune	lemma
močvarne	eksplozivne	lemma
učvrstiste	učvrsti	Person
birači	bìrāč	Number
posledica	posledice	Number
upotrebljena	upotrebljen	Gender
sintakse	sintaksu	Case
kavkaska	kavkaske	Gender
irelevantnim	sličnim	lemma
plastičnosti	plàstičnōst	Case
općenite	živčane	lemma
finoći	finoću	Case
iznenadno	sočno	lemma
poboljšavana	poboljšavan	Gender
krivotvoritelji	krivotvoritelj	Number
mediteranska	ekološka	lemma
crnčila	crnčilo	Gender
prošireno	proširilo	Voice
datotéka	datoteke	Number
čvrstina	čvrstini	Case
ugradila	ugradili	Gender
osramoćeni	osramoćena	Gender
opredijeljena	opredijelila	Voice
mumiji	mumije	Case
dolazaka	dolascima	Case
asirski	asirskih	Case
patriotom	patriotima	Number
sviđale	sviđala	Gender
potkopavam	potkopavate	Person
prepodne	prepodneva	Number
napučena	napučila	Voice
popustljiv	непреносив	lemma
načinjena	načinila	Voice
zablejite	zableji	Person
dekada	dekade	Case
latiničnoga	tadašnjega	lemma
skupljeni	skupljene	Gender
lopovskoga	zaštitničkoga	lemma
nesvesna	raznolika	lemma
olovne	olovnih	Case
probdeo	probdelo	Gender
usadiste	usadi	Person
nepozvani	šaroliki	lemma
lokve	lokvo	Number
pokrajinske	antikomunističke	lemma
djevci	djevče	Number
stanovnica	stanovnice	Case
rezidenciji	rezidencijama	Number
obaveštajcu	obaveštajcima	Number
ludničko	graditeljsko	lemma
potera	potere	Case
ametistima	ametisti	Case
kanadskim	australijskim	lemma
mlitavoj	sistematičnoj	lemma
dojahale	dojahala	Gender
vȅštāče	veštaci	Number
paraboličnima	bilabijalnima	lemma
nesretnijoj	glavatijoj	lemma
jedrila	jedrilo	Gender
ohrabrivao	ohrabrivan	Voice
prazne	talentirane	lemma
zaraza	zaraze	Number
naklade	naklada	Number
zlatnino	zlatnine	Case
licemjernu	svesrdnu	lemma
nelegalna	specifična	lemma
julskom	umetničkom	lemma
nedeljama	nȅdēljā	Case
pripravnih	raspoznatljivih	lemma
plauzibilniji	čitljiviji	lemma
kriticizme	kriticizam	Case
aeromehanika	aeromehanici	Case
ohlađeno	ohlađen	Gender
spadale	spadala	Gender
najprijatnijima	najznačajnijima	lemma
najrealniju	najvlažniju	lemma
izražavala	izražavana	Voice
samouprave	samouprava	Number
probavno	probavni	Gender
odgovorilo	odgovorio	Gender
neudatu	bestelesnu	lemma
žigole	žigolima	Case
istosmjernu	fundamentalnu	lemma
pupahu	uzletahu	lemma
forumima	forumom	Number
kònje	kònja	Number
odvrtalo	odvrtao	Gender
progutala	progutana	Voice
maršalu	maršalima	Number
nadahnuta	nadahnula	Voice
iskonska	benediktinska	lemma
svanusmo	svanuše	Person
žigolo	žigola	Case
najkvalitetnijima	najsumnjivijima	lemma
potpisivah	potpisivaše	Person
pomogao	pomoglo	Gender
protekli	protekle	Gender
најстарији	старији	Comparison
izgorješe	izgorjeh	Person
hijacinti	hijàcint	Number
prokopavahu	prokopavaše	Person
gumi	dimnjaku	lemma
kandidaturi	kandidature	Case
mirotvorke	mirotvorku	Number
promotrio	promotren	Voice
umaknuli	umaknimo	Mood
ubirana	ubirala	Voice
obuhvaćen	obuhvatio	Voice
pupke	pupak	Number
nepredviđena	glazbena	lemma
obranjena	obranila	Voice
prijavljeno	prijavilo	Voice
preuzeto	preuzelo	Voice
najlukrativniju	najsuzniju	lemma
obeštećivalo	obeštećivano	Voice
objedinjene	objedinjena	Gender
sazre	sazreše	Number
pomogao	pomogla	Gender
marila	mario	Gender
neuspjeloga	besmislenoga	lemma
iskašljale	iskašljane	Voice
šahom	šaha	Case
lovorova	unutarnjega	lemma
istupa	istupaju	Person
potaknuti	potaknute	Gender
promociju	promocije	Number
nadzvučni	velški	lemma
čaran	čarao	Voice
homologna	sirova	lemma
svest	svesti	Number
očuvale	očuvane	Voice
usmjerena	usmjereni	Gender
ortáci	ortake	Case
isplativije	životnije	lemma
razdrobi	razdrobimo	Person
sjedale	sjedala	Gender
kolumbijskima	apolitičkima	lemma
nihilističkima	veljačkima	lemma
hlađen	hlađena	Gender
amana	amani	Case
pripravi	apsurdnosti	lemma
žgoljavijemu	najžgoljavijemu	Comparison
pristiže	pristižete	Person
razmećem	razmeću	Person
prihvaćeno	prihvaćena	Gender
odabrana	odabrala	Voice
prevodili	prevođeni	Voice
pobudili	pobudila	Gender
izvijestimo	izvijestim	Person
obzire	obzirima	Case
progrizala	progrizana	Voice
grofovima	grofovi	Case
bodljikavo	bodljikava	Number
najčišći	čišći	Comparison
portal	portalu	Case
rȍžnīci	rȍžnīk	Number
kugli	kugle	Case
oralo	orano	Voice
onanirali	onanirao	Number
mutava	egzemplarna	lemma
kolaboraciju	kolaboracije	Number
spekle	spečene	Voice
sklanjaše	sklanjaste	Person
upotrebljena	upotrebila	Voice
transakciju	transakcije	Case
skrštavale	skrštavane	Voice
veljača	veljačom	Case
beležili	beleženi	Voice
batini	bàtina	Case
trubadurom	trubadurima	Number
penetracije	penetraciju	Number
zaglavljen	zaglavljena	Gender
uresile	uresila	Gender
naučnim	sapunastim	lemma
latite	latiš	Number
priseže	prisežu	Number
svrbele	svrbela	Gender
otkrili	otkrile	Gender
efikasnost	efikasnošću	Case
pišah	pišasmo	Number
poprilična	beskrajna	lemma
železnicu	železnici	Case
obuhvatilo	obuhvaćeno	Voice
osuđivali	osuđivani	Voice
pobeljivano	pobeljivalo	Voice
zaostala	zaostalo	Gender
pridržavao	pridržavan	Voice
impresioniraste	impresioniraše	Person
iskušavaju	iskušava	Person
abecedirala	abecedirao	Gender
obuju	obujemo	Person
dostavljane	dostavljani	Gender
krapanjskima	salvadorskima	lemma
stupove	stup	Number
dozvoljavalo	dozvoljavala	Gender
napadnuta	venčavana	lemma
negodovala	negodovao	Gender
definicijom	definicija	Case
odmazdi	odmazdom	Case
razvrstale	razvrstali	Gender
nedostajale	nedostajala	Number
istrebljene	istrebljena	Gender
praćena	pratila	Voice
očistili	očistile	Gender
kovalencije	kovalencija	Number
mikroskope	mikroskop	Number
internacionalnim	sveobuhvatnim	lemma
drkasmo	drkah	Person
neadekvatno	bukvalno	lemma
povjerene	povjerile	Voice
izvrsne	dugotrajne	lemma
populacije	populaciju	Number
dizajnom	dizajnima	Number
procenilo	procenjeno	Voice
jemstvu	bubregu	lemma
voštanicama	voštanici	Number
kraška	alkoholna	lemma
zatekle	zatekli	Gender
nakane	nakanama	Case
obojenim	tranzitornim	lemma
odano	odana	Gender
rezonantniji	fascinantniji	lemma
takmičile	takmičila	Gender
zgrabljena	zgrabljeno	Gender
naredna	glogova	lemma
najradikalnijega	najekscentičnijega	lemma
prijestolnice	prijestolnici	Case
raspodeljivaste	raspodeljivaše	Person
unakazivane	unakazivale	Voice
kuje	boji	lemma
revanrevna	gadangadna	lemma
statistika	statistikom	Case
isečeni	ugovoreni	lemma
stradamo	strada	Person
ràbīn	rabinu	Case
unižavala	unižavao	Gender
olupinu	olupine	Number
korenitijemu	umjerenijemu	lemma
njujorški	zbiljski	lemma
testom	testa	Case
smislom	smisao	Case
obuzeta	obuzela	Voice
veristi	veristu	Number
lagana	fundamentalna	lemma
најништавнији	ништавнији	Comparison
potrudiste	potrudi	Person
rabotnikom	rabotnik	Case
otpočivale	otpočivali	Gender
mirovinu	mirovino	Case
razotkrite	razotkrile	Voice
uključena	uključila	Voice
narodi	usavrši	lemma
vahabizmu	vahabizmima	Number
najpriprostijoj	najzdravijoj	lemma
crnoriscu	crnoriscem	Case
prikazivao	prikazivan	Voice
građanima	građane	Case
kliknusmo	sprijateljismo	lemma
најпиткији	питкији	Comparison
čauš	čaušu	Case
molimo	molim	Number
hrabrila	hrabrio	Gender
krijumčarilo	krijumčarila	Gender
obesnijemu	gnevnijemu	lemma
totalitarniju	totalitarnija	Case
blagdana	blagdane	Case
ugasimo	ugasim	Number
pripalo	pripao	Gender
brade	brada	Case
hiponimom	hiponimu	Case
sadašnji	енциклопедијски	lemma
neškodljivima	efektivnima	lemma
albanologije	albanologija	Case
reljefe	reljefi	Number
najlakomijima	najtrnovitijima	lemma
projiciraste	apliciraste	lemma
igrališnih	drugih	lemma
rađen	radio	Voice
neuspešnije	sadržajnije	lemma
zabodu	zabodem	Person
povećanje	povećanju	Case
međusobna	dugotrajna	lemma
vađen	vadio	Voice
izmamljivalo	gadilo	lemma
minimalističkom	automobilskom	lemma
prostranijima	slabokrvnijima	lemma
traktatima	traktatu	Number
istodobnima	bezopasnima	lemma
nametljivo	trostruko	lemma
najiracionalnija	najciviliziranija	lemma
prekidaše	prekidahu	Person
skvrčena	skvrčeni	Gender
razvijale	razvijali	Gender
zubar	zubari	Number
nazdravite	sklopite	lemma
buši	bušite	Number
longitudinalno	sistematično	lemma
objašnjeni	objasnili	Voice
najravnomernije	najslabašnije	lemma
raspodeljivao	raspodeljivala	Gender
suoči	suočiše	Person
labuđi	andorski	lemma
pomisliste	pomisli	Person
trenirala	trenirana	Voice
hučanhučna	sursura	lemma
jedinilo	jedinjeno	Voice
badnju	badnjevima	Number
odmeravano	odmeravan	Gender
miljenicu	miljenici	Case
prokušalo	prokušala	Gender
precizan	delotvoran	lemma
pobijena	pobila	Voice
upotrijebio	upotrijebljen	Voice
četu	čete	Number
devetinama	devetini	Number
paprenijima	sposobnijima	lemma
vrhove	plural	Case
nepravedni	racionalni	lemma
napadna	riskantna	lemma
oprostom	oprostima	Number
impliciraše	akumuliraše	lemma
osigurala	osigurana	Voice
događajima	događaji	Case
kipa	kipu	Case
ugrožavaš	ugrožavamo	Person
lopaticama	lopatice	Case
mustrom	mȕstra	Case
jajetu	jajeta	Case
pobeđujem	pobeđuje	Person
uspostavilo	uspostavio	Gender
potopa	potopi	Case
listopadskomu	drugomu	lemma
guje	guju	Number
zborove	zbor	Number
primarnim	besplatnim	lemma
rodoslovlja	rodoslovlje	Number
uverili	uvereni	Voice
probdevena	probdevene	Number
nadživjelo	nadživljeno	Voice
žrtve	žrtvi	Case
najnedosljedniji	najudaljeniji	lemma
proučavaju	proučava	Person
pregrijavalo	pregrijavano	Voice
ražima	gomilama	lemma
roditeljskima	teozofskima	lemma
zamišljao	zamišljali	Number
rastužile	rastužene	Voice
kidnapiram	špijam	lemma
kockasti	časni	lemma
parabolična	agilna	lemma
jahao	jahan	Voice
jugoistočna	automatska	lemma
nogometni	nogometne	Gender
plimno	plimna	Gender
lijepima	besplodnima	lemma
kombinacija	kombinaciji	Case
nečovečnu	rupičastu	lemma
leptirićem	leptirićima	Number
podudarana	podudarala	Voice
kakvi	ažurni	lemma
jugoslavenskoga	jugoslavenskim	Case
nasiljem	nasilju	Case
obnavljan	obnavljana	Gender
bunama	bune	Case
objedinih	objediniste	Person
sagrađeno	sagradilo	Voice
korenita	besvjesna	lemma
oštetimo	ošteti	Person
oličavale	uranile	lemma
napuštala	napuštali	Gender
identitetu	identitetima	Number
otkinuto	otkinulo	Voice
beduine	beduina	Number
pokretano	pokretalo	Voice
molitvom	molitvi	Case
uložili	uloženi	Voice
dugme	dugmeta	Number
admiralom	admiralima	Number
nerazgovijetnim	zamenjivim	lemma
kritici	kritike	Case
militantnijih	staromodnijih	lemma
izmaknuli	transportirasmo	lemma
lovila	lovili	Gender
sviralu	svirali	Case
homoseksualca	homoseksualce	Number
birali	birala	Gender
istraže	istražiš	Person
naslijedio	naslijedila	Gender
predela	predelima	Case
slovo	slova	Number
napati	simbolizira	lemma
izgubio	izgubljen	Voice
kapelani	kapelana	Case
nesvjesnu	bucmastu	lemma
potpise	potpisima	Case
jednačile	jednačili	Gender
pȅtēljke	pȅtēljkī	Case
uvjerena	uvjerene	Gender
seizmološke	seizmološka	Case
kokoši	kokošima	Number
oivičeno	doživljeno	lemma
krčena	krčeni	Gender
istosmjerne	drvene	lemma
junačka	artistička	lemma
radosnijima	najradosnijima	Comparison
eura	eurom	Case
neshvaćena	uzbuđena	lemma
rečice	rečica	Case
preplivao	preplivala	Gender
ciganiš	ciganite	Person
projicira	projiciraš	Person
najnepravednijih	najsatiričnijih	lemma
највећи	већи	Comparison
digao	dignut	Voice
naslijedile	naslijeđene	Voice
nastavom	nastavama	Number
prevashodnijima	zavojitijima	lemma
limfnome	carskome	lemma
kȁprīcā	kaprice	Case
nasledni	afirmativni	lemma
zaglibljeno	zaglibilo	Voice
hrvatska	ambasadorska	lemma
bestidničkima	bestidničke	Case
lansirali	lansirala	Gender
ispričavamo	ispričavaju	Person
vožena	voženo	Gender
uvučeni	uvukli	Voice
ratarska	sirijska	lemma
presudi	presudom	Case
zečevima	zečeve	Case
sutonu	sutonima	Number
nesvakidanjima	vereničkima	lemma
tlaku	tlakovima	Number
snȇg	snȅgovi	Number
prokleli	prokleti	Voice
riđobradom	riđobradim	Gender
kitova	kitovima	Case
runa	rune	Number
neobranjiva	tolerantna	lemma
skok	skokom	Case
dopunjena	dopunila	Voice
gonila	gonio	Gender
kraljevim	biciklističkim	lemma
začeta	začela	Voice
dospeš	dospem	Person
neljudskih	tračkih	lemma
staništa	stanište	Number
takmičarski	takmičarska	Gender
nakupio	nakupila	Gender
najosorniji	najuži	lemma
razmotrimo	razmotri	Person
ramenima	ramena	Case
obećavala	obećavalo	Gender
istovjetnim	urbanim	lemma
ispražnjen	ispraznio	Voice
eliksiri	eliksira	Case
tonski	матерњи	lemma
pčelu	pčele	Case
sajamski	sajamske	Gender
slastičarne	slastičarnu	Case
posedesmo	posedeh	Person
liga	lige	Number
jednookima	razbludnima	lemma
poremećivale	zableštile	lemma
pozivana	pozivan	Gender
bratićem	bratiću	Case
netočnu	svakakvu	lemma
najnezavidnijima	najverodostojnijima	lemma
rashodovala	rashodovale	Gender
umru	umremo	Person
poznajte	poznaj	Person
poprimili	poprimljeni	Voice
ispadaš	ispadamo	Person
stabljiku	stabljika	Case
brušene	brušeni	Gender
modo	modom	Case
ječe	ječi	Number
narednih	naredne	Case
poprilična	blaga	lemma
jednosmernim	dijaboličnim	lemma
akta	aktova	Number
objavljeno	objavilo	Voice
seksualnost	seksualnošću	Case
društvu	društvo	Case
belgijskih	belgijske	Case
izgovorio	izgovoren	Voice
hebrejskoga	sviračkoga	lemma
funtom	funto	Case
nepriliku	neprilike	Case
delovalo	delovao	Gender
mučene	mučile	Voice
pokoreno	pokorilo	Voice
jednače	jednači	Number
propatila	propatili	Gender
ispriča	ispričaju	Person
piramida	piramide	Number
percepcije	percepcija	Number
primetili	primećeni	Voice
mrtvaca	mrtvacima	Case
harmonijske	kožarske	lemma
pripisivan	pripisivao	Voice
neumitno	profinjeno	lemma
dokazalo	dokazano	Voice
boravile	boravili	Gender
proglasili	proglašeni	Voice
zabunkeriramo	zabunkeriraš	Person
nahvale	nahvalite	Person
krugovi	krugovima	Case
genocidu	genocid	Case
trudnicu	trȗdnica	Case
najrezonantniji	najsuptilniji	lemma
kenijskoga	šipkova	lemma
ribnjaci	fetiši	lemma
djevojčuljče	djevojčúljak	Case
lagodnoj	škodnoj	lemma
prebi	prebismo	Person
žȇmljā	žemlje	Case
kuhamo	kuha	Person
kutiju	kutije	Number
odsutnima	ukusnima	lemma
naterala	naterana	Voice
trkom	trče	Case
glasniku	glasnika	Case
uzelo	uzeo	Gender
sástavak	sástāvka	Case
najistinitije	najbistrije	lemma
kopalo	kopano	Voice
најдијаболичнији	дијаболичнији	Comparison
oboreni	oborene	Gender
zapovijedima	zapovijedi	Case
staklenom	staklena	Case
odleđivan	usmeren	lemma
nakladu	naklade	Number
onemogućuje	onemogućuju	Person
obeštećujemo	obeštećuješ	Person
pukovniji	pukovnijama	Number
silovala	silovao	Gender
kupusu	kupus	Case
nezakonita	troma	lemma
htela	htele	Gender
plinom	plinovima	Number
nizozemskima	nizozemskome	Number
nepunima	bučnima	lemma
isporučili	isporučila	Gender
riječima	riječi	Case
zibaste	zibasmo	Person
ljubljen	ljubljena	Gender
neprocenjivoga	crnookoga	lemma
silovanja	silovanje	Case
ljubomorna	beznačajna	lemma
hladnijoj	skeptičnijoj	lemma
krčazima	dahtajima	lemma
raspletalo	raspletala	Gender
speleologu	speleòlog	Case
rázdela	rázdeo	Case
iznenađuje	iznenađuju	Number
čitala	čitalo	Gender
nominalnoj	sićušnoj	lemma
papirom	papirima	Number
novaci	novacima	Case
standardizaciji	standardizaciju	Case
odlutale	odlutala	Gender
prijetilo	prijetio	Gender
uskratio	uskraćen	Voice
zdravlje	zdravlja	Case
rakova	raka	Number
palmino	stanarsko	lemma
trepnule	trepnula	Gender
rat	rata	Case
vježbamo	vježbate	Person
novogrčka	novogrčkoj	Case
brauzere	brauzerom	Case
rotacija	rotaciji	Case
nemarnijim	društvenijim	lemma
iscrpila	iscrpljena	Voice
prestonica	prestonicom	Case
opterećena	opterećeno	Gender
hlađah	hlađaste	Person
razdvajana	razdvajala	Voice
pacovi	pacove	Number
primiše	primi	Person
sredite	sredim	Person
crvenimo	crveniš	Person
kongruentnih	strmih	lemma
korejska	termopilska	lemma
pripovijedan	razdiran	lemma
salezijanskih	salezijanske	Case
izvijestio	izviješten	Voice
brbljala	brbljao	Gender
најшиљастији	шиљастији	Comparison
uzrujavane	uzrujavale	Voice
institutu	institutima	Number
košutu	košute	Case
pore	poro	Number
nagrađivana	nagrađivane	Gender
gatano	gatan	Gender
marah	marahu	Person
bèzbožnīci	bezbožnike	Case
motivima	alkama	lemma
autoportretima	autoportreti	Case
rascepim	rascepimo	Person
istarsko	srednje	lemma
najposrednije	najskupocenije	lemma
oživlena	oživleni	Gender
kukavnijega	budnijega	lemma
prepisivana	prepisivani	Gender
izađe	izađoše	Person
provjerila	provjerio	Gender
upriličene	upriličile	Voice
umarala	umarali	Gender
ključniji	fragilniji	lemma
zauzmu	zauzme	Person
gubitnikom	gubitnicima	Number
opčinjena	opčinila	Voice
otvorene	otvorile	Voice
komedijama	komedijom	Number
prihvatilište	prihvatilištu	Case
algonkijskoj	algonkijskomu	Gender
komandantima	komandantu	Number
kondiciji	veslu	lemma
parazitološkome	biračkome	lemma
krnji	bitniji	lemma
posjećivala	posjećivao	Gender
bezbožje	bezbožja	Case
krici	krik	Number
pratioca	pratiocu	Case
butom	but	Case
slušalico	slušalicom	Case
izmislila	izmišljena	Voice
akumulacija	akumulacijama	Case
ponovno	eminentno	lemma
kronično	voljno	lemma
najotmenije	najšugavije	lemma
vražićima	vražiću	Number
akronimom	akronimima	Number
statistika	statistici	Case
bocom	bocama	Number
namnažan	namnažao	Voice
satrapije	satrapijom	Case
ogrejavah	ogrejavaste	Person
grozovitih	bezosećajnih	lemma
žrtvenicima	žrtveniku	Number
ustaješ	ustajem	Person
krivotvoreni	krivotvorili	Voice
orkanom	orkanu	Case
isporučivana	isporučivala	Voice
najprimjetljivijima	najotmenijima	lemma
obaveštajna	barokna	lemma
obaraju	obara	Number
najmisteriozniji	najenergičniji	lemma
humoristična	ekskluzivna	lemma
saglediva	sagledive	Case
presjeci	presjek	Number
naučena	naučila	Voice
anglosasko	anglosaska	Gender
identificirala	identificiralo	Gender
imigrira	imigriraste	Person
kvislinška	kvislinške	Gender
najmatorijima	najbogohulnijima	lemma
komentatorima	komentatore	Case
slupan	slupano	Gender
prašnjavi	anegdotični	lemma
uraganskomu	uragansko	Case
najlepšoj	najvjetrovitijoj	lemma
најсавеснији	савеснији	Comparison
svrstavane	svrstavale	Voice
finski	finska	Gender
badanj	badnja	Case
daljine	daljino	Number
ukidao	ukidan	Voice
potopila	potopili	Gender
zaližu	zaližem	Person
oivičen	oivičeno	Gender
sagreši	sagreših	Person
saveznikom	saveznik	Case
ugušuju	ugušuješ	Person
usmjereno	usmjerilo	Voice
spikera	spikere	Case
parobrodi	parobrode	Number
ubojstva	ubojstvo	Number
napisano	napisalo	Voice
iscrpeni	iscrpene	Gender
železo	železa	Case
usnu	usno	Case
ostavljano	ostavljalo	Voice
sporazumima	sporazumi	Case
onemogućilo	onemogućeno	Voice
dućanu	dućanima	Number
inherentno	inherentna	Gender
mrvljena	mrvila	Voice
supruga	supruge	Case
neprikladna	učinkovita	lemma
podrezivale	podrezivali	Gender
despotu	despota	Case
inventivne	alarmantne	lemma
derištem	derišta	Case
najkovrdžavijega	najzgodnijega	lemma
pomognuta	pomognuti	Gender
tamnjahu	tamnjah	Person
neodgovorno	neodgovorna	Number
oslabila	oslabljena	Voice
nevernicima	nevernikom	Number
aproksimirao	aproksimiralo	Gender
zeta	zetova	Number
faktora	faktori	Case
naoblači	uspij	lemma
pokazao	pokazalo	Gender
iskustvene	raskošne	lemma
riješila	riješilo	Gender
učinila	učinio	Gender
naslednica	naslednici	Case
nelojalnima	nelojalnomu	Number
omogućile	omogućene	Voice
žlezde	žlezda	Number
sudije	sudiju	Case
najprijatnijih	najubogijih	lemma
prepisima	prepise	Case
lovom	lovama	Number
suprotstavljeni	suprotstavljena	Gender
puščani	božiji	lemma
prigovaraju	prigovara	Person
okrenulo	okrenuo	Gender
listopadnoga	listopadnomu	Case
mučnijega	smjelijega	lemma
neobrađeni	neobrađenomu	Case
mezopauze	mezopauzo	Case
nada	nade	Case
trznule	trznuli	Gender
domaćicu	domaćici	Case
predstavljena	predstavljen	Gender
mamite	mamiš	Number
obojica	obojici	Case
celivala	celivana	Voice
oblačnima	snuždenima	lemma
pogodnijima	bistrijima	lemma
siljene	siljena	Gender
zabušila	zabušilo	Number
ravnomjernijih	vještijih	lemma
neprestanim	tradicionalnim	lemma
fusnote	fusnota	Number
oštroumne	entuzijastične	lemma
provođeni	provodili	Voice
odstupili	odstupio	Number
plutala	plutao	Gender
kartale	kartala	Gender
boravak	boravkom	Case
kajkavština	kajkavštini	Case
rešetkasta	rešetkaste	Gender
nasledniku	naslednikom	Case
elektromrežom	elektromreži	Case
uposlen	uposlio	Voice
izražavana	izražavala	Voice
optuživano	optuživalo	Voice
očuvalo	očuvala	Gender
plovidba	plovidbe	Number
ulazila	ulazio	Gender
nabijane	nabijani	Gender
školom	školama	Number
razmeniš	razmeni	Person
nedodirljivima	bilabijalnima	lemma
razgrizi	razgrizimo	Person
polijetah	blenuh	lemma
nečista	gnusna	lemma
slatki	glineni	lemma
ljubimca	ljubimcem	Case
plahijima	sramotnijima	lemma
škopljeni	škopili	Voice
najmekšoj	najtopivijoj	lemma
rojalista	rojalistima	Case
obasuti	obasuli	Voice
rekonstrukcijom	rekonstrukcija	Case
razmatran	razmatrao	Voice
nedostajala	nedostajalo	Gender
vijeća	vijeću	Case
ručke	ručkama	Case
odvažila	odvažio	Gender
učvrstila	učvršćena	Voice
košnice	košnicu	Number
usidrena	usidrila	Voice
lula	lule	Number
pokajnikom	pokajnika	Case
geologija	geologije	Case
sastavne	sastavnih	Number
renovirasmo	renovira	Person
vreteno	vretenu	Case
palindrom	palindromi	Number
porobljeni	porobili	Voice
pruska	stepska	lemma
detaljnoga	detaljne	Gender
tundro	tundre	Number
okoliše	strukture	lemma
neprijateljstva	neprijateljstvo	Number
rotaciji	rotacijo	Case
oleati	oleata	Case
bogumile	bogumila	Case
ključ	ključeve	Number
povela	povele	Gender
koeficijentom	koeficijent	Case
magnetična	federalna	lemma
severa	severom	Case
manjino	manjinom	Case
ambasadama	ambasadi	Number
tabelu	tabele	Case
indološkome	epileptičkome	lemma
prebijale	prebijane	Voice
nesložnije	dekadentnije	lemma
kukavnih	ukusnih	lemma
razišla	razišao	Gender
najnezavidnijega	najnezavidnijim	Case
putanje	putanjo	Case
skrštene	skrstile	Voice
prijestolnica	prijestolnice	Number
smaknuta	smaknute	Gender
furundžija	furundžijama	Case
најдарежљивији	дарежљивији	Comparison
ogrlicu	ogrlica	Case
energije	energijo	Case
krepaju	krepam	Person
nezakonskoj	fizičkoj	lemma
izgradnje	izgradnja	Case
sȉmultānosti	simultanost	Case
oplovili	borili	lemma
prelomljene	prelomile	Voice
procjenjivane	procjenjivale	Voice
biserima	biseru	Number
istorodni	debeli	lemma
kalvinìzma	kalvinizam	Case
najpovoljnijega	najsnenijega	lemma
skloništa	sklonište	Number
noćila	noćilo	Gender
jesenjoj	djetinjoj	lemma
најеротилнији	еротилнији	Comparison
obilježilo	obilježeno	Voice
plativima	algebarskima	lemma
pobornikom	pobornika	Case
razjarim	razjare	Person
ravnica	ravnicu	Case
sljedeća	sljedeće	Gender
gutani	ukorenjivani	lemma
formacijom	formacijo	Case
fajdi	fajdo	Case
ulože	ulozi	Number
opsežnije	tešnje	lemma
popisani	popisali	Voice
teran	terana	Gender
brisali	brisala	Gender
dogovorene	dogovorile	Voice
kontejnere	kontejnerima	Case
najgrđima	najaljkavijima	lemma
otišla	otišlo	Gender
špeku	špekom	Case
postojala	postojali	Gender
odmorni	sintetični	lemma
podstrižene	podstrigle	Voice
meteorolog	meteorolože	Case
vȅrenīci	vȅrenīk	Number
Bòsānācā	Bosánca	Number
paragvajske	sudanske	lemma
zatočio	zatočili	Number
doselila	doseljena	Voice
poželjnoga	antropomorfnoga	lemma
kolom	kola	Case
naturalno	vodoravno	lemma
okralo	okrao	Gender
otkazale	otkazala	Number
falsifikat	falsifikatom	Case
zapisivan	zapisivao	Voice
vladavina	vladavine	Case
najkrševitiji	najbespravniji	lemma
potajnima	živčanima	lemma
najintimniji	intimniji	Comparison
sažete	sažele	Voice
најженственији	женственији	Comparison
ponela	ponelo	Gender
vadili	vađeni	Voice
grgeč	grgeči	Number
porazi	poraz	Number
meditacije	meditacija	Number
snabdeveni	snabdevena	Gender
kratkovalnomu	toponimskomu	lemma
tuceta	tucetima	Case
nadevana	nadevala	Voice
kaznenome	tekućemu	lemma
izbečen	izbečio	Voice
predano	predalo	Voice
nastupalo	nastupao	Gender
hramovima	hramovi	Case
osnovane	osnovale	Voice
plodna	trostruka	lemma
dimljahu	dimljasmo	Person
aritmije	aritmiju	Number
rastopljen	rastopio	Voice
neadekvatnih	prospektivnih	lemma
tržnice	tržnicom	Case
zahvali	zahvalimo	Person
tučeni	tukli	Voice
ovlasti	ovlastite	Person
napustilo	napušteno	Voice
odgovorila	zakinula	lemma
prikazale	prikazane	Voice
malijske	saksofonske	lemma
neiscrpljivih	suhih	lemma
spojen	spojeno	Gender
komentiraj	elidiraj	lemma
inkvizitorske	cirkusantske	lemma
doznavale	doznavane	Voice
glumljena	glumljene	Number
odobrena	odobrila	Voice
stane	stanu	Case
prisiljavali	prisiljavao	Number
preplivale	preplivane	Voice
napadnom	ranom	lemma
fokusirao	fokusiralo	Gender
izvršavali	izvršavala	Gender
neiskusan	ukusan	lemma
predloženi	predložena	Gender
zamjerilo	zamjerila	Gender
najpraktičnijih	najvrtložnijih	lemma
sarađivale	sarađivala	Gender
diskriminiraše	diskriminiraste	Person
pešaka	pešakom	Case
žicu	žicom	Case
odlomaka	odlomci	Case
obuzimah	obuzimaste	Person
zamenjuje	zamenjuju	Number
aritmetikom	aritmetici	Case
odvio	punio	lemma
prostorijom	prostoriji	Case
skrenuo	skrenulo	Gender
najnezahvalniji	najčvršći	lemma
klikćite	klikćimo	Person
kladu	klade	Case
patologiju	patologiji	Case
pobjednici	pobjednike	Case
nepromijenjena	zauzeta	lemma
nazvala	nazvali	Gender
neovisnima	svemogućima	lemma
pravoslavnih	ratobornih	lemma
prekinuto	prekinut	Gender
patetičnijemu	erotičnijemu	lemma
grešno	riđe	lemma
logički	božiji	lemma
sekundama	sekundom	Number
odjeljivahu	odjeljivah	Person
drvoredima	drvoredom	Number
odzdravila	odzdravilo	Gender
snabdijevala	snabdijevana	Voice
lipnji	lipnju	Number
uslovnom	uslovnim	Gender
zalijevan	zalijevao	Voice
šarmiram	šarmira	Person
najposlovnijima	najglupavijima	lemma
kartografska	češka	lemma
stadionima	stadionom	Number
preseca	zimuje	lemma
iznosila	iznosilo	Gender
podmukla	bespredmetna	lemma
jaja	jaje	Number
neočekivana	glacijalna	lemma
pregradi	pregradama	Number
pokažemo	pokažeš	Person
predloženi	predložene	Gender
stišavao	stišavan	Voice
spaljivana	spaljivani	Gender
primijetio	primijećen	Voice
odgovorena	odgovorila	Voice
sastavljena	sastavljene	Gender
neuobičajenije	dalekosežnije	lemma
oportuno	sabrano	lemma
patriotska	učiteljska	lemma
prilagodbu	prilagodbe	Number
uvažavan	uvažavao	Voice
privedoste	razglobljivaste	lemma
zatajila	zatajena	Voice
izmuzemo	izmuzete	Person
nostalgije	nostalgija	Case
isterate	bodujete	lemma
hladna	beskičmena	lemma
opčiniše	opčini	Person
sjene	sjenama	Case
potpisivani	potpisivane	Gender
napunio	zakasnio	lemma
određivanjima	određivanja	Case
civilna	civilno	Gender
mlekari	mlekarama	Number
suočio	suočen	Voice
jove	čaja	lemma
malarije	malariju	Case
najpotmulijih	najarhaičnijih	lemma
otkazana	otkazano	Gender
opijamo	opijaju	Person
odnarođena	odnarođeni	Gender
smatrala	smatrao	Gender
snimljena	snimljene	Gender
mlečne	dravske	lemma
separirasmo	separirahu	Person
pretplaćivana	pretplaćivala	Voice
navalile	navalila	Gender
potvrđivalo	uvrijedilo	lemma
seksa	seksom	Case
pokrštavaju	pokrštavate	Person
banditska	banditsko	Gender
aerodromsko	tajfunsko	lemma
nenapučenim	vrpčastim	lemma
pokrstilo	pokršteno	Voice
izišla	unakazila	lemma
bosiljke	bosiljaka	Case
kolom	kolo	Case
plodne	oštroumne	lemma
trȏjstāvā	trojstva	Case
jazbina	jazbine	Number
propuštena	propušten	Gender
portfeljima	portfelja	Case
saraju	saraja	Case
kantonski	sudanski	lemma
krezavima	amoralnima	lemma
raspolagala	raspolagali	Gender
rezultirala	rezultirao	Gender
paragrafi	paragraf	Number
pušen	pušio	Voice
neprihvatljivu	staklastu	lemma
razmotavah	razmotavaste	Person
trnjem	trnje	Case
učinak	učinku	Case
specijalizacije	specijalizaciju	Number
vozu	voza	Case
kriminalcem	kriminalca	Case
oduprla	oduprli	Gender
onečišćena	onečišćen	Gender
poletele	uzrujale	lemma
sporazumevaše	sporazumevah	Person
nerazumniji	žižljiviji	lemma
zabavljaču	zabavljačima	Number
nastave	nastavimo	Person
odstranjivalo	odstranjivano	Voice
iracionalne	globalne	lemma
čeličahu	čeličaše	Person
spalila	spalile	Gender
patentima	patenti	Case
izumelo	izumljeno	Voice
opòreknēm	oporeknemo	Number
analizi	analizama	Number
nepredvidljivi	uspravni	lemma
kladile	kladila	Gender
saginjana	saginjani	Gender
histerična	živčana	lemma
kovrdžavije	šiljastije	lemma
bistroumljem	bistroumlju	Case
izmamljivalo	izmamljivala	Gender
granato	granata	Case
agoniju	agonije	Number
puževa	centralna	lemma
kazanima	kazanu	Number
londonskoj	albanskoj	lemma
vakufa	vakuf	Case
zanemarivale	zanemarivali	Gender
najpustolovniji	najsmješniji	lemma
nagradite	nagrade	Person
najosjećajniji	najbolešljiviji	lemma
osigurale	osigurane	Voice
linearna	providna	lemma
nasleđivali	nasleđivao	Number
zabilježena	zabilježeno	Gender
smȇšākā	smeška	Number
navezan	navezao	Voice
kožara	kožar	Case
prosperirali	prosperirale	Gender
priznavani	priznavali	Voice
povjesničara	povjesničar	Case
poginula	poginuli	Gender
različitije	najrazličitije	Comparison
kovrčavijih	senovitijih	lemma
asimetrija	asimetrije	Number
nihilistički	nihilističko	Gender
grubima	zvaničnima	lemma
izravne	federalne	lemma
podese	zbroje	lemma
poljoprivrede	poljoprivreda	Number
preskočeno	preskočen	Gender
najnepovjerljivijih	najfunkcionalnijih	lemma
oplodila	oplođena	Voice
redosleda	redosled	Case
preplivavah	preplivavaše	Person
pripremana	pripremano	Gender
kamenitima	šljunčanima	lemma
uvozili	uvozila	Gender
logičke	astrološke	lemma
proizvodni	proizvodna	Gender
amaterskima	amaterskim	Number
anodom	anodu	Case
pokršten	pokrstio	Voice
најпрецизнији	прецизнији	Comparison
očaravali	viđali	lemma
izbrisala	izbrisana	Voice
komplementarnu	benignu	lemma
pitanjima	pitanju	Number
anegdotičnu	anegdotično	Gender
nekomunikativnu	apartnu	lemma
priprostije	blatnije	lemma
regicidu	regìcīd	Case
pramcem	pramcu	Case
čitave	čitava	Gender
nagradili	nagrađeni	Voice
ljuća	traumatičnija	lemma
zonu	zone	Number
isključena	isključila	Voice
podsvjesna	septična	lemma
nezadovoljstvo	nezadovoljstvu	Case
ciljevi	cilj	Number
novčanih	turističkih	lemma
mutne	biserne	lemma
nesalomljivoj	tekstualnoj	lemma
nepristrane	šarolike	lemma
rekonstruirala	rekonstruirao	Gender
preplaćujte	preplaćujmo	Person
најузвишенији	узвишенији	Comparison
sastavljale	sastavljala	Number
zadavana	zadavano	Gender
kriminalistika	kriminalistiku	Case
najredovitijima	najvarvarskijima	lemma
termin	termine	Number
novorođenih	pustolovnih	lemma
izbegavao	izbegavalo	Gender
pokradeni	pokrali	Voice
kratkovalne	caričine	lemma
javanski	први	lemma
obujmljivano	obujmljivan	Gender
briologije	briologijom	Case
povezuje	povezuju	Number
rešavala	rešavali	Gender
најрупичастији	рупичастији	Comparison
skloni	sklonite	Person
malakši	baždari	lemma
žednele	žednela	Gender
najpoznatije	najstrašnije	lemma
podukama	poduci	Number
nezgoda	nezgode	Case
razmjeru	razmjeri	Number
kancerogenijih	gostoljubivijih	lemma
seansama	seansa	Case
boljima	najboljima	Comparison
mlȁdīću	mladiću	Case
spelovala	spelovalo	Gender
izrečena	izrečeni	Gender
lijena	prosečna	lemma
најстручнији	стручнији	Comparison
nošena	nosila	Voice
šaljivčina	šaljivčinama	Case
lusteri	luster	Number
obuzimala	obuzimalo	Gender
sudila	suđena	Voice
najprimernijima	najamoralnijima	lemma
uspostavili	uspostavila	Gender
popraćena	popratila	Voice
jedaća	dramska	lemma
zakletvi	zakletve	Case
tolerantnost	tolerantnosti	Case
smirene	smireni	Gender
dolazila	dolazilo	Gender
snagatore	snagatori	Number
individua	individue	Number
razuvjerene	razuvjereni	Gender
luđim	celovitijim	lemma
kovačnice	kovačnicama	Case
ponosna	uvređena	lemma
tamnjelo	tamnio	Gender
nenormalna	bilateralna	lemma
postanak	postanku	Case
nasukao	nasukan	Voice
plivača	plivače	Number
usavršavate	usavršavaš	Number
sepsama	sepse	Case
nepromenjena	nepromenjeni	Gender
iznelo	izneseno	Voice
ugađale	ugađala	Gender
izvrsne	trenutne	lemma
koncepti	koncept	Number
najneumerenije	najbezobzirnije	lemma
poletimo	poletite	Person
dokonici	dokonicama	Number
boravku	boravkom	Case
udaljavale	udaljavala	Gender
akvizicija	akvizicije	Number
higijeni	higijenom	Case
pričekate	pričekaš	Number
obnovili	obnovljeni	Voice
belasnu	belasne	Person
opredeljivana	opredeljivala	Voice
posustala	tvrdila	lemma
prestonice	epigrame	lemma
najezda	najezdama	Case
rakúna	rakune	Case
zapazi	zapaziste	Person
hamajlijama	hamajlije	Case
nepoznat	tanak	lemma
frontovima	frontove	Case
uvijate	uvijaš	Number
ekskomunikacija	ekskomunikacije	Case
iskazivao	iskazivala	Gender
reagirah	anketirah	lemma
napravljeno	napravljena	Gender
aerosoli	aerosola	Case
kolekcija	kolekciju	Case
dano	dalo	Voice
uzburkani	uzburkana	Gender
obličju	obličje	Case
jezgre	vežbe	lemma
pretražila	pretražio	Gender
pogođeno	pogođena	Gender
orlova	erotska	lemma
pogodnije	najpogodnije	Comparison
razdvojen	razdvojeno	Gender
zlikovce	zlikovci	Case
nenadane	zauzete	lemma
ocijenjena	ocijenjene	Gender
janjahu	bivovahu	lemma
odugovlačio	odugovlačila	Gender
kompanijom	kompanijama	Number
intrigantnih	federalnih	lemma
blagostanja	blagostanjem	Case
smislile	smišljene	Voice
zatočeni	zatočena	Gender
pripojeni	pripojili	Voice
bosónā	bosónima	Case
pretpostavljalo	pretpostavljao	Gender
malograđana	zapovednika	lemma
menjana	menjala	Voice
šerife	šerifa	Case
predbačeni	uzoravani	lemma
zaratite	zaratimo	Person
suprotstavljeni	suprotstavili	Voice
pošteđena	razasuta	lemma
zabeleženi	zabeležene	Gender
dotiskana	dotiskani	Gender
iskazivala	iskazivana	Voice
kritizirahu	skladahu	lemma
osiromašujem	osiromašuješ	Person
dimljene	dimile	Voice
personifikacijama	personifikacije	Case
najpredvidljivijom	najamorfnijom	lemma
tezom	tezama	Number
prostorne	semitske	lemma
promijenila	promijenile	Gender
anomaliji	anomalijama	Number
krofnom	vizitkom	lemma
kiklopskih	seizmoloških	lemma
talilo	taljeno	Voice
prognali	prognani	Voice
hoćaše	zraše	lemma
svinjarom	svinjaru	Case
nezakonit	smrtonosan	lemma
oprostima	oproste	Case
snimale	snimane	Voice
prepoznata	prepoznat	Gender
spajali	spajala	Gender
budòār	budoaru	Case
ujedinila	ujedinile	Gender
odustale	odustala	Gender
kristaliziran	kristalizirano	Gender
osvajali	osvajani	Voice
procent	pròcent	Case
javilo	javila	Number
tvornici	tvornicom	Case
pìkseli	pìkselima	Case
invazijsku	vampirsku	lemma
saopćimo	saopći	Person
primetljivije	ruševnije	lemma
crnčah	crnčaše	Person
tanjuru	tanjurima	Number
imperijalistu	imperijaliste	Case
čičcima	čičkom	Number
grebano	greban	Gender
pornografska	crtaća	lemma
hvalisava	spiralna	lemma
pomorcima	pomorci	Case
ledila	leđena	Voice
gimnazija	gimnaziji	Case
melodrama	melodrame	Case
transporter	transporteru	Case
krševitoj	bezrezervnoj	lemma
skupnika	skupnike	Number
šljapnute	šljapnuti	Gender
novačilo	novačio	Gender
modemom	modem	Case
razmatralo	razmatrano	Voice
prijateljski	prijateljsko	Gender
podstavih	šparah	lemma
insolventnih	tajnovitih	lemma
estuariji	estuarija	Case
razgaljivao	razgaljivan	Voice
naručivan	naručivano	Gender
načinjeno	načinilo	Voice
nametnuh	nametnu	Person
podatku	podatkom	Case
nametnuta	nametnula	Voice
cepaj	cepajmo	Person
opljačkana	opljačkani	Gender
pjenjah	pjenjahu	Person
zatajivalo	zatajivano	Voice
ptičadi	zadcima	lemma
antireligiozne	antireligiozna	Number
križarici	sjemenu	lemma
tablicom	tablicama	Number
reagirah	reagirahu	Person
lukavoga	relevantnoga	lemma
miješali	miješani	Voice
očarale	očarali	Gender
autorici	autorica	Case
geometrijskoga	geometrijskih	Number
podbadao	podbadan	Voice
provođena	provođeni	Gender
najprašnjavijim	najdramatičnijim	lemma
suzbili	suzbile	Gender
zatvorene	zatvorena	Gender
prerezan	prerezao	Voice
plućna	anglosaksonska	lemma
zlostavljane	zlostavljale	Voice
strašite	straši	Person
plativa	asamskoga	lemma
deizama	deizmima	Case
krađama	krađe	Case
zaraćeni	zaraćene	Gender
nježnih	šarmantnih	lemma
zaboo	zabolo	Gender
obasuo	obasulo	Gender
okrivljivao	okrivljivan	Voice
izuzele	izuzeli	Gender
klasifikacija	klasifikacijom	Case
onemogućili	onemogućeni	Voice
uručivahu	uručivaše	Person
severoistok	severoistoku	Case
sredila	sređena	Voice
ogrejavale	ogrejavala	Gender
jedrenjak	jedrenjakom	Case
cenila	cenjena	Voice
bolnici	bolnicama	Number
žrtve	žrtvom	Case
oštetim	oštete	Person
razarala	razarana	Voice
razvedenosti	razvedenostima	Number
izdaje	izdaji	Case
gnosticizme	gnosticìzam	Case
bilježili	bilježile	Gender
refleksu	refleksima	Number
најсклеротичнији	склеротичнији	Comparison
opisivali	opisivale	Gender
uzvisila	uzvišena	Voice
nabavljene	nabavljena	Gender
osudila	osudio	Gender
gresima	grehom	Number
maternji	dalmatski	lemma
noćne	crnogorične	lemma
bičevahu	bičevah	Person
udarao	udaralo	Gender
iselim	uvalim	lemma
sadra	sadri	Case
buni	buno	Case
tuširali	tuširale	Gender
hraniteljici	hraniteljicu	Case
nadmašili	nadmašila	Gender
upisivan	upisivana	Gender
trodimenzionalnom	trodimenzionalnoj	Case
upaljeno	upaljen	Gender
izvornih	verskih	lemma
rušen	rušio	Voice
sabijen	sabio	Voice
najopravdanijoj	najbezopasnijoj	lemma
podešen	podešena	Gender
đavoljega	đavolji	Case
otkrivena	otkriven	Gender
zasluzi	zasluge	Case
provjere	provjeru	Case
imobilnima	želatinastima	lemma
ocijenjena	ocijenila	Voice
jove	jovi	Case
ispraznih	ispraznismo	Number
nastupila	nastupio	Gender
nastanim	nastaniš	Person
neproduktivan	симултан	lemma
osigurani	osigurali	Voice
najkooperativnije	najfrekventnije	lemma
spriječio	spriječen	Voice
sopranu	sopranima	Number
prisutnijima	zloćudnijima	lemma
podučavao	slabio	lemma
najlošija	najanimalnija	lemma
čuvare	čuvarima	Case
neproduktivnijih	čovječnijih	lemma
prognanika	prognanicima	Case
haringi	haringe	Case
stvarala	stvarale	Gender
aminokiselinama	aminokiselini	Number
uočeni	uočena	Gender
sklopili	sklopila	Gender
oboo	obola	Gender
iscelio	iscelilo	Gender
sviraju	svira	Number
ikavštini	ikavštinom	Case
besparica	besparicom	Case
abecedarije	fakinaže	lemma
okruženje	okruženju	Case
napeh	napesmo	Number
pokornu	besprizornu	lemma
zatekla	zatekli	Gender
čokoladu	čokolado	Case
karane	karana	Gender
močila	močena	Voice
glavoboljom	glavobolju	Case
teologija	teologiji	Case
primičite	primiči	Person
најирационалнији	ирационалнији	Comparison
ljubavnih	zakonskih	lemma
uzdržali	uzdržani	Voice
snimilo	snimljeno	Voice
najkasnijoj	najskrupuloznijoj	lemma
grijesima	grijesi	Case
namerne	trostrane	lemma
kraljevala	kraljevao	Gender
gata	gatam	Person
prilična	bujna	lemma
verile	verili	Gender
korpulentnijima	epohalnijima	lemma
stavovima	stavom	Number
malajski	malajska	Gender
maloljetnicu	maloljetnici	Case
razvožene	razvozile	Voice
izvršena	izvršeni	Gender
favoriti	favorita	Case
najočevidnijemu	najuzvišenijemu	lemma
renovirahu	diktirahu	lemma
pravljene	pravile	Voice
otimaju	otima	Number
jednosobnih	dovitljivih	lemma
posjedovala	posjedovalo	Gender
optužen	optuženo	Gender
ukupni	ukupne	Case
ađùtanātā	ađutanta	Number
železnička	železničke	Gender
bazaltu	bazaltima	Number
trudile	trudili	Gender
kreativna	suzna	lemma
epigramu	epigram	Case
nužno	usko	lemma
atelje	ateljea	Case
pronašao	pronađen	Voice
verski	versko	Gender
rezultiraju	rezultira	Person
dospjela	dospjeli	Gender
nadahnjujte	nadahnjuj	Number
pleonastičnima	grandioznima	lemma
pozdravljeno	pozdravljena	Gender
prigrizalo	prigrizao	Gender
sȕžānjā	sȗžnja	Number
karan	karana	Gender
imovinske	dalekometne	lemma
telefonije	telefoniji	Case
džinizama	džinizme	Case
најнадмоћнији	надмоћнији	Comparison
opsjednuti	opsjeli	Voice
jurcaš	jurcate	Number
neposlušnija	čišća	lemma
indijskim	školskim	lemma
kamenite	uspravne	lemma
primerena	uključiva	lemma
nadvilo	nadvito	Voice
platneni	smjeli	lemma
nedeljnim	akrobatskim	lemma
porabe	porabu	Case
leđne	alkoholne	lemma
lepi	verni	lemma
smenjena	smenjeni	Gender
nemani	neman	Case
donesena	donesen	Gender
najhrapavije	najtreznije	lemma
napijaš	napija	Person
lišajevima	lišajevi	Case
potkupi	potkupiše	Person
glasa	glasam	Person
zaglibljivala	zaglibljivao	Gender
kolebljivija	duhovitija	lemma
mirovine	mirovinu	Number
promašeno	promašena	Gender
simbola	simboli	Case
kupovala	kupovali	Gender
pribadalo	pribadala	Number
stričeve	stričevi	Case
prikupljane	prikupljale	Voice
podesile	podesili	Gender
tegoba	tegobe	Number
mlitaviju	dekadentniju	lemma
ozlede	stisnu	lemma
meko	ružno	lemma
pijaca	pijacama	Case
kravara	kravar	Case
nominativna	venska	lemma
kukavnije	smislenije	lemma
perilice	certifikati	lemma
sazvana	sazvala	Voice
saharinski	svȉ	lemma
uveravao	uveravala	Gender
baš-čaršija	baš-čaršije	Number
obilatijim	solidnijim	lemma
milosrdnima	anegdotalnima	lemma
popričalo	smještalo	lemma
pobaci	pobace	Person
dopunilo	dopunila	Number
štathalterijo	štathalterije	Number
prolozima	prologu	Number
hoteli	hotele	Number
napijaste	razblažiste	lemma
poriče	poriču	Person
opisao	opisan	Voice
ljupkima	bahatima	lemma
progresivnijemu	grandioznijemu	lemma
narav	naravi	Case
jovama	jove	Case
hranjena	hranila	Voice
četvrtice	četvrtici	Case
primaknuli	primaknuo	Person
sastojala	sastojali	Gender
zamjerala	zamjerao	Gender
neshvatljiv	skupocen	lemma
otkaza	otkazaste	Person
pljačkan	pljačkao	Voice
lomljena	lomljeni	Gender
šipak	šipku	Case
incidentom	incidente	Case
miješane	miješana	Gender
solara	solar	Case
aljkavijih	najaljkavijih	Comparison
analgetičkima	analgetičkih	Case
obola	obole	Gender
dangubila	dangubilo	Gender
jarčevom	versajskom	lemma
taloge	talog	Number
nastanjivala	nastanjivalo	Gender
prekinuo	prekinula	Gender
sobaricom	sobarica	Case
pušačima	pušača	Case
sobari	sobar	Number
najravnomernijemu	najučenijemu	lemma
obustavljani	obustavljali	Voice
aparatu	aparatom	Case
ljȕbaznīci	ljubaznika	Case
uočavalo	uočavano	Voice
zlaćaše	zlaćasmo	Person
najrazuzdanijima	najćaknutijima	lemma
nadživljavala	nadživljavana	Voice
skanjivalo	skanjivano	Voice
ȉstorodnōst	istorodnost	Case
antitijela	antitijelo	Number
pomagani	razmotavani	lemma
darovite	darovitima	Case
početa	počela	Voice
antenama	antena	Case
otuđivan	otuđivao	Voice
judejska	tekuća	lemma
tehničari	tehničar	Number
imunitet	imunitete	Number
mjesečna	bračna	lemma
ubirana	ubirano	Gender
razagnamo	razagnaš	Person
nagrtana	nagrtala	Voice
crvendaća	crvendaći	Case
rezultirali	rezultirale	Gender
nagovešćivani	nagovešćivana	Gender
uništavani	uništavane	Gender
intenzivnu	visoku	lemma
najsuhoparniji	suhoparniji	Comparison
porasle	porasla	Gender
kardinalska	zmijska	lemma
supstanca	supstancu	Case
širine	širinama	Case
činovima	činove	Case
menopauza	menopauzi	Case
najpristraniji	najbedniji	lemma
iznesen	iznio	Voice
pokretala	pokretana	Voice
jekne	jeknemo	Person
klimatologijom	klimatologiju	Case
historicizmima	demokratijama	lemma
izmjenično	bombastično	lemma
neverne	blagonaklone	lemma
pobunilo	pobunio	Gender
ograničenjem	ograničenjima	Number
babilonskih	babilonske	Number
izumljeni	izumeli	Voice
ugradio	ugradila	Gender
krivòkletnīče	goljenjačo	lemma
zaboravljena	zaboravila	Voice
filogenezom	filogenezo	Case
stavljani	stavljali	Voice
perspektivno	zrakoprazno	lemma
potaknuta	razlamana	lemma
jednačini	jednačinu	Case
car	care	Case
labilno	reproduktivno	lemma
loče	ločemo	Person
financira	financiram	Person
koloture	kolotur	Number
zadimiš	zadime	Person
protivile	protivili	Gender
solari	solar	Number
oblike	oblik	Number
dimničaru	dimničara	Case
potvrđujete	potvrđuju	Person
lisnata	večita	lemma
kozarstva	kozarstvo	Number
prebačeni	prebacili	Voice
mikrobima	mikrobe	Case
anortite	anortita	Case
budale	budalim	Person
zabijen	zabio	Voice
kaljuge	kaljuga	Number
najosvetljivijima	najvrtoglavijima	lemma
kvant	kvanti	Number
izravnaš	izravnate	Person
stetoskop	stetoskopi	Number
pripravljena	pripravljene	Gender
praznoverja	praznoverje	Number
operama	operom	Number
stopljena	stopljen	Gender
učvršćivano	učvršćivalo	Voice
prikazane	prikazani	Gender
izmamilo	izmamila	Number
tisućo	tisuću	Case
cijenilo	cijenila	Number
lika	lik	Case
obrađivalo	obrađivala	Gender
medena	sumnjiva	lemma
otimam	umaram	lemma
ukrasila	ukrasio	Gender
menjana	menjane	Number
postidjeste	postidjeh	Person
ukorjenjivane	ukorjenjivale	Voice
cinka	cinku	Case
pizdele	pizdela	Gender
udao	udan	Voice
uradimo	uradiš	Person
trgaš	trgate	Person
brojevima	broju	Number
највреднији	najbojažljiviji	lemma
humanima	prkosnima	lemma
štedljiviji	карактернији	lemma
izgorjeh	izgorjesmo	Person
zajedništva	zajedništvu	Case
gubitnicom	gubitnicama	Number
nesputanu	grandioznu	lemma
abnormalne	ezoterične	lemma
izvodljiva	nenaseljena	lemma
očekivanja	očekivanjima	Case
најнезнатнији	незнатнији	Comparison
pacifičke	zapadnjačke	lemma
orgije	orgiju	Case
istrebljeni	istrebljene	Gender
komemoracija	komemoracijom	Case
zeta	zete	Case
snabdijevajte	snabdijevaj	Person
mekšega	drhtavijega	lemma
povećani	povećali	Voice
razmišljalo	razmišljao	Gender
klimi	klimama	Number
најврснији	врснији	Comparison
kontracepcije	kontracepciji	Case
naišla	naišli	Gender
labuđa	akadska	lemma
pećine	pećinu	Number
rastvorena	rastvorila	Voice
usmjeren	usmjereno	Gender
obrisani	obrisane	Gender
legenda	legende	Case
sprovela	sprovedena	Voice
izvodljivije	anonimnije	lemma
parlamente	parlamenta	Case
perzijske	perzijskih	Case
bajtom	bajto	Case
završili	završeni	Voice
higijene	higijeni	Case
potvrdilo	potvrdila	Gender
harana	haran	Gender
najmesnatije	najvidljivije	lemma
zapošljavala	zapošljavali	Gender
neprijatnijemu	vrtoglavijemu	lemma
odeva	odevaju	Person
izrazitijim	tananijim	lemma
naoružala	naoružale	Gender
aerodrome	aerodrom	Case
najmlitavije	najekonomičnije	lemma
premašena	premašila	Voice
plićemu	tečnijemu	lemma
agrostologijom	agrostologiju	Case
poveravana	poveravala	Voice
uzvikivali	uzvikivale	Gender
razapeta	razapete	Gender
nesložnima	smrtonosnima	lemma
marljive	besprimerne	lemma
vožen	vožena	Gender
pomazah	pomaza	Person
sahranjivala	sahranjivana	Voice
replike	replika	Number
hladnokŕvnosti	autoricom	lemma
oštrije	slavohlepnije	lemma
afarskim	afarskom	Gender
prelaznim	vjernim	lemma
ispredu	ispredemo	Person
kozmetički	šahovski	lemma
povredilo	povređeno	Voice
iskoristiše	iskoristi	Person
spaljivalo	spaljivano	Voice
hrama	hram	Case
novaku	novače	Case
darovani	darovan	Number
jačam	vračam	lemma
predam	predaju	Person
zadavan	zadavano	Gender
svidjela	svidjelo	Gender
izrican	izricao	Voice
mjenjačnicama	mjenjačnicom	Number
ismejavajmo	uselimo	lemma
trošite	troši	Person
otporno	otporan	Gender
kolebljive	zanimljive	lemma
raspadahu	raspadaste	Person
kotlovine	kotlovínā	Number
mudrije	frekventnije	lemma
pripremalo	pripremala	Gender
socijalne	socijalna	Gender
pisalo	pisao	Gender
monografiji	monografijama	Number
nerazvijenih	racionalnih	lemma
navozio	navozila	Gender
zvale	zvane	Voice
obola	oboli	Gender
recesiju	recesija	Case
ukoreni	ukorili	Voice
držao	držan	Voice
àršīn	aršinu	Case
preduzeće	preduzeća	Number
zdravlju	zdravlje	Case
ocenili	ocenjeni	Voice
simbole	simbolu	Case
sledu	sled	Case
zatomljeno	zatomljen	Gender
prute	prutu	Case
okotu	okota	Case
aerobičkom	aerobička	Case
nekropolom	nekropoli	Case
iskvareni	iskvarene	Gender
rudničkim	zaključnim	lemma
azilom	azilima	Number
račići	račićima	Case
namačimo	namačite	Person
bijeljena	bijelila	Voice
razdeljivima	razdeljive	Case
ribare	ribarima	Case
podnožja	podnožje	Number
koracasmo	zadrijemasmo	lemma
kontejnere	kontejnera	Case
lakoma	vunasta	lemma
omalovažio	omalovažen	Voice
bespovratna	bespovratnima	Case
dopunjavate	dopunjavaš	Person
izlučen	izlučio	Voice
krèvet	kreveti	Number
sredio	sređen	Voice
ozlijeđeni	crvenokosi	lemma
presade	presadi	Person
ljestvicom	ljestvicu	Case
krmeća	bezbožnička	lemma
istrijebite	smičite	lemma
ugrožavani	ugrožavali	Voice
tiskali	tiskani	Voice
zaoravane	zaoravale	Voice
opijum	opijumu	Case
uhapšene	uhapsile	Voice
okvir	okviri	Number
uvježbavaju	uvježbavate	Person
kandidira	diktira	lemma
pojačale	pojačane	Voice
krivudavima	spojenima	lemma
najprominentnija	najdraža	lemma
uzimasmo	uzimaše	Person
liječene	liječena	Number
otelo	oteto	Voice
nikaragvanski	tematski	lemma
antiimperijalizam	antiimperijalizmom	Case
iznenadne	spekulativne	lemma
izjednačilo	izjednačeno	Voice
izlažete	izlažemo	Person
doktore	doktor	Case
namještaja	namještajem	Case
kravu	krava	Case
zaposlila	zaposlili	Gender
publicirali	publicirala	Gender
geometrijske	geometrijski	Gender
najmoćniju	najspljošteniju	lemma
onemogućila	onemogućena	Voice
kromanjónac	sinonimija	lemma
teren	terene	Case
telegrafa	telegrafu	Case
želelo	želela	Gender
nabrusite	nabrusimo	Person
onemogućeni	onemogućena	Gender
ventilacije	ventilacija	Number
tvorila	tvorilo	Gender
faraonu	faraone	Case
križevačko	telegrafsko	lemma
haićanski	žablji	lemma
intenzivnijemu	vrsnijemu	lemma
dostizana	dostizala	Voice
zlostavljani	zlostavljali	Voice
pozivali	pozivala	Gender
začuđujete	začuđujem	Person
industrijom	industrijama	Number
dočaravale	dočaravala	Gender
obrnuto	prožimano	lemma
crnogorski	crnogorskoga	Case
odbio	odbilo	Gender
crvotočine	crvotočina	Number
vata	vate	Case
jurcan	jurcani	Number
najkomotnijih	najspiritualnijih	lemma
obilna	cijela	lemma
abdicirala	abdicirao	Gender
piščevu	piščeva	Case
hotele	hotelu	Case
meteorologu	meteorolozima	Number
podsjetili	podsjetila	Gender
bivala	bivali	Gender
čojstva	čȏjstāvā	Number
orlovsku	špansku	lemma
lipovu	lipovoj	Gender
napredovala	napredovalo	Gender
ropstvom	ropstvu	Case
mršav	bedast	lemma
djetla	djetlom	Case
pjesne	pjȅsānā	Number
spirituálnōst	spiritualnosti	Case
košuljarima	košuljaru	Number
probala	uklanjala	lemma
žela	žeta	Voice
miševi	miševe	Case
lomna	dragocjena	lemma
napinjani	napinjali	Voice
najkrakatijima	najegoističnijima	lemma
sablažnjeni	sablaznili	Voice
dolara	dolaru	Case
priljubljivala	priljubljivali	Gender
oblo	stvarno	lemma
sipama	sipom	Number
pragmatiku	pragmatici	Case
multilateralnim	aktivnim	lemma
uvećalo	uvećano	Voice
podnijeli	podneseni	Voice
stijena	stijene	Number
agnòstičārkā	bȅlīlā	lemma
najpovoljnije	najverojatnije	lemma
zavele	zavela	Gender
uvenule	uvenuli	Gender
krumpirove	krumpirova	Gender
kupujem	kupuju	Person
prijepisi	prijepise	Number
pojavile	pojavila	Number
ukazuju	ukazuje	Number
pojednostavljen	pojednostavljeno	Gender
najrezistentnije	najslaboumnije	lemma
barčicu	barčice	Case
premijerima	premijera	Case
munjevitima	sistematičnima	lemma
iskorenih	iskorenismo	Number
popravi	šepaj	lemma
štrajhere	štrajhera	Number
pridružila	pridružena	Voice
ginekologije	ginekologiji	Case
zaustavljena	zaustavila	Voice
imaginativnima	svakojakima	lemma
osobitima	osobitomu	Number
integracije	bljeska	lemma
šibu	šibovima	Number
pokvarila	pokvarilo	Gender
skrbila	skrbili	Gender
kontemplaciji	kontemplacije	Case
isplivana	isplivane	Gender
parlamentarnima	gorostasnima	lemma
ukrašavane	ukrašavana	Gender
pojedince	pojedincima	Case
katastrofalnim	svirepim	lemma
platnu	platnima	Number
predvidele	predvideli	Gender
torlačkih	torlačkoga	Number
gospone	gospona	Number
drogama	drogom	Number
rasipavaš	rasipavate	Person
odlasku	odlaskom	Case
nekrstom	nekrstu	Case
promijenio	promijenjen	Voice
privukla	privukao	Gender
mašinama	mašine	Case
gruzijski	turkijski	lemma
spahijama	spahiji	Number
smokve	smokvama	Case
pozitivni	zreli	lemma
mandarinske	uraganske	lemma
glasa	glasova	Number
krčaže	krčagu	Case
izborili	izboreni	Voice
ukraden	ukrao	Voice
izgarate	snebivate	lemma
osećala	osećao	Gender
nadmoćnima	prkosnima	lemma
izumljen	izumljeno	Gender
vjeren	vjerio	Voice
šleperu	šleperi	Number
proterane	proterale	Voice
pritvaralo	pritvarala	Gender
neiskusnima	receptivnima	lemma
ćumurdžiju	ćumurdžijo	Case
preokrenete	preokreneš	Person
aristokracijama	aristokraciji	Number
instruktori	instruktore	Case
osječko	osječka	Number
giljotinirasmo	giljotinirah	Person
dopustile	dopustila	Number
kruta	emotivna	lemma
zadani	zadali	Voice
osramoćivala	osramoćivalo	Gender
rvah	rvaše	Person
humkom	humcima	Number
pisana	pisan	Gender
kidnapirasmo	crknuli	lemma
ubacite	ubacimo	Person
slàvīć	slaviću	Case
objašnjivoga	radozaloga	lemma
iscurim	iscuriš	Person
šalteru	šalter	Case
iznerviraše	bistrahu	lemma
jinizmima	jinizmom	Number
postarija	seizmološka	lemma
pravljena	pravljen	Gender
spašavali	spašavani	Voice
ispravna	akustična	lemma
književnika	književnike	Number
nadgledao	nadgledan	Voice
koegzistencije	stavove	lemma
povezivale	povezivane	Voice
predvodničkomu	srednjovekovnomu	lemma
zidni	терминолошки	lemma
zatoči	zatočiste	Person
trokutima	trokutu	Number
skratimo	skratiš	Person
sačinjene	sačinile	Voice
popustljiva	suptilna	lemma
otuđi	dezertira	lemma
vune	vuni	Case
bližih	najbližih	Comparison
mirisna	važna	lemma
savješću	savjest	Case
aktivistima	aktivisti	Case
naivnih	pustih	lemma
obujmiše	obujmih	Person
kontinuirani	šuplji	lemma
uklete	ukleti	Gender
kupoli	kupole	Case
izvođeno	izvodilo	Voice
kòdeks	kodeksom	Case
nesebičnijih	besramnijih	lemma
poželjela	poželjeli	Gender
nemaštovitima	anonimnima	lemma
srbijanskoga	srbijanskim	Case
pijanijoj	besposlenijoj	lemma
lučnima	veslačkima	lemma
najotrovnija	najdrskija	lemma
hermetička	talmudska	lemma
otopljeni	otopili	Voice
pričan	pričao	Voice
intrigantnima	suvislima	lemma
kroćaše	kroćahu	Person
isključimo	isključi	Person
mlad	cilindričan	lemma
razdvojila	razdvojile	Gender
seksa	seks	Case
modni	modna	Gender
baci	bacite	Person
oporavljala	oporavljali	Gender
највиши	виши	Comparison
pretučena	pretučen	Gender
razgaljivale	razgaljivala	Gender
odbranile	odbranili	Gender
obrednih	teoloških	lemma
povećanja	povećanje	Case
klisura	klisure	Case
raskinuto	raskinulo	Voice
balkona	balkonima	Case
posrednicima	posrednici	Case
pritisnu	pritisnuste	Person
ukrasilo	ukrašeno	Voice
uspomena	uspomeni	Case
uspavala	uspavana	Voice
hotelskom	transformacijskom	lemma
začinjana	začinjala	Voice
narednici	narednicima	Case
svrdlo	svȑdlo	Case
izviđali	izviđala	Gender
držite	drži	Person
delovalo	delovala	Number
preporučeno	preporučena	Gender
igralištima	igralištu	Number
izuzimali	izuzimani	Voice
kivni	gluhi	lemma
medijska	medijskoj	Case
upotrebile	upotrebljene	Voice
istaknutima	asimetričnima	lemma
rasa	rase	Case
raselila	raselili	Gender
pjesmu	pjesme	Number
žitelja	žitelj	Case
nadoknadi	nadoknade	Person
ponudili	ponuđeni	Voice
ponavljali	ponavljani	Voice
zvonicima	zvonikom	Number
neobrađeno	statično	lemma
neotuđivo	žedno	lemma
sekirom	sekiru	Case
istraživačkomu	fakinskomu	lemma
mehaničkomu	seoskomu	lemma
zasjedanje	zasjedanja	Number
svezana	svezano	Gender
tretirala	tretirao	Gender
kratici	kratice	Case
preštampavaste	preštampavaše	Person
istrijebljena	istrijebljeno	Gender
najobilnijima	najsumnjivijima	lemma
naručena	naručen	Gender
useljena	useljeno	Number
sumnjičaste	sumnjičasmo	Person
propisala	propisana	Voice
moskovskih	goveđih	lemma
mikroskopskoj	divovskoj	lemma
trenutku	trenutka	Case
potpredsednica	potpredsednice	Number
ministarstvu	ministarstvima	Number
slavili	slavio	Number
mitska	aneksiona	lemma
zbijah	zbijaše	Person
raskinuta	raskinula	Voice
najpaničnijemu	najzaboravnijemu	lemma
uzburkana	uzburkala	Voice
osvećivaše	osvećivasmo	Person
neprimjetljiva	svojstvena	lemma
identični	brutalni	lemma
brakove	brakovi	Case
simulacije	simulacijama	Case
prezalogajivano	prezalogajivan	Gender
nasilniji	znojniji	lemma
ostvarivao	ostvarivalo	Gender
klasna	bjeloruska	lemma
lokvánja	lokvanja	Number
diktatorice	diktatorica	Number
raspodjele	raspodjela	Number
albanizirana	albaniziran	Gender
povrtni	siječanjski	lemma
koketna	verižasta	lemma
umišljale	umišljala	Gender
miris	mirise	Case
medvjedi	mèdvjed	Number
spomenike	spomenika	Case
ukras	ukrasu	Case
obujmljivale	obujmljivane	Voice
godove	godovima	Case
štedionicama	štedionice	Case
odjeća	odjeće	Number
planerima	planeri	Case
lovištima	lovišta	Case
bežala	bežalo	Gender
zastavi	zastavama	Number
jasni	energični	lemma
smiren	smireno	Gender
vjenčićima	vjenčiću	Number
priračunala	priračunalo	Gender
portugalski	autonomistički	lemma
napisana	napisala	Voice
najponosnijemu	najsposobnijemu	lemma
prismotre	prismotru	Case
zacementirao	zacementiralo	Gender
izmišljotina	izmišljotini	Case
crkvu	crkve	Number
staraca	starcima	Case
dobiva	dobivaju	Person
nezaboravna	suzna	lemma
opisalo	opisano	Voice
pomešala	pomešao	Gender
kišobranara	kišobranaru	Case
prefektu	prefektom	Case
pridruženo	pridružilo	Voice
konverzije	konverzija	Number
skupštinarkom	skupštinarku	Case
ljudskijima	ekskluzivnijima	lemma
razmenio	razmenjen	Voice
prijemčivijih	svežijih	lemma
angiologijom	angiologiji	Case
pite	pitu	Number
acetatima	acetáti	Case
vulkanske	vulkanskoga	Gender
prorađivao	prorađivalo	Gender
kazivano	kazivalo	Voice
povest	povesti	Number
isplivalo	isplivala	Gender
razuvjereno	razuvjerilo	Voice
torbama	torbi	Number
aspìrīn	aspirin	Case
ojačavao	ojačavali	Number
odvajano	odvajalo	Voice
krijumčarila	krijumčarena	Voice
simulacije	simulacija	Number
žuči	žučima	Number
robotičkima	atletskima	lemma
odlomku	odlomak	Case
ptičje	sicilijanske	lemma
onečišćuješ	onečišćujete	Person
slutnje	slutnja	Number
repertoara	repertoare	Case
sendviča	sendvičima	Case
obalni	obalno	Gender
nadogradim	nadogradite	Person
diskreditirasmo	diskreditirah	Person
oštetile	oštetila	Number
presečene	zaoravane	lemma
građevincima	Bosankama	lemma
korisnijemu	bestijalnijemu	lemma
pruska	pruski	Gender
uvršteni	uvrštena	Gender
preziru	prezire	Person
orkestraciji	orkestracijom	Case
isušena	isušila	Voice
zalevano	zalevalo	Voice
termosfere	termosfera	Number
vojvodstvom	vojvodstva	Case
uručeno	uručena	Gender
kozmička	akadska	lemma
naterale	naterali	Gender
kestenjasta	sadržana	lemma
rukovoditeljska	vjerenička	lemma
kestenjaste	djeljive	lemma
primerenu	bezličnu	lemma
prepoznale	prepoznali	Gender
otpuštene	otpuštena	Gender
најстраственији	страственији	Comparison
pozvalo	pozvao	Gender
ćeliju	ćelije	Number
toplomerom	toplomeru	Case
popušene	popušeni	Gender
velikodušnom	velikodušnim	Gender
impotenciju	impotencije	Number
bečite	bečimo	Person
opisivali	opisivala	Gender
medijanu	medijan	Case
mortalìtēt	mortaliteti	Number
vencu	vencima	Number
ocjenjujte	umijte	lemma
pokvarenim	glomaznim	lemma
nesimetričnima	trpkima	lemma
znojava	znojave	Gender
nagnut	nagnuo	Voice
perspektivnim	bitnim	lemma
goda	godova	Number
etiketa	etikete	Number
roštilji	roštiljima	Case
impedancija	transgresija	lemma
bacahu	bacasmo	Person
gustine	salitre	lemma
poroznu	glinenu	lemma
kolosalni	sigurni	lemma
okruženo	okružena	Gender
najplašljivijega	plašljivijega	Comparison
volumen	volumeni	Number
izvađena	izvadila	Voice
hteli	htela	Gender
zadivljen	zadivljeno	Gender
gitara	gitarama	Case
metalurgiji	metalurgijom	Case
patološkima	dosadanjiima	lemma
glupanu	glupane	Case
protjerao	protjeran	Voice
prepilila	prepilili	Gender
rabljeni	rabili	Voice
zapisima	zapisu	Number
estetizmima	estetizama	Case
iznenadna	žgoljava	lemma
nahranjena	nahranila	Voice
nadrealizmu	nadrealizmom	Case
nabacila	nabačena	Voice
krkljancima	krkljanci	Case
provaljen	provalio	Voice
dinstate	dinstaju	Person
најбљутавији	бљутавији	Comparison
plovna	vrijedna	lemma
rascjepljivana	rascjepljivane	Gender
bratstvo	bratstva	Number
zaustavljaju	zaustavljate	Person
opsednute	opsednuta	Gender
krčko	vulkansko	lemma
neseni	nesena	Gender
mirisima	mirisi	Case
izišla	zanimala	lemma
špilovima	špilom	Number
krajnjih	školskih	lemma
ponavljano	ponavljalo	Voice
krajnosti	krajnost	Number
bacačici	bacačicama	Number
napravila	napravile	Gender
marni	uvozni	lemma
nagnute	nagnuti	Gender
projektile	vjeverice	lemma
zamkama	zamke	Case
zevala	zevao	Gender
numeričkih	dijagnostičkih	lemma
izražene	izraženi	Gender
personalni	egzistencijalni	lemma
usavršivan	usavršivana	Gender
žaru	žarovima	Number
podučila	podučena	Voice
popunjen	popunio	Voice
procijenio	procijenila	Gender
laički	laičke	Case
pokazuje	pokazuju	Number
staležima	staležu	Number
sultana	sultane	Case
karizmatična	antropomorfna	lemma
bilancama	bìlāncā	Case
pobeđivano	pobeđivan	Gender
korena	koreni	Gender
prikriveno	prikrilo	Voice
nanerviraste	nanervirasmo	Person
hrabrijih	besplodnijih	lemma
zločina	zločini	Case
povređena	povredila	Voice
pokvaren	pokvareno	Gender
najneprirodnijima	najsmješnijima	lemma
poznati	poznali	Voice
uhapsile	uhapsila	Gender
transkripcije	transkripcijo	Number
okolnim	turističkim	lemma
stvorili	stvorile	Gender
identitete	identiteti	Case
cvrkućem	cvrkućete	Person
spustim	spustite	Person
osiromašena	osiromašeno	Gender
razbistren	razbistrena	Gender
materinima	sestrinima	lemma
posađivano	zbijano	lemma
genom	genome	Number
razgrizan	razgrizana	Gender
prodirala	prodiralo	Gender
isticao	istican	Voice
košarka	košarkom	Case
izbijeni	izbili	Voice
sjedinjavamo	sjedinjavate	Person
posadi	posadiš	Person
najsvesnijima	svesnijima	Comparison
tjestenina	tjestenini	Case
tečnost	tečnošću	Case
lili	lila	Gender
povjerova	zalažaše	lemma
zgrejavale	zgrejavane	Voice
krčili	krčila	Gender
pedofili	pedòfīl	Number
gledali	gledala	Gender
interesantne	shvatljive	lemma
pozva	sjedini	lemma
posredovana	posredovala	Voice
stajalište	stajališta	Number
popraćen	popraćena	Gender
pasivnim	provokativnim	lemma
hajala	hajao	Gender
telesnu	telesnoj	Case
novosadskoj	novosadskomu	Gender
krstarice	krstaricom	Case
ulov	ulovu	Case
zarudje	zarudjeste	Person
astrologije	astrologiju	Case
nasljednica	nasljednici	Case
žanr	žanrove	Number
podnijele	podnijela	Gender
statutom	statutima	Number
falusa	falus	Case
špinate	špinatom	Case
kronologiju	kronologijom	Case
hvaljeni	hvaljena	Gender
trgove	trg	Number
lažnu	venoznu	lemma
matrijarhalnom	autonomaškom	lemma
oslonile	oslonila	Gender
školovaše	školovahu	Number
opcije	opcija	Number
predala	uklanjala	lemma
kaznena	kazneni	Gender
štemovan	štemovao	Voice
tigrova	tigra	Number
kovertirah	alternirah	lemma
stečaj	stečaju	Case
ubacio	ubacili	Number
ukinuo	ukinulo	Gender
prokopavani	prokopavana	Gender
odbojkašima	odbojkašu	Number
pitani	pitali	Voice
implikacije	implikacijama	Case
južine	južinu	Number
separiram	separirate	Person
nagradi	nagrade	Person
etikete	etiketa	Case
odu	odemo	Person
lončarstva	lončarstvu	Case
sarađivala	sarađivali	Gender
prijemčivijemu	bezbolnijemu	lemma
dokumentaciji	dokumentaciju	Case
kraljicu	kraljico	Case
vaginom	vaginama	Number
lupala	lupao	Gender
nepismenost	ekleziologiju	lemma
širene	širile	Voice
predgrađu	stazi	lemma
најмрчи	мрчи	Comparison
upaljen	upalio	Voice
faksiraste	faksirahu	Person
mirise	miris	Number
uvećala	uvećana	Voice
laganu	trojaku	lemma
obijesnima	svetogrdnima	lemma
obiđemo	obiđeš	Person
rȍga	rògōvā	Number
stjecali	stjecani	Voice
medijsko	analitičko	lemma
obruče	obruči	Case
sluškinju	sluškinji	Case
pečeni	uvjetni	lemma
zagrađivana	zagrađivala	Voice
plesnivo	animalno	lemma
saharína	saharinu	Case
namještaju	namještaja	Case
vrapče	vrapci	Number
proždrta	proždrla	Voice
smjera	smjȇr	Case
napisale	napisali	Gender
obitavale	obitavali	Gender
izgrebla	izgrebli	Gender
uračunali	uračunati	Voice
vapiš	vapite	Person
intelektualca	intelektualče	Case
katolicizma	katolicizmu	Case
imaginativnijemu	glavatijemu	lemma
rupijo	rupiju	Case
ekonomska	ekonomsko	Gender
istraživačka	ekonomska	lemma
prsatije	strastvenije	lemma
kambodžanski	terminološki	lemma
postiglo	postigla	Gender
svrhe	svrhu	Number
predstavi	predstavama	Number
izbušili	izbušile	Gender
općini	općinama	Number
asimetrije	asimetrija	Case
đumruka	đumruci	Case
posedovaše	posedovaste	Person
zamenjujte	zamenjuj	Person
kozmopolitskih	balističkih	lemma
napadalo	napadano	Voice
izuzeta	izuzeto	Gender
kambodžanska	erotska	lemma
ispitane	ispitani	Gender
pokidalo	zalutalo	lemma
namjeri	namjerom	Case
gotice	gotica	Case
ulizivala	ulizivali	Gender
karnevalskih	železničkih	lemma
mlohava	vrana	lemma
izvadio	izvadilo	Gender
štucaste	štucasmo	Person
odlučilo	odlučio	Gender
modifikacijama	modifikaciji	Number
udahnuli	udahnuti	Voice
izbjeglice	izbjeglica	Number
makadamskoga	transportnoga	lemma
pamćeno	pamtilo	Voice
krivilo	krivljeno	Voice
potkovice	čestice	lemma
distribucije	distribuciji	Case
zaklon	zakloni	Number
atom	atome	Number
primetna	druželjubiva	lemma
podgrizate	podgrizaju	Person
presudna	varvarska	lemma
pobornika	poborniče	Case
profiti	profitima	Case
pribranih	skromnih	lemma
zagrađivana	zagrađivani	Gender
naglasile	naglasila	Gender
okrvavile	okrvavila	Gender
pačja	teroristička	lemma
pripreme	pripremi	Case
opreme	opremi	Person
opterećuju	ugriju	lemma
kovčežino	kovčežina	Case
uticala	uticale	Number
nostalgično	strpljivo	lemma
presečeš	presečemo	Person
zamka	zamke	Number
uklonjen	uklonio	Voice
nadopunjavana	nadopunjavan	Gender
nazivajte	nazivaj	Person
filtre	filtri	Case
nabavljala	nabavljalo	Gender
popravljalo	popravljala	Number
ledniji	alarmantniji	lemma
uvećalo	uvećala	Gender
planinaru	planinara	Case
izvlačile	izvlačili	Gender
pogođeni	pogođena	Gender
nepopustljivima	učinkovitima	lemma
najprihvatljivijima	najprihvatljivijemu	Number
navodile	navođene	Voice
zadane	zadale	Voice
obavještavalo	svlačilo	lemma
šećeru	šećerima	Number
suprotstavila	suprotstavio	Gender
naseljenu	strmu	lemma
nevjernim	bijesnim	lemma
razglasila	razglasili	Gender
šapnu	šapnemo	Person
sužanjstva	sužanjstvo	Case
plebejskima	ženskima	lemma
pȅrīkā	perike	Case
akordom	akorda	Case
nadvisivane	nadvisivale	Voice
imigracije	imigracija	Case
kretnje	kretnju	Case
sabijane	sabijale	Voice
ovoliko	večito	lemma
udrugu	udrugom	Case
polaskao	polaskala	Gender
intenzivne	cjelovite	lemma
uverila	uverena	Voice
propiste	propi	Number
presvlačilo	presvlačio	Gender
heksametru	heksametrima	Number
kremaljski	taktički	lemma
nepoštenije	samobitnije	lemma
vraćale	vraćala	Gender
zamijenio	zamijenjen	Voice
brazde	brazda	Number
kameri	kamere	Case
најпробављивији	пробављивији	Comparison
naslijedila	naslijedile	Gender
biòlog	biologom	Case
zbrisali	zbrisani	Voice
bojeni	bojili	Voice
sastoji	sastoje	Number
obavijestio	obavijestila	Gender
skrnave	skrnavimo	Person
adekvatnih	suhih	lemma
nasmešite	nasmeši	Person
učvršćeno	učvrstilo	Voice
ofenzive	ofenzivu	Number
inspekcijsko	skeptičko	lemma
opterećene	opterećeni	Gender
natpisom	natpis	Case
razvile	razvijene	Voice
pobegnemo	pobegneš	Person
ličinku	ličinke	Case
sudimo	sudi	Person
ukradena	ukrala	Voice
krčmarili	krčmarile	Gender
podnesena	podneseno	Gender
dirigentima	dirigentu	Number
problematičnije	slavnije	lemma
labirintom	labirint	Case
najlicemernija	najanarhističkija	lemma
promicala	promicali	Gender
lemalo	lemano	Voice
pojasom	pojasevima	Number
podijelila	podijelio	Gender
posredovahu	posredovaste	Person
čekao	čekalo	Gender
predatore	predatora	Case
mistične	rječite	lemma
najparadoksalnijima	najzvučnijima	lemma
haubice	haubicu	Number
omotali	omotani	Voice
uspehu	uspesima	Number
klizače	klizača	Number
svetište	svetištu	Case
moćniče	moćnici	Number
zamrženo	zamrzilo	Voice
pokvarila	pokvario	Gender
premlaćeno	premlatilo	Voice
zobenu	zobena	Case
zahvate	zahvati	Person
mačke	mačku	Number
kričko	krička	Number
pripisala	pripisali	Gender
parlamentarnih	bezuspešnih	lemma
otmičare	otmičari	Case
mleveni	animirani	lemma
pregovora	pregovore	Case
vrhunac	vrhunce	Number
podnaslovi	podnaslov	Number
homoseksualni	aromatični	lemma
pametaru	pametara	Case
nauci	nauke	Case
veštačile	veštačene	Voice
osuđivane	osuđivana	Gender
provodim	provodite	Person
pozorišta	pozorište	Number
pravnica	pravnice	Number
pogrešne	željezne	lemma
omotača	bombonjera	lemma
rušile	rušila	Number
roditeljska	demonska	lemma
naraštaji	naraštaju	Number
naukom	naukama	Number
tipograf	tipografom	Case
rimom	rimama	Number
preliminarni	preliminarna	Gender
komoriaka	komorike	Number
poželjni	užasni	lemma
melodioznijima	frenetičnijima	lemma
guštera	gušteri	Case
tjedan	tjedne	Number
olimpìzam	olimpizmom	Case
raseliš	raselim	Person
maknuli	sustigli	lemma
pačjim	autsajderskim	lemma
potencijalima	potencijalom	Number
najplašljivijih	najbizarnijih	lemma
optužbu	optužbi	Case
proreklo	prorečeno	Voice
žeđam	žeđate	Person
kristijaniziram	kristijanizira	Person
izbjegavasmo	izbjegavah	Person
provokaciji	provokacijom	Case
metempsihozi	metempsihozom	Case
legurama	legurom	Number
obasjavani	suzdržavani	lemma
sukoba	sukob	Case
najnemilosrdnijima	najsarkastičnijima	lemma
grđahu	slizaše	lemma
atlantska	atlantske	Gender
zgrušala	zgrušali	Gender
urotnikom	ùrotnīče	Case
pozivani	pozivali	Voice
hipohondrom	hipohòndra	Case
mitološkim	zoološkim	lemma
neprimjetnima	rasipnima	lemma
podvaljena	podvalila	Voice
svetlosti	svetlošću	Case
runo	runa	Number
izvesne	različite	lemma
čȗvstāvā	čuvstva	Case
lemana	leman	Gender
izdvoje	globe	lemma
doseljenici	doseljenica	Case
gnječili	gnječila	Gender
transliteraciju	transliteracijom	Case
ludo	trezveno	lemma
masa	mase	Case
izmišljeni	izmislili	Voice
trúnka	trunku	Case
srednji	srednja	Gender
ugrađeni	ugradili	Voice
primoravale	primoravane	Voice
operativnu	ružnu	lemma
primercima	primerku	Number
domoljube	domoljuba	Number
napučismo	napučih	Person
pepeljastih	ruralnih	lemma
prihvaćale	prihvaćane	Voice
mnogoljudnoj	fundamentalnoj	lemma
izlizivah	izlizivahu	Person
šljapnuo	šljapnut	Voice
dragstor	dragstorom	Case
čuđenje	čuđenju	Case
organizatora	organizator	Case
zatočeništvo	zatočeništvu	Case
uznemirila	uznemirilo	Gender
stanovale	stanovali	Gender
napravila	napravili	Gender
kratersko	kraterska	Number
nagoviješten	nagoviješteno	Gender
ljutima	uverenima	lemma
isplata	isplati	Case
granje	granja	Number
metričke	bengalske	lemma
zagađivala	zagađivale	Number
zbrajala	zbrajalo	Gender
polijetaše	zablista	lemma
zidarima	zidaru	Number
asovi	as	Number
upada	upadam	Person
stiže	stižu	Person
infantilna	šašava	lemma
patrijaršijskima	baskijskima	lemma
uvršten	uvršteno	Gender
ožive	oživi	Person
konvencionalnije	vetrovitije	lemma
jugoslavenskoga	domaćega	lemma
procuri	procurismo	Person
netačnu	znojavu	lemma
rođenje	ekumenìzam	lemma
poslužimo	poslužiš	Person
ulazna	ulazni	Gender
најискричавији	искричавији	Comparison
ubojice	ubojicama	Case
rastvori	rastvorih	Person
mezopotamskima	samačkima	lemma
naseljena	naselila	Voice
trenirao	treniralo	Gender
općenitijima	elegantnijima	lemma
pozdravi	pozdravite	Person
objedinjavalo	slomilo	lemma
ojačavate	ojačavaš	Person
šnjofalo	šnjofala	Number
zasjedi	zasjedama	Number
doprinelo	doprinela	Gender
žiteljima	žitelja	Case
zadirkivano	zadirkivalo	Voice
organizmu	organizme	Case
najhuđemu	najvjerodostojnijemu	lemma
odjevena	odjevene	Gender
rastanak	rastanke	Number
intrige	intriga	Case
griješno	rješivo	lemma
zovi	zove	Case
krticu	krtice	Number
koturaško	beskućničko	lemma
poprečni	tekstualni	lemma
rupturama	rupture	Case
prestrašeni	prestrašena	Gender
iskusne	prominentne	lemma
mirili	mireni	Voice
pozne	glupe	lemma
autoceste	autocesti	Case
menoreji	menorejo	Case
odzvanjaše	tračaše	lemma
snebio	snebiven	Voice
platinske	šleske	lemma
otvorena	otvorila	Voice
smežurao	smežurala	Gender
најпрофињенији	профињенији	Comparison
dizala	dizale	Number
silvanac	silvanče	Case
najavila	najavljena	Voice
šutjela	šutio	Gender
suptilni	suptilna	Gender
morfologijom	morfologiji	Case
utopila	utopili	Gender
naredne	teutonske	lemma
vazduha	vazduhom	Case
izmišljotine	izmišljotina	Number
nakosivale	nakosivali	Gender
obratima	obrate	Case
pravcu	pravcima	Number
slabokrvnosti	slabokŕvnosti	Case
tipografija	tipografiju	Case
utopljeno	utopilo	Voice
lelekasmo	skijasmo	lemma
odlikovanje	odlikovanja	Number
pokvarili	pokvareni	Voice
najmatorijemu	najsirovijemu	lemma
rešena	rešeni	Gender
pridošlice	železnice	lemma
himnom	himnama	Number
istokrvni	rapidni	lemma
cičale	cičala	Gender
koridóra	koridorom	Case
unakažena	unakazila	Voice
prašnjavu	prašnjavoj	Gender
uočila	uočili	Gender
nošeni	nosili	Voice
čuči	čučite	Person
pregrejana	pregrejala	Voice
impresionira	tegli	lemma
najindisponiranijih	najuverenijih	lemma
apetitom	apetitima	Number
kontaminaciji	kontaminacijama	Number
plaćala	plaćale	Gender
šemom	šeme	Case
neprodane	šupljikave	lemma
jednostranima	tačnima	lemma
smetala	smetana	Voice
mahunama	mahune	Case
hotele	hotela	Case
statistiku	statistike	Number
proćerdavah	proćerdavasmo	Person
raširimo	raširi	Person
beogradska	beogradskoj	Case
plasiraste	drhtali	lemma
organizirali	organizirao	Number
zapušten	zapuštena	Gender
televizorima	televizori	Case
nekomercijalni	nekomercijalne	Gender
obnovu	obnovom	Case
razdobljima	razdobljem	Number
izveštaja	izveštaju	Case
križići	križiću	Number
raščlani	raščlane	Person
namljesmo	namlje	Person
najnatmurenijima	najtužnijima	lemma
ponosito	bezuvjetno	lemma
naivčinom	naívčina	Case
slušani	slušali	Voice
ponizi	usmeri	lemma
plinovitih	cijelih	lemma
provera	provere	Case
mamuti	mamut	Number
iskustvenome	iskustvenoj	Gender
računovođom	računovođama	Number
kaligrafijom	kaligrafiju	Case
jadranski	jadranska	Gender
ukopali	ukopani	Voice
izrazu	izrazima	Number
snage	snagu	Case
sluge	slúga	Case
izvršilo	izvršeno	Voice
kurjake	kurjacima	Case
neefikasno	zrcalno	lemma
otpilim	otpilimo	Number
hvalisaviju	anakronističniju	lemma
bizona	bizonu	Case
plafona	plafone	Case
izvlačila	izvlačile	Number
golicani	golicane	Gender
kante	kántā	Case
konopcima	konopcu	Number
prozodijsku	prozodijska	Case
kambodžanski	automobilski	lemma
nenavidjeli	nenavidjela	Gender
zločine	zločina	Case
pomilovan	pomilovao	Voice
batinani	batinali	Voice
platile	plaćene	Voice
oporavio	oporavilo	Gender
preračunavalo	preračunavala	Gender
usidrili	usidrio	Number
pčelice	udoline	lemma
čizme	čȉzāmā	Case
okršaj	okršaja	Case
jugoistočno	škotsko	lemma
limu	limovima	Number
finskih	finskoga	Number
kirurškom	kirurškim	Gender
prosvjedovahu	vjenčahu	lemma
dopisnike	dopisnika	Number
ugrozila	ugrožena	Voice
nadvladavan	nadvladavao	Voice
shvatila	shvatilo	Gender
odletjela	odletio	Gender
mekušna	zobena	lemma
mitskih	dotičnih	lemma
primjerenijima	zrnastijima	lemma
olakšali	olakšani	Voice
rosi	rosu	Case
vrćena	vrćene	Gender
mamicama	mamica	Case
rižama	riži	Number
kvantnima	dnevnima	lemma
krivotvorena	krivotvoren	Gender
indonezijsko	indonezijskim	Case
okrutnih	zluradih	lemma
nerešena	dokona	lemma
inženjerskih	inženjerska	Case
rastaju	rastajemo	Person
izbrisive	znakovite	lemma
karijera	karijerama	Case
pripremale	pripremane	Voice
poricali	poricale	Gender
prisegnuti	prisegnuli	Voice
progovaralo	progovarao	Gender
namamljena	namamljen	Gender
pivarski	pivarske	Gender
sasečeno	saseklo	Voice
koordinaciji	spoznaji	lemma
prkose	prkosa	Case
kalifu	kalife	Case
postelje	udaljenosti	lemma
najpribližnijih	najflegmatičnijih	lemma
bȗbā	bube	Number
prisustvovalo	prisustvovao	Gender
deranom	deranima	Number
milijuna	milijunima	Case
imaginarni	vječiti	lemma
privedena	privela	Voice
nabrojim	nabroji	Person
postizao	postizalo	Gender
brojaču	brojač	Case
vozarinu	vozarina	Case
zloupotrijebljeni	zloupotrijebili	Voice
potjere	potjerama	Case
blažilo	blaženo	Voice
penušave	učinkovite	lemma
klip	družinu	lemma
novorođenčetu	novorođenče	Case
kakva	progresivna	lemma
izdahnula	izdahnuo	Gender
ćeraste	ćerahu	Person
umetnut	umetnuto	Gender
oholija	čišća	lemma
kurdskim	kurdskom	Gender
ponuđene	ponudile	Voice
latinizacije	žarišta	lemma
agrarna	albanska	lemma
rezistentnija	bestidnija	lemma
infrastrukturna	statusna	lemma
prezirao	preziran	Voice
najnaglijima	najanakroničnijima	lemma
mirovina	mirovine	Case
aprilski	aprilsko	Gender
nepromenjeni	dosljedni	lemma
ozleđivahu	ozleđivaše	Person
iskopani	iskopane	Gender
sačinjavam	sačinjavaju	Person
šokirali	šokirale	Gender
salate	salatu	Number
razrađeno	razrađena	Gender
lunarna	razumna	lemma
izvodljivo	drveno	lemma
zaljubila	zaljubili	Gender
zaradi	zaradih	Person
uvođene	uvodile	Voice
pivskih	aklimatizacijskih	lemma
postavljate	postavlja	Person
normalizirao	normaliziralo	Gender
anilinskom	anilinsku	Case
slavi	slavite	Person
nepovjerljivija	romantičnija	lemma
studenoga	studeni	Case
ravnao	ravnala	Gender
ocijenjena	prozvana	lemma
neželjenijim	bolesnijim	lemma
pozdravljen	pozdravio	Voice
zabava	zabavama	Case
topolu	topole	Number
napore	napora	Case
autekologije	autekologiji	Case
knjigama	knjige	Case
nogometašu	smrtnosti	lemma
omogućivala	omogućivana	Voice
fonologija	fonologije	Number
најнаказнији	наказнији	Comparison
slutnje	slutnji	Case
maštovita	škrta	lemma
komodom	komodu	Case
kvislinške	bečke	lemma
kolosalna	prosječna	lemma
kričala	kričao	Gender
daktilografskih	daktilografskoga	Number
agresivnosti	egiptolozi	lemma
bogumile	bogumil	Case
činjeni	činili	Voice
kvalifikacije	kvalifikacija	Number
panteistički	макадамски	lemma
praznovernome	uverenome	lemma
krvoločnijima	vrednijima	lemma
članicama	članice	Case
krnice	krnicama	Case
најблажи	блажи	Comparison
kvrgu	kvrge	Number
pješaštvu	vrisku	lemma
sustavne	sustavnoj	Case
prešao	prijeđen	Voice
kardinali	kardinalima	Case
dekontaminacijama	dekontaminaciji	Number
zabranjivale	zabranjivane	Voice
nagovešćivani	zavlačeni	lemma
nejednakosti	nejednakost	Case
lišila	lišena	Voice
okupi	okupiš	Person
mjesečni	divljački	lemma
prostirale	prostirala	Number
pristajala	pristajali	Gender
jogo	jogom	Case
melankolična	diskretna	lemma
uspevale	uspevala	Gender
skandalizirali	skandalizirala	Gender
kršćanskom	kršćanskim	Gender
kruhoborca	kruhobórca	Case
kozmopolitizmi	kozmopolitizmima	Case
romanopisci	romanòpīsācā	Case
najkrvožednijim	najsklonijim	lemma
molim	molite	Person
sukobljeni	sukobljena	Gender
korbači	korbaču	Number
spomenula	spomenuta	Voice
najledenije	najbombastičnije	lemma
uvjerila	uvjerio	Gender
pulsu	vagi	lemma
sveučilištima	sveučilištu	Number
kozjetinama	kozjetini	Number
legitimna	uslužna	lemma
kraljevičkim	kraljevičko	Case
iregularni	trošni	lemma
nejednolika	gotivna	lemma
evakuacijom	evakuacija	Case
jadima	jadu	Number
preglednosti	vodomeru	lemma
supstanci	supstancu	Case
opčinjavan	opčinjavana	Gender
čamce	čamac	Number
razredbene	razredbenoga	Gender
kruta	sumanuta	lemma
proučavao	proučavan	Voice
stvarane	stvarale	Voice
pripremo	pripreme	Number
pobjegla	pobjegao	Gender
obradovali	obradovao	Number
groba	grobom	Case
odjeknula	odjeknuo	Gender
povrijedi	povrijedih	Person
odsiječete	odsiječe	Person
zaslužilo	zasluženo	Voice
uključen	uključeni	Number
preradila	prerađena	Voice
pripadnik	pripadniku	Case
prominentnijima	sputanijima	lemma
poverljiva	aktivna	lemma
komuniciraste	transformiraste	lemma
redateljem	redatelju	Case
bacača	bacače	Case
frižiderima	frižideri	Case
nekomercijalni	tranzitivni	lemma
truda	trudova	Number
lekovito	stručno	lemma
počela	počeo	Gender
најегзактнији	егзактнији	Comparison
pretvorila	pretvorena	Voice
najavio	najavljen	Voice
aglomeratu	aglomerat	Case
izbadah	izbadasmo	Person
dopuštao	dopuštala	Gender
singlovima	singlom	Number
komodìtēt	komoditeti	Number
tuljane	tuljanima	Case
gramzivcima	gràmzīvci	Case
karizmatičnijih	zdravijih	lemma
beskorisne	beskorisnima	Case
ugljen	ugljena	Case
keramičkoj	salonskoj	lemma
milimetri	milimetrima	Case
nalikovala	nalikovalo	Gender
ozljeđivan	ozljeđivao	Voice
zatraženo	zatražilo	Voice
pučisti	pučiste	Number
odanije	suvlje	lemma
meridijani	meridijane	Number
jova	jove	Number
slavujima	slavuju	Number
koplje	koplja	Number
zoveš	zove	Person
imunizaciju	imunizacije	Number
ušica	ušicom	Case
bolničkih	bolnička	Case
konverzacije	konverzacija	Number
obožavaš	obožava	Person
direktorice	direktorica	Number
rezan	rezana	Gender
najnepodobnijima	najromantičnijima	lemma
procena	procene	Case
posredovala	posredovali	Gender
križevačke	svibanjske	lemma
neočekivanih	čuvenih	lemma
zagrejavala	zagrejavalo	Gender
smišljaju	smišljate	Person
kovala	kovana	Voice
propustilo	propušteno	Voice
lančane	ulazne	lemma
animirali	animirani	Voice
približavao	približavala	Gender
italskih	amaterskih	lemma
eklisiologije	eklisiologijama	Case
vetreušku	vetreuške	Number
tirkizove	tirkiza	Number
sagledavajmo	sagledavaj	Person
načiniš	načine	Person
posvećeno	posvećen	Gender
ovjerene	ovjerena	Gender
afganistanski	drukčiji	lemma
jurcalo	jurcano	Voice
robova	roba	Number
dostiže	dostigoše	Number
sabrani	sabrali	Voice
transgresija	transgresijo	Case
prikupljala	prikupljale	Gender
razaspe	razaspem	Person
ženidbu	ženidbi	Case
sporazumijevala	sporazumijevalo	Gender
sutlijaše	sutlijaši	Case
najprimetnijoj	najcelovitijoj	lemma
otkrilo	otkrio	Gender
trgovala	trgovao	Gender
otpravljaste	otpravljaše	Person
ugrožen	ugrožena	Gender
kopljima	koplju	Number
najmekša	najefektivnija	lemma
obećani	obećali	Voice
osjetilo	osjetio	Gender
čude	čudi	Person
отмјенији	најотмјенији	Comparison
tužiteljstva	tužiteljstvo	Case
grebe	grebete	Person
smislili	smislila	Gender
sipo	sipe	Case
hrastovina	hrastovine	Number
neprozirnima	bezvernima	lemma
takta	taktu	Case
gužva	gužve	Number
nagurano	nagurana	Gender
dȅdi	dȅdama	Number
prikazivano	prikazivalo	Voice
upisao	upisan	Voice
stvoreni	stvorene	Gender
minutu	minute	Number
imigrantima	složenicama	lemma
hipotetičnosti	hipotètičnōst	Case
blesni	blesnite	Person
porobih	porobismo	Person
halucinantne	venozne	lemma
rudarstvom	rudarstvo	Case
popunile	popunila	Number
smrzotina	smrzotine	Number
besplatnom	besplatnoj	Case
mravi	mrava	Case
prihoda	prihodom	Case
grobovima	grobova	Case
strahovala	strahovao	Gender
pomiješana	pomiješano	Gender
odjure	odjurimo	Person
satro	satrla	Gender
transportéra	transportera	Number
pravim	pravima	Number
pamučnu	religioznu	lemma
ustupi	ustupim	Person
kiselinu	tampon	lemma
posrkan	posrkao	Voice
susedima	susedom	Number
raskrštavalo	raskrštavao	Gender
povraćajte	sarađujte	lemma
stupcima	stupcu	Number
raspravila	raspravili	Gender
pasivnijega	sadržajnijega	lemma
krojasmo	krojaše	Person
pobjegle	pobjegla	Gender
pripremani	pripremane	Gender
tambure	tambura	Number
rudini	rudina	Case
ponovila	ponovljena	Voice
sukrivca	sukrivaca	Number
obilježila	obilježena	Voice
neukrotiva	neukrotivo	Number
neprimerenoj	anaerobnoj	lemma
iskopavaju	iskopavam	Person
obdario	raspustio	lemma
nagovore	nagovori	Person
zablejala	zablejali	Gender
mirisi	miris	Number
sabotiraste	baziraste	lemma
kazaljke	kazaljkama	Case
spremane	spremani	Gender
goli	gola	Gender
otpisani	usavršeni	lemma
pokazivana	pokazivala	Voice
rezale	rezali	Gender
obilatoga	ubojitoga	lemma
pive	pivo	Number
advokatska	vodeća	lemma
taksi	taksa	Case
latentnoj	razrešivoj	lemma
doštampah	doštampa	Person
onemogućavalo	onemogućavala	Gender
najplićom	najsolidarnijom	lemma
komentiraše	komentirasmo	Person
zauzdavam	zauzdava	Person
svadbe	svadbama	Case
zastupala	zastupao	Gender
zabrinuo	zabrinut	Voice
izbavio	izbavljen	Voice
primjenjivala	primjenjivana	Voice
nokautom	nokaut	Case
najkoketnije	najanimalnije	lemma
tamni	tamne	Person
ratnice	ratnicama	Case
zadavio	zadavljen	Voice
priljubljivale	priljubljivane	Voice
kriptičkima	kriptičkom	Number
nastradasmo	brinjasmo	lemma
listajmo	dozivljimo	lemma
neparni	atraktivni	lemma
katafora	kataforu	Case
brinuli	brinuo	Number
najkorenitije	najzahvalnije	lemma
izostanemo	izostanu	Person
rubricirasmo	alternirasmo	lemma
primetljivo	ambiciozno	lemma
smicani	smicali	Voice
opovrgavana	rasipana	lemma
masi	masa	Case
prevrtan	dunut	lemma
lješnjacima	garancijama	lemma
školovali	školovani	Voice
dodan	dodano	Gender
finansijskim	finansijsko	Case
saksofone	saksofon	Number
bači	bačih	Person
daktilografskoga	daktilografsko	Case
izražena	izrazila	Voice
obavještajna	džinovska	lemma
istupljena	istupila	Voice
maliciozni	zmijoliki	lemma
kristaličnih	fenomenalnih	lemma
најефемернији	ефемернији	Comparison
zakasnila	zakasnili	Gender
povrća	povrćem	Case
zavarana	zavarala	Voice
skraćivala	skraćivalo	Gender
mjeriš	mjeri	Person
krknuli	krknuti	Voice
puštani	puštali	Voice
paradoksalan	beskoristan	lemma
metijaste	metijaše	Person
žitnice	žitnica	Number
gróžđā	gróžđa	Case
mrzile	mrzili	Gender
najkolegijalniji	najfrivolniji	lemma
namnožavani	namnožavali	Voice
cijeljeni	cijeljene	Gender
neslužbena	elegantna	lemma
prevodimo	prevodite	Person
komunicirali	komunicirala	Gender
sokaka	sokaku	Case
pojmljivih	znatiželjnih	lemma
raznovrsnosti	raznovrsnost	Number
razrušena	razrušen	Gender
najkasniji	najsposobniji	lemma
eskimsko	eskimski	Gender
ribolovu	ribolov	Case
otpisivane	otpisivale	Voice
aktivirala	aktivirale	Gender
poslednjoj	dnevnoj	lemma
davao	davan	Voice
haljinama	haljini	Number
suđenja	suđenje	Number
neposredna	eminentna	lemma
otkinula	otkinuta	Voice
duvani	duvali	Voice
koračalo	koračao	Gender
bujnosti	bujnost	Case
ozbiljnijima	sputanijima	lemma
šljemahu	šljemaše	Person
sprezanja	sprezanje	Number
izrazi	izrazimo	Person
iskopala	iskopana	Voice
pornografije	pornografija	Case
svirale	sviralama	Case
subote	subotu	Number
jezičnima	jezičnih	Case
četama	četom	Number
gađali	gađani	Voice
pučinom	pučina	Case
neprimerene	dalekosežne	lemma
kročila	kročio	Gender
dijete	dijeta	Number
izvrši	izvršite	Number
izvozili	izvoženi	Voice
metodologiji	metodologija	Case
sveštenici	sveštenicima	Case
neistine	neistina	Number
vis	visove	Number
protivnijima	zloslutnijima	lemma
rukometnima	biljojedskima	lemma
vjerojatnosti	vjerojatnostima	Case
položili	položeni	Voice
pehari	peharu	Number
postale	postala	Gender
odradili	odrađeni	Voice
sȉsavac	sȉsāvci	Number
fokusirala	fokusiralo	Gender
uništiš	uništimo	Person
tvrđah	tvrđahu	Person
publicirah	publicira	Person
maštovitim	maštovitima	Number
odnijelo	odnio	Gender
најнеустрашивији	неустрашивији	Comparison
zaželjele	zaželjeli	Gender
neprijelaznima	stalnima	lemma
nenamjerne	slabe	lemma
најсрећнији	срећнији	Comparison
komentarima	komentaru	Number
spadalo	spadao	Gender
konstruktivnijim	smirenijim	lemma
zatvorenicama	zatvorenici	Number
razmirica	sojeva	lemma
neizbežnome	zlovoljnome	lemma
izbijala	izbijana	Voice
pritisnut	pritisnuo	Voice
neosporna	sirota	lemma
najkreativnijima	najtužnijima	lemma
reflektore	reflektor	Number
izabrana	izabrala	Voice
nagrćite	nagrći	Person
talijanske	talijanska	Gender
ljubitelji	ljubitelja	Case
grančicom	grančice	Case
razišla	razišli	Gender
osvežavana	osvežavala	Voice
ovlašćivalo	ovlašćivao	Gender
zamijenila	zamijenile	Gender
lukavijega	glasovitijega	lemma
zanimale	zanimali	Gender
homonimni	generalni	lemma
ojača	ojačate	Person
platnoj	zakonodavnoj	lemma
vodičima	vodiča	Case
najplesnivijega	najantipatičnijega	lemma
trpuci	trpucima	Case
izbečena	izbečeni	Gender
križánca	krìžānācā	Number
raspodelili	raspodelila	Gender
škripile	škripila	Gender
ontološki	sindski	lemma
vrsnoćom	vrsnoćo	Case
prvaci	prvacima	Case
tromesečjima	tromesečju	Number
noćnih	teleoloških	lemma
halabuci	halabuke	Case
uočiste	uoči	Number
petina	petino	Case
objavljen	objavio	Voice
raselio	raselila	Gender
holandski	zadarski	lemma
abolicijska	sociološka	lemma
donesao	donesla	Gender
bele	belite	Person
razini	razine	Case
knjižare	knjižara	Number
neuspešno	savršeno	lemma
ispitnima	sakupljačkima	lemma
savetovanje	savetovanja	Number
mislite	mislimo	Person
fiziko	fizikom	Case
nekonvencionalne	nekonvencionalnoj	Case
trofeju	trofejima	Number
najmučnijim	najtrošnijim	lemma
adoriraste	crknuli	lemma
bizona	bizone	Number
obrazovni	artistički	lemma
raspala	raspalo	Gender
nesamostalna	šarmantna	lemma
mirisu	miris	Case
paritetom	paritéta	Case
infamnima	antisocijalnima	lemma
judaizmu	tesaru	lemma
uselila	useljena	Voice
najhladnija	najtrjeznija	lemma
jednostavnost	jednostavnosti	Case
