ausbrechen	None
leih	Singular
verhöret	Plural
stinkend	None
Soprans	Singular
zunehmen	None
erfüllst	Singular
Falzen	Plural
versprich	Singular
umbringen	None
gedröhnt	None
Alkenen	Plural
belass	Singular
würzend	None
Eisbohrkernen	Plural
Facharztes	Singular
Velodroms	Singular
Aspekten	Plural
Fräuleins	Singular
vorhersagend	None
Rettungshubschraubers	Singular
Klavierlehrers	Singular
gehampelt	None
Cytochroms	Singular
malet	Plural
reihst	Singular
besteh	Singular
Gesetzentwurfes	Singular
Pinguins	Singular
flötend	None
immunisier	Singular
begeh	Singular
bestichst	Singular
instituier	Singular
Fahrwerkes	Singular
Jägern	Plural
Einkäufen	Plural
schellend	None
schaufelnd	None
Arzneistoffes	Singular
Phosphaten	Plural
überwältigend	None
ausgetreten	None
Vergehens	Singular
Katalane	Singular
reduzierend	None
eintreten	None
Schlagzeugern	Plural
Beinamen	Plural
Korrespondent	Singular
Gnomen	Plural
Bahnsteigen	Plural
Hängen	Plural
Kanarienvögeln	Plural
Fahnenflüchtige	Singular
Insulanern	Plural
Stoppels	Singular
harnest	Singular
Freskos	Singular
Parteitagen	Plural
Hedonist	Singular
bejahend	None
Meridians	Singular
Gedanke	Singular
Eisbär	Singular
Kutschern	Plural
Benutzerkontos	Singular
Hochofenprozesses	Singular
markierend	None
Industriezweiges	Singular
eingelegt	None
Flüssigkristallbildschirmen	Plural
setzend	None
erteil	Singular
labialisierend	None
Einwohners	Singular
geschädigt	None
Gaugraf	Singular
Eisbrechern	Plural
induzierend	None
Zionist	Singular
Lobes	Singular
Jaguars	Singular
Duetten	Plural
Muskates	Singular
winket	Plural
schäm	Singular
Aktienkursen	Plural
replicierend	None
Bürgermeisters	Singular
Nebenflusses	Singular
Schwermetallions	Singular
schämend	None
anhaben	None
gemeutert	None
Geschäftsjahren	Plural
gelernt	None
genarrt	None
Gyroskopes	Singular
gefertigt	None
aufrufend	None
Fröschen	Plural
Mittelfeldes	Singular
Hypochlorits	Singular
bestochen	None
Trainern	Plural
Umstandes	Singular
Mietvertrages	Singular
Markenname	Singular
Wasserstoffmoleküls	Singular
gekabbelt	None
Pilzen	Plural
untermauerst	Singular
antun	None
Neutronensternen	Plural
Administrators	Singular
betrunken	None
ausdenken	None
Erzeugnisses	Singular
Champagners	Singular
Doktorvaters	Singular
restaurieret	Plural
Wimmelbüchern	Plural
verrät	Singular
gescheucht	None
Akzentes	Singular
Umzuges	Singular
Erziehern	Plural
Gefüges	Singular
aufbauend	None
Peroxomolybdaten	Plural
Provokateuren	Plural
sehn	Singular
Mänteln	Plural
scherz	Singular
veröffentlichst	Singular
Tribunals	Singular
gereift	None
gefickt	None
Zechern	Plural
stiehlt	Singular
Lagerhauses	Singular
köpfend	None
husch	Singular
Täufern	Plural
Aschenkuchens	Singular
Homologs	Singular
Wiederkäuern	Plural
erhebet	Plural
panier	Singular
tätig	Singular
Impressionist	Singular
Bestattern	Plural
Sündern	Plural
verlang	Singular
Düngemittels	Singular
Schmierfetten	Plural
Putschist	Singular
Strohdächern	Plural
Symptomen	Plural
Grundbesitzern	Plural
Elementarteilchens	Singular
Profilen	Plural
erörterest	Singular
desoxidierend	None
Fünftels	Singular
geködert	None
belächelest	Singular
klemmend	None
Laborgeräten	Plural
anvertrauen	None
Grauens	Singular
entkommst	Singular
Lehnwörtern	Plural
Betreffen	Plural
Stoffwechselprozessen	Plural
geschmiert	None
variierend	None
Beugfalles	Singular
abgewichen	None
Amethysten	Plural
gescholten	None
verarschet	Plural
Schrankes	Singular
duckend	None
geknallt	None
Zwanzigern	Plural
Wutanfällen	Plural
Philosoph	Singular
Imbissen	Plural
Blitzlichtern	Plural
verdrehend	None
verzehr	Singular
empfindend	None
Sozialarbeiters	Singular
definierend	None
bezwungen	None
Aluminiumsilikats	Singular
schür	Singular
Kommentars	Singular
verprügelnd	None
Foliensätzen	Plural
applizirend	None
gekifft	None
Brüdern	Plural
Hexachloroplatinats	Singular
Mitstudent	Singular
Christogrammen	Plural
gehör	Singular
Kapiteln	Plural
plärrst	Singular
Zytochroms	Singular
frier	Singular
Konzernes	Singular
angewiesen	None
immigrierend	None
kitzelnd	None
verschmelzend	None
dokumentierend	None
Eigennamens	Singular
Grundsatzes	Singular
Amtsgerichtes	Singular
Kupfererzen	Plural
Zipfels	Singular
Tibetern	Plural
Oberhäuptern	Plural
Fasses	Singular
Lochers	Singular
Gelenken	Plural
gerannt	Plural
meditierend	None
schadend	None
Viertels	Singular
debütierend	None
Behälters	Singular
verlockend	None
Ausländern	Plural
belastend	None
entweichend	None
Augenzeuge	Singular
ramifizierend	None
Initialzündern	Plural
offenbarst	Singular
rinn	Singular
Golfschlägern	Plural
verweigernd	None
dank	Singular
Golfers	Singular
geredet	None
dös	Singular
verdrehest	Singular
Frequenzbereichen	Plural
Akkorden	Plural
Rettungswegen	Plural
Auftraggebern	Plural
Beraters	Singular
forsch	Singular
eingestehen	None
Schubsen	Plural
Fleets	Singular
Umfeldes	Singular
Bedürfnissen	Plural
gespiegelt	None
Bügeln	Plural
Laufstegen	Plural
applicirend	None
Oldtimern	Plural
Muskels	Singular
entleerend	None
Entschlüssen	Plural
Aspiken	Plural
schärfest	Singular
Schimmern	Plural
Reinstoffen	Plural
thu	Singular
Höhepunktes	Singular
Spielplätzen	Plural
Phosphinen	Plural
nölest	Singular
geflickt	None
Manteltieren	Plural
geschmeckt	None
Segelbootes	Singular
Angesichts	Singular
Maledivern	Plural
gelaufen	None
Zweisitzern	Plural
genächtigt	None
hinrichten	None
stock	Singular
Rauches	Singular
behülfest	Singular
Rezitativen	Plural
Äpfeln	Plural
Freizeitzentrums	Singular
montier	Singular
Klötzen	Plural
Auftrittes	Singular
Verbundstoffs	Singular
Jahresüberschusses	Singular
wünschend	None
besprichst	Singular
Gesichtsausdrücken	Plural
Schülers	Singular
Armeniers	Singular
Stiefsöhnen	Plural
Reliquiaren	Plural
Zwerges	Singular
Parkhäusern	Plural
dankend	None
gestemmt	None
heckend	None
Handwerksberufen	Plural
Himmelsäquators	Singular
Zeitpunktes	Singular
Steinbrüchen	Plural
Journalist	Singular
Bonze	Singular
vermengst	Singular
Desoxyribonukleotids	Singular
prüfst	Singular
Schlachtfeldes	Singular
kontaminieret	Plural
Vlieses	Singular
Stürmern	Plural
entschädigst	Singular
gestreift	None
Sehers	Singular
lauft	Plural
Skarnen	Plural
grins	Singular
Waffenschmieden	Plural
Vorstandsmitgliedern	Plural
gewundert	None
entspring	Singular
schielest	Singular
angetreten	None
Arbeitsmarktes	Singular
Zweigen	Plural
titrieret	Plural
Begräbnisses	Singular
hungernd	None
gelenkt	None
Fliegers	Singular
mitgebracht	None
perforierend	None
Postillonen	Plural
exend	None
Elementen	Plural
veraltend	None
Softwareentwicklers	Singular
Nukleotiden	Plural
verpuffet	Plural
abgetrieben	None
gewärtiget	Plural
Stieles	Singular
unterrichtend	None
fotografier	Singular
Haastadlers	Singular
Verliesen	Plural
Kämpen	Plural
erstell	Singular
geschöpft	None
Liters	Singular
schmauch	Singular
Bursche	Singular
explizierest	Singular
zugehen	None
beheizend	None
lüftend	None
Isotops	Singular
Vorsätzen	Plural
Charakters	Singular
Gesimses	Singular
Darmstädtern	Plural
tastend	None
fassest	Singular
benötigst	Singular
Schießbefehlen	Plural
pinkelnd	None
Sängern	Plural
absorbierend	None
begibst	Singular
aufgehoben	None
Masseuren	Plural
Lungenproblems	Singular
Besens	Singular
aussprechen	None
anbringend	None
wehrend	None
Fiebers	Singular
Rundfunkgerätes	Singular
Verwaltungsaktes	Singular
abziehend	None
Kaders	Singular
geragt	None
doublierest	Singular
abgearbeitet	None
aufgestiegen	None
entlädst	Singular
Somiten	Plural
erstechet	Plural
Phänomenen	Plural
Schwüngen	Plural
Nachtsichtgeräten	Plural
Schwagers	Singular
Hortes	Singular
Rennpferden	Plural
Buntstiftes	Singular
Winzers	Singular
Spannern	Plural
Atomkernes	Singular
ehr	Singular
Aasvogels	Singular
gewellt	None
entsaget	Plural
Spitznamens	Singular
Jochen	Plural
Vehikeln	Plural
Gesprächspartikels	Singular
Blutgerinnsels	Singular
Rekorden	Plural
aufgesucht	None
Allergenen	Plural
schockier	Singular
schätzend	None
Standardwerten	Plural
sparst	Singular
Internetzugangs	Singular
usurpierend	None
gebremst	None
Benzins	Singular
instanziieret	Plural
bedrückend	None
Krebstieren	Plural
Beistandes	Singular
Herstellungsprozessen	Plural
Wirten	Plural
Oberschenkels	Singular
Elektrolyten	Plural
Prügeln	Singular
startend	None
Druckfehlern	Plural
drängend	None
Ausweisen	Plural
Stücken	Plural
Halsbändern	Plural
Herstellern	Plural
Halogenkohlenwasserstoffen	Plural
anrufen	None
Atolls	Singular
labernd	None
experimentier	Singular
Troges	Singular
abgeholt	None
Mineralstoffen	Plural
gebrandet	None
Gräsern	Plural
Kölnern	Plural
Evangeliums	Singular
Stegosauriern	Plural
aktivierst	Singular
geborgt	None
Gebinden	Plural
Anwendungsbereiches	Singular
tag	Singular
verzweigend	None
Koordinatensystems	Singular
abblitzen	None
Petschaften	Plural
falz	Singular
verstellet	Plural
geglüht	None
Gebrauchsgegenständen	Plural
erlabend	None
sträub	Singular
zertrampelet	Plural
gepeilt	None
lavier	Singular
überschreitend	None
versuch	Singular
gewetteifert	None
ausrechnen	None
Rümpfen	Plural
Stieftöchtern	Plural
Servern	Plural
Blumenstraußes	Singular
besteuerest	Singular
gehinkt	None
ablehnend	None
mißhandelnd	None
gehegt	None
bestickend	None
Piratensendern	Plural
pürierend	None
Mitarbeiters	Singular
bestechet	Plural
Alkoholgehaltes	Singular
verdeckt	None
Kalifeldspats	Singular
meuternd	None
Bitumens	Singular
Silbererzen	Plural
Zählers	Singular
fungierst	Singular
befiehl	Singular
peinigest	Singular
dominierend	None
Gemischen	Plural
besichernd	None
Esters	Singular
kontrollier	Singular
Eigenname	Singular
geknabbert	None
kämpf	Singular
Benzolringen	Plural
Bergwerken	Plural
degustierend	None
ausweichend	None
preis	Singular
anerkennend	None
entführend	None
schmaus	Singular
heck	Singular
Fließtexten	Plural
Gespenstes	Singular
Fetten	Plural
Landesverbandes	Singular
Priesters	Singular
Morden	Plural
quak	Singular
ausmerzen	None
Aposteln	Plural
Vormundes	Singular
unterschriebst	Singular
Bataillonen	Plural
befindend	None
wascht	Plural
rezitierend	None
Fließes	Singular
Zyklons	Singular
feilschend	None
Freimaurers	Singular
frühstückend	None
Schlammes	Singular
überreich	Singular
gebahnt	None
Feuerwerken	Plural
skizzier	Singular
Rettungshubschraubern	Plural
Pelzes	Singular
Keltiberern	Plural
beschlugt	Plural
verschlack	Singular
Komplize	Singular
Aufenthaltsorten	Plural
zustimmend	None
Polysulfanen	Plural
Kaisers	Singular
abandonnierend	None
eskalierst	Singular
Grundsätzen	Plural
eingebend	None
liebet	Plural
Befundes	Singular
tramp	Singular
deregulieret	Plural
Bezugspunktes	Singular
Drehimpulses	Singular
steinigend	None
verwitter	Singular
motivierend	None
Lindenbäumen	Plural
gepumpt	None
Informatikers	Singular
Zeigern	Plural
Schneidern	Plural
Muttersprachlers	Singular
behinderest	Singular
freilassend	None
erklärend	None
vorzeigen	None
Druckmitteln	Plural
aufrufen	None
schöbest	Singular
koagulierend	None
Hofnarr	Singular
attestierend	None
Fotoapparates	Singular
Stieres	Singular
sicherst	Singular
Sulfiden	Plural
verabscheust	Singular
jaul	Singular
Verhältnisses	Singular
verdirbt	Singular
ausgeschaltet	None
untergegangen	None
Ammoniumsulfats	Singular
Sonnenaufgangs	Singular
Giftgasen	Plural
Symbols	Singular
unterdrückend	None
Imperiums	Singular
wiehernd	None
zusagend	None
hass	Singular
Produktionsländern	Plural
Drahtzaunes	Singular
Tubist	Singular
Implantaten	Plural
ablösend	None
Spielgefährte	Singular
gedämmt	None
Kartograf	Singular
Tanzes	Singular
Triglyceriden	Plural
mutmaßend	None
Prozentpunktes	Singular
Blitzkrieges	Singular
Anwohnern	Plural
riskierst	Singular
keulend	None
verstreuend	None
Wuchers	Singular
befreiend	None
freisprechend	None
wahrgenommen	None
Silberlots	Singular
Aachenern	Plural
vernommen	None
Ameisenbär	Singular
Sulfosalzen	Plural
Donnern	Plural
Dermatologe	Singular
Nanometern	Plural
Sogen	Plural
Grundstoffen	Plural
Glühfadens	Singular
Programmierern	Plural
desavouierend	None
Strukturelementen	Plural
geschätzt	None
geharnt	None
getraut	None
Pflöcken	Plural
registrier	Singular
Nichtmuttersprachlers	Singular
Buchfink	Singular
Warenkorbes	Singular
Gemächern	Plural
kränkelst	Singular
Volksstämmen	Plural
wahr	Singular
Ehegatte	Singular
gewälzt	None
protegier	Singular
anhängend	None
Gebern	Plural
gegrüßt	None
Kristallen	Plural
gezapft	None
Rastplatzes	Singular
oszillierend	None
verdächtig	Singular
Feminist	Singular
Jahrganges	Singular
wag	Singular
Pfeilen	Plural
zerbrich	Singular
Bastes	Singular
bedauernd	None
Tierversuchen	Plural
Stiefvaters	Singular
bombardier	Singular
Förstern	Plural
knuffest	Singular
Wettkämpfen	Plural
Vierzylinders	Singular
Silikaten	Plural
Apfelbaumes	Singular
Igels	Singular
Staublappens	Singular
addierend	None
lastend	None
klammerend	None
Druckers	Singular
Gaules	Singular
harn	Singular
Verlöbnisses	Singular
Spaßes	Singular
Finanzämtern	Plural
erlös	Singular
ermutigend	None
verfluchend	None
Geruchsschwellenwertes	Singular
Gewehren	Plural
Ministerpräsident	Singular
Turnschuhen	Plural
Friseuren	Plural
Verstärkers	Singular
ringelet	Plural
gähnend	None
demokratisierend	None
walz	Singular
zekratzend	None
Randes	Singular
Knochens	Singular
Gegenspielern	Plural
Rohlingen	Plural
Lichtjahren	Plural
Druckbehältern	Plural
Zahnstochern	Plural
hervorgebracht	None
Spielplatzes	Singular
Scharnieren	Plural
Schöpfers	Singular
Anstrichs	Singular
abheben	None
mißversteh	Singular
Aufwänden	Plural
Magistern	Plural
Iranern	Plural
Resonators	Singular
Trakten	Plural
Rostschutzmitteln	Plural
verheißend	None
Musikinstrumentes	Singular
anmeldend	None
radier	Singular
kuck	Singular
Dichlorids	Singular
Centern	Plural
watend	None
Werkstoffes	Singular
überraschst	Singular
Waschmitteln	Plural
Kranichs	Singular
geglückt	None
pflückst	Singular
Heptanen	Plural
Federspitzen	Plural
abwerten	None
schell	Singular
bemängelst	Singular
Iberern	Plural
Beratern	Plural
geschlendert	None
erzwingst	Singular
Zehnkampfes	Singular
keim	Singular
gestolpert	None
Henkels	Singular
ergänz	Singular
rawbst	Singular
getropft	None
Versuchen	Plural
geklemmt	None
gewaschen	None
gecheckt	None
erteilend	None
Blockes	Singular
klär	Singular
Staubgefäßen	Plural
Eisenerzen	Plural
Klatschen	Plural
gebangt	None
Buchungskreisen	Plural
reparierend	None
Eingeweiden	Plural
Labormaßstabes	Singular
verscheissernd	None
erachtend	None
kletternd	None
schützend	None
plädierend	None
Klosters	Singular
belasset	Plural
Amins	Singular
Tempels	Singular
Vorwurfes	Singular
abgeschlossen	None
Striches	Singular
klau	Singular
herabsetzend	None
beurteilst	Singular
Halbkreises	Singular
zurücktretend	None
imkernd	None
enthüllend	None
spendend	None
hall	Singular
Chronist	Singular
Außenministeriums	Singular
Pirat	Singular
dien	Singular
zeichnend	None
Schrottes	Singular
Montagnachmittagen	Plural
scann	Singular
Gefäßwänden	Plural
Kanzlern	Plural
gelehrt	None
faltend	None
Justizirrtums	Singular
Rabe	Singular
Korrosionsschutzes	Singular
vertraust	Singular
Gangsters	Singular
Schaffnern	Plural
hydrogentartrats	Singular
Aa machend	None
Zirkonen	Plural
Sketches	Singular
geschleudert	None
abgeändert	None
gewappnet	None
erweiteret	Plural
Planet	Singular
Geschäftsablaufs	Singular
verschleppend	None
replizierend	None
Versicherern	Plural
schwör	Singular
schlägt	Singular
gewürfelt	None
vertrauend	None
Anstiegen	Plural
Bröseln	Plural
Kristallsystems	Singular
Bruttonationaleinkommens	Singular
Fäusten	Plural
geschichtet	None
Lammfellen	Plural
Gottesbeweisen	Plural
putschend	None
prägend	None
gebatikt	None
Geheimdiensten	Plural
Hartmetallen	Plural
gepasst	None
herzet	Plural
Aphelen	Plural
Laubhölzern	Plural
gescharrt	None
Systems	Singular
Ahn	Singular
Quants	Singular
halogenierend	None
Dielektrikums	Singular
Bollwerks	Singular
mitgeteilt	None
Urinals	Singular
Kiesen	Plural
Schwermetallen	Plural
investierest	Singular
Gegensatzes	Singular
Einträgen	Plural
erfreuend	None
gerußt	None
verliebend	None
Asthmas	Singular
Spenders	Singular
fabulierst	Singular
beschwerst	Singular
verschweigst	Singular
Schleiers	Singular
gehäutet	None
übertrifft	Singular
Chlorstroms	Singular
formatierst	Singular
packet	Plural
Integralen	Plural
Wirkstoffs	Singular
Bordsteinen	Plural
Neutrons	Singular
Grieche	Singular
Thermoelementen	Plural
Ausschusses	Singular
berührend	None
Individuums	Singular
improvisierend	None
ausmachen	None
nährest	Singular
Smaragden	Plural
Schulbuchverlagen	Plural
grausend	None
Paradoxes	Singular
Ausstiegen	Plural
zechend	None
abgewartet	None
orgelnd	None
Biestern	Plural
Phosphates	Singular
gefuttert	None
trampest	Singular
abnehmend	None
verscheuchend	None
Handelsblattes	Singular
Staubgefäßes	Singular
rauchst	Singular
Anrufern	Plural
Organen	Plural
Altersheimen	Plural
Loten	Plural
Kortikoiden	Plural
Hartloten	Plural
Kelte	Singular
Hüttenwerken	Plural
pürieret	Plural
Fixsternen	Plural
Schmugglern	Plural
Unteroffizieren	Plural
kreiset	Plural
schnorrend	None
Antikörpern	Plural
erinnerst	Singular
angezweifelt	None
geplatzt	None
angepasst	None
Flame	Singular
Ausländers	Singular
gerätselt	None
Chasar	Singular
Plattners	Singular
Behufs	Singular
gehockt	None
Dübeln	Plural
Zugängen	Plural
geklafft	None
anrichtend	None
feststellend	None
Grizzlybär	Singular
Gesamtjahrs	Singular
Speichern	Plural
hereinkommen	None
Vorsatzes	Singular
schmorend	None
Homologen	Plural
Sanatoriums	Singular
Fahrwerken	Plural
Ladungsausgleichen	Plural
Schnauzern	Plural
gekritzelt	None
erweiset	Plural
Stricken	Plural
berührst	Singular
Medikamentes	Singular
Ozonidanionen	Plural
Wählern	Plural
pachtend	None
gefährdend	None
Zellkernen	Plural
Psychopath	Singular
Quorums	Singular
gestunken	None
abgebend	None
Europäern	Plural
Fixierbads	Singular
Paktes	Singular
Geburtstagsfeiern	Plural
vereinfachend	None
gepustet	None
pups	Singular
kollidierend	None
Luftschiffes	Singular
grenz	Singular
Ingwers	Singular
Talismanen	Plural
geknechtet	None
einnehmend	None
schmeckest	Singular
Haushaltsgegenständen	Plural
gethan	None
Molybdäns	Singular
überredend	None
Menschheitsbeglückern	Plural
verlangend	None
gerast	None
brausend	None
Zweiges	Singular
Bornes	Singular
geschaut	None
genähert	None
zeltend	None
Kaufhauses	Singular
munkelnd	None
Magiern	Plural
Aufsehers	Singular
Departementen	Plural
Aa gemacht	None
unterlass	Singular
ertränket	Plural
Leipzigern	Plural
Einschreibens	Singular
Abiturs	Singular
beigetreten	None
beantrag	Singular
Nussknackers	Singular
behauptend	None
entgehst	Singular
Weltmeeren	Plural
bewehrend	None
Flickens	Singular
Spektralbereichs	Singular
Vietnamese	Singular
Endspiels	Singular
Monoarsanen	Plural
ermöglich	Singular
Satanist	Singular
glättend	None
Bestrebens	Singular
Fässern	Plural
auflösen	None
streik	Singular
gehakt	None
empfiehlst	Singular
Eremit	Singular
leuchtend	None
Hirtenhunden	Plural
existierend	None
Notfällen	Plural
stick	Singular
dimerisierend	None
gebildet	None
verschlüsselnd	None
geblakt	None
verfasset	Plural
Stollens	Singular
Befehles	Singular
Weißweinen	Plural
Ministers	Singular
Piemontesers	Singular
besannst	Singular
begrenzend	None
versinkend	None
blondier	Singular
Besserwissern	Plural
Grossvaters	Singular
Inhaltsverzeichnissen	Plural
Herzogtums	Singular
Staatsstreichen	Plural
freigesprochen	None
Transvestit	Singular
genehmig	Singular
Fundamenten	Plural
Keimes	Singular
Arzneimitteln	Plural
Gebäcken	Plural
Freibades	Singular
plazierend	None
Bewohnern	Plural
Haffen	Plural
Zwangsarbeitern	Plural
bestätig	Singular
Rennpferdes	Singular
Schlagzeugers	Singular
Eides	Singular
gesäubert	None
Nutznießern	Plural
Gefahrensymbolen	Plural
Weißkopfseeadlers	Singular
Goldeseln	Plural
Gerichtshöfen	Plural
Ästen	Plural
kränkend	None
alimentierend	None
Wohnzimmern	Plural
zoff	Singular
abwartend	None
Goldfisches	Singular
wedelnd	None
plauderet	Plural
Absatzes	Singular
erratest	Singular
Lebensmittels	Singular
schmus	Singular
Spruchbandes	Singular
Gespenstern	Plural
geschauspielert	None
Feigenbäumen	Plural
ablehnen	None
Nörglern	Plural
Edelgases	Singular
reiz	Singular
erläuternd	None
gestochert	None
Welsen	Plural
gesorgt	None
errät	Singular
Drehbuches	Singular
gedolmetscht	None
echauffierst	Singular
Nutzens	Singular
Benutzername	Singular
Kletterschuhes	Singular
Schulterblättern	Plural
Specken	Plural
camouflierend	None
Teleskops	Singular
dramatisierest	Singular
beschädigend	None
Onkologe	Singular
verkürzend	None
entschädig	Singular
angebaut	None
Anrufen	Plural
Ordnern	Plural
Sprichwörtern	Plural
verfängt	Singular
beamst	Singular
witzelnd	None
checkst	Singular
eingeführt	None
Wirtschaftsministers	Singular
Herrenhauses	Singular
Exzessen	Plural
gegeifert	None
erwartend	None
Sämlingen	Plural
ausnutzen	None
Fragebogens	Singular
lockernd	None
Waffenstillstandes	Singular
Arschgesichtes	Singular
Hinterkopfes	Singular
Hindernissen	Plural
Süßstoffen	Plural
Arschlöchern	Plural
Besteckes	Singular
Sprachkursen	Plural
Findlings	Singular
Kolumnist	Singular
Delikten	Plural
Funke	Singular
gebilligt	None
Geschäftsbereiches	Singular
Bibelforschern	Plural
Greif	Singular
Zerfallsprodukten	Plural
krächz	Singular
Auslösern	Plural
Brandsätzen	Plural
Kirchtürmen	Plural
Mammakarzinoms	Singular
verbannet	Plural
zusammenstellen	None
spekulierend	None
gebrauch	Singular
Zauberkräften	Plural
aufgeschoben	None
gemischt	None
Schmerzmittels	Singular
gebrannt	None
gefoltert	None
mal	Singular
spürest	Singular
ausgestiegen	None
Tastsinnes	Singular
Desasters	Singular
Weltkrieges	Singular
Assyrern	Plural
Römers	Singular
erläuterst	Singular
Montagabenden	Plural
Fernsehschirmes	Singular
einstellen	None
Molybdits	Singular
Dünsten	Plural
genickt	None
merkest	Singular
anpassend	None
Beitrages	Singular
bohrend	None
Hypothalamin	Plural
auftreten	None
Schwefeloxiden	Plural
Untersuchungsausschusses	Singular
unterschreibst	Singular
Ausschüssen	Plural
Loben	Plural
Arabern	Plural
ablaufen	None
wundernd	None
kippend	None
Grenzlandes	Singular
korrespondierend	None
ersteigernd	None
Einschlusses	Singular
Erzfeinden	Plural
sättigend	None
offenbarend	None
schrumpf	Singular
Parasit	Singular
Gedankenspielen	Plural
geizend	None
Banners	Singular
einbeziehend	None
korrigierst	Singular
Bosniern	Plural
Inhabern	Plural
Büschen	Plural
Gliederungseditorenn	Plural
Treibhausgasen	Plural
geschnürt	None
zerflösset	Plural
Komplexen	Plural
schraub	Singular
sonnend	None
drapier	Singular
streichend	None
Pflastern	Plural
Luchses	Singular
Kanake	Singular
geprostet	None
Kombinationsfeldes	Singular
Groschens	Singular
Anlegern	Plural
gehämmert	None
beziehend	None
kreis	Singular
sonnet	Plural
Einverständnissen	Plural
Falters	Singular
Pilzes	Singular
Kopfhörern	Plural
Bombern	Plural
Grabes	Singular
Auswegen	Plural
Assyriologe	Singular
Bescheiden	Plural
gekackt	None
kennengelernt	None
Übersetzers	Singular
sims	Singular
Ödemen	Plural
zähl	Singular
lancierend	None
Urlaubern	Plural
Bewerbungsgesprächen	Plural
aufgegeben	None
Artgenosse	Singular
Mischelementen	Plural
entnommen	None
schaukelnd	None
Wertpapieren	Plural
angeben	None
Aldehyds	Singular
lokalisierend	None
Unterbegriffen	Plural
Fehlschlusses	Singular
Bundeswirtschaftsministers	Singular
inhaftierend	None
Fallstricken	Plural
Erdrutsches	Singular
Käfern	Plural
tauchend	None
Stichen	Plural
Gehölzes	Singular
Rücktritten	Plural
Zockern	Plural
geschwollen	None
Atoms	Singular
experimentierest	Singular
Wahlgangs	Singular
Piratensenders	Singular
Dachgeschossen	Plural
entsinnend	None
Ohrringen	Plural
isolierend	None
Koteletts	Singular
geduscht	None
brems	Singular
Dachziegeln	Plural
gildend	None
Reportes	Singular
Nervensystems	Singular
Heringen	Plural
Strudels	Singular
Pflasters	Singular
gewürgt	None
Schwellenwertes	Singular
Aufsteigers	Singular
Hauptsatzes	Singular
verkabelnd	None
Karabiners	Singular
Nilpferden	Plural
Flors	Singular
Schmarotzern	Plural
bekanntest	Singular
Spaltprodukten	Plural
Kauzes	Singular
Karzinomen	Plural
Reiseberichtes	Singular
Bindern	Plural
Halsbandes	Singular
Strandbades	Singular
Kompositums	Singular
Gauklern	Plural
schlängelnd	None
Galgens	Singular
Hurritern	Plural
Herausgebers	Singular
zackend	None
wettend	None
gemampft	None
Gauklers	Singular
Oberlandesgerichten	Plural
Geselle	Singular
erzwungen	None
grillet	Plural
probierst	Singular
einschmeicheln	None
erleichterest	Singular
durchfahrend	None
gepeinigt	None
Phospholipiden	Plural
Gecks	Singular
abgegeben	None
Chlorids	Singular
konzentrierst	Singular
Anschlages	Singular
verlanget	Plural
Klavierkonzerts	Singular
eliminierend	None
steueret	Plural
Ritten	Plural
Armenhauses	Singular
gefodert	None
umgewandelt	None
pflügst	Singular
Treffers	Singular
staubsaugend	None
Ferchromiden	Plural
Fremdstoffen	Plural
Silbersalzen	Plural
trommelnd	None
Angebotes	Singular
Exhibitionist	Singular
regst	Singular
Europäers	Singular
eingeladen	None
Baustoffes	Singular
Flugschreibers	Singular
sinkend	None
schlagt	Plural
vorbereiten	None
Gotteshauses	Singular
Cholesterins	Singular
beruhigend	None
Stammes	Singular
anbauend	None
Kopfhörers	Singular
Eiweißen	Plural
Leuchters	Singular
vergrab	Singular
Aufsehern	Plural
Lustspielen	Plural
Unterseebootes	Singular
gesättigt	None
Tennisplätzen	Plural
Wortstämmen	Plural
auswertend	None
Rabenvaters	Singular
anbringen	None
ausgelaugt	None
Agons	Singular
glaubend	None
Arsenaten	Plural
stopfest	Singular
geschmaust	None
Rücktrittes	Singular
Geländern	Plural
Plattfischen	Plural
darstellen	None
ertrag	Singular
managend	None
abspielend	None
teilst	Singular
geankert	None
Dendrit	Singular
batik	Singular
Füchsen	Plural
Skandalen	Plural
respektier	Singular
hievest	Singular
rupf	Singular
Kampfspielen	Plural
Farmern	Plural
Kuttern	Plural
gehüpft	None
Fachärzten	Plural
gepfropft	None
vermagst	Singular
Tellerwäschers	Singular
stiftend	None
gehoben	None
Oldtimers	Singular
demotivieret	Plural
reagierend	None
Akzenten	Plural
Bundesverbandes	Singular
Stromstößen	Plural
Klempners	Singular
Markgraf	Singular
Kammes	Singular
Grenzwerten	Plural
Kreislaufes	Singular
Kreutzen	Plural
Esprits	Singular
geflohen	None
spürend	None
schwadronieret	Plural
verfassend	None
gewatschelt	None
einladend	None
schöpf	Singular
Krampfanfällen	Plural
jammerst	Singular
ahnst	Singular
Prismas	Singular
gefangen	None
Anträgen	Plural
Teilnehmers	Singular
Edelgasen	Plural
Halls	Singular
Arbeitsschritten	Plural
Tiefstwerten	Plural
Pflanzenstoffen	Plural
Ohrwürmern	Plural
Baustoffen	Plural
angelet	Plural
Ausreißern	Plural
nützet	Plural
Funktionswortes	Singular
brennst	Singular
pack	Singular
Defekts	Singular
Genetikers	Singular
recherchier	Singular
Glaubensbrüdern	Plural
abgehalten	None
kapselst	Singular
Metallen	Plural
Oligopolen	Plural
stammend	None
Radfahrers	Singular
mißlungen	None
gefeuert	None
Ankers	Singular
Wärmetauschers	Singular
geglaubt	None
Bogenschütze	Singular
defenestrierend	None
gesponnen	None
trampend	None
deklamierend	None
Apostrophen	Plural
Blutgefäßes	Singular
zugegeben	None
pflanzend	None
hinzufügen	None
Arsentrisulfids	Singular
Lebensjahren	Plural
schlugst	Singular
Auszuges	Singular
redend	None
zielst	Singular
erstaunend	None
Aufzügen	Plural
karr	Singular
mumifizier	Singular
Flugblättern	Plural
ordnend	None
goutierst	Singular
Deltas	Singular
abgebrochen	None
Ersuchens	Singular
verdrängest	Singular
Chics	Singular
Bauwesens	Singular
verpuffest	Singular
Bundesgebietes	Singular
Bächen	Plural
Klebstoffen	Plural
Freunden	Plural
Mohr	Singular
Fagotten	Plural
ausgemerzt	None
Kalkes	Singular
Gelübdes	Singular
Drillings	Singular
Guldens	Singular
Missverständnissen	Plural
gelistet	None
Imperators	Singular
Meilern	Plural
Prinz	Singular
Permafrostbodens	Singular
Begriffes	Singular
Schobers	Singular
rechtfertigend	None
zugeben	None
schädigest	Singular
Chromophors	Singular
Fönen	Plural
Briefkopfes	Singular
Schonern	Plural
Evangelist	Singular
gezackt	None
fauch	Singular
berücksichtigend	None
dimm	Singular
Frühjahrs	Singular
Abredegestellt	None
Gauleiters	Singular
toppend	None
Arbeitskreisen	Plural
Magnetfeldes	Singular
entjungfert	None
bratsch	Singular
Nutzern	Plural
Sehnsüchten	Plural
Gütesiegels	Singular
Schotte	Singular
vermittelnd	None
überprüfst	Singular
schlüpfest	Singular
wegnehmend	None
ramponierend	None
gibbelet	Plural
Fischotters	Singular
zurückhalten	None
geschüttet	None
quetsch	Singular
schwänzend	None
schürf	Singular
annullierst	Singular
verholfen	None
Glaskörpers	Singular
Parse	Singular
getoastet	None
Falke	Singular
wagest	Singular
Lotse	Singular
Sojamehls	Singular
gestohlen	None
Monogrammen	Plural
abgelehnt	None
beb	Singular
geflüstert	None
Niederschlages	Singular
Hämocyaninen	Plural
genörgelt	None
gestempelt	None
Flugzeugmutterschiffen	Plural
gönn	Singular
Prozessen	Plural
verzinkend	None
Pfennigen	Plural
Rechtsstreites	Singular
Herrschers	Singular
veränderst	Singular
DVD-Spielers	Singular
Endemit	Singular
ankündigen	None
Supermarktes	Singular
Axioms	Singular
Unters	Singular
verlötend	None
gepflückt	None
kennenlernen	None
definier	Singular
Alligators	Singular
Autoabgasen	Plural
Schneiders	Singular
Ukrainers	Singular
geschritten	None
Dreirädern	Plural
Salzwassers	Singular
splitternd	None
miauet	Plural
Finks	Singular
leidend	None
Antisemit	Singular
verkenn	Singular
erniedrigend	None
aushalten	None
Dreiklangs	Singular
Seehase	Singular
argumentierend	None
Begräbnissen	Plural
feg	Singular
Getrieben	Plural
senkend	None
Äthers	Singular
Besuchers	Singular
Affekts	Singular
aufbauschen	None
fladerest	Singular
Inselbewohnern	Plural
Kakerlak	Singular
Carbonsäureamiden	Plural
gejätet	None
ausgenutzt	None
Generalsekretärs	Singular
Sekretären	Plural
Heilmittels	Singular
bootend	None
verwundend	None
ringend	None
Ballspielen	Plural
sortierend	None
Zebrafink	Singular
henkend	None
Wanderfalke	Singular
überfischend	None
Gönnens	Singular
DVD-Spielern	Plural
roll	Singular
mailet	Plural
Skelettes	Singular
beruhig	Singular
eingezogen	None
Produktes	Singular
kämpfet	Plural
operierend	None
vergebet	Plural
Akutes	Singular
peinigst	Singular
Flieders	Singular
kicket	Plural
Ständern	Plural
Träumern	Plural
aufatmen	None
gelauscht	None
enträtselnd	None
Gehäuses	Singular
Werkzeuges	Singular
ackeret	Plural
untermauernd	None
Heilandes	Singular
Stahlhelmen	Plural
abspritzen	None
Bocksdornes	Singular
Seelöwe	Singular
Auslösers	Singular
Explosivstoffen	Plural
Leichentüchern	Plural
bestehet	Plural
verzählend	None
provozierend	None
gegriffen	None
entsorgest	Singular
Koteletten	Plural
sanierend	None
integrieret	Plural
Würfen	Plural
gejubelt	None
Theoremen	Plural
Stückes	Singular
Violinist	Singular
Bötchens	Singular
wandelet	Plural
Schmelzpunktes	Singular
Gehens	Singular
Kataloges	Singular
gestammt	None
befummelnd	None
bezieh	Singular
Datenträgern	Plural
Ulmern	Plural
Zahlwörtern	Plural
evakuierst	Singular
Premierministers	Singular
verschiebend	None
Genen	Plural
Campingplätzen	Plural
Klassenzimmern	Plural
genes	Singular
streifend	None
Einschnitten	Plural
Glückwünschen	Plural
Schaufenstern	Plural
quasselnd	None
Höckern	Plural
Dichtern	Plural
Kassierers	Singular
Eintrittes	Singular
Rasens	Singular
Diebes	Singular
Findlingen	Plural
Bergländern	Plural
gegolten	None
gekauert	None
überfällt	Singular
Milchkühen	Plural
ausfüllend	None
kapitalisierst	Singular
geschnitzt	None
Blattläusen	Plural
dotierend	None
fluktuieret	Plural
Eidgenosse	Singular
föchtest	Singular
gefestigt	None
schwill	Singular
Grundgesetzen	Plural
schachernd	None
aufbauen	None
Abhängen	Plural
geordnet	None
Autositzbezügen	Plural
Überblickes	Singular
Akademikers	Singular
verärgernd	None
imitierend	None
reinig	Singular
pickend	None
Demokrat	Singular
Dateinamens	Singular
Selengehalts	Singular
aufzählen	None
verplempernd	None
Sonnenschirmen	Plural
hinlegen	None
Südasiens	Singular
Photons	Singular
Kupferstiches	Singular
Kalbes	Singular
Impulsen	Plural
Hauptquartiers	Singular
Glycerins	Singular
ausgerottet	None
Talenten	Plural
Vorzeichens	Singular
Pflegeheimes	Singular
Exporteuren	Plural
Papieres	Singular
Gedärmen	Plural
Kanarienvogels	Singular
kontrahierend	None
Erregers	Singular
Belgiers	Singular
verallgemeinernd	None
Fundamentes	Singular
Darlehens	Singular
Köhlern	Plural
gekündigt	None
Rauchers	Singular
Hautausschlägen	Plural
geschminkt	None
zubereiten	None
beschuldigend	None
Gestells	Singular
einschließend	None
strapazierend	None
Puppenspielers	Singular
Landrates	Singular
gespreizt	None
Politikwissenschaftlers	Singular
alarmieret	Plural
Brennens	Singular
scannend	None
Kosmopolit	Singular
zitternd	None
hehlend	None
gedonnert	None
Illyrern	Plural
Funktionärs	Singular
gecovert	None
versifizierend	None
übertreibend	None
Hüftgelenkes	Singular
gemailt	None
geschleppt	None
Premierministern	Plural
Hasardeuren	Plural
Prädikats	Singular
Aktionären	Plural
gehetzt	None
Crystals	Singular
Kopilot	Singular
Advokat	Singular
gefügt	None
geblafft	None
Sublimationspunkts	Singular
ausstatten	None
kappend	None
Niederländern	Plural
Potenzials	Singular
einschließen	None
Impressums	Singular
schwingend	None
Stilen	Plural
Anhängern	Plural
krächzend	None
missbrauchest	Singular
Umständen	Plural
Lehrwerken	Plural
Stiles	Singular
Geiers	Singular
rotierend	None
Küsters	Singular
graphitierest	Singular
Bauernhofes	Singular
Ferkeln	Plural
Reisfeldern	Plural
Seehafens	Singular
einbeziehen	None
Psalmes	Singular
erhebend	None
erwach	Singular
individualisierest	Singular
Silberlachsen	Plural
zerstörend	None
weggeworfen	None
Liedes	Singular
schiff	Singular
Fieberanfällen	Plural
Formulars	Singular
Gletschern	Plural
Sonnenwindes	Singular
Homonymen	Plural
Bündnisses	Singular
Anarchist	Singular
Felses	Singular
platsch	Singular
Torhütern	Plural
Geländen	Plural
flehend	None
Hausmäusen	Plural
Postern	Plural
urteil	Singular
erschlugst	Singular
Taiwanern	Plural
Majoranen	Plural
Biograf	Singular
hergestellt	None
Goldschakalen	Plural
Ökosystems	Singular
Nachzüglern	Plural
gefriemelt	None
Tarifvertrages	Singular
geflochten	None
patz	Singular
geheftet	None
Kleinkindern	Plural
Nebenflüssen	Plural
Grüssen	Plural
überfall	Singular
Aquariums	Singular
Schwanes	Singular
Klängen	Plural
geängstigt	None
zugesagt	None
überprüf	Singular
ausmustern	None
Säuglingen	Plural
Spitälern	Plural
produzierst	Singular
Achaten	Plural
ausgebaut	None
Zuname	Singular
überlebend	None
walzend	None
Zentralnervensystems	Singular
Pharisäers	Singular
gesunken	None
Holzscheiten	Plural
gemeistert	None
verursachend	None
Feststoffes	Singular
Hirnhäuten	Plural
Augapfels	Singular
Kampfstoffen	Plural
Einsatzes	Singular
reimest	Singular
Schuldnern	Plural
gekürzt	None
überfallet	Plural
Sigrist	Singular
Stammtischen	Plural
Favorit	Singular
Tümpeln	Plural
Autofahrers	Singular
überkämest	Singular
Herzmuskels	Singular
schluchzend	None
verzähl	Singular
Hardwareentwicklers	Singular
Nestlingen	Plural
Laubfröschen	Plural
Pressesprechern	Plural
bemutterst	Singular
Storches	Singular
Violinkonzerts	Singular
Fundorten	Plural
furz	Singular
trainierest	Singular
mopp	Singular
Spitzenreitern	Plural
Insektiziden	Plural
Aquifers	Singular
bremsend	None
umgebend	None
flambierest	Singular
schmerzend	None
gelitten	None
Päckchens	Singular
Diselanen	Plural
dop	Singular
ruß	Singular
aufgerufen	None
verschlossest	Singular
Dokumentes	Singular
Akuten	Plural
raufet	Plural
tuschelnd	None
Nährstoffen	Plural
Thoriums	Singular
Namensgebers	Singular
Buchstabe	Singular
Traggases	Singular
klammerst	Singular
Parallelogrammen	Plural
warnest	Singular
ehelichst	Singular
lähmend	None
freigesetzt	None
befürwortend	None
wiederbeleben	None
Metallgittern	Plural
Konzernen	Plural
gleitend	None
wimmelet	Plural
Atriums	Singular
gekeult	None
erhellest	Singular
Hafenbeckens	Singular
verlass	Singular
aufnehmend	None
Köttern	Plural
gestreikt	None
wurdest	Singular
geruckelt	None
Scheffeln	Plural
entkommend	None
Wurfes	Singular
Betreffes	Singular
stattfinden	None
Kaminen	Plural
Bankers	Singular
Segelschiffes	Singular
bang	Singular
gesickert	None
bahnst	Singular
eingeräumt	None
Protist	Singular
geherrscht	None
abstrahier	Singular
gehandelt	None
Fegefeuers	Singular
Kaliumpermanganats	Singular
gesehnt	None
genaht	None
gebrandschatzt	None
kau	Singular
klärend	None
Kapitels	Singular
geschönt	None
Hausherr	Singular
pexierend	None
Gebirgen	Plural
überfischst	Singular
Moleküls	Singular
erlaubst	Singular
schrumpfend	None
destillierend	None
Verkehrsflugzeugen	Plural
Bromfluoriden	Plural
abgelaufen	None
schnorr	Singular
Verlagswesens	Singular
Abstimmungsortes	Singular
Endometriums	Singular
Bundespräsident	Singular
gekuckt	None
angebetet	None
umkehren	None
belästigend	None
foppend	None
Netzwerkes	Singular
schlummernd	None
egg	Singular
überquerend	None
Bordells	Singular
Flussbetts	Singular
Tangen	Plural
Zirconiumkomplexes	Singular
erörterst	Singular
Käufen	Plural
bekämpf	Singular
stagnierest	Singular
nerv	Singular
deaktivieret	Plural
Grande	Singular
Appenzellern	Plural
bezichtigend	None
hinreißend	None
schneidend	None
adelnd	None
Graugänsen	Plural
geschottert	None
möppernd	None
konjugier	Singular
Kaufpreises	Singular
Gehegen	Plural
kontrastierend	None
Kardinälen	Plural
Schlossers	Singular
gepackt	None
gerankt	None
gehöret	Plural
verzauberet	Plural
Anglers	Singular
verschlungen	None
entwendend	None
gekremt	None
Gewichtes	Singular
saunierend	None
gewässert	None
Körpergewichtes	Singular
Stickoxiden	Plural
bratend	None
vertrugst	Singular
Prüflings	Singular
Jagdhunden	Plural
geschwätzt	None
verwirrend	None
beantragst	Singular
Abszesses	Singular
Führers	Singular
Abbruches	Singular
Bremsbelägen	Plural
Hydroxyaldehyden	Plural
spuk	Singular
Gegners	Singular
Satyrs	Singular
würdig	Singular
gespritzt	None
zweifelst	Singular
Ereignisses	Singular
Amiden	Plural
Geschäftsjahres	Singular
Kellergeschosses	Singular
Kabinetts	Singular
vergiftend	None
vertuschend	None
Florist	Singular
rutsch	Singular
rächend	None
Terrorist	Singular
einschüchtern	None
Akkordes	Singular
Klanges	Singular
Kriminalromanen	Plural
ausfallen	None
Müllplätzen	Plural
Halbgöttern	Plural
Pollern	Plural
gerawbt	None
Durchbrüchen	Plural
Verhören	Plural
Zweikampfes	Singular
sperrst	Singular
Bischöfen	Plural
schwebst	Singular
Integritätsbereiches	Singular
Betrieben	Plural
bahn	Singular
Drecklochs	Singular
entfärbest	Singular
geklaut	None
würdigend	None
geträllert	None
postulierst	Singular
Blätterpilzen	Plural
Deichen	Plural
Akrobat	Singular
katalysierst	Singular
rebellierend	None
ernüchterst	Singular
Antifaschist	Singular
Entwicklers	Singular
Raumschiffen	Plural
heulend	None
Teilchens	Singular
Verkaufes	Singular
Durchschnittswerten	Plural
gesichert	None
Seeadlern	Plural
einladen	None
Onkels	Singular
Niets	Singular
beklagst	Singular
stabilisierend	None
schabest	Singular
Rappe	Singular
gezügelt	None
aufsteigen	None
plaudernd	None
instanziierst	Singular
angekratzt	None
Mägden	Plural
flüsteret	Plural
Redners	Singular
Stadtteilen	Plural
zuhören	None
Schwabe	Singular
Beilen	Plural
Innensenators	Singular
Fabrikant	Singular
gerügt	None
Erzählern	Plural
gekräht	None
Rändern	Plural
Eisennagels	Singular
verhaftend	None
Totschlages	Singular
gustieret	Plural
gedrungen	None
Bibern	Plural
Gelen	Plural
investierst	Singular
Fernverkehres	Singular
drillend	None
bedurft	None
veranlassst	Singular
tanz	Singular
gewirkt	None
Gottesbeweises	Singular
Signalweges	Singular
Kutschers	Singular
hissend	None
Gebilden	Plural
Mordanschlägen	Plural
Rätsels	Singular
pilgerst	Singular
Schützes	Singular
erziehend	None
Brechern	Plural
Einschnittes	Singular
Ammoniumsalzen	Plural
Eigenwertproblemen	Plural
thust	Singular
Fundamentalist	Singular
Minimums	Singular
beschlagend	None
Roteisensteinen	Plural
merk	Singular
Abfällen	Plural
gekleidet	None
verderbend	None
Diebstahls	Singular
flanierend	None
Blickwinkeln	Plural
gravierend	None
Anfalls	Singular
Mandaten	Plural
betreibst	Singular
erstickend	None
geleakt	None
Volontären	Plural
Pfarrers	Singular
Ausweises	Singular
Reaktionsschritten	Plural
Staubblättern	Plural
fangt	Plural
Verschleißen	Plural
Festkörpers	Singular
lins	Singular
Brillengestellen	Plural
ergebest	Singular
systematisierest	Singular
vermerkst	Singular
Rooibossen	Plural
gestillt	None
zürn	Singular
Krämpfen	Plural
Maltese	Singular
Aufrührern	Plural
ankratzend	None
vertonend	None
Sammlers	Singular
behindernd	None
Phosphanen	Plural
Sauerampfern	Plural
geschifft	None
unterzeichnend	None
sieg	Singular
veranstaltend	None
Metalles	Singular
pumpend	None
heuernd	None
flitz	Singular
Metallatomen	Plural
Lucianers	Singular
Ombudsmännern	Plural
geklettert	None
beherrschend	None
trödelnd	None
Stöcken	Plural
Staatsgebieten	Plural
Sturmes	Singular
verordnend	None
einkaufen	None
Industrieländern	Plural
bedenk	Singular
Wandergeselle	Singular
ausgetrunken	None
Gemälden	Plural
Gespinsten	Plural
glosest	Singular
blockierend	None
Holunderbusches	Singular
Altwassern	Plural
Malzes	Singular
gezeichnet	None
murksend	None
Porzellans	Singular
japsend	None
ritz	Singular
Glaskolbens	Singular
Bordellen	Plural
gewackelt	None
gehumpelt	None
montierend	None
einteilend	None
Apfels	Singular
reproduzierend	None
sprüh	Singular
Haies	Singular
Dirigent	Singular
Wadenbeines	Singular
abgerundet	None
sännest	Singular
Dreieckes	Singular
schockierend	None
Jodlern	Plural
Bürgerhauses	Singular
verarschend	None
zitierend	None
Chipsatzes	Singular
feist	Singular
Altersunterschiedes	Singular
Vergasers	Singular
absagen	None
Sitzkrieges	Singular
Wissenschaftlers	Singular
Wirkstoffen	Plural
geangelt	None
Wahllokalen	Plural
geschwärmt	None
Fingerknöcheln	Plural
Strafstößen	Plural
Attentätern	Plural
hervorgehoben	None
Zügeln	Plural
konvertierend	None
Gehölzen	Plural
ablösen	None
Arylaminen	Plural
Ausbaues	Singular
Kellners	Singular
Schnitzeln	Plural
Pendlern	Plural
verspricht	Singular
verfehlst	Singular
fasend	None
einig	Singular
gelötet	None
Laufwerken	Plural
surf	Singular
Ablebens	Singular
Rondellen	Plural
Buttes	Singular
Heimtieren	Plural
Versehens	Singular
Schweinehunden	Plural
Jüngern	Plural
Objektes	Singular
Koffern	Plural
kipp	Singular
billigend	None
aufgeregt	None
ersticht	Singular
Gleisen	Plural
Urlauben	Plural
erbracht	None
Astronaut	Singular
benannt	None
Trimesters	Singular
Flugstäuben	Plural
Knäufen	Plural
kreisend	None
Nestes	Singular
erinnernd	None
schwärmend	None
Schädlingsbekämpfungsmitteln	Plural
glüh	Singular
geliebäugelt	None
Neulingen	Plural
befolgst	Singular
Standardwerken	Plural
Briefes	Singular
Stichtages	Singular
Polyphosphats	Singular
mulchend	None
pfeifend	None
gestritten	None
Bindegewebes	Singular
isolier	Singular
wachst	Singular
Blitzschlages	Singular
verlieb	Singular
Protektoraten	Plural
Hosenträgern	Plural
Büffeln	Plural
Pfifferlingen	Plural
verkackend	None
Auftragseingangs	Singular
korrespondier	Singular
Kinderbüchern	Plural
Chaot	Singular
Raumschiffes	Singular
Ziegelsteinen	Plural
getarnt	None
zugeordnet	None
plantschend	None
gelullt	None
küssend	None
schminkend	None
Fotoapparaten	Plural
anzeigend	None
schmeck	Singular
Nachträgen	Plural
Passant	Singular
Hauptsitzen	Plural
Maurern	Plural
Managementsystems	Singular
Stannits	Singular
Mineralölen	Plural
Schwede	Singular
überquer	Singular
gebrüht	None
Jahresberichtes	Singular
spar	Singular
Sitzen	Plural
Handelsname	Singular
Renners	Singular
bützet	Plural
Armeniern	Plural
Rüssels	Singular
Turbans	Singular
Gerichtshofs	Singular
Geschmacksstoffes	Singular
Golfspielern	Plural
Hartungs	Singular
flankierend	None
Pelzen	Plural
Widerständen	Plural
epilierend	None
gegraut	None
erholend	None
Geschichtenerzählers	Singular
Überschüssen	Plural
anreden	None
Übergriffen	Plural
Vergewaltigern	Plural
Epigramms	Singular
verfang	Singular
zerkratzt	None
Skorpionen	Plural
Puppenspielern	Plural
Wächters	Singular
Avatars	Singular
nominierest	Singular
erkrankst	Singular
browset	Plural
Akteurs	Singular
Funkers	Singular
Konzernumsatzes	Singular
Zweikämpfen	Plural
Frequenzbereiches	Singular
bier	Singular
Chromosoms	Singular
Pfostens	Singular
vergaltest	Singular
Bürgerrechtlers	Singular
vergeblieben	None
Gerüchen	Plural
reproduzierest	Singular
beziffernd	None
zerbrochen	None
Lehrbuches	Singular
scherzend	None
verputzest	Singular
solidarisierest	Singular
Denkens	Singular
Alterungsprozessen	Plural
Märtyrern	Plural
Dächern	Plural
fetz	Singular
grämest	Singular
Präservativs	Singular
Hörern	Plural
Katern	Plural
Gräbern	Plural
Gewächsen	Plural
Kritikern	Plural
Steppenwarans	Singular
Hüttenwerkes	Singular
Kieses	Singular
importier	Singular
Überbleibsels	Singular
Seleniden	Plural
Kunststoffen	Plural
büßend	None
geglänzt	None
bleich	Singular
Elfe	Singular
genierend	None
dirigierend	None
Olympiastadions	Singular
Körperteilen	Plural
Konkursen	Plural
gewühlt	None
einschlafend	None
Erythrozyt	Singular
Anilins	Singular
Afroamerikaners	Singular
Pokalen	Plural
Unterordnern	Plural
nähr	Singular
abgeleitet	None
pauk	Singular
freigeben	None
Opfern	Plural
Ekzems	Singular
muh	Singular
Vortrages	Singular
zusammengezogen	None
versprochen	None
Kurbades	Singular
austrinken	None
Badern	Plural
hausend	None
hinreißen	None
Temperaturbereichen	Plural
wegfahren	None
Heizelementen	Plural
Fernsehapparates	Singular
Hermaphrodit	Singular
Cermets	Singular
Silicaten	Plural
nachvollzogen	None
Segens	Singular
Eckzahns	Singular
Kriegers	Singular
laich	Singular
erlegen	None
Narkoleptikers	Singular
benimmt	Singular
sprießend	None
Kanzleramtes	Singular
gebuht	None
Pheromons	Singular
Schenkeln	Plural
Kartograph	Singular
stemm	Singular
lausch	Singular
sedierest	Singular
Stickstoffatomen	Plural
Baske	Singular
Kunsthandwerkes	Singular
gescherzt	None
angelnd	None
hingewollt	None
Achates	Singular
überwiesest	Singular
flunkerst	Singular
ertrinkst	Singular
Chelaten	Plural
Baumstammes	Singular
gemalt	None
Endergebnisses	Singular
verwesend	None
Grundnahrungsmitteln	Plural
strafend	None
Wales	Singular
crem	Singular
Doppelgängers	Singular
Höckers	Singular
sinternd	None
räumst	Singular
Fabrikaten	Plural
spezialisieret	Plural
Magiers	Singular
Aufmarsches	Singular
Datenblättern	Plural
abrunden	None
oktroyier	Singular
minderst	Singular
Salmen	Plural
Hochsprunges	Singular
Debakels	Singular
Wasserstoffatomen	Plural
zielend	None
Argumenten	Plural
Fotoalbums	Singular
Deserteurs	Singular
Stempels	Singular
Allgemeinbefindens	Singular
basierend	None
gestrahlt	None
verflieg	Singular
verarbeitend	None
ersetz	Singular
begleich	Singular
rotz	Singular
Karikaturist	Singular
knirsch	Singular
gegolft	None
grab	Singular
Energieträgers	Singular
reg	Singular
Scharbockskräutern	Plural
funktionierend	None
Affenbrotbäumen	Plural
surfst	Singular
zügelnd	None
nies	Singular
Meiern	Plural
verändernd	None
versprechend	None
Initiators	Singular
Aufwandes	Singular
tobend	None
Gefässen	Plural
Schauern	Plural
einbringend	None
ausgeliefert	None
flutend	None
Begehrens	Singular
müffelnd	None
entwässernd	None
Bannen	Plural
Stummeln	Plural
Algeriern	Plural
etikettierend	None
gefesselt	None
Programmierers	Singular
jonglierend	None
erreget	Plural
segnend	None
Passagiers	Singular
Geschwistern	Plural
Arbeitsmärkten	Plural
getunt	None
Scanners	Singular
Augenärzten	Plural
verlüdest	Singular
gipfelnd	None
gestiegen	None
gewandelt	None
besticht	Singular
beeinträchtigst	Singular
reib	Singular
umwandeln	None
Gesetzentwürfen	Plural
weggefahren	None
gerückt	None
mißlingend	None
penn	Singular
bestätigst	Singular
kabbelet	Plural
geschimpft	None
bestreitend	None
Kalbsbratens	Singular
Nachtlichtern	Plural
zögernd	None
Eiern	Plural
heulst	Singular
kniffst	Singular
Silberschmucks	Singular
preisgegeben	None
topp	Singular
gemündet	None
Karlsruhers	Singular
gefluppt	None
Erdgeschossen	Plural
ätz	Singular
Halters	Singular
Künstlern	Plural
zurückgetreten	None
Wandteppichen	Plural
raffinierend	None
grill	Singular
zaubre	Singular
getüftelt	None
Vorsitzes	Singular
versklavend	None
Datentyps	Singular
lernend	None
Reaktionspartnern	Plural
eingewickelt	None
Vorspielen	Plural
Verkehrsunfällen	Plural
Pflanzenwachstums	Singular
Auftrages	Singular
retuschier	Singular
Rohstoffen	Plural
Nachrufes	Singular
Künstlers	Singular
Athlet	Singular
nachgelassen	None
kremierend	None
Sprechchören	Plural
stationierst	Singular
Eckpfeilern	Plural
frittier	Singular
geschliffen	None
Integrals	Singular
Trisulfiden	Plural
Abschlusses	Singular
Politikwissenschaftlern	Plural
Page	Singular
elektrisierend	None
Fernsehpredigers	Singular
Werkstoffen	Plural
versunken	None
bezweifelst	Singular
penetrier	Singular
kühlst	Singular
Bedürfnisses	Singular
Aminen	Plural
begräbt	Singular
Rutheniumisotops	Singular
Bundesinnenministers	Singular
Reportern	Plural
Halbmonden	Plural
erbarm	Singular
Phytats	Singular
Kuscheltieres	Singular
Speeres	Singular
Oberschenkeln	Plural
währ	Singular
benanntest	Singular
quälend	None
aufklären	None
Zuschauers	Singular
Dornhaien	Plural
Silberblechs	Singular
tilgend	None
Zugriffsmodifikators	Singular
beschulet	Plural
tropf	Singular
bombardieret	Plural
Amtsträgers	Singular
Flusses	Singular
berußend	None
Sonnenlichts	Singular
besohlend	None
Büschels	Singular
überhol	Singular
Hieben	Plural
gehäkelt	None
polarisierst	Singular
gerudert	None
Hubschraubern	Plural
mumifizieret	Plural
Aromastoffen	Plural
geblendet	None
referier	Singular
Diplomat	Singular
Hinterbänklern	Plural
Bakteriums	Singular
Linguist	Singular
Wirkungsgrades	Singular
Claqueuren	Plural
umgelegt	None
Stativs	Singular
Norwegers	Singular
Scharlachen	Plural
Briefen	Plural
verein	Singular
geeignet	None
verschleiß	Singular
zusammenziehen	None
gratulierest	Singular
browsend	None
bräun	Singular
abgeschlagen	None
groll	Singular
Spinnern	Plural
betragend	None
vorgezogen	None
Vorräten	Plural
bewirb	Singular
Kompassen	Plural
Fürst	Singular
entthronend	None
Kaplans	Singular
Bausoldat	Singular
grifft	Plural
Italieners	Singular
geknipst	None
Fluorgehalten	Plural
Verteidigungsministers	Singular
Phenolen	Plural
probst	Singular
eingestellt	None
Umsätzen	Plural
Stegosauriers	Singular
Kohlenstoffatoms	Singular
Kumane	Singular
Trampolinen	Plural
mißbrauchend	None
Griffen	Plural
avisieret	Plural
frottier	Singular
Auskünften	Plural
Leutnants	Singular
Standardwertes	Singular
tolerier	Singular
kneif	Singular
gelöst	None
Einschlüssen	Plural
Ankerplätzen	Plural
Seeräubern	Plural
Unterarmes	Singular
bestätigend	None
Lipids	Singular
schmück	Singular
zählend	None
gerüstet	None
Bargeldes	Singular
Kurzschlusses	Singular
Nebelpardern	Plural
genervt	None
geschält	None
Bergsteigers	Singular
gelastet	None
mißbrauch	Singular
Fenneks	Singular
Äquators	Singular
Spielers	Singular
implizierst	Singular
Exzentrikers	Singular
Autofahrern	Plural
Stereotyps	Singular
Kerbels	Singular
kommunizierend	None
Zuschusses	Singular
Windschattens	Singular
Sozialarbeitern	Plural
Posaunenchören	Plural
Briefwechseln	Plural
zusammenfassen	None
Verhaltensmustern	Plural
Trabant	Singular
Halbkreisen	Plural
Orchesters	Singular
sagst	Singular
zoom	Singular
vorgestellt	None
Nierensteinen	Plural
ausdrücken	None
widerstandest	Singular
geschubst	None
Hausmeisters	Singular
fahren	None
Anions	Singular
balleret	Plural
gesteigert	None
dokumentierst	Singular
Sekretärs	Singular
Dampfschiffes	Singular
Koogs	Singular
lernen	None
gestürmt	None
Matrose	Singular
Einflusses	Singular
Prozessabläufen	Plural
Schöpfern	Plural
Fagottist	Singular
heg	Singular
vollziehet	Plural
Planetensystems	Singular
Lunden	Plural
verrätst	Singular
Vollidiot	Singular
Waffenstillstandsabkommens	Singular
Abschlägen	Plural
Kerbtieren	Plural
Gegenständen	Plural
randalierest	Singular
Glockenspielen	Plural
bedankst	Singular
Halonen	Plural
geschwänzt	None
Scheffels	Singular
Zweigeschlechtes	Singular
Finales	Singular
Überflusses	Singular
Gewächshauses	Singular
Räucheraalen	Plural
einziehen	None
beeindruckend	None
Präparaten	Plural
Kreuzworträtseln	Plural
Luftbildes	Singular
Indikativs	Singular
Schlauchbooten	Plural
Glasbläsers	Singular
Wildgänsen	Plural
Thingen	Plural
Hefepilzen	Plural
anerkennen	None
Fichtenrüsselkäfern	Plural
Bankräubers	Singular
stärkest	Singular
getötet	None
stechend	None
geheilt	None
Sarkophagen	Plural
Vorteilen	Plural
Anstrichen	Plural
Nationalist	Singular
Dienstes	Singular
Funkfeuern	Plural
gereckt	None
dinier	Singular
scannst	Singular
Darmes	Singular
Geburtsnamens	Singular
Schutzengeln	Plural
huschend	None
Dienstagabenden	Plural
betriebest	Singular
Ferkels	Singular
Pudern	Plural
dreschend	None
Einsatzbereichs	Singular
demotivier	Singular
sickernd	None
Erzengels	Singular
Lungenkrebses	Singular
Gesellschafters	Singular
mildernd	None
Landwirten	Plural
geleert	None
Delfinen	Plural
Sozialschmarotzern	Plural
entworfen	None
gegrübelt	None
gezeltet	None
irreführend	None
Schuldenschnitten	Plural
grienend	None
Baggers	Singular
Produkten	Plural
Strichern	Plural
Antriebssystemen	Plural
Hanseat	Singular
Wärtern	Plural
Anbietern	Plural
ehret	Plural
Endprodukten	Plural
Euters	Singular
entteerend	None
diskutier	Singular
fügend	None
ausgehalten	None
gaffend	None
Kadett	Singular
hex	Singular
Beweises	Singular
zumachen	None
wegfahrend	None
Kloßes	Singular
Schlachtschiffes	Singular
Seiles	Singular
Krupps	Singular
Sprüchen	Plural
gesprengt	None
Musters	Singular
gefrühstückt	None
wachet	Plural
vernichtend	None
anheben	None
betrankst	Singular
gedünstet	None
verlangst	Singular
verweilend	None
Autopilot	Singular
Parkhauses	Singular
poppend	None
abgeben	None
Krake	Singular
sink	Singular
Knöpfen	Plural
Planern	Plural
Lägern	Plural
Blöcken	Plural
Polders	Singular
Flugzeugträgern	Plural
Zerfällen	Plural
definierst	Singular
Fohlens	Singular
Baumkuchens	Singular
deal	Singular
Gurtes	Singular
Deiches	Singular
stürm	Singular
eingebaut	None
gebrauchest	Singular
begrabend	None
heftend	None
Molekülen	Plural
Alliierte	Singular
Todesfalles	Singular
egget	Plural
Wohnsitzen	Plural
Geweihen	Plural
Isobaren	Plural
korrigierend	None
Sauerstoffmangels	Singular
ableiten	None
gewiehert	None
gefunzt	None
gewütet	None
abgehakt	None
Abwässern	Plural
endgelagert	None
Olefinen	Plural
Parasols	Singular
gefaltet	None
schlürfend	None
Nadelholzes	Singular
unterwerfest	Singular
besteigst	Singular
entflieh	Singular
Hadrons	Singular
gelüftet	None
Absendern	Plural
einschalten	None
Sauerstoffatomen	Plural
gepaukt	None
Ohrringes	Singular
Quirlen	Plural
Anlegers	Singular
Amokläufen	Plural
kasernierend	None
Amarantes	Singular
Abendmahlen	Plural
Aberglaube	Singular
Zeigefingern	Plural
Telefonbüchern	Plural
geschabt	None
boß	Singular
Passagierschiffen	Plural
reagierst	Singular
Hackepeters	Singular
Rabenvätern	Plural
gemuht	None
Gebisses	Singular
zusammengefasst	None
dampfend	None
Hohlraumresonatoren	Plural
Nummernschildern	Plural
Pässen	Plural
veredelnd	None
Maurers	Singular
Bergarbeiters	Singular
schmauchend	None
stützest	Singular
futternd	None
Kations	Singular
Promotors	Singular
Zauberern	Plural
füg	Singular
christianisieret	Plural
Gegenpäpsten	Plural
Pianist	Singular
Herzmuskelgewebes	Singular
Halbfinalen	Plural
behandelst	Singular
unterwürfet	Plural
Urologe	Singular
Flugplatzes	Singular
benetzest	Singular
Nürnbergern	Plural
verfemst	Singular
Vorbildern	Plural
Asteroid	Singular
Feuerwehrmannes	Singular
Seltenerdmetallen	Plural
Drehbüchern	Plural
Verkehrsunfalles	Singular
dringend	None
Fleischers	Singular
betrinkend	None
Absolvent	Singular
Loses	Singular
Gebildes	Singular
vergräbt	Singular
bröselnd	None
Knabe	Singular
angestanden	None
verbrennst	Singular
glück	Singular
muff	Singular
Genetikern	Plural
Feuerwerkes	Singular
Anliegens	Singular
Kopfläusen	Plural
Schädlings	Singular
zubereitet	None
quer	Singular
kaschieret	Plural
Pfeilers	Singular
ex	Singular
Vorstandssprechers	Singular
Hormonen	Plural
Signallichtes	Singular
Thronen	Plural
gekommen	None
Angebers	Singular
wiederbelebt	None
kommentierend	None
substituieret	Plural
erlaubet	Plural
entrichtend	None
gewürzt	None
umarmend	None
Komplexbildnern	Plural
antichambrierend	None
Fühlern	Plural
eingeben	None
Schöffe	Singular
nachschlagen	None
Stadions	Singular
studier	Singular
spitz	Singular
etikettieret	Plural
Kühlschmierstoffen	Plural
logierend	None
Gewitters	Singular
Kernbrennstoffen	Plural
Versuchstieren	Plural
Iodes	Singular
einleben	None
lullend	None
gemästet	None
Backofens	Singular
reich	Singular
bums	Singular
changierest	Singular
Säbeln	Plural
Graten	Plural
verweisend	None
beunruhigend	None
geröntgt	None
Bruchteilen	Plural
ergibt	Singular
geschwiegen	None
Polyethylenen	Plural
gewahrt	None
Planes	Singular
Brunnens	Singular
Kugelschreibers	Singular
beschönigend	None
Glücksspielen	Plural
Fressfeinden	Plural
gelyncht	None
Sesseln	Plural
Digraph	Singular
Gauners	Singular
ausüben	None
befiehlt	Singular
Containerschiffs	Singular
Sittichen	Plural
Fotopapieren	Plural
Augenarztes	Singular
Dopings	Singular
Trolles	Singular
Ödems	Singular
Koffers	Singular
Entzuges	Singular
gekapert	None
Messwertes	Singular
verlagernd	None
verließest	Singular
geadelt	None
vertätet	Plural
übernommen	None
aufhören	None
Beteiligte	Singular
fach	Singular
Eckzähnen	Plural
Doge	Singular
glotz	Singular
Forums	Singular
gepuddelt	None
Olefins	Singular
Freisprüchen	Plural
existier	Singular
empfängst	Singular
vermindernd	None
Zitates	Singular
erschlägt	Singular
Herkünften	Plural
Ekzemen	Plural
gelogen	None
Frühsommers	Singular
Seitensprüngen	Plural
zubereitend	None
schwängest	Singular
assimilierend	None
Omnibussen	Plural
Zivilist	Singular
anhimmelnd	None
übereinstimmend	None
Drahtes	Singular
Aprilscherzen	Plural
angehoben	None
Römern	Plural
boxend	None
geboßt	None
Nationalsozialist	Singular
popelet	Plural
lamm	Singular
gedopt	None
Palindromen	Plural
Polygonen	Plural
Kriechtieren	Plural
Ständen	Plural
gefeilscht	None
meuterest	Singular
gerummelt	None
gegengezeichnet	Plural
erlebend	None
Getriebes	Singular
mahn	Singular
Beutelwölfen	Plural
verhör	Singular
Alkoholikers	Singular
Bestatters	Singular
Stöpseln	Plural
verwirrst	Singular
platzierst	Singular
gebrauchst	Singular
anzünden	None
werfend	None
entsprich	Singular
Ananassäften	Plural
Benzen	Plural
Feststoffen	Plural
Hinweises	Singular
Ärgernisses	Singular
erkennend	None
Herzogtümern	Plural
Elfers	Singular
Logikgattern	Plural
bewirbt	Singular
Verträgen	Plural
voraussetzen	None
Eisenerzes	Singular
Siegels	Singular
einflößend	None
Erzlagers	Singular
Azofarbstoffen	Plural
Feuerwehrleuten	Plural
Chören	Plural
schikanierend	None
Aufzuges	Singular
Nichtmetalloxides	Singular
Dromedaren	Plural
aufgetreten	None
betätigest	Singular
pollet	Plural
Verdienstes	Singular
gekachelt	None
abstoßen	None
konsumierend	None
Katalogen	Plural
Sonntagabends	Singular
Gemeinplätzen	Plural
Maximums	Singular
Hebeln	Plural
holest	Singular
ausgerichtet	None
Großmächten	Plural
Orchestern	Plural
Reformern	Plural
Kasache	Singular
Kalibern	Plural
Estrichs	Singular
evangelisirst	Singular
Felles	Singular
Dealers	Singular
geschmolzen	None
Großpudeln	Plural
Pecannüssen	Plural
abweichen	None
Fruchtfleisches	Singular
streif	Singular
festnehmen	None
zappelnd	None
Nürnbergers	Singular
verdammest	Singular
Abenteurern	Plural
gesiezt	None
verneinst	Singular
Siedepunkten	Plural
gewagt	None
Additiven	Plural
Weltraumes	Singular
veranschlagend	None
Anfängern	Plural
Abschiedsbriefen	Plural
misslängest	Singular
Brandteigkrapferls	Singular
Rittes	Singular
Kastanienbäumen	Plural
vertreib	Singular
Pate	Singular
klönend	None
Provokateurs	Singular
gezockt	None
Dialektes	Singular
mitkommen	None
begnügest	Singular
geprüft	None
Downers	Singular
Kirchhöfen	Plural
Legasthenikern	Plural
Kaisern	Plural
Beines	Singular
schnürend	None
Trichters	Singular
krachend	None
Chlorophylls	Singular
geflattert	None
Goldgräbern	Plural
kommst	Singular
geschauert	None
kriechend	None
futteret	Plural
gähn	Singular
versteinernd	None
Inländern	Plural
Pfades	Singular
Pfennigs	Singular
tränket	Plural
Badegästen	Plural
knips	Singular
Staatspräsident	Singular
gesäugt	None
Scharmützeln	Plural
transferierest	Singular
abgestellt	None
Fließtextes	Singular
Geisterfahrern	Plural
gezögert	None
plantsch	Singular
Tangs	Singular
Metzgern	Plural
Morphemen	Plural
magnetisierend	None
verunglimpfend	None
Bosons	Singular
streichst	Singular
Kissens	Singular
Gewichtsanteilen	Plural
Firmenname	Singular
fassend	None
geklingelt	None
Fundstücken	Plural
zügelest	Singular
Abflügen	Plural
Anionen	Plural
Schlafliedes	Singular
beschäftigst	Singular
Eigentoren	Plural
Zeltes	Singular
geschneit	None
Ikonoklast	Singular
Adjektives	Singular
wachend	None
Austauschen	Plural
Stiefsohnes	Singular
boom	Singular
Koordinatensystemen	Plural
dienet	Plural
verstorben	None
Interessent	Singular
Biokraftstoffen	Plural
Kähnen	Plural
eingeweiht	None
Gasmolekülen	Plural
bekennend	None
Fruchtsäften	Plural
fäll	Singular
verhilft	Singular
befunden	None
Effektes	Singular
Leuchtstoffen	Plural
Sicherheitsdienstes	Singular
Siegern	Plural
gedroht	None
Empfangsgeräten	Plural
geseufzt	None
Zeigefingers	Singular
Steinkauzes	Singular
Genealoge	Singular
eingegangen	None
geklickt	None
gelocht	None
Aufsteigern	Plural
Risses	Singular
wähl	Singular
Landgerichtes	Singular
zurückkehrend	None
abgesetzt	None
Profiles	Singular
Lacken	Plural
Hypochondern	Plural
Vorfahre	Singular
geregelt	None
Delfins	Singular
fröret	Plural
gelangt	Plural
pupsend	None
Einsiedlers	Singular
Psychothrillers	Singular
Hugenotte	Singular
entkriminalisier	Singular
Chores	Singular
Waschbeckens	Singular
grüßend	None
Wellblechen	Plural
Kadavern	Plural
Gewahrsams	Singular
Kugelschreibern	Plural
ejakulierend	None
Rückständen	Plural
Mitgliedes	Singular
Fullerenen	Plural
Frühsportes	Singular
getröpfelt	None
Knies	Singular
reibst	Singular
gelohnt	None
rettend	None
Arbeitsfeldern	Plural
Kampfhunden	Plural
Unwohlseins	Singular
Blumensträußen	Plural
Funkgerätes	Singular
multiplizierend	None
wandelnd	None
umarbeitend	None
knack	Singular
Afroamerikanern	Plural
Freihandels	Singular
picket	Plural
Braunbär	Singular
verleumdend	None
gemindert	None
erbringend	None
wühl	Singular
internierend	None
besänftigend	None
Scheitels	Singular
entwickelnd	None
Försters	Singular
gefiebert	None
antwortend	None
Rucksäcken	Plural
kritisierend	None
krakel	Singular
verdreifachst	Singular
Jonglierens	Singular
Sprachwandels	Singular
erschaffend	None
Luftstroms	Singular
verschlinget	Plural
Bockspringens	Singular
Bleches	Singular
randalierend	None
Schwägern	Plural
Bromatoms	Singular
Helfers	Singular
Stativen	Plural
Flugblatts	Singular
Umsatzes	Singular
Saxophons	Singular
gelinst	None
verglühend	None
heisch	Singular
hemm	Singular
ersetzend	None
jährend	None
überraschend	None
Automatikgetrieben	Plural
rußest	Singular
geteilt	None
berechtigend	None
faszinierst	Singular
Glockengießers	Singular
Kliffen	Plural
Funkens	Singular
Augur	Singular
Nachzüglers	Singular
Flussufern	Plural
Schlagers	Singular
Kreuzzeichens	Singular
Stellvertreters	Singular
zwingst	Singular
Judenrates	Singular
Likörs	Singular
bewahrend	None
Kreiseln	Plural
Hörsälen	Plural
Kampfkünsten	Plural
Mullen	Plural
abbekommen	None
speis	Singular
Kreuzfahrtschiffen	Plural
schlendernd	None
Erreichens	Singular
Standpunktes	Singular
sichernd	None
ausschließen	None
Flugzeugtriebwerken	Plural
Vorzügen	Plural
Nichtmetallen	Plural
Zwergpinguins	Singular
Einblicken	Plural
Ackers	Singular
Phospholipids	Singular
zusammenbrechen	None
gelangweilt	None
Intervalls	Singular
Datensatzes	Singular
Belegen	Plural
entwaffnend	None
pellend	None
Baders	Singular
abnehmen	None
Auswanderers	Singular
Propionaten	Plural
schmeichelnd	None
gedisst	None
Ehrenmorden	Plural
Alkylhalogeniden	Plural
Überläufers	Singular
übernimmt	Singular
aufhalten	None
geschlagen	None
ball	Singular
Kämpfers	Singular
Kohyponyms	Singular
Isomeren	Plural
Hakenkreuzen	Plural
Scherge	Singular
Berglandes	Singular
Ukrainern	Plural
Quadraten	Plural
Bündnissen	Plural
Gemüsehändlers	Singular
stützend	None
dünstend	None
gebootet	None
gefrickelt	None
verzichtend	None
Lipiden	Plural
Straßenpflastern	Plural
Zyklop	Singular
freust	Singular
Statist	Singular
Rumpfes	Singular
designierend	None
Deckmantels	Singular
verhandelst	Singular
Spitzenkandidat	Singular
beruhend	None
Tieflandes	Singular
Aktienmarktes	Singular
Schrägstrichen	Plural
übermittelest	Singular
geparkt	None
vereinbar	Singular
gejammert	None
eingebracht	None
Kardinals	Singular
getagt	None
verratend	None
Haltepunktes	Singular
Azteke	Singular
gewärtig	Singular
erlass	Singular
abwiegen	None
Deliktes	Singular
gedrillt	None
jag	Singular
geforscht	None
Vestibüls	Singular
Lokalen	Plural
Schlummers	Singular
deckend	None
gekniffen	None
Erziehers	Singular
erwirb	Singular
Hörspielen	Plural
gegründet	None
Sermones	Singular
hergehört	None
Teilnehmern	Plural
Fußballspielers	Singular
beeindruck	Singular
miß	Singular
klammer	Singular
malmend	None
einlegen	None
föhnend	None
Jägers	Singular
Graveurs	Singular
Donnerstagvormittags	Singular
gedeucht	None
Germanist	Singular
Lagergeldern	Plural
umgesetzt	None
Pflugscharen	Plural
irreführen	None
bedienend	None
Jupitermonden	Plural
Ablasses	Singular
verstürbest	Singular
subventionier	Singular
Proxyservern	Plural
übertriebet	Plural
erpressend	None
verkrustend	None
Zusätzen	Plural
würfelnd	None
pressierst	Singular
Einstürzen	Plural
Atomen	Plural
geströmt	None
reichst	Singular
reflektierend	None
Säers	Singular
Weltfriedens	Singular
schlepp	Singular
manipulierst	Singular
gealtert	None
Experte	Singular
duzend	None
applicier	Singular
amenagier	Singular
Schillen	Plural
Wikipedianers	Singular
gehallt	None
marschier	Singular
kollernd	None
Schlesiern	Plural
Böttchers	Singular
dolmetsch	Singular
Flusswassers	Singular
ahnend	None
systematisierend	None
konzentrieret	Plural
Haushalten	Plural
Alkinen	Plural
Koalitionspartnern	Plural
Chauvinist	Singular
Almanachs	Singular
Atomkernen	Plural
patentierend	None
installier	Singular
vollzogt	Plural
minderet	Plural
Rekordes	Singular
Analphabet	Singular
Gebräuchen	Plural
Pigmenten	Plural
Polygons	Singular
geneckt	None
gestickt	None
Messbechers	Singular
umgestiegen	None
Wasserstoffantriebes	Singular
aufrichtend	None
Kaffeeweißers	Singular
Vorstoßes	Singular
anschnallend	None
hervorgerufen	None
Balkons	Singular
verschreibend	None
scharrend	None
Horrors	Singular
Zahnschmelzes	Singular
Cytochromen	Plural
Rücksprüngen	Plural
Gastarbeitern	Plural
sperr	Singular
dampf	Singular
kommerzialisierend	None
tagend	None
pulsierend	None
ansteigen	None
gehofft	None
wirkend	None
Umfeldern	Plural
Bleistiften	Plural
Bergführern	Plural
gebrütet	None
Bräutigams	Singular
Baldachinen	Plural
gewehrt	None
abgereist	None
Heimspielen	Plural
Muttersprachlern	Plural
Vertrieben	Plural
Türke	Singular
befändet	Plural
Mikrometern	Plural
gelierend	None
billigst	Singular
nebelest	Singular
geändert	None
Kurses	Singular
beziehet	Plural
Basten	Plural
verdrießend	None
geröstet	None
geschürft	None
freigelassen	None
monogrammierend	None
belagernd	None
Alarmen	Plural
getrieben	None
Sadist	Singular
abdecken	None
gespeichert	None
bekannt	None
hinkend	None
Einfallsreichtums	Singular
Stierkampfes	Singular
anschnallen	None
brüskierend	None
fetzst	Singular
Finanzministers	Singular
Kranichen	Plural
installierend	None
einbauen	None
Schlüffen	Plural
erstehend	None
Mordes	Singular
verformend	None
Abfertigungsgebäuden	Plural
verpuppet	Plural
zugehend	None
Staunens	Singular
zugefügt	None
migrierend	None
chiffrier	Singular
Atheist	Singular
partitionier	Singular
Marschällen	Plural
entheiligest	Singular
Aufsatzes	Singular
Anrufbeantwortern	Plural
Abgases	Singular
Pulten	Plural
interessier	Singular
treibend	None
geschummelt	None
Anzuges	Singular
legst	Singular
Kultusministers	Singular
boomest	Singular
abgeblitzt	None
Akteuren	Plural
verbleibend	None
erwerbet	Plural
Posters	Singular
geschimmelt	None
kartographierend	None
Psychologe	Singular
Peptids	Singular
Daumens	Singular
Wedels	Singular
Deist	Singular
geschlissen	None
penetrierend	None
kampierend	None
Auftragsmördern	Plural
gezuckert	None
Anzeigegeräten	Plural
Schüben	Plural
zerdeppernd	None
zerkreuzend	None
Fernsehbildern	Plural
Adventes	Singular
Spieltagen	Plural
Schlossern	Plural
verschlänget	Plural
haar	Singular
gepflügt	None
fiepend	None
Arsenosacchariden	Plural
Magenkrebsen	Plural
bescherend	None
gekränkt	None
vermerk	Singular
nütz	Singular
Brennern	Plural
Konklaves	Singular
gelehnt	None
oktroyierest	Singular
löffelnd	None
zurücktreten	None
Anteiles	Singular
Freiburgern	Plural
Genitivs	Singular
grenzend	None
Gels	Singular
Basalten	Plural
aufstellen	None
gezeugt	None
Präparators	Singular
faszinieret	Plural
beteiligend	None
aalest	Singular
Rasterkraftmikroskops	Singular
Lignins	Singular
Wohngebieten	Plural
geschwindelt	None
Feuerwerkskörpern	Plural
Schachtelhalmen	Plural
anhängen	None
klingst	Singular
unterstricht	Plural
Wärters	Singular
freuet	Plural
Weihnachtsbaumes	Singular
Datenbankmodells	Singular
Salzes	Singular
Gasthauses	Singular
Bundesfinanzministers	Singular
Sperlings	Singular
Falzes	Singular
Verfassungsgerichtes	Singular
Untern	Plural
geplatscht	None
graus	Singular
Knusten	Plural
Käfigen	Plural
servierend	None
Aktivist	Singular
Membranpotentials	Singular
angefochten	None
begibt	Singular
Elektrofahrzeugen	Plural
gemümmelt	None
Leuchttürmen	Plural
klon	Singular
Kirchturmes	Singular
Arbeitnehmern	Plural
Stockes	Singular
Fahrgestellen	Plural
beinhaltend	None
Umrisses	Singular
replicirst	Singular
schanghai	Singular
Jahrtausends	Singular
rauf	Singular
durchwühlend	None
gelabert	None
Grießen	Plural
Kratzern	Plural
Bowdenzuges	Singular
Formant	Singular
Märtyrers	Singular
Dateiname	Singular
Kandidat	Singular
innehalten	None
Postamtes	Singular
Entkommens	Singular
beäugend	None
Massenprozentes	Singular
Vorschlägen	Plural
Investors	Singular
Urbaren	Plural
mutierend	None
gelauert	None
trauerst	Singular
eröffnend	None
nächtiget	Plural
Werdens	Singular
Abklatschen	Plural
Befürworters	Singular
Kannibale	Singular
Epitaphs	Singular
Bilderbuches	Singular
gemustert	None
eingenommen	None
Hodens	Singular
Umspannwerkes	Singular
Eiskunstläufern	Plural
benimmst	Singular
krepierend	None
Emiren	Plural
Autorennens	Singular
gepredigt	None
Hölzchens	Singular
Müllers	Singular
Geschehens	Singular
keuchend	None
plündernd	None
getrampelt	None
verbaselnd	None
Kettenblättern	Plural
Schwänen	Plural
Mineralen	Plural
Reformers	Singular
Blechteilen	Plural
Sprichwortes	Singular
schotternd	None
Auftraggebers	Singular
Garant	Singular
gesurft	None
Zeichnern	Plural
Zauberers	Singular
Neolithikums	Singular
Diplomen	Plural
Feldversuchen	Plural
dechiffrierest	Singular
gedenket	Plural
Donners	Singular
verweis	Singular
Litauern	Plural
Karlchens	Singular
geklatscht	None
Farmers	Singular
geleistet	None
acetylier	Singular
Laiben	Plural
Horten	Plural
Ermittlers	Singular
strukturier	Singular
Ärzteblattes	Singular
verzweigst	Singular
Bräuchen	Plural
Wirtschaftszweigen	Plural
Reinstoffes	Singular
Ägypters	Singular
gescannt	None
Sockels	Singular
Astronom	Singular
Pigmentes	Singular
beantragend	None
Luftschlägen	Plural
abtragen	None
Handlesens	Singular
Gewindestiftes	Singular
geprobt	None
Schusswechsels	Singular
Brettspielen	Plural
japsest	Singular
Phantoms	Singular
Versen	Plural
modifizierest	Singular
Karthagern	Plural
downgeloadet	None
behältst	Singular
interagierst	Singular
idealisier	Singular
Hobeln	Plural
Landgerichten	Plural
Intervallen	Plural
Gewichten	Plural
gehastet	None
Lieblingen	Plural
verbogst	Singular
holst	Singular
rüg	Singular
reih	Singular
geschweißt	None
verzögernd	None
eingreifend	None
Goldräuschen	Plural
Centers	Singular
gerammt	None
Inkrafttretens	Singular
Verehrers	Singular
Paradoxons	Singular
Signalen	Plural
Gesellschaftern	Plural
gehievt	None
Fußballspielen	Plural
entsprochen	None
gepatzt	None
angetan	None
Häuschens	Singular
mehr	Singular
gedeckt	None
Salzen	Plural
prickelnd	None
Laboratoriums	Singular
erweckst	Singular
Bundesräten	Plural
fühlest	Singular
einsetzend	None
konfigurierest	Singular
Grinden	Plural
nachlassen	None
verschon	Singular
Konzerthäusern	Plural
Pennys	Singular
verzehrend	None
schüttend	None
Streikgeldes	Singular
eingegeben	None
Verkehrsflugzeuges	Singular
Boddens	Singular
Volltexten	Plural
nominierend	None
Gehäusen	Plural
Olympiasiegern	Plural
stockend	None
Lammfellhandschuhs	Singular
lull	Singular
Erkers	Singular
Drahtseilen	Plural
missverstehst	Singular
rezitieret	Plural
schupp	Singular
kriech	Singular
Wärmetauschern	Plural
stationierend	None
fühlend	None
Urgroßvaters	Singular
ramm	Singular
Vermögens	Singular
Kumpels	Singular
Einfaltspinsels	Singular
Giebeln	Plural
doppelnd	None
Brennelementen	Plural
Geflügels	Singular
quantisierend	None
Kürbissen	Plural
Vorläufern	Plural
gehustet	None
Hechten	Plural
Aristokrat	Singular
erträgt	Singular
genagelt	None
Bäuchen	Plural
Hellsehers	Singular
ausgeführt	None
Benehmens	Singular
Berbers	Singular
Söhnen	Plural
folgend	None
popp	Singular
Schnorcheln	Plural
vorgelesen	None
formulierst	Singular
verschlimmernd	None
geschossen	None
reinigend	None
kühlend	None
informierend	None
Ulmers	Singular
schimpf	Singular
Musketieren	Plural
Einzügen	Plural
Weltmarktes	Singular
Grönländern	Plural
Kompasses	Singular
gemogelt	None
Marktplätzen	Plural
Berichterstattern	Plural
vorhergesagt	None
abgenutzt	None
Naturstoffen	Plural
kommend	None
klemm	Singular
Spielen	Plural
gemerkt	None
Kriegern	Plural
Wohnheimen	Plural
paukst	Singular
Vorreitern	Plural
nächtigend	None
erlagt	Plural
Friedensnobelpreises	Singular
Fühlers	Singular
trampelet	Plural
Lieferant	Singular
beschissest	Singular
Schäfern	Plural
angelegt	None
Pflegers	Singular
gemessen	None
Hummern	Plural
Musikantenwagens	Singular
Eintrages	Singular
Wellenlängenbereichen	Plural
Kindergeldes	Singular
Thioesters	Singular
stopfend	None
Exporteurs	Singular
Italienern	Plural
Digitalisats	Singular
Inhaltes	Singular
Adlers	Singular
Hörnern	Plural
absolvierend	None
Hafermehlen	Plural
geordert	None
Attentaten	Plural
Doppels	Singular
Blumentöpfen	Plural
Schlafmittels	Singular
gekippt	None
Schränken	Plural
Tumulten	Plural
süß	Singular
Proteinen	Plural
substituierst	Singular
panaschierend	None
vermäßest	Singular
duschend	None
bepflanzend	None
gelungen	None
Ermittlungsverfahrens	Singular
destillierest	Singular
windend	None
Abschnitts	Singular
Hochstaplern	Plural
Abfalls	Singular
schnurr	Singular
zuordnen	None
Regenpfeifern	Plural
Geheimdienstes	Singular
Agitators	Singular
gesiegt	None
Held	Singular
gestrickt	None
Kunstwerken	Plural
Roteisensteins	Singular
Spielautomat	Singular
Gelenkes	Singular
Bildungsromans	Singular
gepfändet	None
Blitzschlägen	Plural
Kalmaren	Plural
Trägern	Plural
Scherzes	Singular
knüpfest	Singular
geatmet	None
gerb	Singular
Dorschen	Plural
legalisierend	None
segelnd	None
knitternd	None
Verbrauchers	Singular
Zwergen	Plural
erstochen	None
reglementierst	Singular
werft	Plural
geächtet	None
Hochstaplers	Singular
kondensierend	None
Glockenspiels	Singular
erhellst	Singular
Benutzernamens	Singular
Töpfen	Plural
Spaniern	Plural
Distrikten	Plural
Jahrtausenden	Plural
Kommunarde	Singular
Einzelgängers	Singular
gedenk	Singular
picknick	Singular
Schlosses	Singular
Exemplaren	Plural
obsend	None
explizierend	None
geschaukelt	None
wetzest	Singular
Textils	Singular
Zaines	Singular
Käufern	Plural
Kulten	Plural
Wuchses	Singular
debattier	Singular
abgewiesen	None
simsend	None
Kriegsendes	Singular
Hausens	Singular
pustend	None
Bettelstabes	Singular
Attentäters	Singular
Nachweises	Singular
gedämpft	None
Wasserrädern	Plural
Finanzministeriums	Singular
bestrahlend	None
interpolierend	None
etikettierest	Singular
aufwachend	None
Häuten	Plural
interpretierst	Singular
warft	Plural
schlicht	Plural
aufregend	None
weißend	None
Importeuren	Plural
Spießern	Plural
Lügnern	Plural
Komet	Singular
salutierest	Singular
Alkaloiden	Plural
aufgeatmet	None
geschmirgelt	None
würgend	None
vollzöget	Plural
Morphems	Singular
Kerosins	Singular
Supermärkten	Plural
Elektrikers	Singular
Wahlprogrammen	Plural
trauernd	None
Bestsellers	Singular
kotend	None
vergreis	Singular
Graveuren	Plural
Geldscheinen	Plural
nick	Singular
wimmelnd	None
Homöopath	Singular
Hinterhöfen	Plural
vergraulst	Singular
jobbest	Singular
Gemüsehändlern	Plural
dürft	Plural
parkend	None
Ausbauen	Plural
Halophyt	Singular
lenk	Singular
Berbern	Plural
Nennwertes	Singular
gerechnet	None
Carbenen	Plural
Gens	Singular
würdet	Plural
Gewichthebens	Singular
Alaunen	Plural
Stammlagern	Plural
konnotierend	None
zerknitternd	None
rennend	None
Klonen	Plural
zwing	Singular
Geisterstädten	Plural
stillend	None
wetzend	None
ernannt	None
verdrängend	None
Mönches	Singular
geknüpft	None
verfolgst	Singular
Xylems	Singular
romantisierend	None
vorbeugen	None
Montagmittagen	Plural
Windhunden	Plural
Fischbeständen	Plural
Walmdaches	Singular
Dissident	Singular
Stürmers	Singular
fortpflanzen	None
kritisierst	Singular
beschwerend	None
erdrückend	None
übergebest	Singular
Quelltexten	Plural
Gemäldes	Singular
Alkohols	Singular
Dampferzeugers	Singular
entschliefet	Plural
Teufels	Singular
los	Singular
verjüngend	None
Arzneimittels	Singular
Kurzschlüssen	Plural
neckend	None
Souveränen	Plural
eil	Singular
Tiegels	Singular
Ozeanen	Plural
Gedichten	Plural
Fechters	Singular
Buckeln	Plural
Doppelzimmern	Plural
Streifzügen	Plural
dehn	Singular
Wohngebietes	Singular
Silikonen	Plural
Hinterzimmers	Singular
miss	Singular
Zungenbeinen	Plural
kupier	Singular
Schneepfluges	Singular
Dämmen	Plural
Hackern	Plural
Anstieges	Singular
Griffeln	Plural
Metallteiles	Singular
sagend	None
besteuernd	None
chattend	None
eingefallen	None
Pilgers	Singular
überweiset	Plural
ausrottend	None
Tätern	Plural
zurückhaltend	None
Telluriden	Plural
Inertialsystems	Singular
Hokuspokussen	Plural
Betrachters	Singular
küss	Singular
sexelnd	None
entschleiernd	None
Impfstoffes	Singular
Bussen	Plural
Freimaurern	Plural
stau	Singular
umgeschmolzen	None
Frikativen	Plural
Wattenmeeren	Plural
benetzend	None
geholt	None
befrei	Singular
Referent	Singular
Bolzens	Singular
Alkoholen	Plural
versüßend	None
Buchhalters	Singular
gemalmt	None
gedrängt	None
Tongaern	Plural
Schneidwerkzeugen	Plural
Anwachsens	Singular
Flötist	Singular
Chilene	Singular
lik	Singular
tappend	None
gemehrt	None
Gegensätzen	Plural
Einwurfes	Singular
Elektronenpaaren	Plural
fahrend	None
anweisend	None
Bindungspartnern	Plural
ausgelassen	None
Gelegen	Plural
Vorwürfen	Plural
Marschalls	Singular
Dosenöffnern	Plural
beherrschst	Singular
Fahrplänen	Plural
gekreist	None
Rundfunkgeräten	Plural
geboxt	None
erhöhst	Singular
Nichteisenmetallen	Plural
rag	Singular
umbringend	None
Rohlings	Singular
Frosches	Singular
vertu	Singular
Äckern	Plural
Gewehres	Singular
geimpft	None
geprügelt	None
demonstrieret	Plural
Gewittern	Plural
Selenit	Singular
finanzier	Singular
Schlitzes	Singular
Zoologe	Singular
Protestes	Singular
ernanntest	Singular
geerbt	None
geschlüpft	None
entfern	Singular
einbrechen	None
dräng	Singular
gesagt	None
Waldbrandes	Singular
demoralisierst	Singular
Stellenwertes	Singular
Gewürzen	Plural
Vorhanges	Singular
japp	Singular
raubend	None
Ammoniaks	Singular
Ausrutschern	Plural
gemeckert	None
Krankheitsfällen	Plural
Flügels	Singular
grien	Singular
geeiert	None
Maschinenräumen	Plural
überschätz	Singular
Preises	Singular
gebessert	None
Fischermarders	Singular
unterdrücket	Plural
Schiffskörpers	Singular
gesplittert	None
Papieren	Plural
Polymers	Singular
Katamaranen	Plural
Berufen	Plural
verwundernd	None
Stoffwechselweges	Singular
eingeordnet	None
Parkplätzen	Plural
unterworfen	None
Privatlebens	Singular
ölend	None
hüpf	Singular
Belages	Singular
wassernd	None
gedurft	None
Hausschafen	Plural
brünierst	Singular
gezerrt	None
karikierend	None
Isländers	Singular
Zwangsarbeiters	Singular
Sprunggelenks	Singular
einreichen	None
industrialisierend	None
Spieles	Singular
abweichend	None
Psychotherapeut	Singular
Freiern	Plural
turn	Singular
pell	Singular
Einverständnisses	Singular
trau	Singular
Ibissen	Plural
erweiternd	None
zipp	Singular
gerunzelt	None
akzeptier	Singular
Jochbeinen	Plural
verdorben	None
grinsend	None
Austragungsortes	Singular
Hartungen	Plural
reimst	Singular
beholfen	None
Erdölprodukten	Plural
gesputet	None
bereinigend	None
gekrabbelt	None
schilderst	Singular
verfüg	Singular
ausrotten	None
ausführend	None
Kontextes	Singular
Zwergschwänen	Plural
balancier	Singular
Restaurators	Singular
Sonntagnachmittags	Singular
ernüchternd	None
behilft	Singular
Verwaltungsakten	Plural
fisch	Singular
Giftmordes	Singular
glasierend	None
untergeschrieben	None
kontaktierest	Singular
gewähr	Singular
Hurrikans	Singular
gerettet	None
marschierend	None
Erzpriesters	Singular
leim	Singular
Präsidiums	Singular
Hohlleitern	Plural
erzogst	Singular
lenkst	Singular
geschleimt	None
Namensvetters	Singular
Bleichmitteln	Plural
einlebend	None
Sklave	Singular
stibitz	Singular
Prophet	Singular
falzest	Singular
schirm	Singular
misslungen	None
Behüters	Singular
Bundesgerichtshofes	Singular
Permanentmagneten	Plural
beschulst	Singular
enthauptend	None
beruhst	Singular
vorhersagen	None
Atems	Singular
gewalzt	None
Spitzers	Singular
frottierest	Singular
Aluminats	Singular
Scharmützels	Singular
nagelnd	None
verheimlichend	None
Bandabständen	Plural
Genkinits	Singular
Kartons	Singular
Haltern	Plural
requirierend	None
Stränden	Plural
Heiles	Singular
angebracht	None
geschaufelt	None
Direktors	Singular
Erbgutes	Singular
Duftstoffen	Plural
verzeigend	None
vermöchtet	Plural
Gaumens	Singular
gelaicht	None
Stranges	Singular
Asthmamitteln	Plural
Kriegsschauplatzes	Singular
Parallelogramms	Singular
Sozialamtes	Singular
Fahrradfahrern	Plural
gebappt	None
etiolier	Singular
Altarmen	Plural
Rednern	Plural
Stoffwechselprodukten	Plural
notier	Singular
Heilmitteln	Plural
Rummels	Singular
Strukturproteinen	Plural
Stammlagers	Singular
mutier	Singular
Sockeln	Plural
Fernstudiums	Singular
Oberbegriffen	Plural
Gebirges	Singular
Vorbildes	Singular
Alkoholikern	Plural
Tonmineralen	Plural
Skorpions	Singular
Inhabers	Singular
gesät	None
seihst	Singular
Schächten	Plural
freisprechen	None
gestaltend	None
frappierend	None
verschleiernd	None
nachgesagt	None
flens	Singular
Entschlusses	Singular
grün	Singular
zusammengebrochen	None
Schlafsälen	Plural
Datasets	Singular
Präsidentschaftskandidat	Singular
Rauchern	Plural
verjünget	Plural
Holunders	Singular
Drängen	Plural
geflutet	None
Kompromisses	Singular
Bossen	Plural
Mondfinsternissen	Plural
hemmend	None
geblökt	None
hinausgeragt	None
ionisierst	Singular
Gouverneurs	Singular
provozierst	Singular
abgestoßen	None
Sichtgeräten	Plural
Metallurg	Singular
gepriesen	None
begangen	None
acetylierend	None
fixieret	Plural
Verzeichnisdienstes	Singular
Gasplanet	Singular
Freiers	Singular
besorg	Singular
Kubikmetern	Plural
Vorfahr	Singular
Mageninhalten	Plural
Trichloriden	Plural
Sattlern	Plural
Mangrovenwäldern	Plural
verspeisend	None
Spielzeugen	Plural
wispernd	None
entsprachst	Singular
erwähnst	Singular
Messgeräten	Plural
vorgekommen	None
bombardierest	Singular
wäg	Singular
Schildläusen	Plural
Absiedlern	Plural
Wandgemäldes	Singular
patzend	None
Gedankens	Singular
Märchenbüchern	Plural
demütigend	None
Vorurteils	Singular
entgleisend	None
Gerbers	Singular
offenbar	Singular
Glasgerätes	Singular
entstammend	None
Mönchen	Plural
bemerkst	Singular
Kriegszustandes	Singular
Motorbooten	Plural
Android	Singular
Bleiglases	Singular
Nährmediums	Singular
gepinkelt	None
betrachtend	None
illustrierend	None
Handwerkes	Singular
feilbieten	None
beaufsichtigend	None
Saphiren	Plural
Schmierstoffen	Plural
Rittern	Plural
spiegelnd	None
tanzend	None
abgebremst	None
Kastenwagens	Singular
Trichtern	Plural
Verführers	Singular
bestehlend	None
nervst	Singular
Häuptlingen	Plural
demonstrierst	Singular
Freiberuflern	Plural
frierend	None
Verkehrsmitteln	Plural
Kopftüchern	Plural
Gesichtspunkten	Plural
Gases	Singular
bestehend	None
Trainers	Singular
übertreibest	Singular
zugegangen	None
gemeuchelt	None
Bayers	Singular
Pedant	Singular
umgebracht	None
auftauchend	None
vibrierend	None
bezichtig	Singular
beigelegt	None
Alls	Singular
Geldgebers	Singular
Verstärkern	Plural
Beinen	Plural
Pressesprechers	Singular
Domen	Plural
ausrichten	None
Stierkämpfen	Plural
Appells	Singular
Parkinsons	Singular
Verlangens	Singular
Arsenmonosulfiden	Plural
Peruanern	Plural
Weißbart-Ameisenwürgers	Singular
Nebenprodukten	Plural
beigebracht	None
Sieben	Plural
Biotops	Singular
rummelst	Singular
Fragestellen	None
reduzierst	Singular
schwenkend	None
erhebst	Singular
erklingend	None
lenkend	None
akzeptierst	Singular
schnatternd	None
geniesset	Plural
Belten	Plural
Renderers	Singular
Tragflügelbooten	Plural
kommentierst	Singular
vermittelet	Plural
gar	Singular
Ausstieges	Singular
Siedepunktes	Singular
genäht	None
Geburtsname	Singular
Glasspiegeln	Plural
Knechten	Plural
Zebraameisenwürgers	Singular
gesattelt	None
rostend	None
ändernd	None
Maschinengewehres	Singular
Granatapfels	Singular
angezeigt	None
Signales	Singular
schiel	Singular
Schleppers	Singular
einräumend	None
Gänsebratens	Singular
bereitgestellt	None
erfunden	None
Mathematikern	Plural
gesprenkelt	None
beeil	Singular
Rahmens	Singular
schieb	Singular
Phänomens	Singular
Hirnschädels	Singular
gefeilt	None
gechattet	None
vergrubst	Singular
Hydroxylapatiten	Plural
Zirkels	Singular
Hartkäses	Singular
Zelten	Plural
eingereicht	None
Planers	Singular
Anstoßes	Singular
Turmfalke	Singular
Flippern	Plural
hinrichtend	None
Berufes	Singular
Esels	Singular
Kurzzeichens	Singular
Chorals	Singular
Schreines	Singular
nachgewiesen	None
beschieß	Singular
aufbewahren	None
eingeschaltet	None
Trankes	Singular
sperrend	None
Gabelstaplern	Plural
Namensvorschlägen	Plural
Fahrern	Plural
Isländern	Plural
gemüffelt	None
gezählt	None
herrsch	Singular
gefolgert	None
gefühlt	None
Stützrädern	Plural
fusionierst	Singular
Eiters	Singular
stampf	Singular
erscheinst	Singular
Eisennägeln	Plural
erhoffend	None
gras	Singular
Speicherkraftwerken	Plural
aufschieben	None
keif	Singular
Süßwasserfischen	Plural
Knüppels	Singular
aufsuchen	None
befürchtend	None
Rauben	Plural
verbleiend	None
berücksichtigst	Singular
türmest	Singular
behält	Singular
ausgesagt	None
Briefträgers	Singular
Bezuges	Singular
gedroschen	None
bequemest	Singular
limitierend	None
geflossen	None
Emails	Singular
getappt	None
Gedächtnisses	Singular
zermatschend	None
hehl	Singular
geschwankt	None
Helikoptern	Plural
ausschütteln	None
wisch	Singular
hupend	None
rollend	None
trällernd	None
schleudernd	None
auslassen	None
frustrierend	None
gehasst	None
Nasenbär	Singular
Rasenmähern	Plural
geglitten	None
erbend	None
gemeldet	None
Aufkommens	Singular
bemerket	Plural
staubsauget	Plural
Düngers	Singular
hicks	Singular
Großvätern	Plural
Blutfarbstoffs	Singular
Dilettant	Singular
Plänen	Plural
ertön	Singular
schwinget	Plural
ausreichen	None
Trinkers	Singular
erläuteret	Plural
Außenministern	Plural
ehelich	Singular
Wirtschaftswissenschaftlern	Plural
getanzt	None
abschließen	None
Garnes	Singular
mutieret	Plural
gemildert	None
kamst	Singular
gefeiert	None
Kapitänen	Plural
Panters	Singular
Autoverkehrs	Singular
fütterst	Singular
porträtier	Singular
Kumpeln	Plural
Verfassungsgerichten	Plural
Ergüssen	Plural
blinkend	None
Grünspechtes	Singular
Stängeln	Plural
schiffst	Singular
anhabend	None
Doppeldeckers	Singular
knallend	None
verzier	Singular
gefahren	None
Tausches	Singular
Quadrant	Singular
Knechtes	Singular
absetzen	None
beredend	None
nachlassend	None
geniessend	None
Computern	Plural
Richters	Singular
stattfindend	None
Aktienkurses	Singular
Rotweinen	Plural
Verbundes	Singular
Marxist	Singular
Ministeriums	Singular
Rotscheitelreihern	Plural
Nationalspielern	Plural
Basaren	Plural
ragst	Singular
Führern	Plural
Kiefernholzes	Singular
geärgert	None
fertig	Singular
summest	Singular
Richtern	Plural
verschmelzest	Singular
faschierest	Singular
lügst	Singular
Teslas	Singular
Hundeführers	Singular
Wohnzimmers	Singular
Zugriffes	Singular
Geschirrspülern	Plural
knüpfend	None
ausbreiten	None
Binnenlandes	Singular
scharr	Singular
lieferst	Singular
Dorfbewohnern	Plural
erfüllend	None
entwischend	None
erklärst	Singular
marternd	None
Brutparasit	Singular
Sulfonamiden	Plural
Mikrokristallen	Plural
fluchend	None
Betriebes	Singular
geeitert	None
Avantgarde-Künsten	Plural
Exemplars	Singular
zwitschernd	None
Vorbaus	Singular
loch	Singular
Umschlages	Singular
erübrig	Singular
Übels	Singular
dring	Singular
Schulze	Singular
Feldzügen	Plural
dekompilieret	Plural
strapazieret	Plural
Hammels	Singular
Einwanderers	Singular
grübelnd	None
Kernes	Singular
Plagiaten	Plural
aufnehmen	None
nanntet	Plural
Zirconiumkomplexen	Plural
pflegst	Singular
hüllend	None
Greises	Singular
Phosphatgesteines	Singular
Mustern	Plural
Seeadlers	Singular
Disulfits	Singular
verworfen	None
abhalten	None
servier	Singular
einräumen	None
geschwächt	None
Grenzfällen	Plural
Synonymen	Plural
eingegriffen	None
Schäumen	Plural
geschludert	None
anprangern	None
bestiehlt	Singular
Lippenstiften	Plural
gefummelt	None
Hörspiels	Singular
Schneefällen	Plural
Abbaues	Singular
Trögen	Plural
gestreichelt	None
Kreationist	Singular
gaff	Singular
Helmes	Singular
globalisierend	None
ableitend	None
gebürstet	None
stillst	Singular
Passes	Singular
steigerst	Singular
Verbotes	Singular
Medienwissenschaftlern	Plural
Gasthöfen	Plural
Chirurg	Singular
dämm	Singular
Brauches	Singular
Endproduktes	Singular
Elektroingenieurs	Singular
frottierend	None
Synonyms	Singular
Übeln	Plural
Kraftfahrzeuges	Singular
genährt	None
Stilllebens	Singular
Maure	Singular
Divises	Singular
Perihels	Singular
angenommen	None
Abhörverbrechers	Singular
legend	None
Chalkogenids	Singular
Brennstoffes	Singular
Isotopen	Plural
Schwirrhölzern	Plural
verdunstend	None
schwäret	Plural
Bosses	Singular
abbauen	None
Wirtschaftswissenschaftlers	Singular
gefällt	None
Mobilfunknetzes	Singular
krach	Singular
gesündigt	None
Gewindes	Singular
Ansatzes	Singular
Südkoreaners	Singular
Erpressers	Singular
anerkannt	None
gepflanzt	None
räsonierend	None
Masters	Singular
durchquerend	None
markier	Singular
Vergleichen	Plural
Bergfink	Singular
Bebauungsplänen	Plural
Nachtfaltern	Plural
Einzelnachweisen	Plural
Flügen	Plural
Sultanaten	Plural
Mehlen	Plural
Verkehrsmittels	Singular
gestreckt	None
Platinoids	Singular
Sprachratgebern	Plural
widmend	None
Rabbinern	Plural
erhöhend	None
Gladiators	Singular
Sandsteinen	Plural
hinnehmen	None
Feldzuges	Singular
klopfet	Plural
Kreisläufen	Plural
vergibt	Singular
verfügst	Singular
gewertet	None
Schweigens	Singular
ziel	Singular
zischet	Plural
Holländers	Singular
Schädeln	Plural
absondern	None
fließend	None
bugsier	Singular
zerfielt	Plural
Marmors	Singular
Rosenkriegen	Plural
Leopard	Singular
Achteln	Plural
Graphs	Singular
Asiate	Singular
Hexern	Plural
Bezirken	Plural
Sprengstoffes	Singular
changierend	None
Ferredoxinen	Plural
Segelschiffen	Plural
favorisierend	None
Sedimentgesteinen	Plural
gebettet	None
abstellend	None
gepaart	None
verletzend	None
nachgeschlagen	None
anschauend	None
überständet	Plural
gewärmt	None
entwirrend	None
Tierschützern	Plural
tüftelnd	None
Komplexions	Singular
küsset	Plural
bereust	Singular
applicierend	None
Intendant	Singular
schnitz	Singular
ackerst	Singular
Hologramms	Singular
fingieret	Plural
verdummend	None
Gefieders	Singular
Gewürzes	Singular
Rächers	Singular
Außenwänden	Plural
gegrunzt	None
Hysterikers	Singular
gestikulierend	None
Universums	Singular
versauend	None
Faunen	Plural
kollabierend	None
Bundesverbänden	Plural
Gemisches	Singular
duftend	None
Sonetten	Plural
geklappt	None
Niedergangs	Singular
getrommelt	None
blätternd	None
Rußen	Plural
Kachelofens	Singular
Schweizers	Singular
Grates	Singular
Pentagramms	Singular
vollziehend	None
Motiven	Plural
angemacht	None
Abszessen	Plural
säuft	Singular
Preisen	Plural
gesponsert	None
kassierend	None
Trauringes	Singular
verstoß	Singular
Knien	Plural
Hirnstammes	Singular
Glycolipiden	Plural
Geschützes	Singular
Gallensteinen	Plural
Gesamtkunstwerkes	Singular
Entfernens	Singular
erbest	Singular
Sols	Singular
gewünscht	None
quasselest	Singular
misstrauend	None
Diskursen	Plural
Bauwerken	Plural
schwenk	Singular
Dichters	Singular
Gestirnen	Plural
gepflegt	None
Hormons	Singular
Fragegestellt	None
Huflattichs	Singular
schwafelst	Singular
Schlachters	Singular
preisgebend	None
getaut	None
Baritons	Singular
Wedeln	Plural
Katastrophenschutzes	Singular
Asses	Singular
Senders	Singular
eingesetzt	None
ignorierst	Singular
Atommodells	Singular
Virtuose	Singular
drill	Singular
entmineralisierend	None
Aufschlusses	Singular
Haarbändern	Plural
Anläufen	Plural
Spitzels	Singular
lähmest	Singular
Stadtgebietes	Singular
Robotern	Plural
Schmierölen	Plural
Münchnern	Plural
Rates	Singular
Veilchens	Singular
kribbelnd	None
kram	Singular
Bürgermeistern	Plural
gesüßt	None
ausgereicht	None
Gemahls	Singular
Empfängers	Singular
Funkern	Plural
aufgehalten	None
Schlächters	Singular
extrahierend	None
Amateurs	Singular
Filzen	Plural
Gasgemischen	Plural
glaubst	Singular
Bergführers	Singular
Stadtparlamenten	Plural
Kernreaktors	Singular
Madrigalen	Plural
Raketentreibstoffen	Plural
Diamantgitters	Singular
schleiß	Singular
Affe	Singular
gepickt	None
Prügelknabe	Singular
Ahnenscheinen	Plural
Teleskopen	Plural
Bauwerkes	Singular
verbreitend	None
gewitzelt	None
einschlafen	None
transportierend	None
sankt	Plural
Bambusameisenwürgern	Plural
Druide	Singular
Sultanates	Singular
Elfmeters	Singular
Schutzengels	Singular
erkennst	Singular
Werdern	Plural
kennzeichnend	None
Indikators	Singular
Schauspielen	Plural
verstauend	None
eintragen	None
Jurist	Singular
Monazitsanden	Plural
imkeret	Plural
Pfluges	Singular
Anhangs	Singular
ermächtigend	None
ausstreckend	None
Lenkern	Plural
Blechen	Plural
riskier	Singular
dürftet	Plural
Gasthäusern	Plural
Bildes	Singular
Lymphsystems	Singular
Hammerhaien	Plural
diffamierst	Singular
Blaubussards	Singular
Dienstbote	Singular
riskierend	None
widersprechend	None
geklönt	None
Xylophonen	Plural
Krebsen	Plural
Mandates	Singular
brütend	None
Belichtungsmessern	Plural
Sedimentes	Singular
Vordergrundes	Singular
Gesimsen	Plural
Kommentaren	Plural
erhebest	Singular
gehorchend	None
überbrückend	None
Knubbeln	Plural
abgestiegen	None
Fotopapiers	Singular
Engpasses	Singular
Hamsters	Singular
innegehalten	None
Grabhügeln	Plural
Sammlern	Plural
Pfirsichen	Plural
Peptiden	Plural
Leguanen	Plural
gerappt	None
Internetanschlüssen	Plural
Blumenmustern	Plural
Fertiggerichten	Plural
Daches	Singular
Pförtners	Singular
gefleucht	None
Mähdreschern	Plural
Mietverträgen	Plural
tagg	Singular
Surrealist	Singular
Kuckucks	Singular
teilend	None
schauspielerest	Singular
Kontoren	Plural
gejault	None
ausschüttelnd	None
übereilend	None
Beispieles	Singular
Barbar	Singular
weck	Singular
zertifizieret	Plural
austreten	None
rapp	Singular
tun	Singular
kauerest	Singular
berechnend	None
lauernd	None
Glasbläsern	Plural
ausmerzend	None
Enterichen	Plural
auslaugen	None
Rückgängen	Plural
schnarchest	Singular
Äxten	Plural
Quellflüssen	Plural
juck	Singular
verknallet	Plural
Meeressedimenten	Plural
schäumend	None
Rebell	Singular
Scheinwerfern	Plural
Acyloinen	Plural
mißlängest	Singular
geschämt	None
während	None
form	Singular
geritzt	None
Ebern	Plural
gesperrt	None
gespurtet	None
Wattestäbchens	Singular
Telephons	Singular
Klavieres	Singular
urteilst	Singular
Rebhühnern	Plural
befriedigend	None
beheimatend	None
Schiffsverkehrs	Singular
Graphems	Singular
erblassend	None
zusagen	None
verlassend	None
Fernsehgeräten	Plural
gemahlen	None
Wirbels	Singular
gewöhnend	None
akkreditierend	None
gedacht	None
ätzend	None
Gefahrgütern	Plural
taxierend	None
Schadens	Singular
Galaxienhaufens	Singular
Schiefern	Plural
schassend	None
Dämons	Singular
Fluches	Singular
Verkäufen	Plural
fesselnd	None
Rindern	Plural
Horizontes	Singular
schnür	Singular
galvanisierend	None
Wiesbadeners	Singular
geschwafelt	None
absprechen	None
Gesetzgebers	Singular
gekräuselt	None
Molchen	Plural
Anteilen	Plural
Sinn gemacht	None
blanchierend	None
Bahnsteiges	Singular
Kniffen	Plural
negierend	None
geopfert	None
Lehrlinges	Singular
Vorteiles	Singular
Steuerberaters	Singular
Dekreten	Plural
Eissen	Plural
abspielen	None
gesäumt	None
Glockengießern	Plural
gekoppelt	None
Infekten	Plural
ignorier	Singular
verbrauchst	Singular
kastei	Singular
Isolierstoffen	Plural
Bilchen	Plural
geklärt	None
gezwinkert	None
ähnelnd	None
verschleißest	Singular
Apostels	Singular
kompilierend	None
verneinend	None
Alpenvereinen	Plural
abspecken	None
Einsatzorten	Plural
Orgelkonzerten	Plural
rauchend	None
Instrumentes	Singular
erschient	Plural
getürmt	None
gepfiffen	None
Leuchtern	Plural
Winkeln	Plural
Glossaren	Plural
lehn	Singular
Carbens	Singular
Hüttenrauches	Singular
beschmutzend	None
Hehlers	Singular
gefaucht	None
ernennend	None
Amtsinhabern	Plural
Gitarrist	Singular
Bändchens	Singular
Reifenhebern	Plural
Mandelbäumen	Plural
Fernsehsenders	Singular
Walzern	Plural
Schnorchels	Singular
Anhängseln	Plural
Laufrings	Singular
Beobachters	Singular
entnimmst	Singular
gestampft	None
Erzkanzlers	Singular
Detektiven	Plural
käuf	Singular
Strebers	Singular
Schusswechseln	Plural
ausgemacht	None
Atomreaktors	Singular
falzend	None
schiebst	Singular
wählend	None
geflunkert	None
dargestellt	None
kotz	Singular
Kaplänen	Plural
Verbunden	Plural
Luftangriffes	Singular
Pilot	Singular
verwechselst	Singular
Puderzuckers	Singular
Zeitpunkten	Plural
verzeiget	Plural
warnend	None
flutsch	Singular
Frachtschiffen	Plural
Nadelbäumen	Plural
horchend	None
Felsens	Singular
Knutschflecken	Plural
pinkelet	Plural
Aggressors	Singular
Ethnologe	Singular
Ägyptern	Plural
geeilt	None
emulierend	None
abgezogen	None
Pfarrern	Plural
bekränzend	None
gemurmelt	None
gelost	None
Kinderschändern	Plural
Schöpfen	Plural
Rentieren	Plural
chauffier	Singular
erklär	Singular
rekonstruier	Singular
gerächt	None
aufgebracht	None
geheiratet	None
Orientale	Singular
drischt	Singular
Streiten	Plural
Dornes	Singular
getestet	None
Christogramms	Singular
Krüppeln	Plural
besprochen	None
Zar	Singular
eingeschlossen	None
Zapfens	Singular
Ausfällen	Plural
Rangierbahnhofes	Singular
kalkulierend	None
Bezugspunkten	Plural
hops	Singular
Witherits	Singular
Rätseln	Plural
schiebend	None
Monarch	Singular
entpackend	None
Überbleibseln	Plural
besessen	None
Stadtbezirken	Plural
leer	Singular
gegliedert	None
Abstechern	Plural
Durchschnitten	Plural
Schlagern	Plural
Magneten	Plural
Hexers	Singular
geschlurft	None
Vorbote	Singular
Mannsschilden	Plural
Idealist	Singular
Rumäne	Singular
gequatscht	None
Hauchen	Plural
Triebwerkes	Singular
Hüne	Singular
Gouverneuren	Plural
Rabbiners	Singular
Wirtshauses	Singular
Jahrzehntes	Singular
tötend	None
Grants	Singular
herabsetzen	None
Luchsen	Plural
abbremsen	None
geschändet	None
zermatschst	Singular
Kirschbäumen	Plural
brennend	None
Epoxiden	Plural
stammelnd	None
Spendern	Plural
peroxidierst	Singular
Gefäßes	Singular
nickend	None
gemäht	None
Symbolen	Plural
Überangeboten	Plural
Minerals	Singular
sorgst	Singular
pfleg	Singular
geflüchtet	None
steigend	None
umstoßen	None
Planetensystemen	Plural
bezichtigst	Singular
Seeschiffes	Singular
kichernd	None
aufbewahrend	None
hereingekommen	None
Verbindungshalbleitern	Plural
unterwarfst	Singular
Pilotprojekts	Singular
Gotteshäusern	Plural
Nichtrauchern	Plural
Schwätzern	Plural
Fremdenverkehrs	Singular
Fleischern	Plural
rechtfertig	Singular
analysieret	Plural
Königreichen	Plural
Berichterstatters	Singular
fei	Singular
Teiches	Singular
Dialogfensters	Singular
Halbgottes	Singular
zögerst	Singular
plädierst	Singular
Meerschweinchens	Singular
Dozent	Singular
nivellierend	None
Anbieters	Singular
Schwänzen	Plural
Handlangern	Plural
Trotzkist	Singular
wärmest	Singular
Zeitstempeln	Plural
Straßenschildern	Plural
geklopft	None
Geruchssinnes	Singular
gequietscht	None
Vorbeifluges	Singular
Arbeitsplätzen	Plural
garnierest	Singular
Blindenhunden	Plural
ratifizieret	Plural
Verwalters	Singular
Hüben	Plural
Kongressen	Plural
belaufet	Plural
Alchemist	Singular
borg	Singular
strick	Singular
gestutzt	None
gesetzt	None
übermittelnd	None
erleichternd	None
Zielen	Plural
Taschendieben	Plural
zappend	None
gewildert	None
abtreiben	None
Übersetzens	Singular
Erlösen	Plural
heil	Singular
muffend	None
eingeleitet	None
Straßenverkehrs	Singular
Kondomen	Plural
ELs	Singular
gesessen	None
Iraners	Singular
gestrandet	None
Fledermäusen	Plural
Assemblers	Singular
Sektors	Singular
verkloppest	Singular
Imkers	Singular
Sekundenbruchteilen	Plural
vorlesen	None
gezielt	None
Fahrplanes	Singular
mimend	None
begegnend	None
Addukten	Plural
Laders	Singular
gestiftet	None
Proteins	Singular
Strümpfen	Plural
Fühlens	Singular
Stielen	Plural
purgier	Singular
Erlebnissen	Plural
chiffrierest	Singular
gewatet	None
verbrannt	None
aufgehen	None
Siebes	Singular
Schwimmern	Plural
abgewogen	None
zupfend	None
Beutlers	Singular
Hühnchens	Singular
rall	Singular
Piemontese	Singular
duldend	None
standardisierst	Singular
würdest	Singular
park	Singular
knutschest	Singular
Butten	Plural
würg	Singular
gedemütigt	None
Turbanen	Plural
erlischt	Singular
Freibädern	Plural
erlöschend	None
liefernd	None
Ermittlern	Plural
ausgerechnet	None
Bürogebäudes	Singular
Abbildes	Singular
Golfplätzen	Plural
zufügend	None
Magnetrons	Singular
Libanese	Singular
zerreißend	None
gebellt	None
Demagoge	Singular
Sperrgebieten	Plural
interkulturalisierend	None
gejodelt	None
Downsyndroms	Singular
Trachoms	Singular
Besuchern	Plural
Enzyms	Singular
musterst	Singular
entwirft	Singular
Amtsinhabers	Singular
Cers	Singular
aufregen	None
gestockt	None
Tiefschlägen	Plural
Forschungslabors	Singular
Lüfters	Singular
geschluchzt	None
recherchierend	None
narret	Plural
Floßes	Singular
Aspektes	Singular
Romanist	Singular
Leichnamen	Plural
zapf	Singular
alarmierend	None
Kranzes	Singular
Kabeljaus	Singular
Funks	Singular
scheiterst	Singular
Getreides	Singular
gehörst	Singular
Hacks	Singular
Knopfes	Singular
Bastarden	Plural
implizieret	Plural
Schneepflügen	Plural
Sehens	Singular
hingerissen	None
Stadtparlamentes	Singular
Verbindungselementen	Plural
formulier	Singular
Winterweizens	Singular
Pegmatiten	Plural
Arzneistoffen	Plural
Internierungslagers	Singular
Hydrant	Singular
einwickeln	None
Vorsitzen	Plural
Linksruckes	Singular
Anfällen	Plural
Höhlenforschern	Plural
Technetiumatomen	Plural
Astes	Singular
geäussert	None
zag	Singular
Holzwurmes	Singular
Aa machen	None
Öltankers	Singular
geschnappt	None
mim	Singular
tendierend	None
Finalen	Plural
Satyrn	Plural
Ausnahmefällen	Plural
Fremdkapitals	Singular
gewitteret	Plural
Handbuchs	Singular
Donnerwetters	Singular
Nektars	Singular
Spanes	Singular
malst	Singular
Bauchnabels	Singular
abändern	None
Vielecken	Plural
Resonatoren	Plural
abgewickelt	None
Servers	Singular
einleiten	None
tränkend	None
explizieret	Plural
Besitzern	Plural
nanntest	Singular
enttäuschend	None
Epigone	Singular
zustimmen	None
besorgst	Singular
angerufen	None
Gefechtes	Singular
hock	Singular
unterschreibest	Singular
Schimmelpilzen	Plural
gekapselt	None
beschießend	None
gequert	None
Dienstagen	Plural
Buntstiften	Plural
Blaubussarden	Plural
Extremen	Plural
gurgelnd	None
bestohlen	None
schwebend	None
Fehlschlägen	Plural
Arabers	Singular
Zaunes	Singular
abgeschieden	None
Brauhäusern	Plural
werdend	None
Torschütze	Singular
löget	Plural
Herrgotts	Singular
errichtend	None
vermocht	None
fas	Singular
erschöpfend	None
gewogen	None
Brutblattes	Singular
Unterschieden	Plural
regier	Singular
statuier	Singular
geknibbelt	None
glänz	Singular
Gründern	Plural
Firmennamens	Singular
Fasanen	Plural
Konkurses	Singular
nachvollziehend	None
gebiert	None
gelispelt	None
Geschichtenbüchern	Plural
ausgemustert	None
Trugschlüssen	Plural
Schreibern	Plural
Argentiniers	Singular
Schubes	Singular
Kilometers	Singular
Rabatts	Singular
Pirols	Singular
blamierst	Singular
Tabaken	Plural
Röhrchens	Singular
Wollhandschuhs	Singular
hegst	Singular
gekillt	None
eingehen	None
einrichten	None
Ferngläsern	Plural
Hubschraubers	Singular
Jagdbombers	Singular
schnarchend	None
entmischst	Singular
grollend	None
Verläufen	Plural
zürnend	None
gemieden	None
gemimt	None
Reifenhebers	Singular
Magnetfeldern	Plural
getaucht	None
vermutend	None
gabelest	Singular
getröstet	None
Bahndrehimpulsen	Plural
regelnd	None
abnutzen	None
schluchz	Singular
polarisierend	None
Bummeln	Plural
Schädelknochens	Singular
anbetend	None
Kadern	Plural
ausstrecken	None
prüfend	None
nenntest	Singular
gedrosselt	None
Schornsteinfegern	Plural
Ferriten	Plural
traumatisierend	None
Stengeln	Plural
vorausgesetzt	None
Hauptsitzes	Singular
Heizers	Singular
klatschend	None
Abganges	Singular
Buckels	Singular
Jaren	Plural
Drahtzäunen	Plural
Taschengeldes	Singular
Spruches	Singular
Wahlkreisen	Plural
Messwerten	Plural
Rubinen	Plural
Versprechens	Singular
urbanisierend	None
missachtend	None
schleim	Singular
geniest	None
Stören	Plural
bezeuget	Plural
vermerket	Plural
staunend	None
wögest	Singular
spür	Singular
Musketiers	Singular
Springbrunnens	Singular
Puffern	Plural
Schlaumeiers	Singular
getagträumt	None
Mikrofons	Singular
Übergriffs	Singular
Bauelementes	Singular
Spielfeldern	Plural
Albums	Singular
Slowene	Singular
Halses	Singular
Visieren	Plural
geköpft	None
Großmeisters	Singular
laufend	None
Holländern	Plural
Zuschlagstoffen	Plural
Rundschreibens	Singular
Transistors	Singular
Kühlern	Plural
Lazaretten	Plural
Theaterstückes	Singular
gecrèmt	None
regulierend	None
Flüssigtreibstoffen	Plural
Krankenhäuschens	Singular
festgenommen	None
bestimmst	Singular
abhaken	None
Dimers	Singular
Kelches	Singular
stippend	None
errötend	None
Konzertsaales	Singular
Mediators	Singular
gekühlt	None
koppelnd	None
kleidend	None
Stiches	Singular
vermittelst	Singular
Nebensätzen	Plural
Drähten	Plural
geweckt	None
Männchens	Singular
Cheerleadern	Plural
Brauhauses	Singular
Verständnisses	Singular
verknitternd	None
Triarsanen	Plural
Pflügen	Plural
Kunstmalern	Plural
Stromnetzes	Singular
Wirtes	Singular
platzest	Singular
Inhalten	Plural
berechtig	Singular
gefoppt	None
Dämpfen	Plural
Waschbär	Singular
Nierenversagens	Singular
schlugt	Plural
Walrosses	Singular
stimmst	Singular
Vorstellungsgesprächen	Plural
Messdienern	Plural
ergänzend	None
beweisend	None
Sonnenuntergangs	Singular
Gewinden	Plural
Beckens	Singular
Clustern	Plural
Fürstentümern	Plural
triumphierend	None
gebräunt	None
schweigst	Singular
rührend	None
erworben	None
getrampt	None
Enzians	Singular
Weinfässern	Plural
gekarrt	None
reglementierend	None
angegeben	None
Knicken	Plural
Gleises	Singular
Pflegern	Plural
Verwaltungsgerichten	Plural
gekugelt	None
Erzählers	Singular
Herrschern	Plural
Rettern	Plural
Stäben	Plural
gegrinst	None
Fettalkoholen	Plural
urteilest	Singular
borgend	None
abgenommen	None
Berichten	Plural
strickst	Singular
Kunstdüngers	Singular
gegabelt	None
durchgefahren	None
Tapirs	Singular
gekappt	None
Edukten	Plural
Michiganwaldsängern	Plural
Berichtes	Singular
Abstürzen	Plural
geschwunden	None
stapf	Singular
Flugkapitäns	Singular
malm	Singular
kackend	None
trab	Singular
Heteroatomen	Plural
Apportierhundes	Singular
Adeliepinguinen	Plural
Hauptspiegels	Singular
zurückgekehrt	None
Photopapieren	Plural
eingeflößt	None
geknetet	None
bierst	Singular
Bürogebäuden	Plural
ausgestreckt	None
abweisend	None
ersparend	None
Podiums	Singular
beeinflussend	None
Kindermädchens	Singular
dämpfend	None
Selbstmorden	Plural
Amokläufers	Singular
ausfüllen	None
Immergrünen	Plural
Desoxyribonukleotiden	Plural
Bohrern	Plural
Stapeln	Plural
konfiszierend	None
pflücket	Plural
Anhaltspunkten	Plural
rauschend	None
gewispert	None
geflucht	None
Kaiserreiches	Singular
Hunten	Plural
geschwungen	None
geflittert	None
rationieret	Plural
Vorjahren	Plural
Zunamens	Singular
grasend	None
ranntet	Plural
Botschaftern	Plural
geäußert	None
gepunktet	None
sorg	Singular
Graumennigvögeln	Plural
denunzierend	None
Ölfässern	Plural
ausfallend	None
Steuerzahlern	Plural
seihend	None
verweigerst	Singular
unternommen	None
erfüll	Singular
Sternzeichens	Singular
ergießend	None
gekabelt	None
Dreckskerlen	Plural
schimmernd	None
einleitend	None
gepachtet	None
Meeresbodens	Singular
erlösend	None
Zuckerphosphaten	Plural
Priestern	Plural
Großfürst	Singular
Sigels	Singular
knallst	Singular
übernimmst	Singular
einordnend	None
Fonemen	Plural
steigeret	Plural
Carbonatgesteinen	Plural
Armaturenbrettes	Singular
Meeresfischen	Plural
Cursors	Singular
verschlingest	Singular
duz	Singular
geleimt	None
Schlagbäumen	Plural
harmonisierend	None
abgeschafft	None
entspricht	Singular
schlagend	None
geurteilt	None
knackend	None
entkriminalisierend	None
Wählers	Singular
Polymeren	Plural
Instrumentalen	Plural
ausgebrochen	None
Platinmetallen	Plural
Kabinetten	Plural
umgekehrt	None
schleißend	None
Endspielen	Plural
Schotts	Singular
Müllern	Plural
vibrierest	Singular
Krankheitserregern	Plural
Nestern	Plural
kuschelet	Plural
abschlagen	None
stipp	Singular
kultivieret	Plural
wiederbelebend	None
gefeit	None
Stadtrates	Singular
limitier	Singular
Bolzplätzen	Plural
Taifuns	Singular
Anhängers	Singular
Containerschiffen	Plural
Kraftfahrzeugen	Plural
ballet	Plural
Hainen	Plural
Angriffen	Plural
Primatologe	Singular
schwafelnd	None
mumifizierst	Singular
Oberbürgermeisters	Singular
Schleifringen	Plural
Nukleons	Singular
saus	Singular
Winkels	Singular
hyperventilierend	None
angerichtet	None
blinzelnd	None
herunterkommen	None
interview	Singular
Alphabetes	Singular
Supraleiters	Singular
stierend	None
Ariern	Plural
Farbtönen	Plural
Mammuts	Singular
herrschend	None
Meteoriten	Plural
heuerst	Singular
Mengenrabattes	Singular
wurschtelet	Plural
Stauen	Plural
gewunden	None
priorisierend	None
Anzügen	Plural
missbrauch	Singular
eingestanden	None
Immigrant	Singular
Mieders	Singular
Biwaks	Singular
Wasservögeln	Plural
Verstößen	Plural
Unpaarhufern	Plural
Einsprengseln	Plural
Telluriums	Singular
ausgelöst	None
Fahrstühlen	Plural
Imbisses	Singular
Außenministers	Singular
jagst	Singular
referenzierest	Singular
schlachtend	None
Statthalters	Singular
rauch	Singular
Zirkussen	Plural
Staatsbesuches	Singular
Selenols	Singular
umlegen	None
gespeist	None
schnabulieret	Plural
Nebensatzes	Singular
angesiedelt	None
Speichers	Singular
Notenwertes	Singular
begehr	Singular
Antigenen	Plural
Jahrzehnten	Plural
gehisst	None
gescheffelt	None
kartographierest	Singular
Spießers	Singular
funzend	None
initialisier	Singular
beschlägst	Singular
funktionier	Singular
Pulsaren	Plural
ärgerst	Singular
mogelnd	None
Hintergaumens	Singular
erzwängest	Singular
Alterungsprozesses	Singular
Brauers	Singular
Bannes	Singular
gekotzt	None
keuch	Singular
Märchens	Singular
Schutzmännern	Plural
gezankt	None
gekrakelt	None
grillend	None
wallfahrst	Singular
kränkelnd	None
Fernsehgerätes	Singular
missverstandest	Singular
ehrend	None
fass	Singular
baggeret	Plural
golfend	None
Kochlöffels	Singular
Lebensmittelfarbstoffs	Singular
geriffelt	None
gesabbelt	None
lackier	Singular
kalibrierst	Singular
Mörteln	Plural
deregulierend	None
Bundesministers	Singular
schluckend	None
forcierest	Singular
Vordenkern	Plural
Schmelzpunkten	Plural
gemeißelt	None
käbbelest	Singular
Laubwäldern	Plural
Köppern	Plural
Weilers	Singular
Gewässers	Singular
Inertgasen	Plural
Brandanschlages	Singular
versaueret	Plural
kooperierend	None
Ranges	Singular
Herzschrittmachers	Singular
Kojote	Singular
philosophier	Singular
Wohnortes	Singular
datierend	None
ermittelst	Singular
beglückwünschst	Singular
geschmuggelt	None
Ziegenmelkern	Plural
verbrauchend	None
gesteuert	None
Quarzes	Singular
Rohstoffes	Singular
Grundstückes	Singular
Mageninhaltes	Singular
Wertes	Singular
Zuschauern	Plural
Prüflingen	Plural
Kursen	Plural
Knöcheln	Plural
Stieren	Plural
Pudels	Singular
Bürzeln	Plural
Rotfüchsen	Plural
gequakt	None
Anklägers	Singular
Anhängen	Plural
entlastend	None
klüngelnd	None
Endpunkten	Plural
Sauerstoffanteilen	Plural
Rächern	Plural
geprägt	None
Vernichtungslagern	Plural
Jagdpanzern	Plural
stahlst	Singular
Billards	Singular
Pütts	Singular
Graphemen	Plural
Gefängniswärtern	Plural
geschirmt	None
gekennzeichnet	None
Dienstgraden	Plural
bedank	Singular
Wants	Singular
begebet	Plural
versiehst	Singular
handelst	Singular
Seiteneingängen	Plural
läuft	Singular
herstellen	None
regierend	None
flackernd	None
Verlegers	Singular
Schakals	Singular
zunehmend	None
vertan	None
Steiges	Singular
greifend	None
Broilers	Singular
verzeih	Singular
Karfreitagen	Plural
putz	Singular
Amtsantrittes	Singular
Hallenbädern	Plural
weggenommen	None
Wohnsitzes	Singular
Industriezweigen	Plural
Kronenpinguins	Singular
Testosterons	Singular
Plutoniums	Singular
durftest	Singular
verfem	Singular
babbelnd	None
buchstabierend	None
Wettkampfes	Singular
Portalen	Plural
Baumärkten	Plural
murks	Singular
versprichst	Singular
Flüchen	Plural
Komodowaranen	Plural
Fuchswelpe	Singular
Nieten	Plural
Marktanteilen	Plural
Transporters	Singular
inspizieret	Plural
Heckantriebes	Singular
Sonnenscheins	Singular
abonnierend	None
gekloppt	None
Klecksen	Plural
still	Singular
Jahrgängen	Plural
geläutet	None
Postulates	Singular
vertiefend	None
behalfst	Singular
hervorbringen	None
Knappe	Singular
Instinkten	Plural
evaluierend	None
Pilotprojekten	Plural
Dampfes	Singular
einhergehend	None
Akademikern	Plural
gestaunt	None
Weilern	Plural
unterhaltend	None
demütig	Singular
geschieden	None
lockerst	Singular
Biomolekülen	Plural
integrierend	None
Urtexten	Plural
Gaspedals	Singular
auslösend	None
reckend	None
Baumarktes	Singular
unterbrechest	Singular
Fischers	Singular
umschmölzest	Singular
genieß	Singular
ertrunken	None
Vergewaltigers	Singular
demütigst	Singular
korrumpierend	None
strahlend	None
geschult	None
Hütern	Plural
Mörsern	Plural
oxidierend	None
Pullovern	Plural
Schutzblechen	Plural
bevorzugst	Singular
Idiot	Singular
Aktienmärkten	Plural
Borkenkäfers	Singular
genutzt	None
Theaters	Singular
belegst	Singular
Untersuchungsausschüssen	Plural
gewähnt	None
genietet	None
Achtzigern	Plural
Hammeln	Plural
gestehst	Singular
Magisters	Singular
Umläufen	Plural
ertränkest	Singular
Späßen	Plural
rekapitulierend	None
Steckern	Plural
folgernd	None
Ebers	Singular
Fiebern	Plural
aufbewahrt	None
empfohlen	None
Habitaten	Plural
übernimm	Singular
anlegen	None
Predigern	Plural
Schwirrgeräts	Singular
akzeptieret	Plural
Tölpeln	Plural
Halbtönen	Plural
Ideologe	Singular
genannt	None
angedeutet	None
zurückgekommen	None
heiz	Singular
eingekauft	None
Tischtuches	Singular
verknüpfet	Plural
Liedern	Plural
festnehmend	None
Erzes	Singular
Leimen	Plural
harr	Singular
hantierst	Singular
Beifahrern	Plural
grölst	Singular
gekrochen	None
rätselet	Plural
arrangierend	None
bildend	None
feststellen	None
Kollagenen	Plural
wickelnd	None
beweis	Singular
verdampfend	None
verzweifelnd	None
Rissen	Plural
Sedimenten	Plural
abschließend	None
befall	Singular
gedöst	None
Stützpunktes	Singular
Hauptreihensternen	Plural
Sonnabendabenden	Plural
blinzelet	Plural
signalisierst	Singular
Exponaten	Plural
gesträubt	None
imprägnierend	None
Mahles	Singular
gestrichen	None
liierend	None
Lehnwortes	Singular
Eilandes	Singular
Sprachräumen	Plural
Bankern	Plural
Höhenunterschieds	Singular
Kurators	Singular
anhörend	None
Kolloiden	Plural
gestartet	None
erwischst	Singular
Retters	Singular
krön	Singular
Ledern	Plural
Metallocenen	Plural
Ideals	Singular
zählst	Singular
Kinderbuches	Singular
erlaub	Singular
Nutzers	Singular
verklag	Singular
aufgeben	None
Verdachtes	Singular
Maßstabes	Singular
Geschäftsbereichen	Plural
Steinsalzes	Singular
Strauches	Singular
widersprichst	Singular
Mikrofonen	Plural
gejobbt	None
einflößen	None
geschnüffelt	None
Spielern	Plural
Zelot	Singular
Gangstern	Plural
übertreib	Singular
Innenräumen	Plural
Myons	Singular
Stiefvätern	Plural
tauet	Plural
Tennisplatzes	Singular
profitierst	Singular
Riegeln	Plural
Chorälen	Plural
Antriebssystems	Singular
Spanners	Singular
aufschließen	None
Nanomaterials	Singular
Cholins	Singular
Kelchen	Plural
Domes	Singular
Betreuern	Plural
Protagonist	Singular
Milchprodukten	Plural
gesprüht	None
Strandes	Singular
Eroberungszügen	Plural
Winzern	Plural
wird	Singular
Zweisitzers	Singular
taktierend	None
Barschen	Plural
Sekundant	Singular
Fremdwörtern	Plural
verdampfet	Plural
Sehern	Plural
gepudert	None
Aggregates	Singular
Festkörpern	Plural
sonnst	Singular
Sportwettkämpfen	Plural
Spektralbereichen	Plural
wahrnehmen	None
gedealt	None
Kavaliers	Singular
Bundesaußenministers	Singular
nipp	Singular
Töpfers	Singular
kratzend	None
Kernen	Plural
Betreuers	Singular
Goldrausches	Singular
geduzt	None
geschmunzelt	None
bezahlst	Singular
gewürdigt	None
Langstreckenläufers	Singular
Motivs	Singular
geweiht	None
umsetzen	None
äußernd	None
geschmiedet	None
retuschierend	None
agierend	None
gesoffen	None
hellend	None
aufgewertet	None
Zementen	Plural
Emirs	Singular
gelächelt	None
Tauschen	Plural
Belägen	Plural
anzündend	None
Hadithen	Plural
Gaunern	Plural
überwunden	None
koordinierend	None
gekaut	None
Bundeskanzlern	Plural
handelnd	None
wändest	Singular
Leibern	Plural
Auripigmentes	Singular
Gradient	Singular
Heptamolybdats	Singular
Betreibern	Plural
Widdern	Plural
geobst	None
Entdeckers	Singular
Legierungsbestandteilen	Plural
Ochse	Singular
Topfes	Singular
Flügeln	Plural
ausgestrahlt	None
Balletten	Plural
Vampires	Singular
Matches	Singular
Zürchern	Plural
beschwörend	None
Schnitzern	Plural
iah	Singular
Unterarmen	Plural
Gehorsams	Singular
Klavieren	Plural
Zirkonkristalls	Singular
frohlockest	Singular
Sprachkurses	Singular
Detektors	Singular
Aldehyden	Plural
begnügend	None
Übermensch	Singular
Gewandes	Singular
Träumers	Singular
geebnet	None
Tributen	Plural
Tälern	Plural
knirschend	None
eierest	Singular
Fickers	Singular
Briefbeschwerers	Singular
Kampfflugzeugen	Plural
Anspruches	Singular
posierend	None
Treuhänders	Singular
Bahnmomenten	Plural
schabend	None
angehen	None
Bestandes	Singular
Tribunalen	Plural
Fundortes	Singular
Fleischfressern	Plural
amputierend	None
Abzügen	Plural
desertierend	None
kreier	Singular
Nebenschauplätzen	Plural
verhörend	None
Wipfels	Singular
marodierend	None
flirtend	None
versemmelet	Plural
Emigrant	Singular
erweckend	None
klassifizierend	None
Bunkers	Singular
geerdet	None
Bausteines	Singular
Schicksalen	Plural
gemartert	None
Kielern	Plural
gelikt	None
Gemahlen	Plural
Missverständnisses	Singular
Tümpels	Singular
Waffenstillständen	Plural
Ziegenfickern	Plural
aktivierend	None
mümmelnd	None
ausschließend	None
gewischt	None
Gerüchten	Plural
Silberbestecks	Singular
Grindwalen	Plural
Elb	Singular
Apparaten	Plural
anschauen	None
getadelt	None
Flachses	Singular
Strohhalmen	Plural
patentierst	Singular
abschaffen	None
Drahtesels	Singular
Inventaren	Plural
erweiterst	Singular
verhängend	None
Köpfchens	Singular
Vierzylindern	Plural
abtreibend	None
verkloppend	None
menstruierend	None
zapp	Singular
Karzinoms	Singular
Kamelen	Plural
stimm	Singular
sengend	None
Bisphosphonaten	Plural
Nerzen	Plural
flensend	None
tratsch	Singular
Balte	Singular
Walen	Plural
Sketchen	Plural
entschädigend	None
wegtolerierend	None
einführen	None
Schülern	Plural
Leichnams	Singular
geputscht	None
begnadigst	Singular
Überfällen	Plural
bewerkstelligend	None
Blödsinnes	Singular
Gigant	Singular
danket	Plural
Dackels	Singular
Containers	Singular
Diadems	Singular
Urteilen	Plural
ausgefüllt	None
Rängen	Plural
blondierend	None
Selens	Singular
Särgen	Plural
verfärbst	Singular
regnen	None
fluorierend	None
Zirkeln	Plural
Gesamtsystems	Singular
Sumpfes	Singular
Arbeitsbereiches	Singular
gequetscht	None
nähest	Singular
gesteinigt	None
balkanisierend	None
Weißbieren	Plural
gestaut	None
geworfen	None
kling	Singular
Zöllnern	Plural
scheuernd	None
Blütenstiels	Singular
Kränzen	Plural
bemühst	Singular
gehüllt	None
säuselnd	None
gereicht	None
Russe	Singular
umgedreht	None
reichend	None
darfst	Singular
hingelegt	None
downloadend	None
gegildet	None
Bahnüberganges	Singular
Herumgeeieres	Singular
Besitzes	Singular
sinn	Singular
Lokführern	Plural
Hauptquartieren	Plural
Kreiselkompassen	Plural
Alkalimetallen	Plural
getratscht	None
betrifft	Singular
pharyngalisierst	Singular
Schlafmitteln	Plural
zweifelest	Singular
übertroffen	None
besonnen	None
Halogeniden	Plural
Widders	Singular
kullerst	Singular
Containern	Plural
zerkleinernd	None
Inhibitors	Singular
Kamps	Singular
Hopfens	Singular
Sommers	Singular
Stützpunkten	Plural
Grundbegriffen	Plural
abgeschrieben	None
Pulvern	Plural
Branntkalks	Singular
Gelübden	Plural
berühr	Singular
geglichen	None
Baldachins	Singular
Kolbeckits	Singular
enthärtend	None
überschattend	None
Fremdkörpern	Plural
klickst	Singular
Gebrüdern	Singular
gelierest	Singular
murmelest	Singular
stammet	Plural
kämpfend	None
Klößen	Plural
geschützt	None
Vorquartals	Singular
klopf	Singular
geballt	None
Komponist	Singular
Affenpinschers	Singular
abgesagt	None
gekämpft	None
gebündelt	None
watschelet	Plural
zersetzend	None
dementier	Singular
oszillier	Singular
grabend	None
Fischern	Plural
Anwendungsbereichen	Plural
drohend	None
zerbricht	Singular
Bannstrahles	Singular
beanspruchst	Singular
verzauberst	Singular
Aufgebotes	Singular
bekräftigend	None
Anstandes	Singular
Skriptoriums	Singular
rummelnd	None
Kammerjägern	Plural
Teichen	Plural
Lagerhäusern	Plural
gemunkelt	None
Schäfers	Singular
Fichtelits	Singular
Neurotransmitters	Singular
rühr	Singular
ausgewandert	None
Anklägern	Plural
verstarbst	Singular
Antibiotikums	Singular
Mittelfingers	Singular
Segeln	Plural
Spinners	Singular
Wüchsen	Plural
Reliquiars	Singular
Elektrophilen	Plural
hervorheben	None
Schattens	Singular
beschuldigst	Singular
Unterseebooten	Plural
begünstig	Singular
Renderern	Plural
übergibt	Singular
rennst	Singular
Trägers	Singular
mischst	Singular
Zinnerzen	Plural
gefacht	None
Happens	Singular
Ökologe	Singular
philosophierend	None
Thuliums	Singular
Schaltkreisen	Plural
Flugzeugträgers	Singular
verblassend	None
Baumbastes	Singular
Klassenkamerad	Singular
erkannt	None
belästigest	Singular
Hecken	Plural
Augsburgern	Plural
Landesverrates	Singular
überzeugend	None
abschreiben	None
Hufeisens	Singular
Norwegern	Plural
Kanonieren	Plural
Fuchshunden	Plural
Substraten	Plural
Diebstählen	Plural
gelautet	None
angeschaltet	None
Finanzmärkten	Plural
zerstörst	Singular
Stammtisches	Singular
Würfeln	Plural
vereinbarend	None
Weilchens	Singular
Bilderbüchern	Plural
Lorbeerblättern	Plural
Stenograf	Singular
schädigend	None
Geheges	Singular
Kanute	Singular
Birkhuhnes	Singular
schmunzelnd	None
ränget	Plural
Verbrauchern	Plural
Egoist	Singular
lieb	Singular
sortieret	Plural
Golfplatzes	Singular
Lehrbüchern	Plural
tatternd	None
Gitarrenbauers	Singular
Korridors	Singular
feuernd	None
Edelmetalls	Singular
Gemütes	Singular
verbarrikadierest	Singular
Füllfederhalters	Singular
erscheinend	None
wechselgewirkt	None
hell	Singular
Seidenschwänzen	Plural
domestizierest	Singular
Quarzen	Plural
aufgebaut	None
Königsgeiers	Singular
klatsch	Singular
gravier	Singular
Trakts	Singular
dirigier	Singular
Reaktionsprodukten	Plural
Delphins	Singular
Lokales	Singular
Holzschnitten	Plural
kugelnd	None
Geländewagens	Singular
angestiegen	None
Schlafwandlers	Singular
Alkylrestes	Singular
Talentes	Singular
Einwürfen	Plural
zugemacht	None
verdächtigend	None
Psychiaters	Singular
Schützen	Plural
Spitals	Singular
geheizt	None
zerstör	Singular
abgedeckt	None
Tartraten	Plural
grüß	Singular
Kugelhaufenreaktors	Singular
geölt	None
Irrtümern	Plural
ausgeschlossen	None
Aufschlüssen	Plural
aufsteigend	None
Bundesinstitutes	Singular
abarbeiten	None
Aufläufen	Plural
Akten	Plural
Blutgefäßen	Plural
geherzt	None
bugsierend	None
wagst	Singular
Anwesens	Singular
Likören	Plural
Nebenblättern	Plural
Empfanges	Singular
Hydroxyaldehyds	Singular
Vagabund	Singular
Henkeln	Plural
erbrachtest	Singular
Autoklav	Singular
paralysieret	Plural
aufrichten	None
Kriegsschiffes	Singular
Zufällen	Plural
Dividend	Singular
zurückweisen	None
Schilddrüsenhormonen	Plural
generalisierend	None
Vormündern	Plural
Neidern	Plural
Erdrutschen	Plural
grunz	Singular
angeschnallt	None
Straßenbildern	Plural
Polyamiden	Plural
Kretschams	Singular
denaturierend	None
kill	Singular
ableben	None
begeisternd	None
gesintert	None
Klinkern	Plural
auflösend	None
geduftet	None
Klebern	Plural
Drehorten	Plural
Schulkindern	Plural
Ferners	Singular
Schmugglers	Singular
Sümpfen	Plural
Spielfeldes	Singular
Wirbeln	Plural
Gebissen	Plural
Fanatikers	Singular
aufmunternd	None
benehmend	None
gebeichtet	None
preisgeben	None
ablenken	None
getobt	None
Monsuns	Singular
mißhandelest	Singular
Dekans	Singular
ausbreitend	None
Quelltextes	Singular
belügest	Singular
Treibers	Singular
Rubeln	Plural
knabberet	Plural
Bezirksausschusses	Singular
Fahndern	Plural
Kunststoffes	Singular
Christdemokrat	Singular
weglegen	None
Jagdpanzers	Singular
Erzbischofs	Singular
benötig	Singular
vermasselnd	None
Auftragsmörders	Singular
aufgenommen	None
Staatsbürgers	Singular
schlurfst	Singular
Bienenstöcken	Plural
Laminaten	Plural
schmerz	Singular
Forschungslaboren	Plural
Verbundwerkstoffen	Plural
Antibiotikan	Plural
demotivierend	None
Einsatzgebieten	Plural
Duellen	Plural
geschildert	None
Leukozyt	Singular
divergierend	None
leitend	None
gewährend	None
klingend	None
einprägen	None
verselbstständigend	None
geformt	None
Objekten	Plural
Treibhäusern	Plural
Mobilfunknetzen	Plural
betätigst	Singular
Aufsichtsräten	Plural
getrauert	None
verseifend	None
Bundesgrenzschutzes	Singular
Rückschlüssen	Plural
Todesfällen	Plural
Pharisäern	Plural
gebüßt	None
Sonnabendmittagen	Plural
Kühlers	Singular
Einhörnern	Plural
Lammfelles	Singular
betreibest	Singular
Haspels	Singular
Reimen	Plural
verminend	None
drohst	Singular
Stoffkreisläufen	Plural
Beiles	Singular
gelutscht	None
Ire	Singular
Leerzeichens	Singular
Aufsetzens	Singular
aufgerundet	None
Klebebändern	Plural
Atollen	Plural
strullerst	Singular
koexistierest	Singular
Wohnräumen	Plural
Zaubern	Plural
Stadtteiles	Singular
Spitzes	Singular
Kohlenstoffgehalten	Plural
nagelet	Plural
Enzymen	Plural
Halbfinales	Singular
geweißt	None
gemutmaßt	None
vermiss	Singular
gegrillt	None
fließ	Singular
Tänzern	Plural
entmutigend	None
sedimentierend	None
Bauernhöfen	Plural
Einführungsjahren	Plural
Erdgeschosses	Singular
geschärft	None
Kamerad	Singular
qualifizierest	Singular
Sternbildes	Singular
Kabelfernsehens	Singular
benimm	Singular
stolperet	Plural
komponieret	Plural
Beiständen	Plural
Schills	Singular
gespürt	None
Abführmittels	Singular
jappet	Plural
Pfaden	Plural
Fakiren	Plural
schön	Singular
getränkt	None
Frontallappens	Singular
Schnürsenkeln	Plural
Hälsen	Plural
wurzelnd	None
Carbiden	Plural
teeret	Plural
Albes	Singular
Knöchels	Singular
vernimmt	Singular
befällt	Singular
gezittert	None
Aufgeboten	Plural
wilderet	Plural
Fäßchens	Singular
Bisams	Singular
Brite	Singular
Wacholdern	Plural
Verehrern	Plural
genügend	None
Umweltschutzes	Singular
Meridianen	Plural
empörend	None
Kochlöffeln	Plural
Werkstückes	Singular
Phenakits	Singular
Abkühlens	Singular
Rückwärtsgängen	Plural
Gadoliniten	Plural
Rehen	Plural
anvertraut	None
gesächselt	None
Verdecken	Plural
lehr	Singular
orientierend	None
geschissen	None
melierend	None
vorstellen	None
Grundstücken	Plural
Schnipseln	Plural
Magistrats	Singular
Prangern	Plural
gescheitert	None
Australiers	Singular
verbrochen	None
separierend	None
Gleichströmen	Plural
auftauchen	None
Gelbbleierzes	Singular
Sanitätern	Plural
gequält	None
geduckt	None
Borates	Singular
Auftritten	Plural
Platzhaltern	Plural
variier	Singular
renn	Singular
Wohnorten	Plural
übereinstimmen	None
Honorars	Singular
