micșorat	Past
ghicit	Past
dorești	Present
pictata	None
arătau	Past
drogului	None
ghepardul	None
doreau	Past
visaseră	Past
stăpânit	Past
prinzând	Present
prioritățile	None
heterosexualilor	None
stângului	None
lăsă	Past
amețiserăți	Past
nerezervații	None
înghițind	Present
refec	Present
congelat	Past
flămânda	None
treceți	Present
îndepărtaserăm	Past
momi	Past
făină	None
scoli	Present
amiciției	None
legau	Past
соба	None
scoatem	Present
luării	None
scrumieră	None
recunoștința	None
învechisem	Past
rostogolește	Present
tarii	None
izgoniți	Present
vrăjiți	Present
trabucului	None
construiești	Present
compunând	Present
nodurilor	None
cunoștea	Past
îmbrăcau	Past
fugim	Present
întinzând	Present
aliații	None
integrabil	None
mistrețului	None
nevăzuţii	None
șade	Present
încălțasem	Past
îneca	Past
produci	Present
culese	Past
sticleții	None
codobatură	None
absorbeați	Past
întinde	Present
distilării	None
vine	Present
delfinii	None
îngropa	Past
lubrifiind	Present
comunicau	Past
CD-ului	None
mistreții	None
interzice	Present
fluierași	Past
țintirimului	None
cutreierau	Past
împlinim	Present
măriți	Present
încercuiți	Present
popoarele	None
tehnologice	None
masculule	None
pieptăn	Present
îndobitocise	Past
înec	Present
legăna	Past
florarului	None
chemau	Past
codificați	None
sculptură	None
estimarăm	Past
rulat	Past
animat	Past
aleatoriii	None
măritași	Past
intuiește	Present
tranziționale	None
numiți	Present
geme	Present
silvă	None
alunecat	Past
endoscopule	None
cuceriseră	Past
stejarul	None
numești	Present
măcinarăm	Past
negând	Present
examenele	None
plecăm	Present
minuna	Past
elefantul	None
topit	Past
prostii	Past
aprindea	Past
simplificat	Past
pumele	None
nodului	None
spectrali	None
ținteau	Past
țestos	None
râmăm	Present
aflară	Past
lărgiți	Present
observăm	Present
tradus	Past
neregal	None
încorporau	Past
uzi	Present
robiți	Present
bucătăriile	None
sărise	Past
încoronaseși	Past
vedea	Past
elementarele	None
țării	None
îndrăgostește	Present
rugă	Past
fărâmau	Past
secvențiale	None
bătuse	Past
cumplise	Past
anonimului	None
încercaseră	Past
gândirăm	Past
mințise	Past
scufundasem	Past
legase	Past
ascensiunea	None
împarți	Present
ocupase	Past
labă	None
albastre	None
dansatorul	None
exagerarăm	Past
neutrelor	None
vineți	None
știa	Past
ajun	Present
putuseră	Past
împărțit	Past
scaunelor	None
loghez	Present
angaja	Past
frige	Present
gătind	Present
cerni	Present
căutase	Past
prinzi	Present
urmau	Past
pedepsi	Past
fixase	Past
golea	Past
ramurilor	None
proiectelor	None
greblă	None
prezicea	Past
completau	Past
alina	Past
stropit	Past
nepopular	None
stricase	Past
olimpice	None
învelește	Present
petreceau	Past
comândară	Past
simbolizau	Past
batem	Present
scris	Past
programul	None
încheierea	None
ezit	Present
reziști	Present
peți	Past
pompierilor	None
guvernau	Past
înlesniși	Past
risipeau	Past
asimetrie	None
cămilelor	None
întărise	Past
întăreau	Past
activând	Present
iriți	Present
letonei	None
îndrăgostiți	Present
țipi	Present
accelerând	Present
mustrând	Present
legând	Present
bandajului	None
fraudasem	Past
scoci	Present
invariabile	None
murdărește	Present
balustrada	None
maltratat	Past
castrat	Past
obțineau	Past
zice	Present
vânez	Present
copiezi	Present
lascivele	None
afla	Past
anglofonule	None
înrădăcinat	Past
urci	Present
contravii	Present
înfăinară	Past
crede	Present
lămpilor	None
mirosi	Past
afundat	Past
bulevardelor	None
uniserăți	Past
vopsește	Present
păziserăm	Past
felina	None
frigiderele	None
ionosferei	None
dezunisem	Past
ferecat	Past
strâns	Past
frecând	Present
lansau	Past
muiat	Past
împletiți	Present
distrugând	Present
separaserăți	Past
surprins	Past
omora	Past
berbecule	None
pup	Present
istoricului	None
posterității	None
convinse	Past
tăcem	Present
prăjită	None
sinagogă	None
însoțit	Past
cavernele	None
recunoscut	Past
lucești	Present
mușca	Past
umblu	Present
frânând	Present
spălăm	Present
ceruseră	Past
încetase	Past
urmat	Past
dezgropăm	Present
roibul	None
abacului	None
completând	Present
răniți	Present
sugruma	Past
pensula	None
înfricoșa	Past
șchiopătând	Present
mutăm	Present
șterse	Past
încurajând	Present
năsucului	None
orgasmicelor	None
mijlocind	Present
cotidianului	None
butonului	None
mândrește	Present
punctat	Past
gnosticismul	None
îngrămădiserăți	Past
sănătosul	None
mersese	Past
nutrea	Past
cănii	None
substantivele	None
testiculul	None
cărnurilor	None
înjosi	Past
ridicarea	None
mamei	None
descrieți	Present
crești	Present
conceptului	None
contrazice	Present
înrâurise	Past
lămurești	Present
telefoanelor	None
sfeclind	Present
fericiți	Present
fericea	Past
tramvaiul	None
blasfemiile	None
cust	Present
externi	None
aflat	Past
ros	Past
amărâți	Present
criticii	None
condu	None
urzeală	None
întortocheat	Past
doreați	Past
franțuzoaică	None
inducea	Past
venerare	None
nucile	None
spânzurară	Past
lăcrimioara	None
ploaia	None
înflorea	Past
dobândește	Present
funcționase	Past
completezi	Present
distrugem	Present
îmbrățișa	Past
monoaxiali	None
slujea	Past
îndepărtă	Past
distinsese	Past
ales	Past
agățau	Past
blestema	Past
platelor	None
măslinul	None
obscură	None
purificaserăm	Past
componentei	None
aprigii	None
împiedicase	Past
tatuajul	None
umbroase	None
imprimau	Past
aromânească	None
tentat	Past
compari	Present
înșela	Past
încăput	Past
extins	Past
invadă	Past
sinagogile	None
urechea	None
carpelei	None
neglijând	Present
soția	None
mediocri	None
construi	Past
porniți	Present
încurajăm	Present
speraseră	Past
declari	Present
parazitologiei	None
sfârtica	Past
credeați	Past
apăsă	Past
asigurăm	Present
înseraseși	Past
topirăți	Past
potriviși	Past
fixau	Past
alcătuia	Past
semnat	Past
comparăm	Present
spărgând	Present
retrageți	Present
tufișului	None
mirosea	Past
iobagul	None
emoționali	None
răsare	Present
adunând	Present
frustrării	None
angajase	Past
belea	Past
arând	Present
consultările	None
țipau	Past
întrebuințat	Past
piedestalurilor	None
păcătui	Past
retrage	Present
îngropăm	Present
salvie	None
ipocriților	None
lămurit	Past
utilizez	Present
compunea	Past
alcătuiește	Present
eliberau	Past
mierlă	None
desișul	None
reușiți	Present
dimensionare	None
izgoni	Past
bărbile	None
lățea	Past
mustrarăm	Past
pornografică	None
lânarul	None
egalilor	None
inginerul	None
adormise	Past
contrazise	Past
aduce	Present
temi	Present
legeni	Present
scrierii	None
completase	Past
stabilisem	Past
frauda	Past
întinat	Past
mințit	Past
dansezi	Present
cumpărăm	Present
izbit	Past
răspunseseși	Past
stăpâniți	Present
fereau	Past
împerecheat	Past
prezice	Present
roză	None
exagera	Past
umanitate	None
aplicau	Past
înghesuiau	Past
auzea	Past
zbura	Past
vărsau	Past
suflând	Present
salutau	Past
găsiră	Past
pinguinii	None
umblând	Present
înșeuasem	Past
omor	Present
port	Present
nebunii	Past
răgazul	None
încălzești	Present
cutreiera	Past
globurile	None
împuști	Present
gălbuiul	None
purces	Past
vărsaseră	Past
cotiți	Present
furioșii	None
oglindește	Present
câștigăm	Present
presupuserăm	Past
completaseși	Past
dobândi	Past
rotește	Present
enigmatice	None
stindardul	None
insultând	Present
șubred	None
adâncind	Present
viperelor	None
cocoloșise	Past
obișnuiești	Present
jupuiseră	Past
nevăzute	None
baltică	None
înfruntat	Past
merindele	None
ruinat	Past
credincioasa	None
desenase	Past
deismului	None
germana	None
reduci	Present
cooperând	Present
semnăm	Present
liniștește	Present
amiaza	None
piersic	Present
storsei	Past
delimita	Past
îmbunătățești	Present
muncind	Present
insulă	None
sacoșele	None
măcina	Past
prosti	Past
despicase	Past
constat	Past
rezolvând	Present
insultași	Past
scol	Present
dispui	Present
delirantul	None
îmbogățeau	Past
văile	None
micșorarăți	Past
veștedelor	None
descurci	Present
făgăduiește	Present
adormea	Past
proprietățile	None
clătește	Present
plantând	Present
oprea	Past
merităm	Present
rosti	Past
înjugaserăți	Past
principala	None
pasteurizat	Past
arară	Past
sporea	Past
băgăm	Present
îmbulzise	Past
încadrez	Present
supraviețuiați	Past
călăreții	None
mut	Present
intraserăți	Past
încetii	Past
anteriorii	None
salva	Past
seninătatea	None
interesau	Past
mulsesem	Past
scump	None
servise	Past
negau	Past
răspunzând	Present
germană	None
mijlocit	Past
nimiciți	Present
oprise	Past
pregătești	Present
peruchierului	None
căpătau	Past
zdrobi	Past
însemnătății	None
sfârșeau	Past
tiviși	Past
studiau	Past
roadem	Present
destramat	Past
împingeau	Past
trage	Present
legendarii	None
zdrobiți	Present
cotești	Present
îndop	Present
renul	None
rezistaseră	Past
oii	None
cantautorului	None
măcinau	Past
recuperăm	Present
putând	Present
ascultase	Past
sângeroase	None
urzit	Past
ofticat	Past
retezi	Present
parazitare	None
căzuți	None
ebraică	None
țintiserăm	Past
dogarule	None
secvențială	None
îmbinau	Past
blestemase	Past
ovăz	None
ieșeau	Past
făuri	Past
țesut	Past
onorăm	Present
schimbi	Present
uitaseră	Past
uimind	Present
muncim	Present
injectezi	Present
prăjiserăți	Past
defaimi	Present
simetrie	None
agenta	None
auziseră	Past
înălța	Past
disponibila	None
străvăzut	Past
plecă	Past
injecta	Past
vârtos	None
alin	Present
măgărie	None
reînnoim	Present
apăreți	Present
guvernase	Past
constrânsei	Past
văduvit	Past
lansatoarele	None
înșir	Present
pleci	Present
depuse	Past
pic	Present
răposat	Past
asigurat	Past
ursuleții	None
timiditate	None
arhicunoscuții	None
asimila	Past
sinonimelor	None
rezolvăm	Present
ierna	Past
vânzând	Present
declarasem	Past
îngusta	Past
reușit	Past
scădea	Past
podișul	None
sărbătorește	Present
vlăguit	Past
găsii	Past
prăbușește	Present
răsculase	Past
judecau	Past
interfața	None
îngreunase	Past
treierarăți	Past
emoționat	Past
ridicărilor	None
peristaltică	None
mirăm	Present
căutau	Past
culcat	Past
înscrieți	Present
satisfăcând	Present
îndupleca	Past
adaugi	Present
convine	Present
înjunghia	Past
capitula	Past
vitejilor	None
ușuratice	None
purtau	Past
deșirară	Past
mândriți	Present
cartezienei	None
curcubeului	None
răsufla	Past
tuna	Past
turnau	Past
înot	Present
împins	Past
socotești	Present
veghezi	Present
belești	Present
ciocneau	Past
grăsimea	None
oglindiși	Past
amanetat	Past
fuma	Past
artelor	None
animalitate	None
clădind	Present
articula	Past
căzură	Past
fluxurile	None
tragi	Present
înierbarăți	Past
rezistau	Past
cunoșteau	Past
zărise	Past
înceta	Past
riscau	Past
alegeai	Past
făgădui	Past
argilosului	None
râzi	Present
scăpătat	Past
știucă	None
distrași	Past
cumnatul	None
servit	Past
mângâia	Past
schimbau	Past
accelerat	Past
invit	Present
izbiți	Present
lipsiserăm	Past
rădea	Past
mirat	Past
întrerupând	Present
utilizăm	Present
șmecherul	None
taifunul	None
răpuneai	Past
prelungim	Present
profesiilor	None
transatlantic	None
cărturarilor	None
înălțat	Past
bețivilor	None
noua	None
scărpinaseră	Past
seninul	None
răzgândește	Present
nasoale	None
bătu	Past
amenințase	Past
conceput	Past
catastrofic	None
adulmecarăți	Past
încununa	Past
spune	Present
îngrijorau	Past
rotunjit	Past
obliga	Past
epuizară	Past
citadela	None
scoțând	Present
apărau	Past
cuceriți	Present
scufundând	Present
contravenind	Present
ademenea	Past
gravitații	None
distilare	None
dușmănii	Past
chemase	Past
folosind	Present
căzând	Present
scumpit	Past
scutur	Present
agăța	Past
supărăm	Present
dezminți	Past
înlocui	Past
dezlegat	Past
înfrunta	Past
tâmpiseră	Past
secretariatul	None
mulțumit	Past
returna	Past
ciopleau	Past
aplauda	Past
dozare	None
hotarul	None
împădurit	Past
curăți	Present
goliți	Present
gramaticilor	None
impus	Past
constrânge	Present
cumpătat	Past
răbdat	Past
înnegri	Past
certa	Past
sânului	None
tehnologicii	None
merizele	None
cântase	Past
uitase	Past
muiere	None
dulci	None
malteze	None
conduse	Past
scrise	Past
mobilul	None
iritând	Present
stropii	Past
imputa	Past
zburând	Present
săcreților	None
bebelușii	None
dezlegarăm	Past
țineau	Past
împodobește	Present
brațele	None
strada	None
fericitului	None
rășinii	None
biologici	None
libera	Past
zări	Past
locui	Past
folosire	None
târgui	Past
pedepsiți	Present
lua	Past
zgâria	Past
lipiseră	Past
dumnezeul	None
bocea	Past
adoptaseră	Past
biochimică	None
afunda	Past
scăpau	Past
stabilii	Past
sunteți	Present
lipiți	Present
visau	Past
futui	Past
cântăreau	Past
halvaua	None
ajutau	Past
valahul	None
dobândiseră	Past
funcționară	Past
clarificăm	Present
împăcase	Past
solari	None
stați	Present
prelungit	Past
bărbierit	Past
obligat	Past
venii	Past
extinzând	Present
alcătuise	Past
salt	Present
liberat	Past
aperi	Present
fereați	Past
preoților	None
acuzatului	None
prinsesem	Past
spumaseră	Past
peticeați	Past
vândut	Past
adăstaseși	Past
meritau	Past
fumurie	None
spuneți	Present
producând	Present
sufocând	Present
lipsiți	Present
dezbrac	Present
albicioși	None
scriseseră	Past
versul	None
pugilatelor	None
ecosistemelor	None
doriseră	Past
moștenea	Past
dezamăgisem	Past
joc	Present
busola	None
întâmpinând	Present
stimat	Past
spovedi	Past
salvarăm	Past
operațiilor	None
îmbătrânind	Present
delicios	None
afidelor	None
pofteați	Past
surpat	Past
cotind	Present
trifoiului	None
făptui	Past
întări	Past
scormonim	Present
dezvoltau	Past
ferestruiră	Past
nevestele	None
învățaserăți	Past
împarte	Present
simplificând	Present
boante	None
urmărea	Past
penisule	None
devenit	Past
haitiene	None
tradu	None
susținui	Past
rușilor	None
bănuise	Past
turtit	Past
înmormântat	Past
temu	Past
stropiți	Present
saliva	None
auzeați	Past
imprecației	None
urăști	Present
dezrobiți	Present
treptele	None
înjur	Present
leoaicei	None
apărăm	Present
ultimul	None
zbătut	Past
stăm	Present
abililor	None
hazlia	None
credea	Past
parazita	None
tristețe	None
desenez	Present
crescutele	None
unealta	None
răcit	Past
cerea	Past
lipsea	Past
deveniseră	Past
treierat	Past
mândrit	Past
serioșii	None
clarifica	Past
sufla	Past
numiră	Past
încălzeau	Past
rusească	None
tarilor	None
urau	Past
înnoadă	Present
capitulând	Present
apropia	Past
pregnant	None
portocaliii	None
afânase	Past
murmura	Past
lățiseră	Past
socializat	Past
spălat	Past
stejarule	None
saxofonul	None
interesez	Present
răciseră	Past
alinta	Past
catastrofică	None
adăposturilor	None
amenințare	None
erai	Past
poftit	Past
farmaciștii	None
ții	Present
desziceau	Past
focului	None
obosit	Past
tresăriserăm	Past
recupera	Past
producerea	None
sacre	None
era	Past
tăcea	Past
logodește	Present
lucrasem	Past
construind	Present
continental	None
icrele	None
încurcăm	Present
admirau	Past
somnoroasa	None
cazanelor	None
surpriză	None
așezară	Past
înfumurez	Present
noilor	None
lucim	Present
sătulului	None
înghețate	None
împrejmuia	Past
afânat	Past
distractive	None
strâmba	Past
stabilități	None
pingeliserăți	Past
desfirăm	Present
satele	None
propuneau	Past
gudurând	Present
încrezurăți	Past
poruncea	Past
dărâmat	Past
învierea	None
coase	Present
știm	Present
întâmplăm	Present
creierul	None
oglindirăți	Past
arătaseră	Past
gecile	None
îmbunătății	Past
conteniră	Past
interveniseră	Past
cumpleați	Past
clinică	None
fericiși	Past
izbăvit	Past
trunchiului	None
râvnea	Past
îmbogățind	Present
întemeie	Past
suciți	Present
documentând	Present
supus	Past
blondul	None
vrăjitorul	None
reduseseră	Past
urmărise	Past
frânarăm	Past
lărgit	Past
păgânismului	None
păreai	Past
împiedicând	Present
sinucis	Past
epuizat	Past
sucii	Past
funda	Past
poștă	None
fanteziei	None
întristat	Past
agentului	None
plângi	Present
distrugeți	Present
asexualul	None
articulat	Past
cutremurele	None
zăcământule	None
încet	Present
serurilor	None
emoțiile	None
dorise	Past
organizațiile	None
digitală	None
desprinzând	Present
gătit	Past
începusem	Past
îmbătat	Past
societate	None
fiert	Past
dezmântăm	Present
aligatorii	None
emoționez	Present
demonilor	None
vulgule	None
râvniși	Past
îngrijim	Present
lovim	Present
însuflețea	Past
articulară	Past
portarilor	None
răpi	Past
lansatoarelor	None
păroase	None
zoologie	None
orientat	Past
scăzând	Present
apăreau	Past
urmări	Past
asigurând	Present
săpaseră	Past
neanticipaților	None
drapelelor	None
ciopleați	Past
întreținea	Past
botezau	Past
eliberezi	Present
mira	Past
radioul	None
drumule	None
potriveați	Past
golește	Present
fărâmând	Present
apăs	Present
ruginii	Past
înfricoșat	Past
mândri	Past
confruntăm	Present
închideați	Past
hibernat	Past
slujeau	Past
tâmpit	Past
ajutaseră	Past
sașiei	None
bărbieriseși	Past
pictă	Past
silabic	None
neguța	Past
slujești	Present
arătând	Present
ramurii	None
bisexualii	None
cucerea	Past
acoperea	Past
voce	None
cumințirăm	Past
masculini	None
cioplești	Present
petrecuseră	Past
cumpărau	Past
muzicale	None
discutând	Present
veniră	Past
glumești	Present
satirei	None
ruinase	Past
oglindiserăți	Past
întreprindem	Present
ața	None
încheiat	Past
înfățișară	Past
zebrele	None
înălțăm	Present
pocniră	Past
luceda	None
gâdilăm	Present
umpluseră	Past
băusem	Past
copleșit	Past
prevesteau	Past
utilizaseră	Past
mărturisit	Past
înțelegeți	Present
disponibilităților	None
adoptând	Present
defileului	None
dezvoltaserăți	Past
apuseră	Past
unsoarea	None
împresurarăți	Past
nebuni	Past
asemeni	Present
adeverit	Past
îngheț	Present
sapi	Present
vigilenței	None
momind	Present
placentei	None
dezmințise	Past
anima	Past
ocrotiseră	Past
tehnologici	None
dezrădăcinaseși	Past
bărbații	None
reala	None
țânțarul	None
chimistul	None
compune	Present
înlesnind	Present
balcanică	None
cobaiul	None
obosiți	Present
fractură	Past
aroganților	None
lipsiseși	Past
dominau	Past
topise	Past
săgetarăm	Past
returnând	Present
cârtiței	None
poftim	Present
aritmetice	None
desparți	Present
microbiologii	None
șoptește	Present
îndemn	Present
publicități	None
mulțumi	Past
scurtă	Past
odihniți	Present
satisfaceți	Present
eroticilor	None
înșelase	Past
jigniți	Present
trecuse	Past
ar	Present
înlesniți	Present
munca	None
pășunat	Past
arcadă	None
urziți	Present
încrezut	Past
colonialismului	None
compar	Present
rezolv	Present
ascultăm	Present
suspensoare	None
sicriului	None
batjocoreau	Past
chefalul	None
rotunjiți	Present
destrăbălat	Past
prăbuși	Past
flămânzit	Past
visătoarei	None
răsfoirăm	Past
doctorii	None
peticeai	Past
explicarăm	Past
purtat	Past
serviți	Present
jucat	Past
dubiosului	None
literaturilor	None
încununând	Present
ascunzând	Present
întreține	Present
îmbrăcăm	Present
inundând	Present
respirat	Past
chestiune	None
înrămat	Past
regalist	None
intervine	Present
cronic	None
fețele	None
ridichilor	None
citiți	Present
înțelegi	Present
asigurarăți	Past
construim	Present
așternusem	Past
depuseseră	Past
lovit	Past
făli	Past
priveghea	Past
făurim	Present
dezgustarăți	Past
elimin	Present
piureului	None
vasului	None
omorât	Past
pâine	None
defăimat	Past
insultat	Past
judecat	Past
întâlniseră	Past
descălecaseră	Past
ferecasem	Past
locuiseră	Past
sexoasei	None
sorbea	Past
înscrise	Past
cumpănit	Past
cerșind	Present
dorinței	None
brazilianului	None
dezmățaserăți	Past
lămurim	Present
tăind	Present
dublară	Past
desprinsese	Past
anina	Past
leg	Present
liniștea	Past
aplici	Present
sexualității	None
ascunsese	Past
amicali	None
împiedicat	Past
injectând	Present
răspândiți	Present
unii	Past
sătula	None
victorie	None
profunda	None
ascuns	Past
încoronând	Present
lungea	Past
reînnoit	Past
grăbi	Past
adăugă	Past
eliberase	Past
fierbințile	None
croi	Past
vânzătoarea	None
bârna	None
făptuit	Past
părăsise	Past
parcarăți	Past
atingeau	Past
citești	Present
mișto	None
artei	None
exist	Present
dopurilor	None
desmăța	Past
miroase	Present
chibritului	None
sănătoasa	None
influențezi	Present
moștenise	Past
coci	Present
puteați	Past
histologicul	None
lucește	Present
mândrii	Past
stric	Present
prescurtărilor	None
studiind	Present
uimiserăm	Past
formație	None
înscrie	Present
dovedi	Past
înfruntăm	Present
cașului	None
rogi	Present
împărțim	Present
terțului	None
erați	Past
unea	Past
ghicind	Present
otrăvi	Past
viului	None
măsurat	Past
numi	Past
nimerind	Present
vizitat	Past
elevei	None
cerșiseși	Past
întrebările	None
ținem	Present
gândit	Past
veșnicii	None
vizitaseră	Past
născu	Past
apăruse	Past
răsucit	Past
corbilor	None
rescrieți	Present
încadrăm	Present
discutaseră	Past
dușmănirăm	Past
biologiei	None
cartă	None
înfățișaseși	Past
spumă	Past
seriosului	None
stingea	Past
atârna	Past
uit	Present
răzbun	Present
înfășurași	Past
psihiatria	None
ațâțarăm	Past
traduci	Present
împușcase	Past
tulbura	Past
retezasem	Past
atingea	Past
funcționaseră	Past
judeci	Present
împrumutau	Past
răsculăm	Present
semivocalei	None
păruiserăm	Past
rezolvase	Past
dezvoltaseși	Past
chitarei	None
contopit	Past
contraveniserăți	Past
diminuase	Past
spuseseră	Past
serbau	Past
clădi	Past
intenționând	Present
priorității	None
vrăjirăți	Past
secreta	None
insistase	Past
cumpătare	None
susținuseră	Past
rezolvară	Past
înfuriind	Present
bărbierilor	None
fluvialii	None
zbiera	Past
viroză	None
dulgherul	None
mormintelor	None
scoteau	Past
încarci	Present
ilegala	None
înfiat	Past
inflexibil	None
aduni	Present
adevăraților	None
raționali	None
dovediți	Present
zgăuri	Present
plutește	Present
simțise	Past
monogamia	None
cutremuraserăți	Past
intenționase	Past
descheiat	Past
pășunau	Past
mâzgăleai	Past
stropi	Past
maltezi	None
stimă	Past
înscria	Past
publicitatea	None
justiția	None
râzând	Present
histologiei	None
deschideau	Past
apuc	Present
strângeau	Past
apăsa	Past
racul	None
pornea	Past
sonetului	None
cântării	Past
fălirăți	Past
luciosului	None
deveniți	Present
oprii	Past
comunei	None
mișcau	Past
calculatoarele	None
prăda	Past
îngreunasem	Past
întrebau	Past
avânta	Past
tâmpeau	Past
șubredă	None
adoarme	Present
complexul	None
dezbrăca	Past
documentat	Past
înrădăcinând	Present
întinarăți	Past
aberantului	None
scormonind	Present
viețui	Past
atomul	None
rețelele	None
dezamăgite	None
împlântaserăți	Past
vizitând	Present
nerecunoscute	None
apucăm	Present
dovediseră	Past
fluturași	Past
clipei	None
ocroteau	Past
concepând	Present
despărțim	Present
întrebat	Past
unduia	Past
asiguri	Present
imaginară	Past
flexibilei	None
rămânem	Present
hreanul	None
acizii	None
estimat	Past
pătimit	Past
dormeau	Past
utilizând	Present
construit	Past
prinși	None
îngropând	Present
așteptarea	None
trecem	Present
înduplecasem	Past
răcorile	None
nega	Past
greșind	Present
modific	Present
omorâți	Present
continuei	None
pricepuseră	Past
gazat	Past
bășisem	Past
contraziceți	Present
intrăm	Present
unim	Present
platformei	None
deschidea	Past
rulăm	Present
parcările	None
îngălbenește	Present
pașca	None
întâlnind	Present
lății	Past
preferința	None
bocești	Present
rotundă	None
confluență	None
hrean	None
împingem	Present
ierbos	None
conjugat	Past
distruseseră	Past
îndeletnicii	Past
mâțele	None
omorâse	Past
încercui	Past
depănat	Past
hotărăște	Present
deplinătatea	None
omniscienta	None
smulgeți	Present
ghiciră	Past
descrescând	Present
spartă	None
înrudit	Past
prevestea	Past
săturase	Past
analizatorul	None
capitulară	Past
socializa	Past
dezavantaja	Past
sacul	None
inestetic	None
putrezea	Past
afinitățile	None
luând	Present
goleați	Past
actrița	None
lipsise	Past
bag	Present
eliminând	Present
activat	Past
fostelor	None
pingeliră	Past
cădea	Past
separaseși	Past
descălecat	Past
viețuia	Past
stejarii	None
minunaseră	Past
pregnantă	None
culegea	Past
goli	Past
tăcere	None
capeți	Present
ruina	Past
însuflețiți	Present
apari	Present
înțepaserăți	Past
zdrobiserăți	Past
scremui	Past
iernezi	Present
îndurau	Past
activau	Past
încercăm	Present
netezi	Past
canadienilor	None
întreba	Past
înmulțește	Present
dispusesem	Past
încăpățânată	None
pripit	Past
găsise	Past
luptaserăți	Past
naivul	None
lipsești	Present
vitamina	None
freamăt	Present
luptau	Past
unduiați	Past
măselariță	None
spulberi	Present
calcă	Present
exotici	None
bezmetic	None
place	Present
insulți	Present
obișnuiră	Past
întoarcem	Present
scormoneați	Past
apunea	Past
născut	Past
pulsat	Past
acuzi	Present
vechimii	None
vânduse	Past
încumet	Present
stăruiați	Past
inflamabilă	None
dogmaticilor	None
lansăm	Present
cotropit	Past
șovăiești	Present
atingem	Present
reciprocității	None
rupseseră	Past
abanoșii	None
rezolvaseși	Past
ștergătoarelor	None
scrisorile	None
introduse	Past
bunicii	None
pictate	None
abdicat	Past
defileurilor	None
abilă	None
cubism	None
călcaserăți	Past
agricultorului	None
socializasem	Past
locuind	Present
simplelor	None
ascultând	Present
lutoasă	None
studiat	Past
cotidienele	None
rotunjește	Present
excelat	Past
lăcrimat	Past
apocalipsului	None
uimitor	None
tâmplarilor	None
portabilității	None
ploile	None
acuzând	Present
mincinosului	None
refuzase	Past
zburdăm	Present
prânziră	Past
întâmpinase	Past
adăugase	Past
iei	Present
bârfise	Past
răni	Past
prindea	Past
legă	Past
încurajau	Past
bolnavilor	None
găuriră	Past
ieftinele	None
dres	Past
heringului	None
îngrămădeau	Past
depărau	Past
lotusul	None
obraznicele	None
pârghiilor	None
criminalului	None
aflăm	Present
socrii	None
țapilor	None
socrilor	None
paragrafelor	None
urcași	Past
sfătuiseși	Past
combinau	Past
miresele	None
părăsiți	Present
conversația	None
așteptaseră	Past
distingea	Past
slăbea	Past
împlântat	Past
înflorirăm	Past
posibilitățile	None
seducând	Present
riscat	Past
rămâneau	Past
întrezărea	Past
pierit	Past
izbi	Past
iepelor	None
păți	Past
ședea	Past
rescrise	Past
manechinul	None
pisezi	Present
vădirăm	Past
obișnuiserăm	Past
arzi	Present
amnarul	None
donațiile	None
iert	Present
uniți	Present
veneraserăm	Past
sfârticaseră	Past
forța	Past
numeri	Present
țărmurilor	None
trăiește	Present
locuit	Past
zânele	None
numărătorii	None
poruncește	Present
câștigaseră	Past
deșirând	Present
scălda	Past
algoritmului	None
înjurași	Past
împărții	Past
jupuit	Past
ruginește	Present
baschetului	None
bază	Past
transform	Present
împăcat	Past
apropiind	Present
tocase	Past
rupe	Present
intenționa	Past
împodobi	Past
bătea	Past
abandonaseră	Past
izbăvirăți	Past
dispunând	Present
bunicului	None
tinzând	Present
trecură	Past
împrumutară	Past
prospătasem	Past
continue	None
orientau	Past
dovediserăți	Past
neapăratele	None
grăbea	Past
înlocuim	Present
așteptă	Past
închidem	Present
baza	Past
naționalilor	None
grota	None
perfecte	None
terminase	Past
funcționarea	None
schimba	Past
dezghețat	Past
utile	None
pumă	None
engleză	None
împrumutăm	Present
relaxată	None
dezvoltat	Past
recuperase	Past
botezatul	None
incendiului	None
stingherește	Present
terminaseră	Past
urmărind	Present
strigase	Past
biclele	None
japonezilor	None
comporți	Present
cauți	Present
ardeați	Past
instabilități	None
foca	None
buburuzei	None
trădaseră	Past
histologice	None
purcelul	None
număraserăm	Past
întrebuințarăm	Past
supremațiilor	None
intru	Present
ghidară	Past
cocoloșim	Present
polarele	None
dispăruse	Past
ferea	Past
abiogenezele	None
iese	Present
necuviincioase	None
putu	Past
luare	None
colaboratorii	None
începi	Present
cineticelor	None
întrezărit	Past
decădeai	Past
coși	Present
drăguțului	None
ferestruiserăm	Past
promisiunilor	None
cruzii	None
uimea	Past
psihologiei	None
românului	None
canonirăți	Past
măgăriile	None
obezi	None
împărat	Past
fugiseră	Past
răspândeau	Past
chestiunea	None
legăturile	None
urâți	Present
asigura	Past
strâmtaserăm	Past
releele	None
înălțași	Past
îndrăgostești	Present
botezași	Past
scrimerul	None
disponibili	None
frontieră	None
așternuserăți	Past
chemând	Present
demn	None
intervenise	Past
numărase	Past
urbanizărilor	None
pasteurizăm	Present
economici	None
aprindeai	Past
judeca	Past
gândiți	Present
eleborul	None
proba	Past
mănânc	Present
coborând	Present
răcnim	Present
păianjenii	None
beleați	Past
râvnește	Present
produse	Past
sunând	Present
îmbunătățim	Present
îmboldind	Present
generalilor	None
singurei	None
lovești	Present
oxidului	None
adverbială	None
pofticioși	None
sfâșiat	Past
comandaseră	Past
crucificăm	Present
încrezi	Present
atacau	Past
cucerim	Present
veninoasă	None
onorat	Past
îmbinat	Past
amețelii	None
admir	Present
masculinul	None
albiciosul	None
învingem	Present
dezamăgeau	Past
preoțești	Present
adoraseși	Past
anatomica	None
cină	Past
călcat	Past
suci	Past
preejaculatoarei	None
tipărea	Past
trădau	Past
spurcat	Past
dezbinat	Past
răscoli	Present
jignim	Present
slăviți	Present
mărunțit	Past
zgardă	None
emoționaseși	Past
aciuat	Past
combinat	Past
pierduseră	Past
semnând	Present
engleze	None
răsturnaseși	Past
enormă	None
boteza	Past
implicând	Present
odihnim	Present
sperat	Past
cleștelui	None
scorpionii	None
sun	Present
safirului	None
rog	Present
însuflețise	Past
cuprinzi	Present
banilor	None
canadienii	None
intuiești	Present
mânea	Past
împodobeați	Past
mustra	Past
scuzaseră	Past
pocnește	Present
izbiseră	Past
retrase	Past
sufletul	None
genetici	None
străvechiul	None
minciunile	None
frunzoase	None
fachiei	None
încoronăm	Present
necinstitul	None
comportând	Present
structurali	None
excela	Past
plictisi	Past
învățau	Past
prăbușind	Present
esență	None
alegeau	Past
cantinierului	None
invadând	Present
înghițiți	Present
contopi	Past
coceau	Past
alianțelor	None
parmezanul	None
simții	Past
încurajezi	Present
bianuală	None
strămuta	Past
suveranei	None
lipi	Past
sinagogii	None
deplasarăți	Past
mâneca	Past
oacheșelor	None
fugea	Past
furat	Past
lucraseră	Past
lămurește	Present
creăm	Present
călătoriei	None
extrage	Present
sinucide	Present
pătat	Past
stăpânise	Past
utilă	None
amânând	Present
cățeii	None
salvă	Past
dialectale	None
împerechea	Past
explic	Present
observațiile	None
ascundeți	Present
bagi	Present
înșurubau	Past
controlase	Past
depănară	Past
schimb	Present
proverbul	None
murmurat	Past
zdrobeați	Past
intuisem	Past
vopsiți	Present
amuțiți	Present
sfătuia	Past
activezi	Present
scumpă	None
uns	Past
căzu	Past
mutau	Past
ocupaseră	Past
mursecarăm	Past
coborârăm	Past
zebrelor	None
iertăm	Present
jena	Past
răspuns	Past
intenționaseră	Past
gloanțelor	None
decădea	Past
valsase	Past
dansând	Present
îngrijește	Present
încrucișau	Past
discordie	None
folosise	Past
falusul	None
scârba	None
tânjea	Past
batjocoriți	Present
sufletesc	None
nenumărabilă	None
surpaserăți	Past
câștig	Present
apucau	Past
rețelei	None
antilopele	None
cunoscuților	None
căpușă	None
înduplecat	Past
formidabilele	None
gătiseră	Past
apucase	Past
votul	None
modificat	Past
botezând	Present
treabă	None
întrebând	Present
scuz	Present
solidității	None
fumegasem	Past
zăcământului	None
hotărând	Present
pornit	Past
ploaie	None
transformase	Past
leoarbei	None
fumez	Present
abanosul	None
îmbărbăta	Past
lovea	Past
joci	Present
digitalelor	None
fixă	Past
aflase	Past
drese	Past
dezgustător	None
propunem	Present
logat	Past
naști	Present
corcești	Present
adăstasem	Past
aluneca	Past
circulând	Present
universitatea	None
gâdili	Present
ascultat	Past
declarăm	Present
putut	Past
flăcării	None
scoate	Present
speri	Present
invizibilități	None
oprești	Present
recunoscuți	None
câștigat	Past
așterneai	Past
inducând	Present
născuse	Past
undița	None
mărginește	Present
îndepărta	Past
existat	Past
făcut	Past
abilitatea	None
temea	Past
spunea	Past
gospodină	None
scrierilor	None
străpunge	Present
aleilor	None
echinocțiule	None
întrebuințau	Past
scurtasem	Past
conducând	Present
oacheșilor	None
lipește	Present
cercetași	Past
bisericos	None
dobândise	Past
perechilor	None
oftaserăți	Past
stricăm	Present
intervenind	Present
săruta	Past
induce	Present
culc	Present
rămase	Past
traversă	Past
supremație	None
important	None
doamnei	None
pica	Past
orbii	Past
încărcase	Past
virile	None
autobuzul	None
specificului	None
sfulgerau	Past
rinocerul	None
complex	None
fractura	Past
amestecate	None
explicat	Past
vădirăți	Past
răspunse	Past
giaca	None
deplasat	Past
stânjeniserăm	Past
bogăției	None
umiliți	Present
slăvim	Present
sperând	Present
venera	Past
strângând	Present
clăti	Past
veneai	Past
citit	Past
serba	Past
orhidee	None
desculț	Present
socii	None
subțiat	Past
crezusem	Past
închinarăți	Past
adormiți	Present
adânciserăm	Past
tors	Past
încurajat	Past
apropiaseră	Past
lingvistica	None
umed	None
cunoscut	Past
plaja	None
încal	Present
impuneau	Past
îmblânzind	Present
asigur	Present
viezurele	None
pătrunse	Past
râvniră	Past
agresivul	None
stăpânești	Present
purcedeau	Past
astrucaserăți	Past
trase	Past
capitulat	Past
pieptănat	Past
cuvioși	None
furnicasem	Past
ungeau	Past
răsunau	Past
zdrobit	Past
separi	Present
italianca	None
vindecat	Past
principatului	None
conjugării	None
prezise	Past
descuiat	Past
aducătoare	None
merizăm	Present
scriptelor	None
îmbărbătase	Past
acoperit	Past
stăpâni	Past
veniseră	Past
sortești	Present
veniși	Past
ucis	Past
supraveghease	Past
scărmănat	Past
plantarăm	Past
peștele	None
cunoscutele	None
intra	Past
veni	Past
separăm	Present
strecuraserăm	Past
adevăratului	None
scurmarăm	Past
benzinăriei	None
lans	Present
obligase	Past
răgușit	Past
testiculule	None
spân	None
tușeați	Past
impunem	Present
podului	None
descălțase	Past
râde	Present
urzește	Present
salvezi	Present
scurtele	None
viețuiește	Present
creau	Past
mințitor	None
parcării	None
asemănarăm	Past
butoanelor	None
depărtând	Present
albilor	None
profesorule	None
lebedele	None
îmbătrânit	Past
sarcastica	None
vocii	None
mărturisi	Past
auzim	Present
pupi	Present
angajând	Present
explicând	Present
migrenelor	None
coopera	Past
creez	Present
înțepaseră	Past
atentului	None
câștigaserăți	Past
golești	Present
parcaseși	Past
fotbalistul	None
furnici	Present
crizantemele	None
înnegrit	Past
excelând	Present
propunea	Past
șefilor	None
plânsurile	None
pedepseau	Past
rezistând	Present
înserarea	None
înfierbântat	Past
îngriji	Past
neg	Present
închideau	Past
așeza	Past
dubioasele	None
pacea	None
pregătește	Present
ocrotea	Past
leșinaserăm	Past
îngâmf	Present
grase	None
prinsele	None
prăjiți	Present
piureul	None
angelica	None
ușurat	Past
părăsește	Present
schimbăm	Present
absoarbe	Present
papi	Present
delimitau	Past
slăvit	Past
înnorat	Past
închipuit	Past
aplica	Past
sculat	Past
umidități	None
recunoscuseră	Past
cercară	Past
strânge	Present
înverzirăm	Past
ghidând	Present
sfeclirăm	Past
încape	Present
înțeleseserăm	Past
împlini	Past
înfulecat	Past
ocupăm	Present
blond	None
custat	Past
rezistențele	None
crăpa	Past
moarte	None
cățea	None
invincibili	None
adopți	Present
desziceai	Past
întindem	Present
sorbisem	Past
tehnologie	None
aplecat	Past
păcălind	Present
parazitarele	None
împliniți	Present
fripți	None
construiseră	Past
păruseră	Past
tragea	Past
catedrală	None
întâmplau	Past
întemeiau	Past
șoptirăți	Past
reteza	Past
prăbușea	Past
aurii	Past
greșeau	Past
regicidule	None
curcubetă	None
drăguț	None
măsură	Past
întindea	Past
adormit	Past
veselele	None
felurilor	None
desfăcuse	Past
termina	Past
deschizi	Present
lăudaseși	Past
compuneau	Past
răbda	Past
mergea	Past
surului	None
însușirea	None
bulbuci	Present
răcește	Present
împuns	Past
vinzi	Present
confruntau	Past
ebraicei	None
fătul	None
nechbzuința	None
alchimic	None
vedeai	Past
veșnic	None
slavul	None
zburase	Past
săpunurile	None
despăduririle	None
orei	None
influențau	Past
opreau	Past
pătrunjelului	None
calendarul	None
petrecea	Past
sedus	Past
mânia	Past
zbor	Present
curmi	Present
grăbind	Present
focurilor	None
încăpea	Past
intenționăm	Present
plăcea	Past
preotul	None
slăvi	Past
marinii	None
fumega	Past
reduse	Past
inunda	Past
catastroficilor	None
știi	Present
contravine	Present
rupserăți	Past
rupturii	None
veșnice	None
zbârciseși	Past
concepeau	Past
înmulțit	Past
pornim	Present
aducând	Present
înjoseați	Past
muți	Present
țigănii	Past
clocotind	Present
avalanșă	None
dovedea	Past
descopăr	Present
învecinau	Past
plângeau	Past
descris	Past
slugărirăți	Past
jurau	Past
iertăciunii	None
cinat	Past
muzicală	None
diminuau	Past
treziți	Present
disecat	Past
stingheriți	Present
porniseră	Past
desprindeau	Past
bocetele	None
cocea	Past
micii	None
zărit	Past
naște	Present
documentez	Present
spinoșii	None
egalului	None
sudică	None
diminuat	Past
nivelă	Past
înțeleserăți	Past
capitulez	Present
furnicau	Past
iluzorii	None
răsuflat	Past
copiem	Present
vegheaserăți	Past
răstignit	Past
venisem	Past
forjat	Past
liniștii	Past
plictisești	Present
răzbunase	Past
labelor	None
aprinzi	Present
înfrânaseși	Past
moștenit	Past
inundară	Past
dizolva	Past
prospătaserăm	Past
poruncit	Past
buză	None
acumulasem	Past
interzisese	Past
cutreierarăți	Past
murind	Present
negat	Past
desfășurând	Present
cobor	Present
delimitărilor	None
împărțirăm	Past
înrudeați	Past
muta	Past
orzul	None
sortiți	Present
galfede	None
tivii	Past
pății	Past
mâneci	Present
rasei	None
automobilul	None
cumnații	None
prostește	Present
utilizau	Past
golit	Past
mureai	Past
adăugau	Past
încetat	Past
îndrăgosti	Past
tăcut	Past
înclina	Past
produs	Past
depusese	Past
copereai	Past
puturoasă	None
pastorilor	None
capsulaseși	Past
impunând	Present
necăji	Past
sferică	None
ascute	Present
slujind	Present
căpătâielor	None
satisfacem	Present
uraganul	None
scriem	Present
deprins	Past
slujește	Present
însufleți	Past
transparenței	None
invariabililor	None
câmpeneasca	None
orientând	Present
limpezeați	Past
ceainicule	None
răpit	Past
ruginit	Past
desenând	Present
suflaseși	Past
supuneau	Past
ardeau	Past
încoronat	Past
prime	None
stânga	None
șoarecii	None
craniilor	None
străbătut	Past
excursia	None
interveneau	Past
înmulțind	Present
ghicim	Present
trimiseră	Past
pisică	None
dezamăgiți	Present
cartilajele	None
presupusei	Past
impuneți	Present
vaccină	Past
cartei	None
înfăptuia	Past
somnoros	None
oxidul	None
diseca	Past
asexualitate	None
anihila	Past
abiogeneză	None
implicase	Past
dispăreau	Past
prindeți	Present
legănarăți	Past
risipind	Present
acoperiși	Past
borârăți	Past
stins	Past
golise	Past
putrezește	Present
cuvintelor	None
obținem	Present
trăi	Past
arborii	None
săriți	Present
înșelat	Past
renovat	Past
extindea	Past
păreau	Past
înfoiarăți	Past
castanie	None
tras	Past
întreținuse	Past
cobaii	None
frână	Past
rupte	None
scriseserăți	Past
documenta	Past
răspundeți	Present
delimitând	Present
pădurarul	None
pinguinul	None
eronatei	None
închipuii	Past
înrâuriși	Past
furau	Past
castra	Past
aminti	Past
piersicile	None
dispuse	Past
mărităm	Present
palincile	None
căsătorește	Present
copleșea	Past
cosmic	None
acvilă	None
conținând	Present
borăști	Present
înmulțea	Past
sticlele	None
târziul	None
azerii	None
iubești	Present
tâmplarului	None
uscatul	None
rezolvau	Past
uimiți	Present
închizând	Present
susțineau	Past
mursecând	Present
împlineau	Past
treptei	None
echilibra	Past
musculoasei	None
construiește	Present
decapitând	Present
nudul	None
convinseși	Past
încruntat	Past
jenat	Past
rămâneți	Present
pătrundem	Present
înfrânat	Past
speriind	Present
fluturelui	None
grădinii	None
întâlni	Past
perfectului	None
mărginiți	Present
oilor	None
lipsurile	None
zgâiți	Present
măsor	Present
dovedeau	Past
crapul	None
slăbiți	Present
memorizat	Past
atenta	None
sacului	None
începeau	Past
spulbera	Past
dezgustat	Past
slăbise	Past
tereștri	None
jucase	Past
prospătezi	Present
lungiți	Present
bara	Past
taurilor	None
malul	None
potrivisem	Past
înfășurat	Past
adun	Present
cineticele	None
demnele	None
locuinței	None
descheiau	Past
sinonimul	None
dispăru	Past
scorțișoare	None
aude	Present
introdusese	Past
pricepeau	Past
conjuncției	None
arnicii	None
intraseră	Past
trezeau	Past
dansatorului	None
menținea	Past
înnoi	Past
încânt	Present
ștergea	Past
mielarule	None
preistoriei	None
completași	Past
vorbitoarele	None
făurești	Present
ciocnind	Present
pricepem	Present
săpunurilor	None
decăzut	Past
mergeți	Present
cumineca	Past
masiva	None
prelungind	Present
fugise	Past
borați	Past
supraveghind	Present
dovedind	Present
vindeci	Present
visat	Past
hibernaserăți	Past
învăluraseră	Past
alegând	Present
întorci	Present
celebrat	Past
căra	Past
tociți	Present
opăritele	None
terminau	Past
sălbaticului	None
boala	None
migdală	None
ceteraseși	Past
observasem	Past
balconule	None
lovise	Past
adorând	Present
conducem	Present
furând	Present
alăptând	Present
intui	Past
crease	Past
vizualizezi	Present
prindem	Present
minuscul	None
tăgăduiți	Present
masacrele	None
tubului	None
vede	Present
împerecheași	Past
vorbești	Present
bârfiseră	Past
respirăm	Present
alunecând	Present
încercuit	Past
copacul	None
lași	Present
însărcinat	Past
spuneai	Past
sărate	None
îngrămădirăți	Past
panteismule	None
chem	Present
înghesuind	Present
mahalalele	None
plictisiră	Past
perindaseră	Past
anatomiei	None
atinse	Past
părăsești	Present
unsorilor	None
conturului	None
otrăvirăți	Past
orchestrele	None
întrerupsese	Past
lucios	None
mâncând	Present
urdinarăți	Past
susținea	Past
dezveți	Present
referendumului	None
sulurilor	None
întremași	Past
spăl	Present
simțind	Present
posibilitate	None
mutația	None
îndurând	Present
lăsat	Past
îmbunătățise	Past
despăduririlor	None
maltrataserăm	Past
cules	Past
recuperă	Past
apărură	Past
perindaseși	Past
nodoasa	None
vrăjește	Present
striga	Past
problema	None
vaccinezi	Present
protejez	Present
brună	None
găsisem	Past
mamelor	None
păzim	Present
coborî	Past
prostești	Present
oacheșei	None
țitera	None
orzului	None
agentelor	None
cărând	Present
vându	Past
rătăcește	Present
car	Present
sperase	Past
ciocârlanilor	None
introduceau	Past
scoți	Present
apărea	Past
bisericoasa	None
întâlneau	Past
deplasaseși	Past
observi	Present
schimbase	Past
artisticelor	None
străzii	None
stricând	Present
lauzi	Present
zărind	Present
pregeta	Past
cumpăr	Present
susținut	Past
iarbă	None
socul	None
budismul	None
dezvoltaseră	Past
amestecăm	Present
ocupi	Present
orașul	None
interviul	None
distracției	None
prezervativului	None
existau	Past
ghiciți	Present
spurcatul	None
lânii	None
împletit	Past
reținuse	Past
expoziția	None
învioraserăm	Past
exagerând	Present
socotind	Present
orbi	Past
viețuiau	Past
glumind	Present
dorit	Past
existase	Past
rostogolit	Past
lalea	None
furioase	None
grăbit	Past
străpungând	Present
moșteniseră	Past
foamete	None
viforelor	None
știai	Past
specifici	None
prădând	Present
descarci	Present
trezirea	None
îngrășat	Past
începeți	Present
cooperat	Past
dictaserăți	Past
distilarea	None
prevestit	Past
pictau	Past
stăruind	Present
îndulceai	Past
fixat	Past
decapitau	Past
șanselor	None
sântului	None
hotărî	Past
comportăm	Present
înfruntau	Past
ofensatoare	None
înconjuraseră	Past
transformând	Present
reia	Present
plafonului	None
tipări	Past
inteligentă	None
lucrurile	None
reluând	Present
rupând	Present
limpezi	Past
încerci	Present
străbătea	Past
epuizând	Present
spânzura	Past
roșie	None
griurilor	None
știe	Present
mândrea	Past
făinii	None
fumaseși	Past
acronimule	None
păcăleau	Past
amăgiseși	Past
stăruia	Past
prinserăm	Past
luăm	Present
corcea	Past
ferestrei	None
aprinsese	Past
sugrumat	Past
sfătui	Past
dormiseră	Past
batjocori	Past
dezbrăcaseși	Past
fumegase	Past
răpuse	Past
greșiși	Past
lins	Past
ierarhiei	None
găsiseră	Past
căsătoreați	Past
porcușorii	None
cinstiră	Past
judecăm	Present
adormind	Present
înțelesului	None
funcționând	Present
cumpliți	Present
termometrele	None
lăsase	Past
bărbierește	Present
înfășurasem	Past
sosurilor	None
vizualizarea	None
trăiți	Present
întortocheaseși	Past
întâmpinau	Past
șacalul	None
scoapseși	Past
reușiseră	Past
mijlocii	Past
masacrul	None
tăbăcit	Past
goleau	Past
falezele	None
păstraseră	Past
garoafă	None
contrazis	Past
salutat	Past
cobora	Past
cocoșul	None
artera	None
prelungește	Present
elimina	Past
săltat	Past
purităților	None
împrejmuit	Past
ședințelor	None
voioși	None
ștergeți	Present
fermierul	None
gândeau	Past
amintește	Present
cearșafului	None
pricepe	Present
diacriticelor	None
descoperind	Present
încuiară	Past
ascunsului	None
citeau	Past
originalității	None
orgasmice	None
cosmonauților	None
flămânde	None
polonezei	None
decideau	Past
cămilă	None
urcând	Present
desculți	Present
fenixul	None
croiește	Present
scurgea	Past
îngrășau	Past
aera	Past
bărbătoaselor	None
farului	None
absorbiseși	Past
țipat	Past
conduceți	Present
bășiseși	Past
fumegând	Present
bulgarului	None
gâsca	None
corupi	Present
distra	Past
țintiră	Past
corceau	Past
marinului	None
menestrelii	None
îndrăznea	Past
adopt	Present
înlesnit	Past
probarăm	Past
decăzuse	Past
grelele	None
desfășura	Past
sărătura	None
desfășurat	Past
cerut	Past
treapta	None
nominală	None
uciderile	None
parazitar	None
închipuiși	Past
ține	Present
furaseră	Past
dovleacule	None
apăsăm	Present
mulțumim	Present
stătuse	Past
scânteia	Past
circula	Past
înverșunând	Present
ținând	Present
mulsese	Past
invincibila	None
îndrăgostit	Past
urmăm	Present
arcului	None
înfăptuind	Present
auri	Past
lansaseră	Past
răspândea	Past
speriat	Past
conjuga	Past
alcătuiau	Past
cinând	Present
întoarse	Past
dărâmi	Present
generalii	None
gaza	Past
mutase	Past
slăbeau	Past
dinozaurule	None
beregată	None
sărind	Present
chimica	None
trezeai	Past
înscris	Past
scald	Present
iscăliși	Past
îndopasem	Past
atacase	Past
deranjezi	Present
acuzate	None
atragem	Present
pupăza	None
clădirea	None
mobilului	None
inteligenții	None
castorii	None
înfipsei	Past
busolelor	None
intervino	None
păzind	Present
naștere	None
încăpățânatul	None
laba	None
propune	Present
curgând	Present
caut	Present
sângerând	Present
funcționăm	Present
păstrezi	Present
moștenește	Present
circulară	Past
îndulciseși	Past
maltezii	None
cărau	Past
scădem	Present
freca	Past
dezrădăcinat	Past
ghicea	Past
angajat	Past
anonimității	None
închidea	Past
ascult	Present
păcăliți	Present
înspăimântasem	Past
obișnuit	Past
atacat	Past
spuma	Past
amuțiră	Past
purcedea	Past
menținuseră	Past
plec	Present
felină	None
stabilești	Present
adâncește	Present
umedei	None
stăpâneau	Past
urcat	Past
cinstea	Past
intenționaseși	Past
pistonule	None
trântirăți	Past
potrivește	Present
tâmpenie	None
îmbinarăm	Past
asigurase	Past
urcau	Past
acvatică	None
pierii	Past
democratice	None
dezlega	Past
furăm	Present
căzuserăm	Past
așezau	Past
nostalgicei	None
rescrii	Present
desculțe	None
obținerile	None
cufuri	Past
sângerez	Present
pieptene	None
soma	Past
modificând	Present
apărui	Past
amestec	Present
capsula	Past
blochez	Present
observau	Past
socotite	None
mișcării	None
înfăptuiește	Present
doinelor	None
legănat	Past
meritat	Past
plătise	Past
lipseau	Past
descompune	Present
atârnau	Past
pețea	Past
ridicau	Past
gravatelor	None
activa	Past
puteți	Present
strecurași	Past
plâns	Past
dorii	Past
mențineți	Present
târgurilor	None
exemplule	None
însărcinase	Past
afumat	Past
ciugulea	Past
distruse	Past
neadaptați	None
abandonez	Present
evins	Past
păstra	Past
rugilor	None
sucit	Past
răsziseseși	Past
strecurau	Past
masivei	None
anim	Present
brazda	None
zăceau	Past
nopțile	None
sparge	Present
număr	Present
eliminat	Past
admirăm	Present
lupt	Present
rasele	None
oftez	Present
înlăturând	Present
masculine	None
despărțeau	Past
obții	Present
căzuserăți	Past
despica	Past
canoneau	Past
căzuse	Past
apocalipticul	None
simple	None
cuminți	Past
credeai	Past
înfloriți	Present
central-europeana	None
lingvistice	None
conteniți	Present
pușcăria	None
încercuiseră	Past
încercase	Past
satisface	Present
mărturisea	Past
conduceau	Past
desfășuraseră	Past
preferase	Past
întreținând	Present
nutrit	Past
scuturi	Present
socializarăm	Past
studiez	Present
mirosind	Present
rută	None
contagiosului	None
rugii	Past
stinge	Present
nominalul	None
stând	Present
schimbului	None
trăise	Past
vedeți	Present
bănuiți	Present
cutremurăm	Present
locuise	Past
lovind	Present
independența	None
bacteriilor	None
ispitiți	Present
terapiei	None
răspândește	Present
pornii	Past
alergă	Past
existaserăm	Past
tatuat	Past
ador	Present
udat	Past
grațiile	None
saturat	Past
agresivă	None
semnase	Past
mesteca	Past
răspunzi	Present
chinurilor	None
autozomilor	None
putrezi	Past
realul	None
păreți	Present
plutim	Present
înverzit	Past
urâtului	None
zdrobirăm	Past
omorau	Past
decădere	None
căprița	None
transformăm	Present
leucemii	None
plictisea	Past
gândim	Present
dărăpănau	Past
îmbogățise	Past
început	Past
blonzii	None
chemă	Past
zăcea	Past
țestosului	None
porumbeii	None
descrie	Present
obligând	Present
distingem	Present
prelungea	Past
împodobiți	Present
identitățile	None
înșiraseși	Past
tremurând	Present
elementarii	None
atrocitățile	None
plătit	Past
piersicaserăm	Past
adunaseși	Past
strigând	Present
pregătind	Present
prevestind	Present
atingând	Present
împiedici	Present
obține	Present
benzina	None
bând	Present
întâlneați	Past
împrejmuiseși	Past
întrebuințând	Present
înfrățiți	Present
greșeați	Past
râvnit	Past
ascundem	Present
trecuseră	Past
dansa	Past
supraveghea	Past
căsătoriți	Present
așezăm	Present
afundăm	Present
înjuri	Present
tălmaciului	None
stinse	Past
lipsi	Past
coborați	Past
burtoșii	None
imputat	Past
distrugi	Present
lungit	Past
suspin	Present
vorbii	Past
artistice	None
urla	Past
crescuseră	Past
fraudă	Past
găurii	Past
bărbierule	None
exploatare	None
balcanice	None
merse	Past
anulat	Past
ferici	Past
folositoare	None
descompus	Past
răzgândise	Past
bizonii	None
tulburau	Past
boală	None
aduna	Past
deliciosului	None
măturat	Past
acelor	None
învolburând	Present
uscată	None
uita	Past
dogmaticii	None
spăla	Past
scăpând	Present
lucezilor	None
curăț	Present
înfundaserăți	Past
cucereau	Past
zmeurului	None
enciclopediilor	None
vâna	Past
țările	None
tăgăduit	Past
avortat	Past
persanilor	None
storseseși	Past
lăudând	Present
traversăm	Present
crezut	Past
bianual	None
monocrome	None
pare	Present
șeii	None
cununa	Past
surprinzători	None
prevesti	Past
traduce	Present
frământat	Past
furios	None
grăbești	Present
încălzea	Past
azvârle	Present
copăr	Present
îngânaseși	Past
alotropică	None
găsești	Present
dospești	Present
disprețurilor	None
bravi	None
recunoști	Present
părăsind	Present
tăiaseră	Past
îmbulzii	Past
îngrijiți	Present
ușurasem	Past
păru	Past
așezaseră	Past
meriți	Present
mulțumea	Past
puparăm	Past
crunta	None
cădeați	Past
flexibili	None
obținuseră	Past
suveranitate	None
sărbătorind	Present
vindecau	Past
vizitării	None
interveni	Past
tinde	Present
încântat	Past
tiramisule	None
reînnoirăți	Past
contopiși	Past
trimis	Past
turnași	Past
singur	None
ospăta	Past
numim	Present
cooperară	Past
ținea	Past
rezolvat	Past
frământase	Past
declinare	None
greșești	Present
avansa	Past
bolnavele	None
lepădat	Past
distracțiilor	None
dezrobit	Past
slaba	None
josului	None
crucificaserăm	Past
asigurau	Past
ghida	Past
ageră	None
cercetărilor	None
crudul	None
îngălbenisem	Past
îmblânzi	Past
comporta	Past
odăile	None
sfârcurilor	None
răspândit	Past
subsonice	None
pungii	None
aisbergurilor	None
lubrifiantule	None
pășunaseră	Past
concepurăm	Past
porniserăm	Past
întemeiat	Past
împrumutând	Present
varză	None
numiseră	Past
anulăm	Present
dospea	Past
păcătuiește	Present
transatlantice	None
jignești	Present
strâmbi	Present
capăt	Present
declin	Present
scriitorului	None
risipit	Past
dezbina	Past
croia	Past
clește	None
prețuiră	Past
îndulcește	Present
desfăceau	Past
moșierul	None
ațipit	Past
luasem	Past
răsfoiți	Present
smintiți	Present
înavuțit	Past
îmbrățișat	Past
prezisese	Past
opririle	None
pluralitatea	None
încerca	Past
clarificat	Past
certi	Present
punctez	Present
încadrarăți	Past
dezleg	Present
adunaseră	Past
importantul	None
consoana	None
chițăiau	Past
intensitățile	None
orbește	Present
obținând	Present
bucătăriei	None
brunei	None
veștejise	Past
rupse	Past
bulucirăți	Past
descoperim	Present
sarcastică	None
impui	Present
adăugând	Present
adânci	Past
divorța	Past
scurtului	None
stepele	None
oftat	Past
liberă	Past
umiditatea	None
fraternitatea	None
produce	Present
tincturarăți	Past
botez	Present
răcoriră	Past
amicalul	None
desface	Present
prădau	Past
acuzat	Past
purica	Past
nefertilizatei	None
ciclist	None
înfățișând	Present
străbăteau	Past
întinaseși	Past
trombonul	None
fierbând	Present
utiliza	Past
locuiau	Past
bășici	Present
risca	Past
aducea	Past
apucaseră	Past
înfulecaserăm	Past
rămăseseră	Past
dezunirăți	Past
averea	None
acoperind	Present
votca	None
tragem	Present
muncă	None
perechea	None
citi	Past
prezentele	None
îngrijit	Past
serviră	Past
dispărea	Past
deranjat	Past
vamali	None
topind	Present
legăturilor	None
lesbiene	None
visezi	Present
abdica	Past
încăriseră	Past
roșului	None
interziceau	Past
servim	Present
completez	Present
lingând	Present
răsfățat	Past
amuza	Past
antimateriei	None
rezemat	Past
ghilotinei	None
întrezărește	Present
urmă	Past
împingând	Present
plămânule	None
ghidat	Past
sărbătorit	Past
simfoniilor	None
lucrase	Past
crește	Present
cioplește	Present
învingeau	Past
luaseră	Past
amorțise	Past
plantau	Past
apăruseră	Past
inutil	None
confruntând	Present
supraviețuise	Past
îngrămădiră	Past
încurca	Past
blestemul	None
anulau	Past
conopidă	None
deschide	Present
colaboratorului	None
construiși	Past
spectral	None
bucium	Present
lampă	None
scuturăm	Present
sării	Past
plumburia	None
încălzit	Past
parazitară	None
strânsese	Past
anticului	None
fulgerat	Past
uscat	Past
ventilatorule	None
gâștele	None
încadrezi	Present
piețele	None
dăpăra	Past
șoaptei	None
șmecherie	None
împrejmuiește	Present
necăjiți	Present
convingem	Present
scufundau	Past
prețuiești	Present
dispus	Past
bietului	None
poftiți	Present
presupuneau	Past
puturoaselor	None
vărsa	Past
pătrunde	Present
bășica	Past
naivilor	None
bănuit	Past
stăturăți	Past
împărțea	Past
gândind	Present
scobiseși	Past
oripilat	Past
sfințit	Past
uitând	Present
urmăreau	Past
incendiul	None
asemănă	Past
reluăm	Present
ajutând	Present
dictăm	Present
marină	None
insulei	None
învăț	Present
fijiană	None
pederastice	None
râdem	Present
perfecților	None
literele	None
ulițelor	None
mingile	None
distilat	Past
măruntei	None
excita	Past
uităm	Present
încăpățânaților	None
distrat	Past
elibera	Past
invizibil	None
înverșunez	Present
globului	None
bolilor	None
ceterat	Past
ponegrești	Present
intri	Present
reînnoiește	Present
suflase	Past
descurcat	Past
mămică	None
spus	Past
invita	Past
plutit	Past
căpătaserăți	Past
răpește	Present
bălăim	Present
glumea	Past
constă	Present
vizibili	None
luminile	None
urmezi	Present
tărâțele	None
ștergând	Present
pocniți	Present
sălbatici	None
amânat	Past
opărite	None
lacului	None
înfometa	Past
întrevăzui	Past
strâmtă	Past
stimula	Past
plini	None
depui	Present
răneai	Past
pictase	Past
săreau	Past
suntem	Present
ferestrele	None
dorește	Present
prinseseră	Past
înlături	Present
căzută	None
fugind	Present
înviorași	Past
geamurilor	None
sporirăți	Past
donau	Past
curechiul	None
păzit	Past
asemănat	Past
distrusese	Past
luase	Past
ofensatoarea	None
murise	Past
reușea	Past
ierți	Present
părăsim	Present
încurajarăm	Past
cloci	Past
părăsi	Past
rață	None
lungim	Present
merseseră	Past
canadianului	None
turnând	Present
ferestruitul	None
muiarăm	Past
sfătuise	Past
urcaseră	Past
excavă	Past
suverana	None
pierdeți	Present
murdării	Past
învecinaseși	Past
astupat	Past
înviorat	Past
deprinse	Past
lichidității	None
vrăji	Past
cununat	Past
monotonia	None
încăpuse	Past
ațâțat	Past
forja	Past
atotputernicul	None
greață	None
fugiți	Present
răstigniți	Present
răsfiraserăți	Past
risipiți	Present
ceainicul	None
mărginea	Past
subscrise	Past
compara	Past
umplut	Past
uitat	Past
munciți	Present
acoperise	Past
feriși	Past
zarzărelor	None
susținuse	Past
nemila	None
venea	Past
constrâns	Past
putreziți	Present
sărit	Past
cerc	Present
aeră	Past
grosimea	None
cronicele	None
rostim	Present
mutând	Present
economiilor	None
omenirea	None
ajutat	Past
lotușilor	None
clarificând	Present
cântat	Past
spulberat	Past
potrivi	Past
scumpirăți	Past
orbiți	Present
amesteca	Past
grelelor	None
terapeuticul	None
răsuna	Past
ferești	Present
kidnapping	None
înscriind	Present
plecaserăți	Past
dimensionării	None
căzuseră	Past
suferințele	None
încărcat	Past
vindea	Past
supraviețui	Past
lansat	Past
îndrăzneau	Past
conveni	Past
arăți	Present
vipturilor	None
fremătând	Present
băteau	Past
traiectoriilor	None
blocat	Past
îngrozitoare	None
sărbătoriți	Present
atârnarăm	Past
introduseseră	Past
moare	Present
ciclistul	None
aerodromurile	None
trăsnim	Present
zircon	None
bulucii	Past
francezii	None
amețit	Past
devenise	Past
îmbogăți	Past
religiilor	None
protejau	Past
contraziserăm	Past
viperă	None
ieșire	None
desfăcură	Past
nădăjduisem	Past
prețuim	Present
minuscule	None
luciosul	None
distrezi	Present
înfiripaăm	Present
eliberăm	Present
rândunicilor	None
încuiat	Past
strica	Past
învecina	Past
sufocau	Past
puritate	None
rețineau	Past
despărțind	Present
tunde	Present
trăim	Present
încărcau	Past
recunoaștem	Present
dururoasa	None
alinând	Present
sinagoga	None
crăpat	Past
spunând	Present
mâhnirăți	Past
chema	Past
sugerea	None
aninară	Past
ieftini	Past
prietenie	None
masturbarăm	Past
însoțiseră	Past
aruncau	Past
arsese	Past
actorul	None
extras	Past
gardul	None
făgetele	None
bigă	None
peticește	Present
înfățișat	Past
înconjurau	Past
mistreților	None
apucând	Present
împușcat	Past
sapei	None
obișnuind	Present
mențineau	Past
teme	Present
înfruntând	Present
plăcerii	None
presupus	Past
preziceau	Past
vacilor	None
lăsaseră	Past
mândrim	Present
desparte	Present
amenințași	Past
spart	Past
prăjind	Present
inflamabililor	None
întemeiem	Present
căutat	Past
prăpădit	Past
pătruns	Past
injectaserăm	Past
reținem	Present
ocupând	Present
drăgălașe	None
pierind	Present
fiicele	None
ecranele	None
închipuind	Present
grăbitele	None
așeză	Past
prădaserăți	Past
construiți	Present
viermuiește	Present
râma	Past
seduce	Present
răzgândit	Past
fertili	None
apuca	Past
trecut	Past
folosi	Past
visarea	None
greșește	Present
intenționezi	Present
rotundul	None
îmbrăca	Past
meșteai	Past
gazelele	None
adunarăm	Past
încălțat	Past
pășunasem	Past
extindem	Present
înfocat	Past
întemeiaseră	Past
descărcarăm	Past
abandonării	None
forțând	Present
întâlniți	Present
așezând	Present
ascundea	Past
junia	None
orientare	None
ghicește	Present
renovând	Present
cunoaștem	Present
înnegrim	Present
prezentării	None
traversând	Present
stângii	None
zebra	None
dopului	None
curmalei	None
stabilit	Past
spânzurăm	Present
înlăturat	Past
deplasase	Past
cancerul	None
închideți	Present
înjurăturile	None
începu	Past
dispărut	Past
forțarăți	Past
hotăra	Past
rumegaserăți	Past
fumarului	None
dezamăgit	Past
petreceți	Present
șterge	Present
scuiparăm	Past
amintirăm	Past
devenind	Present
superi	Present
verișoara	None
viilor	None
echilibrului	None
moștenind	Present
pingelește	Present
deplasaseră	Past
nădăjduia	Past
discuțiile	None
ziceți	Present
praful	None
invizibilul	None
schiorul	None
bibanii	None
fusarului	None
înfășurau	Past
invadau	Past
simțea	Past
vindecând	Present
ușuratică	None
murdărit	Past
descrește	Present
aștepta	Past
crezi	Present
fixa	Past
muștelor	None
numind	Present
începea	Past
folosește	Present
veghe	Past
destrama	Past
plămânul	None
acopereau	Past
râvneați	Past
vorbisem	Past
avântat	Past
corneele	None
scufundatului	None
unseseși	Past
bulbuc	Present
lipsurilor	None
serviseră	Past
întemeia	Past
plătim	Present
ornată	None
delăsarăm	Past
broaștelor	None
împletește	Present
cântau	Past
împrejmuiau	Past
albaneze	None
completăm	Present
zicea	Past
plătește	Present
fugit	Past
dură	None
cinste	None
cascadă	None
muncilor	None
utili	None
terminând	Present
gorunului	None
rupem	Present
trimițând	Present
scurge	Present
fremătași	Past
delfinul	None
schimbaseră	Past
pornografice	None
scoase	Past
sughiț	Present
democratizării	None
pătrarului	None
înoți	Present
nenorocit	Past
bacteria	None
însoțeau	Past
ardea	Past
oprit	Past
suferinței	None
românei	None
viguroasa	None
adânciți	Present
merizând	Present
trimise	Past
purcede	Present
nerușinată	None
căscat	Past
lățit	Past
înscriau	Past
lămuriți	Present
influență	Past
discreției	None
cerca	Past
frontiera	None
mergem	Present
înțelesesem	Past
încălziți	Present
devierea	None
impuseseră	Past
școlarii	None
ghidaserăți	Past
anonimilor	None
barat	Past
salamul	None
diminuând	Present
halucinase	Past
dispărând	Present
forțezi	Present
gnosticilor	None
cerșit	Past
englezii	None
locuia	Past
lăsăm	Present
fălești	Present
împușc	Present
turbat	Past
anihilasem	Past
descompunând	Present
împodobind	Present
închisele	None
stingi	Present
scriitorule	None
introduserăți	Past
deprinde	Present
întrerupeau	Past
tinzi	Present
rugea	Past
producerilor	None
curcile	None
scria	Past
logodise	Past
salivei	None
popular	None
insistat	Past
iepurarii	None
nutri	Past
iubise	Past
frământau	Past
arunca	Past
lucra	Past
greșiți	Present
rezistat	Past
sângerul	None
prăjește	Present
stânjeneau	Past
minunaserăți	Past
adoptase	Past
prețuiți	Present
rece	None
contraveneau	Past
duhurile	None
cornuții	None
vizualizarăm	Past
înmânând	Present
ațipim	Present
explica	Past
rosei	Past
aruncaseră	Past
îmbrățișaseră	Past
muriți	Present
curăturii	None
rupeți	Present
țăcănea	Past
tovărășiei	None
pasând	Present
păcălește	Present
micșorau	Past
curmând	Present
orientăm	Present
slăbim	Present
petrecu	Past
trimite	Present
părea	Past
respingerile	None
potrivea	Past
tipărise	Past
intuit	Past
cearșaful	None
temeți	Present
apărut	Past
grăbită	None
comandând	Present
clădire	None
nuda	None
putem	Present
căutaseră	Past
lămurisem	Past
curățaseră	Past
susține	Present
blestemele	None
plimbat	Past
alcătuit	Past
întreprindeți	Present
morcovul	None
plângea	Past
speriem	Present
așezat	Past
interzicem	Present
punctași	Past
viețuind	Present
trădase	Past
ucizi	Present
măsurau	Past
mulsură	None
hotarele	None
înmulțirăm	Past
rămâne	Present
deranjez	Present
dramaticul	None
juisaseși	Past
despărțiră	Past
cuvenea	Past
cutremurat	Past
loveau	Past
anihilat	Past
putrezit	Past
ciocolata	None
constați	Present
anulase	Past
găinușă	None
bate	Present
izbăvește	Present
datorăm	Present
absorbiți	Present
doarme	Present
completa	Past
pierdu	Past
lungești	Present
bleu-ule	None
părem	Present
spera	Past
înnegreau	Past
depărta	Past
aiorul	None
extinseseră	Past
îmbinând	Present
prețuii	Past
cugetând	Present
învechit	Past
stătu	Past
dezbinaserăm	Past
străbătuse	Past
comandat	Past
limpeziciune	None
mediocre	None
arbustului	None
țesând	Present
înconjurând	Present
prelungiseră	Past
venericului	None
tridimensional	None
masivului	None
poșta	None
bombardamentul	None
intranzitive	None
iubea	Past
înfrățit	Past
chiftea	None
înțepă	Past
turba	Past
conținea	Past
frământa	Past
rugaserăți	Past
slăbit	Past
inutila	None
portarii	None
sporisem	Past
răpunând	Present
popularii	None
bazând	Present
dispari	Present
venit	Past
începuseră	Past
decăzând	Present
mâncase	Past
prieteniilor	None
băuse	Past
distrugea	Past
eliminaseră	Past
fertilitatea	None
făcură	Past
ghidăm	Present
despărțeai	Past
îndepărtau	Past
culca	Past
origine	None
iernasem	Past
scăldat	Past
proastelor	None
răci	Past
supranațional	None
îndesat	Past
nebunește	Present
scurt	None
înșeuând	Present
măturând	Present
încăperilor	None
curățând	Present
bomba	None
auzind	Present
urâm	Present
râseși	Past
infinitate	None
vădim	Present
cazi	Present
degerasem	Past
măreți	None
scuzat	Past
căsătoriilor	None
cercetând	Present
valsaseși	Past
dezmeticisem	Past
clădirăm	Past
perja	None
închinăm	Present
structurată	None
soarele	None
înfoiarăm	Past
pasăre	None
augurând	Present
moașa	None
pișaturilor	None
văduvi	Past
inelele	None
violeți	None
golind	Present
lipim	Present
radem	Present
oglindeau	Past
adormii	Past
înotat	Past
acvatice	None
împila	Past
malului	None
neașteptaţilor	None
depune	Present
supusese	Past
dobândea	Past
sfințești	Present
ubicuilor	None
șerbim	Present
toarnă	Present
măsliniu	None
caracatiță	None
optici	None
mucoase	None
nivelat	Past
pictură	None
apare	Present
înverzește	Present
grăiește	Present
tociseși	Past
caisele	None
întărâtarăm	Past
speriatului	None
inseparabile	None
jucând	Present
venim	Present
copia	Past
răsunând	Present
ucideau	Past
caracatiței	None
linsesem	Past
râmele	None
cântăreții	None
deprinsei	Past
împrumut	Present
amorți	Past
coapse	Past
preveni	Past
amânarăm	Past
șerbești	Present
imnurilor	None
ridic	Present
întreprinzi	Present
sfârșiți	Present
drepturilor	None
răspândi	Past
descriind	Present
slugări	Past
înlesnea	Past
slăvești	Present
portocalia	None
anin	Present
controlau	Past
ridicând	Present
tentanții	None
accidental	None
grasa	None
fierarul	None
invitau	Past
curmaseră	Past
ocrotind	Present
alergau	Past
vrăjilor	None
dublând	Present
plantat	Past
fericit	Past
mărețului	None
tăieturile	None
sacii	None
știuseși	Past
plantară	Past
surprinse	Past
centrale	None
bluză	None
unidirecționale	None
gătea	Past
boxerul	None
urmasem	Past
înghesuiți	Present
ghici	Past
bășicasem	Past
unise	Past
cugetat	Past
descins	Past
diminua	Past
microbiologiei	None
geacă	None
fiind	Present
delictului	None
nădăjduiți	Present
ferind	Present
explicativă	None
slujiseră	Past
extinsese	Past
nimeri	Past
scurse	Past
asudasem	Past
dictat	Past
menții	Present
exagerăm	Present
sinistră	None
algerienilor	None
nenorocește	Present
pregătii	Past
ghidelor	None
picat	Past
discrete	None
cernu	Past
întrezări	Past
apusese	Past
vorbiși	Past
ajuta	Past
plătești	Present
oprisem	Past
mâhneau	Past
lebădă	None
zărești	Present
împac	Present
introducem	Present
ultima	None
donași	Past
cărăbușule	None
alungau	Past
abandonase	Past
înmulțiți	Present
vătămat	Past
obscurantismule	None
sacrificiului	None
cumpănind	Present
excelaseră	Past
dezgustarăm	Past
sporind	Present
verosimililor	None
parcul	None
ofensator	None
confruntat	Past
cerurăți	Past
îndepărtase	Past
artistică	None
ușurând	Present
muzicali	None
digitalii	None
păcălim	Present
dovedim	Present
bibanului	None
legăm	Present
strămoșilor	None
înrudea	Past
înclinat	Past
centrali	None
oblig	Present
săcreții	None
rezistară	Past
desmățase	Past
lansași	Past
discutat	Past
paharul	None
cinsteau	Past
țineți	Present
cercetezi	Present
vărez	Present
păstrat	Past
lungeați	Past
atacând	Present
romancierului	None
decizând	Present
lungiră	Past
propuseseră	Past
murit	Past
smulse	Past
cântărește	Present
numise	Past
onirice	None
seducției	None
țeseau	Past
urmărești	Present
rostogoli	Past
nenorociți	Present
preget	Present
mișunau	Past
violoncelule	None
încercuiserăți	Past
încălziserăți	Past
școlărița	None
distingând	Present
mișcat	Past
vaca	None
întorceai	Past
fonetica	None
scuipa	Past
înclinând	Present
alergie	None
arunci	Present
chemăm	Present
citise	Past
amiezii	None
coteau	Past
cuprinse	Past
vinde	Present
strigat	Past
potriviți	Present
strigoilor	None
ținuseră	Past
ridica	Past
refractometria	None
urmărește	Present
invizibilitate	None
înșirau	Past
citește	Present
flămândă	None
vorbim	Present
visez	Present
libertate	None
diacriticului	None
aflaseră	Past
bivalente	None
intrase	Past
stingherind	Present
ucisese	Past
strângem	Present
creștem	Present
îmbunătățea	Past
răzbuni	Present
pietrosului	None
potriviră	Past
hotărăști	Present
rescriem	Present
credințele	None
pragurilor	None
meritând	Present
extinzi	Present
destrăbălă	Past
strămutat	Past
înfige	Present
ruginești	Present
putuse	Past
vorbește	Present
gândește	Present
învelit	Past
socului	None
poalele	None
admirară	Past
descrisese	Past
caprele	None
controlez	Present
lingurile	None
poalelor	None
aprinde	Present
înverșunat	Past
semnezi	Present
împăcăm	Present
îngrijorând	Present
motivul	None
lai	None
picase	Past
arnicilor	None
dăunând	Present
comparând	Present
harfă	None
rămăsese	Past
inginerie	None
împilând	Present
răzgândind	Present
descopereau	Past
fierbea	Past
închizi	Present
saxofonule	None
îmblânzit	Past
desfăcut	Past
azurului	None
răpusese	Past
lepăda	Past
scuipat	Past
atentă	None
cânt	Present
convenim	Present
murmuraseși	Past
apocalipsele	None
negi	Present
arăduseseră	Past
zgomotoase	None
alerga	Past
cicliști	None
pețind	Present
îmbiase	Past
zgărzii	None
înșelași	Past
transatlanticele	None
însetezau	Past
semnași	Past
ari	Present
pofticios	None
enigmaticii	None
internelor	None
ținusem	Past
opriseră	Past
minunând	Present
mugetul	None
contravino	None
guvernare	None
invitaseși	Past
majorat	None
arhicunoscută	None
folosiți	Present
făcu	Past
sărutând	Present
domin	Present
declarat	Past
jignește	Present
unge	Present
inteligibila	None
gândise	Past
arde	Present
semnară	Past
prindeau	Past
separase	Past
cinetica	None
bufnița	None
rășinilor	None
copiau	Past
deștepte	None
îngerului	None
atârnat	Past
asiguraseră	Past
tăceai	Past
îngrijeau	Past
îmbina	Past
perioada	None
insista	Past
fundaseși	Past
torseseși	Past
gențile	None
gust	Present
guvernărilor	None
pisat	Past
vorbeați	Past
reținut	Past
lipit	Past
izbăvi	Past
beli	Past
începură	Past
dezrobeau	Past
însera	Past
deschideai	Past
introduceți	Present
imunologie	None
clătești	Present
cumplită	None
obișnuiește	Present
transformi	Present
convenind	Present
ferecând	Present
nocturni	None
echilibrară	Past
externa	None
parcului	None
ezitat	Past
înscrisese	Past
traduse	Past
nemilos	None
trageai	Past
încăpeau	Past
alchimica	None
obișnuise	Past
prad	Present
plăcuse	Past
plăceau	Past
diminuă	Past
simbolului	None
arse	Past
masturba	Past
stimulau	Past
cimpanzeii	None
amărăciunii	None
fura	Past
căută	Past
satisfăceau	Past
recunoaștea	Past
cert	Present
îmbogățit	Past
testicular	None
însuflețire	None
vegheaseră	Past
pingelit	Past
scobit	Past
evlavioaselor	None
mănușa	None
mase	Past
pedepsea	Past
absorbeau	Past
supăra	Past
mărturisim	Present
cufundi	Present
îmbunătăți	Past
crestat	Past
cheile	None
despărți	Past
acumulase	Past
sigura	None
conduseseră	Past
celuloza	None
dovedești	Present
stelei	None
veșnicul	None
aroganței	None
analogiilor	None
spălași	Past
găsi	Past
treceau	Past
curse	Past
moștenești	Present
cercetarea	None
găoazele	None
pederastie	None
gândeai	Past
ia	Present
traduceți	Present
cutreieraseră	Past
dezbrăcat	Past
turbaseși	Past
nodurile	None
ciudatul	None
abajururile	None
oglindit	Past
jocului	None
făcători	None
stima	Past
măgăriei	None
răzleți	Past
geamănul	None
anglican	None
bălăiați	Past
îngreuna	Past
sorbit	Past
scoseră	Past
gimnastul	None
modifica	Past
avânt	Present
deschideți	Present
începuse	Past
cugetasem	Past
expozițiilor	None
ascuțeați	Past
limpezit	Past
vizualiza	Past
înfățișau	Past
iubiseră	Past
pansexualitatea	None
animi	Present
alegea	Past
orașelor	None
celebrând	Present
răcoriți	Present
înjurasem	Past
aduse	Past
eșecurilor	None
onoarea	None
ajutase	Past
înflorind	Present
afânasem	Past
povârneați	Past
pregăti	Past
trăgănaseși	Past
apele	None
prescrie	Present
desculțaseră	Past
răpiți	Present
obișnuiau	Past
varule	None
mâncat	Past
reuși	Past
iernând	Present
înnoit	Past
simțit	Past
evlaviosul	None
necăjeai	Past
sângerat	Past
însorit	Past
calci	Present
întinaserăm	Past
prășit	Past
îngrijind	Present
lucrătorii	None
decide	Present
botezasem	Past
jucăria	None
cuvine	Present
cugeta	Past
șoptit	Past
sudul	None
înfometat	Past
curca	None
leoarbă	None
înfigea	Past
dezlipi	Past
celuloză	None
încheiaseră	Past
subscrie	Present
sângera	Past
recunoscând	Present
dezdoind	Present
lipsit	Past
mărinimos	None
lichidelor	None
plângem	Present
săpasem	Past
implicau	Past
pasă	Past
surprinsese	Past
întrista	Past
sărat	Past
blestemasem	Past
friptă	None
omulețul	None
depărtezi	Present
corupe	Present
îndepărtez	Present
mințirăm	Past
repauzăm	Present
mirosit	Past
înțep	Present
aritmetică	None
stângi	None
obișnuiseră	Past
lipeau	Past
căsătoriseră	Past
castaniu	None
neglijau	Past
împreună	Past
mistific	Present
rodia	None
înșira	Past
carnivorului	None
avortași	Past
lucraseși	Past
adorarăm	Past
vorbit	Past
asculți	Present
fumurii	None
înveleau	Past
luptat	Past
cartofule	None
împroprietăriți	Present
separat	Past
empiricului	None
râdeau	Past
școlarilor	None
bășicaseși	Past
beți	Present
seara	None
somând	Present
picturilor	None
sașie	None
numărăm	Present
demnităților	None
înmărmurit	Past
moșteni	Past
culege	Present
străpunseseră	Past
răsturnat	Past
traversase	Past
petrece	Present
întâietate	None
nimerea	Past
trântește	Present
oripilaseră	Past
implica	Past
înrâurit	Past
țăcănit	Past
vopsit	Past
greceasca	None
masive	None
existăm	Present
răsfoiește	Present
mândrești	Present
cadourile	None
briciul	None
scap	Present
înotând	Present
polari	None
crucificat	Past
ciupercile	None
modificau	Past
văzuse	Past
ocrotește	Present
britanicele	None
coseau	Past
înlesneau	Past
cercetase	Past
refuzaseră	Past
activă	Past
cameleonul	None
flămânzi	Past
îndulciră	Past
urlu	Present
alăptat	Past
șoarecele	None
zgâia	Past
neutra	None
aleseseră	Past
purtările	None
păcăli	Past
deciseseră	Past
zdrobind	Present
măsura	Past
muflonul	None
plătind	Present
interesat	Past
potrivit	Past
duioase	None
recuperau	Past
tunseseră	Past
înlocuia	Past
bați	Present
transcris	Past
muzica	None
mărturisești	Present
dispăruserăți	Past
împlinește	Present
morsă	None
surprindea	Past
plimbau	Past
echilibrelor	None
otrăvise	Past
temem	Present
însoțește	Present
poți	Present
tăbăciserăm	Past
lipite	None
panterele	None
înlătur	Present
periuțele	None
construia	Past
transcrie	Present
conveneați	Past
umpluse	Past
prostului	None
muls	Past
cântări	Past
plimbi	Present
trăia	Past
leneșul	None
curăța	Past
amăgind	Present
torceau	Past
cinstind	Present
real	None
contopii	Past
întreprinzând	Present
combinasem	Past
lasciva	None
arbuștilor	None
aruncase	Past
necunoscutei	None
frecat	Past
țărmului	None
întrebi	Present
scornise	Past
lipiși	Past
distins	Past
mintale	None
scrisese	Past
diastolică	None
comunica	Past
auzeau	Past
cărbunelui	None
astronomiei	None
spumaserăți	Past
uitau	Past
nauruan	None
susții	Present
descoperiți	Present
închipui	Past
spusese	Past
curățarăm	Past
excavat	Past
întrerupt	Past
venerase	Past
împăca	Past
ațâța	Past
oficialului	None
dorule	None
ascunseseră	Past
încuiaserăți	Past
declinat	Past
mulțumiți	Present
murmurasem	Past
cuprindea	Past
danezii	None
fălește	Present
măiastra	None
spuneați	Past
medicamentul	None
rulezi	Present
admirase	Past
numii	Past
anticorpilor	None
preveștim	Present
transcriseseși	Past
încurajase	Past
aromâneștii	None
închin	Present
sucește	Present
propunând	Present
dovlecilor	None
scăpat	Past
pastorule	None
românescului	None
înflorise	Past
dublase	Past
haoticei	None
plimb	Present
versule	None
mărunțește	Present
arșii	None
străbunilor	None
gravată	None
împușcaseră	Past
rosul	None
rotind	Present
comândași	Past
frecă	Past
raționalizabila	None
ascunzi	Present
dărăpănarăți	Past
propus	Past
mărit	Present
depănași	Past
muncește	Present
vieții	None
săpat	Past
vânătului	None
răsculat	Past
lacul	None
crescuți	None
reflectată	None
înnopta	Past
robi	Past
tânjește	Present
despărțit	Past
nemiloșilor	None
cumpărase	Past
declarase	Past
înghesuit	Past
ziceai	Past
refuzau	Past
redusese	Past
supraviețuind	Present
străpuns	Past
congela	Past
descrii	Present
mente	None
înfățișez	Present
scapăt	Present
opiul	None
scufundaseră	Past
latru	Present
îngălbeneați	Past
păpau	Past
căsoaia	None
înlocuiți	Present
înșirat	Past
mas	Past
bănuind	Present
ospătat	Past
urmaseră	Past
ulmii	None
solarii	None
amețirăm	Past
bucurat	Past
enorm	None
dospiseși	Past
păgânul	None
simulare	None
gândiră	Past
întrerupeai	Past
înserași	Past
înmânasem	Past
slavilor	None
rușii	None
plătiră	Past
ștersese	Past
nerealul	None
circumscris	Past
întristasem	Past
spuse	Past
prefer	Present
creștinismul	None
uscă	Past
dovedise	Past
cromozomilor	None
traducea	Past
rotea	Past
desenau	Past
împușcând	Present
lăuda	Past
detaliile	None
semnaseră	Past
deplasând	Present
toiurilor	None
alungi	Present
datorat	Past
uimit	Past
melanjul	None
muriseră	Past
desprins	Past
apucat	Past
înălță	Past
dezavantajat	Past
descompuse	Past
rotunjise	Past
adora	Past
trăiești	Present
influențaserăți	Past
combina	Past
ieșise	Past
sinistra	None
intempestiv	None
șoarece	None
discutau	Past
transbordarea	None
curge	Present
ascensiunile	None
pripiră	Past
cumplit	Past
isprăvit	Past
cafeaua	None
programelor	None
înfășasem	Past
aglomerat	None
căpăta	Past
prunilor	None
bancnotă	None
facem	Present
prăjești	Present
luptaseră	Past
apărase	Past
definiția	None
cucerise	Past
minunasem	Past
clarificaseră	Past
naiva	None
luau	Past
tomatelor	None
certau	Past
bicicleta	None
despuiem	Present
pieptănaseși	Past
ficatului	None
compuse	Past
tușește	Present
alerg	Present
îngreunând	Present
cântăm	Present
răsucește	Present
rostește	Present
căzut	Past
vizităm	Present
omorâm	Present
asemănând	Present
pădurarilor	None
întărâtat	Past
futând	Present
rănește	Present
lingușește	Present
imprimaserăți	Past
judecata	None
odihnea	Past
ridiche	None
ataci	Present
făceau	Past
scuzi	Present
exagerez	Present
citisem	Past
gâmbase	Past
sfinții	Past
ucidem	Present
miști	Present
uiți	Present
schimbând	Present
autozomule	None
aciua	Past
șerbi	Past
îmbrățișase	Past
purta	Past
înlocuiești	Present
alunec	Present
erau	Past
oficial	None
șansei	None
împaci	Present
masivii	None
ascuțirăm	Past
pricepi	Present
țipa	Past
zdrobea	Past
miroseau	Past
călcase	Past
arătat	Past
dispunem	Present
pântecoși	None
plângând	Present
perturbatorii	None
rămaseră	Past
supravegheat	Past
nocturn	None
descoperise	Past
fundară	Past
șacalii	None
păstrau	Past
văduvul	None
rezistența	None
pătimim	Present
blocaseră	Past
simfoniei	None
făinos	None
mințind	Present
ridicăm	Present
stabilim	Present
spitalului	None
nuielei	None
înăbușind	Present
amabilul	None
este	Present
amestecând	Present
străvechile	None
impusese	Past
esențelor	None
îmbulzirăm	Past
orientarăm	Past
scrimerului	None
rezistași	Past
umbroasă	None
nimerești	Present
năframa	None
glumiserăți	Past
prim	None
roșii	Past
preveștiseși	Past
înșelând	Present
cunoscuseră	Past
cade	Present
gâmbarăți	Past
găsim	Present
străvedeți	Present
călcau	Past
acceleră	Past
renova	Past
frec	Present
retras	Past
rezistaseși	Past
măritase	Past
învecinat	Past
simplifica	Past
legaseră	Past
duhurilor	None
luminoasa	None
semicercul	None
insult	Present
bloca	Past
scăzut	Past
răsfoind	Present
subteranei	None
salvase	Past
inflexibilii	None
circumscrie	Present
comportau	Past
bufniță	None
plângeai	Past
mușcând	Present
integralelor	None
înțelese	Past
zidăriilor	None
pregetase	Past
stoarce	Present
scăzui	Past
reușisem	Past
preistorie	None
azvârliți	Present
platul	None
nearticulată	None
regaliste	None
inutilă	None
explici	Present
ferecaseși	Past
șerbii	Past
preferi	Present
împăduriți	Present
edificiul	None
declarau	Past
adaug	Present
nisipurilor	None
urilor	None
îmbrac	Present
acuzata	None
părut	Past
pornește	Present
scosese	Past
comandasem	Past
căutând	Present
încurc	Present
porcarii	None
răsturna	Past
singurul	None
lasă	Present
alegeți	Present
oacheșă	None
analogice	None
îmbunătățit	Past
clocotește	Present
pofticioasă	None
picând	Present
urma	Past
dureroși	None
astronomului	None
cinsti	Past
bontului	None
reluat	Past
acoperite	None
invadaseră	Past
puternicul	None
terțiilor	None
copt	Past
căsătorise	Past
avansaseră	Past
râdeți	Present
distingeau	Past
cămășile	None
cercetaseși	Past
harfa	None
interveniți	Present
furiei	None
răspândind	Present
ridicată	None
închise	Past
futusem	Past
sărutat	Past
solar	None
creaseră	Past
crezând	Present
implicat	Past
complecșii	None
lucrători	None
găuri	Past
intelectul	None
pieriseră	Past
socotim	Present
influența	Past
înșelasem	Past
învinsese	Past
atrage	Present
faini	None
cinse	Past
pregătea	Past
italiencei	None
albicioasa	None
despărțiți	Present
locuiești	Present
câștigară	Past
ținti	Past
auzisem	Past
înțelesese	Past
băut	Past
învățase	Past
farmecele	None
numărând	Present
comunelor	None
descingeați	Past
prunei	None
surzi	None
alungarăm	Past
eronată	None
excava	Past
zbiciserăm	Past
cumpărând	Present
juca	Past
revoluția	None
pregetasem	Past
botezat	Past
mandrilului	None
flămânziseră	Past
astuparăți	Past
caracatița	None
amărâserăți	Past
tipărind	Present
moșteneau	Past
înfrânarăm	Past
acuz	Present
animațiilor	None
inserție	None
năluca	None
silabă	None
basmalei	None
căsători	Past
înotătoarele	None
dăpărarăți	Past
fata	None
aruncărilor	None
rândurilor	None
tâmpiți	Present
glumit	Past
expedia	Past
urile	None
lansase	Past
юбисерэць	Past
obscurilor	None
muncit	Past
feriți	Present
picta	Past
despărțiseră	Past
mangustelor	None
ficatul	None
stabiliseră	Past
adverbelor	None
ținu	Past
dormea	Past
histologie	None
ubicuei	None
absorbit	Past
distruserăți	Past
atacaseră	Past
întărâtară	Past
sporii	Past
secului	None
scade	Present
ucidea	Past
dezunit	Past
desculțasem	Past
descălțăm	Present
nălucilor	None
deprindeau	Past
universitățile	None
secera	Past
înmulțiși	Past
mături	Present
strânseserăm	Past
apune	Present
zburat	Past
sângerului	None
învinge	Present
aștepți	Present
pictând	Present
răzgândim	Present
jupânului	None
însoriți	Present
nejudecatul	None
învățaseră	Past
umbri	Past
înconjur	Present
întorcând	Present
întâlnise	Past
murat	Past
dezbrăcarăți	Past
spori	Past
recunoscu	Past
excursie	None
prezis	Past
înecat	Past
comport	Present
descriem	Present
adormiților	None
eliberând	Present
lămurind	Present
făcuseră	Past
durul	None
refuzi	Present
descrierile	None
scurți	None
plivit	Past
descrisesem	Past
emoționa	Past
întrezărim	Present
beții	None
implicaseră	Past
salvaseră	Past
enciclopedia	None
paradoxurile	None
zdrobește	Present
rotiți	Present
sfătuind	Present
scuza	Past
delimităm	Present
lămâie	None
îmbulzeau	Past
bătând	Present
nebunești	Present
cântăriserăm	Past
înnoind	Present
lăudăm	Present
curgeau	Past
alpaca	None
văzură	Past
arau	Past
stimezi	Present
împărțiți	Present
rupeau	Past
azvârliserăți	Past
dormiți	Present
înavuți	Past
semna	Past
încărcaseră	Past
menținem	Present
instantele	None
glumiți	Present
pregătiți	Present
sud	None
acului	None
păcălești	Present
ferit	Past
sfinți	Past
încetăm	Present
dispune	Present
obișnuiți	Present
netezit	Past
capitalei	None
secilor	None
relua	Past
spălau	Past
opăritul	None
nude	None
hrănii	Past
îmbogățim	Present
muzicile	None
căsătorit	Past
pierde	Present
înfășuri	Present
porunciși	Past
îndeletniceau	Past
furi	Present
aplec	Present
pripisem	Past
mulțumești	Present
ecologia	None
forfotiserăm	Past
roteau	Past
controlă	Past
lipitorilor	None
tâmpitul	None
onestă	None
cerem	Present
stimulând	Present
soție	None
corupserăți	Past
armăsarule	None
făceați	Past
îngrijea	Past
culci	Present
copiind	Present
rostind	Present
gheară	None
afli	Present
somași	Past
ieftina	None
îmbucase	Past
saliniza	Past
preistoric	None
trecând	Present
grăsunule	None
vânau	Past
acuzau	Past
mișcând	Present
luceau	Past
întreprinseserăm	Past
fișierului	None
invitat	Past
suflu	Present
implici	Present
logași	Past
răsziceți	Present
credeau	Past
vii	Present
băga	Past
reprezentanții	None
porțile	None
susțineți	Present
futangiii	None
cumpătaseși	Past
sănătoasă	None
plimbând	Present
murau	Past
vizitase	Past
murmur	Present
îngropase	Past
aberativ	None
inteligente	None
tavanelor	None
tentasem	Past
sucești	Present
previne	Present
coapsei	Past
scăpaseră	Past
grasele	None
ștersul	None
drapelele	None
muie	Past
țese	Present
amesteci	Present
înotau	Past
testicularei	None
vegheat	Past
cutreierând	Present
despuiași	Past
răzgândi	Past
intenționat	Past
cuprins	Past
ascundeau	Past
tinseserăți	Past
împrumuta	Past
putea	Past
prezici	Present
logodi	Past
concepea	Past
rămăseși	Past
muribundului	None
miroși	Present
vinete	None
fusese	Past
retezat	Past
farfurioara	None
comparau	Past
siberianului	None
cusut	Past
mulțimii	None
conduce	Present
irita	Past
brutale	None
pasat	Past
ciungi	None
robii	Past
rulând	Present
fotoliul	None
grăbim	Present
iscăliserăți	Past
excit	Present
copiez	Present
dezvoltând	Present
imprima	Past
obișnuim	Present
răcorește	Present
macin	Present
petalele	None
seminței	None
abceselor	None
măreței	None
depuneți	Present
zăcut	Past
îngrijora	Past
stă	Present
excitaserăți	Past
închinau	Past
cunoaște	Present
alungat	Past
turna	Past
dialectalului	None
traseși	Past
constând	Present
explicași	Past
menținut	Past
distrau	Past
alcătuiți	Present
trezirii	None
găti	Past
adăst	Present
înfruntase	Past
dezis	Past
amintit	Past
cutremura	Past
împărțiseră	Past
bulgarilor	None
australienilor	None
țărmurile	None
înșeli	Present
urî	Past
ieșea	Past
modificăm	Present
asurzii	Past
spumat	Past
preferau	Past
știind	Present
însoți	Past
globurilor	None
bazat	Past
desfășurau	Past
pătrundeau	Past
tenta	Past
retezași	Past
conversațiilor	None
aluminiferei	None
apropiat	Past
monocromului	None
sparse	Past
hârtiei	None
umanitatea	None
intenționez	Present
malule	None
socoti	Past
poruncii	Past
nimerit	Past
izgonind	Present
recunoscuse	Past
înnegriră	Past
binecuvântez	Present
ocupat	Past
cinstim	Present
părând	Present
corupt	Past
studiase	Past
forjaseși	Past
estima	Past
slăbiseră	Past
formidabilă	None
apocalipticilor	None
închisese	Past
simplificăm	Present
vindec	Present
încrederea	None
impuneați	Past
dormirăți	Past
rândului	None
împăunarăți	Past
dezrădăcina	Past
rade	Present
prezicând	Present
întrețineți	Present
potcoavei	None
glandului	None
nenorocind	Present
principalului	None
căsătoreau	Past
pictat	Past
stimară	Past
minte	Present
ascultaserăți	Past
lătra	Past
depuserăți	Past
dublă	Past
chefalule	None
iertații	None
păcălit	Past
țintii	Past
plânge	Present
spovedește	Present
necinstite	None
recuperat	Past
comunicasem	Past
zgâiși	Past
trăsniți	Present
ierta	Past
răsculaseră	Past
otrăvii	Past
rulau	Past
contrazici	Present
urăște	Present
observa	Past
comunicarăți	Past
vărat	Past
foarfeci	Present
alege	Present
intenționași	Past
proporționalilor	None
înfundat	Past
apărărilor	None
înjunghiat	Past
anihilarăm	Past
organizației	None
aeriseau	Past
forțau	Past
credem	Present
explicăm	Present
faurul	None
cereți	Present
plătea	Past
preoțit	Past
erotici	None
iertat	Past
gravitat	Past
fricii	None
vedem	Present
cerci	Present
vânzătoarele	None
căuta	Past
înlocuise	Past
geografică	None
femininul	None
ruină	Past
făurit	Past
clădirii	None
irlandezului	None
bucuroasa	None
bolnăvicios	None
licărise	Past
pregătise	Past
satura	Past
vorbărețelor	None
atingeți	Present
zgâriat	Past
blestem	Present
scoseseră	Past
cursei	Past
programabil	None
împodobeau	Past
cerșeau	Past
circuli	Present
aurie	None
istoviți	Present
frâna	Past
bej	None
astupau	Past
destrăbălași	Past
pupasem	Past
eliberez	Present
înserat	Past
speria	Past
cerând	Present
gândacilor	None
legat	Past
pedepsește	Present
mamutului	None
sporit	Past
orbind	Present
busolele	None
intuiați	Past
manechinele	None
desculțelor	None
contravenea	Past
nutreau	Past
alunga	Past
sărutului	None
virusurilor	None
slabului	None
plutea	Past
bărbieriți	Present
cercetau	Past
vădea	Past
bărbieriserăm	Past
purtase	Past
porni	Past
sălcetul	None
odihni	Past
cununi	Present
cancerele	None
cerneți	Present
violenței	None
vărgata	None
rezolva	Past
scarpini	Present
întâlnirăm	Past
gătește	Present
făurește	Present
înghițea	Past
mândreau	Past
stânjeneai	Past
perușule	None
fluturând	Present
iubind	Present
stăpâniseră	Past
cinstit	Past
strânse	Past
înfășura	Past
tunse	Past
supraviețuiește	Present
șuierat	Past
învins	Past
neglija	Past
sumețând	Present
obosea	Past
temurăți	Past
obosi	Past
puric	Present
obișnuia	Past
încumetat	Past
putere	None
putreziseră	Past
rănit	Past
amuzau	Past
comanda	Past
lamura	None
prescria	Past
depuneau	Past
înțelegeau	Past
tuburile	None
mangustei	None
vindeca	Past
scufundate	None
activaseră	Past
ajuți	Present
fremătară	Past
irit	Present
obrazule	None
ascunde	Present
alanină	None
alegem	Present
muribunzilor	None
socotiți	Present
homosexualul	None
redus	Past
aroganta	None
alint	Present
vidra	None
inserțiile	None
trăgănase	Past
crucific	Present
atacăm	Present
câștigi	Present
controlând	Present
sculpturii	None
lărgea	Past
apărării	None
convingând	Present
vulturului	None
bateți	Present
grăbise	Past
grația	None
începuseși	Past
bolnavii	None
față	None
integralele	None
rostit	Past
imaginezi	Present
deveni	Past
răpui	Present
cununând	Present
bibanul	None
înfierbântaserăți	Past
cuprinzând	Present
augurarăți	Past
întrețineau	Past
arbaleta	None
leșina	Past
trăind	Present
păstrăm	Present
mestecat	Past
interacțiunile	None
examenelor	None
trezi	Past
tuns	Past
cutreierat	Past
jignit	Past
obrăznicie	None
faci	Present
studiezi	Present
lepădarăți	Past
croitorilor	None
însărcină	Past
trezit	Past
îmbogățește	Present
conjuncțiile	None
anulând	Present
cuveni	Past
abandonând	Present
profesiile	None
descrise	Past
fericita	None
iepurașului	None
arăt	Present
interziseră	Past
îmbătrâniserăm	Past
străbătând	Present
obțineți	Present
amuz	Present
crescusem	Past
onorând	Present
roade	Present
măslină	None
trenul	None
rugau	Past
agățată	None
prietenele	None
radiourile	None
țuică	None
supraviețuia	Past
alotropicelor	None
rescrie	Present
blocăm	Present
prăbușit	Past
înrudește	Present
gândea	Past
mamuții	None
visătorul	None
activiștilor	None
supraviețuim	Present
înclin	Present
lăudase	Past
heringilor	None
ruptura	None
fierarilor	None
îmbinaserăm	Past
primi	None
documentară	Past
betele	None
riscaseră	Past
hotărâseră	Past
deprindeți	Present
celebra	Past
sulfurosul	None
adoptau	Past
tulburat	Past
simbolizară	Past
înrădăcinaserăm	Past
supravegheau	Past
adjectivul	None
prevenind	Present
petrecut	Past
celebră	Past
maghiar	None
prețuit	Past
chestiunile	None
vânat	Past
călcând	Present
frânat	Past
zicând	Present
mică	None
dezgust	Present
dungaților	None
betonului	None
scăzuseră	Past
văduvele	None
trecu	Past
intrând	Present
căpătând	Present
lutoși	None
rănești	Present
îndrăznise	Past
somnambulilor	None
aplicând	Present
deschizând	Present
devenii	Past
dușmănie	None
cetera	Past
țintind	Present
pozitronul	None
fluierat	Past
strecura	Past
descoperit	Past
încheiau	Past
hotărâți	Present
persevera	Past
capacitățile	None
dezlipit	Past
urmăriseră	Past
țipași	Past
plecaseră	Past
argintiilor	None
strigătelor	None
surpaseși	Past
discuta	Past
căpătat	Past
apăru	Past
veșmintelor	None
uzului	None
înălțând	Present
pari	Present
încercasem	Past
analogic	None
clociți	Present
măcină	Past
strecurat	Past
umili	Past
împodobit	Past
înghesuiseși	Past
frecăm	Present
ceru	Past
glonțului	None
accelerațiilor	None
descriau	Past
imaginăm	Present
învelii	Past
covoarelor	None
răpuneau	Past
induceau	Past
nucă	None
pierzi	Present
razi	Present
apăsat	Past
ucide	Present
înspăimântat	Past
gemând	Present
chinezoaică	None
elimini	Present
mouse-urile	None
mușuroiului	None
răsfoit	Past
construiau	Past
tăiat	Past
bănuiau	Past
vădit	Past
ducerilor	None
rotunjite	None
deschis	Past
încânta	Past
aliatului	None
ulița	None
pupa	Past
respirau	Past
puteai	Past
liniștirăți	Past
pilotat	Past
acoperii	Past
prietenoșilor	None
arțarii	None
portretul	None
întunecași	Past
muzical	None
dormirăm	Past
suni	Present
dominarăm	Past
zbătea	Past
împiedicau	Past
salutând	Present
construcției	None
scăpă	Past
făcusem	Past
sistăm	Present
contraziceau	Past
convenea	Past
simplitatea	None
întunecat	Past
mănânci	Present
masturbare	None
cucii	None
invitând	Present
întrerupea	Past
contenit	Past
căsătorie	None
încălăm	Present
invincibilă	None
mură	Past
prefera	Past
băgat	Past
mureau	Past
halucina	Past
robești	Present
ținuți	None
întâlnim	Present
înlăturase	Past
slujise	Past
devii	Present
scurtăm	Present
scăzuse	Past
însușirilor	None
aerisit	Past
desenasem	Past
imaginase	Past
naștem	Present
întâietății	None
putrezind	Present
râdea	Past
îndepărtând	Present
crescută	None
temperaturile	None
înlăturarăm	Past
țip	Present
înlesnește	Present
dormind	Present
adus	Past
dovedit	Past
decidem	Present
măgăria	None
locuiți	Present
sărbători	Past
rufelor	None
zgâriarăm	Past
viețuiși	Past
îndemnând	Present
bucura	Past
dispare	Present
învățăm	Present
capitulaseră	Past
salvau	Past
presupuneați	Past
înseninau	Past
îngustat	Past
imitarea	None
îndurat	Past
desfășat	Past
colectivității	None
ațipise	Past
denaturarea	None
simte	Present
vindecase	Past
zăceați	Past
smulge	Present
venerat	Past
cuțitelor	None
stătea	Past
datorez	Present
intact	None
blocase	Past
întâlnești	Present
ascuțit	Past
verandă	None
prostul	None
întoarce	Present
ironică	None
mâhniți	Present
deprinsese	Past
victoriile	None
strănut	Present
aplaudat	Past
plăteau	Past
înscriseseră	Past
sec	None
rupturile	None
conștiințele	None
ghidez	Present
scuzaseși	Past
rotunda	None
deplasa	Past
juraseră	Past
citadelă	None
mausule	None
așternuse	Past
purificat	Past
cutremur	Present
guvernăm	Present
răcelilor	None
copleși	Past
ușurau	Past
lini	None
dezvolta	Past
albii	None
slovenii	None
omorând	Present
reintroduceți	Present
desfășaserăți	Past
menestrelul	None
modifici	Present
astruc	Present
spinii	None
interesase	Past
amărăști	Present
sper	Present
prinde	Present
răspundem	Present
pantofii	None
decăzuseră	Past
greșim	Present
trimiți	Present
gospodarul	None
radiația	None
sfătuim	Present
recuperând	Present
ploios	None
stimulat	Past
curvele	None
dublez	Present
tremurul	None
rarilor	None
încetau	Past
emoția	None
încorporând	Present
închegară	Past
aduceau	Past
căpătase	Past
concepuseră	Past
detaliule	None
hali	Past
halucinez	Present
credincioasă	None
împlinise	Past
întâmpina	Past
respiri	Present
excitat	Past
împrumutase	Past
flămânziserăți	Past
prefixele	None
suna	Past
adumbrim	Present
fotbalistelor	None
seduse	Past
supraveghearăm	Past
furaseși	Past
umbriți	Present
masculii	None
invadat	Past
atingi	Present
carpelele	None
ciocănitorile	None
slăbi	Past
chițcăise	Past
roșești	Present
răzbuna	Past
întrerupi	Present
bucurase	Past
plimba	Past
atingeați	Past
adusese	Past
smulgând	Present
visăm	Present
simplific	Present
lingvisticei	None
cunoscând	Present
susceptibilele	None
necăjește	Present
vegheau	Past
amara	None
ureche	None
răsărind	Present
mililitrului	None
dezvolți	Present
pierise	Past
distracție	None
actorii	None
puncta	Past
încuraja	Past
rescriind	Present
întâmpin	Present
vulcanului	None
sporește	Present
umblau	Past
înceti	Past
furnica	Past
stejarului	None
broaștei	None
calmarule	None
scuturat	Past
varicelelor	None
încrucișase	Past
răsturnarăți	Past
portocaliile	None
evreii	None
toarse	Past
smintit	Past
îndurerasem	Past
brebilor	None
închipuim	Present
mutat	Past
ginerii	None
întrebă	Past
unchii	None
poarcele	None
înțelegea	Past
conștiință	None
lepezi	Present
omniprezente	None
milimetrice	None
pierduși	Past
descărcând	Present
cerceta	Past
făgăduind	Present
rezistăm	Present
rușinat	Past
suit	Past
plătiți	Present
știți	Present
descrescut	Past
pierdem	Present
gravitarăți	Past
introduce	Present
înmărmuriși	Past
jucaseră	Past
plângeți	Present
angajau	Past
aplaudând	Present
verbul	None
începem	Present
ascuțiși	Past
distinge	Present
reînnoind	Present
rătăceați	Past
lucrau	Past
castraveților	None
căpriorii	None
maimuțele	None
avansat	Past
dalta	None
zgâiserăți	Past
râm	Present
divorțaseră	Past
aroganță	None
rase	Past
huliganului	None
conțineau	Past
asculta	Past
ascuțiți	Present
hotărau	Past
confrunta	Past
menta	None
muncii	Past
balticilor	None
baltice	None
intrași	Past
secundarelor	None
lucrezi	Present
săptămânalele	None
treci	Present
opri	Past
frământând	Present
continentalilor	None
structural	None
emoțională	None
foamei	None
convingeai	Past
îngrămădind	Present
înțepat	Past
dinte	None
îngrijorat	Past
dezvăța	Past
puțiserăți	Past
deșiderau	Past
convingi	Present
toarcem	Present
ridici	Present
spânzurase	Past
înfrânasem	Past
basmaua	None
sfulgeraseși	Past
ciocănitoare	None
câmpului	None
împlinit	Past
mărginind	Present
născuseră	Past
scurta	Past
dorea	Past
lăsa	Past
cuprinsă	None
devenim	Present
returnau	Past
interne	None
mierla	None
simțim	Present
dispăruseră	Past
obosirăți	Past
milimetrilor	None
angajăm	Present
crucificase	Past
armene	None
iubim	Present
alfabetelor	None
câștigase	Past
cuțitele	None
clădiți	Present
intoxicat	Past
riscăm	Present
becule	None
armei	None
dispuneau	Past
trecea	Past
aiuraserăți	Past
fumaserăm	Past
așteptat	Past
jachetelor	None
deranjaserăți	Past
gândiseră	Past
insistă	Past
comunic	Present
tulburând	Present
îndulceați	Past
cotidiana	None
gândi	Past
preoți	Past
pescărușul	None
scrie	Present
inserția	None
minunaseși	Past
șesul	None
micșora	Past
zburau	Past
ara	Past
dezgropa	Past
pute	Present
logodiți	Present
napul	None
cereau	Past
bășicarăți	Past
oripilă	Past
întindeau	Past
întărâtași	Past
aruncași	Past
olandezilor	None
complexa	None
psihozei	None
dominat	Past
comandi	Present
alcătuiseră	Past
cărat	Past
deschidem	Present
încruntaserăți	Past
odihnește	Present
ușilor	None
lărgește	Present
acele	None
castraveții	None
sinucisese	Past
înveninaseși	Past
aerat	Past
certăm	Present
defăima	Past
dumnezeilor	None
protejând	Present
mărunt	None
futeți	Present
întrevăzurăți	Past
supraviețuit	Past
puținele	None
cucule	None
albinoase	None
înnorași	Past
ademenise	Past
încununat	Past
jucă	Past
supăr	Present
porcarule	None
secretelor	None
iernau	Past
oprim	Present
suflat	Past
scobim	Present
prostit	Past
mușețelul	None
dogmatici	None
cuprinsului	None
tornadele	None
omenescului	None
întemeiase	Past
scumpe	None
îndepărtaseră	Past
amâna	Past
înfiind	Present
dobândeau	Past
cântărea	Past
încadrând	Present
îmbuna	Past
pilotând	Present
zbârli	Past
glasurilor	None
înțeleseseră	Past
reînnoia	Past
dărâmând	Present
socotește	Present
rumegat	Past
discursul	None
declarând	Present
omorî	Past
întreținut	Past
piersici	Present
fundat	Past
cântărind	Present
lucrat	Past
dragului	None
păziți	Present
parcule	None
înșirași	Past
mâinii	None
dezvolt	Present
prăpădiți	Present
acordurilor	None
croii	Past
așteptase	Past
cămășilor	None
zbăteau	Past
servea	Past
venerau	Past
scurtei	None
vorbea	Past
păducheaseră	Past
declara	Past
porumbelule	None
tunau	Past
simbolizând	Present
umplem	Present
vădeau	Past
deveniră	Past
protejăm	Present
canelura	None
băutul	None
sluji	Past
întreprins	Past
mințitoare	None
hrănea	Past
rescris	Past
susținu	Past
alegi	Present
soporiferilor	None
stătuserăm	Past
mistificăm	Present
preveștiși	Past
scăpătaseră	Past
harpiștii	None
prânzise	Past
lătrând	Present
podelei	None
cooperezi	Present
transformaseră	Past
silabele	None
cerbilor	None
trezind	Present
păpase	Past
trăsăturile	None
cloceai	Past
voltmetrul	None
extindeau	Past
îmbogățiți	Present
vlăguiserăm	Past
forțase	Past
interzise	Past
stors	Past
tăiem	Present
scârbele	None
fugii	Past
presupui	Present
contravenise	Past
umblăm	Present
riști	Present
măsurând	Present
observaseși	Past
neglijat	Past
lipsim	Present
programabile	None
continuelor	None
documentaseși	Past
folosit	Past
ocrotiți	Present
împleteau	Past
heringul	None
citii	Past
comunicăm	Present
liberaseși	Past
păzea	Past
scoapsesem	Past
fur	Present
răsfirat	Past
trăda	Past
lichizi	None
adulmec	Present
încetând	Present
clinicile	None
alungase	Past
șoimii	None
contraveni	Past
lungilor	None
aerisi	Past
tărăgăna	Past
organizația	None
smintiserăți	Past
rotunji	Past
însoțirăm	Past
miri	Present
mustraseși	Past
vorbeau	Past
murim	Present
javrele	None
chel	None
adăpostului	None
înlocuiau	Past
originalitatea	None
apus	Past
dezarmării	None
zăcuseră	Past
ars	Past
slăvește	Present
reține	Present
traversaseră	Past
purpurii	None
desprindea	Past
convinsese	Past
icra	None
certat	Past
vorbind	Present
vădește	Present
urmez	Present
rugase	Past
jurase	Past
îndepărtaseși	Past
croit	Past
aducătorul	None
însoțiserăți	Past
vindecaserăm	Past
interesa	Past
uscași	Past
binecuvânta	Past
încruntaseși	Past
întărește	Present
baschetul	None
bătut	Past
abilul	None
răbojiseră	Past
flexibil	None
încetaseră	Past
târguit	Past
urmărit	Past
bănuia	Past
folosești	Present
vizita	Past
vână	Past
dezgheț	Present
numărau	Past
producere	None
brutala	None
învăță	Past
concepeai	Past
închegat	Past
trântite	None
masacrelor	None
scânceați	Past
amăgește	Present
împrăștiind	Present
atragi	Present
babuinului	None
rugineai	Past
îndrăznit	Past
pedepsit	Past
arăta	Past
apuse	Past
lubrifiez	Present
uciseseră	Past
violențele	None
femeilor	None
covrigului	None
glumi	Past
umple	Present
coborâse	Past
adorat	Past
veacule	None
plânse	Past
estimau	Past
încercuia	Past
răpind	Present
sărim	Present
ofileau	Past
atmosfera	None
analogiile	None
încurajez	Present
otrăviți	Present
capacităților	None
tunat	Past
rechinul	None
chipul	None
simțiți	Present
suveranii	None
metionină	None
aritmetica	None
avantajule	None
virtuoase	None
extinde	Present
presupunem	Present
încăperea	None
stângul	None
introdus	Past
custau	Past
cotit	Past
împărțiși	Past
încărcând	Present
mistificaseși	Past
caracatițelor	None
viguroasă	None
comand	Present
crapului	None
risipi	Past
peșterilor	None
harta	None
curcubeta	None
învăța	Past
împodobii	Past
fluturat	Past
utilizatorii	None
împiedicăm	Present
lărgi	Past
îndrăznind	Present
supraviețuiră	Past
tun	Present
evlavia	None
familia	None
eliberat	Past
indiscretelor	None
senin	None
veniți	Present
lăbărțați	None
popularității	None
arta	None
comunismul	None
scurtez	Present
răspândiși	Past
pricepeți	Present
stăruit	Past
trimitem	Present
izgonește	Present
plictiseală	None
reușind	Present
întreținurăți	Past
veștejit	Past
cinstiți	Present
învinse	Past
găsind	Present
trăsnea	Past
înalți	Present
fericiserăm	Past
numește	Present
cari	Present
sfârșind	Present
sfecliți	Present
curgeți	Present
liniștiți	Present
păduche	Past
perineala	None
bazezi	Present
compus	Past
binecuvântând	Present
spiritual	None
lăsau	Past
îmbunătățind	Present
râs	Past
pingelirăți	Past
convinseserăm	Past
stabilește	Present
distinsei	Past
auriilor	None
închipuia	Past
ispitit	Past
mintala	None
prăpădisem	Past
ștergi	Present
venerărilor	None
călcare	None
concavitate	None
încărunțiși	Past
ieșiseră	Past
plin	None
zbierase	Past
iubeau	Past
pieptăna	Past
mintal	None
jurăm	Present
răsfăț	Present
bolnăvicioase	None
plimbase	Past
somat	Past
produsese	Past
aruncăm	Present
surprindeau	Past
zestre	None
portocaliei	None
pătrarul	None
răzgândisem	Past
faceți	Present
muncea	Past
atras	Past
strigi	Present
accelera	Past
curgea	Past
zgâiserăm	Past
acuzase	Past
împinse	Past
orchestrale	None
mutarăți	Past
maghiari	None
rămânând	Present
expediasem	Past
vindeau	Past
dărăpănasem	Past
azotos	None
numărătorul	None
alintasem	Past
caci	Present
solare	None
risc	Present
dulgherilor	None
piepteni	Present
slabei	None
județele	None
deprinzând	Present
încălaserăți	Past
greșise	Past
înțepa	Past
stimulule	None
agățat	Past
desfășând	Present
înghețatelor	None
limpezise	Past
spurca	Past
încadrau	Past
mergi	Present
donez	Present
plinul	None
gimnastelor	None
încorona	Past
cercurile	None
răbojeau	Past
odihnești	Present
înghețând	Present
concepuse	Past
sorti	Past
lățimea	None
activistul	None
depus	Past
menținuserăm	Past
încercuind	Present
metionine	None
împușcăm	Present
încăpățânați	None
delăsași	Past
peruchierul	None
însoțind	Present
agresivi	None
fonetice	None
vorbitoare	None
supunem	Present
amestecau	Past
alesese	Past
însenină	Past
clocește	Present
frasinul	None
greși	Past
ștergătorule	None
cuteza	Past
evingea	Past
viu	None
păunul	None
ortopedia	None
supa	None
prânzul	None
tentante	None
depunea	Past
întuneca	Past
turiștilor	None
scurgeau	Past
lucrării	None
imprimași	Past
ajut	Present
răsturnând	Present
preoții	Past
obosiserăm	Past
risipea	Past
câmpul	None
putreda	None
vars	Present
hulite	None
munceau	Past
evenimentului	None
zgâriaserăți	Past
aruncaserăm	Past
reflectat	None
prinsorilor	None
slăvind	Present
păcălirăți	Past
umplând	Present
ruinaserăți	Past
benzinăriile	None
caraghioase	None
așteptară	Past
argilosul	None
înspăimântaseră	Past
aprinșii	None
cosea	Past
urmăriți	Present
nuiaua	None
comunilor	None
poftiserăți	Past
ideile	None
mura	Past
tăia	Past
excavezi	Present
loga	Past
întărind	Present
moștenirăți	Past
scriptele	None
sparserăm	Past
atins	Past
lăsând	Present
deștepți	Present
mânecară	Past
amuzat	Past
colajele	None
vrăjii	Past
inundat	Past
urlaserăm	Past
cotește	Present
odihnit	Past
devierile	None
flutur	Present
robirăți	Past
înșirând	Present
adăpa	Past
bucuri	Present
răgușeala	None
purtând	Present
placentă	None
îmbunătățește	Present
spălând	Present
frigeați	Past
reînnoiți	Present
însoțiți	Present
accidentali	None
înfățișa	Past
țintești	Present
dușule	None
crea	Past
însărcinarăm	Past
încurci	Present
comparat	Past
adăpat	Past
pornești	Present
păroasa	None
deceda	Past
adunau	Past
înfipt	Past
supunerii	None
obținut	Past
oprind	Present
traducerea	None
întrevedeai	Past
scărmănarăți	Past
singurii	None
supranaționale	None
gusta	Past
ierarhia	None
ucigând	Present
peticim	Present
imagina	Past
produceți	Present
râncedele	None
pătrunsesem	Past
reții	Present
păstrase	Past
întrebase	Past
grăbirăm	Past
farmacistului	None
săptămîna	None
ieșit	Past
alungași	Past
pierdeau	Past
îndeletnicea	Past
tainei	None
conducea	Past
mijloci	Past
anali	None
timpul	None
aurești	Present
petrecuse	Past
temut	Past
echilibrul	None
nuielele	None
partidului	None
arbaletă	None
abațiile	None
fumat	Past
coperirăm	Past
venise	Past
dubioaselor	None
văzusem	Past
amăgit	Past
templierul	None
văduvii	Past
înjunghiind	Present
agricultorul	None
rebeliune	None
producea	Past
alăptau	Past
ghimber	None
creezi	Present
ejacularea	None
fuseră	Past
usca	Past
rugăm	Present
tristele	None
curățau	Past
prăjit	Past
unind	Present
fraudat	Past
îndulcit	Past
acumulat	Past
strămoșul	None
induse	Past
curma	Past
vărsând	Present
răcori	Past
satisfăcea	Past
înscrisei	Past
lâncedelor	None
cunoști	Present
rămâi	Present
aspră	None
masturbat	Past
putred	None
jur	Present
ruga	Past
omenoșilor	None
traducând	Present
socotea	Past
fraternități	None
ofta	Past
purici	Present
urâțenie	None
agenților	None
batracianul	None
câștigau	Past
abdicase	Past
iscălit	Past
înmâna	Past
dorind	Present
stingeau	Past
cearceafurilor	None
asemănau	Past
ultimi	None
deveneau	Past
utilizaseși	Past
plânsurilor	None
fuse	Past
depăna	Past
anini	Present
pavat	Past
împresuraserăm	Past
destinate	None
naționalului	None
cumpăra	Past
amuzăm	Present
adoptat	Past
intenționau	Past
binecuvântat	Past
înotătoare	None
intuind	Present
înțeleptului	None
înscriem	Present
depănaseră	Past
brigadierul	None
zdrobise	Past
plecau	Past
intervenea	Past
atârnând	Present
jucau	Past
generalului	None
socotit	Past
