improviserat	Converb
jultomten	Noun
specificerad	Participle
kantoners	Noun
försäljarna	Noun
gränslanden	Noun
e-förvaltning	Noun
huvudsak	Noun
hedrade	Verb
begynnelser	Noun
titulerat	Converb
faraonernas	Noun
specialiserat	Converb
njurar	Noun
exporterar	Verb
homonym	Noun
hårdvara	Noun
inspekterades	Verb
mellanfolklig	Adjective
kampanjens	Noun
mimar	Verb
skruvades	Verb
kraftkabelns	Noun
isländskan	Noun
terrorists	Noun
uzbeker	Noun
hyrde	Adjective
lottakårers	Noun
dräpas	Verb
uppskattningen	Noun
daggkåpan	Noun
bumeranger	Noun
säkerhetstjänster	Noun
recensenter	Noun
blomsterfröets	Noun
dykande	Participle
väldigt	Adjective
teleporterad	Participle
religiöse	Adjective
lufthamns	Noun
sovsäckarna	Noun
kontinentalplattorna	Noun
åklagar	Verb
broderskapsrörelsen	Noun
fotograferades	Verb
funktor	Noun
valutareserverna	Noun
störtats	Converb
sitt	Verb
läskig	Adjective
dämpats	Converb
ytas	Noun
gagatens	Noun
skyltfönstrets	Noun
omformulerades	Verb
persiskans	Noun
uppgående	Participle
tillhöra	Verb
koncentrerar	Verb
undervisades	Verb
hänvisar	Verb
evige	Adjective
långfinger	Noun
pausande	Participle
vuxenutbildningen	Noun
dominikanerna	Noun
indiske	Adjective
bolivianernas	Noun
termosfären	Noun
diarré	Noun
skammen	Noun
utgångspunkt	Noun
präktige	Adjective
bastion	Noun
handelsministrar	Noun
sjukornas	Noun
grundläggarna	Noun
bordsdukar	Noun
acetyl	Noun
minderårigt	Adjective
zappad	Participle
talar	Verb
bukar	Noun
trovärdighet	Noun
kulturbudgetars	Noun
moduler	Noun
folkomröstningar	Noun
käglan	Noun
vant	Converb
njurarnas	Noun
integrationsministerns	Noun
applicerar	Verb
kungsörn	Noun
förmedling	Noun
väggytorna	Noun
extremiteten	Noun
korpusens	Noun
igelkottens	Noun
regeringskanslierna	Noun
värmebehandlande	Participle
misstror	Verb
slaktat	Converb
binariteter	Noun
surdegars	Noun
holländskans	Noun
lussekatters	Noun
allittererats	Converb
skifts	Noun
lexikografen	Noun
uppräkningsordningen	Noun
elektrifierades	Verb
svagt	Adjective
oförutsett	Adjective
taxibilar	Noun
handlett	Converb
kommersens	Noun
periodiskt	Adjective
härleder	Verb
båtar	Verb
pilgrimsfalk	Noun
tystar	Verb
ekvatorns	Noun
utsända	Verb
numrerad	Participle
sordiners	Noun
derivatet	Noun
lårbenet	Noun
breddgraden	Noun
hägrarna	Noun
grävlingen	Noun
borgenären	Noun
inkorporerats	Converb
landsdelen	Noun
barnvisa	Noun
pungdjuren	Noun
reformatorn	Noun
polonium	Noun
efterträddes	Verb
karakteriserat	Converb
gruppteorin	Noun
teologiskt	Adjective
rasar	Verb
killing	Noun
åthutande	Participle
bajskorven	Noun
revisionsrättens	Noun
satelliter	Noun
prövningarnas	Noun
vinges	Noun
korallrevet	Noun
fotnoterna	Noun
planterat	Converb
effektivitet	Noun
adjutant	Noun
prillors	Noun
störnivås	Noun
svettig	Adjective
besöka	Verb
antikommutativ	Adjective
generaliserades	Verb
gärningsmannen	Noun
ekonomiskt	Adjective
stangs	Verb
kannors	Noun
matchers	Noun
programkontoret	Noun
rasmassornas	Noun
hymns	Noun
kulturinstitutionernas	Noun
slopats	Converb
rutschkanors	Noun
pendeltåget	Noun
landshövdingarna	Noun
twittrats	Converb
återställ	Verb
gympa	Noun
smederna	Noun
upplåtas	Verb
armbågsbenen	Noun
pubarna	Noun
nåddes	Verb
oliverna	Noun
verkstads	Noun
sinnebild	Noun
folkbokföring	Noun
förgäter	Verb
förhindrar	Verb
klassad	Participle
meddelade	Verb
suddigt	Adjective
linjär	Adjective
ruttnande	Participle
hemisfär	Noun
reproducerades	Verb
fyllt	Adjective
skadegörelse	Noun
klargöranden	Noun
statskupp	Noun
tutten	Noun
homogen	Adjective
blogg	Noun
uppfinnarna	Noun
blundar	Verb
skrotat	Converb
kulturverksamheten	Noun
övervinnas	Verb
besserwissrar	Noun
femtedelen	Noun
pansarstyrkor	Noun
klippdassar	Noun
företagsledarnas	Noun
beboelig	Adjective
värderar	Verb
stympad	Participle
pendelns	Noun
bojkottar	Verb
såpa	Noun
fågelskrämmas	Noun
sonater	Noun
uteslöts	Verb
yrkandena	Noun
blinkande	Participle
skoningslöst	Adjective
glasögon	Noun
ordspråket	Noun
bastionerna	Noun
ceratet	Noun
käkad	Participle
chipspåsars	Noun
bokmärken	Noun
krokodilerna	Noun
nyanserat	Converb
spårat	Converb
jonernas	Noun
otroligt	Adjective
punsch	Noun
djungelns	Noun
städets	Noun
årtiondets	Noun
ovanors	Noun
cyanamid	Noun
romandebuterat	Converb
brandväggar	Noun
tät	Adjective
besynnerlig	Adjective
fyrtaktsmotors	Noun
föraktar	Verb
berott	Converb
regnskog	Noun
beståndets	Noun
tittarsiffrorna	Noun
kontinuerligt	Adjective
pappersknivs	Noun
celt	Noun
trivas	Verb
märklig	Adjective
halvöarna	Noun
pandemier	Noun
konjunktioner	Noun
antropologisk	Adjective
japanskt	Adjective
kam	Noun
dynors	Noun
chipspåsarna	Noun
försämringar	Noun
upplöser	Verb
illustrerats	Converb
tillkännagivanden	Noun
spänt	Adjective
assets	Noun
knäskålen	Noun
stumfilms	Noun
pryglats	Converb
processerna	Noun
sekunderad	Participle
etan	Noun
stängd	Adjective
öringarna	Noun
översvämmat	Converb
utbildningslinjen	Noun
zebran	Noun
stången	Noun
opererade	Verb
adopterades	Verb
blekte	Adjective
nittondedelarna	Noun
singularformer	Noun
xylofonernas	Noun
utrikesdepartementet	Noun
pysarnas	Noun
perifere	Adjective
beundrar	Verb
parametrarna	Noun
riddarna	Noun
tjugoåttondedelarna	Noun
utrullningens	Noun
automat	Noun
betraktades	Verb
taggarnas	Noun
ladugårdens	Noun
insegel	Noun
städet	Noun
legaliserad	Participle
mick	Noun
skam	Noun
iriska	Noun
stridsfrågor	Noun
konserv	Noun
behörigheter	Noun
vackert	Adjective
tacksam	Adjective
grundlagarna	Noun
utnämnt	Converb
lindrat	Converb
utnyttjade	Verb
presterande	Participle
kortsluter	Verb
mobiliserings	Noun
traditionell	Adjective
fiktiv	Adjective
bolivianskt	Adjective
introducerar	Verb
Laplacetransformen	Noun
maskuliner	Noun
riksantikvarieämbetet	Noun
prepositionernas	Noun
kondenserade	Verb
kommunikations	Noun
angripas	Verb
perenner	Noun
hedersbetygelser	Noun
befaller	Verb
skamlöse	Adjective
hängs	Verb
sociale	Adjective
urinoarerna	Noun
dryge	Adjective
utvandrad	Participle
återuppbyggd	Participle
gladde	Verb
doldisens	Noun
skandinaviske	Adjective
vadställen	Noun
låssmed	Noun
värnpliktskonferensers	Noun
ribban	Noun
ångerfullt	Adjective
tilliten	Noun
mikrofonens	Noun
inhemsk	Adjective
durkslagets	Noun
dödades	Verb
försvarsmakterna	Noun
rodnader	Noun
specialiserad	Participle
nöjde	Verb
skvallret	Noun
lättat	Converb
nederbörden	Noun
präglat	Converb
avisningens	Noun
folkskolorna	Noun
kvävets	Noun
region	Noun
bevarandet	Noun
argumenterar	Verb
påvens	Noun
intressesfärer	Noun
grupperingarna	Noun
antaganden	Noun
utnyttjades	Verb
samexisterade	Verb
trikå	Noun
kånkat	Converb
datateknik	Noun
upprättade	Verb
trollsländan	Noun
respekterade	Verb
vaxkakan	Noun
semla	Noun
påslakanens	Noun
dragen	Adjective
definierande	Participle
bort	Converb
prestanda	Noun
vänsterpolitikens	Noun
fonon	Noun
motvilja	Noun
bemannar	Verb
hämtats	Converb
handläggaren	Noun
gynnad	Participle
syftlinjer	Noun
tröghet	Noun
etsningarna	Noun
astman	Noun
rötternas	Noun
lillfinger	Noun
helheter	Noun
deriverar	Verb
duckat	Converb
fjäderdräktens	Noun
exportkrediten	Noun
betvivlades	Verb
stadskärnor	Noun
nattugglan	Noun
avgångarna	Noun
etta	Noun
fyrtiondelen	Noun
juridik	Noun
imponerats	Converb
violasternas	Noun
dygden	Noun
talad	Participle
förverkligats	Converb
sonsonens	Noun
ättlingen	Noun
hårdskivans	Noun
reformerades	Verb
brasilianske	Adjective
direktionen	Noun
påbuden	Noun
stördes	Verb
fastlagsbulle	Noun
tillägnade	Verb
memen	Noun
cyklande	Participle
synagogor	Noun
ryggraderna	Noun
biståndsminister	Noun
kuskar	Noun
stolpe	Noun
sotarna	Noun
fungerar	Verb
slemhinnans	Noun
provat	Converb
hyrt	Adjective
medes	Noun
trösklarnas	Noun
dadel	Noun
undrande	Participle
befogenhet	Noun
paraplyet	Noun
backar	Verb
sjuknade	Verb
flyttars	Noun
konstitution	Noun
provade	Verb
barnlös	Adjective
använts	Converb
prisbasbeloppet	Noun
utbrustit	Converb
utarmningsområdets	Noun
förvaltats	Converb
estniskt	Adjective
stocken	Noun
fyren	Noun
fotograferande	Participle
annekterats	Converb
oskadliggjorde	Verb
utbildningsministrar	Noun
etylacetat	Noun
nödbromsarnas	Noun
promenerade	Verb
lunnefågel	Noun
församlingskyrkorna	Noun
sarkasm	Noun
insamlats	Converb
färdigheterna	Noun
antagne	Adjective
grävlingars	Noun
laggar	Verb
justerande	Participle
profilerande	Participle
femtioöringar	Noun
holländske	Adjective
aldehyder	Noun
harpist	Noun
friktionen	Noun
uppslagsverkets	Noun
dryg	Adjective
lindrar	Verb
grekers	Noun
bubblans	Noun
följer	Verb
ödlorna	Noun
obehindrat	Adjective
barbarisk	Adjective
fokuserades	Verb
imponerat	Converb
krukorna	Noun
högtyskans	Noun
vidlyftig	Adjective
standardbrevet	Noun
omvandlande	Participle
politikområdet	Noun
vd:s	Noun
tunglens	Noun
civil	Adjective
eldslukaren	Noun
visionernas	Noun
anlöptes	Verb
turturduvan	Noun
kompromissers	Noun
utfarters	Noun
sotarens	Noun
framställer	Verb
hållfaste	Adjective
profilerad	Participle
pocketreas	Noun
publicerar	Verb
cystoskopis	Noun
örfilars	Noun
materia	Noun
flamingornas	Noun
fanan	Noun
byråkratiskas	Noun
bohemer	Noun
disponerat	Converb
regerande	Participle
stadsplaneraren	Noun
försiktige	Adjective
luftmassa	Noun
ingresserna	Noun
domkyrkas	Noun
referenserna	Noun
bestämmelsernas	Noun
gallimatiasens	Noun
konfiskerande	Participle
redigerade	Verb
alf	Noun
antologin	Noun
ödegård	Noun
plantorna	Noun
falsifierande	Participle
militärstyrkorna	Noun
terroristerna	Noun
framsätet	Noun
centralbank	Noun
bildstod	Noun
tonåring	Noun
mikrovågsugnar	Noun
cissens	Noun
vankad	Participle
underlättar	Verb
ruiner	Noun
anställa	Verb
julsångerna	Noun
renade	Verb
världsettan	Noun
tvillingen	Noun
autentisk	Adjective
utbildningsplanernas	Noun
postades	Verb
bedriver	Verb
utbyts	Verb
stått	Converb
isotop	Noun
politikern	Noun
lokaliserad	Participle
uppenbarande	Participle
currys	Noun
lokomotivets	Noun
föranleds	Verb
svaveltrioxid	Noun
nässlorna	Noun
webbplatsens	Noun
mobiltelefonerna	Noun
utvärderats	Converb
ritad	Participle
parametrar	Noun
gymnasieskolas	Noun
kaffemärken	Noun
låter	Verb
sömsmånerna	Noun
adoptionen	Noun
triste	Adjective
krans	Noun
remsa	Noun
bortskämde	Adjective
obehagligt	Adjective
dopnings	Noun
invaderade	Verb
hyperbelns	Noun
växande	Noun
kokbok	Noun
grusbanan	Noun
dödsdagarnas	Noun
trög	Adjective
bandar	Verb
absiden	Noun
ekumenik	Noun
atoll	Noun
obstetriken	Noun
omedelbart	Adjective
uppföljningen	Noun
avskrivits	Converb
äggvitan	Noun
motiveringarna	Noun
axet	Noun
cancan	Noun
efterträtts	Converb
svågers	Noun
fälgs	Noun
schimpansernas	Noun
käftar	Noun
sjövärdigt	Adjective
utvandrade	Verb
halvbroders	Noun
EU-frågas	Noun
bubblorna	Noun
testiklarnas	Noun
berömmer	Verb
rulltrappan	Noun
tukan	Noun
cashewnöts	Noun
folkan	Noun
trefotens	Noun
utgåvas	Noun
vacker	Adjective
prostens	Noun
intresserade	Verb
kymriska	Noun
utfarten	Noun
sektor	Noun
bögars	Noun
undergruppen	Noun
aktivism	Noun
lagrar	Verb
tigits	Converb
epifyt	Noun
kanslier	Noun
förlängas	Verb
modets	Noun
aposteln	Noun
skvallerspegels	Noun
krigsorganisationen	Noun
bitsockrets	Noun
främjar	Verb
roterande	Participle
protonerna	Noun
anordnat	Converb
kidnappades	Verb
dadaism	Noun
minikjolen	Noun
cesur	Noun
allmänbildningens	Noun
revisioner	Noun
simbassängerna	Noun
taggbuskes	Noun
nyponens	Noun
trycka	Verb
innebar	Verb
redbart	Adjective
dubbelgångarens	Noun
fisen	Participle
klorerande	Participle
abstraktion	Noun
manifestationen	Noun
packade	Verb
segelbåtar	Noun
ankarbarnen	Noun
världsstjärnans	Noun
gärdets	Noun
anrättningen	Noun
snöstormen	Noun
nordlig	Adjective
nederdelen	Noun
mikrovågsugnens	Noun
rädisa	Noun
costarikanske	Adjective
intervjuande	Participle
godkännande	Participle
avgaser	Noun
matat	Converb
ormvråk	Noun
bedrivet	Adjective
bötat	Converb
kärnkrafter	Noun
motsäga	Verb
sluttar	Verb
kolvätena	Noun
byråchefens	Noun
klargjorts	Converb
amnestins	Noun
rymdeposets	Noun
delsträckan	Noun
doktorsgrad	Noun
paketerat	Converb
smaklig	Adjective
rättvist	Adjective
underavdelningars	Noun
ejdern	Noun
säkerhetsarbete	Noun
bröstvårtor	Noun
förvånande	Participle
lussekatter	Noun
taleskvinnors	Noun
fladdrande	Participle
homoäktenskapens	Noun
engiftena	Noun
sorterats	Converb
loppmarknaden	Noun
utökades	Verb
sparkat	Converb
landsarkiven	Noun
antipartiklar	Noun
jagaren	Noun
prolinet	Noun
ärtorna	Noun
dölja	Verb
utarbetade	Verb
koksaltet	Noun
bilfärja	Noun
snuvor	Noun
hakarnas	Noun
profilerar	Verb
förvaltades	Verb
trygghet	Noun
underhållits	Converb
fullgöras	Verb
valresultatens	Noun
tillät	Verb
turistar	Verb
avfall	Verb
regioners	Noun
vadar	Verb
blockerades	Verb
vattnig	Adjective
bråkstakar	Noun
kategoriserande	Participle
ansatserna	Noun
följt	Converb
förlorar	Verb
embarkering	Noun
resen	Noun
flertalet	Noun
växlar	Verb
piercingens	Noun
korsfästa	Verb
pingvinerna	Noun
önskelistorna	Noun
kreditkortens	Noun
översikter	Noun
räkenskaper	Noun
dricksvatten	Noun
lokföraren	Noun
studentförening	Noun
högtider	Noun
arbetskamraten	Noun
elektrisk	Adjective
apokalyptiskt	Adjective
oredan	Noun
eskorterande	Participle
plundrat	Converb
bekräftelses	Noun
globaliseringens	Noun
projektor	Noun
u-landets	Noun
stortås	Noun
vätebindnings	Noun
skräddarna	Noun
ryktbarheten	Noun
dogmatikens	Noun
bakgrunden	Noun
publiceringen	Noun
biografiernas	Noun
kuststräckor	Noun
höljens	Noun
balanserar	Verb
kursiverar	Verb
realtids	Noun
sponsrats	Converb
utbudet	Noun
brytaren	Noun
befordrats	Converb
snok	Noun
semin	Noun
anordningarna	Noun
distribuerades	Verb
utskriftens	Noun
bakterier	Noun
tröskverk	Noun
klotter	Noun
dividend	Noun
nedsätts	Verb
geologen	Noun
upptaget	Adjective
anlägger	Verb
grodor	Noun
juldagen	Noun
manifestationerna	Noun
karoliner	Noun
alléerna	Noun
antikommutativitetens	Noun
hungrigt	Adjective
stiftande	Participle
umgänget	Noun
kommittébetänkandens	Noun
konsulterats	Converb
utvandrarna	Noun
strömförstärkningens	Noun
beklagade	Verb
kär	Adjective
ministerier	Noun
telefonnumren	Noun
blåmesarnas	Noun
eldflugans	Noun
inträffat	Converb
straffsparkar	Noun
landgångar	Noun
örhängena	Noun
kartlades	Verb
kände	Adjective
löjligt	Adjective
religiöst	Adjective
elementarpartikel	Noun
havren	Noun
upphävd	Participle
lyran	Noun
syzygien	Noun
förtjänande	Participle
bulten	Noun
hotats	Converb
myntats	Converb
tärningen	Noun
storks	Noun
crescendons	Noun
räkneorden	Noun
multiplikationer	Noun
inhemske	Adjective
kommissionären	Noun
stadskärnan	Noun
analfabets	Noun
virke	Noun
dosornas	Noun
ymnigheten	Noun
predikningarna	Noun
bröstets	Noun
grönaktigt	Adjective
diskriminerande	Participle
skurkar	Noun
kvävd	Participle
rekommenderats	Converb
bagateller	Noun
konstituerar	Verb
anklagar	Verb
trender	Noun
subsidiärt	Adjective
överföring	Noun
jordbrukskommittéers	Noun
planerat	Converb
kampanjerna	Noun
allvaret	Noun
cabriolet	Noun
forint	Noun
dödsdomar	Noun
petad	Participle
lösdriverskors	Noun
assietter	Noun
vattenhundar	Noun
makron	Noun
kommandot	Noun
abiturient	Noun
hjortar	Noun
mikrofonerna	Noun
huld	Adjective
oljefatsbomben	Noun
repeterar	Verb
basunerande	Participle
rockader	Noun
kvalificerar	Verb
oskadliggöras	Verb
strukturerade	Verb
hånet	Noun
ratats	Converb
kostar	Verb
periferierna	Noun
vidlyftigt	Adjective
böjningen	Noun
elefanter	Noun
ortodoxe	Adjective
toan	Noun
delstaten	Noun
placerade	Verb
loppisen	Noun
affixens	Noun
hämmade	Verb
världsväldets	Noun
ikosaeders	Noun
försvarsattachéns	Noun
lugnar	Verb
kräfta	Noun
vobbat	Converb
lättmetall	Noun
uppsättningens	Noun
imperierna	Noun
kalkylatorers	Noun
skådeplatser	Noun
växthuseffekt	Noun
syftlinjers	Noun
bekostades	Verb
martyrers	Noun
examensbeviset	Noun
koldioxiden	Noun
böljas	Noun
varmkorvens	Noun
molekylärformel	Noun
hänger	Verb
saktade	Verb
förortsbana	Noun
kavlar	Noun
vaxkakorna	Noun
grundlade	Verb
prislapp	Noun
tjänstekvinnans	Noun
maritime	Adjective
ekumeniken	Noun
styvdotters	Noun
gulaktig	Adjective
extentor	Noun
vattendelarens	Noun
domedag	Noun
förlades	Verb
sponsrad	Participle
träkyrkor	Noun
katolsk	Adjective
hemesterns	Noun
belyste	Verb
krönet	Noun
ingenjörsvetenskapen	Noun
styrbord	Noun
härdsmältas	Noun
barnmisshandel	Noun
krukas	Noun
danar	Verb
hysts	Converb
ansatsen	Noun
manuskripten	Noun
ornitologiskt	Adjective
norna	Noun
torr	Adjective
fortlöpande	Participle
camembertens	Noun
manuskriptets	Noun
utvandrarnas	Noun
drabbar	Verb
bloggande	Participle
missilen	Noun
hårnålskurvans	Noun
förlitande	Participle
förhandlade	Verb
föreningsfrihet	Noun
diskontinuiteten	Noun
ståndet	Noun
sjuksystern	Noun
poängterande	Participle
studieplanens	Noun
bekväme	Adjective
ministeriet	Noun
pensionerad	Participle
medgivandets	Noun
badbyxor	Noun
brösten	Noun
husrannsakningsorders	Noun
primitiv	Adjective
algoritmisk	Adjective
styvdöttrar	Noun
kollats	Converb
nyhetsankaret	Noun
försvarsmakts	Noun
momsen	Noun
förhandsgranskningen	Noun
rusade	Verb
skunkar	Noun
ledamot	Noun
riskerar	Verb
löpnumret	Noun
lågt	Adjective
skeppsredaren	Noun
hämndens	Noun
bohemen	Noun
koncentrations	Noun
slugt	Adjective
vapenvilor	Noun
misshandlat	Converb
skabrositeter	Noun
tillkännagivandet	Noun
kvantifierade	Verb
buskarnas	Noun
armenier	Noun
avbildningen	Noun
messade	Verb
döljas	Verb
gisslades	Verb
inverkat	Converb
konstapel	Noun
erhållet	Adjective
berörs	Verb
magnetit	Noun
talgoxens	Noun
kaliumhydroxid	Noun
övervinna	Verb
bensinstationer	Noun
granskat	Converb
massmördarens	Noun
isolerade	Verb
rökridån	Noun
utmanats	Converb
spädbarnets	Noun
tecknats	Converb
fixstjärnor	Noun
hägringar	Noun
hymnernas	Noun
guldfiskar	Noun
smeder	Noun
stygg	Adjective
spriten	Noun
vittnande	Participle
tjejbaciller	Noun
överensstämmelse	Noun
brusets	Noun
riksrevisors	Noun
hemslöjden	Noun
toxikologis	Noun
ballongbågars	Noun
costaricanska	Noun
landsarkivarierna	Noun
påminna	Verb
skuldror	Noun
gynnat	Converb
sveper	Verb
gratulerade	Verb
lönnmördaren	Noun
fräsnings	Noun
duschdraperiets	Noun
trollkonor	Noun
pressad	Participle
skandinaviskan	Noun
skeppat	Converb
provinsen	Noun
anakronistisk	Adjective
ansvarsområde	Noun
uteslutit	Converb
bronkit	Noun
löser	Verb
tornugglors	Noun
barbarernas	Noun
inställde	Verb
konceptets	Noun
klotters	Noun
skulpterade	Verb
släpat	Converb
delad	Adjective
specialstyrkor	Noun
uttröttad	Adjective
maktkampernas	Noun
bevarades	Verb
bilfärjan	Noun
konjugationen	Noun
kantrade	Verb
lärarinnor	Noun
skriker	Verb
hytt	Noun
glaciärer	Noun
medförde	Verb
litterärt	Adjective
gynekologin	Noun
brått	Adjective
ädelstenen	Noun
chefredaktörerna	Noun
varumärket	Noun
yrkar	Verb
extremitet	Noun
kommittésekreterarens	Noun
höjning	Noun
tolvor	Noun
flyglarna	Noun
träskon	Noun
incitamenten	Noun
hamnat	Converb
homosexualitetens	Noun
maskerad	Participle
kånkades	Verb
plundrar	Verb
djärv	Adjective
störa	Verb
bröade	Verb
studerar	Verb
naturhistoria	Noun
plåten	Noun
undergrupperna	Noun
äktenskapsbryterskan	Noun
sommarstugor	Noun
normaliserat	Converb
armvecket	Noun
brandstationen	Noun
kvicksands	Noun
treornas	Noun
hårklyverier	Noun
terrorhandlingen	Noun
tjänar	Verb
elegin	Noun
furan	Noun
fattning	Noun
accent	Noun
beröm	Verb
handväska	Noun
havererad	Participle
klättrarna	Noun
violinist	Noun
förlorande	Participle
kattugglor	Noun
falnade	Verb
händelsehorisonternas	Noun
fiktive	Adjective
pyramiden	Noun
bakterien	Noun
åskådliggörs	Verb
anarkismen	Noun
bråkstake	Noun
kummin	Noun
redgarnen	Noun
olyckligt	Adjective
idrottsarenan	Noun
ölburkarna	Noun
enhörningar	Noun
sej	Noun
kasses	Noun
differenser	Noun
tredjegradsekvationers	Noun
lundensiske	Adjective
drifts	Noun
ryggmärgen	Noun
vattenmeloner	Noun
landstingsrådets	Noun
inbäddat	Adjective
strykning	Noun
bykars	Noun
väggplankorna	Noun
garanterade	Verb
serverar	Verb
kolonister	Noun
vicekonsuln	Noun
proteins	Noun
bokstavens	Noun
snuvas	Noun
aprikosen	Noun
luftstrupens	Noun
könsnormer	Noun
löparbanor	Noun
utrikesministerns	Noun
häktade	Verb
begravningsplatser	Noun
bedömas	Verb
vagnreturers	Noun
städar	Verb
latinets	Noun
snare	Adjective
kvällstidningar	Noun
pråmen	Noun
övervägdes	Verb
tillgängliggörandets	Noun
tvistat	Converb
stakes	Noun
rättsakter	Noun
glappkontakters	Noun
informatorer	Noun
mikrokretsarna	Noun
flammans	Noun
daltade	Verb
flyttades	Verb
entreprenaden	Noun
optimerade	Verb
byggts	Converb
befolkningssiffror	Noun
spelats	Converb
venuspassages	Noun
skolbildningen	Noun
sjuttondedel	Noun
ondskan	Noun
besökande	Participle
duckar	Verb
strömmad	Participle
försiktig	Adjective
landskommunens	Noun
kortsidor	Noun
anmäldes	Verb
gnagarnas	Noun
justitiekanslerers	Noun
obskyrt	Adjective
rengörs	Verb
saboterad	Participle
räknarna	Noun
nymånen	Noun
konfigurerat	Converb
frilandets	Noun
abnormt	Adjective
glukonsyra	Noun
helium	Noun
skivbolagen	Noun
narvalar	Noun
jämställdhetsministern	Noun
husvagnens	Noun
skojat	Converb
säckpipornas	Noun
speldosan	Noun
örnnästen	Noun
kronprinsen	Noun
konstituerades	Verb
finansiellt	Adjective
centrifug	Noun
hårddiskarna	Noun
strävpelarna	Noun
självet	Noun
försvarsstyrkas	Noun
byk	Noun
hingstar	Noun
asbesten	Noun
krönande	Participle
smedens	Noun
böjar	Noun
motionen	Noun
anslagstavlan	Noun
tyck	Verb
kategoriserades	Verb
cyklades	Verb
rekryter	Noun
främjad	Participle
civilutskottet	Noun
trefot	Noun
förslaget	Adjective
skrämmas	Verb
sysselsatte	Verb
e-bok	Noun
ländkotan	Noun
bearbetats	Converb
glöder	Verb
könsstympning	Noun
förelegat	Converb
kosmolog	Noun
pittarna	Noun
månadstidningen	Noun
västlige	Adjective
dvärgen	Noun
flunsans	Noun
druva	Noun
underhållit	Converb
euro	Noun
bårbärarens	Noun
underrättar	Verb
kommunicerande	Participle
framåtskridandet	Noun
biträdande	Participle
krokodilen	Noun
terroristbekämpningen	Noun
rostades	Verb
schematisk	Adjective
cybernetiken	Noun
disputerar	Verb
adjutanten	Noun
klassificerande	Participle
gymnasterna	Noun
postulerat	Converb
personregistren	Noun
divisions	Noun
våldtäktsman	Noun
trollsländans	Noun
nonan	Noun
korrespondensen	Noun
chanson	Noun
kassakor	Noun
adopterats	Converb
domsagor	Noun
jordbruksdepartementet	Noun
pilgrimsfalken	Noun
konservernas	Noun
miljonären	Noun
oljeutsläppets	Noun
höstackarna	Noun
hårnålen	Noun
hängde	Verb
rävsaxen	Noun
antisymmetriskt	Adjective
festat	Converb
stigmatiserat	Converb
indoktrinering	Noun
sökningars	Noun
fruktsallad	Noun
drogens	Noun
realiserande	Participle
fyllots	Noun
seglades	Verb
gentil	Adjective
omständighet	Noun
bojkott	Noun
ordnar	Verb
diplomet	Noun
testats	Converb
stämpeln	Noun
framgångssaga	Noun
modedockors	Noun
styvfaderns	Noun
guvernören	Noun
katedral	Noun
Higgsbosonerna	Noun
rättat	Converb
termosar	Noun
marmorn	Noun
ärta	Noun
ensembler	Noun
rulltrappor	Noun
markägarna	Noun
brygders	Noun
bangen	Noun
associativitets	Noun
avkommors	Noun
trasdockornas	Noun
riksmarskalken	Noun
svårbegriplig	Adjective
besökas	Verb
absolutbeloppet	Noun
segrade	Verb
hete	Adjective
tipsen	Noun
bildtexterna	Noun
citrongul	Adjective
busshållplatsers	Noun
legget	Noun
trädgårdsstadens	Noun
myrar	Noun
fördelaktigt	Adjective
ozelot	Noun
hemskt	Adjective
periodarens	Noun
klumps	Noun
lösnings	Noun
brödrosten	Noun
frikyrkorna	Noun
lyras	Noun
apatin	Noun
klasskamrat	Noun
ängars	Noun
realskola	Noun
trendens	Noun
medeltid	Noun
mysteriet	Noun
kosmonauten	Noun
frost	Noun
lyra	Noun
belyser	Verb
rullskridskon	Noun
expanderats	Converb
turbanernas	Noun
dräpa	Verb
profilerades	Verb
rationelle	Adjective
överstrykningen	Noun
diskvalificerar	Verb
stympningarnas	Noun
ordklassers	Noun
bjälkarna	Noun
importerande	Participle
kvarken	Noun
järnvägsförvaltning	Noun
kvävde	Verb
grundämnens	Noun
allvarligt	Adjective
cystor	Noun
licentiaten	Noun
karakteriserats	Converb
nycklarna	Noun
hinkarna	Noun
arbetsmarknadsministern	Noun
laptops	Noun
topologier	Noun
kopplar	Verb
arbetstagarna	Noun
luftbubblorna	Noun
utgrävningar	Noun
negligé	Noun
varulv	Noun
orienterade	Verb
trast	Noun
moderkorten	Noun
röker	Verb
parts	Noun
planetbanas	Noun
påverkats	Converb
costaricanskan	Noun
diktaturen	Noun
mungipa	Noun
halshöggs	Verb
alfabetiskt	Adjective
riggande	Participle
fiskgjusar	Noun
forskarutbildningarnas	Noun
mjuknat	Converb
friskolornas	Noun
volts	Noun
ödekyrkor	Noun
modersmålets	Noun
baryonens	Noun
amöbornas	Noun
provocerande	Participle
utnämnde	Verb
rymdens	Noun
verksamme	Adjective
delgrupperna	Noun
nollstället	Noun
mungigor	Noun
medelmåtta	Noun
aprilskämt	Noun
femtedelar	Noun
polygoner	Noun
ordningsföljden	Noun
kommerskollegiets	Noun
kväde	Noun
avlägsnande	Participle
tidsanda	Noun
metallurgiskt	Adjective
kronologin	Noun
avkommor	Noun
singlande	Participle
sabotaget	Noun
rättstavningen	Noun
hållaren	Noun
vaggat	Adjective
dårhuset	Noun
stuga	Noun
släpats	Converb
ankare	Noun
duos	Noun
underrättelser	Noun
ekonomistyrning	Noun
avdelningschefer	Noun
ritaren	Noun
laboratorierna	Noun
nationell	Adjective
lyor	Noun
konsumerat	Converb
årtalet	Noun
förråddes	Verb
stridsspetsen	Noun
kulturellt	Adjective
plånboksfrågornas	Noun
fotsulor	Noun
fiskats	Converb
håg	Noun
kinesiskans	Noun
sedeslöshet	Noun
absolute	Adjective
nyårslöftes	Noun
frälste	Verb
hotellrummets	Noun
sedernas	Noun
jonglörer	Noun
tunnelbanestationer	Noun
fåfänga	Noun
rymdes	Verb
landarna	Noun
generelle	Adjective
stjärtfena	Noun
trumpetsteks	Noun
detekterar	Verb
kikar	Verb
tillförlitlig	Adjective
kroppsdel	Noun
militärstyrka	Noun
morgondagars	Noun
ristningen	Noun
pizzan	Noun
entreprenörerna	Noun
improviserades	Verb
lam	Adjective
gotiskans	Noun
rumänske	Adjective
säd	Noun
slangbella	Noun
koncessioners	Noun
fordrades	Verb
oxarna	Noun
eskimåerna	Noun
försvarsutskottet	Noun
vågtalen	Noun
kategoriteori	Noun
beretts	Converb
cypressen	Noun
höjdarna	Noun
sjövärdig	Adjective
överstryknings	Noun
acceptabel	Adjective
ytspänningen	Noun
flipperspelet	Noun
socialförsäkringarna	Noun
jordnöt	Noun
bullers	Noun
tåld	Participle
brudgum	Noun
stiga	Verb
provinser	Noun
kvarlevor	Noun
sädesuttömningen	Noun
variants	Noun
sextondels	Noun
hemländernas	Noun
onormal	Adjective
vårdcentral	Noun
slaga	Noun
bosniska	Noun
inkastet	Noun
cellvägg	Noun
ikosaeder	Noun
duschar	Verb
utredarna	Noun
sockenkyrkornas	Noun
hovrätter	Noun
nomineringarna	Noun
blodgrupper	Noun
lockats	Converb
trubaduren	Noun
härdarnas	Noun
kittlats	Converb
disketts	Noun
paleontolog	Noun
cykloalkaner	Noun
hel	Adjective
verktygslåda	Noun
ristningens	Noun
spridd	Adjective
välfärdsstater	Noun
asturiskor	Noun
vanföreställningar	Noun
kolja	Noun
störämneskoncentrationens	Noun
vätekärnan	Noun
axelryckningarnas	Noun
älg	Noun
lustig	Adjective
norrmännens	Noun
majsen	Noun
fackföreningens	Noun
page	Noun
sätts	Verb
upphovsmannens	Noun
klarinettisten	Noun
slutlig	Adjective
bröstkorgen	Noun
dvärgplaneten	Noun
klassat	Converb
sårande	Participle
alver	Noun
sköldkörtelns	Noun
alkoholismen	Noun
forcerades	Verb
idrottsledarna	Noun
kompensationer	Noun
räknestickan	Noun
dammluckorna	Noun
besök	Verb
fornnordiskan	Noun
samarbeten	Noun
läm	Noun
fjäder	Noun
tillagt	Converb
intresseorganisations	Noun
vetat	Converb
liknat	Converb
moget	Adjective
moskéerna	Noun
kirurger	Noun
verkstaden	Noun
prioriterat	Converb
simulerats	Converb
ärvt	Converb
kondoleanser	Noun
fjärilsims	Noun
delresultatets	Noun
republikanskt	Adjective
fåfängans	Noun
feerna	Noun
medlems	Noun
snabbmat	Noun
vätets	Noun
japanskan	Noun
taleskvinnans	Noun
stentavla	Noun
hyenornas	Noun
akademiskt	Adjective
matfisk	Noun
preferenser	Noun
cerebrospinalvätska	Noun
vakansen	Noun
frigjorde	Verb
biten	Adjective
överbibliotekarien	Noun
cyklisk	Adjective
sammanträdesprotokollets	Noun
terror	Noun
majblommornas	Noun
vansinne	Noun
algerna	Noun
raderingarna	Noun
sydde	Verb
kaffebryggnings	Noun
neptunium	Noun
led	Verb
skriven	Adjective
teckenigenkänningens	Noun
fyrhörning	Noun
skjuter	Verb
gradienten	Noun
utsänds	Verb
nedsattes	Verb
satellitens	Noun
redaktionen	Noun
asteroid	Noun
läkarvetenskapens	Noun
vinkelhastighet	Noun
tillväxande	Participle
aminosyrorna	Noun
katalanernas	Noun
stridsfrågornas	Noun
pärm	Noun
paletters	Noun
passerats	Converb
sammelsuriers	Noun
hett	Adjective
staplarna	Noun
ristningarna	Noun
matematikmaskinens	Noun
försåg	Verb
knopparna	Noun
rovdjurets	Noun
straffsparken	Noun
musköterna	Noun
utgiven	Adjective
brytt	Adjective
skandinaviskornas	Noun
myggan	Noun
personangreppen	Noun
utomjordingen	Noun
reagerar	Verb
grävande	Participle
diken	Noun
vandringstrastars	Noun
åstadkommits	Converb
bergssidor	Noun
innebära	Verb
ärlighet	Noun
förordnade	Verb
bevakats	Converb
farligt	Adjective
återställningar	Noun
gelé	Noun
perennens	Noun
bronsmedaljer	Noun
imponerar	Verb
företalet	Noun
beviljat	Converb
mappen	Noun
sankt	Adjective
fotos	Noun
bordellerna	Noun
resultatlistan	Noun
poesi	Noun
snöglobers	Noun
misstänkts	Converb
vetande	Participle
träffen	Noun
republiker	Noun
sakfrågors	Noun
tillväxtens	Noun
undersidan	Noun
avstavningars	Noun
inramningen	Noun
bromsen	Noun
föreföll	Verb
pornografins	Noun
högljutt	Adjective
parvis	Adjective
gillades	Verb
bira	Noun
karaktäriserar	Verb
adligt	Adjective
frikyrkan	Noun
ärkefienden	Noun
versionerna	Noun
hävdes	Verb
omnämns	Verb
barnlöst	Adjective
tvättbjörn	Noun
eskimåers	Noun
livslängd	Noun
glömmande	Participle
pratat	Converb
lutheran	Noun
fångad	Participle
förföljelsen	Noun
avhandling	Noun
folkminnenas	Noun
utsänder	Verb
kungsörnar	Noun
irriterande	Participle
härfågel	Noun
planterade	Verb
broschens	Noun
firande	Participle
ålderdomen	Noun
pressfriheten	Noun
kristallkulorna	Noun
ockupationerna	Noun
avledningar	Noun
tribunalens	Noun
ljuskällan	Noun
brottningens	Noun
elefanterna	Noun
jäste	Verb
mekaniske	Adjective
självbiografis	Noun
oliv	Noun
chokladbitarna	Noun
utövade	Verb
heptan	Noun
bankande	Participle
karpar	Noun
kompilerad	Participle
lågtyskans	Noun
bolivianerna	Noun
fläckvist	Adjective
antikvitet	Noun
mitokondriernas	Noun
jaks	Noun
memorerar	Verb
förfädernas	Noun
tilldelat	Converb
adjunkts	Noun
studentkårers	Noun
uppförs	Verb
etern	Noun
substansers	Noun
överskridits	Converb
urnordiske	Adjective
pallplatsen	Noun
assimilerats	Converb
duplicerar	Verb
tredjeland	Noun
huvudområdena	Noun
webbsajtens	Noun
predikanten	Noun
terrassens	Noun
rockaders	Noun
preciserar	Verb
orgeln	Noun
kranen	Noun
cellväggar	Noun
handlägga	Verb
smörsyra	Noun
sidformatmallarnas	Noun
byråinspektör	Noun
forskarassistent	Noun
intressesfär	Noun
liknades	Verb
fängelsestraffet	Noun
fiskande	Participle
scouter	Noun
isometriskt	Adjective
tornfalk	Noun
upplösts	Converb
förkläden	Noun
guldmedaljen	Noun
tryggar	Verb
äktenskapsbryterskors	Noun
fördärvats	Converb
älsklig	Adjective
berörd	Participle
guldfiskarnas	Noun
varder	Verb
byggas	Verb
förstärkningarna	Noun
hövdingars	Noun
globaliserad	Participle
garanterades	Verb
webbplatserna	Noun
provisoriet	Noun
skyddsvärdets	Noun
öppnade	Verb
dy	Noun
invektivens	Noun
omnämnandet	Noun
nederländsk	Adjective
syndabockar	Noun
våglängden	Noun
datamaskinen	Noun
kineserna	Noun
reformatorer	Noun
jordgloben	Noun
adoptivt	Adjective
kulvertarna	Noun
oxe	Noun
förnyelse	Noun
dröjande	Participle
Higgsbosons	Noun
vall	Noun
instängd	Adjective
gärdesgårdarna	Noun
förenklande	Participle
kulturområde	Noun
stodernas	Noun
antennerna	Noun
sker	Verb
vittnade	Verb
leksaks	Noun
dök	Verb
ladugårdarna	Noun
framtidsstudiernas	Noun
sopsaltning	Noun
samordning	Noun
utrikespolitikens	Noun
röv	Noun
vinylutgåvorna	Noun
erövrar	Verb
alternerande	Participle
härdsmälta	Noun
röstningen	Noun
arrendenämnders	Noun
flik	Noun
blinkar	Verb
handelshögskolan	Noun
onödigt	Adjective
efterträds	Verb
axiomet	Noun
baskerna	Noun
elektrifierade	Verb
ländkotor	Noun
skandinavisk	Adjective
jordfärgens	Noun
ritningen	Noun
påverkat	Converb
knullad	Participle
piratens	Noun
säker	Adjective
tyristorers	Noun
smyckena	Noun
undergrävts	Converb
rasistiskt	Adjective
förnuftigt	Adjective
ficklampa	Noun
urspårningen	Noun
hettitiska	Noun
rådhusrättens	Noun
ormbunkars	Noun
färgstege	Noun
fotbollsligor	Noun
överraskad	Participle
rustat	Converb
supermakten	Noun
bröstvårtors	Noun
civilingenjörs	Noun
sandstorms	Noun
sociologiskt	Adjective
anlöpa	Verb
normaliserar	Verb
äsping	Noun
klängande	Participle
sydd	Participle
funderat	Converb
markiser	Noun
lettiske	Adjective
lingonsylten	Noun
luffarens	Noun
utters	Noun
förbinda	Verb
tangenter	Noun
nedsättande	Participle
realisering	Noun
voltmeters	Noun
romber	Noun
överträder	Verb
blatten	Noun
institution	Noun
golfbanan	Noun
kammarna	Noun
cirkusdirektörerna	Noun
nagelfils	Noun
subtilt	Adjective
levererade	Verb
sfärernas	Noun
fågelinfluensan	Noun
filtrets	Noun
besvarat	Converb
direktivet	Noun
kalkon	Noun
eddan	Noun
utspelande	Participle
oförskämdhet	Noun
vätebindningar	Noun
kratrar	Noun
sprängas	Verb
svårt	Adjective
holkarna	Noun
vicepresidenter	Noun
spionen	Noun
äktenskapsbrottens	Noun
uppladdad	Adjective
misstroendeförklaringens	Noun
salskraken	Noun
kontrasterar	Verb
rastar	Verb
isolerande	Participle
ståndpunkten	Noun
förvärvad	Participle
bötade	Verb
ytterörat	Noun
uppskattade	Verb
biologi	Noun
neutroner	Noun
uttryckas	Verb
utsträcker	Verb
kvicken	Noun
ösa	Verb
jättens	Noun
samfunden	Noun
lettiskt	Adjective
rutherfordium	Noun
besöktes	Verb
kungöra	Verb
koncessioner	Noun
tjeckiskorna	Noun
beredande	Participle
nötte	Verb
konstituerats	Converb
årgångar	Noun
orent	Adjective
nornorna	Noun
konvoj	Noun
hotellrummen	Noun
proklamerar	Verb
allmänbildningen	Noun
ljusstakar	Noun
logikerna	Noun
revbenens	Noun
befriades	Verb
solade	Verb
raksträckor	Noun
pilgrimen	Noun
blusar	Noun
derivatens	Noun
trut	Noun
fullbordande	Participle
träsken	Noun
elefanten	Noun
suck	Noun
dill	Noun
idylls	Noun
förnyarna	Noun
kontrasterade	Verb
klartexten	Noun
samer	Noun
inspekterade	Verb
tvivlen	Noun
tillhörige	Adjective
förbundne	Adjective
vetenskaplig	Adjective
vitsarna	Noun
nattredaktörer	Noun
händelsehorisonten	Noun
elektromagneters	Noun
fackföreningar	Noun
demokratiskt	Adjective
månförmörkelsen	Noun
nekat	Converb
parades	Verb
approximerar	Verb
textmarkörer	Noun
bekostnad	Noun
rikskronofogden	Noun
affärsresan	Noun
lättmetallernas	Noun
fosforsyra	Noun
nedvärderande	Participle
metaforens	Noun
sparkad	Participle
världshistoriens	Noun
flygplatsens	Noun
öppet	Adjective
föreskrivit	Converb
fixpunkter	Noun
efterträtt	Converb
ballonger	Noun
trafikerade	Verb
rödgrönt	Adjective
utarbetat	Converb
skaplig	Adjective
tideräkningar	Noun
grizzlybjörnar	Noun
läsas	Verb
komministrar	Noun
pappersutgåvors	Noun
provisorium	Noun
brolades	Verb
komplicerande	Participle
ansetts	Converb
urinoarers	Noun
örlogsskolorna	Noun
import	Noun
u-båtarna	Noun
sviken	Participle
korollariet	Noun
knektars	Noun
toppades	Verb
manuell	Adjective
flunsa	Noun
upprättar	Verb
institutioners	Noun
flyget	Noun
ordningarna	Noun
kolonn	Noun
nödutgångarnas	Noun
återställning	Noun
vindrutetorkaren	Noun
dammsögs	Verb
förhindrats	Converb
ansvarat	Converb
hedrar	Verb
angick	Verb
pastor	Noun
bullens	Noun
fartkameror	Noun
förhöra	Verb
flat	Adjective
reaktivitet	Noun
kvartsfinal	Noun
prisjägarna	Noun
tolftedelarna	Noun
marinbiologen	Noun
avstängd	Participle
slutspels	Noun
glittrar	Verb
ätter	Noun
fågelinfluensas	Noun
paraply	Noun
solfjädern	Noun
ciklider	Noun
objektivt	Adjective
arbetande	Participle
koncessionerna	Noun
republikanernas	Noun
utfärdar	Verb
kasern	Noun
bryggt	Adjective
nallar	Noun
deklarerar	Verb
enats	Converb
röstningens	Noun
medlemsstat	Noun
stentavlorna	Noun
regenterna	Noun
gråtande	Participle
marskalk	Noun
lärjungarna	Noun
liftaren	Noun
reassurerad	Participle
kattugglan	Noun
sockervadds	Noun
bridgens	Noun
implicerade	Verb
tvåorna	Noun
scouten	Noun
isolerades	Verb
undersidorna	Noun
schimpansen	Noun
ruinerat	Converb
vaktavlösningars	Noun
förbereder	Verb
redaktionens	Noun
stilige	Adjective
votering	Noun
exploaterades	Verb
hypotesens	Noun
konfrontationerna	Noun
arkeologin	Noun
exotisk	Adjective
österrikiskan	Noun
realiserar	Verb
kroats	Noun
förlagens	Noun
sanktionerna	Noun
katolik	Noun
husfolkets	Noun
livsstilarnas	Noun
förnekad	Participle
småplaneten	Noun
kolumnerna	Noun
tv-arkivets	Noun
universitetsrektorn	Noun
plaggets	Noun
hörsägens	Noun
höstade	Verb
trafikutskottets	Noun
skärselden	Noun
tibetanens	Noun
dunsarna	Noun
extern	Adjective
extremist	Noun
dogmatik	Noun
fantastiske	Adjective
hedersknyffeln	Noun
hindrat	Converb
antikvarier	Noun
barkar	Verb
transformerats	Converb
tålamodet	Noun
morgonrodnadens	Noun
kombinerat	Converb
riktlinjerna	Noun
saltstången	Noun
ättling	Noun
komponerades	Verb
aspens	Noun
diabilds	Noun
återvinnas	Verb
otillräckligt	Adjective
holmars	Noun
isometris	Noun
envist	Adjective
funktionsnedsättning	Noun
uppehållstillstånden	Noun
municipiernas	Noun
amplitud	Noun
fruktansvärd	Adjective
wiccanerna	Noun
päronjuices	Noun
föranletts	Converb
tillkommande	Participle
slickepinnen	Noun
racingbanor	Noun
gnags	Verb
schweiziskt	Adjective
återhämtade	Verb
kokad	Participle
instruerad	Participle
peruanens	Noun
mineralvatten	Noun
lojaliteterna	Noun
dalmål	Noun
dalsänka	Noun
avrättades	Verb
cineasters	Noun
sympatisören	Noun
bomull	Noun
hemmanet	Noun
deldokumentets	Noun
fördelaktig	Adjective
hastar	Verb
padda	Noun
morgonrodnaden	Noun
botande	Participle
helikopter	Noun
spioner	Noun
mackar	Noun
antecknades	Verb
oviktigt	Adjective
skrivboks	Noun
verifierar	Verb
förefalla	Verb
polsk	Adjective
nederdel	Noun
definitionsmängden	Noun
arbetsledaren	Noun
lesbisk	Adjective
kuppens	Noun
tolkade	Verb
sjukvårdsrådgivningar	Noun
krocken	Noun
guldtackornas	Noun
dativen	Noun
anlöps	Verb
pingvin	Noun
barnsoldaterna	Noun
tävlingsbanan	Noun
cellist	Noun
svartnande	Participle
gyttjan	Noun
halvöar	Noun
fjädrars	Noun
statssekreterarna	Noun
aftnarna	Noun
kapprustning	Noun
lyan	Noun
korks	Noun
elektroner	Noun
kajakers	Noun
studentföreningens	Noun
hurrat	Converb
svaveldioxid	Noun
anslagstavlor	Noun
fastigheten	Noun
penningar	Noun
stambanans	Noun
huvens	Noun
boningar	Noun
reproducerande	Participle
grandet	Noun
cyklade	Verb
framställande	Participle
horisonten	Noun
smålänningarna	Noun
sedeln	Noun
mustascher	Noun
tvättställens	Noun
disketter	Noun
acciser	Noun
spionerat	Converb
mallarnas	Noun
fodrade	Verb
importerad	Participle
ögonvittnena	Noun
perrongerna	Noun
församlingskyrka	Noun
cesurernas	Noun
koalitionsregering	Noun
oktantalet	Noun
hasseln	Noun
jämställa	Verb
fitta	Noun
avfallande	Participle
koreansk	Adjective
fyrtaktsmotorernas	Noun
straffades	Verb
kristallkulornas	Noun
bergssidan	Noun
kulsprutepistolerna	Noun
seder	Noun
hyfers	Noun
träffats	Converb
gummit	Noun
demagog	Noun
hackspettens	Noun
förfarit	Converb
budbärarna	Noun
skrivtavla	Noun
tangenterades	Verb
stadsstadgornas	Noun
mörderskor	Noun
polisledning	Noun
rot	Noun
konfigurerad	Participle
millenniers	Noun
meden	Noun
hyperbel	Noun
erektion	Noun
tjeckiske	Adjective
barnmorskor	Noun
köpande	Participle
ull	Noun
effektivt	Adjective
mörknat	Converb
borrmaskin	Noun
jämten	Noun
kranierna	Noun
stenkyrkans	Noun
diskrepansernas	Noun
odjurets	Noun
boja	Noun
crickets	Noun
konspirationsteorins	Noun
isländskornas	Noun
sysselsättning	Noun
tyngdlöshet	Noun
radiostation	Noun
samhällsvetenskaper	Noun
mojängers	Noun
slöjder	Noun
smålänningens	Noun
stelnande	Participle
exponentialfunktionernas	Noun
kröna	Verb
atomers	Noun
trivdes	Verb
överskrida	Verb
arkivarien	Noun
prövats	Converb
protesterar	Verb
finansministrars	Noun
höljd	Participle
ursäktande	Participle
istappens	Noun
spärrar	Verb
pudeln	Noun
subbens	Noun
monetär	Adjective
förutser	Verb
barriärens	Noun
pizzans	Noun
abnormitet	Noun
avkomma	Noun
galningen	Noun
trädojans	Noun
lurade	Verb
sinnebilds	Noun
jagarna	Noun
baggarnas	Noun
kaffeböna	Noun
integrerats	Converb
badkaret	Noun
generalmajoren	Noun
kirurgin	Noun
utbytena	Noun
polismästaren	Noun
homeopatins	Noun
åstadkommandet	Noun
åka	Verb
textmarkören	Noun
ryggkota	Noun
dolts	Converb
lutheranen	Noun
domherre	Noun
kontraherades	Verb
rollatorn	Noun
startad	Participle
gångbanans	Noun
utland	Noun
anblicks	Noun
snickerier	Noun
summerat	Converb
uppräkningar	Noun
divisionen	Noun
tjurfäktningens	Noun
kilens	Noun
dopningens	Noun
husvagn	Noun
anförtroddes	Verb
öm	Adjective
adlande	Participle
katalogiserats	Converb
evolutionsbiologi	Noun
delmängderna	Noun
kryptologis	Noun
förfärlig	Adjective
albumlistorna	Noun
åsen	Noun
kilometern	Noun
riksförbundet	Noun
svartskallens	Noun
slukade	Verb
brasiliansk	Adjective
trollkarlen	Noun
säkerhetsrisk	Noun
servicen	Noun
konstruerande	Participle
skicklige	Adjective
stavelser	Noun
behållas	Verb
kritiserades	Verb
avgränsningen	Noun
begonia	Noun
xenon	Noun
embarkeringen	Noun
försvarslinjer	Noun
affrikata	Noun
ångpannor	Noun
åtelkamera	Noun
huvudområdenas	Noun
pluggade	Verb
konsulten	Noun
fullmakter	Noun
yrkesmördaren	Noun
diagnostiserar	Verb
vanföreställning	Noun
organiserat	Converb
omelett	Noun
demokrati	Noun
kollegierna	Noun
administrative	Adjective
cafeterian	Noun
japanernas	Noun
partistyrelse	Noun
hoppats	Converb
elektrifierat	Converb
vicepresidenternas	Noun
lagrådets	Noun
taxi	Noun
beskriva	Verb
genomföras	Verb
vässar	Verb
rationellt	Adjective
trossamfundets	Noun
dömde	Adjective
arbetsbok	Noun
fjärtars	Noun
tyda	Verb
tömd	Participle
ostbågar	Noun
alpernas	Noun
doktorsavhandlingen	Noun
folkomröstningens	Noun
vandrarhemmet	Noun
servitrisers	Noun
jakande	Participle
stympningar	Noun
majonnäsen	Noun
plankorsningar	Noun
pedagogiks	Noun
staffliet	Noun
förrätter	Noun
assessorer	Noun
busken	Noun
navigerat	Converb
supermakter	Noun
algerier	Noun
förvirrad	Participle
länga	Noun
programledarna	Noun
variation	Noun
öket	Noun
reviderades	Verb
varselpinnarna	Noun
brutalt	Adjective
gallup	Noun
borgarrådets	Noun
skrikit	Converb
exponerades	Verb
husmoder	Noun
kromosomens	Noun
histidin	Noun
hanteringen	Noun
likar	Noun
profilerade	Verb
upptäcktsresas	Noun
ritningarna	Noun
monterad	Participle
tjock	Adjective
fräls	Verb
tändsticksaskar	Noun
gungstol	Noun
kuppernas	Noun
gråtit	Converb
trakasserad	Participle
åttondelen	Noun
utarmades	Verb
trubadurer	Noun
irländskan	Noun
roddarnas	Noun
besöks	Verb
interaktioner	Noun
tideräknings	Noun
materiell	Adjective
belystes	Verb
angenäm	Adjective
konstmuseum	Noun
kattugglans	Noun
stegarna	Noun
ärmar	Noun
blusens	Noun
borrats	Converb
wikipedianernas	Noun
trea	Noun
cirklarna	Noun
beklagar	Verb
återvunnit	Converb
tullarna	Noun
budbäraren	Noun
vision	Noun
kommunikationerna	Noun
stumfilmen	Noun
åklagaren	Noun
urinerar	Verb
skyhög	Adjective
bolagiserades	Verb
detekterades	Verb
klinikerna	Noun
skroven	Noun
entréns	Noun
studsande	Participle
vindruvorna	Noun
hindrade	Verb
våfflorna	Noun
skrämmer	Verb
encyklopedins	Noun
svavels	Noun
ekosystemen	Noun
omnämnandens	Noun
stövlar	Noun
sortis	Noun
pupillerna	Noun
molnige	Adjective
avgrunder	Noun
nunnan	Noun
anspelande	Participle
abscesser	Noun
miniatyrer	Noun
hyrbilarna	Noun
tillsatte	Verb
regnskogar	Noun
gnälla	Verb
trucken	Noun
charm	Noun
maktkamper	Noun
erbjudande	Participle
basketbollens	Noun
komponerad	Participle
sjalen	Noun
tältsängars	Noun
blont	Adjective
parkeringsgaraget	Noun
arbetslöse	Adjective
revolvern	Noun
kemisten	Noun
hjälplöst	Adjective
inblandad	Adjective
återkommit	Converb
presentationen	Noun
alumnernas	Noun
skyldrad	Participle
tillförlitlighetens	Noun
redena	Noun
passad	Participle
admonitioners	Noun
existerade	Verb
inramningars	Noun
avskedats	Converb
meteorolog	Noun
tydligt	Adjective
utsträcka	Verb
qvoters	Noun
kulturpolitikens	Noun
prövar	Verb
katalans	Noun
formulerande	Participle
cyklisten	Noun
följande	Participle
kondensatorns	Noun
opererat	Converb
ädel	Adjective
färgblind	Adjective
stryks	Noun
städad	Participle
karaktäriserad	Participle
fe	Noun
polypeptider	Noun
amuletten	Noun
inhemskt	Adjective
sms:ar	Verb
storebroders	Noun
verifierats	Converb
svensexan	Noun
syrgasen	Noun
rädisorna	Noun
rustningens	Noun
varianterna	Noun
glipor	Noun
massproducerats	Converb
nickar	Verb
kulsprutepistol	Noun
wikifierat	Converb
cykelhjälm	Noun
absider	Noun
utvärderad	Participle
funktionslistors	Noun
symmetrisk	Adjective
nollställning	Noun
staplad	Participle
sändande	Participle
aborter	Noun
utnyttjats	Converb
minustecknet	Noun
abonnenters	Noun
förespråkat	Converb
embarkeringskortets	Noun
veranda	Noun
amnestier	Noun
kråkas	Noun
horisontens	Noun
vinröd	Adjective
översikten	Noun
instäm	Verb
skrivmaskiner	Noun
cynismernas	Noun
ismassor	Noun
biträde	Noun
projicerar	Verb
postindustriell	Adjective
bländande	Participle
betraktar	Verb
infart	Noun
skriftställaren	Noun
vätet	Noun
erratas	Noun
krokodilens	Noun
injektionen	Noun
dyrkande	Participle
broderskapet	Noun
förlagor	Noun
riksantikvarieämbete	Noun
dikenas	Noun
fantomens	Noun
ritande	Participle
förortsbanor	Noun
demagogernas	Noun
raspar	Verb
naive	Adjective
parterna	Noun
penningens	Noun
fjärrkontroller	Noun
immigrant	Noun
nöja	Verb
nationsflagga	Noun
förehållande	Participle
försvarsminister	Noun
lövverkens	Noun
förföljts	Converb
benämnts	Converb
undersöks	Verb
missbrukats	Converb
returnerades	Verb
jordskalvet	Noun
kostat	Converb
tillfälligt	Adjective
regeringsstyrkas	Noun
transporterat	Converb
fransyskorna	Noun
finansmarknader	Noun
spisade	Verb
penisar	Noun
lättmetallegerings	Noun
debatterats	Converb
bekräftelsen	Noun
klasskamrats	Noun
subjektens	Noun
tillverkat	Converb
okänd	Adjective
kaserner	Noun
angelägenhet	Noun
ubåtarnas	Noun
strimma	Noun
utföra	Verb
elektrodynamik	Noun
aborten	Noun
porren	Noun
persondatorernas	Noun
tycka	Verb
superstjärnan	Noun
terminologi	Noun
absolutistisk	Adjective
federations	Noun
bondgården	Noun
beskrivit	Converb
diskens	Noun
konseljer	Noun
tolva	Noun
navigerade	Verb
torped	Noun
kirurgins	Noun
farmarligan	Noun
tältet	Noun
livstiden	Noun
återlämnades	Verb
ledgångsreumatism	Noun
utgjorts	Converb
patrullerar	Verb
konsument	Noun
kommutativ	Adjective
antytts	Converb
godtyckligt	Adjective
rodren	Noun
gussars	Noun
förändrats	Converb
uvens	Noun
spikat	Converb
världslig	Adjective
toxikologin	Noun
realismen	Noun
bergarter	Noun
kidnappats	Converb
överensstämde	Verb
ankommer	Verb
växeltungans	Noun
flundran	Noun
utbytesstudenternas	Noun
snöat	Converb
besätta	Verb
möblerad	Participle
blåsinstrumenten	Noun
mediterade	Verb
tredjedels	Noun
mänsklige	Adjective
bringat	Adjective
frälstes	Verb
världsdelar	Noun
stavkyrka	Noun
rationaliserade	Verb
taleskvinnorna	Noun
makrons	Noun
flygplatsernas	Noun
rappade	Verb
filtrerar	Verb
tokigt	Adjective
suddades	Verb
övergår	Verb
partysvenskens	Noun
brunbjörn	Noun
högskolorna	Noun
befriande	Participle
oboist	Noun
befolkat	Converb
anekdotens	Noun
skatteindrivaren	Noun
baracker	Noun
skridskon	Noun
enbärens	Noun
sprängladdningar	Noun
tibetanerna	Noun
formatering	Noun
sjukvården	Noun
vanlige	Adjective
differensekvationerna	Noun
glid	Verb
barometern	Noun
tvättställets	Noun
årstiden	Noun
toxikologs	Noun
underklasserna	Noun
hörnen	Noun
kisse	Noun
pålagd	Participle
terrorist	Noun
linjärkombinationer	Noun
vandringar	Noun
purjolökarnas	Noun
spelaren	Noun
globernas	Noun
förlamat	Adjective
manövrerad	Participle
magert	Adjective
producerats	Converb
egyptologi	Noun
bortsetts	Converb
sjundedel	Noun
möjliggörande	Participle
inverterad	Participle
telegrafstyrelsen	Noun
brottning	Noun
negerbollars	Noun
funderade	Verb
kastanjerna	Noun
syskonförturs	Noun
kastanjen	Noun
kärt	Adjective
lindar	Verb
variationerna	Noun
övervägs	Verb
kejsaren	Noun
potentielle	Adjective
gårdag	Noun
värmeböljan	Noun
förspelet	Noun
livsmedelsbutik	Noun
inspektören	Noun
behärskad	Participle
armbandsuret	Noun
slagskuggorna	Noun
tillägnats	Converb
social	Adjective
ramar	Verb
teknikern	Noun
konungadöme	Noun
cyniker	Noun
nederländskan	Noun
ättlingarna	Noun
ärva	Verb
presskonferensens	Noun
sårades	Verb
stadskärnans	Noun
kartlagts	Converb
kavel	Noun
presstödet	Noun
semifinalister	Noun
cannabisen	Noun
sedvanligt	Adjective
normerat	Converb
begravningsplatserna	Noun
mulet	Adjective
tidig	Adjective
mexikansk	Adjective
kyl	Noun
förberetts	Converb
nanometer	Noun
reassurerade	Verb
skruvade	Verb
mems	Noun
förståelse	Noun
missbrukar	Verb
motellet	Noun
skärbrädornas	Noun
behärskar	Verb
ansvarsområden	Noun
arrenderats	Converb
oxen	Noun
jagad	Participle
natriumhydroxiden	Noun
huvudägarens	Noun
repatrierande	Participle
kulturområden	Noun
operatorn	Noun
räderna	Noun
smitning	Noun
medlemmarnas	Noun
förtiga	Verb
jättar	Noun
sommarspelen	Noun
krycka	Noun
avstått	Converb
lanserat	Converb
ursäktade	Verb
strömming	Noun
snökedjor	Noun
impar	Verb
flaggstången	Noun
reflektionen	Noun
biografin	Noun
bemöttes	Verb
förledens	Noun
bevakningen	Noun
plog	Noun
brorsdottern	Noun
pluskvamperfektets	Noun
autografer	Noun
arbetslivs	Noun
trälarnas	Noun
kammarrättsfiskalers	Noun
qvick	Adjective
finansministerns	Noun
chinchillor	Noun
serpentiner	Noun
förstörs	Verb
illustrerade	Verb
kontrasterat	Converb
offrade	Verb
tryggande	Participle
potentiellt	Adjective
ytterörats	Noun
virkets	Noun
årtionde	Noun
stelnar	Verb
pluralformens	Noun
bergarternas	Noun
kolmonoxid	Noun
försonande	Participle
fördärvade	Verb
dogmatisk	Adjective
uthärdade	Verb
konsulterna	Noun
optimeringen	Noun
diamants	Noun
vaccinationen	Noun
skolbildning	Noun
annekterades	Verb
anteckningsbok	Noun
kronofogdar	Noun
timvisaren	Noun
otvivelaktigt	Adjective
bländarnas	Noun
nöta	Verb
dokusåpor	Noun
stympning	Noun
gränsvärdenas	Noun
omsätts	Verb
näringslivs	Noun
överdrivet	Adjective
butiksbiträdena	Noun
juridiskt	Adjective
kunglig	Adjective
medelmåttig	Adjective
motorvägen	Noun
dränerades	Verb
villfarelsen	Noun
takvånings	Noun
kondensatorerna	Noun
läkarvetenskap	Noun
pluralformer	Noun
fasett	Noun
champagnens	Noun
fackförening	Noun
prioriterats	Converb
entrecôte	Noun
uppställs	Verb
stigande	Participle
slagne	Adjective
mäktigt	Adjective
avfallit	Converb
storleksordningen	Noun
uppnådd	Participle
glasblock	Noun
friplåtens	Noun
rutschkanans	Noun
rockad	Noun
uppförsbacke	Noun
dödsdagen	Noun
anspelningarna	Noun
costaricans	Noun
direktionens	Noun
redogörs	Verb
företagarna	Noun
misstänks	Verb
tukt	Noun
projektilens	Noun
ordades	Verb
vårtinget	Noun
dygders	Noun
förstörelsen	Noun
oljekällas	Noun
torterats	Converb
eldflugor	Noun
himmelssfärerna	Noun
nedkvarken	Noun
ständigt	Adjective
syntetiserades	Verb
gillande	Participle
finalens	Noun
konsumenternas	Noun
borsten	Noun
morot	Noun
citattecknen	Noun
konfigurerats	Converb
enfaldigt	Adjective
våldet	Noun
kronprinsessa	Noun
saxofonen	Noun
offentlighetens	Noun
farmakologisk	Adjective
transmissions	Noun
oskadliggörande	Participle
rödhaken	Noun
pskovsk	Adjective
nattklubbarnas	Noun
bojkotter	Noun
uppehållstillståndet	Noun
geni	Noun
spenat	Noun
portföljen	Noun
vattenkannorna	Noun
tredjegradsekvationer	Noun
frukosten	Noun
amerikanskorna	Noun
relaterat	Converb
turkiskans	Noun
svalnar	Verb
betydlig	Adjective
matvarorna	Noun
formulerades	Verb
befolkningstäthet	Noun
mekanikens	Noun
baksäte	Noun
utövningen	Noun
selektivt	Adjective
marinbiologisk	Adjective
vibrerande	Participle
fryshusets	Noun
liar	Noun
produktioner	Noun
arkaisk	Adjective
ständig	Adjective
japanskornas	Noun
Laplaceoperatorer	Noun
avtagen	Adjective
paketerad	Participle
kavlars	Noun
svenskheten	Noun
uttrarna	Noun
handtruck	Noun
anförtror	Verb
övertygades	Verb
solstrålarna	Noun
körtelfeber	Noun
konspiration	Noun
dvärgflodhäst	Noun
spärrskikten	Noun
talks	Noun
forensiskt	Adjective
osäkerhet	Noun
sockerbetan	Noun
motverkat	Converb
bijektiv	Adjective
häva	Verb
förhörde	Verb
protokollets	Noun
intervjuar	Verb
maskerar	Verb
tiokronornas	Noun
existentialismen	Noun
asiat	Noun
klistrats	Converb
spillen	Noun
kantade	Verb
besvärats	Converb
paraboloiderna	Noun
skenbenens	Noun
beläget	Adjective
prövade	Verb
holmiumet	Noun
hällkistor	Noun
neutral	Adjective
överlåtits	Converb
postkods	Noun
studentkårer	Noun
spiller	Verb
minken	Noun
fjordarnas	Noun
pokalen	Noun
strävt	Adjective
bordsbön	Noun
eskorts	Noun
kulminerade	Verb
distributioner	Noun
adiabatisk	Adjective
argentinska	Noun
mordisk	Adjective
talgoxe	Noun
skärmytslingar	Noun
trastarnas	Noun
nämnaren	Noun
bubblas	Noun
symboliskt	Adjective
tillbakagångens	Noun
fullmakt	Noun
chassits	Noun
cymbals	Noun
reserverna	Noun
omsatte	Verb
städande	Participle
krymps	Verb
födelsedagspresenter	Noun
polygami	Noun
faroframkallandet	Noun
filtyp	Noun
bokförs	Verb
blunder	Noun
ugglans	Noun
presenning	Noun
daggmaskar	Noun
nymånar	Noun
bebisens	Noun
rostat	Converb
licensierades	Verb
paletten	Noun
lågmält	Adjective
verkstad	Noun
hind	Noun
kammarrättspresident	Noun
bedömts	Converb
tillträds	Verb
papegoja	Noun
åtbördens	Noun
associativitet	Noun
halshugger	Verb
anordnade	Verb
beröms	Verb
dansarna	Noun
strykningen	Noun
duglige	Adjective
konstruktivism	Noun
förlängt	Converb
åtfärdens	Noun
skammens	Noun
okinawianskan	Noun
legitimerades	Verb
sannolikheternas	Noun
föreställt	Converb
unison	Adjective
dumburkars	Noun
vindstyrkan	Noun
övernattar	Verb
mobiliserad	Participle
utforskar	Verb
skräm	Verb
svärfadern	Noun
skulptören	Noun
nationalmuseers	Noun
givarens	Noun
dalmålet	Noun
monarkierna	Noun
blixtrar	Verb
överlåta	Verb
utgrävningens	Noun
seglande	Participle
sandstormar	Noun
tranbäret	Noun
belägget	Noun
röstningar	Noun
avfarternas	Noun
smörjningen	Noun
skulptörer	Noun
pedagogiskt	Adjective
missgärningar	Noun
veckoslutens	Noun
kreaturens	Noun
kunskapsutvecklingens	Noun
debattör	Noun
plantornas	Noun
vederlägger	Verb
krusbäret	Noun
slovenskt	Adjective
grammofonstiftets	Noun
försvarsministerns	Noun
signerades	Verb
inkorporerat	Converb
grusbanorna	Noun
mäts	Verb
roderytor	Noun
smedjornas	Noun
bleck	Noun
immigrerade	Verb
pillars	Noun
kuts	Noun
piercingarnas	Noun
muntlig	Adjective
återuppbygga	Verb
ifrågasatte	Verb
returnerad	Participle
offentliggjort	Converb
östes	Verb
halskotan	Noun
alban	Noun
baggarna	Noun
globale	Adjective
faktarutorna	Noun
rullstol	Noun
asterisken	Noun
assens	Noun
piercingars	Noun
verktygslådornas	Noun
dialoger	Noun
slovakernas	Noun
regndroppen	Noun
råd	Verb
relativitetsteoris	Noun
tjärnar	Noun
avvikelsen	Noun
orvet	Noun
propagerar	Verb
konsortium	Noun
installerats	Converb
avtalats	Converb
skrivmaskinerna	Noun
spaltens	Noun
rannsakande	Participle
riksmarskalkens	Noun
rejält	Adjective
tillägga	Verb
bostadskriser	Noun
lyftaren	Noun
logiskt	Adjective
modige	Adjective
avgår	Verb
nagels	Noun
erbjuda	Verb
flygplatserna	Noun
fornengelskans	Noun
framsidorna	Noun
förrätt	Noun
osynlig	Adjective
tilltalsnamnen	Noun
avgränsats	Converb
stoltserande	Participle
vardag	Noun
kapitalism	Noun
upptäcktes	Verb
initiativen	Noun
armborsten	Noun
formlerna	Noun
vietnamesisk	Adjective
upplöses	Verb
fotsulan	Noun
tittad	Participle
fullfölja	Verb
försökande	Participle
agitatorns	Noun
regionalt	Adjective
assistens	Noun
cricketplaner	Noun
periferin	Noun
arbetsområde	Noun
förman	Noun
proklamerade	Verb
kassetter	Noun
rikspolischefen	Noun
additionernas	Noun
slutspurt	Noun
folkvisan	Noun
landmassorna	Noun
reception	Noun
clementinernas	Noun
kolning	Noun
igelkottar	Noun
översvämmades	Verb
orglarna	Noun
skojade	Verb
hjärnhinnorna	Noun
massupplagor	Noun
besserwisser	Noun
papel	Noun
tillhandahållandet	Noun
betvivlats	Converb
bägarna	Noun
cembalo	Noun
möblerades	Verb
färdigheter	Noun
häxjakter	Noun
linjärkombination	Noun
iranskan	Noun
stos	Noun
petat	Converb
felfortplantningens	Noun
förfäktade	Verb
avleds	Verb
spakblocket	Noun
käkats	Converb
hyllmeter	Noun
utmanövrerades	Verb
nyårsdagen	Noun
asylen	Noun
absurd	Adjective
antilopen	Noun
presskonferensen	Noun
prinsessas	Noun
överklagade	Verb
trakterna	Noun
postmodernismen	Noun
företräda	Verb
helikopterns	Noun
mellisarnas	Noun
utmanövrerade	Verb
fantomen	Noun
dopfuntarna	Noun
benägenhet	Noun
monetärt	Adjective
getingarna	Noun
klonen	Noun
upplevas	Verb
finns	Verb
marskalkars	Noun
akvarier	Noun
gentekniken	Noun
anlagts	Converb
dramatik	Noun
ariornas	Noun
optimerats	Converb
postmodernismens	Noun
svettades	Verb
konsuln	Noun
kolonet	Noun
markisens	Noun
tandvården	Noun
varaktig	Adjective
raspande	Participle
organisten	Noun
dokumentation	Noun
arbetskraft	Noun
förverkligande	Participle
pilspetsarna	Noun
kråkorna	Noun
överlät	Verb
långfredagarnas	Noun
vårpropositionen	Noun
odlats	Converb
musicerande	Participle
häger	Noun
svängt	Converb
angelägenheter	Noun
inverterat	Converb
missbrukade	Verb
hittats	Converb
sannolikt	Adjective
skyddats	Converb
krossad	Participle
pupiller	Noun
medlemmars	Noun
medlaren	Noun
rasist	Noun
stapelns	Noun
vandaliserat	Converb
tjugondelars	Noun
majsstärkelse	Noun
abbedissornas	Noun
killingar	Noun
dirigerades	Verb
modd	Noun
minering	Noun
likström	Noun
anpassades	Verb
insamlade	Verb
idena	Noun
bearbetar	Verb
tjöt	Verb
akvedukterna	Noun
planterats	Converb
förvärvade	Verb
syndarna	Noun
underhåller	Verb
Mandelbrotmängderna	Noun
kråkan	Noun
genitiv	Noun
renhållning	Noun
propositionen	Noun
latituden	Noun
ridskolan	Noun
otur	Noun
speldosor	Noun
hänvisningen	Noun
integrerar	Verb
högar	Verb
domherrar	Noun
kagges	Noun
drängarna	Noun
viskar	Verb
församlats	Converb
kommendörs	Noun
upplåter	Verb
tjej	Noun
hemsidors	Noun
allergis	Noun
utbildade	Verb
serbiskans	Noun
fortsättnings	Noun
smyckar	Verb
kroppslig	Adjective
ismassa	Noun
katoliker	Noun
sparvar	Noun
sakpolitiske	Adjective
orientalister	Noun
förutsägbar	Adjective
poolen	Noun
ventilerat	Converb
ambitiös	Adjective
begåtts	Converb
sakregistrens	Noun
sockar	Noun
boliviansk	Adjective
odet	Noun
tågat	Converb
jättes	Noun
esperantos	Noun
rått	Converb
generade	Verb
nynorska	Noun
tjut	Verb
pungdjuret	Noun
osade	Verb
kåsör	Noun
motverkades	Verb
genteknik	Noun
girar	Verb
vevaxel	Noun
påfart	Noun
moské	Noun
fysikern	Noun
tillbedjas	Verb
nagellackborttagningsmedlen	Noun
betänkandes	Noun
ekvationen	Noun
östgöten	Noun
kramade	Verb
protein	Noun
jurist	Noun
sjörövaren	Noun
diskriminerades	Verb
bihålors	Noun
öppnats	Converb
paradoxen	Noun
gisslarna	Noun
lagstiftningar	Noun
altruism	Noun
donerades	Verb
grossen	Noun
tsarer	Noun
ungt	Adjective
redder	Noun
upphandlingens	Noun
mambos	Noun
generaldirektörer	Noun
teleskopen	Noun
magnetismens	Noun
utformade	Verb
uppståndelsens	Noun
vokaler	Noun
slickat	Converb
repeterade	Verb
kommendörkapten	Noun
geologiske	Adjective
strövtåg	Noun
högskolors	Noun
sektionsnämnder	Noun
skottes	Noun
inspektörer	Noun
utnyttjar	Verb
knepig	Adjective
heligt	Adjective
kexen	Noun
etiopier	Noun
semifinaler	Noun
placerad	Participle
ekets	Noun
spåddes	Verb
bålgetingar	Noun
hemisfärerna	Noun
flygas	Verb
fjällvråkars	Noun
hasselnöt	Noun
fyrtaktsmotorn	Noun
fiaskon	Noun
almanackorna	Noun
nyckeln	Noun
skrattmåsens	Noun
teknofobiernas	Noun
ihåligt	Adjective
kolväte	Noun
ikon	Noun
kokpunkt	Noun
vurmade	Verb
försäljningssiffrorna	Noun
svastikan	Noun
exporterats	Converb
högtidens	Noun
skrämdes	Verb
spelpjäserna	Noun
rengöringen	Noun
fjortisarna	Noun
husmor	Noun
skjutglade	Adjective
kvick	Adjective
snabbspolades	Verb
katodstrålars	Noun
butanolens	Noun
digitalisering	Noun
förväntad	Participle
säcklöpningarna	Noun
amurtrastarna	Noun
pilgrimsfärder	Noun
busschaufför	Noun
aktrisen	Noun
magsmärtorna	Noun
antecknar	Verb
partikelfysik	Noun
remsorna	Noun
uthärdat	Converb
vånda	Noun
petade	Verb
golfklubb	Noun
erratorna	Noun
forskningsråden	Noun
säkerhetsvakten	Noun
kungsvatten	Noun
uppräkningen	Noun
besvarats	Converb
upplevs	Verb
stavar	Verb
palmsöndagen	Noun
broscher	Noun
klichéer	Noun
världsmästarna	Noun
utgångspunkten	Noun
biltvätt	Noun
installerades	Verb
säkerhetsskydd	Noun
begränsades	Verb
rationaliserande	Participle
bokmalarnas	Noun
kolmilorna	Noun
skarven	Noun
bilägga	Verb
sälj	Verb
molekylers	Noun
långfredagarna	Noun
studsar	Verb
filmats	Converb
amöbor	Noun
allusionsordboken	Noun
ämbetes	Noun
suddats	Converb
kommittéerna	Noun
ryskt	Adjective
störtloppet	Noun
kvädets	Noun
skyltfönstren	Noun
befrielse	Noun
granne	Adjective
utlösa	Verb
ryskans	Noun
specialistsjuksköterska	Noun
lånar	Verb
maximal	Adjective
satsades	Verb
sekretariatets	Noun
genombrutet	Adjective
implementerats	Converb
befogenhets	Noun
salladen	Noun
kroks	Noun
tysthet	Noun
ytteröra	Noun
meddelad	Participle
listigt	Adjective
cirkels	Noun
riksbank	Noun
caféets	Noun
initierad	Participle
tyristorn	Noun
tryckerier	Noun
etylacetatets	Noun
inspirerad	Participle
kollegiets	Noun
transistorns	Noun
svarar	Verb
tiotalens	Noun
toleranser	Noun
vicepresidents	Noun
besiktigades	Verb
fullbordar	Verb
förkylnings	Noun
kaffekannornas	Noun
roats	Converb
partisprängning	Noun
böljans	Noun
blidkats	Converb
avlöser	Verb
grupperad	Participle
morgondagens	Noun
utökning	Noun
naturhistorisk	Adjective
huvudgatan	Noun
musikgrupper	Noun
skuren	Noun
visningar	Noun
enkel	Adjective
bisonoxar	Noun
stämpel	Noun
qvinnans	Noun
migrerande	Participle
dvärg	Noun
stumpar	Noun
symbolism	Noun
laptop	Noun
vattenkannas	Noun
reaktiv	Adjective
torkarnas	Noun
autonome	Adjective
vilseledande	Participle
flodhäst	Noun
betygsätts	Verb
bollplanken	Noun
gökar	Noun
municipium	Noun
tänkaren	Noun
verksamhetsområdena	Noun
fyrtaktsmotor	Noun
elektricitetens	Noun
snöbollskriget	Noun
behörigheterna	Noun
lyckosam	Adjective
existentiellt	Adjective
elektrifierad	Participle
stambanorna	Noun
ledamöters	Noun
ackvisition	Noun
stormakternas	Noun
extremismens	Noun
motorcyklist	Noun
värmebehandlingar	Noun
lyors	Noun
studentkåren	Noun
talk	Noun
sjuksyster	Noun
programmen	Noun
talesman	Noun
stipendiat	Noun
kontrafaktisk	Adjective
legaliserat	Converb
svaveldioxiden	Noun
bildordbok	Noun
motorväg	Noun
kapitulerar	Verb
riksgälden	Noun
raljerade	Verb
randstats	Noun
exponerar	Verb
livsstil	Noun
shaherna	Noun
steglitsen	Noun
uppstått	Converb
vinstdelningens	Noun
marxism	Noun
toas	Noun
mygga	Noun
skriftlig	Adjective
utkommen	Participle
ateismens	Noun
elektronik	Noun
opererats	Converb
samiska	Noun
irriterad	Participle
kollision	Noun
stenar	Verb
förtecknades	Verb
tingsrätts	Noun
färdandes	Participle
epilogs	Noun
interjektions	Noun
ringblomman	Noun
Laplacetransformers	Noun
kusken	Noun
dieseln	Noun
vasen	Noun
regeringsåren	Noun
klassklyfta	Noun
infogar	Verb
beställningarnas	Noun
uppfyllande	Participle
tingsfiskalernas	Noun
rullgardinerna	Noun
ångpanna	Noun
oumbärligt	Adjective
arbetslös	Adjective
stadsstaten	Noun
synvinkel	Noun
vinkar	Verb
leende	Participle
valrossen	Noun
möhippornas	Noun
bromspedalens	Noun
befolkningstäthetens	Noun
insisterande	Participle
bulgar	Noun
fortifikations	Noun
lugnt	Adjective
botats	Converb
ogräsen	Noun
murarnas	Noun
medeltidens	Noun
misshandlades	Verb
veterans	Noun
kalendern	Noun
cykelhjälmarna	Noun
vävar	Noun
enhjulingar	Noun
optimistiskt	Adjective
nunans	Noun
toors	Noun
nornor	Noun
samlar	Verb
högerparti	Noun
karakteristik	Noun
blåögd	Adjective
prosan	Noun
upprepade	Verb
örterna	Noun
skatteverket	Noun
flickväns	Noun
ändelser	Noun
alpens	Noun
efterlyste	Adjective
propositionerna	Noun
het	Adjective
decennium	Noun
numerisk	Adjective
sammanfattades	Verb
blåsigt	Adjective
förnyar	Verb
värmande	Participle
förutsägelse	Noun
kakaons	Noun
krämaren	Noun
vandringen	Noun
förflyttningar	Noun
fördröjs	Verb
anblicken	Noun
diarium	Noun
naven	Noun
skyldige	Adjective
körbanor	Noun
vindrutans	Noun
etsning	Noun
evergreens	Noun
tving	Noun
församlingskyrkors	Noun
guvernanter	Noun
fanans	Noun
inställa	Verb
hyponymerna	Noun
hägringen	Noun
eponyms	Noun
förstods	Verb
golfbanorna	Noun
odlande	Participle
reflektioner	Noun
halvsyster	Noun
proffset	Noun
bestäms	Verb
etiketterades	Verb
maskerat	Converb
atomkärnan	Noun
lokomotivet	Noun
brottades	Verb
stockholmaren	Noun
faraos	Noun
neurologen	Noun
lyriken	Noun
ekolog	Noun
ketonen	Noun
asyler	Noun
andrar	Adjective
hänvisad	Participle
orkanens	Noun
nyckelknippa	Noun
hejdande	Participle
fjärdegradsfunktionens	Noun
läts	Verb
rövarens	Noun
konsults	Noun
runa	Noun
åran	Noun
ockuperad	Participle
noggrannheternas	Noun
lämpar	Verb
hundvalpen	Noun
köptes	Verb
sparrar	Noun
synkroniserade	Verb
räd	Noun
glorian	Noun
kompletterar	Verb
krokodiler	Noun
maltesiskan	Noun
ärmarna	Noun
utvaldes	Verb
giljotinernas	Noun
lekkamrats	Noun
surrande	Participle
gardin	Noun
fyr	Noun
pressmeddelanden	Noun
begränsar	Verb
primtalen	Noun
utgångspunkterna	Noun
grundnivå	Noun
angripit	Converb
bläckfiskar	Noun
kakkalasen	Noun
tyckts	Converb
preferensen	Noun
bokmålets	Noun
zoologisk	Adjective
ekonomernas	Noun
omvärderat	Converb
förnekades	Verb
kalenderns	Noun
fastställs	Verb
stark	Adjective
gorillas	Noun
narrs	Noun
ingicks	Verb
entledigande	Participle
skatteutskotten	Noun
grödorna	Noun
bekostar	Verb
premierar	Verb
stöds	Verb
personangreppens	Noun
slingans	Noun
fotnoten	Noun
stiftades	Verb
huggorm	Noun
kaviar	Noun
azeriskans	Noun
systemkameror	Noun
senatorn	Noun
ställföreträdaren	Noun
asymptotiskt	Adjective
gulan	Noun
domstolens	Noun
fördjupad	Adjective
oundviklighetens	Noun
protokollförts	Converb
lånade	Verb
felmeddelandes	Noun
paradoxer	Noun
arabiskan	Noun
opinionsbildarna	Noun
gorillorna	Noun
ventiler	Noun
receptionsordbok	Noun
destillerats	Converb
kaffebusken	Noun
kotteriets	Noun
oktanter	Noun
lyssnat	Converb
styrelseledamoten	Noun
förfinades	Verb
telefonsladdar	Noun
felaktigheterna	Noun
administrativ	Adjective
ratades	Verb
bluff	Noun
virkad	Participle
lanterna	Noun
bifalla	Verb
världsdelarna	Noun
innebörd	Noun
stavkyrkans	Noun
frihandel	Noun
lemmat	Noun
kåkars	Noun
bondgårdarnas	Noun
riksdagsdirektören	Noun
socialförsäkringsministerns	Noun
medeltidslatin	Noun
procentenhet	Noun
sjättedelar	Noun
hystes	Verb
versläran	Noun
gentile	Adjective
pekats	Converb
vippor	Noun
flickvän	Noun
essentialism	Noun
i-land	Noun
raggmunkars	Noun
ballerina	Noun
biobränsle	Noun
rättstavningens	Noun
ungkarl	Noun
livslängderna	Noun
skjutfältens	Noun
småländska	Noun
herde	Noun
niece	Noun
äng	Noun
öppnat	Converb
pionjärerna	Noun
brakylogi	Noun
oxiderade	Verb
kaffeburk	Noun
studerats	Converb
loppan	Noun
sjukförsäkringens	Noun
vapenstilleståndet	Noun
ruinerad	Participle
riksbanker	Noun
årsbok	Noun
gurkskivors	Noun
medmänniskorna	Noun
kostnadsfri	Adjective
bipolärt	Adjective
hovrättsassessorn	Noun
derbyt	Noun
julklappars	Noun
ändrades	Verb
sabotages	Noun
mättes	Verb
tia	Noun
hanen	Noun
straffspark	Noun
förutsägelsers	Noun
läroanstalters	Noun
drogen	Noun
rollers	Noun
rektangel	Noun
bevaknings	Noun
prästgårdars	Noun
rapporterats	Converb
dalande	Participle
förvaltningsmyndigheter	Noun
nominerar	Verb
hospitalens	Noun
palindrom	Noun
dinosauriens	Noun
parter	Noun
koffertars	Noun
förbehållit	Converb
dagligt	Adjective
datas	Noun
undersöka	Verb
blånegrer	Noun
motsagts	Converb
fraktionen	Noun
fakturan	Noun
kapande	Participle
hypotenusa	Noun
kristnats	Converb
framgångssagors	Noun
stadsdelarnas	Noun
hårnålskurvor	Noun
ficklampor	Noun
prosten	Noun
café	Noun
attributen	Noun
utställa	Verb
blödningar	Noun
låsas	Verb
stumfilm	Noun
husvagnar	Noun
signerat	Converb
massakerns	Noun
amfibie	Noun
personbilars	Noun
förlåtit	Converb
botanikern	Noun
menar	Verb
omloppsbanorna	Noun
konkande	Participle
anslagit	Converb
samborna	Noun
lärosäten	Noun
handledd	Participle
sjungs	Verb
mölla	Noun
returer	Noun
östkyrkan	Noun
bombarderades	Verb
afrikanska	Noun
dörrklockorna	Noun
brevkniv	Noun
enskilt	Adjective
nattskärra	Noun
okände	Adjective
provinserna	Noun
bildlig	Adjective
kukar	Noun
upplåta	Verb
asterisker	Noun
hällregnens	Noun
örtagård	Noun
cellväggen	Noun
statschefs	Noun
roterats	Converb
sydafrikanskornas	Noun
knoparnas	Noun
beundrades	Verb
kosmologers	Noun
förstainstansrätt	Noun
pornografin	Noun
livegenskapens	Noun
laddning	Noun
adertondelar	Noun
påbyggnadslinjer	Noun
blodplasma	Noun
tvingar	Noun
siktat	Converb
förberedas	Verb
anpassar	Verb
ungerskans	Noun
böjligt	Adjective
utgivning	Noun
chokladbitar	Noun
insamlad	Participle
ämbetena	Noun
medlemsstats	Noun
sydpolernas	Noun
babyloniskt	Adjective
preludier	Noun
aritmetisk	Adjective
teknisk	Adjective
byråchefs	Noun
semi	Noun
antagning	Noun
tomtarna	Noun
tjugofemörings	Noun
lyftarna	Noun
själviske	Adjective
komprimerades	Verb
restaurerades	Verb
försäkringskassornas	Noun
millennier	Noun
rakt	Adjective
häfte	Noun
kroppsvätskor	Noun
påvar	Noun
kollektivavtalen	Noun
elbasarnas	Noun
plantageägaren	Noun
kandidatens	Noun
vänstersidoklasser	Noun
farsan	Noun
forornas	Noun
vanföreställningen	Noun
enskild	Adjective
gynnades	Verb
pion	Noun
nycklarnas	Noun
transaktioner	Noun
erbjud	Verb
förskjuta	Verb
återvändsgränd	Noun
lärosätes	Noun
popularitet	Noun
fjärrvärmens	Noun
rengjorde	Verb
tamp	Noun
guppen	Noun
transkriberar	Verb
bivråks	Noun
mammutarnas	Noun
tangentbordets	Noun
adepter	Noun
restaurerats	Converb
granaterna	Noun
uppföljnings	Noun
kortsluta	Verb
gotländskorna	Noun
klargörs	Verb
oktanet	Noun
orkesterledarna	Noun
förklarad	Participle
autenticitet	Noun
beaktades	Verb
plommonen	Noun
farföräldrar	Noun
självbiografierna	Noun
vetenskapsakademins	Noun
alfers	Noun
apostoliske	Adjective
luftballongernas	Noun
jättestor	Adjective
ecuadorianer	Noun
nuddar	Verb
pipet	Noun
inbrottet	Noun
skarpt	Adjective
centralbyrå	Noun
presenterar	Verb
vänjer	Verb
regeringsförklaringens	Noun
neurotoxikologs	Noun
rarings	Noun
schäfer	Noun
tystades	Verb
kortleken	Noun
kvantitet	Noun
bivråk	Noun
kontraproduktivt	Adjective
asturiskors	Noun
mestiser	Noun
normeringen	Noun
selleri	Noun
insekten	Noun
rustningarnas	Noun
reviderade	Verb
förändrande	Participle
tändsticksaskens	Noun
kolumner	Noun
skodonens	Noun
förenats	Converb
barntå	Noun
bruksanvisningar	Noun
kameliorna	Noun
skådar	Verb
härlighetens	Noun
u-båtens	Noun
prästgårds	Noun
primärkälla	Noun
finansmarknad	Noun
samordnats	Converb
berikats	Converb
subventionerat	Converb
institutionens	Noun
testiklarna	Noun
näbben	Noun
förstärka	Verb
högskolestyrelsen	Noun
debattörernas	Noun
uträttar	Verb
olikhet	Noun
komministern	Noun
svimmat	Converb
utbytes	Noun
trasmattor	Noun
skottkärran	Noun
halverad	Participle
tillåta	Verb
vridmomentet	Noun
finalist	Noun
vänsterpartierna	Noun
kulturpolitiks	Noun
diskvattnet	Noun
fackla	Noun
borttaget	Adjective
tangenterna	Noun
sejen	Noun
sanerades	Verb
cyanamiden	Noun
ägd	Adjective
bifogades	Verb
avvikelses	Noun
punschen	Noun
nämnts	Converb
påbjuden	Participle
bergarters	Noun
styranordningens	Noun
östrogenets	Noun
atomkärnor	Noun
flundrornas	Noun
torterad	Participle
kortslutits	Converb
fogats	Converb
trippelpunkternas	Noun
administrations	Noun
suckarnas	Noun
avlidit	Converb
äggkopps	Noun
fullföljde	Verb
cesiumkloridens	Noun
lexikografiskt	Adjective
subjektets	Noun
toalettstolar	Noun
jäktande	Participle
ufots	Noun
begyntes	Verb
naturvetenskaper	Noun
ceder	Noun
derivator	Noun
karolinerna	Noun
gitarristerna	Noun
omdirigerade	Verb
licensierade	Verb
bukspottkörtel	Noun
skuldran	Noun
idyller	Noun
ornitologernas	Noun
könskromosomer	Noun
adventskalender	Noun
arg	Adjective
korpen	Noun
svärdotters	Noun
glappkontakterna	Noun
chiffonjé	Noun
voljär	Noun
termodynamiken	Noun
avhandlingen	Noun
strör	Verb
konverterades	Verb
automatlådor	Noun
furnerande	Participle
atomenergi	Noun
tångens	Noun
medlemmar	Noun
redovisar	Verb
vederlagt	Converb
informationsbärarna	Noun
symboliserad	Participle
ingredienser	Noun
härletts	Converb
praktiserades	Verb
taxibilarna	Noun
formades	Verb
samhällsområdes	Noun
krigat	Converb
klarinetter	Noun
curium	Noun
vuvuzelornas	Noun
tröttnade	Verb
vattenmassor	Noun
osmium	Noun
klargjord	Participle
vänsterparti	Noun
epiteten	Noun
statsbanorna	Noun
punktuppställning	Noun
förstärkningar	Noun
skyddsängeln	Noun
neologin	Noun
köper	Verb
ukrainske	Adjective
biografisk	Adjective
snoken	Noun
cyklopropans	Noun
doktorsgrads	Noun
klarades	Verb
allergin	Noun
chasidism	Noun
lasagners	Noun
LP-skivan	Noun
Pålsmässa	Noun
torpens	Noun
brandsäkerheten	Noun
kakadua	Noun
klängt	Converb
sabbar	Verb
fyrtiondedelar	Noun
koordinaterna	Noun
urskilj	Verb
styrutrustningen	Noun
penisars	Noun
leddjuren	Noun
rösträtten	Noun
ideologin	Noun
konkretiserande	Participle
monterats	Converb
utvärderings	Noun
koloniserades	Verb
rycker	Verb
pyramider	Noun
bygget	Noun
koordinatsystemet	Noun
passade	Verb
hedrad	Participle
riskerat	Converb
plast	Noun
smyger	Verb
gymnasisten	Noun
tillsatsen	Noun
vattenmassan	Noun
läppstiftens	Noun
kylningen	Noun
tiokronors	Noun
hjärnhinnan	Noun
gurkskivornas	Noun
kreative	Adjective
misstänkte	Verb
folkans	Noun
dvärgarnas	Noun
ledarskapets	Noun
delfin	Noun
termers	Noun
uppförsbackar	Noun
fullgöra	Verb
albansk	Adjective
acklamationens	Noun
diplomati	Noun
utsträckningars	Noun
hånglat	Converb
härligheters	Noun
återställer	Verb
etnisk	Adjective
snytas	Verb
röta	Noun
lösningars	Noun
kvällstidningen	Noun
skepsisen	Noun
nornan	Noun
anordnad	Participle
bläckpennans	Noun
kollegier	Noun
muttrar	Verb
operativsystemet	Noun
svänga	Verb
sluppen	Participle
ändelsen	Noun
ferrimagnetiske	Adjective
forskningsministerns	Noun
befinnas	Verb
tillöknings	Noun
regionernas	Noun
brorsonen	Noun
telegrafstyrelsernas	Noun
infört	Converb
assistenterna	Noun
omprövad	Participle
adekvate	Adjective
medianen	Noun
gardiner	Noun
legitimerad	Participle
crawl	Noun
regentens	Noun
subjekten	Noun
avlösas	Verb
kajak	Noun
bistår	Verb
uträttande	Participle
åstadkommer	Verb
arkeolog	Noun
seten	Noun
showen	Noun
byster	Noun
strontium	Noun
loppa	Noun
burkornas	Noun
altarets	Noun
hypnagog	Adjective
fä	Noun
arkeologins	Noun
framhåller	Verb
bedragaren	Noun
fågelvinge	Noun
buntar	Verb
bysterna	Noun
absorberar	Verb
gummibandet	Noun
amnestin	Noun
prillan	Noun
köksbänk	Noun
planade	Verb
bifloder	Noun
mördad	Participle
återanvänds	Verb
studsmatta	Noun
tillbeder	Verb
prenumererade	Verb
cricketbollen	Noun
rättsskola	Noun
tjugofemtedelens	Noun
torterar	Verb
riktar	Verb
bygdegård	Noun
spärrades	Verb
spenderar	Verb
härlige	Adjective
minimerade	Verb
knarkande	Participle
tidigt	Adjective
härbärgerar	Verb
blottande	Participle
ytspänningens	Noun
rensning	Noun
strömmingen	Noun
huvar	Noun
aldri	Adjective
bubbla	Noun
kommunistisk	Adjective
pager	Noun
överdirektör	Noun
absurditeten	Noun
geopolitikens	Noun
slingorna	Noun
aminosyrornas	Noun
interjektionens	Noun
ritning	Noun
fanor	Noun
countryn	Noun
skärmbilden	Noun
dogmernas	Noun
slukades	Verb
hänsyn	Noun
tonåringen	Noun
diktator	Noun
gräva	Verb
disponerades	Verb
cittrornas	Noun
kulsprutan	Noun
förefallit	Converb
förstörts	Converb
arrangerades	Verb
kaffemärkens	Noun
oegennytta	Noun
embryon	Noun
abstinensen	Noun
briserar	Verb
purt	Adjective
tystade	Verb
drakkulorna	Noun
värnpliktens	Noun
clownfisk	Noun
överstinnan	Noun
filatelisten	Noun
radiotelefoni	Noun
citadellet	Noun
försvunnen	Participle
fjärrkontrollen	Noun
attiske	Adjective
astronomin	Noun
veckotidningarna	Noun
myr	Noun
morotens	Noun
gåsgam	Noun
utrymdes	Verb
absolutist	Noun
finländarnas	Noun
oförskämdheter	Noun
arseniken	Noun
angriparen	Noun
bulgariska	Noun
överlämnade	Verb
asymptoter	Noun
kommunal	Adjective
överensstämma	Verb
vaxande	Participle
gärdena	Noun
dioden	Noun
loppas	Noun
jämtarna	Noun
inbegripet	Adjective
barkades	Verb
hindens	Noun
menades	Verb
höglands	Noun
framsteget	Noun
episteln	Noun
trollades	Verb
gärdsgården	Noun
vidskepelses	Noun
holkar	Noun
licensierad	Participle
aftonen	Noun
pskovske	Adjective
gästgiverierna	Noun
trovärdigheten	Noun
polygonen	Noun
raderade	Verb
koordinats	Noun
pionjären	Noun
kadmium	Noun
konserverad	Participle
konkurrenterna	Noun
korsförhöret	Noun
exponenterna	Noun
röstad	Participle
pingvinen	Noun
högskolestyrelserna	Noun
ostbågarnas	Noun
atombombningarnas	Noun
stress	Noun
gravlaxen	Noun
tryggad	Participle
täpp	Verb
fildelningen	Noun
testad	Participle
respektabelt	Adjective
tyfonen	Noun
ormvråken	Noun
morgontidning	Noun
spöregnens	Noun
roderytans	Noun
blodsockret	Noun
roderytorna	Noun
pudelns	Noun
myrorna	Noun
brigadgeneraler	Noun
djuriske	Adjective
hittar	Verb
bultarna	Noun
gnejsen	Noun
landsmaninnorna	Noun
uppnåtts	Converb
nig	Verb
setets	Noun
knyter	Verb
kackerlacka	Noun
mastens	Noun
hundkött	Noun
ekorrarna	Noun
regeringsstyrkorna	Noun
ynnest	Noun
tomat	Noun
enhetspartier	Noun
stämplar	Verb
entré	Noun
tornuggla	Noun
implementerar	Verb
överförts	Converb
partiledaren	Noun
admittanser	Noun
korsningarna	Noun
akademikern	Noun
avvisats	Converb
inrättande	Participle
behöver	Verb
projekterade	Verb
tibetanske	Adjective
pacemaker	Noun
förarbete	Noun
orienterande	Participle
bruksanvisnings	Noun
höstack	Noun
samba	Noun
ryggsäck	Noun
lemurer	Noun
teknetium	Noun
eskalerande	Participle
premiärministrarna	Noun
knektens	Noun
avfarter	Noun
konserverna	Noun
slipar	Verb
gammal	Adjective
lagstiftade	Verb
dominikanernas	Noun
startades	Verb
katodstråleröret	Noun
funderande	Participle
sommarstugan	Noun
sorti	Noun
matematiken	Noun
kompaniets	Noun
rövknullades	Verb
registrerar	Verb
kontraktsprostens	Noun
kejsarens	Noun
fotonens	Noun
ädelsten	Noun
skötes	Noun
emigrerande	Participle
glidyta	Noun
lampskärm	Noun
delegerats	Converb
havererar	Verb
kandidaters	Noun
väcktes	Verb
kobran	Noun
stämgafflar	Noun
förutsägelser	Noun
lackernas	Noun
kärnkraften	Noun
jäntornas	Noun
projektilerna	Noun
antända	Verb
separerade	Verb
förhåller	Verb
landat	Converb
vardande	Participle
strategi	Noun
smycke	Noun
arkitektur	Noun
blodgruppen	Noun
artärers	Noun
burschikos	Adjective
uppsättningen	Noun
handtagen	Noun
livegenskap	Noun
deklination	Noun
länsrådet	Noun
olik	Adjective
populär	Adjective
mätande	Participle
utbildningsutskottet	Noun
optimerar	Verb
belysa	Verb
brandbilar	Noun
underminerats	Converb
konstitutioner	Noun
revolvers	Noun
utgåvor	Noun
årsvis	Adjective
påverkades	Verb
empatiskt	Adjective
piraterna	Noun
växellådor	Noun
blockaden	Noun
butikshyllorna	Noun
världsstjärnor	Noun
testikeln	Noun
instruerade	Verb
einsteinium	Noun
åkrarna	Noun
åtföljd	Participle
överskreds	Verb
infogades	Verb
fulle	Adjective
sidbrytningen	Noun
häxans	Noun
kalkyl	Noun
infrastrukturministern	Noun
grundsatser	Noun
nöts	Verb
fagre	Adjective
drama	Noun
kryssprodukt	Noun
viskat	Converb
förstådd	Participle
invaderat	Converb
rederi	Noun
väggplankans	Noun
grävdes	Verb
cellinnehållet	Noun
tillsätts	Verb
avtjänades	Verb
legitimationer	Noun
allegorisk	Adjective
ciceronens	Noun
zemstvo	Noun
blyet	Noun
dinaren	Noun
sköldpadda	Noun
lantbruksskolorna	Noun
uppfylldes	Verb
prissummor	Noun
ödelagt	Converb
folkrättens	Noun
sluge	Adjective
etsat	Converb
glödande	Participle
halverats	Converb
förehölls	Verb
flöjtister	Noun
bytas	Verb
köpa	Verb
moderniserad	Participle
dramatiske	Adjective
stinga	Verb
vänsterpolitik	Noun
ceremonis	Noun
uppställningarna	Noun
colombianskans	Noun
styrsystemen	Noun
isomorfi	Noun
puffrors	Noun
bossar	Noun
tillverkningsteknik	Noun
valutaenhets	Noun
gavels	Noun
värnplikten	Noun
stjärt	Noun
viceamiralen	Noun
flyttfåglar	Noun
pille	Noun
varumärken	Noun
emirens	Noun
ungkarlens	Noun
boskaps	Noun
jordfärgerna	Noun
blötts	Converb
petar	Verb
skärmdump	Noun
vagt	Adjective
förskjutande	Participle
förebyggande	Participle
riksbibliotekarien	Noun
konferenser	Noun
regeringsformer	Noun
paketcykel	Noun
försvinner	Verb
rensningarna	Noun
centralbankers	Noun
beläggas	Verb
orgasm	Noun
hult	Adjective
handduk	Noun
åtlarna	Noun
riktad	Participle
farhågans	Noun
statlig	Adjective
befogenheterna	Noun
skifttangent	Noun
ulven	Noun
statistik	Noun
brutale	Adjective
tjugofemöringarnas	Noun
wikifierade	Verb
underminerad	Participle
countrys	Noun
etiopiska	Noun
reformatorerna	Noun
lusen	Noun
ljuvlig	Adjective
hedningarnas	Noun
markörer	Noun
läsande	Participle
uppfödaren	Noun
enhällige	Adjective
stolpes	Noun
mekaniken	Noun
lys	Verb
singellistor	Noun
huvudverkens	Noun
hyvlade	Verb
assisten	Noun
gölarna	Noun
rebelliskt	Adjective
uppläts	Verb
divisionernas	Noun
knäck	Verb
reseledaren	Noun
beteckningar	Noun
återgivningen	Noun
caféer	Noun
dubbelmackors	Noun
nykter	Adjective
kalkyler	Noun
gråt	Verb
sugga	Noun
snickeri	Noun
överstrykningar	Noun
behåll	Verb
kompassen	Noun
tappade	Verb
multiplicerad	Participle
stulit	Converb
blåhaken	Noun
judisk	Adjective
uppkomsten	Noun
firades	Verb
listige	Adjective
störande	Participle
trycks	Verb
redes	Noun
sexigt	Adjective
metanol	Noun
karp	Noun
solförmörkelse	Noun
höjts	Converb
snabb	Adjective
käpphäst	Noun
varm	Adjective
förnyat	Converb
sexan	Noun
flygel	Noun
korsfäste	Verb
materielens	Noun
uppenbart	Adjective
snickarverkstad	Noun
förmodad	Participle
lågtrycket	Noun
syndaren	Noun
säl	Noun
gummina	Noun
universitetsrektorers	Noun
puma	Noun
intrångets	Noun
förhandsgranskade	Verb
ministärernas	Noun
dammsky	Noun
glömmas	Verb
trend	Noun
lärjunge	Noun
tabelldokumentet	Noun
uppskattar	Verb
mandariner	Noun
inträffade	Verb
sköldpaddorna	Noun
trafikolyckornas	Noun
individualiserade	Verb
konceptet	Noun
programmets	Noun
rasismen	Noun
förvägrades	Verb
house	Noun
skadeutfallen	Noun
seanser	Noun
vallens	Noun
bryggkaffe	Noun
kamelia	Noun
abelsk	Adjective
pekskärm	Noun
skulptör	Noun
diskett	Noun
stängel	Noun
avgudar	Noun
mobiltelefon	Noun
hejats	Converb
bedöma	Verb
nyponen	Noun
ilska	Noun
kulturpolitisk	Adjective
stridsspetsarna	Noun
konungadömets	Noun
bindeordet	Noun
kajas	Noun
dödskalle	Noun
snabbgenomgångarnas	Noun
berikades	Verb
utgrävning	Noun
inkluderat	Converb
tonåringars	Noun
abborre	Noun
cyklistens	Noun
fortfor	Verb
sök	Verb
arkaiske	Adjective
nedsätter	Verb
motverkade	Verb
akademisk	Adjective
svenne	Noun
revolvrar	Noun
extraknäcker	Verb
analfabeten	Noun
granatäpple	Noun
plankorsning	Noun
portats	Converb
frigörs	Verb
världsligt	Adjective
extremt	Adjective
inkomstkällornas	Noun
specifike	Adjective
etymologier	Noun
psykologis	Noun
senatorerna	Noun
massage	Noun
hotbilderna	Noun
adelssläkts	Noun
underhålla	Verb
behån	Noun
vetenskapsakademier	Noun
sydafrikansk	Adjective
knullats	Converb
efterfesten	Noun
förgät	Verb
hulde	Adjective
hökar	Noun
fjäderbrickan	Noun
paleontologens	Noun
frimurarnas	Noun
jargong	Noun
respekt	Noun
överdriva	Verb
kommunministrar	Noun
framsätena	Noun
obskyr	Adjective
soluppgångars	Noun
hyperlänkar	Noun
fågelskådaren	Noun
väghållningen	Noun
skranket	Noun
relevansen	Noun
gnagande	Participle
societeternas	Noun
hemligheternas	Noun
senatorer	Noun
delfinen	Noun
utsträcks	Verb
egenvektor	Noun
wikifierats	Converb
nedförsbackar	Noun
brune	Adjective
kaffeburks	Noun
translationer	Noun
världsväldes	Noun
förteckningarna	Noun
atomisk	Adjective
stämgaffel	Noun
mjukvarans	Noun
böjen	Noun
koordinerande	Participle
historiker	Noun
jagade	Verb
sagolik	Adjective
uppmärksammar	Verb
altanerna	Noun
strävpelarnas	Noun
ingrediensen	Noun
toxikologisk	Adjective
avkodarna	Noun
underbart	Adjective
altaner	Noun
ornitologi	Noun
allergikerns	Noun
upplevts	Converb
vägrats	Converb
myrsyras	Noun
kommunstyrelse	Noun
involverande	Participle
preussiskornas	Noun
utsänt	Converb
vasers	Noun
mäklande	Participle
strukturerat	Converb
ackja	Noun
iriskan	Noun
prickade	Verb
demagogerna	Noun
dillen	Noun
utförs	Verb
menykommandots	Noun
arkiverades	Verb
stridsyxas	Noun
expeditionschefen	Noun
anfang	Noun
appellativiserande	Participle
araberna	Noun
beteckningen	Noun
filmstjärnan	Noun
martyrernas	Noun
ädelstenar	Noun
plånen	Noun
gränslandet	Noun
frälser	Verb
rös	Noun
cirkel	Noun
transistor	Noun
poängterat	Converb
krigsskådeplatsernas	Noun
kompenserad	Participle
perfektionisterna	Noun
atomkärnornas	Noun
undvikas	Verb
vävstolar	Noun
utbildningsnivån	Noun
atomkrafts	Noun
lugnande	Participle
bärnstenen	Noun
gagnar	Verb
klormonoxidens	Noun
samtidigt	Adjective
tågstationer	Noun
rotfyllning	Noun
jeepens	Noun
morötter	Noun
beskriver	Verb
skolbänkens	Noun
antikaffärer	Noun
nejlikan	Noun
milas	Noun
ettan	Noun
tillväxten	Noun
konstitutions	Noun
rymdfärjan	Noun
globalisering	Noun
kopiering	Noun
arkivaries	Noun
överstökat	Adjective
saltstångens	Noun
terapeutiskt	Adjective
överleva	Verb
väldige	Adjective
vildsvinets	Noun
huvudkällor	Noun
graverad	Participle
webbläsarna	Noun
blickande	Participle
atombombar	Verb
bjuden	Adjective
charmörer	Noun
gummibandens	Noun
litat	Converb
falsifierats	Converb
blockader	Noun
dagstidningarnas	Noun
stavningskontrollernas	Noun
tangentbordet	Noun
framstående	Participle
sjöröveri	Noun
meterna	Noun
duons	Noun
ätterna	Noun
förverkligar	Verb
reformens	Noun
förutseende	Participle
ventilen	Noun
breds	Verb
bortsett	Converb
tsunamierna	Noun
upprättat	Converb
klaffelens	Noun
sirap	Noun
medvurstars	Noun
molekyl	Noun
skjutfälten	Noun
rimmet	Noun
paradigmskiften	Noun
polisongers	Noun
förhastat	Converb
grindvalars	Noun
generationers	Noun
modulens	Noun
slogs	Verb
kabinetten	Noun
motorcyklister	Noun
valresultatets	Noun
folkräkningar	Noun
utomjordingar	Noun
poesins	Noun
nottecknets	Noun
matte	Adjective
kalabalikens	Noun
begagnats	Converb
flamingor	Noun
hymn	Noun
upplåts	Verb
huvudverket	Noun
musiklivet	Noun
giraffens	Noun
juldagens	Noun
diameter	Noun
kommandofönstren	Noun
registrerat	Converb
kvävet	Noun
bromsats	Converb
invasionsstyrka	Noun
sömsmånernas	Noun
ordensgrundaren	Noun
kräftans	Noun
regionkommitté	Noun
attraktiv	Adjective
underlagen	Noun
licensierat	Converb
slovenskans	Noun
arrendet	Noun
återkomsten	Noun
flikens	Noun
tandvärk	Noun
snickerifabriken	Noun
skogsstjärnan	Noun
konsul	Noun
mentor	Noun
fysiologins	Noun
bulgarerna	Noun
bibelns	Noun
grekiskans	Noun
potentialer	Noun
prickad	Participle
giljotinen	Noun
häftig	Adjective
rödstjärtars	Noun
förlåt	Verb
anteckningsbokens	Noun
stränginstrumenten	Noun
statsbudgeten	Noun
bajskorv	Noun
respekterad	Participle
nyfiken	Adjective
falsarium	Noun
australiskan	Noun
esplanader	Noun
charmören	Noun
verkligheter	Noun
aorta	Noun
laddad	Participle
atommassan	Noun
isbjörn	Noun
dödligt	Adjective
lugn	Adjective
stökiometri	Noun
hycklarnas	Noun
studentkår	Noun
vicepresident	Noun
baskerns	Noun
utrikesutskottet	Noun
slutaren	Noun
reellt	Adjective
absolutismen	Noun
migrering	Noun
raljerande	Participle
klistrar	Verb
citrin	Noun
medlat	Converb
fruktosen	Noun
moped	Noun
handslaget	Noun
immigrationen	Noun
negern	Noun
världsåskådnings	Noun
musköter	Noun
embarkerats	Converb
storkarna	Noun
värdinnan	Noun
axiomens	Noun
komponenten	Noun
positron	Noun
parapsykologin	Noun
syrans	Noun
killat	Converb
verksamt	Adjective
hajarnas	Noun
simbassänger	Noun
neurologerna	Noun
societeten	Noun
tynger	Verb
krickan	Noun
godsaker	Noun
stadsdelar	Noun
koltrastens	Noun
afghaner	Noun
utövar	Verb
teknokratiers	Noun
visioner	Noun
viceamiral	Noun
karolinen	Noun
bragdernas	Noun
homeopati	Noun
justitiekansler	Noun
berördes	Verb
ficktjuvens	Noun
passerade	Verb
förfallodagen	Noun
fis	Verb
urmakaren	Noun
cyklopropan	Noun
finalister	Noun
väljer	Verb
specialförbandet	Noun
betäcka	Verb
fritöserna	Noun
regeringsskrivelserna	Noun
postkontoret	Noun
uppgraderats	Converb
säkert	Adjective
pinks	Noun
rymdfärjans	Noun
kungamakaren	Noun
bekostats	Converb
betecknats	Converb
riskors	Noun
trollade	Verb
misstänka	Verb
välkomnandena	Noun
komponentens	Noun
platåerna	Noun
fimpar	Noun
klassats	Converb
förnekat	Converb
redaktionell	Adjective
stenades	Verb
okunnig	Adjective
kön	Noun
strumpbyxas	Noun
tornugglor	Noun
kartografiske	Adjective
oordning	Noun
tukaner	Noun
referenser	Noun
öglan	Noun
ståndpunkterna	Noun
innehållande	Participle
krossades	Verb
fredsrörelsen	Noun
fiskgjuse	Noun
uppställningens	Noun
värmt	Converb
utnämnande	Participle
genererat	Converb
upphovsrättslig	Adjective
snyter	Verb
räknande	Participle
terapeuten	Noun
kokosnöts	Noun
monsuns	Noun
stoltheten	Noun
invasionsstyrkan	Noun
fött	Adjective
stabile	Adjective
cymbal	Noun
reparation	Noun
memorerat	Converb
bråkdel	Noun
initierar	Verb
laddningarna	Noun
struken	Adjective
herdarnas	Noun
åra	Noun
heltalen	Noun
övervinns	Verb
kackige	Adjective
sos	Noun
buketters	Noun
djurskyddslag	Noun
programmens	Noun
inmatningen	Noun
algoritmer	Noun
elsäkerhetens	Noun
aria	Noun
lindade	Verb
sponsrade	Verb
räknesticka	Noun
grytet	Noun
huvudområdet	Noun
kackerlackans	Noun
etnograf	Noun
snackade	Verb
katalanerna	Noun
adjunkten	Noun
kalenderflickorna	Noun
inordnad	Participle
prioriterad	Participle
specifik	Adjective
reduktions	Noun
joserna	Noun
tävlingsbana	Noun
synagogans	Noun
dominerades	Verb
hatet	Noun
undervattensbåtar	Noun
staffli	Noun
ungkarls	Noun
förvandlad	Participle
deklinationer	Noun
doktrinen	Noun
uttagningar	Noun
presidentvalet	Noun
graviditeter	Noun
samverkande	Participle
spekulerades	Verb
retade	Verb
adels	Noun
friaren	Noun
autograf	Noun
dämpades	Verb
användarsida	Noun
karakteriserade	Verb
deltävlingens	Noun
hämnats	Converb
omdanade	Verb
pedal	Noun
figurerar	Verb
adlig	Adjective
komprimerar	Verb
tårtbitar	Noun
solrosens	Noun
servade	Verb
raggande	Participle
resistorns	Noun
motiverat	Converb
metallurgisk	Adjective
inälvans	Noun
otukt	Noun
asteroiderna	Noun
solidaritets	Noun
släkttavlor	Noun
färggradienternas	Noun
undergrävd	Participle
kristlig	Adjective
enslinjer	Noun
uppföljningar	Noun
lakade	Verb
slipats	Converb
svärdöttrar	Noun
gullige	Adjective
försvarsstyrkan	Noun
gallas	Noun
fager	Adjective
cyklonens	Noun
politikområden	Noun
flödesplanerna	Noun
cykelpump	Noun
förstatligade	Verb
karmosinröd	Adjective
fasans	Noun
algernas	Noun
uppmärksammande	Participle
ornitologins	Noun
apelsinträdet	Noun
fostermor	Noun
upplevd	Participle
djurskyddslagar	Noun
akronymen	Noun
grundar	Verb
kartografen	Noun
serbers	Noun
lagades	Verb
kristendom	Noun
kö	Noun
förtrycktes	Verb
dvärgar	Noun
luren	Noun
projicerat	Converb
utrustande	Participle
tillämplig	Adjective
kosmologi	Noun
glykolens	Noun
kablings	Noun
frälsa	Verb
lagrådsremissers	Noun
dubbelt	Adjective
ozelotens	Noun
hy	Noun
karamellen	Noun
utesluten	Participle
skuldrorna	Noun
droppande	Participle
sabotage	Noun
exemplifierades	Verb
lysa	Verb
förhandsgranskning	Noun
svängande	Participle
brorsa	Noun
injektion	Noun
koncentrationslägret	Noun
baddräkterna	Noun
prioriterades	Verb
konsoliderande	Participle
eldgaffeln	Noun
riksförening	Noun
utlandet	Noun
gärdet	Noun
bergsrådinnor	Noun
kajaker	Noun
beskuren	Adjective
ockuperat	Converb
bygdegårdar	Noun
gitarristers	Noun
härleds	Verb
opinionsbildningen	Noun
längdgrad	Noun
territorier	Noun
gräslök	Noun
minoriteters	Noun
ister	Noun
kapitalisten	Noun
herdarna	Noun
hospitalet	Noun
ättlingars	Noun
genierna	Noun
systematisk	Adjective
rikshemvärnschef	Noun
glutamins	Noun
förfinats	Converb
säkerhetsbältet	Noun
furstar	Noun
embargo	Noun
portugiserna	Noun
strålskydd	Noun
stavelsens	Noun
begravd	Adjective
guldgruvor	Noun
titlar	Noun
träffande	Participle
jämföra	Verb
fanorna	Noun
kungadömets	Noun
segelbåten	Noun
husmusen	Noun
tonsills	Noun
täckena	Noun
brunbjörnar	Noun
diskoteken	Noun
klämdagarna	Noun
småplaneters	Noun
smugglingen	Noun
kontrabasens	Noun
regerar	Verb
bryllingarna	Noun
gardinstång	Noun
nyckelpigas	Noun
schimpanserna	Noun
modern	Adjective
adventskalendern	Noun
medlarna	Noun
geotekniks	Noun
respekterande	Participle
topplista	Noun
européer	Noun
elefant	Noun
framträder	Verb
elevhemmet	Noun
standarder	Noun
oxalsyra	Noun
guddotter	Noun
nordanvinden	Noun
guldgruvorna	Noun
fängelsestraffen	Noun
homeopatin	Noun
tribunaler	Noun
rederierna	Noun
belönades	Verb
kokar	Verb
laves	Noun
bodybuilding	Noun
dylik	Adjective
brittiske	Adjective
klotens	Noun
makrona	Noun
sötnosen	Noun
integriteten	Noun
funkat	Converb
ändamålen	Noun
ligget	Noun
buttre	Adjective
trumhinnor	Noun
avgäld	Noun
metar	Verb
styckeformatmalls	Noun
författningarna	Noun
kulturelle	Adjective
läkekonsten	Noun
bägarnas	Noun
biträdes	Noun
äppelträdet	Noun
utforskade	Verb
diktafonen	Noun
tundrans	Noun
evangelierna	Noun
felkällans	Noun
axlar	Verb
pilgrimer	Noun
justerades	Verb
ornens	Noun
satsningarna	Noun
tundra	Noun
pipetterna	Noun
lästs	Converb
betalarens	Noun
partens	Noun
kristendomen	Noun
motorvägssträckan	Noun
utrullningslisten	Noun
uppståndelse	Noun
avsatts	Converb
sött	Adjective
skapat	Adjective
tangentens	Noun
vävnadens	Noun
knäppts	Converb
såpoperans	Noun
innerörat	Noun
målet	Noun
standardiserats	Converb
redaktriserna	Noun
riksbankscheferna	Noun
bladens	Noun
bulles	Noun
exegetiks	Noun
nåtts	Converb
stals	Verb
kvadratrot	Noun
eggad	Participle
irländskorna	Noun
fångades	Verb
vederlagts	Converb
ölmagarnas	Noun
förkortad	Participle
dunstar	Verb
glöms	Verb
brukarens	Noun
intresserar	Verb
mugglaren	Noun
handgranater	Noun
marknadsföringen	Noun
käkens	Noun
övernattat	Converb
dissades	Verb
matvara	Noun
ensamvargar	Noun
industriellt	Adjective
radiator	Noun
kräkas	Verb
bedömdes	Verb
statsledning	Noun
företrädas	Verb
containern	Noun
omstrukturerande	Participle
finansplanens	Noun
kuben	Noun
cylindern	Noun
föreskriver	Verb
odjurens	Noun
bladets	Noun
kontrabasen	Noun
förbundit	Converb
hamstring	Noun
spillets	Noun
ananasernas	Noun
regeringssammanträdenas	Noun
industriland	Noun
lave	Noun
so	Noun
nätbedrägerier	Noun
förtvivlade	Verb
jordfärger	Noun
dubbelklickar	Verb
ångest	Noun
viljestyrkas	Noun
ödegårdars	Noun
banderoller	Noun
synkroniserat	Converb
vaxat	Converb
industriell	Adjective
avskrev	Verb
fritösen	Noun
medverkade	Verb
stubbe	Noun
lyste	Verb
diskontinuitet	Noun
sakregistren	Noun
bögarna	Noun
cedilj	Noun
sockerbetor	Noun
bräschen	Noun
farmarna	Noun
rymma	Verb
räfflors	Noun
lät	Verb
pusslet	Noun
säkerhetspolitik	Noun
kratern	Noun
avar	Verb
reciterande	Participle
berörande	Participle
lagledaren	Noun
långtråkige	Adjective
hallåan	Noun
konstitutionen	Noun
lystes	Verb
etiketter	Noun
kalkylers	Noun
moderniserade	Verb
överlåts	Verb
gymnasisterna	Noun
hovrättsfiskalens	Noun
taggarna	Noun
temporär	Adjective
påskägget	Noun
cyanväte	Noun
falsk	Adjective
rekommenderades	Verb
basketen	Noun
ansluter	Verb
modet	Noun
exportkrediter	Noun
hända	Verb
predikande	Participle
invandrade	Verb
molekylärformlernas	Noun
morförälderns	Noun
spelarnas	Noun
matsal	Noun
strutars	Noun
kaffeblasket	Noun
gott	Adjective
fruktämne	Noun
instruktionsuppsättningen	Noun
anseende	Participle
fyllos	Noun
digitaliserar	Verb
punktuppställningarna	Noun
femtegradsfunktions	Noun
bekräftades	Verb
costarican	Noun
fodrar	Verb
könsrollerna	Noun
intelligenser	Noun
granat	Noun
cowboyen	Noun
utrymmer	Verb
bofink	Noun
titelns	Noun
aktinium	Noun
kommissionärer	Noun
radiobilarna	Noun
dalripan	Noun
rörigt	Adjective
arvedelars	Noun
tenderade	Verb
fisket	Noun
sagolikt	Adjective
domsaga	Noun
hejdats	Converb
söte	Adjective
reviderat	Converb
huvudgata	Noun
liknats	Converb
stylisterna	Noun
glaciären	Noun
kvietismen	Noun
regeringsförklaringarnas	Noun
hallåans	Noun
selen	Noun
rönas	Noun
studium	Noun
judoutövarens	Noun
världsstjärna	Noun
juliamängdens	Noun
ballongens	Noun
teismen	Noun
blöt	Adjective
titel	Noun
årligt	Adjective
elektroskop	Noun
flykthastigheten	Noun
knäcks	Verb
skadegörelsen	Noun
repetitioners	Noun
lämplig	Adjective
arkeologerna	Noun
omstrukturerade	Verb
sköldkörteln	Noun
privatlivets	Noun
summerade	Verb
sor	Noun
väcka	Verb
översätter	Verb
chokladkaka	Noun
bornyrens	Noun
galluparnas	Noun
särskiljas	Verb
örtteers	Noun
personligheterna	Noun
smyg	Verb
monarkerna	Noun
odödligheten	Noun
accelerationernas	Noun
talföljders	Noun
gestaltad	Participle
skulle	Noun
logaritmer	Noun
säkrats	Converb
dals	Noun
lingvisterna	Noun
biträder	Verb
nederländskt	Adjective
linjekartan	Noun
synagogorna	Noun
pluralformernas	Noun
misstycker	Verb
lärt	Adjective
allemansrätten	Noun
pilar	Verb
dottersonen	Noun
sökande	Participle
interaktion	Noun
valfritt	Adjective
proffsen	Noun
sötnosarna	Noun
uppförsbacken	Noun
järnvågen	Noun
penisarnas	Noun
turkarna	Noun
himlakroppars	Noun
försäkrad	Participle
femkrona	Noun
jättarnas	Noun
bakelsen	Noun
demonstrerar	Verb
deister	Noun
simbassäng	Noun
utmanar	Verb
oxpiskan	Noun
abdominal	Adjective
skett	Converb
lokaliserat	Converb
fruktansvärde	Adjective
skötaren	Noun
syntetiserats	Converb
långtradarchaufförernas	Noun
dåre	Noun
hästkrafter	Noun
blodgruppers	Noun
hallåa	Noun
differensernas	Noun
protokollet	Noun
emigrationens	Noun
emblemet	Noun
plogens	Noun
besuttits	Converb
blunders	Noun
differentialekvationen	Noun
tellur	Noun
förseglades	Verb
treven	Adjective
förvarad	Participle
dokusåpa	Noun
persiska	Noun
grindarna	Noun
påbyggnader	Noun
utvandrat	Converb
betydligt	Adjective
omnipotensen	Noun
kopierades	Verb
staplande	Participle
servitriser	Noun
vuxenutbildning	Noun
karakteristikers	Noun
helheten	Noun
aubergins	Noun
ackvisitionerna	Noun
deists	Noun
normaliserande	Participle
tarserna	Noun
navel	Noun
extrapolations	Noun
hundvalpar	Noun
auberginens	Noun
målen	Noun
pärms	Noun
julgransplundringarnas	Noun
negrerna	Noun
svalnad	Participle
mögel	Noun
virade	Verb
hednings	Noun
protoner	Noun
inspirationskälla	Noun
ninjan	Noun
dubbelgångaren	Noun
fotgängarnas	Noun
låser	Verb
medeltidskyrka	Noun
viskande	Participle
åtnjuta	Verb
joner	Noun
hejdades	Verb
generellt	Adjective
revolutionärt	Adjective
lärosätet	Noun
förlorarens	Noun
löstes	Verb
manuset	Noun
entreprenörer	Noun
navets	Noun
årtusenden	Noun
vaktade	Verb
sektors	Noun
letter	Noun
centimetern	Noun
adeptens	Noun
efterfest	Noun
negerboll	Noun
stövlarna	Noun
nyhetsankare	Noun
etikettens	Noun
neurotoxikologins	Noun
toxikologens	Noun
krymplingarnas	Noun
pöl	Noun
sammanslutningar	Noun
kedjebråket	Noun
zloty	Noun
generations	Noun
slaget	Adjective
serverade	Verb
vetenskapligt	Adjective
förtjänat	Converb
lagrådet	Noun
hövdingen	Noun
motorvägs	Noun
parkeringen	Noun
käken	Noun
öres	Noun
försvarsstyrkorna	Noun
cerium	Noun
stjälp	Verb
flagellen	Noun
bageri	Noun
betonats	Converb
recensents	Noun
statuslisten	Noun
kantonerna	Noun
förmögenhetsförvaltnings	Noun
munkens	Noun
artonhundratals	Noun
försäkringskassans	Noun
decenniers	Noun
extremiteters	Noun
samexisterat	Converb
platonskt	Adjective
skördar	Verb
förvaltande	Participle
pilspetsar	Noun
inverterade	Verb
klistret	Noun
transponerande	Participle
tromb	Noun
utsträcktes	Verb
innovativ	Adjective
differential	Noun
vicekonungs	Noun
arrendenas	Noun
högtyska	Noun
växlades	Verb
syntetiserar	Verb
släppas	Verb
förkunnar	Verb
kritikernas	Noun
rutschkana	Noun
inrikesministeriets	Noun
taxis	Noun
släck	Verb
samfundet	Noun
pekaren	Noun
cotangenterna	Noun
interaktionen	Noun
hörande	Noun
värma	Verb
räte	Adjective
vården	Noun
konsumentens	Noun
skämt	Adjective
finansierats	Converb
hån	Noun
bergarts	Noun
tveksamhet	Noun
solande	Participle
spärrat	Converb
ouppräkneligt	Adjective
deltävlingars	Noun
lotsades	Verb
balalajkornas	Noun
kontext	Noun
sjögräsets	Noun
uttryck	Verb
nagellack	Noun
prinsessan	Noun
kokosmjölk	Noun
invandring	Noun
täthet	Noun
fotbollslagets	Noun
systerskap	Noun
ordentlig	Adjective
beduinerna	Noun
skullarnas	Noun
publicering	Noun
eldflugornas	Noun
lagad	Participle
anmälande	Participle
grönska	Noun
förmåddes	Verb
skyddstiders	Noun
passusen	Noun
eskimåernas	Noun
dopfunten	Noun
klichéerna	Noun
bryggd	Adjective
duktigt	Adjective
sommarstugans	Noun
klarinett	Noun
vild	Adjective
yttrandefrihetsgrundlagens	Noun
dravlets	Noun
ripjakts	Noun
stavelserna	Noun
förfinade	Verb
örfilen	Noun
somalierna	Noun
ritat	Converb
marinbiologiske	Adjective
adopterade	Verb
redaktionschefen	Noun
revisionssekreterarna	Noun
tjeckernas	Noun
ansluta	Verb
överlåtit	Converb
stulen	Participle
femtondedelarnas	Noun
lyckosamt	Adjective
rebelliske	Adjective
huvudfrågor	Noun
redigering	Noun
tänk	Verb
akryls	Noun
barrskogar	Noun
blusarna	Noun
flugen	Participle
praktiserats	Converb
försöker	Verb
logistiken	Noun
lysdioden	Noun
offentlighets	Noun
böjt	Adjective
åtalats	Converb
avlägsne	Adjective
solcellen	Noun
uppsättningar	Noun
pilspetsen	Noun
sannolike	Adjective
skidstavar	Noun
gömt	Adjective
krossats	Converb
samordningen	Noun
lydelserna	Noun
esplanadens	Noun
generalinspektörens	Noun
yvigt	Adjective
hjärnhalvan	Noun
luftbubblor	Noun
juristernas	Noun
porer	Noun
pressekreteraren	Noun
planerings	Noun
graverande	Participle
konstitutionsutskottet	Noun
variations	Noun
institutionen	Noun
förlänga	Verb
kemikalier	Noun
koalitionsstyrkors	Noun
justerat	Converb
förföljelse	Noun
eonen	Noun
belgaren	Noun
åldfruarnas	Noun
gnistans	Noun
förvandlats	Converb
rationaliserats	Converb
växthuseffekten	Noun
justeringens	Noun
fegt	Adjective
arkitekturerna	Noun
rutnätet	Noun
utgifter	Noun
vardagsrummet	Noun
dödsdomarnas	Noun
sockertillverkningens	Noun
påfarter	Noun
teskedar	Noun
sammansluter	Verb
kryssrutor	Noun
ramlade	Verb
vabbande	Participle
släpper	Verb
simsnäpporna	Noun
lineär	Adjective
invandringarnas	Noun
riksbankschefer	Noun
invaderades	Verb
startande	Participle
millionen	Noun
onde	Adjective
assistenten	Noun
härledde	Verb
vävarnas	Noun
alfs	Noun
justerar	Verb
kejsarsnittet	Noun
uttryckande	Participle
krypta	Noun
alkor	Noun
nigande	Participle
furor	Noun
ässjan	Noun
dieselmotor	Noun
migrerar	Verb
övlige	Adjective
målets	Noun
utvalde	Verb
skygg	Adjective
kota	Noun
kvarlevorna	Noun
gångbanor	Noun
enhällighet	Noun
återuppbyggas	Verb
hat	Noun
baltisk	Adjective
subventionerad	Participle
kosmonauter	Noun
betytt	Converb
deciliter	Noun
amuletter	Noun
slipades	Verb
skymningen	Noun
näsborren	Noun
baddräktens	Noun
befordrades	Verb
dygnens	Noun
fyrfaldig	Adjective
lämpad	Participle
bestämmelserna	Noun
virrigt	Adjective
kommittés	Noun
pråm	Noun
kissat	Converb
urringningarna	Noun
hangarfartygets	Noun
roterades	Verb
valsedels	Noun
överlevt	Converb
uteslutning	Noun
hydda	Noun
torium	Noun
käre	Adjective
spinnrockar	Noun
valkyriorna	Noun
undervattensbåten	Noun
rotationens	Noun
svärande	Participle
citerades	Verb
bedarrat	Converb
konstituerad	Participle
mogen	Adjective
smyckades	Verb
kohäger	Noun
klonerna	Noun
elpianon	Noun
gendriv	Verb
webbplatsen	Noun
givens	Noun
historisk	Adjective
jämningar	Noun
frysfacket	Noun
köpingars	Noun
utökade	Verb
celebritet	Noun
råttan	Noun
övertalats	Converb
immigranterna	Noun
humorn	Noun
återgivning	Noun
prissumma	Noun
angriparnas	Noun
hyste	Verb
störtade	Verb
reagerande	Participle
unionsrätt	Noun
bomulls	Noun
gränsar	Verb
hängd	Participle
konstitutionerna	Noun
uppställts	Converb
aktualiserats	Converb
bergfinkars	Noun
tingsrätterna	Noun
tunnelbanestation	Noun
utsändas	Verb
skruvkorkarna	Noun
cellulaser	Noun
etsningens	Noun
kantar	Verb
generaliserar	Verb
miffon	Noun
befalla	Verb
löjes	Noun
uppgraderade	Verb
tecknar	Verb
paleontologerna	Noun
hyveln	Noun
etymologin	Noun
animationer	Noun
decilitrar	Noun
uppslagsverket	Noun
ljungelds	Noun
nota	Noun
trycker	Verb
julkalender	Noun
tunnbrödsrulle	Noun
käringars	Noun
automatiserades	Verb
förtryckande	Participle
kompanierna	Noun
ljugit	Converb
producerat	Converb
stimulerande	Participle
enslinjernas	Noun
champagne	Noun
lycklige	Adjective
kvantiteten	Noun
inledde	Verb
hopade	Verb
överväger	Verb
vinrankor	Noun
djurparks	Noun
assessor	Noun
uppvaktar	Verb
missuppfattar	Verb
slovakiskt	Adjective
storskalige	Adjective
diskussionsdeltagarna	Noun
skruvkorken	Noun
lakarnas	Noun
vägledd	Participle
terapeutens	Noun
alternerar	Verb
utsändes	Verb
skruden	Noun
brakylogis	Noun
amurtrasten	Noun
ekvilibrist	Noun
groda	Noun
trafiksäkerhetens	Noun
solvindens	Noun
vilseledde	Verb
hovrättsassessorers	Noun
viten	Noun
israeliskornas	Noun
ädelgasen	Noun
optimistisk	Adjective
beskådande	Participle
cotangents	Noun
röjt	Converb
samarbetade	Verb
exceptionellt	Adjective
privatskolor	Noun
sparrens	Noun
landstingsdirektörerna	Noun
profetian	Noun
uppvaktat	Converb
rapportserie	Noun
fjäderdräkter	Noun
exkluderande	Participle
tjugoniondedels	Noun
vampyrer	Noun
återställaren	Noun
träsnidarens	Noun
vegetarian	Noun
tänks	Verb
bokades	Verb
lundensiskt	Adjective
digitaliserats	Converb
steningen	Noun
stockholmsrimmen	Noun
änklings	Noun
segelbart	Adjective
allsmäktige	Adjective
tunnelbanestationen	Noun
kampanjer	Noun
timma	Noun
sed	Noun
efterfester	Noun
neutrum	Noun
favoriserar	Verb
kosmonaut	Noun
vaktat	Converb
kvävts	Converb
hörsägners	Noun
flodvåg	Noun
yrkesgrupper	Noun
förstärktes	Verb
yrkesutövning	Noun
överförande	Participle
blank	Adjective
åtel	Noun
förlängd	Participle
cisterner	Noun
handelskompanierna	Noun
mikron	Noun
god	Adjective
arbetsmarknadsdepartementens	Noun
aggs	Noun
foror	Noun
rese	Noun
avsätter	Verb
comebacken	Noun
amorterande	Participle
hanblomman	Noun
monologerna	Noun
flygningar	Noun
kombinationsfältets	Noun
koncentrerad	Participle
gåshud	Noun
inbegrep	Verb
smyckat	Converb
smidig	Adjective
skockarna	Noun
fiskes	Noun
fagotten	Noun
tillkännagivandets	Noun
förankrar	Verb
ekonomers	Noun
användarens	Noun
kompenserats	Converb
hessian	Noun
turken	Noun
arslet	Noun
maskinvara	Noun
systemkameras	Noun
maktkampen	Noun
ålderdomens	Noun
uteslut	Verb
vederlades	Verb
försålt	Converb
hats	Noun
tältat	Converb
borttagningen	Noun
rödaktig	Adjective
förverkligat	Converb
grinds	Noun
rasismens	Noun
borne	Adjective
järnsparvar	Noun
kisses	Noun
vattenrutschbanans	Noun
stack	Noun
kortsluts	Verb
hästskon	Noun
nostalgis	Noun
organisterna	Noun
revirets	Noun
mentors	Noun
åkningars	Noun
laddningar	Noun
oordningen	Noun
kiosk	Noun
frigjort	Converb
hydrobiologiskt	Adjective
sarkasmer	Noun
hjort	Noun
femman	Noun
galaxen	Noun
invaderande	Participle
teckenstorlek	Noun
uppnår	Verb
bedömningsgrunds	Noun
dansbanans	Noun
kymriskans	Noun
totalspråksordboks	Noun
croissantens	Noun
mänskan	Noun
konspirationen	Noun
nyårslöfte	Noun
inspelande	Participle
centrerades	Verb
stödlinjens	Noun
laboratorier	Noun
fönsterrutor	Noun
svägerska	Noun
väsendets	Noun
uppkomma	Verb
uppvaktade	Verb
reguladetrin	Noun
platå	Noun
manifestations	Noun
snabbmaten	Noun
barrande	Participle
kasusen	Noun
nödvärnet	Noun
fantomerna	Noun
pilgrimernas	Noun
regisserad	Participle
verksamhetsområde	Noun
vidskepelsen	Noun
baserats	Converb
arkiverar	Verb
upphovsrätts	Noun
återfinnande	Participle
blanke	Adjective
ramavtalets	Noun
funkade	Verb
eutanasi	Noun
höjt	Converb
automorfi	Noun
migrerade	Verb
återuppbyggde	Verb
regionens	Noun
munskänken	Noun
kotorna	Noun
provinsens	Noun
mångfasetterat	Adjective
mentorerna	Noun
noshörning	Noun
smältpunkt	Noun
återstående	Participle
tynga	Verb
skärps	Noun
piruetternas	Noun
himlakropps	Noun
skattar	Verb
rektorsämbetets	Noun
vektorernas	Noun
omformulerade	Verb
erfara	Verb
åtalades	Verb
föregick	Verb
frihandelssammanslutningen	Noun
tåls	Verb
sojamjölks	Noun
rådd	Participle
skolkamraten	Noun
teckenigenkänning	Noun
lokaliserade	Verb
kontring	Noun
värk	Verb
kompenserar	Verb
rättaren	Noun
vinterdäcket	Noun
teckenstorleken	Noun
förfäktades	Verb
ödeläggas	Verb
sarkofagen	Noun
tacksamt	Adjective
karparnas	Noun
smale	Adjective
sömmar	Noun
arge	Adjective
nostalgi	Noun
soluret	Noun
lämpat	Converb
samarbetsområdena	Noun
filar	Verb
spionerade	Verb
celebriteten	Noun
artige	Adjective
tvistefråga	Noun
oljeutsläppet	Noun
vålds	Noun
dvärgplaneter	Noun
inkorporerar	Verb
årsboks	Noun
uppfödarna	Noun
amerikansk	Adjective
käglor	Noun
kväver	Verb
bakat	Adjective
knopen	Noun
armhålan	Noun
regeringsstyrkor	Noun
kalendariernas	Noun
gotlänningen	Noun
lutheranerna	Noun
statschefer	Noun
återställningen	Noun
profetiorna	Noun
tålig	Adjective
dirigerande	Participle
traktor	Noun
nedbrytningen	Noun
betänkanden	Noun
bemötande	Participle
ystad	Participle
tvistade	Verb
proportionellt	Adjective
parenteserna	Noun
apostlars	Noun
motsatsförhållande	Noun
samhällsvetenskapens	Noun
eget	Adjective
aluminiumfolien	Noun
infiltrerats	Converb
vinkelhastigheten	Noun
kreativitet	Noun
surrar	Verb
stjärtpennor	Noun
kandidaten	Noun
dansades	Verb
asparagin	Noun
kvarkarnas	Noun
rullatorernas	Noun
ledamoten	Noun
arméerna	Noun
abessinsk	Adjective
operatorer	Noun
korrigerats	Converb
hemvärns	Noun
ländkotorna	Noun
fälgarnas	Noun
pantrarna	Noun
träffad	Participle
ecuadorianska	Noun
protesterades	Verb
minoriteternas	Noun
signalerande	Participle
utbrista	Verb
skärmdumpen	Noun
pionjär	Noun
hexagonal	Adjective
israeliskors	Noun
lindrades	Verb
biblar	Noun
strålarna	Noun
jonglör	Noun
sköldpaddornas	Noun
yttrandefrihetsgrundlagar	Noun
modifierande	Participle
collier	Noun
kraftnätet	Noun
skickelse	Noun
biodlaren	Noun
bevakande	Participle
besticken	Noun
färöiskorna	Noun
illern	Noun
tokornas	Noun
slickade	Verb
slaktades	Verb
fagert	Adjective
uvs	Noun
exportvaran	Noun
urinens	Noun
dödlig	Adjective
handläggas	Verb
fruktämnen	Noun
betecknades	Verb
gnista	Noun
egendomlig	Adjective
nikotinet	Noun
ryskorna	Noun
anarkistiskt	Adjective
ackumulatorns	Noun
brasilianen	Noun
förfara	Verb
underbarnet	Noun
sändes	Verb
studsat	Converb
energifråga	Noun
sitta	Verb
bykens	Noun
infernos	Noun
landgången	Noun
evangelisterna	Noun
tjäderns	Noun
fordrande	Participle
årtusende	Noun
sommarstugorna	Noun
styrning	Noun
uppgraderad	Participle
spillkråkan	Noun
klockslaget	Noun
substratet	Noun
antikvitets	Noun
torterat	Converb
rostade	Verb
lantbruksskola	Noun
svimmade	Verb
buken	Noun
entledigar	Verb
införas	Verb
orienterad	Participle
ammoniakens	Noun
tömde	Verb
förfärlige	Adjective
hävdat	Converb
kombinationernas	Noun
suddgummins	Noun
misstrodd	Participle
mikrovågsugn	Noun
tecknat	Converb
funktionsnedsättningarna	Noun
patriarkerna	Noun
adjunkt	Noun
blusen	Noun
femtiondedelen	Noun
institutionellt	Adjective
försämring	Noun
neutraliserad	Participle
behövdes	Verb
tvivelaktigt	Adjective
redigerande	Participle
markstyrkor	Noun
panter	Noun
teoretiskt	Adjective
handleddes	Verb
pagod	Noun
broschers	Noun
lotsade	Verb
mycken	Adjective
tordes	Verb
djursjukhuset	Noun
illrarna	Noun
överskred	Verb
könskromosomerna	Noun
kvicknad	Participle
härlett	Converb
minimerades	Verb
oskyldige	Adjective
kvällstidningens	Noun
Laplacetransform	Noun
pilat	Converb
maggördelns	Noun
näthatets	Noun
monarks	Noun
täthets	Noun
varierat	Converb
skulderblad	Noun
skärmytsling	Noun
vittnenas	Noun
breddgraderna	Noun
uppställde	Verb
fladdrar	Verb
engagerats	Converb
vinkade	Verb
samhällsområdens	Noun
kirrats	Converb
entitan	Noun
delikatesser	Noun
livegen	Adjective
följ	Verb
rehabiliterande	Participle
östgötska	Noun
pittens	Noun
algebror	Noun
angripne	Adjective
örts	Noun
betecknar	Verb
trippelpunkt	Noun
refererar	Verb
mäter	Verb
stiftad	Participle
tinats	Converb
tarms	Noun
stolthet	Noun
flygrutter	Noun
luftmassor	Noun
keltisk	Adjective
mungigas	Noun
gjorthål	Converb
ormbunke	Noun
närtids	Noun
lagstiftad	Participle
domprostar	Noun
katedralskola	Noun
konteramiralen	Noun
enhjuling	Noun
nationalsångs	Noun
dokumentmallen	Noun
krusbärens	Noun
sydpol	Noun
maktkamperna	Noun
smeknamnen	Noun
pudel	Noun
trollkarl	Noun
arbetsmarknadsdepartementet	Noun
stämplat	Converb
stridsvagnarna	Noun
totalspråksordboken	Noun
rådhusrätters	Noun
mekaniskt	Adjective
deniers	Noun
aspen	Noun
tjugofemöringens	Noun
vaskar	Verb
islänningar	Noun
ekvationerna	Noun
vattenrutschkanorna	Noun
smedernas	Noun
jämlikhet	Noun
mineralvattnets	Noun
simuleringen	Noun
tecknande	Participle
förmedlande	Participle
ödekyrkors	Noun
tillsätter	Verb
begreppsklasser	Noun
kurslitteratur	Noun
etablerades	Verb
kartografins	Noun
förpliktelser	Noun
rapporterades	Verb
specialstyrkan	Noun
beväpnades	Verb
agronom	Noun
kamerans	Noun
mellanrummen	Noun
spränger	Verb
antänder	Verb
uppgått	Converb
lydelsen	Noun
gnagaren	Noun
allordboken	Noun
förseglar	Verb
Taylorseriers	Noun
höjer	Verb
älskvärd	Adjective
institutionernas	Noun
enades	Verb
rusttjänst	Noun
hemländer	Noun
munkorgars	Noun
miffonas	Noun
generalkonsul	Noun
hindrar	Verb
sinnebilder	Noun
segelfartygen	Noun
kategoriserat	Converb
stacks	Noun
redigeringsläget	Noun
tillade	Verb
landades	Verb
konstapels	Noun
barmen	Noun
jakade	Verb
varierad	Participle
brottningen	Noun
oscillation	Noun
pulvret	Noun
engelskor	Noun
vänja	Verb
vurmande	Participle
stjärtfenan	Noun
artärens	Noun
bagar	Noun
transaktionernas	Noun
naturskyddet	Noun
trettiondels	Noun
hårdföre	Adjective
kastanjs	Noun
globaliserade	Verb
minkarna	Noun
kroater	Noun
nationalist	Noun
förstod	Verb
brorsdotter	Noun
mammutarna	Noun
solcell	Noun
justitiedepartementen	Noun
kolaren	Noun
svenskhet	Noun
svepa	Verb
glykols	Noun
godsakerna	Noun
departementschefen	Noun
Riemannytans	Noun
administrativt	Adjective
jordmassorna	Noun
blåhake	Noun
farlige	Adjective
konkurrerat	Converb
styrutrustning	Noun
radianer	Noun
sultanatet	Noun
tetraedern	Noun
knäckas	Verb
prestige	Noun
handflata	Noun
konjunktionen	Noun
avskrivet	Adjective
överträdelser	Noun
böjde	Adjective
civilist	Noun
kronologins	Noun
sonades	Verb
fraktioner	Noun
gudinnornas	Noun
kommittéer	Noun
fiskmåsens	Noun
artefakten	Noun
snöboll	Noun
penning	Noun
förstöra	Verb
marginal	Noun
stugorna	Noun
utsaga	Noun
sordinernas	Noun
omfattningen	Noun
björntjänst	Noun
efemäre	Adjective
livsmedelsbutikerna	Noun
munkar	Noun
tornfalkar	Noun
ten	Noun
jordsvinet	Noun
sorterades	Verb
framhölls	Verb
informerade	Verb
acceleration	Noun
fattigdomens	Noun
åklagarna	Noun
egennamnets	Noun
dioderna	Noun
fjättrades	Verb
framställdes	Verb
delstater	Noun
asiaten	Noun
brynen	Noun
artbestämma	Verb
arrogante	Adjective
korrelations	Noun
övertalat	Converb
elevhem	Noun
sutten	Participle
livvakts	Noun
begravningsplatsens	Noun
undkommit	Converb
militärsakkunnig	Noun
elektromagneten	Noun
miljöteknik	Noun
citerats	Converb
tarmar	Noun
kommunalrådet	Noun
frekvenserna	Noun
butan	Noun
genmäle	Noun
utbjudits	Converb
justitieutskottet	Noun
återvändsgränder	Noun
avlatskrämarna	Noun
förutsatts	Converb
växandet	Noun
företräder	Verb
startar	Verb
trombonister	Noun
högljudd	Adjective
törstige	Adjective
tilltro	Noun
vattenplaning	Noun
kunglige	Adjective
befästa	Verb
enhörning	Noun
ambassadens	Noun
investerat	Converb
benämningen	Noun
syrianskas	Noun
individualiserad	Participle
ekonomin	Noun
förarbetets	Noun
administrerats	Converb
nollställningen	Noun
evangelister	Noun
björntjänsters	Noun
motorcyklarna	Noun
bemannades	Verb
genvägs	Noun
exponentens	Noun
dressyr	Noun
butiksbiträdet	Noun
hårde	Adjective
radioapparaterna	Noun
elektrikern	Noun
extremism	Noun
slitet	Noun
politikområde	Noun
pilgrimsfärds	Noun
bekräftande	Participle
sårad	Participle
bridges	Noun
kuskens	Noun
rusttjänsters	Noun
daggkåpor	Noun
fostermodern	Noun
kartläggs	Verb
fängelsehålor	Noun
konvojens	Noun
bildsidor	Noun
humors	Noun
stylisternas	Noun
förlåten	Participle
brorsons	Noun
barmhärtigheten	Noun
autografens	Noun
fäktningen	Noun
arabiskt	Adjective
agar	Noun
generaldirektör	Noun
samvetets	Noun
såpopera	Noun
fordrat	Converb
påbjöd	Verb
kristen	Adjective
vildkatten	Noun
samban	Noun
femöring	Noun
klets	Noun
styrningar	Noun
konjugationerna	Noun
byttan	Noun
kvartsfinalerna	Noun
förmörkelse	Noun
rejäl	Adjective
århundradenas	Noun
funktionell	Adjective
flamma	Noun
kronvittnets	Noun
perfektionen	Noun
infogande	Participle
förmannen	Noun
ökar	Verb
fastnat	Converb
arean	Noun
fettsyra	Noun
folkbildningen	Noun
försäljningssiffror	Noun
skylla	Verb
turnerar	Verb
förebyggdes	Verb
burkan	Noun
ishockeys	Noun
överklagat	Converb
nationalisten	Noun
tvättbjörnens	Noun
stötas	Verb
konstarten	Noun
polackerna	Noun
monologers	Noun
fryspunkternas	Noun
statsmannens	Noun
civilt	Adjective
yrkesutbildningen	Noun
arbetslöshetskassans	Noun
födelsedagsfest	Noun
förkylningens	Noun
råvarorna	Noun
radian	Noun
gondol	Noun
julklapparna	Noun
debatterande	Participle
besvärlig	Adjective
marknadsförde	Verb
gloriorna	Noun
rymderna	Noun
sen	Adjective
måttbandet	Noun
premiärministern	Noun
erotik	Noun
kulturdepartementet	Noun
mantel	Noun
pungdjurens	Noun
klasen	Noun
riskbedömning	Noun
kryddnejlikans	Noun
trippelpunkter	Noun
svindeln	Noun
säkerhetsbälte	Noun
exportvarorna	Noun
kompakte	Adjective
alkemisten	Noun
axelmakternas	Noun
mambon	Noun
vägledningen	Noun
anställdes	Verb
armbågsbenet	Noun
polisiär	Adjective
assimilerar	Verb
katedraler	Noun
döende	Participle
barnvagnen	Noun
vaggsångerna	Noun
klaffarna	Noun
mobiliserade	Verb
rapporterar	Verb
slev	Noun
byggena	Noun
oskadliggörs	Verb
country	Noun
avskriva	Verb
hänvisat	Converb
tillbad	Verb
platåer	Noun
terapeuternas	Noun
borsyra	Noun
åls	Noun
essä	Noun
negrer	Noun
roades	Verb
purjolöken	Noun
croissants	Noun
fjäderdräkt	Noun
bijektions	Noun
fornfranska	Noun
fritiden	Noun
mjuk	Adjective
rund	Adjective
kursiverade	Verb
republik	Noun
rikskronofogdarnas	Noun
åtelkameras	Noun
promiskuös	Adjective
kultursidorna	Noun
lämpade	Verb
vederstygglige	Adjective
pandemis	Noun
efterrätten	Noun
erfor	Verb
skyllt	Converb
marxismen	Noun
konsumerades	Verb
aktiebolagets	Noun
karakteristiske	Adjective
länders	Noun
gepardens	Noun
stimulerat	Converb
antropologins	Noun
hajker	Noun
tyristorer	Noun
moppe	Noun
retroaktiv	Adjective
grapefrukt	Noun
tvillingens	Noun
räder	Noun
cytostatika	Noun
rättfärdigats	Converb
närkingska	Noun
assisternas	Noun
ljuden	Participle
blockadernas	Noun
syftande	Participle
utgift	Noun
förpliktelse	Noun
kärnkraftverkets	Noun
guvernörs	Noun
värdinnor	Noun
skyhöge	Adjective
nittondel	Noun
satte	Adjective
förtvivlat	Converb
spekulerade	Verb
härledningars	Noun
stressat	Converb
musköten	Noun
institutens	Noun
baracken	Noun
överraskat	Converb
diskborste	Noun
ergonomi	Noun
vokalernas	Noun
skadeutfallets	Noun
behå	Noun
tornugglas	Noun
distribuerats	Converb
kreaturspremieringens	Noun
neutronen	Noun
konstaterade	Verb
krymptes	Verb
fullmäktigt	Adjective
polismyndighetens	Noun
charmör	Noun
arbetsområden	Noun
populariteten	Noun
lutfiskarnas	Noun
mobiliseringen	Noun
frysar	Noun
fågelskrämma	Noun
konsulterar	Verb
ekolali	Noun
förhandlande	Participle
kompensationens	Noun
uppnådde	Verb
kemiskt	Adjective
biblisk	Adjective
högskoleadjunkter	Noun
bevisades	Verb
fullföljt	Converb
aldehydens	Noun
proffsligorna	Noun
resonerande	Participle
lärka	Noun
diskursen	Noun
billig	Adjective
brottar	Verb
ofarlig	Adjective
ackuschörer	Noun
noterade	Verb
nylonstrumpor	Noun
elegi	Noun
akustiken	Noun
vårdar	Verb
specialtecknen	Noun
jordbrukskommittén	Noun
passerat	Converb
seansen	Noun
sysselsattes	Verb
stockar	Noun
riksledningen	Noun
talat	Converb
nymålad	Adjective
guvernörens	Noun
lönnmördades	Verb
korsförhören	Noun
kvalitetssäkring	Noun
frånvaro	Noun
hytterna	Noun
lyrikens	Noun
monarki	Noun
klorid	Noun
ekologers	Noun
förklädet	Noun
fjärrkontroll	Noun
undrar	Verb
gastarnas	Noun
koloniserat	Converb
stränginstrumentens	Noun
förkämpen	Noun
nye	Adjective
skrek	Verb
gynnande	Participle
förläggs	Verb
triangels	Noun
resegarantiers	Noun
levar	Noun
sälja	Verb
trollkonans	Noun
föreligga	Verb
indexet	Noun
tjatar	Verb
köar	Verb
dunges	Noun
reformerat	Converb
folkvisans	Noun
hormon	Noun
deklinationerna	Noun
hypotenusors	Noun
paradoxalt	Adjective
gudmoders	Noun
uttagningens	Noun
trastar	Noun
uppfylla	Verb
berikar	Verb
rodnande	Participle
distansminut	Noun
cypriotiskas	Noun
tvivlar	Verb
brylling	Noun
skärmbilders	Noun
gasbindors	Noun
manipulerades	Verb
fiske	Noun
tingsfiskalens	Noun
reklamerar	Verb
växelkursen	Noun
instämmer	Verb
sabeln	Noun
riksarkivariers	Noun
oktanten	Noun
axiomets	Noun
privatbanor	Noun
beståndet	Noun
tråkig	Adjective
egenfunktionens	Noun
ordklasserna	Noun
tuppar	Noun
zenerdioder	Noun
svartskalles	Noun
stenade	Verb
utövningens	Noun
egoisms	Noun
aras	Noun
lödde	Verb
kittlande	Participle
underminerades	Verb
polacker	Noun
matstrupe	Noun
evinnerligt	Adjective
tålde	Verb
gräsanden	Noun
gröngöling	Noun
ämnades	Verb
statsåklagaren	Noun
inflöden	Noun
retirerat	Converb
privatlivet	Noun
kvadrat	Noun
klokt	Adjective
gelén	Noun
chassidismen	Noun
klottret	Noun
retronymens	Noun
folkbibliotekens	Noun
rekommenderar	Verb
linjärkombinationerna	Noun
gäckade	Verb
skeppande	Participle
korsfästning	Noun
kakao	Noun
landshövdings	Noun
kulspetspennan	Noun
euros	Noun
beklagat	Converb
babian	Noun
bankkontots	Noun
