սեռին	None
բանտարկություններս	None
կառաքեմ	Future
դուզ	None
կհարնչեմ	Future
չկանխամտածենք	Future
տարածի	Future
հարսնացներ	Future
ապահովել	None
կաղկանձեցիք	Past
չկարօտեցիր	Past
աբստրակտներիցս	None
փրփրես	Future
սիրվել	None
հպարտանայիք	Future
կմեկնեն	Future
փուլին	None
փախստականների	None
կտենամ	Future
չզգենա	Future
ճանապարհորդի	Future
կնճիթը	None
ներքինացրինք	Past
չհամենային	Future
խորհրդանշեր	Future
ոխանար	Future
դիսկոտեկի	None
կխրոխտանայիր	Future
մատուցեիր	Future
կգիշատեն	Future
ուզենար	Future
կլողանայիր	Future
քշեն	Future
ստորագրությամբդ	None
հանքին	None
եփեն	Future
մուրայի	Future
պարարտներովս	None
կոտրեն	Future
կփայփայեիք	Future
մագման	None
տեղեկատվություններ	None
ընտրվեին	Future
կփռշտայինք	Future
մալեք	Future
հյուսիսի	None
աքսորանքում	None
պանին	None
բորբոքեց	Past
ծաղրով	None
շփագիտականիս	None
ստում	None
արտադրությունում	None
գանգրացվեի	Future
բտեն	Future
ձվաբջջին	None
չվերուվարեցիք	Past
հարձակում	None
ճաշին	None
կուզենամ	Future
չսարսափեիք	Future
հիմնադրամներ	None
չթաքչեմ	Future
շանսոնյե	None
աստվածաբանության	None
կարտագաղթի	Future
կհագնեիր	Future
հղիանան	Future
շնչեց	Past
մատչ	Past
մոլորվենք	Future
հատակի	Future
զգենայիր	Future
կմայեիր	Future
արաբերենին	None
քերած	None
գադոլինիումը	None
թանաք	Future
չգուրար	Future
լեռնագնացի	None
չզննեցի	Past
կտանջենք	Future
արբ	Past
չսաղացա	Past
կօգտագործեմ	Future
զրույցներից	None
չսնգուրեք	Future
չպահպանի	Future
որոճաս	Future
բզզաք	Future
չհորանջի	Future
կոշկակարի	None
չուժեղացար	Past
ունկնդրի	Future
հալեցիր	Past
չդատարկեն	Future
չբղավեցիր	Past
կարգահատեիր	Future
մեղքերում	None
ֆիլիպինյան	None
գեղջուկովս	None
այրվեցինք	Past
գանգրացվեին	Future
չլափեինք	Future
այցելեիք	Future
կտցարներ	None
անդամը	None
մղեց	Past
կոգեն	Future
չվարեցինք	Past
պղծեի	Future
ենիչարով	None
չտռեցիր	Past
համերգասրահը	None
ուսաներ	Future
կստամբակեիր	Future
լոգանայիք	Future
ակադեմիան	None
ձողերը	None
չշարժվեցին	Past
չզեղծեցիր	Past
կառերեսվեր	Future
փորձենք	Future
հրեշների	None
գարեջուրը	None
օսմանցիները	None
կամայանաք	Future
չառաքեիք	Future
ազդեց	Past
չվերադառնա	Future
կզարմանայինք	Future
ածանցեցիր	Past
բաղձանքները	None
գարնանային	None
ճաքեին	Future
սամսար	None
ուղեկցեցի	Past
շարժվեիր	Future
օսլա	None
կկիսեք	Future
հեծյալի	None
կշփոթեիր	Future
չփռթկացրեց	Past
կոռուպցիայի	None
կմոտեցնեի	Future
չճանապարհորդեն	Future
շտկեց	Past
չաղատեցին	Past
չհարեր	Future
ժողովածու	None
առաջադիմի	Future
կներքինանան	Future
կապացուցվեի	Future
մյուռոնը	None
կրակեք	Future
գնչեք	Future
չավելացնես	Future
չթոթովես	Future
չհմայեինք	Future
չհուռթանային	Future
տողերը	None
չմոլեմ	Future
կսրտառի	Future
կնպաստի	Future
ուսումնասիրեք	Future
կկարօտեն	Future
հանդեսից	None
ցածրից	None
կաբստրահվես	Future
հեռացնեն	Future
ուզեիր	Future
կդրսեւորվես	Future
չընթանայինք	Future
կխածնեի	Future
այցելեցին	Past
թաղել	None
կհառնենք	Future
քանակները	None
հրեն	Future
ուղարկում	None
շշնջան	Future
ամորձատեիր	Future
ուզենաս	Future
չկիրառվեց	Past
չհրճվեց	Past
փողոտ	Past
բարելավեց	Past
կագրեգատավորեք	Future
չդարբնեմ	Future
մժեղները	None
չհոշոտեն	Future
չվճռեցին	Past
համբավին	None
օրակարգ	None
կիրճը	None
սառնամանիքներ	None
սանրվեր	Future
փորձին	None
վան	Past
փութար	Future
սորա	Future
վճար	Past
տունդրայում	None
չշռեց	Past
դալուկ	None
կկոտրեիք	Future
լրտեսի	Future
երկրաբանությունը	None
կուսումնասիրեիր	Future
թուլիումներս	None
չդարբնեցինք	Past
ավանդությունների	None
հաստատունին	None
հոտոտեմ	Future
չագռավանայիք	Future
կրպակներում	None
չհարսնանայիր	Future
չհյուսեցինք	Past
չոգեշնչեիր	Future
անհատ	None
բոշաների	None
կվանկարկեն	Future
կշտապեն	Future
տաղտկանա	Future
ուժեղի	None
փչեիք	Future
չհագնվեի	Future
գոռայի	Future
ձախողակիդ	None
չմատչեն	Future
ապահովացնեիք	Future
աքսորեց	Past
նիզակի	None
հայտներ	Future
փայփայես	Future
չհպատակվենք	Future
ձիթենի	None
թշիդ	None
գանգրացնեիր	Future
ճոճանակ	None
արդյունաբերությունից	None
չխնչեիր	Future
կճմռեր	Future
կմարթեիք	Future
կեղեցիք	Past
արկանեի	Future
ծպտեցին	Past
ժողովածուները	None
գրգռեն	Future
չհաստատեց	Past
կմոլեմ	Future
չծափահարեցիք	Past
փռշտայիք	Future
չսարսափեինք	Future
բացվածքը	None
փախցնելու	None
չնախանձենք	Future
թաքցնեն	Future
կփնտրեք	Future
մահմեդականների	None
տարամիտեի	Future
կծլես	Future
չտանջեիր	Future
չզանգեիք	Future
քննարկենք	Future
կողպեք	Future
չնեղանային	Future
կընդգծեր	Future
ընդարմանայիք	Future
քիմիա	None
վիթը	None
խոռոչով	None
կաղարտեիր	Future
հատկացրիք	Past
չզգեցա	Past
այտուց	None
կձգտի	Future
պատկերենք	Future
ընթանա	Future
չտուժվեցի	Past
կուզի	Future
կխնչեիք	Future
տանուտերը	None
կաքսորվեք	Future
թատրոնները	None
ուղարկեր	Future
ծղոտը	None
տոռներ	None
արձագանքեց	Past
բացականչեինք	Future
կինոներ	None
աբսորբեցիք	Past
հանդուգն	None
կազմակերպիչների	None
ընկղմեին	Future
փոխվարչապետ	None
մատչեիր	Future
հասարակում	None
կայսրությունների	None
կակալներս	None
մեղադրի	Future
նեղանա	Future
ցտեցիք	Past
կանչեցին	Past
հեղաշրջումներ	None
ցուցանի	Future
ունկնդրեն	Future
քշեին	Future
հանգեն	Future
կհամարենք	Future
տիկնիկի	None
մեդալներին	None
չկարօտէի	Future
կնքեն	Future
կմալեիր	Future
զանգեր	Future
կկռնչայինք	Future
հայտնեցի	Past
խոչընդոտներումդ	None
կխոչընդոտեմ	Future
հրճվես	Future
չփայլունացվենք	Future
ուսանեց	Past
չքարոզեցիր	Past
կագահանամ	Future
քայլել	None
տեւեցին	Past
զոդ	Past
մատուցեց	Past
իմաստուններ	None
բալետներով	None
ճանապարհ	None
շնչեցի	Past
կառչեցի	Past
վերարտադրությանը	None
կկտղեիր	Future
հեռախոսից	None
հեռացնեիր	Future
մակեդոնացիների	None
տահիտի	None
չբնութագրեք	Future
ժամանակաշրջան	None
պատրաստեցին	Past
կոգուդ	None
նոճին	None
շեշտ	Past
ուռեր	Future
բաղաձայններով	None
չճամփեն	Future
տուժեց	Past
չխոպոպացվեինք	Future
կկճես	Future
հավելեինք	Future
պոլկա	None
կսպրդի	Future
խրթեի	Future
կծպտվեմ	Future
արբենար	Future
չհարնչեցին	Past
չուզեցան	Past
վերադարձի	None
բուտումդ	None
ջրամբարում	None
կակտուս	None
բացականչեին	Future
ամուսնությունում	None
համակարգեմ	Future
ստորագրեց	Past
բժիշկների	None
լրջացաք	Past
կնազենք	Future
աջակցես	Future
չմոլեցի	Past
ներգաղթեցիր	Past
շփագիտականներով	None
փոր	Past
ոսպնյակներից	None
վերծանես	Future
տեղեկացնի	Future
շինականովս	None
երկայնացանք	Past
կսանձահարեմ	Future
կհամակարգեն	Future
հրավերներ	None
տկռեմ	Future
մտցնի	Future
վավերագրական	None
չափեց	Past
ավանդի	Future
քայլելիս	None
չտռզեինք	Future
կտառադարձեիք	Future
ազդեր	Future
արածեցնի	Future
հավակնորդիցս	None
մղձկաս	Future
անկան	Past
կտոկար	Future
չագուցավորես	Future
կգթամ	Future
չփայլատակեցին	Past
ողողվում	None
ապացուցվի	Future
կհեծնեի	Future
չտնօրինես	Future
չանցգայացանք	Past
փչի	Future
հարգ	Past
կփտեինք	Future
արագիլ	None
ընդգծեց	Past
քայլ	Past
կխանդի	Future
զղջան	Future
չբզզանք	Future
ծնող	None
կզեռայինք	Future
սայլեր	None
չպագեի	Future
հափափեցինք	Past
կհպատակվեր	Future
պոռոտաբանեցինք	Past
թակարդների	None
չաբսորբեցիք	Past
նիշերդ	None
ուղարկեք	Future
կարտագաղթեիր	Future
զանգի	Future
կասկածի	Future
չբաղբաջեցին	Past
թատրոններին	None
զղջայիք	Future
կհատնենք	Future
նիդերլանդականներիցս	None
կշառաչեին	Future
կռթնենք	Future
չափեցի	Past
տրամաչափեր	None
քննարկող	None
պատկերասրահի	None
չխարխալեինք	Future
թլվատեցինք	Past
քիմիականներով	None
չշտապեցինք	Past
հար	Past
գրույթ	None
պայմանավորեցին	Past
չքելեցի	Past
չհելնեիր	Future
հանվեց	Past
չհոգայի	Future
ֆիզիկա	None
ենթարկեցին	Past
կհերքի	Future
գորովեր	Future
կտռզեինք	Future
շիթերիդ	None
կթոտեմ	Future
վիրաբուժությունը	None
տարածեց	Past
կմահանար	Future
կստրկացնի	Future
բնութագրում	None
կգանգրացնեին	Future
պահպաներ	Future
կենդանակերպիս	None
առնետը	None
կհերքվեինք	Future
պիրոլների	None
զարմանա	Future
բխենք	Future
չսովորեի	Future
բացատրենք	Future
կարեկցանքի	None
չհմայեիր	Future
կարեցա	Past
չբարձեցինք	Past
քվարկը	None
ընթանար	Future
չխնչեն	Future
միանար	Future
կմոլեգնի	Future
չկազմակերպի	Future
չհայթայթեն	Future
հայերը	None
կճշգրտեր	Future
ընդգծեցին	Past
մակամորձուցդ	None
կխուզեիք	Future
ուզեցար	Past
նվագելիս	None
բաջաղես	Future
կողմը	None
շրջվ	Past
կբաղբանջենք	Future
անզգայացվեմ	Future
կմարթի	Future
ապահովանանք	Future
շաչեցիք	Past
սիրահար	None
չնեղանամ	Future
ջղայնացան	Past
կլուծենք	Future
չխածնեցիր	Past
մոգոնեցիք	Past
փոթի	None
կերկկտտացնեիք	Future
չծածկեին	Future
վզիկից	None
չսլացան	Past
չլրտեսեցինք	Past
կեսօրվա	None
չքծնեինք	Future
կզաքիսը	None
ամպից	None
կախարդի	Future
չգնահատեցիք	Past
չփողոտեք	Future
չմատուցեին	Future
չսիկտիրվենք	Future
պայմանավորվեցին	Past
կիրճերից	None
սուսերամարտիկներ	None
ծնվեցին	Past
սառեց	Past
երեց	None
նահատակի	None
չմօտեցանք	Past
չմոռացավ	Past
ծածան	Past
կհորանջեին	Future
ճոպանները	None
պապանձվեց	Past
հանձնեցին	Past
կլվացվի	Future
դայլայլենք	Future
չբեկանեինք	Future
կտարվեիք	Future
խոր	None
ուղեկցեմ	Future
տառադարձեր	Future
հասկացաք	Past
չօթեին	Future
կազմակերպեցին	Past
չհամբուրեք	Future
գով	Past
զտի	Future
վանեիք	Future
չբաղբանջեցիք	Past
կհայտարարեիք	Future
չկիզեիք	Future
ատի	Future
նպաստեն	Future
կերթայիք	Future
դարպասապահներ	None
կաղատի	Future
կխածատեին	Future
տարվեցիք	Past
համարեցին	Past
երկբայանար	Future
ներգաղթեցինք	Past
չօղողեիք	Future
տուժող	None
զուրից	None
շփոթվեն	Future
չհարկանեցիր	Past
չբնակվեց	Past
բառնայիք	Future
ածանցներով	None
չհնացա	Past
կընդոստեք	Future
վառվեինք	Future
չքննեք	Future
աճեցնեն	Future
վերագրեինք	Future
չհոխորտամ	Future
ցանկանամ	Future
մրցակցին	None
կփորձեն	Future
ուզեր	Future
չամորձատեն	Future
լիացան	Past
չնպաստի	Future
չզննեց	Past
չկարծեին	Future
ագահանամ	Future
չբացականչեցին	Past
ծածկ	Past
կեսօրը	None
չհատկացնեմ	Future
խուզող	None
չհալածեմ	Future
հպարտանայիր	Future
անասնաբույժով	None
կարողացանք	Past
չվիճաբանես	Future
թարգմանեցիք	Past
չարորեր	Future
հայտնին	None
պրոտոն	None
կծլարձակեր	Future
պարապ	Past
փորեին	Future
չհմայեք	Future
չթրմեցին	Past
չգնեցի	Past
չմտադրվեցինք	Past
հացահատիկը	None
հաճախեց	Past
կտուժվեիր	Future
կգանգրվես	Future
ներբեռնի	Future
կհրճվեն	Future
չսովորեիր	Future
ախտորոշեմ	Future
չկթոտեիք	Future
վերադարձներ	None
բուժումները	None
նավ	Past
փռթկացրեց	Past
կկռկռայիր	Future
վանկարկեն	Future
կգանգրացվես	Future
ընդարմանա	Future
կուրսերը	None
կնքեցինք	Past
ստեղն	None
չշաչեցի	Past
կհափափեն	Future
խմբագրի	Future
կեղի	Future
շաքարավազի	None
ձախողին	None
փսխեցին	Past
չխմբագրեինք	Future
կտառապեիք	Future
կազմակերպենք	Future
ծաղր	Past
վայելեիր	Future
չարածեի	Future
բողոքեցին	Past
կքամեք	Future
աբստրահվես	Future
կշռադատեմ	Future
կմնչեք	Future
չհրամայեմ	Future
վայելեի	Future
լողացանք	Past
կխրախուսես	Future
արիությունդ	None
խանձեք	Future
վճիռների	None
ճեմեցիր	Past
խածատենք	Future
տարածքում	None
պահակիցդ	None
կօգտագործի	Future
մեծանաս	Future
հիմնադրամներին	None
ավելացնեիր	Future
անիվ	None
կդարբնեք	Future
խեթա	Future
կոտորներիդ	None
քառյակները	None
չփչանաս	Future
գրադարձեինք	Future
որսորդ	None
ջանայիր	Future
հպատակվեն	Future
չսանձահարեք	Future
չխթեցին	Past
խոպոպվեինք	Future
կկատակեին	Future
չբուսնեք	Future
ոլորապտույտ	None
չալեկոծեց	Past
խազեր	Future
կխմի	Future
չփնտրեիր	Future
հեռեի	Future
մարզադաշտեր	None
սոված	None
չշփոթեն	Future
կատի	Future
նորը	None
չսայթաքեցի	Past
բաժանվի	Future
վարագույրից	None
տեքստի	None
ջեբով	None
կրակ	Past
քայլեց	Past
բզզայիր	Future
ճմլեն	Future
նեխեցինք	Past
գյուտարարին	None
հորջորջ	Past
չշիջուցանեին	Future
չապշի	Future
կթարթեք	Future
չըղձանք	Future
կեպերեն	Future
անզգայանար	Future
մրցեին	Future
կիրառեն	Future
սպանեցին	Past
վերադարձան	Past
պաշտոնակից	None
ազգանուններով	None
կոչին	None
հայտարարումից	None
հառենք	Future
ամորձատեցին	Past
հանվեցին	Past
հիացավ	Past
արորի	Future
մխոցների	None
էտի	Future
նետեց	Past
ֆուտբոլիստ	None
չհպատակվեր	Future
կապացուցեն	Future
հարսնացուներ	None
աֆղաներեն	None
չկիզեին	Future
կխածես	Future
հալածեց	Past
կծուլանայինք	Future
կկատաղեի	Future
հունիսդ	None
կծանուցես	Future
թեփի	None
չճմլեցիր	Past
կկճեմ	Future
արկեցիր	Past
չտաղտկացավ	Past
ստեղծագործություններ	None
փոխանակեցին	Past
ավելացնի	Future
մեկնաբանություններ	None
բավարարեին	Future
կմօտենաս	Future
պաշտամունքների	None
կհայտարարի	Future
չսարսափեիր	Future
չզգածվես	Future
միացնի	Future
չուռթացար	Past
մտադրեցի	Past
նեգրերը	None
ուրացա	Past
գուլպաների	None
չվաներ	Future
մեղադրեն	Future
քաղաքացիությամբ	None
մեգապոլիսի	None
գոյացավ	Past
քանդեք	Future
կործկայիք	Future
այսբերգովս	None
կենգուրուն	None
կաֆե	None
կվերծանես	Future
չխազեին	Future
պաշտ	Past
կայացավ	Past
կկկեն	Future
չհիասթափեցնեին	Future
ֆրանսիացիների	None
պատկանեինք	Future
շատացան	Past
վայրերում	None
տառապեցիր	Past
որորը	None
ծնի	Future
կբաժանվես	Future
իշխանը	None
կճշգրտեինք	Future
համեինք	Future
կբզզային	Future
հասկանան	Future
չկշռադատենք	Future
չախտորոշեիք	Future
խոցեք	Future
շարժվեր	Future
չքարշեին	Future
կծնգցնի	Future
չխառնեին	Future
գլյուոնները	None
ստուգենք	Future
կթոթովեի	Future
չհատեր	Future
կրեինք	Future
կրեն	Future
կբանային	Future
նացիստ	None
կհուսահատեցներ	Future
խանդ	Past
կմխիթարենք	Future
շպրտեց	Past
կբարբառեին	Future
սառնամանիք	None
աղոթեց	Past
փնտրի	Future
խօսէինք	Future
չառաջադիմեցիք	Past
չբողոքեին	Future
փոխհատուցեն	Future
գործարքներում	None
անեկդոտներումդ	None
ֆուտբոլասեր	None
կանգնեին	Future
ցուցանեց	Past
աքսորվեցին	Past
ծածկեց	Past
կհամենային	Future
չհարենք	Future
չափեր	Future
կծանուցեինք	Future
խորան	None
ծոծորակը	None
չսփոփվեի	Future
կործանվել	None
կբարբաջեիք	Future
չհայթայթեք	Future
ամբարտավանեք	Future
ագարականան	Future
կրած	None
կըմպենք	Future
տենար	Future
ոչխարին	None
կսպանենք	Future
համաներման	None
չամայանայիք	Future
խրոխտանանք	Future
մագնիսականություն	None
չհիասթափեցնենք	Future
Ծաղկազարդներումս	None
կհարնչեինք	Future
չթլփատեինք	Future
չուղարկեցիք	Past
հեղինակությանը	None
չմխիթարեիք	Future
չհուսահատվեցիր	Past
Մխիթարի	None
չծնգցնեի	Future
շարունակեցինք	Past
չպարապեք	Future
խլության	None
չբանտարկես	Future
նվագ	Past
շարժվենք	Future
չողբանք	Future
հորանջեք	Future
օթ	Past
մրցես	Future
կլրտեսեիր	Future
գլ	Past
չպաշտած	None
աճեցրին	Past
կհաստես	Future
փտեցիք	Past
արշալույսի	None
մուշից	None
հնացանք	Past
զտեցինք	Past
չհառներ	Future
վռնդեց	Past
կազմակերպած	None
կշփոթվեիք	Future
ըմպեցին	Past
չգերծեմ	Future
պայթեց	Past
կկարողանանք	Future
կրծքանշանը	None
ուսուցանեք	Future
թաքցներ	Future
կարդուկեիք	Future
փոխանակ	Past
կոռնամ	Future
չկալեն	Future
կկայանամ	Future
կսառչի	Future
տեղեկանա	Future
չծլարձակեի	Future
կատարեն	Future
չագռավանան	Future
մեղադրեցին	Past
չհյուծեցիք	Past
ոտանավորներ	None
հաճախած	None
հազալիս	None
չերազեր	Future
խոցեց	Past
առաջարկությունները	None
նպաստեին	Future
երազած	None
չխածնես	Future
չսլացաք	Past
չհղեցան	Past
ծառայել	None
լողափ	None
հառեր	Future
չթովեց	Past
կագուցահանեմ	Future
ապահովեմ	Future
հանգստացավ	Past
չքաղեր	Future
վայել	Past
բողոքարկեինք	Future
մարտնչեր	Future
ցերիումի	None
չօժանդակեցիր	Past
ուղեկցեցին	Past
տեղեկացնեմ	Future
սերմնաժայթքումից	None
ֆիննը	None
շեշտի	Future
ցարի	None
կոռնան	Future
չմնչեն	Future
կտղեր	Future
ձներումս	None
կցուցանես	Future
չխօսան	Future
արդար	None
հանգստանանք	Future
կաճեմ	Future
հանձնեք	Future
կսրտաշարժի	Future
ծեփի	Future
բալենիների	None
չեղծանեցիք	Past
սահմանեցին	Past
կարմրանար	Future
չապացուցվեք	Future
հնչյունների	None
համարեին	Future
մսեղենի	None
չտաղտկացա	Past
մուրաս	Future
սահման	Past
ապահովվեց	Past
պարուհիներովս	None
հարնչեցինք	Past
բարելավեք	Future
մտցրին	Past
դարանակալ	Past
մեկնաբանության	None
ծնգցրիր	Past
աքսորական	None
չեռայիր	Future
չընտրվի	Future
ազդելիս	None
չջղայնացնեին	Future
ամբարտավանանար	Future
արդուկեիր	Future
շախմատիստներից	None
կխափանեմ	Future
հեղ	Past
նետեր	Future
պետություններումս	None
չչարաշահեք	Future
գործազուրկներիդ	None
քյուֆթայիս	None
չհաճեիր	Future
կգուրայի	Future
չմնչեցիք	Past
տարածություն	None
խորթերը	None
հերքվենք	Future
ապրանքի	None
չսիրւէին	Future
սփռեց	Past
ահաբեկվենք	Future
այբուբեն	None
կոգենք	Future
չեխերը	None
կխղճաս	Future
շնչի	Future
չլուծեր	Future
զգածվեր	Future
կշարունակեր	Future
ճոնի	None
գորով	Past
կագուցվեիք	Future
բաղաձայնդ	None
երկրաշարժ	None
ավելացնեն	Future
չփռթկացնեի	Future
կխրտնես	Future
կողողվեինք	Future
կկեի	Future
քրթմնջայիք	Future
կցուցանեիր	Future
հորջորջես	Future
գոգի	Future
չխոպոպացնեինք	Future
փոքրատառերը	None
էնցեֆալիտի	None
ողբայինք	Future
չպագանեիր	Future
քոչեր	Future
շարժումից	None
չպղծեիր	Future
սրտաշարժ	Past
գալիումը	None
չխոչընդոտենք	Future
գնի	Future
բաղբանջ	Past
տառապեց	Past
թրի	Future
սպանեն	Future
կքարշեն	Future
կլան	Past
չգարշեցիք	Past
կազդեմ	Future
չպայթեցի	Past
ընկճ	Past
խօսեցիր	Past
տեքստ	None
համբարներին	None
օղակ	None
հարգի՛ր	None
կապաշխարենք	Future
կպագես	Future
բարձրաձայն	Past
չհափափեք	Future
քամի	Future
կպեղեի	Future
չարածած	None
մտածելակերպը	None
սանդերս	None
չգանգրացվեցին	Past
չատենք	Future
ականջներում	None
չփքվեիր	Future
կհորդեիր	Future
լահմաջոներից	None
առկայծեմ	Future
կհուսալքեինք	Future
խորենացի	None
չգիշատենք	Future
ներկայացներ	Future
տպել	None
ընդգծեիր	Future
կագուցավորենք	Future
աբսորբեցինք	Past
այցելել	None
մագնեզիումի	None
կկարողանային	Future
միակը	None
ջունգլի	None
չպարգեւեի	Future
լուսանկարների	None
կզրնգային	Future
չմարթեմ	Future
չզարմացնեի	Future
հուսահատեցնես	Future
չփչանայի	Future
չխոպոպեցրիր	Past
չեխով	None
աճեցնես	Future
կմաքառես	Future
տաբատի	None
չլրջանային	Future
փայլունացվեցի	Past
կխնամեն	Future
պագաներ	Future
յակի	None
գոչեր	Future
հեղուսեիր	Future
խրախուսեցինք	Past
չմրցես	Future
հերքված	None
չկշռադատեինք	Future
կհարբեինք	Future
ազդեցին	Past
պանծացինք	Past
արթնացան	Past
չվարեց	Past
սովորությունները	None
խոչընդոտի	Future
ողբաք	Future
տեսնամ	Future
ծաղկյաներից	None
առաջադիմեց	Past
չուզեցար	Past
արկեցիք	Past
արթնանալու	None
պայմանում	None
կքերեիք	Future
դաշտան	None
չանձրեւեիք	Future
հուսահատեցրիր	Past
համեստության	None
չբնութագրեին	Future
հավելվածով	None
չարհամարհենք	Future
փոխհատուցենք	Future
արձագանքեիր	Future
չցուցանեիք	Future
ռազմիկներ	None
մաքառեցիր	Past
ջինսի	None
թուլանալ	None
չագահանացիք	Past
տերտեր	None
տետրում	None
ունկնդիրներովդ	None
վառվեցինք	Past
կգողանայիր	Future
չմեղադրի	Future
կխոպոպանանք	Future
տարեկանների	None
բնութագրեր	Future
հարսնանամ	Future
մրցանակներով	None
չմաքրեմ	Future
խածնեինք	Future
աներկյուղությանս	None
չխածատեի	Future
ճոնին	None
գուրամ	Future
կհղեր	Future
խառնեն	Future
բարձեցին	Past
բանեցնենք	Future
պագանեիք	Future
պառավ	None
հետազոտել	None
կբողոքեինք	Future
կխարխալես	Future
չծլես	Future
թանգարաններում	None
երեւայիր	Future
օժանդակեցին	Past
հնարքներ	None
խոխոջացիր	Past
չարիքից	None
բացատրեցին	Past
միջնադարյան	None
չօթեք	Future
կատակում	None
կհայտներ	Future
չծնեին	Future
ցուցանակներին	None
չկերտեինք	Future
ըմպանակներիս	None
չհեղեղենք	Future
արտագաղթեցիք	Past
բեկտի	Future
չխնչեցին	Past
գնաճը	None
չուժեղանայինք	Future
բարեկամներից	None
պատկերեցին	Past
չաղությունումս	None
կարծեմ	Future
ակորդեոններում	None
չառկայծեին	Future
անորոշելի	None
չչորացնեիր	Future
փնտրեինք	Future
կասկած	Past
պագնեմ	Future
կարդարացնեիր	Future
չծպտեցինք	Past
չդրսեւորենք	Future
լենի	None
խեթերենի	None
ձուլեն	Future
կջղայնացնեն	Future
կռվեր	Future
թեորեմով	None
ջանար	Future
կցանկանամ	Future
կպեղեմ	Future
չլվացին	Past
օղակների	None
ծեփեր	Future
կճմռի	Future
կհորդեր	Future
դարակներում	None
քծնեիր	Future
չսաղացնի	Future
ցնծամ	Future
բարձրաձայնի	Future
ռեակցիաներին	None
կտրուկ	None
մագնեզիում	None
խուփ	None
տաբուներս	None
չփռթկացնեն	Future
սպաներ	Future
կաշխատի	Future
լուտան	Future
կուռի	Future
չհագնվեինք	Future
չմտցրինք	Past
բարութ	None
ոխերիմ	None
մինարեթները	None
տշեմ	Future
տկռեինք	Future
ծածկույթներ	None
ապահովանան	Future
ձկնկուլի	None
աներկյուղանամ	Future
թափվեցին	Past
չմտմտանք	Future
փայլունացնեիր	Future
վաղվան	None
ռեակցիան	None
չքննարկեցինք	Past
զանգահարեցին	Past
հոլովակներով	None
տելուգու	None
չլկստեցին	Past
սխալին	None
երգիծեինք	Future
խեժերը	None
ազդվեն	Future
թամաշայով	None
առողջացնի	Future
անկածի	None
տարածեր	Future
կավելացնի	Future
շաչեինք	Future
ճաքեր	Future
չվանկեինք	Future
ճշմարտությանը	None
քվեարկողներին	None
ստիպեցինք	Past
ճանապարհներով	None
այսբերգի	None
կերակրեի	Future
աճես	Future
տոհմի	None
կտակում	None
սլացավ	Past
կցնծայիք	Future
կրակեց	Past
չճվատեինք	Future
հայեցի	Past
հաճարի	None
կարոտում	None
բնութագրելու	None
կհեռացնենք	Future
չուղեկցեիր	Future
հատակ	Past
առիթը	None
մաթեմատիկոսից	None
կուսակցությունների	None
հետազոտելիս	None
չբանտարկեի	Future
արտերը	None
ուժեղացած	None
կզրնգանք	Future
արկ	Past
չներբեռնեցիք	Past
չտաղտկացանք	Past
ապահովեր	Future
կողպեցին	Past
միացնել	None
չկթեիր	Future
ստվարաթղթակազմիդ	None
սիրուհին	None
չուռչեր	Future
խաղատան	None
կսայթաքի	Future
որյարը	None
թարխանության	None
կկարենար	Future
չհավելեցի	Past
ոտանավորի	None
կարոտ	Past
առերեսվեց	Past
հալեի	Future
կողոպտեցին	Past
հրճվանքի	None
չորացնեցիք	Past
վարենք	Future
ներքինացան	Past
չարյունահոսեք	Future
վրանից	None
պաներիցս	None
կաղամբ	None
հետազոտեց	Past
չփնտրեք	Future
կգլդորեն	Future
չճողոպրենք	Future
չշտապես	Future
լրիվումս	None
կէթա	Future
կատակեցիք	Past
աքեմենյան	None
շողա	Future
ներխուժեցին	Past
հորդորեցին	Past
չթքի	Future
կառչել	None
բարբաջեցիք	Past
չվհատեցրինք	Past
չծուլացանք	Past
չկախարդվեն	Future
չկռացար	Past
կալանք	Past
այրվեմ	Future
խորովածը	None
չստիպի	Future
հանգեր	Future
կհոշոտեր	Future
հրկիզես	Future
սազայինք	Future
չքրտնեցի	Past
կկախարդվի	Future
դարձվածքը	None
աղցանը	None
հիմնադրամի	None
չգրառեն	Future
նախատինք	None
կերազեիք	Future
հարնչեց	Past
կպահածոյացնեմ	Future
ուսումնասիրեն	Future
չխարխալեցին	Past
չճոռոմախոսեինք	Future
չհասցրին	Past
տասնամյակումս	None
նշանաբանի	None
կիս	Past
հուսահատվեցին	Past
կբխեն	Future
կնվաղեր	Future
կմղձկենք	Future
պոռոչես	Future
հասիում	None
քվեներ	None
բղավեց	Past
բեկորի	None
ռեստորաններից	None
հեռացրին	Past
չանզգայացրեց	Past
ապստամբեց	Past
կհասկանաս	Future
կազդվեի	Future
մոգոնեիր	Future
հրամանների	None
բախումներ	None
գոհացնելու	None
կհիասթափեցնեմ	Future
խեթային	Future
հատակեք	Future
հովանու	None
չմերկացա	Past
չմօտենայիք	Future
չգեղգեղեցի	Past
ճշգրտեիք	Future
տողով	None
խրթեինք	Future
կաղերսեմ	Future
քավեն	Future
անմեռին	None
կրակի	Future
կդրսեւորենք	Future
գրյանքներդ	None
չծպտեմ	Future
ներքինացնի	Future
կզրուցեիր	Future
փռշտացի	Past
դատապարտել	None
լճերում	None
չկործանի	Future
չծփեցիր	Past
նիրհեցինք	Past
օգտագործելիս	None
հացադուլը	None
չմրմնջաս	Future
չներքինացրի	Past
խառնես	Future
վերադառնամ	Future
չտաղտկանային	Future
մղձկային	Future
կպատկանի	Future
հնագույնը	None
չուռթեմ	Future
չբնութագրեցիք	Past
թագ	None
չարգելեն	Future
վկայով	None
լեզվաընտանիքում	None
հատուցեմ	Future
կանչեր	Future
կբաժանվեին	Future
լկստվեցիք	Past
կաճեն	Future
դատապարտեինք	Future
կընտրվի	Future
գրադարձություն	None
կնքողեիր	Future
խոստացավ	Past
զվարճացրել	None
փարպեցու	None
չորոճանք	Future
հորդոր	Past
հաստեցիք	Past
կհոլաթեւեն	Future
չհառաչեիք	Future
մարտիկներից	None
տուժվեին	Future
կտառադարձեիր	Future
պատկերեի	Future
չհատկացնեք	Future
չդարբնեցի	Past
կսանրվեիր	Future
հայտնեք	Future
հանելուկը	None
սոուսի	None
փախցրիք	Past
բեկանեք	Future
նեղանայի	Future
չկողպեք	Future
չանզգայացնեին	Future
նամականիներդ	None
հնձանի	None
ատելությամբ	None
կհագնեին	Future
չբարբաջեք	Future
կմրցեն	Future
մաքրեց	Past
մանանայի	None
աբստրահվեմ	Future
աղոթի	Future
չհերքեցինք	Past
համի	Future
թլփատեց	Past
ճակնդեղից	None
չծղրտային	Future
կլանի	Future
կաղոթեք	Future
թարգմանեք	Future
գեղարքունուս	None
գնչեց	Past
կփքվեիր	Future
արկան	Past
հայագիտականդ	None
թովեցիր	Past
չբաղխեին	Future
կթարգմանեմ	Future
հավատին	None
հանրապետությանը	None
զորավարներից	None
չխածնեմ	Future
սիրվենք	Future
մրսում	None
կբանտարկի	Future
երդման	None
խրամատները	None
չվանի	Future
հաճեի	Future
չշահագործեմ	Future
կբացականչեն	Future
կաղնիներին	None
ձաղեն	Future
չբաղբաջեի	Future
խայտառակի	None
մայեն	Future
կենցաղում	None
չջղայնացրեց	Past
ստուգեցի	Past
չհատեցիր	Past
մալ	Past
գողանայինք	Future
չբարելավեինք	Future
ոստայնի	None
մաքրելու	None
սլովեներենի	None
մարտնչեց	Past
խորքումդ	None
չերերացիր	Past
կանկանեն	Future
ձուլածոյովս	None
կպահպանեք	Future
չզեղեցի	Past
չկատակեիր	Future
հայկազուն	None
բուի	None
պատենտների	None
կհասկանաք	Future
չհարգեք	Future
փարպեցուն	None
կանխագրեիր	Future
անհրաժեշտությունը	None
գիշերով	None
չլքեիք	Future
կարեկցանք	None
վարորդները	None
օճառներս	None
հաստատությունից	None
կմղեին	Future
չողորմեմ	Future
հաշվիչների	None
թովեք	Future
լրիվ	None
պառակտություններ	None
սովորություն	None
թանկերիդ	None
կիսեցին	Past
ջանասիրությունդ	None
չլրթանա	Future
ուզենան	Future
չմնչեիք	Future
չգիշատեցինք	Past
քանդեց	Past
կոճակ	None
ներբեռնեինք	Future
չափանիշ	None
հանդեսի	None
կծեփեին	Future
տնտեսությունների	None
չհամոզեմ	Future
չզեղեինք	Future
բնութագրի	Future
գիշատեինք	Future
կպաճուճաբանեի	Future
կքարոզեն	Future
քեր	Past
ստիպեց	Past
կոտրեցին	Past
չցանկացավ	Past
ագուցանեիք	Future
ապահովանային	Future
փոխարիներ	Future
խոստացան	Past
կբաղբաջեիք	Future
ագուցվեիք	Future
չցավաք	Future
կկոշկոճենք	Future
քամած	None
կքարշեինք	Future
հայրը	None
բդկեն	Future
շրջակայք	None
ավանները	None
վաշտեր	None
չբաղձացին	Past
խորհրդանշեն	Future
չապստամբեն	Future
փորձեցիր	Past
ծնեցիք	Past
համակարգեց	Past
ներգաղթեք	Future
հաճախեցնեիք	Future
ուսուցիչը	None
սազ	Past
կորեն	Future
խառնեիր	Future
ընթացած	None
չանձրեւեի	Future
սեզոնների	None
չգթան	Future
քորի	Future
աշխատի	Future
կներկայացնի	Future
կկարեկցեր	Future
կծառայեիք	Future
փետրվարներիցդ	None
չագռավացած	None
չհատնեն	Future
թրմեց	Past
չհեղուսեց	Past
կխանդեի	Future
կկշռեք	Future
զառանցեցիր	Past
չբխեի	Future
կիրառվեն	Future
չկցեիր	Future
գեղգեղեին	Future
կզանգահարեինք	Future
զատեի	Future
չարդարացներ	Future
գլխարկով	None
լուսանկարից	None
խրախուսեցիք	Past
վայելեն	Future
դեկտեմբերին	None
կներբեռնի	Future
առերեսվեր	Future
չփախնեք	Future
փամփուշտ	None
զեռայիր	Future
արտագաղթեն	Future
կպարգեւեիր	Future
եփես	Future
ամարաստանում	None
լծակներով	None
չխոպոպացնես	Future
չհամբուրեցի	Past
չմեծացանք	Past
կմիանայի	Future
ճախրեք	Future
փորելու	None
հանգստանա	Future
կատեր	Future
չփայլատակեին	Future
կբացականչեինք	Future
չմատնեք	Future
մաքառեցի	Past
կէթայինք	Future
դրդեց	Past
ծաղրեին	Future
ահազանգի	Future
լիանայիք	Future
չհեղուսեցին	Past
աշխատեր	Future
կքոչեինք	Future
վճարեցին	Past
համաձայնեց	Past
կսրամտեի	Future
սառցադաշտ	None
հայցի	Future
բաղաձայն	None
չխոցեիք	Future
զարթնեինք	Future
չկլաներ	Future
բարբաջես	Future
գնահատեցին	Past
կպապանձեցնեինք	Future
ուսուցանեցինք	Past
մահացավ	Past
կհոլաթեւեին	Future
ավտոբուսներ	None
տերտերին	None
քալամի	None
արմանաք	Future
ծառայեն	Future
կագարակացնեինք	Future
չկակազեմ	Future
չախտորոշես	Future
սահմանեց	Past
արվեստագետները	None
կձաղեի	Future
կիսեն	Future
գերերում	None
չխմեինք	Future
կմոգոնենք	Future
սաղարթը	None
փոխարինումներին	None
ընդավորների	None
ճկույթը	None
բիզնեսներ	None
սաղմում	None
արժեքի	None
պայմանագրումս	None
քննի	Future
սառես	Future
բուծեի	Future
թլփատություններիցդ	None
հայհոյեցի	Past
հղեցավ	Past
չխանձատեցինք	Past
որոշմամբ	None
փտեք	Future
չհազացի	Past
չագուցվեցինք	Past
ակներում	None
չաբստրահենք	Future
փոխարինենք	Future
անձրեւեի	Future
բորբոքում	None
հաղարջենի	None
ճաշեր	Future
կագրեգատավորեին	Future
ցինի	None
կարի	Future
կերակրի	Future
կգիտակցվեմ	Future
կծուլանայիր	Future
գմբեթին	None
կապահովեն	Future
ծնվեր	Future
մոլեն	Future
չմայեին	Future
չհղանան	Future
կոտորակները	None
տեղեկանային	Future
կսիրւէր	Future
ցանկանաք	Future
օլիգարխ	None
կրի	Future
գաղտնիքներ	None
շտապեք	Future
չխրոխտացանք	Past
չմարթեք	Future
չհուզեր	Future
պաշտամունքին	None
նվաղեի	Future
չագուցահանեիր	Future
խոպոպեմ	Future
մարգագետիններով	None
չպոռոտաբանեցի	Past
կնպաստես	Future
չսփռեի	Future
անշարժումդ	None
կտաղտկանա	Future
հիմարացնեմ	Future
կողբայի	Future
կիրճ	None
կպղծեինք	Future
մարզիկը	None
քարշ	Past
ապահովեն	Future
նվագի	Future
բողբոջ	Past
նվագախմբին	None
տուժեցին	Past
գանգրացվեց	Past
կոտորած	None
հրաբխովս	None
չհազան	Future
ականծուղակներովս	None
օժանդակ	Past
նազ	Past
քելի	Future
նավեին	Future
քուն	Past
չզառանցեցինք	Past
փքվեիր	Future
ապուշիցդ	None
մայրուղիների	None
կկռնչեմ	Future
կարիերենիցս	None
կսահմանենք	Future
փութացնեն	Future
չպահածոյացրիք	Past
կբառնաք	Future
ատ	Past
չընդգծի	Future
վհուկին	None
ընտրվենք	Future
կշնորհեինք	Future
չբխեինք	Future
չգանգրվեինք	Future
կքծնենք	Future
կգոհանանք	Future
ձգտեիք	Future
կարկանդակները	None
կաջակցի	Future
մտմտացին	Past
ակնածեր	Future
կորբանաս	Future
հոլաթեւեիք	Future
հայերս	None
աստվածամերժությամբս	None
չհիմարացնեն	Future
կարտագաղթեր	Future
կարծեց	Past
կահագնանայիք	Future
գլդորեինք	Future
չմիացրեց	Past
չչորանան	Future
մեռելոտիներին	None
չահաբեկեն	Future
փայլունացա	Past
գանգրացվեր	Future
կանխամտածենք	Future
մուրացինք	Past
չօծեի	Future
փաստաթղթից	None
երազեցիր	Past
արդարացնի	Future
կեղտոտեցիք	Past
գրախանութը	None
կուրանաս	Future
չգոչեմ	Future
չծուլանայինք	Future
չալեկոծի	Future
բոլորից	None
ալբաներենիցդ	None
մեռյալի	None
կցավանք	Future
գործվածքներ	None
չողջագուրեի	Future
կմիացներ	Future
սպրդի	Future
թուլացան	Past
քարավաններ	None
կկանչի	Future
կբողբոջեիք	Future
ավետարանից	None
կհիանեին	Future
հայտն	Past
մոդայի	None
շարունակեց	Past
կդատապարտեին	Future
կխածանեի	Future
արփենի	None
մետաղ	None
կսրամտեն	Future
չհմայեցիք	Past
չբանանք	Future
աղատ	Past
չկարեկցեր	Future
սնուկերի	None
ծնին	None
ուզբեկերեններովս	None
ուժեղացան	Past
հատակեմ	Future
չհավելեցիր	Past
որոճես	Future
գումարներ	None
քարոզ	Past
գորտնուկների	None
չշողաս	Future
չարտաքսեն	Future
չքաղցեցի	Past
արխիվը	None
թլփատենք	Future
համբուրեիր	Future
շնորհեց	Past
հարգենք	Future
օսլայի	None
մղած	None
շահագործեցի	Past
չվրդովվեի	Future
հույլիդ	None
կամբարտավանանաս	Future
զեղծեց	Past
կքարշեի	Future
վանկարկ	Past
չխոչընդոտեին	Future
համացանցով	None
կդատապարտի	Future
մնչենք	Future
չթրեր	Future
հազայիք	Future
չմոլեր	Future
չսիգաց	Past
աղքատ	None
շիջուցանեցին	Past
ընտրյալը	None
կհոտես	Future
բիլ	None
թլվատեցիր	Past
հրկիզեցին	Past
այցելեց	Past
կմրմնջայի	Future
չներգաղթենք	Future
չսխալվեցի	Past
զղջացել	None
կխոսայի	Future
ապստամբությունների	None
սփոփվեինք	Future
հանգույցը	None
հաճի	Future
հարեիք	Future
աքսորով	None
կթռնեին	Future
չսաղանայի	Future
հերոսը	None
սահմանեի	Future
վանեցին	Past
մածվեի	Future
մատերիալիզմին	None
չստիպեի	Future
եբրայերենիցդ	None
կըղձան	Future
փոխարինելու	None
չքննարկեն	Future
չկաղկանձենք	Future
արեւմտյան	None
շարժվեցին	Past
թքեին	Future
լքնեցինք	Past
չհյուսող	None
ողջագուրեն	Future
գուրգուրայինք	Future
ուժեղացանք	Past
մնջուկները	None
երկի	None
կքններ	Future
ելույթին	None
բացականչեցի	Past
չուռթանայի	Future
միաց	Past
չճշգրտեց	Past
պատասխանատվություն	None
շրջվեցիր	Past
տրամադրեի	Future
կփչանայինք	Future
չհորանջեր	Future
չհամբուրվեի	Future
գեյզերների	None
լեզվաբանները	None
աղյուսակներում	None
ձողերի	None
չխրոխտային	Future
բանսարկուդ	None
չմագլցեցին	Past
պարտվեց	Past
կզխկտեն	Future
չնքողեց	Past
չուռթենք	Future
կռնչայի	Future
կոչենք	Future
չքաքի	Future
չլծի	Future
չգոյանանք	Future
ժպիտով	None
չմտցնեինք	Future
չփքվես	Future
չկքենք	Future
զորախմբերի	None
պատկերի	Future
կկատարեն	Future
կթափվեին	Future
հորջորջի՛ր	None
կիզեն	Future
կրոնավորները	None
օվկիանոսներ	None
չահագնացա	Past
կկշռեի	Future
չենթարկեցի	Past
զգուշանաս	Future
կհողդողդեր	Future
առոգանեին	Future
չբանեցրիր	Past
հոս	Past
աղաղակեցիք	Past
լեմուրներ	None
չկարծի	Future
անապատական	None
չակնածեիր	Future
մեխանիզմին	None
ներկայացնեին	Future
ցուցանենք	Future
խայթեք	Future
չհամոզեինք	Future
նեղացաք	Past
կանացի	None
կեչուայի	None
կնքողեմ	Future
կլուծի	Future
ձավարապուրներովդ	None
արտասվեիք	Future
ընթերցողներ	None
կարեն	Future
սիրահարների	None
ստ	Past
քանդեցին	Past
աբստրահեր	Future
պարտվեցիր	Past
գանգրվեինք	Future
հածեցիր	Past
կուրսերում	None
վանկ	Past
ըլնեք	Future
կաբսորբեի	Future
պոմիդորի	None
չափահասների	None
կծլարձակեն	Future
ծածանեցիք	Past
չթովեիք	Future
ճանճին	None
մարզադաշտերից	None
փրփրեիք	Future
չհամակարգեցիք	Past
կիսեք	Future
չբանեցինք	Past
կփլեին	Future
կպագանենք	Future
կճկեք	Future
դրսեւորեր	Future
ժամով	None
աբրեշումեդ	None
չզատեցիք	Past
կմեղանչեք	Future
կգոչի	Future
կշաչես	Future
իմաստություն	None
թքեր	Future
մրցույթով	None
չընդարմանայիր	Future
անիծեիր	Future
համակարգի	Future
ագուցավորեիք	Future
սիրվեց	Past
համաձայնեք	Future
մօտենար	Future
քանանացիների	None
կքաղեի	Future
ձգտեք	Future
ֆիններենով	None
պարերով	None
ճամփենք	Future
մոլեգնենք	Future
չօծեն	Future
օդակայանները	None
տնտեսագետների	None
հոլովումներ	None
ցնծանք	Future
կվանկեն	Future
աղատեցիք	Past
ընգար	Past
ուզեցի	Past
չփչեք	Future
կայանայի	Future
պոռոտախոսեք	Future
կարծես	Future
խարզային	None
խռթա՛	None
հեծյալը	None
չճանապարհորդի	Future
կողքերով	None
օդակայանը	None
մալեց	Past
ռուսներին	None
չսառչեիք	Future
կնքեցին	Past
խազ	Past
ազդվելու	None
չհղանա	Future
քելեր	Future
էլեկտրոդներին	None
գերդաստանները	None
նվաս	Future
կխմեր	Future
ուռչեցինք	Past
ջաղացիդ	None
կռիվներով	None
արդուկեցին	Past
սազաս	Future
բնակվեմ	Future
արտադրությունների	None
մոլեկուլներին	None
խորանով	None
սփոփվեր	Future
արտոնագիր	None
չմտցնեիք	Future
չակնածեն	Future
չագարականայիք	Future
քցենք	Future
օդակայանի	None
կողբա	Future
դիեցիր	Past
ծիծաղաս	Future
թափվեց	Past
զոդեցինք	Past
կհորդեն	Future
չքոչեց	Past
ձգտեն	Future
տարած	Past
վարան	Past
շաքարեղեգը	None
արշիպելագներ	None
իտալացիներ	None
չհարնչեր	Future
կստուգի	Future
սահմանեցիք	Past
կպարգեւեք	Future
գուարանիիդ	None
կսփռեմ	Future
գամետները	None
օրգանիզմին	None
կհոլաներ	Future
կրծի	Future
գրգռի	Future
հոգա	Future
քաջալերանք	None
չծանուցեմ	Future
չգրառեք	Future
չբացատրեք	Future
թխվածքը	None
չվերծանեցին	Past
հեգի	Future
կպարգեւեիք	Future
կպարապեն	Future
կերտեց	Past
կարողանաս	Future
գիշատեցին	Past
ներգաղթել	None
կհայտնի	Future
խորդ	None
լոգանանք	Future
կբաղխեր	Future
ճնշումը	None
սիրուեմ	Future
կխռթա	Future
ապահովանայի	Future
դատապարտեցին	Past
չկախեք	Future
չարդարացնեի	Future
արշավանքները	None
մկանում	None
չահագնացավ	Past
ծառայեցիք	Past
նեյտրոնների	None
տնօրինելու	None
շախմատիստը	None
համաձայնեցին	Past
համարի	Future
կփլվեմ	Future
հուզեցին	Past
կագուցես	Future
չգովեիր	Future
խարխալեն	Future
կխեղդես	Future
կկարմրեն	Future
վհատեցրին	Past
տռի	Future
չլվացինք	Past
ծածկենք	Future
պիտույքներ	None
բարեւեի	Future
կրծքերը	None
չմտմտայիր	Future
կատարեիր	Future
չգլեիք	Future
հատկացնեն	Future
կխռմփաք	Future
մեծարեն	Future
ստեն	Future
վախեցավ	Past
ցավեք	Future
չզարթնեցիր	Past
կգոռային	Future
չդարսենք	Future
չմաքրեիք	Future
գլյուոնների	None
զետեղեց	Past
գոհացնեինք	Future
նավեն	Future
հաղարջը	None
չհետազոտենք	Future
բալետներին	None
շիջեցի	Past
հանձն	Past
չմաքառեի	Future
թլվատեիք	Future
ճնճղուկի	None
հղի	Future
կշարունակեիք	Future
նախընտրեն	Future
պայուսակների	None
հիմնավորեց	Past
վանես	Future
չէթար	Future
մառախուղը	None
խթան	Past
քորերից	None
կստամբակեի	Future
հանգի	Future
թենիսով	None
օժանդակենք	Future
չհոլանի	Future
կքայլեր	Future
հեծեծ	Past
արարքի	None
չհոլաներ	Future
չմեկնեցի	Past
չբզզամ	Future
կջանայինք	Future
կկարօտենք	Future
չչաղացավ	Past
արցունքների	None
չագահենք	Future
չգոչեցինք	Past
մտրակի	None
հանվեցի	Past
չխրտնեի	Future
չհոգացի	Past
կթռնեիր	Future
գայթակղի	Future
կասկածել	None
ժպիտից	None
առավելներիս	None
եպերեի	Future
չնազեցիր	Past
տառադարձեիր	Future
համել	None
տեղեկացրեց	Past
աջակցեին	Future
պարտեզների	None
չայցելի	Future
շտկեինք	Future
ագուցեք	Future
կազմակերպությունը	None
կտնօրինենք	Future
կկատակենք	Future
մղձկեցիր	Past
սպերմատոզոիդի	None
աղոթեին	Future
հոնքերը	None
պագնեն	Future
բողոքարկեցիր	Past
կուրանայի	Future
շարունակենք	Future
թք	Past
շվեդերենի	None
չշիկնեմ	Future
չոգեշնչեն	Future
ներքինանար	Future
ընթանան	Future
բուծվել	None
պատկերեն	Future
մարտնչեն	Future
չեղծանեցին	Past
եբրայերենով	None
խաչակիրը	None
աշխույժի	None
չկասկածեց	Past
ինքնյակ	None
տրամադր	Past
փութայինք	Future
ավելացնում	None
միացյալ	None
չընկճեմ	Future
մարկերի	None
չստրկացնեիք	Future
էտրուսկյաններդ	None
պարգեւեմ	Future
պառկեին	Future
չհաճախեցրինք	Past
տրամաբանությունումդ	None
զոդի	Future
երկեր	None
չբողբոջի	Future
փքունություններիցդ	None
ցանկացան	Past
պապանձվեր	Future
չճողոպրեք	Future
ողբամ	Future
կճողոպրեիք	Future
կհայտնեմ	Future
կնիրհեիք	Future
չփորձեց	Past
փութայի	Future
չմտմտացիք	Past
կհոշոտեին	Future
խեժի	None
հալեց	Past
չկողպեց	Past
ներկայացումներիդ	None
հասկանար	Future
ուսումից	None
կորեմ	Future
շնորհի	Future
չքցեցիք	Past
բետոնի	None
թեղոշներս	None
ջանք	None
կաճես	Future
մթնոլորտ	None
սփոփեինք	Future
համաձայնեցնել	None
որմնախորշի	None
կողոպտեցինք	Past
ավազականոցներում	None
նավեի	Future
չզրնգայիք	Future
պետության	None
չխրտնեն	Future
չտռեինք	Future
սալոր	None
մահանայի	Future
չթռանք	Past
արեւելյան	None
գանգրվեր	Future
կուզես	Future
խթեի	Future
ներխուժեն	Future
կկոչեք	Future
չլծեիք	Future
ծանծաղուտը	None
կիրառեցին	Past
չխանձատեն	Future
տանջեիր	Future
գործարքների	None
ժողովուրդներին	None
հոտ	Past
տրամագծով	None
խմբագրեմ	Future
չպաղատեցի	Past
մոլորվեիք	Future
կանկանես	Future
ապահովացան	Past
թարգմանի	Future
չհղենային	Future
կթորշոմեիր	Future
չհպարտացանք	Past
չվառվենք	Future
կերթայի	Future
հեշտոց	None
չշփոթվես	Future
ավելացրեց	Past
չխառնես	Future
ինքնահավան	Past
միացնեն	Future
պառկեք	Future
ընկերուհիների	None
մղեն	Future
ձնով	None
փրփրեցիր	Past
չխոպոպանայինք	Future
հիասթափեցրեց	Past
հափափեր	Future
չագուցվեցին	Past
չնազեիք	Future
վերագրեցին	Past
տաղտկացաք	Past
հղեցինք	Past
մահանում	None
ազգականին	None
ցուրտը	None
շվեդերեն	None
չգայթակղես	Future
ձուլածոներիցս	None
արտագաղթեց	Past
երկերին	None
կտառապեցներ	Future
չօրհնեմ	Future
սերմնաբջիջներ	None
ներքինանաք	Future
պահպանեց	Past
հոլաթեւեցիր	Past
օյինբազությունումդ	None
տարակուսեցիք	Past
պրոթեզի	None
խեղդեց	Past
չորոճաս	Future
չթոթովեցի	Past
հածեիր	Future
պատվոգիր	None
շպրտեիք	Future
ունկնդրես	Future
սոցիալիստական	None
կոփածոներս	None
լաոսերեն	None
չփսխեինք	Future
երկրպագուներով	None
քննադատներից	None
փոխհատուցեիր	Future
հեռացնի	Future
սպիրտները	None
կնետեր	Future
չպաշտեցին	Past
քարտեսը	None
կիլոմետր	None
աբստրահեն	Future
կսրտառեր	Future
կքշեի	Future
ախտորոշեց	Past
անոդի	None
չկարողանան	Future
չցուցանեցինք	Past
երազեմ	Future
հառաչաձայնս	None
կփոխհատուցի	Future
չծեփեք	Future
քամեիք	Future
պատվանդանը	None
նպաստի	Future
չուղարկես	Future
գելեք	Future
կեղեքեի	Future
հառեց	Past
կլվացվեք	Future
չօղողեք	Future
չպատկերեցին	Past
կկասկածի	Future
կանգնի	Future
խոնարհումներիցդ	None
բացառեիր	Future
կատակեք	Future
վճարեիք	Future
չցավայինք	Future
կաթսա	None
կքչքչայինք	Future
կճեիք	Future
կարողանա	Future
շարունակեինք	Future
չահազանգեմ	Future
ապացուցվեցիք	Past
կազմակերպեին	Future
չթրծեցին	Past
չարկանեմ	Future
վաշտում	None
չհեգնեին	Future
ահագին	None
մրցանակին	None
հալածվել	None
մաքսերը	None
կարբի	Future
կշպրտես	Future
միսս	None
պարտվող	None
շտապելու	None
կարտոֆիլ	None
վերադառնան	Future
մեղադրեց	Past
չճողոպրեինք	Future
չզեռային	Future
կգոգեմ	Future
ներկայացնի	Future
բռնություններով	None
չհատեինք	Future
նորույթների	None
վանեցի	Past
խոչընդոտող	None
չտառապեցիք	Past
կաղոթես	Future
մրցավարը	None
պարապեիր	Future
բեյսբոլը	None
սաղաց	Past
բուծեցիր	Past
շփոթմունքներս	None
սրտաշարժեր	Future
կտեղեկանար	Future
մատուցի	Future
արագացումների	None
տեղեկացնեն	Future
կփրփրեին	Future
չգլտորեն	Future
լուծեն	Future
սավառնող	None
քլորից	None
չխորհրդանշեցի	Past
չշփոթվեն	Future
սպասարկեց	Past
ագուցեինք	Future
սվինին	None
չանզգայանայիք	Future
ընդարմացա	Past
կրիպտոնը	None
վրացիներով	None
ջանային	Future
կկատակի	Future
խմի	Future
չքարշես	Future
հարկանեցինք	Past
կսիգաք	Future
կկռնչեիք	Future
տռզի	Future
կատարի	Future
չստորագրեցիք	Past
երկաթգծովս	None
չհիասթափվեք	Future
կալեի	Future
քերեն	Future
սառչեն	Future
հաստության	None
կճաքեի	Future
կեռերս	None
բացառվեցիք	Past
չպահածոյացրիր	Past
կխոպոպացնեինք	Future
ձգտի	Future
չփայլունանանք	Future
գնոստիկական	None
կհամաձայնեն	Future
մեղադրեցինք	Past
մրսեք	Future
չաճապարեց	Past
կաթսայից	None
կթորշոմեին	Future
երեքնուկներիցս	None
կգոհացնեք	Future
աքսորվեի	Future
կկրեք	Future
քշեց	Past
չփայլունացնեք	Future
բացատրեր	Future
կերակր	Past
պրոլյուվիալ	None
կծափահարվեիք	Future
արհամարհեի	Future
չստի	Future
ճոռոմաբանեիր	Future
արարիչ	None
սովորեցի	Past
ավազուտներիս	None
մթերով	None
հագնես	Future
ծորանին	None
մասրենու	None
չկենդանացաք	Past
կցանկանա	Future
հղեցանք	Past
վիրաբուժություն	None
չհարեցինք	Past
կճեք	Future
չհուզեն	Future
զորախումբը	None
չնպաստեմ	Future
կկիզեին	Future
շպարանյութում	None
չլվացվեց	Past
կքցեինք	Future
չհիասթափեցրինք	Past
կազմակերպեց	Past
խոց	Past
եղծանեիք	Future
հագեցնեիր	Future
չհոլանես	Future
հրեց	Past
տուբերկուլոզը	None
ջիլ	None
պաշտենք	Future
կիրառվեց	Past
կոչի	Future
բարուց	None
կհավելեք	Future
չառաքեց	Past
չճշգրտեցիր	Past
չխռթա	Future
հումք	None
արքայազնի	None
հանվեինք	Future
չընտրվեք	Future
կայրվեն	Future
չբխի	Future
չնքողեցին	Past
չզառանցեմ	Future
կձգտեմ	Future
իրիկուն	None
հոխորտայինք	Future
կոտորածներ	None
չզարթնեին	Future
կպառկեմ	Future
կմահանա	Future
կսայթաքեինք	Future
խնջույքը	None
կկեղտոտի	Future
ճոռոմաբանի	Future
ոգեշնչեցի	Past
կանձրեւեիք	Future
վաստակիդ	None
չճմլեն	Future
հիվանդագին	None
ներդրումից	None
ներկայացր	Past
գնահատեն	Future
չկանգնեցի	Past
կշիջուցանեմ	Future
չբդկեն	Future
թլվատեին	Future
չաքսորես	Future
մխիթարեիք	Future
ըլնենք	Future
չհաստեր	Future
քննարկեցինք	Past
կանխամտածեցիք	Past
լիանա	Future
չմեծարեին	Future
հել	Past
եպերեք	Future
կստիպեին	Future
ճառագայթներ	None
բեկանենք	Future
սորան	Future
մարթ	Past
հռետորաբանության	None
չխոստանայի	Future
կավերին	None
կմրմնջայինք	Future
խնջույքները	None
ժամկետներիցս	None
շտկի	Future
չկնքի	Future
կազդի	Future
վայրեր	None
չկողպեցիք	Past
կպայթեի	Future
չմրմնջաց	Past
կերպարանք	None
տրամադրեն	Future
ստորագր	Past
կուրախացնես	Future
քաղց	Past
պապանձեցնեին	Future
հասկացավ	Past
կշփեիր	Future
կտակարանում	None
կմնչեն	Future
կատարից	None
կգիշատի	Future
չագուցահանենք	Future
հայդուկը	None
չկարողանամ	Future
հայդուկների	None
իոններ	None
հյուսեինք	Future
թարխանությանդ	None
անհամեստ	None
շարունակեր	Future
քարոզող	None
խոցեցի	Past
կխոսաս	Future
ուզբեկերեններս	None
երկկտտացրիք	Past
մաքրի	Future
ագրեգատավոր	Past
կճոռոմաբանենք	Future
պատանյակ	None
գարշեցիք	Past
պոռոտախոսեցի	Past
չշնչեին	Future
ազգայնացումս	None
չկնքեցինք	Past
չկցեինք	Future
արտագաղթի	Future
կարտոֆիլին	None
կամեցավ	Past
նվագելու	None
րոպեականումդ	None
ապացուցվեցի	Past
լայնությամբ	None
հիմնավոր	Past
չտարբերեիր	Future
չներկայացրեց	Past
քրոմիդ	None
չառողջացնեն	Future
խօսի	Future
կզգածվեք	Future
չմոռանաք	Future
կտակեց	Past
չհելնեի	Future
չբավարարի	Future
հատեն	Future
հաղթական	None
ունկնդրենք	Future
կհամեիր	Future
դաշնակցականները	None
շրջվի՛ր	None
մեղքին	None
հանվի	Future
չձուլեցիք	Past
մոռանան	Future
չկորնչի	Future
կպագնեք	Future
ծառայի	Future
չծլարձակես	Future
կսրճեր	Future
կխոխոջեի	Future
չփութացրին	Past
կարենան	Future
մխիթարեցիր	Past
կճամփեինք	Future
կնախընտրեի	Future
կատակ	Past
շտապեց	Past
մղ	Past
տողերով	None
քահանաներին	None
հետազոտող	None
շքերթում	None
արագությունները	None
մաքրեն	Future
կհանձնի	Future
մերձեցավ	Past
շառավղից	None
չագարականացիր	Past
կփոխարինենք	Future
չսգաս	Future
չձաղեինք	Future
շիկացանք	Past
վճարեց	Past
կտակ	Past
կարօտ	Past
յուղով	None
սկալդս	None
կհափափեիր	Future
լորիկներս	None
բնութագրեցին	Past
կրպակներով	None
կորեց	Past
կվերադառնամ	Future
կհեգնեինք	Future
կընգնեի	Future
լրջանային	Future
փայտփորիկները	None
որոմներովդ	None
կռթնեիր	Future
լեզգիները	None
կջեռուցես	Future
ստրկացրեց	Past
արեւելքիդ	None
ամուսնացրեց	Past
գերիդ	None
կսրճեիք	Future
չծլի	Future
գմբեթներ	None
խորխեն	Future
կտպեմ	Future
տանտերերի	None
կվհատեն	Future
միջինին	None
սովորույթներ	None
ընդարմաց	Past
չսաղացնես	Future
չաղարտեիք	Future
կապահովվեի	Future
կտրամադրի	Future
չարտագաղթեք	Future
հանձնեցիր	Past
աղամողումդ	None
վանկեր	Future
քայլին	None
լողավազաններիս	None
լքնեք	Future
կոգեշնչեմ	Future
գնահատեք	Future
հանձնել	None
զտես	Future
կհասցնեիր	Future
հաճախեցին	Past
կատեիք	Future
անասնաբույժը	None
գոգեմ	Future
հյութեղ	None
մոլի	Future
պառկելու	None
նինջայի	None
կշռադատող	None
խօսաք	Future
դարբնեին	Future
հարի	Future
շատանայինք	Future
հաճախեմ	Future
համեր	Future
ալերգիա	None
ագուցվես	Future
կթոտեցի	Past
հիրի	Future
գյուղում	None
խարույկը	None
կծաղրեիք	Future
ոստնեց	Past
ողբերգության	None
կշարունակենք	Future
կհաճեն	Future
հարեն	Future
աբստրահեցին	Past
մածվեք	Future
չմարտնչեցիր	Past
կհայեի	Future
մեծաքիթներիցդ	None
գերծեցինք	Past
արմանայիր	Future
մետաղադրամի	None
չհրամայեն	Future
վարձակը	None
ներխուժեց	Past
չոգեմ	Future
հաշիվներով	None
չկերակրեցիր	Past
չպաղատի	Future
որոճեինք	Future
կկարմրեի	Future
չգանգրանան	Future
կախարդը	None
սիրուհուն	None
լուծ	Past
չհիրեք	Future
չաքսորեցին	Past
անզգայանանք	Future
փախան	Past
ներխուժենք	Future
կառավարեցի	Past
հեղեղի	Future
որոճան	Future
թեկնածուն	None
չլուտանք	Future
վաստակների	None
լիզեցի	Past
կամակորներովս	None
չտեղեկանաք	Future
բնութագրես	Future
կշրջվես	Future
չսրտառեին	Future
մառան	None
չգրառեցիր	Past
կատարեմ	Future
չսայթաքեցիք	Past
քնկոտ	None
կարմրեց	Past
հաճախեցրիր	Past
չհողդողդեիք	Future
ազդվել	None
ծանծաղուտները	None
երկբարբառներ	None
կոտրում	None
խորովեց	Past
չկանգնեցինք	Past
սովորեն	Future
խաչս	None
բանային	Future
էրբիում	None
մնացորդներ	None
ագուցահանեիր	Future
քորեր	Future
չբաղբաջեմ	Future
կխոխոջայիր	Future
չարածեցնի	Future
հագնվի՛ր	None
կզղջայի	Future
վաճառի	Future
կնքողեն	Future
սիրուհի	None
ջրաղացը	None
կարեկցի	Future
կբաղխեի	Future
չշառաչեիր	Future
կսիկտիրվեի	Future
կացնի	None
թրմեմ	Future
չվրդովեմ	Future
կամավորներից	None
չծնեիք	Future
չգիտակցեինք	Future
չգթանք	Future
բուսանի	Future
հեռ	Past
չխազեցի	Past
ծուլանային	Future
հավատամ	Future
չդայլայլեն	Future
շրջակայքում	None
չորանայինք	Future
ձմեռայիններից	None
թակիցդ	None
չմեծանայինք	Future
աճապարեցին	Past
բացատրի	Future
ընդերքից	None
չխնկեի	Future
մատուռներ	None
պարողներին	None
մտցրինք	Past
կանխամտածեցի	Past
չպանծաք	Future
սնգուրվեիք	Future
բնագրի	None
կկարեիք	Future
չխոցոտեիր	Future
կագուցեր	Future
չկարծեի	Future
հալածեք	Future
պագնի	Future
չհայեինք	Future
կանգնեն	Future
չողբամ	Future
չվրդովվեցին	Past
համառոտիդ	None
մտածելակերպով	None
չհոշոտեիք	Future
չորոճեմ	Future
քննարկումները	None
չգոլանաս	Future
չկաղկանձեք	Future
միջատին	None
բացականչեցիք	Past
կկանգնի	Future
կչորացնեիք	Future
պարան	None
մատենագիրներովդ	None
չհրկիզեր	Future
հորդ	Past
քարոզեն	Future
ակրոպոլիսում	None
չըղձար	Future
կուսակցությունից	None
կայքերին	None
բացառենք	Future
պայմանավորվեք	Future
եղծեցի	Past
ուզես	Future
կկերտես	Future
բաղբաջեցիք	Past
մատչեի	Future
վերնագիր	None
չկիզեմ	Future
զարմացել	None
չկոճկեն	Future
շարժիչի	None
հառաչեցին	Past
չափսերով	None
չչորանայիր	Future
սրտառուչիդ	None
արգելքներ	None
վախեցին	Past
արբանյակների	None
չմեկնեց	Past
խորհրդանշեցինք	Past
չխոյացան	Past
չբողոքեն	Future
երդվեցին	Past
կդարսեի	Future
տանձը	None
ավարներին	None
կաղին	None
ընթեռնենք	Future
մերկասառույց	None
պղծեցի	Past
չշնչեցիք	Past
էջերով	None
ձիթենիներ	None
պատկանի	Future
կերգիծեիր	Future
կկրեի	Future
պուլսարների	None
բուծանեմ	Future
կանորոշանա	Future
չտենային	Future
վեպում	None
փլվեց	Past
ձնծաղիկ	None
խնչեի	Future
կհարկանի	Future
ձեղնահարկում	None
խոցեր	Future
սայլի	None
տեղեկատվություններովդ	None
կվառվեիք	Future
երգիծեցիր	Past
չերկայնանար	Future
կհոսեի	Future
կբխեմ	Future
հաստատենք	Future
դարբնեիր	Future
կդարբնեմ	Future
չմտադրվենք	Future
լողացա	Past
չթաղի	Future
խանձատեր	Future
պագավ	Past
չահագնանաս	Future
երգեհոնիցս	None
հանգամանքը	None
կթաղեր	Future
չբուծանեցիր	Past
կջանայիք	Future
պագի	Future
կբրթեմ	Future
չապաշխարեցիր	Past
նկուղը	None
ընթերցումը	None
ֆիննիցս	None
չցավամ	Future
տոմարը	None
կզատեմ	Future
կհղենայինք	Future
կպարտվեիք	Future
կամուսնացնես	Future
կկրեն	Future
չփախնեն	Future
աղերսում	None
պոռոտախոսեի	Future
սպայի	None
զանգ	Past
կողորմեիք	Future
չապացուցվեիք	Future
զվարճացա	Past
սխալվեցիր	Past
փախցրի	Past
շաչեցինք	Past
կողմերին	None
երեքկիններով	None
աշխատեք	Future
քարոզեցիր	Past
շփոթեցրի	Past
Մխիթարին	None
լուտեցիում	None
չկշռադատեիր	Future
կանխամտածվի	Future
չհայտնեց	Past
կարողացա	Past
աշխատենք	Future
բառարանից	None
լողանալ	None
հեռացներ	Future
մրցեմ	Future
հիդրոլիզը	None
չապշեցիր	Past
սրերը	None
կփորձեք	Future
վանկեիր	Future
նկարիչներին	None
հայելու	None
չխեթկեն	Future
չխորովեք	Future
չբխեր	Future
ժանիքներ	None
չտարբերեի	Future
լորամարգերիցդ	None
ստորագրեին	Future
բողոքարկեի	Future
ներխուժեիք	Future
ծլարձակեցիր	Past
կխարխլեն	Future
կհոլանեիր	Future
չլքեց	Past
կարտասվեինք	Future
շիկնեց	Past
մեկնի	Future
բուսանեցինք	Past
հոլանդականդ	None
պորտուգալերեն	None
կանանցով	None
չխածատեիր	Future
ախտաբանս	None
քրոմը	None
ծափահարվեմ	Future
բացառությունը	None
համակարգիչներում	None
փետրվարյանովս	None
պատառեիր	Future
սիկտիրվեիք	Future
հալածանքին	None
գնչուները	None
չտրամադրեցին	Past
տշեք	Future
խարույկ	None
հատնի	Future
վաճառեցին	Past
կոչես	Future
խորշը	None
մատյան	None
կարբենայիք	Future
ուզեմ	Future
սառեիք	Future
չթլվատեցիր	Past
նախանձի	Future
չէտեն	Future
մորթում	None
թափվ	Past
չոլորեցիր	Past
գիտակցվ	Past
կվանի	Future
չործկայինք	Future
չպատառեցինք	Past
աքսորի	Future
հասցեին	None
չգանգրանաք	Future
կծափահարես	Future
ռեժիսորից	None
գործոնները	None
չապացուցենք	Future
կշատանայիր	Future
չաղացինք	Past
գոռացին	Past
չջեռուցի	Future
ֆրանսիում	None
ներկայացրին	Past
չմոռանալ	None
կհորանջենք	Future
արտագաղթող	None
հարկանի	Future
կոմպոզիտորների	None
ագուցվեմ	Future
կդիեինք	Future
խածատեմ	Future
չհամեցիր	Past
նախընտր	Past
փոխհատուց	Past
մեղանչեր	Future
կխոյանաս	Future
փնտրեն	Future
ղարաբաղյան	None
փնտրեք	Future
կերգիծենք	Future
խոխոջացին	Past
քննարկեն	Future
կողողվեն	Future
ոլորեր	Future
կչաղանայի	Future
թաղ	Past
հավաքածոները	None
կենացը	None
կհեռացնեինք	Future
կթաքցնի	Future
չշփոթվենք	Future
կլանեմ	Future
կագուցահանեն	Future
բանա	Future
տափաստանների	None
ամուսնացրին	Past
պայմանավորված	None
կկանչեիք	Future
մառախուղ	None
կզառամեինք	Future
կհավելես	Future
քունեին	Future
կբեկտեն	Future
երուն	None
կցանկանայի	Future
միայնակներիդ	None
մոռանանք	Future
երիցուկի	None
կճեմեինք	Future
սխալվեցի	Past
կհրահրեի	Future
կլծես	Future
հանգեի	Future
խեթկեցին	Past
ճկույթի	None
կոնֆետներով	None
վարակը	None
հազարամյակներում	None
գյուտս	None
լուծի	Future
տրոմբոն	None
ավտոտնակների	None
կհալածեն	Future
առերեսեն	Future
ընկճում	None
կասկածեցին	Past
կմիանա	Future
խալ	None
ենթակառուցվածքները	None
խորհուրդների	None
չհյուսես	Future
կոչեցի	Past
բարեւեցի	Past
գանգրաձեւներովս	None
փոխհատուցի	Future
չոռոգեցիք	Past
կուզեն	Future
կհաճախենք	Future
կողոպտեն	Future
կարեցի	Past
հեծան	Past
կեղեւը	None
հափափեմ	Future
կազդվեին	Future
կոշկոճ	Past
բորբոսի	None
համբերեինք	Future
առաջադրանքում	None
դողացին	Past
նվագել	None
կհղենաս	Future
սրամտեինք	Future
տարիքի	None
կբեկտի	Future
խխունջների	None
կմոռանայիր	Future
չբուծանեցիք	Past
չերկբայես	Future
չածի	Future
չսնգուրվեիք	Future
չմխիթարեի	Future
կածեմ	Future
լուծիչներում	None
բաղխեի	Future
ռիսկի	None
չծղրտացինք	Past
կկիսեի	Future
կներքինանայիք	Future
այգեվետիդ	None
ապստամբի	Future
բառակազմությունը	None
հայտնագործություններումս	None
որոճայիք	Future
օդանավակայաններում	None
չարձագանքեց	Past
կիզեք	Future
սահմանեն	Future
չպաղատեիր	Future
ներկայացնեք	Future
խրոխտացաք	Past
մթությունից	None
չզառամեիք	Future
չսովորեինք	Future
հմայես	Future
չապաշխարի	Future
հնավունով	None
իրականի	None
աճեր	Future
կրեին	Future
Զատկից	None
հորդորեց	Past
վերջիններիս	None
կուզեր	Future
էրեկցիան	None
կհնանայիր	Future
ճողոպրեցինք	Past
պարգեւեք	Future
ծոծրակից	None
կզտեն	Future
կքեցին	Past
խեթացի	Past
լավագույնների	None
կխռմփաս	Future
չհավատամ	Future
բուծեին	Future
չարորեցի	Past
չսխալվեցիր	Past
երիցս	None
կբարբառեիր	Future
չագուցավորեիր	Future
վերադառնային	Future
չեռացիք	Past
ոգեր	Future
աղքատներ	None
չսազաց	Past
կտռեիք	Future
մալարիային	None
չհողդողդես	Future
քերծում	None
չկծեցինք	Past
կոսմոպոլիտներ	None
չգանգրացվեցիք	Past
ձեթերիդ	None
կծածկեն	Future
չխայթեցին	Past
վճարել	None
խոհեմ	None
յուղը	None
չգոյանաք	Future
վանկեմ	Future
կարօտէին	Future
արտասանություն	None
ծիլերի	None
չկռկռաց	Past
ապիկը	None
կցավայիր	Future
հայտ	None
ապստամբեր	Future
չհպարտացար	Past
չուրանա	Future
բզզա	Future
լողակների	None
գրառեին	Future
կապաշխարեիք	Future
հմայելու	None
պատյանի	None
կվառվեիր	Future
կնավեին	Future
չխոպոպվեցիր	Past
չտրոհեն	Future
չեմպիոնից	None
բղավեցին	Past
գրադարձեցիր	Past
չործկա	Future
երկրպագուներ	None
մարտնչեցինք	Past
ֆլեյտաներ	None
կհորդորեիր	Future
սննդով	None
չհաճեն	Future
կկատարեմ	Future
էլեկտրոդը	None
ցուրտի	None
տեղեկացրին	Past
բարդություն	None
դատարաններին	None
ավիաընկերությունների	None
կխռմփա	Future
վալսի	None
բուսնեցի	Past
էլեկտրոնի	None
չխոստանան	Future
չբռնաբարեցին	Past
կորեր	Future
ագարակացնեմ	Future
կփայլունացվեիր	Future
բալետս	None
չհեգեք	Future
կերկայնանային	Future
կկրի	Future
ուժեղանում	None
վճարի	Future
չդրդես	Future
չահազանգեցին	Past
գանգրանանք	Future
կխորովեին	Future
տառապանքներ	None
չքերծեցին	Past
աբսորբեք	Future
անկանեցի	Past
մոլ	Past
ապիկիներս	None
հառում	None
չապշեի	Future
կհածեք	Future
չցանկանայինք	Future
վախեցիր	Past
գլեմ	Future
վռնդեինք	Future
պայմանավորվենք	Future
ֆերմիոններ	None
շիթերը	None
չխոպոպեիք	Future
չկտցեր	Future
հաթաթաներիդ	None
շպռտեցիք	Past
կոչեն	Future
չափի	Future
հաճ	Past
ըղձացիր	Past
հիասթափվեց	Past
փարոս	None
սեզեր	None
չբավարարեց	Past
կարոտեցի	Past
պարզում	None
կեչուան	None
թվարկեք	Future
չօթեցի	Past
ճամփորդ	Past
ամսագրերիս	None
պահածոյանան	Future
պարուհիները	None
կոնֆետի	None
չճամփորդենք	Future
կվրդովվենք	Future
կքրթմնջայինք	Future
կխմբագրեն	Future
հայտարար	Past
տարբերող	None
բաներ	Future
ծղրտան	Future
կաշխատեմ	Future
հանգստանար	Future
արքաների	None
չկառչեցիր	Past
կխթենք	Future
համակարգեր	Future
թարխուններովս	None
սացիվի	None
բանեցներ	Future
սիգար	Future
թոքերից	None
արագացմանը	None
կձգտենք	Future
կատար	Past
արթնացա	Past
չուռթացա	Past
հաստատ	Past
արաբ	None
թուրքերենի	None
մանանեխ	None
կանխեն	Future
չշաչեին	Future
փորեի	Future
կաղարտեր	Future
ընթանային	Future
շինարարիցս	None
կխոխոջայի	Future
ծավալից	None
չվրդովեցինք	Past
չզետեղեիր	Future
ստեին	Future
կհասցնեմ	Future
չկտղի	Future
հատկացնի	Future
հապավումներից	None
փորի	Future
հարգեն	Future
կճմռեի	Future
կզննեիք	Future
չորոճեցին	Past
չհրեք	Future
լրացումների	None
կեղեքեր	Future
նիոբիում	None
ունկնդրեիք	Future
զգուշաց	Past
վռնդում	None
կհուսահատվեին	Future
կծեփեի	Future
վարանեք	Future
համոզեցինք	Past
սրճի	Future
չբեկանեիր	Future
մեծանա	Future
արտաքսեցին	Past
նպաստելու	None
ընտրվեցին	Past
նիշի	None
էրիկի	None
թռնենք	Future
ավազակները	None
ուրդուի	None
չկարօտէր	Future
երթան	Future
փչեց	Past
կկանխագրես	Future
չհանգստանայիք	Future
չփրփրայի	Future
նորոգ	None
մետաղով	None
բուսանեն	Future
կթռնեինք	Future
չմտադրվեցիր	Past
հրեցին	Past
հայտարարեինք	Future
չհուսահատեցնեինք	Future
չափենք	Future
վերընթերցեի	Future
քաղցկեղից	None
կրոններ	None
ստորագրի	Future
չտեւեց	Past
կհյուսի	Future
ուռչեիր	Future
նախագահությունների	None
չխրոխտանաս	Future
հոտի	Future
հապավումներով	None
թաթը	None
չառերեսվեցին	Past
թոռոմեի	Future
ուլունքները	None
չճաքեք	Future
չապահովանան	Future
տառապի	Future
ցանկապատ	None
կշնորհի	Future
գերմաներեն	None
որբացել	None
չհյուծես	Future
քննեց	Past
չհորդեի	Future
նախասրտերի	None
վտանգին	None
թիթեռներով	None
մատենագիրներից	None
չչաղացաք	Past
սխալվեց	Past
այգեստանը	None
զավթեցիք	Past
սառնարան	None
վարազի	None
չվաճառեցի	Past
օծեի	Future
մատնություններում	None
փայլունանան	Future
ղեկավարի	None
ակնածալիցները	None
դարսեին	Future
հորեղբայրը	None
կկշռեիք	Future
չմերձենայինք	Future
խաղաթղթերը	None
չաղաս	Future
հնարը	None
վախենար	Future
դաշնակցականների	None
սրճարանատերերից	None
կաճեի	Future
չխածատեք	Future
կճամփեք	Future
կրկեսի	None
կոչեցին	Past
չզտեի	Future
մօտեցան	Past
հեծեծեցիք	Past
տնտես	None
քերականագետ	None
գլխագիրը	None
չնքողեիք	Future
սավառնեք	Future
դրվատեց	Past
կլիմայով	None
կասկածեց	Past
կզեղեի	Future
կխափանեիք	Future
չվերադարձանք	Past
չխածատեցիք	Past
կնավեինք	Future
փորձեց	Past
չագուցանեն	Future
կողպեիք	Future
հագնեք	Future
չքցես	Future
դատարկ	Past
ոսկեհուռներս	None
գողանա	Future
կպագնի	Future
չկողպեինք	Future
չաճեցի	Past
չշփոթվեք	Future
աջակցեցին	Past
հեռուստատեսություն	None
հրճվեք	Future
չշպռտեիք	Future
տանջել	None
փոխանակեց	Past
արտագաղթեի	Future
կազմություն	None
երկյուղում	None
չհառեն	Future
արածի	Future
չուղարկեցին	Past
տեղեկատուի	None
ահազանգ	Past
դիսպրոզիումը	None
չընդգծեին	Future
հասցեներով	None
սաղմին	None
չաղերսեցին	Past
ոստիկանությունում	None
մարտնչի	Future
կուսուցանեմ	Future
երաստանքում	None
արականներումդ	None
ագարականացին	Past
հնանայի	Future
համաներումովս	None
պողոտաներից	None
կործանեց	Past
չզղջայիր	Future
խաչով	None
չավանդեին	Future
չհպատակվեցիր	Past
նահանգում	None
հատենք	Future
քրտներ	Future
ցախում	None
կոլոլիկում	None
փարթամանայիր	Future
կռանում	None
չոլորեցինք	Past
քոչ	Past
չքերծեիք	Future
տոկայինք	Future
կանզգայացվեր	Future
թրեյլերը	None
անշուքներովս	None
կգիշատեիր	Future
չհատկացնենք	Future
զեղծենք	Future
կայցելեն	Future
մրցավարին	None
կանիծեն	Future
բարբառեցին	Past
ալքիմիկոս	None
խորենացուն	None
հասկացան	Past
զգածվեցի	Past
լվացել	None
բանականությամբ	None
չսարսափեցիք	Past
կմխիթարի	Future
չարտասվեցինք	Past
լքյալ	None
չհետազոտեցիք	Past
սկզբունքի	None
չգարշեիր	Future
չմարթենք	Future
տեսարան	None
փաստաթղթին	None
ինքնահավանեցինք	Past
կարձագանքի	Future
կղբենիս	None
բացատրեց	Past
չմոռանանք	Future
կվերծանեք	Future
չթքեիր	Future
կնվագեր	Future
չսնգուրեցին	Past
կմոռանանք	Future
արտագաղթ	Past
աղան	Future
կառավարի	Future
կհեգներ	Future
չփրփրեն	Future
տենդ	None
չվերագրի	Future
ածանց	Past
ազդեինք	Future
ճաշեմ	Future
չհետազոտեք	Future
նվագեք	Future
կողքերին	None
կկարօտէք	Future
վնասվածքներից	None
չափարներ	None
վարագույրը	None
կանխեց	Past
կատակես	Future
աճեցին	Past
ձագեր	None
դարավանդներով	None
չմեծաբանեցինք	Past
կխարխլեիք	Future
ակնոցների	None
հառներ	Future
տրոմբոնի	None
հոգար	Future
կդարսեն	Future
ավիաընկերությունը	None
չկիսեին	Future
ձվաբջիջը	None
ճախրեց	Past
կծծեինք	Future
կպաշտենք	Future
խարույկի	None
հակասեմականության	None
կհետազոտեր	Future
շրջվեցի	Past
կարկանի	Future
կվաներ	Future
խթանեց	Past
բեկան	Past
փարոսների	None
չչարաշահեր	Future
չշտապեիք	Future
արքայազնին	None
կօգտագործեն	Future
մուրուքներով	None
փորոքների	None
կարծր	None
բավարար	Past
աքսոր	Past
որոշումներում	None
պիրենեյան	None
աշտարակները	None
չշռեն	Future
վճարեն	Future
կշտկեմ	Future
ալբաներենում	None
գողացավ	Past
մալի	Future
կանիծեմ	Future
զանգես	Future
չփութան	Future
զատեն	Future
կնեխեիք	Future
չենթարկես	Future
բացականչությունները	None
ներբեռնեց	Past
բրուցելոզի	None
տուբերկուլոզով	None
պարգեւեց	Past
ռեակցիաներից	None
կեղեքես	Future
թլվատ	Past
կատարեցին	Past
կերտես	Future
կախեցին	Past
մոլեիք	Future
հեղեղենք	Future
շարժվեին	Future
չբուսանեմ	Future
սփռ	Past
պաճուճաբանություններովդ	None
կվերընթերցենք	Future
պատկերեց	Past
կկոճկեն	Future
ծառայեր	Future
շաչեց	Past
խորխեմ	Future
կփութացնենք	Future
դեղաբույսերից	None
չտարբերեն	Future
հատած	None
չսփոփեմ	Future
կսառչեմ	Future
փոխանակեինք	Future
շփ	Past
չընդգծեցին	Past
լրթանային	Future
մագլցեի	Future
փնտրեին	Future
աճեցնեինք	Future
թարգմանություններովդ	None
վարի	Future
ակոսում	None
չդողամ	Future
կհառեն	Future
չփնտրեն	Future
աքսորվեին	Future
անզգայացր	Past
կազմակերպեն	Future
սուզեի	Future
իսլամի	None
կամաց	None
բավարարեց	Past
շարունակ	Past
չմերձենայիք	Future
չաղանաս	Future
հարգել	None
ջազվեով	None
գլորի	Future
կտնօրինեի	Future
անձրեւ	Past
չապահովացնեինք	Future
մարմարները	None
կխնկեիք	Future
պտղաբեր	None
կխռթացնեն	Future
հղփանային	Future
խանձատեիր	Future
կարծեցիր	Past
հաստատեմ	Future
փքվեմ	Future
կըղձա	Future
զեղծեցին	Past
չմատչեինք	Future
փռշտացին	Past
բվեճը	None
բետոններ	None
կվհատեցնի	Future
չփոխհատուցեմ	Future
կայմերումդ	None
հաստատեցին	Past
կհազա	Future
չընթեռնեց	Past
ծավալները	None
չհառաչեցին	Past
օրհնեին	Future
չկկեր	Future
կքցեք	Future
կլուծեինք	Future
չաներկյուղանամ	Future
քննարկեցին	Past
թաթուլովս	None
աստվածաբանությունը	None
խեթայինք	Future
վարժություններով	None
սառցադաշտեր	None
ֆրանսիացիներից	None
ագուցահանեցինք	Past
կաճի	Future
չհագեցնեի	Future
կզվարճացնեք	Future
կմղձկեն	Future
կկատաղես	Future
կարոտեցիր	Past
ծծում	None
զննես	Future
կտպեիր	Future
գործարկեց	Past
թիթեղը	None
ծնվեինք	Future
չկտցեցինք	Past
ջղայնացնեիր	Future
ներկայացնենք	Future
գոյացա	Past
շվեդականից	None
հատիկներից	None
կճեմի	Future
տարբերի	Future
բարձր	None
աստատը	None
ոստիկանի	None
չծնես	Future
չթրմեն	Future
չդրսեւորեցինք	Past
ստորագրեցին	Past
չաճեր	Future
երնջակի	None
չհամաձայնեցիր	Past
չմոռանա	Future
կնպաստեիր	Future
չչաղանաք	Future
չբարեւեին	Future
ագուցեցիր	Past
կալեց	Past
ընթերցման	None
տեղեկացնեի	Future
աղատեցի	Past
դալարուտդ	None
լրտես	Past
չվիճի	Future
հոշոտում	None
կծղրտամ	Future
պատրանք	None
կքաղցեր	Future
չվերադարձա	Past
սազեցին	Past
հրահր	Past
չքորենք	Future
չթաղեին	Future
գիի	None
լաստանավդ	None
սպանենք	Future
չքուներ	Future
սեռերից	None
չթաղող	None
վերընթերցենք	Future
շնաձկան	None
նեյտրոններով	None
գավազանների	None
ծերակույտ	None
օկցիտանայումդ	None
հնչյուններից	None
ար	None
կթլփատեն	Future
չգիշատեցին	Past
կտակարանովս	None
երաժշտությամբ	None
պրակրիտի	None
խորովեն	Future
քարշեցին	Past
ճկեցի	Past
արգելոցը	None
հառեցի	Past
աղայինք	Future
կմարտնչենք	Future
բանականովդ	None
չհնանայիր	Future
հուլիսյան	None
չածեմ	Future
կբացատրի	Future
ահաբեկվեիր	Future
սոուլը	None
մրջյուններով	None
կշռադատեի	Future
ճամփի	Future
կերով	None
ծղրտայիր	Future
սառ	Past
չմաքրեցիր	Past
կսարսափեի	Future
վխտայի	Future
կարենք	Future
սարսափներ	None
չերկայնեցիր	Past
հիմարները	None
չբուծեն	Future
մօտեցաւ	Past
մետրոպոլիտենում	None
կոտորածներին	None
աքսորվեց	Past
կխրոխտանայիք	Future
գաղափարագրերը	None
օժանդակեցիք	Past
կարորես	Future
ամբողջ	None
ուսումնասիրեր	Future
կփորձեմ	Future
սիրուէինք	Future
կտկռեին	Future
չհարգեցի	Past
միացավ	Past
կծլեր	Future
հազան	Future
լանչ	None
չպաշտեր	Future
գրանիտներում	None
կբխեինք	Future
չահաբեկեք	Future
կարենանք	Future
տափաստաններով	None
կներկայացներ	Future
չորացնեին	Future
գողանար	Future
շատանան	Future
բասկերենիդ	None
կհամեր	Future
մարգագետիններ	None
չսնգուրեիք	Future
մոռանար	Future
երգեցիկների	None
չերդվեին	Future
կխրոխտայիր	Future
կճոռոմաբանեն	Future
ամսագրեր	None
լվացվեիք	Future
չգլեց	Past
ինքնաթիռներում	None
գանգրացրեց	Past
փայլակ	None
հորդեց	Past
կեչուսներդ	None
սազան	Future
կխրախուսեն	Future
կգգվես	Future
ախտորոշել	None
դրսեւորվես	Future
հալած	Past
ամբարտավանեցիր	Past
հայտարարեցին	Past
կիրառեց	Past
խռմփոցներով	None
կխնչեն	Future
գնել	None
կհեռեի	Future
աղանդերներումս	None
մրցանակի	None
ժանրեր	None
մնջախաղի	None
կհպարտանայինք	Future
չսրճես	Future
գիտակցականի	None
շփենք	Future
փնտրեցի	Past
կսլանայիք	Future
կընտրվեի	Future
նախանձեիր	Future
պճեղ	None
կմեկնի	Future
չխնչեր	Future
ամոթույքում	None
կպայմանավորվեիք	Future
բարիումներ	None
չհառեցիք	Past
կբնորոշեինք	Future
անիոններիս	None
հաճույքներին	None
ագռավացավ	Past
չբարեւեր	Future
գնեցի	Past
թոռոմեցի	Past
անիծեինք	Future
ուսանողների	None
չընկճեր	Future
տարածեն	Future
կծենք	Future
ներգաղթյալների	None
համարեի	Future
գանգրենաները	None
ջանացին	Past
պատրանքներից	None
հայուհիներ	None
կանխի	Future
սերմերում	None
բլթակները	None
տառադարձեց	Past
ստի	Future
կուռթի	Future
հարնչեին	Future
չներկայացրի	Past
կորբանանք	Future
կարեր	Future
սավառնել	None
չկիրառեմ	Future
դողան	Future
ձողերից	None
հրետանուց	None
պետությանը	None
կթլվատեիր	Future
թալիում	None
կասկածեք	Future
փախցնենք	Future
չագահեին	Future
ողբերի	None
զեն	Past
երեխան	None
կագարականայինք	Future
արքաները	None
կգնահատեին	Future
կկծեմ	Future
խմբագրում	None
ազդանշանները	None
հրամաններին	None
չփրփրացիր	Past
ավանդեմ	Future
խթեր	Future
վառվեիք	Future
նախագահությանը	None
վանեմ	Future
հմայեց	Past
վաճառեց	Past
կոտրեր	Future
սեղանապետով	None
զգացմունքով	None
կանչեն	Future
գործադուլին	None
սիգի	None
կկ	Past
եզակիի	None
ապացուցած	None
կհարենք	Future
խարխլեցիք	Past
պագնեի	Future
իշխան	None
կունկնդրեին	Future
կթովեին	Future
սալորենուց	None
չորոճեի	Future
կտղ	Past
վայելեին	Future
գուրա	Future
կարածեն	Future
վիներ	None
տարվի	Future
պաշտոնյաները	None
չկռնչացիր	Past
սառույցները	None
տեսախցիկների	None
կրակեցին	Past
չուրախացրեց	Past
կահագնանայինք	Future
հանվեին	Future
արատները	None
կեռա	Future
կամուսնացնի	Future
չաբստրահվեցի	Past
չստամբակեք	Future
չմիանանք	Future
կբարբաջեիր	Future
կատարելիս	None
թութունի	None
կայցելի	Future
կաթոդի	None
կծիծաղաս	Future
չու	None
խմ	Past
լկստեիր	Future
հուռթանային	Future
հատեմ	Future
հղումներից	None
ապացուցվեց	Past
մարզիկ	None
թերակղզի	None
կծիծաղան	Future
կսրտառեի	Future
փոխանակեցի	Past
չզննեցիր	Past
զանգեց	Past
կալվածքներից	None
ցեմենտ	None
կաճեցնի	Future
քրթմնջաք	Future
չկկեցին	Past
կսանրվեմ	Future
կապացուցվեն	Future
չամչիցդ	None
համախոհները	None
բահով	None
կկանխեիր	Future
չզեռաց	Past
հանդիսականները	None
հանդիսավորներումս	None
պահպանեցին	Past
ճատրակ	None
կլրջանայիք	Future
ճուտ	None
վախեցան	Past
կծնգցնես	Future
հաշվառմամբ	None
ազդանշան	None
կքորեր	Future
կծափահարեն	Future
չբողբոջենք	Future
վեճի	None
անկումը	None
հոխորտացինք	Past
չգայթակղեցիր	Past
անձեռոցիկ	None
կստամբակեինք	Future
ընկճեց	Past
պահպանենք	Future
կգելեր	Future
կբաժանվեն	Future
չաղավաղեցին	Past
թափվելիս	None
չքչքչա	Future
բդկ	Past
մեներգերը	None
չսառչեիր	Future
անձրեւի	Future
դիեի	Future
հայի	Future
չսարսափի	Future
կտեղեկացնեմ	Future
կհամաձայնեին	Future
աղյուսակ	None
կամարին	None
մաղթեցին	Past
հարկաներ	Future
փորձեցին	Past
ձորս	None
չպապանձվեց	Past
չծնգցրած	None
հելնես	Future
կուռթանային	Future
ուրացավ	Past
չքշեն	Future
չեփեցիք	Past
կանխամտածվեց	Past
կծափահարեի	Future
ինքնաշարժը	None
արորեինք	Future
ծնեց	Past
չափանիշը	None
բնորոշեի	Future
օժանդակեցիր	Past
չկազմակերպեց	Past
էթան	Future
մտմտային	Future
առերեսվես	Future
ծիրանը	None
համբուրվեմ	Future
մայ	Past
ծնվի	Future
սանրվեն	Future
հասցներ	Future
ցանկանա	Future
չխռմփամ	Future
կվերադառնայի	Future
կուղեկցես	Future
ենթակայի	None
չհալածենք	Future
չկենդանանայիք	Future
հարսնացնեք	Future
ժանրերից	None
ամնիստիայում	None
անցում	None
կփչեի	Future
ժանրերի	None
կիրառի	Future
խածնեի	Future
օթեցի	Past
կկանխի	Future
քրդերենը	None
կմոռանամ	Future
չհիացանք	Past
քսակներում	None
կվիճաբանեմ	Future
կհամոզեիր	Future
չակնածեին	Future
հրճվենք	Future
փորձեցի	Past
քարայրում	None
կտառադարձեին	Future
գիտակցվեցին	Past
ֆիլմի	None
էներգիա	None
կխոցոտեմ	Future
պաշտեր	Future
չինականից	None
կզեղծեինք	Future
չգերծեիք	Future
կարածեցնեն	Future
չդրսեւորվենք	Future
ջղայնացնեի	Future
կմագլցեմ	Future
չգիտակցվեն	Future
ստամբակեց	Past
ծպտեցիք	Past
պահապանը	None
կձաղկեինք	Future
ամբարտավանես	Future
հասկացար	Past
քունեն	Future
բորբոքմանը	None
կատարեին	Future
կհարկանեիք	Future
ընդգծի	Future
նախաճաշ	Past
կբուսնի	Future
լքնեն	Future
խոցի	Future
կկտակեին	Future
երդվ	Past
սեզոնից	None
հասուններից	None
կայաններից	None
ազերիների	None
ճառերով	None
հովիտներով	None
չխթանեցին	Past
գրառել	None
մարերի	None
շղթայիցդ	None
հարգեցին	Past
նմաններին	None
արվարձանի	None
կվերադառնա	Future
հայտարարեց	Past
գործարկեիք	Future
հարսնացնի	Future
չներքինացնեի	Future
կջանամ	Future
շիջեց	Past
եզակին	None
չկալնեիր	Future
բուրժուազիա	None
չահաբեկեցիք	Past
չփութային	Future
կարոտի	Future
ուտեստը	None
ընձուղտ	None
կախարդում	None
չործկայիք	Future
չերդվեցիք	Past
սանձ	Past
միացան	Past
չհայթայթեի	Future
չքծնեց	Past
աղեղնավորների	None
կռկռայիք	Future
պարիսպներին	None
տարակուսեմ	Future
կկկեինք	Future
չարկեն	Future
մահանան	Future
լեղիներումդ	None
ցելերը	None
ներկայացնող	None
մալարիայիցս	None
թով	Past
հայցեր	Future
ավելացրին	Past
մղի	Future
ներգաղթեին	Future
հունից	None
չնեխեց	Past
ցեմենտի	None
մոտեցրեց	Past
լափ	Past
ցավային	Future
չփողոտի	Future
չքծնես	Future
սաստիկ	None
բաժանվեր	Future
չհիանեինք	Future
չսպանեինք	Future
չամբարտավանացան	Past
գլեի	Future
չխեթկեին	Future
չխոյանայիր	Future
կծառայեն	Future
էլեկտրոլիզից	None
հորդի	Future
արձագանքեն	Future
ոսպնյակից	None
չկեղեքեցի	Past
գալակտիկաներիցս	None
հանրախանութներով	None
կտռզեիք	Future
գլդորեցի	Past
չխոպոպեմ	Future
ատոմում	None
ջեռուցես	Future
հռետորաբանություններիցս	None
բակում	None
կդարանակալեն	Future
միություններից	None
աճուրդից	None
ուրացել	None
չկործանեցիր	Past
կտուժի	Future
չնքողեինք	Future
ծանուցման	None
կանկանեինք	Future
կխնամեինք	Future
նախագահությամբ	None
հանճարին	None
մարթեն	Future
չպատառեի	Future
միություն	None
չսավառնեին	Future
աղատեինք	Future
կքունեիք	Future
կստիպի	Future
մահմեդականներ	None
խորը	None
ջուլհակ	None
մոռացավ	Past
խոխոջելիք	None
ծովագնաց	None
չաբստրահվեին	Future
կգողանան	Future
հեթանոսներին	None
վախերից	None
կերգիծեիք	Future
լուց	Past
կենդանանա	Future
չզղջաս	Future
չառկայծեր	Future
մատուռները	None
կծեին	Future
չկարեիք	Future
չզննեցինք	Past
զսպանակիցդ	None
կնեղանայիք	Future
բուսնեին	Future
չդատարկեմ	Future
գայլենիս	None
չխոպոպացվեց	Past
պատմվածքներիցս	None
սաղավարտներ	None
աշխատես	Future
ձեռին	None
հուռթիներիցս	None
ջերմաստիճանով	None
շաղախների	None
երկարությանը	None
կբեկտեիք	Future
չվհատեցիք	Past
հաշվիչը	None
ծեծդ	None
կկրծեն	Future
կր	Past
քաղաքական	None
նվագեց	Past
թլփատեի	Future
չտեւի	Future
չընկճեինք	Future
մատանուց	None
փաստաթղթերը	None
փայփայում	None
ապահովեցիք	Past
զատ	Past
համոզեն	Future
անթայրներին	None
հեծեծի	Future
կճամփես	Future
կփոխարինեինք	Future
չբեկանես	Future
ուկրաիներեն	None
արաբներից	None
չկռվեցիր	Past
մերկացավ	Past
կմիանամ	Future
չաճապարեք	Future
մանաթներումս	None
կմրցեին	Future
կախեց	Past
կմայեին	Future
ուսուցանեիր	Future
ոստայնը	None
վարեն	Future
կախի	Future
բարբարոսներ	None
կումիս	None
հանրապետություններում	None
կուսուցանեին	Future
հիմնավորեցին	Past
կշահագործեիր	Future
գլորեց	Past
սխալներով	None
չկառչեին	Future
սիրւէինք	Future
հույն	None
հոգեբանները	None
շպրտեցին	Past
կստեին	Future
սահմանենք	Future
կտարամիտեինք	Future
գործարքից	None
չսիրւէիր	Future
ուզենա	Future
տրամադրես	Future
տանջեի	Future
պահքի	None
խառնեմ	Future
չվերագրեցին	Past
արծաթը	None
հասկանա	Future
կպահածոյանանք	Future
չսադրենք	Future
կվերադառնար	Future
օրանգուտանին	None
չխոսայինք	Future
չերեւային	Future
հոբելյանների	None
բռնաբարեցիք	Past
վկայի	None
ազազեինք	Future
չմեղկացանք	Past
աղատես	Future
ածխածինը	None
կխածնեիք	Future
ամուսնալուծությունից	None
արձագանք	Past
խօսայիք	Future
բերբերների	None
կխօսէի	Future
չհաստեց	Past
գիտակցի	Future
չաճեցնեք	Future
դարպասումդ	None
անցյալից	None
չախտորոշեիր	Future
լծեցի	Past
վայելի	Future
ծպտեք	Future
չհեռեն	Future
գերու	None
չհայցենք	Future
լկստ	Past
կաբստրահի	Future
քաղցեցիք	Past
կյուրիում	None
չխոպոպացրեց	Past
չկործանեցիք	Past
հոտեր	Future
խորովի	Future
հիվանդագիններից	None
չագրեգատավորեցիք	Past
կեղեւի	None
այրվեր	Future
չմաքառեն	Future
կուզեք	Future
հարկադրեցին	Past
չուռեիր	Future
լիբիդոյի	None
բառացանկիդ	None
հովտի	None
հարկանեիք	Future
կէտեին	Future
ընգավ	Past
ահազանգումները	None
ստամբակեին	Future
չկատարեց	Past
մարզում	None
տարածություններով	None
սահմանի	Future
հատա	Past
կխոստանանք	Future
կհասցներ	Future
կցեց	Past
չընտրվեց	Past
չհերքվեցի	Past
արջառի	None
չեպերեի	Future
չվերագրեիր	Future
չչափեցի	Past
խեցգետիններ	None
չեզոքներիցս	None
աշտարակներից	None
կբաղբանջեն	Future
առածից	None
կստեք	Future
միանա	Future
կագուցավորեր	Future
կագուցվեն	Future
կքորեք	Future
թութակներ	None
չշաչի	Future
չմերկանա	Future
բրթեինք	Future
կզոդեինք	Future
մրցանակներից	None
չգոհանաս	Future
կդրդեինք	Future
էակները	None
չուրանայինք	Future
հարթուկներս	None
չգործարկեիք	Future
ընթացան	Past
չկարենանք	Future
գելի	Future
թոթովեց	Past
շնիկի	None
չառոգանենք	Future
վերծանեց	Past
ստիպեինք	Future
կհայթայթեին	Future
խոզանակով	None
բացառություն	None
ամուրին	None
կհարթուկես	Future
կեռան	Future
կհմայեիր	Future
բանաստեղծի	None
նեյտրինոներ	None
կհիասթափվենք	Future
կհատնես	Future
կռնչան	Future
չառերեսվեիր	Future
չքշեցիք	Past
կտեղեկացներ	Future
կհիրեն	Future
չտպեցիք	Past
կմղի	Future
հանվեն	Future
թուլացավ	Past
չամորձատի	Future
կոշկեղենիցդ	None
հալածանքը	None
չծափահարվի	Future
պտերները	None
չմտցնի	Future
կսրտառեինք	Future
չսրտառեք	Future
երդվեց	Past
խնկեցիք	Past
անձնագիր	None
կքայլեն	Future
բնագրին	None
չդարանակալեք	Future
կբանտարկեինք	Future
մերձեցար	Past
կծանուցեն	Future
որոճեցի	Past
սայթաք	Past
առաքեցիր	Past
բնակվեցիք	Past
օգտագործեր	Future
շիջուցանեցիր	Past
խոսացիր	Past
վրձնին	None
չանզգայացնեիր	Future
կմեծաբանես	Future
հաստատությունում	None
տարածեցի	Past
չհորջորջենք	Future
մաքրեցին	Past
չցանկանայիք	Future
դրսեւորեցինք	Past
քրտնեք	Future
կապվածության	None
չխարխլեց	Past
չծածկեց	Past
կհղանանք	Future
կշարժվի	Future
թզուկներ	None
աշխարհաբարին	None
աճով	None
կարօտի	Future
չպաճուճաբանեցինք	Past
պարգեւեցինք	Past
փշուրները	None
չխոթենք	Future
գգվենք	Future
չծպտեք	Future
չքաղցեիր	Future
կուսումնասիրեինք	Future
խոթեցի	Past
եղծանեմ	Future
կրոններում	None
սառնարաններովս	None
կսարսափի	Future
չտկռեցինք	Past
կապշեի	Future
չահաբեկեցինք	Past
խթանում	None
կկերակրենք	Future
հղումը	None
չանզգայացվեցին	Past
արտում	None
ընգնեք	Future
չչվեցի	Past
ռեստորանում	None
շքանշանին	None
առկայծենք	Future
կախարդ	Past
դրսեւորվեցին	Past
զննեց	Past
կռվեց	Past
երկնակամարի	None
չբուծեցիր	Past
չկարողացանք	Past
ջայլամները	None
թանգարաններից	None
երգիծեր	Future
չշիջուցանեիր	Future
ագրեգատավորենք	Future
հուսալքությունդ	None
կմօտենայիր	Future
պապայայից	None
կծածանես	Future
կատակերգություններում	None
ազդել	None
չվիճաբանեիք	Future
ասացվածք	None
նավահանգստում	None
մոլեր	Future
չափ	Past
ֆենի	None
չփարվեին	Future
քերծ	Past
չբանտարկեիր	Future
բողբոջի	Future
աճեց	Past
նացիստները	None
կզգածվեինք	Future
շտապեցինք	Past
հերոինի	None
կաքսորեմ	Future
պուրակից	None
հալածեիք	Future
վարձ	None
քարշեք	Future
տարածեինք	Future
կհայեմ	Future
խնձորիցդ	None
չընդելուզեք	Future
շատանային	Future
չուռչեի	Future
հեծաններ	None
չհղենայի	Future
բուրդը	None
կքննեին	Future
գնահատեց	Past
նպաստների	None
կագուցավորես	Future
կեղտոտ	Past
շիջուցանենք	Future
ներողության	None
փռթկացնեին	Future
չվերթների	None
հեռախոսին	None
չկոչեցին	Past
ռիսկերից	None
քաղաքականությանը	None
չթոթովեմ	Future
կկռկռաք	Future
եպերեցիք	Past
ապերախտներում	None
հիասթափվեք	Future
ստրկացրի	Past
կնգումներդ	None
չամբարտավանեցի	Past
հարսնանայիր	Future
չշպռտեիր	Future
աշտարակի	None
գլտորեին	Future
հարսնացրինք	Past
տափաստանը	None
հաշվից	None
չցանկանային	Future
կիզի	Future
ստուգեց	Past
չկրեց	Past
պատկանեն	Future
վաճառքների	None
չերկկտտացնեինք	Future
բավարարեր	Future
հազար	Future
թորիումի	None
երկբայ	Past
պանծացի	Past
արարով	None
ործկայիր	Future
ընտրվեր	Future
չքարոզեցին	Past
չնեխեցիք	Past
կհայտարարես	Future
մետրանոցներից	None
հարգեք	Future
քարանձավի	None
կհարթուկեիք	Future
նախադասությունը	None
գնդացիրը	None
քանդում	None
հղացավ	Past
չհատուցեմ	Future
տեգեր	None
շոկոլադը	None
կխռթացնեմ	Future
տնօրենը	None
չբողոքեիք	Future
շփոթ	Past
կայքին	None
գոյանան	Future
չսրտաշարժեցիք	Past
չխոթեինք	Future
ստեր	Future
չմրսեիր	Future
լքեն	Future
կզանգահարեի	Future
կլիանան	Future
կքավես	Future
ենթակառույցիցդ	None
բաժի	None
կհուսահատեցնեք	Future
բիզոնների	None
հածեք	Future
հղենամ	Future
ուռթացավ	Past
չկնքեցիք	Past
սպանեց	Past
չկարողանա	Future
ձախը	None
ապացուցեն	Future
քարավան	None
չհորջորջեցիր	Past
բաղբաջանքումդ	None
չկարենային	Future
չամբարտավանի	Future
չխռթացնեմ	Future
պատկանեմ	Future
չաղատեն	Future
տղամարդու	None
գոհարների	None
առակներին	None
հաճախորդը	None
կոմսերիցս	None
քելեն	Future
չհագեցնեինք	Future
չհանգեինք	Future
անհանգստանաք	Future
խայթում	None
արթնանան	Future
ծղրտացիք	Past
կագուցահանեիր	Future
կկիրառվենք	Future
կասկածների	None
չհրճվեիր	Future
չմիզես	Future
գգվեինք	Future
աշխատեցին	Past
կվճարեի	Future
ծնգցրինք	Past
չբաղբանջեցիր	Past
չհատաք	Past
կարեմ	Future
գյուտեր	None
չքավես	Future
չհուռթացա	Past
թռար	Past
արոր	Past
չափածոյի	None
փլատակից	None
ագահեցինք	Past
կթոտ	Past
ուրանային	Future
պայմանավորվեցինք	Past
չուղեկցեցինք	Past
ճակատագրերով	None
չծանուցեցի	Past
չընդարմացանք	Past
աբոնենտին	None
չխղճայիր	Future
օսլան	None
ճոռոմաբանեցիք	Past
սովորեք	Future
բարբառից	None
չգարշեցի	Past
չհեռեցի	Past
չկռթներ	Future
կպոռոտաբանեի	Future
չհաճեիք	Future
գիշատենք	Future
աթեիստները	None
մտցնենք	Future
հայտնեն	Future
կհատուցեմ	Future
կռնչի	Future
էղնեի	Future
կղզուցդ	None
բառնայի	Future
չարտասվի	Future
կոպեկ	None
ծնվեց	Past
կբառնաս	Future
սփռեի	Future
թորշոմեր	Future
չկարողանար	Future
տրցակեիր	Future
չտենչայիք	Future
օգտագործեցին	Past
չսրճեր	Future
սառցադաշտերով	None
դրդեցին	Past
հումքից	None
ագռավացա	Past
չկեղեն	Future
չազդեց	Past
հեն	Past
չգելես	Future
չընթեռնեիք	Future
շիջեինք	Future
չճոռոմախոսեցի	Past
կփարվեի	Future
չողբացիր	Past
համարեն	Future
պոռոտաբանեի	Future
նարնջի	None
չգոհանային	Future
կբնակվեիք	Future
բարիքներից	None
կողորմեի	Future
սորենք	Future
պագեցի	Past
գոհացնեմ	Future
աղաղակ	Past
չկանխեց	Past
կմատնեմ	Future
բուսնեի	Future
բիրմաներենի	None
տիեզերագնացը	None
չլիզեցիր	Past
կհայտարարեին	Future
թաղեց	Past
կիրառվի	Future
չտառապեցրինք	Past
կսգանք	Future
հայեցված	None
չվարեինք	Future
տեսքին	None
պարողների	None
չբավարարող	None
փականների	None
չգործարկեցին	Past
զրույցների	None
բողկի	None
զարմացրեց	Past
գիին	None
ըմբիշները	None
ջրաղաց	None
խորվաթական	None
զղջացիք	Past
չկռթնեին	Future
վարագույրիցս	None
կհմայենք	Future
գրաբար	None
չհագնվեցիր	Past
կքաքեիք	Future
գոչեց	Past
կիրառելիս	None
ապահով	Past
արտաքսեին	Future
կանչեց	Past
մարթեր	Future
բարձրաձայնես	Future
չկարողանանք	Future
չհեծնենք	Future
պրոմեթիումներից	None
չգովենք	Future
հիվանդանոցին	None
կգողանայիք	Future
վկայություններով	None
չքելեր	Future
ելից	None
չսնգուրեցինք	Past
կատակել	None
ոչնչացումիցդ	None
չգրգռեցիք	Past
խոհարարը	None
չհասկացավ	Past
սահմանես	Future
փռշտաս	Future
հավասարումներից	None
մտադրես	Future
նիստից	None
կճուճ	None
կսպանեմ	Future
անձնագրերը	None
թաթարների	None
չմեղանչեցիք	Past
կռվեք	Future
աղավաղեցինք	Past
չկատակեցին	Past
սգայինք	Future
բավարարեն	Future
հղեցա	Past
կլրտեսեինք	Future
կոնֆետներից	None
վագոնները	None
ռուբլի	None
չբարբառեիք	Future
կխթեր	Future
մտցրեց	Past
չգուրգուրա	Future
շուկայից	None
նեղացավ	Past
կգոյանային	Future
պարանոցով	None
կէթամ	Future
պարտիզպանովդ	None
հայտարարեն	Future
հնոցին	None
չծուլանայի	Future
չթրծեիր	Future
զանգահար	Past
կհղփանանք	Future
կճեն	Future
հայացքը	None
հղեցին	Past
չխանձեիք	Future
կոսմոպոլիտությունիցս	None
անորոշի	None
կռնչա	Future
զարմովդ	None
հուսահատվում	None
թր	Past
այցելությունները	None
բարելավեմ	Future
մեծաբանի	Future
չսորեցի	Past
չմիացա	Past
չաղոթեցին	Past
հարցազրույցների	None
չբուծեցինք	Past
կթարգմանեիր	Future
խարխլեցին	Past
կավանդեր	Future
համբուրեցինք	Past
խեղդեք	Future
խորվաթ	None
չաղաղակեց	Past
հագավ	Past
երեւակայությամբ	None
ուղեկցեց	Past
փոխարինեց	Past
իոնը	None
շնորհում	None
հագեցնող	None
հիասթափեցնի	Future
կռնչամ	Future
սերմնաբշտիկովս	None
կթարթեն	Future
հաճախ	Past
բոխի	None
ընտրվի	Future
ապարանցին	None
կագռավանար	Future
կսադրեինք	Future
կբնութագրի	Future
չթաղեցի	Past
անզգայացնեք	Future
ամեոբան	None
բնակվեցին	Past
չհուռթանան	Future
կներքինանաք	Future
կապացուցեին	Future
բողոք	Past
բարձրավանդակ	None
կուլտուրայի	None
չարձագանքեիր	Future
ավելացնեք	Future
գիտակցեց	Past
չկասկածեք	Future
վասալը	None
չոռոգես	Future
խորհում	None
կանգնեց	Past
չաշխատեք	Future
կագռավանայիք	Future
չկոճկեցինք	Past
չանձրեւեք	Future
գլեցին	Past
խունտայի	None
բացառվեմ	Future
չզարմացնես	Future
կնախաճաշեք	Future
չգնչեի	Future
չհարթուկեիք	Future
չգրառեին	Future
բակերով	None
խոպոպացնում	None
ընկուզենի	None
հառաչեցիք	Past
սազացիր	Past
կփայլունանայիր	Future
ալգորիթմում	None
կթաղեիր	Future
կընկղմենք	Future
պագենք	Future
չսիրվեմ	Future
եբրայեցիս	None
կորնչեի	Future
երկրաբանությանդ	None
տնտեսագետ	None
բանում	None
զոդեիր	Future
շպրտեի	Future
պարտվես	Future
ողնուղեղի	None
առակ	None
փորձեն	Future
կշահագործես	Future
չխորխեին	Future
կփարվեր	Future
չզխկտեցիք	Past
չթանան	Future
չդրսեւորեք	Future
մարտկոցներ	None
առաջնությունիցս	None
չզատի	Future
չկռկռացիք	Past
առաջարկությունը	None
հետազոտեցին	Past
չայցելեիր	Future
շնիկին	None
հավաքածուով	None
կհամակարգեիր	Future
կգեղգեղեին	Future
մրցեր	Future
ստուգաթերթիցս	None
չընդոստնեինք	Future
չհաճախի	Future
նկարում	None
միատոն	None
պատկերելիս	None
անասնաբույժների	None
թվանշանի	None
մատնեցին	Past
օրանգուտանգներ	None
աճեցնեին	Future
չկողպեիք	Future
կոշկոճեր	Future
մատուցեն	Future
մատնի	Future
չնետեցիր	Past
նորույթներին	None
չշնորհեր	Future
հորդես	Future
լավատես	None
կխածնի	Future
լիզեց	Past
իլիկ	None
զանգակը	None
փլի՛ր	None
չգիտակցեիք	Future
ապուխտիս	None
կկատարի	Future
գեղարդով	None
աղյուսակում	None
չծլեիր	Future
հեղեի	Future
կհամբերեր	Future
չզետեղես	Future
խածեցիր	Past
հանվեր	Future
սիգա	Future
կմխիթարեն	Future
կներխուժես	Future
չգանգրացաք	Past
շտկեցի	Past
ամերիկյան	None
կսանձենք	Future
կառկայծեմ	Future
ուսումնասիրի	Future
ժողովածուներ	None
փոթերի	None
պղնձի	None
սանրեի	Future
չճաշի	Future
թաղեր	Future
կգոյանաք	Future
կոչեց	Past
ընթանալ	None
կարկանեիր	Future
խոլերայից	None
սնգուրվես	Future
կբարելավեմ	Future
շնորհ	Past
որսացիք	Past
այցել	Past
կուզեին	Future
չհագնեիր	Future
կփռշտար	Future
թութ	None
լուծեց	Past
աշխատեց	Past
խօսէիք	Future
քամեմ	Future
չբանեցնենք	Future
չնեղացանք	Past
չխնամեն	Future
չկախեն	Future
չքարշեն	Future
չվախեցին	Past
չգովեցի	Past
կինքնահավանի	Future
չծնգցնեիր	Future
չհայթայթեինք	Future
բզզացի	Past
աճ	Past
հարեց	Past
ազազի	Future
նավեր	Future
չփրթես	Future
զանգահարեց	Past
սանրը	None
ենթարկող	None
աղավաղեիք	Future
ուղարկեցի	Past
վագոններ	None
սպիրտներ	None
պատրաստեր	Future
քննարկես	Future
չփրթեինք	Future
չագուցանեցիք	Past
խորհրդանշեց	Past
բնակչությանը	None
հանգեցիք	Past
պաշտամունքը	None
կհանվի	Future
մրսենք	Future
չպարապեց	Past
խոխոջեին	Future
չկարողացան	Past
չքավեն	Future
վաճառեն	Future
զրուցեց	Past
չխազեն	Future
արտաքսելու	None
հուզեր	Future
մտաբերեցի	Past
կեռաս	Future
բացատրեմ	Future
հանվենք	Future
փերուցդ	None
երգչուհիներից	None
հասարակածով	None
կոպեկիս	None
վնասվածքներով	None
չշնորհի	Future
մանրէ	None
կարծեք	Future
վեզիրին	None
լվանար	Future
ճոռոմախոսի	Future
իոններին	None
հած	Past
զորքերը	None
կկոճկեի	Future
կեռայիր	Future
ապարանքը	None
չարթնանայի	Future
բանտարկեցի	Past
կբանեցնեմ	Future
կամայանամ	Future
չշողացիր	Past
սրճեցի	Past
ազազեն	Future
լողավազան	None
կառուցվածքներով	None
կվերադառնան	Future
չբնակվեիք	Future
միջադիրների	None
ջերմությանը	None
կծեր	Future
ինքնահավանեցիք	Past
չվերընթերցեցինք	Past
չմագլցեին	Future
չհամենար	Future
պեղեց	Past
կատիոնի	None
կոկոսյան	None
թաղանթներով	None
առերես	Past
չներքինացնեինք	Future
չհուսալքեի	Future
հումքերում	None
չկքեին	Future
չաբստրահեիր	Future
կողմանոցներդ	None
կհիրեր	Future
ցեմենտով	None
կմիացնեինք	Future
թանա	Future
կարձագանքես	Future
շեշտեցիք	Past
ծովափղերի	None
բարբառի	Future
մենամարտերը	None
չաշխատեց	Past
չկրեիք	Future
չածանցեիր	Future
շնորհքը	None
հայեցակարգի	None
մահանա	Future
կագահանայիր	Future
հավատների	None
չշփեի	Future
չառերեսեցիք	Past
հայեց	Past
վերադառնա	Future
շպռտեին	Future
լաստանավով	None
նախընտրեցին	Past
մեծի	None
առանցքին	None
վերընթերցեիք	Future
գն	Past
փողոտեցիր	Past
ներկայացնեմ	Future
չթռնեիք	Future
տեսնային	Future
փռշտացիր	Past
սաղլամից	None
ուղարկեցին	Past
կզենի	Future
կոռոգես	Future
կզգուշանային	Future
քարից	None
կոշկակարիցդ	None
կահաբեկեի	Future
չկարոտեցիք	Past
կսանձես	Future
վայելքի	None
չվանեցին	Past
լիացե՛ք	None
անդյաներս	None
սազեր	Future
ուսումնասիրենք	Future
հագեցիր	Past
կկտակեն	Future
աղախինը	None
կբաղբաջես	Future
քամեինք	Future
ալեկոծ	Past
կգլտորեինք	Future
կզգենայինք	Future
ցինկում	None
աղաղակների	None
չխոստանային	Future
հաճախեցր	Past
կնեխես	Future
կզխկտես	Future
մալեր	Future
չմագլցի	Future
թզենին	None
կտարամիտեն	Future
չներխուժես	Future
գլտորեց	Past
ճակատագիր	None
կարողանար	Future
չձաղկեցին	Past
տպեցիր	Past
գայթակղեք	Future
ագռավանա	Future
Գարեգինը	None
չքերի	Future
չբարբաջող	None
կսպանես	Future
կցանկանար	Future
խոթեց	Past
մեծարեմ	Future
մերձավորներից	None
չգողացավ	Past
երթային	Future
կրեցին	Past
չհորդորեինք	Future
չվխտայի	Future
խազի	Future
թրջ	Past
կփայլունանայի	Future
ծիծաղացիք	Past
մտածողը	None
մերկանան	Future
կհետազոտենք	Future
գեշեր	None
կորի	Future
կփայլունացնենք	Future
մատուցես	Future
կչորանայի	Future
շիկանայի	Future
թուլանամ	Future
ասպազենքիցդ	None
տառապեցրինք	Past
վարազներս	None
պաշտոնների	None
ծածկեցին	Past
հայհոյեիք	Future
քննելու	None
կմահանաք	Future
չաղոթեր	Future
չհարկանեին	Future
բացառեց	Past
հումուսներովդ	None
կհեղեն	Future
համար	Past
պառկի	Future
չկենդանանամ	Future
բլղուրապուրում	None
մտմտամ	Future
մերկանա	Future
ընկղմ	Past
բեկանեցին	Past
մեծաց	Past
չուզենային	Future
կարգահատենք	Future
չմարտնչեք	Future
կվռնդեիք	Future
կթուլանայիք	Future
չզխկտեիք	Future
կբացառվենք	Future
բնաբանը	None
ուռ	Past
չբավարարեիր	Future
փողկապով	None
շպրտում	None
գործընկերոջը	None
քոր	Past
քոչում	None
չորսաս	Future
կմիացնի	Future
ֆիններ	None
մատուցելու	None
կփսխենք	Future
մորուս	None
վճարեին	Future
ցնծացինք	Past
սեպտեմբերից	None
կառերեսվեիր	Future
պատառեին	Future
չստամբակեի	Future
մարտակառք	None
կնեղանան	Future
բաժանվեց	Past
վրանը	None
կխրտնեմ	Future
սաղմոնների	None
չհնանար	Future
շենքեր	None
ամսագրերին	None
կուսաթաղանթդ	None
կկարմրեր	Future
տնտեսությամբ	None
ապացուցվեցին	Past
գովասաններով	None
տաղտկանանք	Future
կրծքանշան	None
սիրվեիք	Future
սպորտից	None
չկախարդվեցի	Past
կկատարեր	Future
կեռնեխը	None
ռեստորաններ	None
չզխկտենք	Future
շնչափողիդ	None
ջինս	None
ռեփ	None
կոնքերը	None
եռացինք	Past
չտառապեցրի	Past
կակաչի	None
չսիրուէինք	Future
կխնչեր	Future
զոդեինք	Future
կփոխարինի	Future
կարմրանաք	Future
կպատկանեինք	Future
նվա	Future
չխոյանան	Future
խօսացի	Past
նիկելի	None
կհարի	Future
չցուցանեիր	Future
վաներ	Future
խառնեցինք	Past
չգիտակցեցին	Past
կցտեիր	Future
կտրոնների	None
աղերս	Past
չնազեի	Future
թույն	None
մույթերի	None
երկկենցաղներով	None
բարձրաձայնեմ	Future
մաքառումը	None
չհարգեի	Future
կշտապեք	Future
չսանձահարեցի	Past
չվարաներ	Future
չհաճախեցնես	Future
ներգաղթեցի	Past
ներբեռնեք	Future
անբաններիս	None
հուսալքեիք	Future
կխայթեն	Future
ընկույզիդ	None
ասք	None
տրամադրվել	None
կբարելավեին	Future
հերթով	None
լողաց	Past
գնահատի	Future
չդիեք	Future
կառավարեն	Future
կբուսանի	Future
չարթնանային	Future
կխածատենք	Future
կփլվեն	Future
շփոթեցնեն	Future
հայեր	Future
արվեստով	None
տանտիրոջը	None
ընձուղտի	None
արձակուրդից	None
պատառ	Past
մրցույթներին	None
ուղարկի	Future
փրփրայի	Future
կքանդեն	Future
հյուսեն	Future
վերծաներ	Future
չշրջվեք	Future
երդվեցի	Past
սպարապետի	None
չքծնեի	Future
կնախաճաշեիր	Future
կգովեիք	Future
չվհատեցնեին	Future
չբողոքարկեցի	Past
կսփոփեք	Future
խոռոչներից	None
չկաշկանդեինք	Future
վճիտներով	None
էներգիաները	None
չշտապել	None
չտռեիք	Future
վարած	None
կզարթնեք	Future
նավեցինք	Past
կհարգեին	Future
կատիոնումդ	None
արոտների	None
շատով	None
հոտոտեինք	Future
ենթարկած	None
նպաստեց	Past
շտկեր	Future
մեկնեց	Past
ռեցենզիաներում	None
զենիթս	None
արգելոցները	None
չխոթեք	Future
կռացան	Past
կմոլեգնեինք	Future
փախնեին	Future
հետինը	None
շրջվեցին	Past
շարունակեն	Future
լորիկով	None
կմնչեիր	Future
ճակատագիրը	None
աղանդերումս	None
կկայանա	Future
կկալնի	Future
բնակվել	None
ստես	Future
հայագետը	None
էջի	None
ոգեմ	Future
օգտագործեք	Future
ապուրներ	None
զենիթներումս	None
սարավանդների	None
ջայլամը	None
ծաղկախտը	None
համալսարանի	None
մահանաս	Future
չօգտագործեց	Past
առյուծին	None
երիտասարդի	None
սարսափեիք	Future
կթարթի	Future
ծածկեն	Future
չկիսեիք	Future
մարտիկի	None
օգոստոսներով	None
չցավացի	Past
քելեին	Future
ցիկլոններ	None
կերդվեր	Future
լիբիդոյիս	None
կորնչ	Past
կթուլանաս	Future
չմաղթեցիր	Past
տարակուսենք	Future
կուռես	Future
ճեմասրահում	None
մխիթար	Past
եբրայերեն	None
չփորձեի	Future
լկստեք	Future
կտուրի	None
հեղուս	Past
պարտք	None
գեր	None
կկռանաք	Future
ընթերցումից	None
սիրելիս	None
հորջորջեիք	Future
հիվանդանոցից	None
խոխոջի	Future
փորեց	Past
կբաջաղես	Future
կհեծնեմ	Future
կատարենք	Future
չտուժեիր	Future
չկատակեցիր	Past
սղոցս	None
խոպոպացան	Past
կպահպանես	Future
չարածեն	Future
տեսնաս	Future
կողորմեմ	Future
կապաշխարեի	Future
նռնենին	None
ընթեռնեինք	Future
բավարարող	None
ուղեկցի	Future
լքեցին	Past
կբնութագրենք	Future
չճաշեցիր	Past
չքանդեր	Future
չբաղձանք	Future
չճմռեն	Future
ծափահարեցի	Past
չնքողենք	Future
արմավենին	None
տեքստերը	None
կփսխի	Future
շնագայլ	None
չխածատեմ	Future
հողմերի	None
մեծաբանեն	Future
չվիճեցիր	Past
կատակեցինք	Past
բառակապակցությունները	None
չուսուցանեք	Future
մայիսյանով	None
մտադրվեցինք	Past
կաջակցեինք	Future
բարբանջեց	Past
կհամարի	Future
հոլանեցինք	Past
ալյումինից	None
մարտնչեցին	Past
կխմբագրեիր	Future
չպապանձվեիք	Future
ազդ	Past
եպերեցիր	Past
նվաղեին	Future
պահապան	None
ներքինանայիք	Future
երեւում	None
հումքեր	None
չփսխեց	Past
հագնի	Future
կքանդենք	Future
չտառապեցնեի	Future
սառեինք	Future
կարմրի	Future
նեպտունիումումս	None
չշփոթվեի	Future
չհրեց	Past
հաստ	Past
չգանգրանային	Future
քաղաքականությունում	None
չկիրառեիր	Future
պատկանեիր	Future
օտարոտի	None
ալեկոծեր	Future
տրոհենք	Future
չհարսնանայի	Future
գեղգեղեիր	Future
հեղեն	Future
ծանուցեմ	Future
ապահովացար	Past
հենվել	None
կգիտակցի	Future
չխնամեք	Future
օգտագործվել	None
ծանուցենք	Future
տենդերի	None
սեղանապետ	None
ջանա	Future
չտարվեն	Future
կակնածեին	Future
քաջալերանքով	None
չնավեցին	Past
կշտապեիր	Future
հասկացանք	Past
չանզգայացնեք	Future
կթրծի	Future
սպասարկենք	Future
սադրեցին	Past
սադրեիք	Future
կհալեինք	Future
կարողացաք	Past
ռիսկը	None
կոլաժները	None
կձգտեիր	Future
վանկարկեցիք	Past
տարբեր	Past
չկանգնեիք	Future
կմատչեի	Future
մոխրին	None
կծառայի	Future
օգտագործեիր	Future
դպրոցականի	None
կծիծաղա	Future
չհղփանար	Future
չհիասթափվեցիք	Past
չմղի	Future
հեռացրի	Past
կկողպենք	Future
պապանձվելու	None
կզգուշանայի	Future
երկմտեն	Future
կթափվի	Future
մեղկանայի	Future
մկանովդ	None
չկողպես	Future
գորշից	None
սովորեցին	Past
կսպանեինք	Future
կհարսնացնեիք	Future
ապստամբների	None
լորիկներիդ	None
սպանախ	None
գել	Past
ընդելուզես	Future
ոգ	Past
ֆիզիկոս	None
չուսանեիք	Future
կհաճեմ	Future
պատմությանը	None
հավել	Past
քյոռ	None
բարելավեցին	Past
աքսորվեցի	Past
քել	Past
կհեգնեի	Future
կկնքեիք	Future
գնչեր	Future
փախավ	Past
կէտեի	Future
չանկանի	Future
բարիք	None
չճվատեին	Future
մարտնչեինք	Future
կաթսաներ	None
տնօրեն	None
միջադիրներին	None
ճեմասրահի	None
մոլեգնեցիր	Past
կուղեկցի	Future
ադամանդների	None
հարկանեցիր	Past
սումոն	None
կլուտայի	Future
կփայփայեիր	Future
մաքրեմ	Future
երթաս	Future
չհմայեր	Future
չմեծանայի	Future
աղավաղեի	Future
այցելեն	Future
երթանք	Future
շտկես	Future
քանակներով	None
տեսքում	None
ջանից	None
սանձեք	Future
չմահացավ	Past
առաջավորներ	None
կսրամտեին	Future
օժանդակեցի	Past
չբարձրաձայնեիք	Future
չվճարես	Future
ցնծություն	None
կջղայնացնեիր	Future
ծնկոսկրի	None
չերկբայի	Future
կծնվեք	Future
քորեն	Future
ընկղմեցինք	Past
հավատայի	Future
կխայթենք	Future
վոլֆրամներումս	None
գարշենք	Future
սրբուհի	None
ակադեմիայի	None
չնախընտրես	Future
կսսկվեն	Future
չգոհացրինք	Past
աքսորվեն	Future
խաժ	None
նեյտրինոների	None
շտկեցիր	Past
չծնենք	Future
ազդեն	Future
քաղաքում	None
պայծառ	None
կմրսենք	Future
չապացուցվեցիր	Past
չհարսնացնի	Future
մոռանա	Future
բնաբան	None
կգնահատի	Future
մաղթեց	Past
անթառամը	None
կշարունակեն	Future
բխի	Future
ստուգեն	Future
չմեղկանամ	Future
տանջ	Past
քեռեկիններովդ	None
չգոհանան	Future
կէտեր	Future
երեւան	Future
լիրը	None
համբուրեց	Past
չազազեին	Future
համոզեց	Past
հաճախի	Future
զավթ	Past
թրթուրներից	None
չխայթեմ	Future
կճոռոմաբանեին	Future
անձնագրեր	None
կվաճառի	Future
օծեինք	Future
կարողանային	Future
կխթանեիր	Future
կառկայծեինք	Future
հրապուրեց	Past
հնացաք	Past
չզեղծեին	Future
կհիասթափեցնենք	Future
տրամաբանությանը	None
ձաղկեինք	Future
չերգիծեցիր	Past
կառավարեցին	Past
կբուծեի	Future
կպեղեին	Future
կցորդիչները	None
բողոքարկեց	Past
հրի	Future
կկախարդվենք	Future
գիտակցեն	Future
կկաղկանձես	Future
միացրիր	Past
արբի	Future
լիզի	Future
կանաչումդ	None
ճմլեցի	Past
կխօսանք	Future
չկանխամտածվեց	Past
ուռչի	Future
չտպեցիր	Past
մարգարեության	None
կճամփորդեր	Future
ձմեռանոցներում	None
չխանձեցինք	Past
կփսխեմ	Future
գոռացիք	Past
չկրծեցիր	Past
չթորշոմեց	Past
չորացնում	None
ջանը	None
երկբայեց	Past
տատրակովս	None
կհրեիր	Future
չբարելավեց	Past
չգանգրվեի	Future
ողողվեցիք	Past
չծպտվեին	Future
չհաստատեցիր	Past
խոստանայիք	Future
խրոխտայինք	Future
կաշխատեն	Future
չհպարտանան	Future
խղճացին	Past
չկցես	Future
սովորեց	Past
աշուղիցս	None
ընթացավ	Past
չկշռեցին	Past
պարտեզի	None
չեռար	Future
երկայնեի	Future
փարթամագեղիցդ	None
ակնածալիցում	None
կկանխագրեն	Future
թթենու	None
կսփոփենք	Future
տառապեր	Future
չմածվես	Future
կագուցավորեմ	Future
ընդունակություն	None
կրեի	Future
իշխանները	None
նախաճաշեիք	Future
կփայլունանայիք	Future
տուժել	None
դայլայլեցին	Past
ստորագրեք	Future
ձվածեղներումդ	None
նվագող	None
ապահովվի	Future
գրգռեին	Future
ամսականը	None
որբանաս	Future
ագուցահանեն	Future
աներկյուղացար	Past
կխօսամ	Future
նահատակները	None
նշենին	None
չվռնդեցինք	Past
կբտեր	Future
չբզզացի	Past
մայրուղիներ	None
ծնգցնենք	Future
կպոռոտախոսեի	Future
կծլարձակենք	Future
սխալ	None
կշարժվեմ	Future
սիգայիք	Future
գլուխների	None
չձաղեի	Future
զրնգայիր	Future
ուղարկեն	Future
քայլից	None
պետությունից	None
թուլիում	None
չփչանայիր	Future
տեղեկատվությունից	None
հաճեց	Past
չթվարկեին	Future
խրճիթները	None
մոլորվեցիր	Past
չհրկիզեմ	Future
համոզի	Future
օդապարիկները	None
կզտեիր	Future
ճվատեինք	Future
անզգայանային	Future
հարնչեինք	Future
չքրթմնջացի	Past
չքորեցի	Past
ախտորոշեր	Future
սիգաք	Future
կաշկանդեր	Future
տանջվել	None
ցեղասպանությանը	None
կկալես	Future
ագուցահանեք	Future
հայլի	None
մրմնջացիք	Past
չպաճուճաբաներ	Future
հապավումներիցս	None
կրեիր	Future
կօժանդակեք	Future
կփոխհատուցեինք	Future
հավելի	Future
կկաղկանձեր	Future
գլյուոնը	None
չառերեսվեցի	Past
կնպաստեր	Future
չզխկտես	Future
ծանուց	Past
չավելացնեինք	Future
չխոչընդոտեց	Past
եղծանեի	Future
չկկեցիր	Past
չզգուշացանք	Past
մոտին	None
միանան	Future
չօղողենք	Future
կաղարտեինք	Future
ձեռնոցները	None
շոր	None
կբացատրեիք	Future
չխածանեցին	Past
կսպանի	Future
չտրցակեք	Future
թոռոմեցիք	Past
չխուզեցի	Past
կործանի	Future
աղաղակեր	Future
չգլի	Future
ամբարտավանեցինք	Past
կռվեն	Future
թրծեի	Future
հեծեծեք	Future
չերդվեի	Future
մեկնեցին	Past
դարսեցինք	Past
չսնգուրվեցի	Past
կընկճի	Future
դեկանը	None
կփրփրեի	Future
կողմանոցներիցդ	None
ճաղերով	None
կսազեն	Future
կքորես	Future
մտադրությամբ	None
կնքեիր	Future
պոռոչեինք	Future
կամավորներդ	None
ներգաղթեինք	Future
չհոլանեցիք	Past
կհոտոտեիք	Future
նորույթ	None
հանգամանքների	None
հոգան	Future
կհուզեիք	Future
սփոփեք	Future
այցելեք	Future
չթլփատի	Future
նախկինից	None
գյուրզա	None
անձնանուն	None
զարմացա	Past
չձուլեն	Future
կորովաձիգումս	None
չզրուցեիք	Future
չփրփրայինք	Future
աքսորեիք	Future
չգլորեինք	Future
չսազենք	Future
հայեի	Future
չպարգեւեիր	Future
չափահասները	None
չմերձենայիր	Future
չծպտվեի	Future
ներկայացնեն	Future
ճնշում	None
էական	None
կհերքվեր	Future
կխորհրդանշենք	Future
ճաքեինք	Future
մօտենան	Future
կոնը	None
կմուրար	Future
չարածեք	Future
կսրճեին	Future
խուզի	Future
կմիացնես	Future
խափանվել	None
ընդելուզեիք	Future
կմտցնեն	Future
գերծեցի	Past
չաճացնես	Future
չվերադարձան	Past
ամրոցիցդ	None
հալի	Future
յակին	None
չմաքրեց	Past
հրեայի	None
կկալեի	Future
չզանգահարեիք	Future
կտարվեն	Future
էրեկցիա	None
ծնվեցիք	Past
ճամփորդի	Future
կվարես	Future
վերագրեցիք	Past
մատչես	Future
չթաղեն	Future
լքի	Future
խայթ	Past
մարզասրահներ	None
քայլերում	None
փայփայեց	Past
խավիարում	None
սպասք	None
տերեփուկը	None
չեռամ	Future
սովորեցիր	Past
չկասկածեցիր	Past
չվանկեին	Future
չկոտրեիր	Future
աճին	None
չօծեցիր	Past
կլիման	None
կտենչանք	Future
չկայացար	Past
կհամարեմ	Future
կաշկանդեի	Future
կաղա	Future
ընթեռնեին	Future
մաքրենք	Future
լծի	Future
կթաքցնեիր	Future
զբոսանքներովս	None
երախ	None
հրապուրենք	Future
կհամբերես	Future
չբաղխեն	Future
կտեւեին	Future
փռթկացրին	Past
ծովեզերքներումդ	None
չպահածոյացրին	Past
կագահես	Future
ճոռոմախոս	Past
թարգմանեց	Past
չցանկացան	Past
խոպոպացվեր	Future
պատվիրակությունները	None
մատնությամբ	None
չշրջվեին	Future
ֆիլիպինուհովս	None
վարում	None
չկանչեցին	Past
չանձրեւեցին	Past
ործկացիր	Past
քրտն	Past
չմերկացաք	Past
ծառայ	Past
միացար	Past
թիթեռները	None
արած	Past
լրթացա	Past
կկնքեին	Future
կարծեցի	Past
կանաչ	None
օթեք	Future
դարպասներով	None
վտանգում	None
վռնդեցին	Past
պանծանք	Future
չհարսնացնեիր	Future
կոճապղպեղներովս	None
շավիղը	None
կխմբագրեին	Future
չգրառեինք	Future
չաբստրահեի	Future
չոլորեի	Future
կբառնայիր	Future
կներխուժեի	Future
ավելացնեմ	Future
չզեղեր	Future
չագուցեին	Future
արարած	None
գամետներ	None
զրուցեին	Future
դեղոտովս	None
կհասկանայինք	Future
չաղատեի	Future
չտպեինք	Future
հրապույրումս	None
տրցակեմ	Future
մրցեց	Past
չմածվեիք	Future
որորների	None
երկխոսություններում	None
ատաղձիս	None
խմեց	Past
կկարողանամ	Future
չլրտեսեց	Past
կներկայացնեմ	Future
քշեցին	Past
չամորձատեի	Future
ձեւեր	None
խածատեց	Past
լուսավորների	None
տրամադրեց	Past
վարագույրներով	None
կառքերից	None
չճոռոմաբանեիր	Future
կարեկցման	None
բանտարկեցին	Past
կհառեինք	Future
ռադիումի	None
փոթերումդ	None
չհղենար	Future
քյուֆթային	None
հալածանքներ	None
չշտապեց	Past
ողորմեցին	Past
բուսանեցիք	Past
բեկտեին	Future
կքոչեմ	Future
չլծեցի	Past
չկտակեցիք	Past
բումերանգի	None
խոսաք	Future
կապահովվի	Future
նախարար	None
սերմնաբջիջները	None
կբացականչեին	Future
կալեն	Future
խայթի	Future
ռումիներեն	None
բարեկամների	None
արածեցնեն	Future
ցանկանար	Future
արու	None
այրին	None
զղջաս	Future
առագաստների	None
չկայացավ	Past
չճանապարհորդեցին	Past
լքն	Past
զառամանայիր	Future
չափար	None
թղթախաղս	None
կոստնեի	Future
բժշկություններից	None
ծեծերդ	None
կկռկռայինք	Future
արհամարհի	Future
չգանգրացրին	Past
կալեր	Future
չհարբեք	Future
կմատուցի	Future
չծածկեցին	Past
չէթայի	Future
ֆիզիոլոգիային	None
չերազի	Future
խօսէր	Future
չհավելեցինք	Past
բավարարի	Future
զբոսանավեր	None
աղային	Future
կայրվես	Future
պարապի	Future
չաղավաղեցի	Past
կհալածեին	Future
կընթեռնեիր	Future
փլ	Past
կհետեւենք	Future
եպիսկոպոսը	None
չհեռեմ	Future
չսպրդեր	Future
ապացուցեցին	Past
հագար	Past
չմտադրեի	Future
նպաստեր	Future
զարմացնեն	Future
ցավացին	Past
ապահովեցին	Past
աչալուրջ	None
տերմիններից	None
ճոռոմախոսությանը	None
զառամանան	Future
չստորագրես	Future
հրամայեցին	Past
կլվանաք	Future
չփութացրինք	Past
չկթոտեմ	Future
առաջադիմեցի	Past
չկտակեմ	Future
հոգացիր	Past
տեղեկանամ	Future
կհեռացնի	Future
շրթներկ	None
առաջնություններից	None
չստուգեցիր	Past
քվեարկող	None
խեթկեց	Past
տունդրա	None
չուռեինք	Future
կծափահարվեք	Future
հասկանանք	Future
կփլես	Future
չպապանձվեցին	Past
գողանանք	Future
գանգրացվեցինք	Past
կռվեիր	Future
ֆերմիոն	None
չգարշեցիր	Past
կոչեցիր	Past
կթռնեմ	Future
մահապատիժներ	None
չմտաբերեմ	Future
որբություն	None
բանակցություններից	None
ծովախորշի	None
մոգոնեցինք	Past
խանութի	None
խրճիթներ	None
կբտեինք	Future
քայլի	Future
չգոչեն	Future
չառաջադիմեի	Future
չքարշեք	Future
խորհրդարաններ	None
քոչենք	Future
կպայմանավորվեին	Future
դարավանդիդ	None
ածանցի	Future
ուզեն	Future
գանգրացվեցիք	Past
յուղերի	None
գոյականը	None
չսահմանեցիր	Past
չգլեր	Future
չբացառեինք	Future
կամբարտավաներ	Future
կջանայի	Future
չհառնեք	Future
չմուրաք	Future
չտարվեմ	Future
հուռթանայինք	Future
չսովորեց	Past
բանեցնես	Future
սազի	Future
ահաբեկչին	None
կհրապուրեիք	Future
արտեւաններումս	None
մռայլ	None
կհեգեիք	Future
կըղձայինք	Future
պարտատոմսերը	None
վճռեցին	Past
մրսեմ	Future
ապացուցեց	Past
չդարսի	Future
տպեց	Past
ինքնասպանությանը	None
հարբեցինք	Past
չնախընտրեք	Future
խածատեցիր	Past
կրիաները	None
հեղեղիս	None
կկցեիք	Future
հավատան	Future
կզետեղեն	Future
ուսուցանեց	Past
ակադեմիաների	None
չսանձեց	Past
մարերին	None
աստիճանավորներ	None
չկտղեցինք	Past
չգոյանայի	Future
չթուլանայիք	Future
ուժեղանային	Future
չգնեցիր	Past
կգլդորենք	Future
կըմպես	Future
արածեցրեց	Past
չմրցի	Future
փչացավ	Past
չհասցրեց	Past
կլվանայի	Future
քարավանով	None
շտապ	Past
հրահրեց	Past
կհելնես	Future
կքննարկենք	Future
ամբողջությունից	None
ճարպերի	None
քարշի	Future
հատի	Future
տարիքներիս	None
շողայիք	Future
ընթանաս	Future
որբաց	Past
բարձրաձայնեցին	Past
խոստանար	Future
հաստատեն	Future
բաղարջներից	None
պատրաստեն	Future
քաքեմ	Future
կարգելեինք	Future
ատեն	Future
կողոպտել	None
փռթկացրի	Past
լուծեր	Future
չհողդողդի	Future
կաքավներիս	None
չհերքվեմ	Future
անասնաբույժներ	None
ամիրաներիդ	None
մրցույթների	None
նշխարներ	None
տեսողությանը	None
կխոխոջեն	Future
չսաղանայիր	Future
սագ	None
կասկածեինք	Future
կքծնեինք	Future
սրտառեիք	Future
նետի	Future
չչաղանային	Future
չոռոգեր	Future
անհրաժեշտություն	None
կսահմանեիր	Future
ապագային	None
շառլատանությունս	None
ձուլվել	None
կկախենք	Future
չհափափեցիր	Past
կհամբերեիր	Future
կկամենաք	Future
խառն	Past
զնն	Past
կպաշտեին	Future
մարտյան	None
հրամայենք	Future
նեղուցին	None
հեռացրեց	Past
չագուցանենք	Future
բտեր	Future
հետազոտողներից	None
չպայթեինք	Future
չգանգրացվեցիր	Past
չթռնես	Future
չթարթեին	Future
վտակներ	None
չճմլեին	Future
փարպեցովս	None
տկարներս	None
հելա	Past
կասկածեի	Future
ձուլեցին	Past
խմորում	None
նախահայրը	None
արմացավ	Past
նոսր	None
լաչառովդ	None
կապարովս	None
խաչակիր	None
բաժանվեն	Future
կբավարարեինք	Future
կռիվ	None
տրցակի	Future
կոտրեմ	Future
չմեկնեք	Future
կխօսայինք	Future
գողացան	Past
առավել	None
ակնածեցինք	Past
չքունեցինք	Past
կարգելեիք	Future
կենգուրուների	None
ապահովեց	Past
կխեղդի	Future
չվախենք	Future
կալա	Past
ողբացի	Past
սկեսրոջիցս	None
չսիրուի	Future
չաղոթեիր	Future
չպարգեւեցիր	Past
չպարգեւեցին	Past
մեկներ	Future
հետազոտ	Past
վերծանեի	Future
չորանայիր	Future
չմուրամ	Future
մահաց	Past
երթար	Future
ցողունին	None
չգուրգուրային	Future
կալիֆոռնիումներումդ	None
նեխեց	Past
կմիանան	Future
մերիս	None
լիզ	Past
չզրնգային	Future
չկռնչեցի	Past
շարժվի	Future
կկողպեինք	Future
արտաքսենք	Future
գնդացրով	None
չզառամացան	Past
քավ	Past
կտռեի	Future
մայրենին	None
չբարեւեիր	Future
հուսալքես	Future
շնորհեցի	Past
կզեներ	Future
ոսպերս	None
չպանծամ	Future
կարողանան	Future
չծփեր	Future
չարածեցրի	Past
վերադարձավ	Past
փականով	None
աղարտեր	Future
չսիկտիրվես	Future
չկանխամտածեի	Future
ուզեցա	Past
չգովեին	Future
երթամ	Future
կհամբուրվեի	Future
շփոթվեց	Past
կարձագանքեի	Future
չգլդորեմ	Future
եղծանեցին	Past
կապարի	None
տարակուսեինք	Future
կատարեցինք	Past
վարչապետը	None
խոչընդոտեցին	Past
կսահմանեն	Future
մատուցենք	Future
չերեւաս	Future
կմտաբերի	Future
չաղարտեց	Past
չծպտվես	Future
փորձեր	Future
տրամադրեր	Future
կզեռաս	Future
արգելեցին	Past
չմրցեցիք	Past
հասցրեց	Past
կավին	None
վերադառնանք	Future
ինքնահավաներ	Future
չպոռոտախոսեր	Future
կկորի	Future
բարեւեիք	Future
անկանող	None
կակազեցինք	Past
հերքող	None
չդայլայլենք	Future
քաղեի	Future
կճամփորդեինք	Future
չկողոպտեց	Past
չգանգրվեիք	Future
զվարճացրինք	Past
կռանար	Future
չսիրւէք	Future
վխտան	Future
խափանեցիր	Past
ընկճեին	Future
էթա՛	None
շենում	None
խռթանք	Future
կողոպտեց	Past
հանձնենք	Future
չկեղեքեիր	Future
գնոստիցիզմը	None
ասքի	None
կկրակեր	Future
յուղալավաշներումդ	None
չսանրվեմ	Future
գործընկեր	None
չշատացավ	Past
չտենչայիր	Future
չպեղի	Future
չաբստրահվեմ	Future
բաջաղեմ	Future
կաթոլիկներին	None
չծաղրեր	Future
բացականչեց	Past
ցողունները	None
ածանցյալները	None
լավաշ	None
չկատակեր	Future
քաղ	Past
չսառչեին	Future
թաքչեցին	Past
չընգավ	Past
չխափանեի	Future
ֆրանկերեններիս	None
թաքցնեին	Future
օգտագործեի	Future
չծնգցնեն	Future
գլդորեմ	Future
դատապարտեց	Past
արտաքսեց	Past
պայթեիր	Future
աճյունը	None
թակեր	None
թորշոմումդ	None
անվանիների	None
կրաքարերի	None
անհանգստանայինք	Future
հարիսայումս	None
արգել	Past
զգածվեցիք	Past
ղպտիներ	None
եղջյուրից	None
կայանա	Future
չխոթեն	Future
չգանգրանայի	Future
կանիծեի	Future
շարժականից	None
կսովորի	Future
տռուզներիցս	None
կթրեմ	Future
չհաճեցի	Past
ընթացար	Past
չզգենամ	Future
խոստացար	Past
կերակրեիր	Future
աշխատակազմում	None
կհրես	Future
բացատրեք	Future
հոգեբաններին	None
թրեք	Future
ձիգ	None
շնորհներ	None
կանզգայացվեք	Future
չհաստեցինք	Past
հմայեցինք	Past
նետեն	Future
կշարունակեմ	Future
կալնեմ	Future
չծղրտացի	Past
կխնչեիր	Future
կսիգար	Future
թռան	Past
կստրկացնեիք	Future
թարթեիք	Future
հանդիսականի	None
սպրիչներ	None
չվերծանեց	Past
չսգացիք	Past
մրցեցին	Past
չնեխեր	Future
գիդ	None
դողա	Future
չկարեկցես	Future
չներխուժեինք	Future
չվճռես	Future
չպաշտեցի	Past
կներկայացնենք	Future
շարունակի	Future
համ	Past
չշփոթվեցիր	Past
դեգերումս	None
երգիծեի	Future
չագրեգատավորեցի	Past
չտարածեին	Future
ինֆեկցիայի	None
չգոլացաք	Past
կլուծեն	Future
վտակներից	None
ոլորմոլորներիդ	None
չփախանք	Past
արքային	None
ահաբեկչի	None
կշփեինք	Future
փյունիկ	None
չթրմեիք	Future
ավելացնես	Future
կից	None
չմարտնչեիք	Future
գոռաս	Future
կաճեցնեմ	Future
հարեցիք	Past
խմեք	Future
կկճեիք	Future
հեռադիտակումս	None
կգնահատեր	Future
չհաստի	Future
վարեինք	Future
չհալեր	Future
կամենար	Future
ատես	Future
հեգն	Past
շտապեցին	Past
հիացար	Past
օսմանների	None
վասալին	None
չծիծաղացի	Past
կորնչես	Future
կխանդեիր	Future
չկոճկեիք	Future
դրդես	Future
վախի	Future
զխկտեր	Future
կթոռոմես	Future
լքեր	Future
չապշեինք	Future
կընտրվեիք	Future
վանդակով	None
չէթանք	Future
մաքառեր	Future
տարեցներս	None
գիտակցականության	None
չխարխալեմ	Future
կճամփենք	Future
կծափահարեիք	Future
բարելավի	Future
մօտենայ	Future
չսանրվեցի	Past
արգելքով	None
օծեց	Past
չլիզի	Future
ճաշարանի	None
կրեմ	Future
հյուրանոցներ	None
պուրակում	None
մեղանչեցի	Past
լքեց	Past
փուլերի	None
կեփեր	Future
ճարպով	None
հագնեին	Future
չմեղանչեցիր	Past
փախ	Past
հր	Past
չվերադարձավ	Past
ընտրվեցիր	Past
կկազմակերպեի	Future
մայի	Future
ծափահարեցիր	Past
կպայթի	Future
շալվարներ	None
միացրեց	Past
քերծեցիք	Past
ագուցես	Future
չհառեց	Past
թթվածնից	None
չտեւեցիր	Past
հագնվել	None
ակնթարթների	None
լոլիկս	None
կհածենք	Future
բացառվի	Future
կհրապուրես	Future
կսանձեք	Future
չճշգրտի	Future
աճացրեց	Past
չսգայինք	Future
քավեինք	Future
չհարսնանային	Future
չապստամբեր	Future
ծպտվեցիր	Past
պատմվածքներից	None
ճամփեմ	Future
կուզենա	Future
երերայի	Future
չլուծեմ	Future
չգործարկեք	Future
հնացա	Past
զավթեց	Past
կտարակուսեին	Future
լանջքերից	None
աքսորման	None
զեղծես	Future
վիետնամերեն	None
կհանգեին	Future
կանձրեւես	Future
կեղծեմ	Future
բարկեր	None
շաքարեղեգումդ	None
կթոտեցին	Past
գայթակղ	Past
չտենայի	Future
մույթեր	None
քավեր	Future
քաղցի	Future
շախմատ	None
վերադառնար	Future
չվանկարկեն	Future
բողոքի	Future
կաղերսենք	Future
չգուրգուրացի	Past
պիստակենիներիցդ	None
ոլոռ	None
չկնքեինք	Future
չխռթայինք	Future
չզղջան	Future
բարեւ	Past
չկտցեիք	Future
հոկեյ	None
ծնեցին	Past
նոթին	None
հավատացին	Past
լրջամիտները	None
ծանոթներից	None
չօթեր	Future
սեզերովս	None
կկռանայինք	Future
հոտոտեցի	Past
արկի	Future
լուծիչներով	None
թիթեղներ	None
կմատչի	Future
կհաստատեիր	Future
քչերդ	None
չարձագանքենք	Future
ձիրքերով	None
բնակվեն	Future
չողողվեն	Future
ստիպեն	Future
կշրջվեինք	Future
խթանեցին	Past
տունդրաներում	None
դառնենիներին	None
ներկան	None
խարխալես	Future
վանադիումի	None
վակուումը	None
ցանկացա	Past
չաբսորբեք	Future
մեծագույնը	None
փայտածխի	None
հայց	Past
չերկայնանանք	Future
ընտրվեց	Past
ամորձապարկին	None
հատկացնեի	Future
խրախուսեցիր	Past
սնուցումիցս	None
կքավեի	Future
քառակուսիներից	None
կհարեիք	Future
կհեռացնեիր	Future
կերտեն	Future
չխոպոպացնեն	Future
մայրցամաքների	None
արեգներով	None
ապահովանաս	Future
ժամահարին	None
լրջաց	Past
կավանդեիր	Future
մսառատներին	None
դայլայլեին	Future
կգելեիք	Future
չաճացնեիր	Future
մեկնեն	Future
կբռնաբարեն	Future
ապացուցենք	Future
չխռմփացնեք	Future
չմոռանայի	Future
կսփոփվեք	Future
զրուցեցիք	Past
ուռչեց	Past
հոգացինք	Past
չհեռացրին	Past
կբրթեիր	Future
չհամեցինք	Past
հղման	None
ուղեկցեր	Future
զեռան	Future
հղիանայինք	Future
չշառաչեր	Future
չլուցեցինք	Past
կմտցնեինք	Future
չթուլանայի	Future
քամեր	Future
եղծանեց	Past
կօթեինք	Future
աղբուտներում	None
ֆուտբոլիստը	None
զարթնենք	Future
աջակցած	None
քիմիկոսներ	None
քերծեի	Future
ազնիվին	None
շտկեի	Future
չաղարտես	Future
ճիվս	None
կբողբոջի	Future
փայփայենք	Future
կտցար	None
հիմնավորի	Future
չսորեցիք	Past
չպաղատեցիր	Past
խանձատեք	Future
թենիսիստներ	None
օժանդակեք	Future
կխափանեին	Future
չգնեիր	Future
նենգ	None
չընկճեն	Future
կնպաստեն	Future
ահաբեկիչները	None
կմեղանչի	Future
հպատակվեր	Future
ալքիմիկոսը	None
կուղարկի	Future
կկարոտեիք	Future
սառած	None
կգոլանա	Future
կկքեր	Future
չփորձեցին	Past
արթնացավ	Past
գրադարձեցի	Past
մուրա	Future
կտպենք	Future
խոստանան	Future
ողողվեինք	Future
նետաձգուհուն	None
կխածեք	Future
կզարմացնի	Future
չուրախացրի	Past
ոգեշնչեցին	Past
նավահանգստին	None
ոգի	Future
չվխտայիք	Future
լեզվաբանի	None
կավելացնեի	Future
չմղեիր	Future
չպայմանավորի	Future
չանզգայացվեն	Future
չմերձենաք	Future
պոմպերից	None
թզուկները	None
կկարողանա	Future
մեծից	None
կլուտայիր	Future
նախագահություններում	None
նախաճաշեցիք	Past
սպերման	None
կատարեք	Future
սարսափեցի	Past
կբարբանջեիք	Future
ֆեոդալների	None
սանր	Past
կոփածո	None
դողաս	Future
տեսություններից	None
հայթայթել	None
չվաճառեն	Future
ցուցասրահ	None
գեղեցիկին	None
չզգածվեց	Past
տեղեկացան	Past
չուռչեք	Future
կքորեմ	Future
կտոկաք	Future
թիակի	None
տարածությամբ	None
ճառագայթներով	None
կարողացավ	Past
շողայիր	Future
փախցրիր	Past
մխիթարել	None
բաժանվեմ	Future
ծանոթը	None
մղեցին	Past
կմածվենք	Future
հիասթափեցնում	None
հաստատի	Future
հասկանաք	Future
ուզեցին	Past
չդրդեք	Future
չգրգռեն	Future
համերգասրահում	None
մթարին	None
վար	Past
ինքնագիրը	None
կոճկեն	Future
կտղուցքի	None
կխուզեին	Future
հոխորտային	Future
խոչընդոտեցիր	Past
կհայցեմ	Future
օղակին	None
հոդերիս	None
չմաքառեցիք	Past
չճամփեմ	Future
սիկղերումս	None
հատնեին	Future
կշարժվենք	Future
չեխերենով	None
մեծարեին	Future
վախերը	None
նազի	Future
շահագործող	None
հանքերում	None
վարունգ	None
ապարանքների	None
մետաքսյայով	None
երկայնենք	Future
կակնածեմ	Future
չճախրեց	Past
շտապի	Future
բարբանջեցինք	Past
հաշիվներ	None
կորոճեր	Future
պահպանի	Future
ֆուտբոլիստով	None
ուժգին	None
չնպաստեիք	Future
բուլղարացիներին	None
չսփոփեցին	Past
խմեցի	Past
կգնեինք	Future
հեգնեիք	Future
հորանջեինք	Future
ամբարտակը	None
բոսոր	None
կլքի	Future
բարբառեցինք	Past
ոսկրին	None
բաջաղի	Future
նկուղ	None
պարտիզանները	None
ցանկանայի	Future
չաջակցեց	Past
աքսորեն	Future
մրց	Past
մոլորվեր	Future
չողողվեր	Future
ըմբշամարտը	None
չփլվեմ	Future
բզզացնել	None
չշշնջաք	Future
վիճեց	Past
կախ	Past
պատանեկիկիցդ	None
աներկյուղանաս	Future
չոռնացիր	Past
վախենա	Future
երկայն	Past
զգացմունքների	None
ընդգծեն	Future
նախդիր	None
հարկադր	Past
չխղճացինք	Past
հեղեղատներով	None
կոստղերիցս	None
ճաշեի	Future
փայլունացնեի	Future
կամորձատեմ	Future
մալգաշերեններով	None
ծիծեռնակները	None
զանգեք	Future
չբնակվես	Future
չսանձեի	Future
պանակի	None
երկնչեին	Future
չպայմանավորեց	Past
համակարգիչներից	None
ճաշի	Future
ենթարկեր	Future
կառավարեինք	Future
չմարտնչեի	Future
սփռի	Future
երկերում	None
աստվածածանոթներդ	None
չանձրեւեր	Future
չապահովացրի	Past
պայմանագրի	None
գնեն	Future
չպարտվեն	Future
կվարանենք	Future
ագուցանող	None
չապահովեին	Future
ծառայեցին	Past
հաճախում	None
արգելի	Future
սովորեր	Future
չմոռանամ	Future
ծպտ	Past
միացրին	Past
ֆուտբոլասերովս	None
չարդարացրինք	Past
լուծեին	Future
կցանկանան	Future
կատալաներենովս	None
կկռվեր	Future
աչս	None
չտշեինք	Future
մեզոնիցս	None
պայթ	Past
չշիկանան	Future
հարսանյացումդ	None
սնգուրվեք	Future
հանդիսական	None
հոսի	Future
պայմանավոր	Past
պապանձեցնելու	None
տղամարդ	None
չարգելի	Future
շիջեմ	Future
հանձնեին	Future
չողողվեցին	Past
օգտագործեն	Future
ուրախացրինք	Past
ածեցիր	Past
մեղադրեցիր	Past
կլրտեսենք	Future
չխոպոպվեիր	Future
ճամփեցինք	Past
ձուլեի	Future
մատչեցինք	Past
սառույցների	None
շահագործական	None
չխրոխտացին	Past
բաժանվեիր	Future
բեյսբոլով	None
կապույտով	None
կղզիախումբ	None
բողոքեց	Past
ագրեգատավորեր	Future
զարմացար	Past
վագոններից	None
կենդանի	None
չտռզեր	Future
կբտես	Future
սորի	Future
սվաստիկաներով	None
արբեն	Future
աշուղները	None
կխռմփացնես	Future
ամուսնությունների	None
նունուֆար	None
տանուտիրոջդ	None
հոգնակիներիցդ	None
ձգտեր	Future
չփորեցիր	Past
կոլորակեինք	Future
ընկճեինք	Future
նատրիումով	None
հովի	None
չխիթաս	Future
հուշանվերներ	None
խոսա	Future
կփայլունացնեիր	Future
չարածեինք	Future
կկանչեր	Future
ստուգեք	Future
զոդեի	Future
կկնքի	Future
չզառամանամ	Future
հատակում	None
արտասվեցիք	Past
վերջինիցս	None
ընդոստես	Future
վերուվարեցիր	Past
չփոխարինեց	Past
չպայմանավորեիք	Future
էլեկտրոդներով	None
կկանխեք	Future
շարժվեց	Past
կապուտակով	None
չմոռանաս	Future
նախահայրերը	None
շնագայլը	None
հավասարումներին	None
քանակը	None
չարաշահեիք	Future
գառնարած	None
չտարբերես	Future
