hallgassunk	Present
agyig	None
városnegyednek	None
elláttak	Past
kimenne	Present
odavágná	Present
lenyűgözze	Present
bevezetésén	None
szenvedsz	Present
hazaérek	Present
tápláló	Present
emulgeál	Present
politikainak	None
zsoltárokat	None
megtekint	Present
választónak	None
kötelezte	Past
földel	Present
parkolóba	None
ürítetek	Present
megrémül	Present
összefogjanak	Present
megőrizték	Past
kitünteti	Present
elrontó	Present
riasszuk	Present
javították	Past
kiújultak	Past
pörgő	Present
befagy	Present
pótlását	None
kertünkben	None
megfogalmazod	Present
dicsekednének	Present
igazgattak	Past
értékekért	None
szüntetek	Present
júl.-sal	None
folytatódtunk	Past
felnézek	Present
témákban	None
megkezdődő	Present
vargát	None
végződik	Present
megkértük	Past
népeken	None
sütkérezik	Present
vasgyárban	None
unatkoznak	Present
dirndliről	None
sebeket	None
nevezendő	Future
megbíznak	Present
szid	Present
egyesekből	None
életmódnak	None
méltányolandó	Future
képezzék	Present
visszaélő	Present
legalizálni	None
statisztát	None
vásárlások	None
mérlegelik	Present
emelik	Present
szíjak	Present
tábornokká	None
termeszti	Present
fújdogáltok	Present
megkülönböztették	Past
átalakulnak	Present
értékesít	Present
feltüntetendő	Future
rózsaablakodként	None
típusa	None
férfiaknak	None
makogták	Past
rámutattál	Past
szerkesztenek	Present
vesztenéd	Present
fésüljenek	Present
ürítsen	Present
fejtsenek	Present
lassul	Present
kiírod	Present
törekedjen	Present
borzalmakkal	None
átírtam	Past
felbukkannak	Present
lemaradnak	Present
mozgat	Present
megtekintette	Past
sötétedjek	Present
védekeznek	Present
dúlnak	Present
fülei	None
felejtsétek	Present
tároltak	Past
lefordítanád	Present
illesztünk	Present
meglát	Present
uralok	Present
eljutottak	Past
filmezzünk	Present
formáció	None
bíráltak	Past
ragasztottam	Past
ideálisabbakból	None
nézegetnéd	Present
megerősödnek	Present
emelnek	Present
láncok	None
idézzek	Present
múlnál	Present
irodán	None
uszítottatok	Past
odavágó	Present
elvegyük	Present
gyászzenéknél	None
befogadjon	Present
találgatod	Present
emulgeáljanak	Present
kiszállnak	Present
indítsa	Present
szakértőig	None
lerakódik	Present
tisztították	Past
sajnálták	Past
igazságosságért	None
mozgáson	None
kiközösítette	Past
pirosítottuk	Past
eltörjem|	Present
szakirodalomra	None
tartalomjegyzékre	None
ellopj|or|	Present
felhasználunk	Present
összekenjünk	Present
jelentkeznek	Present
aláírod	Present
beavatkozzak	Present
feltüntetné	Present
kitörnek	Present
fakítandó	Future
újultak	Past
jelképeznek	Present
féltették	Past
mérsékelik	Present
hirdetek	Present
gondolataival	None
kormányzóként	None
ijeszti	Present
pumpálnak	Present
kivonó	Present
gyanúsították	Past
bezáró	Present
szerkesztünk	Present
kergessék	Present
megmondod	Present
bitet	None
dominóeffektusról	None
figyelik	Present
munkavállalók	None
elfelejtek	Present
bekapcsoltak	Past
hordoz	Present
pusztítja	Present
hegesztünk	Present
elrabolták	Past
forgalmazót	None
megkérdezted	Past
kegyetlenebbek	None
kiáltok	Present
fejtsük	Present
alkalmatlanok	None
megalázd|or|	Present
átírásról	None
ballag	Present
ismertetik	Present
létesítenél	Present
hamisította	Past
bűzlő	Present
őrizz|or|	Present
megerősítettek	Past
irányítana	Present
értelmezésétől	None
visszatér	Present
megbízhatatlanabbon	None
felnagyítsák	Present
automatizáltatok	Past
áld	Present
hegesztő	Present
fülünk	None
arabeszkben	None
áldozunk	Present
iktatják	Present
rabold|or|	Present
szerelik	Present
indítanának	Present
végezzünk	Present
megrendeli	Present
engedélyezendő	Future
erősítsék	Present
egyszerűsíteném|	Present
tékozoljon	Present
ígérkező	Present
meghajoltok	Present
smaragdgyűrűktől	None
megcsalta	Past
csapvízzel	None
beiktattam	Past
életmóddá	None
kizárunk	Present
kitöltöttek	Past
megidézze	Present
ünnepelje	Present
vadászattól	None
kutyáktól	None
megelőző	Present
lelet	None
füstölő	Present
bírsz	Present
egyszerűsítsek	Present
festéket	None
modernnek	None
ötvözeteket	None
diszkvalifikálod	Present
megsemmisítenek	Present
ültetik	Present
reklámozna	Present
telefonszámhoz	None
feszülnek	Present
horderőhöz	None
kiabáltak	Past
propagandára	None
verbuváljak	Present
megtartsa	Present
entrópiával	None
rendezőn	None
egyesülve	None
vibráljatok	Present
foglalkoztat	Present
öszvérek	None
elkényeztettünk	Past
azonosították	Past
szoptassátok	Present
megjelölné	Present
elhelyeztem	Past
hároméves	None
asszociálnak	Present
kasztrálsz	Present
kondenzátorokból	None
zsizsik	None
elutasították	Past
verifikáljunk	Present
lenézi	Present
működtetik	Present
bajorral	None
vigyáznék	Present
siklik	Present
szórtam	Past
kedveltem	Past
megkaptad	Past
féltettétek	Past
tulajdonságokra	None
gyöngyöt	None
órást	None
létesítek	Present
fejezné	Present
indukál	Present
véglegesítsünk	Present
bemutatná	Present
mészárlandó	Future
felszabadító	Present
fogalmaznál	Present
zúztak	Past
taszították	Past
kötelező	Present
motiváló	Present
alábecsülök	Present
cenzúrázták	Past
kémkedik	Present
hallgat	Present
kizáró	Present
térinformatikákhoz	None
elképzelik	Present
berúgta	Past
körülvette	Past
zabálnod	None
landolás	None
szenvedő	Present
elcsúszik	Present
fedezze	Present
felírná	Present
ösztönöz	Present
fontossága	None
közelít	Present
társaságokat	None
vonakodik	Present
gyógyszernek	None
ajánlólevelet	None
megismerünk	Present
vegyészek	None
tövéig	None
alkossunk	Present
utál	Present
növekedsz	Present
emlékeznek	Present
menetrendeket	None
szenvedőket	None
felállítsák	Present
feláldoztuk	Past
élőlénnyel	None
kielégít	Present
elkövetünk	Present
illeszkedne	Present
elindultunk	Past
talp	None
elfogyassza	Present
kiad	Present
keretre	None
tördelik	Present
viszonyítunk	Present
fogyatkoztak	Past
próbálkozó	Present
titkosították	Past
szarba	None
sövényt	None
indítványban	None
vádoltál	Past
létesítünk	Present
tárolták	Past
kategorizáló	Present
szándékoztak	Past
súg	Present
vergődő	Present
kobalt	None
találkozzanak	Present
elhelyezkedő	Present
szeleteld|or|	Present
sűrűséget	None
frissítő	Present
viselkednének	Present
elfogultnak	None
óriáshoz	None
törődtek	Past
ígérek	Present
viselje	Present
seregnél	None
megelőzze	Present
dezodorodtól	None
műtő	Present
megtekintendő	Future
kalandoznak	Present
hasáb	None
kerít	Present
kicsinyekben	None
hanyatlanak	Present
agyonszúrnám|	Present
prostituáltról	None
fokozná	Present
lobogjon	Present
megosztják	Present
asztmában	None
dzsesszt	None
melletti	None
kivétellel	None
cinek	None
vél	Present
találkoznak	Present
kibővítették	Past
dicsekedtek	Past
közösségétől	None
vásároltam	Past
hangzana	Present
nyaral	Present
elnézi	Present
feltette	Past
kiszenvedjek	Present
távvezérelsz	Present
vizsgál	Present
nyűgöztek	Past
tolódtak	Past
lefordítják	Present
érában	None
szándékozol	Present
elvárunk	Present
kódolnak	Present
hitelért	None
csomóelmélet	None
adókulcsokba	None
meneküljenek	Present
exportálnának	Present
korszerűsítik	Present
konzultálnátok	Present
elérkeztetek	Past
keményítő	None
erősödtek	Past
hasznosítandó	Future
bátorító	Present
értesülő	Present
továbbfejlesztik	Present
cserebogár	None
bosszantja	Present
térítendő	Future
beszédfelismerések	None
tapintó	Present
harisnyanadrágon	None
elkezdjen	Present
kompenzál	Present
piramisként	None
telepednek	Present
beágyaztam	Past
elváljon	Present
süvegeld|or|	Present
küszöbön	None
megteszek	Present
helyreállításban	None
óceánparton	None
tárolandó	Future
igényesek	None
záruljon	Present
siessenek	Present
felöltözik	Present
telítik	Present
hitelesítették	Past
lefoglalta	Past
megállok	Present
ellenőrzést	None
járdán	None
pénzügyekben	None
megrázta	Past
csinálsz	Present
sebzésekként	None
csíkozod	Present
sósból	None
tevékenységektől	None
kielégíti	Present
kicserélte	Past
egyenletrendszer	None
területeiig	None
megnövekedjünk	Present
hangszereljünk	Present
mikroprocesszor	None
fosztjuk	Present
fűre	None
hasznosította	Past
pszichológus	None
hűtötték	Past
tájékozódjunk	Present
konvencióknak	None
törtek	Past
felfogtátok	Past
elismerik	Present
megmaradjon	Present
szervezetetek	None
gondtalanságoktól	None
megtizedeljünk	Present
túlbecsüljek	Present
inti	Present
feladtam	Past
összeszednek	Present
kitöltötte	Past
megismertesse	Present
szavazták	Past
leírnak	Present
megértsék	Present
előír	Present
elrontok	Present
darázskürtöknek	None
gyertyatartót	None
fokoztak	Past
űrhajósoktól	None
foglalkoztató	Present
javítják	Present
koncentrálásról	None
dumálta	Past
megtettek	Past
legegyszerűbbek	None
véli	Present
századok	None
vonszolnál	Present
teljesítse	Present
színlelte	Past
ágyúz	Present
semlegesítetted	Past
alakítottak	Past
tévesztették	Past
szabályozták	Past
villognak	Present
részesítettek	Past
tagjává	None
tudományos	None
forogjon	Present
nyersanyagokban	None
konzultálni	None
bizonyítottad	Past
beszálljon	Present
összegyűjtenek	Present
legkiválóbb	None
felajánlották	Past
emlékeztették	Past
elmulasztották	Past
ürítsük	Present
megszerezték	Past
bivaly	None
merészeli	Present
elrendezzetek	Present
tapasztják	Present
archiváltam|	Past
agyonütném|	Present
ünnepelték	Past
dagálytól	None
csibék	None
mennyiségtől	None
szimatoltátok	Past
szidták	Past
vitáztak	Past
technológia	None
kiléptem	Past
harmonizáltál	Past
rakéták	None
tapasztalsz	Present
stírölje	Present
felruházták	Past
karácsonyból	None
elkezdtünk	Past
megírandó	Future
határoló	Present
vízilabdákhoz	None
kedvező	Present
kiváltságos	None
felkérték	Past
képzőművészetre	None
szelektál	Present
létrehozást	None
nekilátok	Present
rövidítettem	Past
törődik	Present
megerősödik	Present
kötetbe	None
tönkreteszik	Present
hangzotok	Present
mozgatják	Present
birtokoljon	Present
fordításnál	None
kiterjesszük	Present
megújította	Past
megvédtem	Past
megsemmisítenél	Present
frekvencia	None
cincognám|	Present
hibáztatja	Present
olaszoknál	None
lemondta	Past
xeroxoztad	Past
sugározták	Past
szakterülethez	None
megszüntessük	Present
felnagyította	Past
politikából	None
orrcimpák	None
előírjatok	Present
söpörtek	Past
kérdésesbe	None
szültek	Past
elbeszélgetésekből	None
terjessze	Present
hölggyel	None
múltam	Past
ugráljunk	Present
tulajdonosának	None
kipróbálta	Past
kapitulálunk	Present
riasztunk	Present
ellátogatnak	Present
alapítója	None
félreértik	Present
meghaljon	Present
filmeztünk	Past
sétáltam	Past
kérdéseiben	None
megvalósultak	Past
henyélnétek	Present
vonatoknak	None
bokrokra	None
bűnbánatra	None
stagnál	Present
kezdeményezte	Past
erkéllyel	None
összerakjam|	Present
illeszkedő	Present
ágenssel	None
sci-fiken	None
kommentálta	Past
főherceg	None
tanítják	Present
beküldő	Present
kifejtettük	Past
történelemtől	None
létrehoztál	Past
idézetnél	None
bűvölünk	Present
szatyrokhoz	None
zongorázó	Present
fűtötte	Past
elkezdi	Present
vodkán	None
elhelyezze	Present
engedélyeznek	Present
leírtuk	Past
megbocsátó	Present
alperes	None
ismerkednek	Present
vegetálnának	Present
összegez	Present
képeznek	Present
elrontotta	Past
rövidlátást	None
leled	Present
áldoz	Present
elhanyagoltak	Past
röhögtem	Past
csábulnánk	Present
átadták	Past
tejtermékeket	None
nekilátnak	Present
rózsákból	None
modernizáló	Present
agressziótól	None
trombitáló	Present
lelkesíti	Present
bukkanunk	Present
végeznél	Present
megvennéd	Present
reménytelennek	None
észlelsz	Present
ragasztanak	Present
megtették	Past
fogad	Present
idézünk	Present
ecseteljünk	Present
kifejtünk	Present
kaparandó	Future
hozzáadunk	Present
melegedjen	Present
kiadásokkal	None
sáfárkodtatok	Past
javítsátok	Present
lakkal	None
szállítson	Present
közvetítenek	Present
befonod	Present
hatásai	None
mérgezik	Present
betenném|	Present
coboly	None
csábítania	None
döngetném|	Present
borzalmakról	None
alakítana	Present
visszautasítanak	Present
zajló	Present
hangszereljenek	Present
célpontokká	None
forraló	Present
atomfegyver	None
ellátására	None
feltöltök	Present
származásnak	None
vádolnak	Present
ellenőrizze	Present
megnyúztatok	Past
műtik	Present
kiállították	Past
fűszerezte	Past
cinegéknél	None
szétlapítanak	Present
szentesítette	Past
töréseknél	None
feltételben	None
ünnepelné	Present
elkerülik	Present
forgó	Present
kapcsolónak	None
ismertetjük	Present
fűződnek	Present
megfogalmazni	None
tapasztaltunk	Past
szórnak	Present
keltettek	Past
emberkének	None
etetőszékben	None
átír	Present
fejted	Present
fogyaszt	Present
sértegettem	Past
ellentmondana	Present
egyeztettem	Past
elvesztik	Present
sütötte	Past
baloldalt	None
megkülönböztetnek	Present
csinálnék	Present
egészébe	None
alapjaiba	None
határozószó	None
szomorú	None
költünk	Present
megfogalmaz	Present
helyezkedne	Present
körülvegyük	Present
álmodnak	Present
igény	None
számlálták	Past
lerakódjanak	Present
verifikáltuk	Past
törne	Present
kijelölő	Present
folyamatba	None
lerombolnak	Present
véleményként	None
taszító	Present
formálnál	Present
segítésére	None
asztalosról	None
nyilvánítanak	Present
kérdezték	Past
nyomtatja	Present
süssön	Present
ígéret	None
szalasztanék	Present
udvarló	Present
bukkannánk	Present
töltéseként	None
oktatóként	None
nehezítjük	Present
kiírok	Present
vándor	None
kosarakat	None
indították	Past
kerülgetik	Present
elvágtak	Past
leggazdaságosabbakba	None
szekularizálnának	Present
megütötték	Past
reformáltuk	Past
betevő	Present
félreértenek	Present
javaslattól	None
ártó	Present
illesztették	Past
felülírta	Past
megindították	Past
elférnek	Present
mellényről	None
neveztünk	Past
tehénnel	None
megdönti	Present
fogyasztja	Present
öntözi	Present
elkészítettek	Past
végiggondolod	Present
pityizálnátok	Present
megkezdj|or|	Present
spionírozna	Present
készletet	None
kijavítod	Present
árfolyamhoz	None
ültessenek	Present
elbűvölő	Present
remetéről	None
ítélő	Present
rettegő	Present
meghajtóként	None
darálandó	Future
gorillákat	None
kölcsönöztek	Past
teljesítsük	Present
bosszantják	Present
leadta	Past
bőgő	Present
csábították	Past
legeltettük	Past
tükrözzétek	Present
irányuljon	Present
zaklatnák	Present
elintézik	Present
melléknevek	None
zászlóaljjá	None
elküldted	Past
viszonyító	Present
egyenlítsek	Present
hipnotizőrökig	None
extrát	None
kárnak	None
vásároltátok	Past
lakostól	None
akcelerációkkal	None
teremtek	Present
wikiszótárt	None
engedelmeskedjenek	Present
forradnak	Present
elbarikádozna	Present
boncolj|or|	Present
rögzítette	Past
halásztak	Past
konfirmálnád	Present
érdemelnének	Present
szemerkélő	Present
megbocsátják	Present
változásainak	None
elválaszt	Present
megaláznotok	None
üldöz	Present
újraválasztották	Past
zeneszerzőnek	None
sztoriból	None
szférákba	None
különbözünk	Present
legelik	Present
elkezdenek	Present
feleltem	Past
haragudjatok	Present
immobilizálnál	Present
terrorizálta	Past
kutatásokra	None
sértené	Present
fogamzás	None
elnapolta	Past
direktívával	None
indokolnak	Present
parkírozó	Present
megfojtottak	Past
összekevernél	Present
megmaradunk	Present
elfojtják	Present
előbőröket	None
kampányol	Present
bánjunk	Present
elállsz	Present
hallgassa	Present
megjelenítenek	Present
uszít	Present
megismertet	Present
tolódó	Present
elválasztották	Past
feldobunk	Present
avart	None
bolondító	Present
jelölik	Present
országosakként	None
ürítsék	Present
tönkretevő	Present
halászó	Present
összekeverendő	Future
dúskál	Present
történelmére	None
beírok	Present
fejlődnie	None
odavágnék	Present
véglegesítenéd	Present
kibővítettek	Past
rövidít	Present
indukáló	Present
éretten	None
ellenálló	Present
béreljenek	Present
sejtetnek	Present
szigonyoznál	Present
városnegyedeket	None
megegyeznek	Present
elvesztése	None
elfelejtettem	Past
dagonyázzatok	Present
feladatokba	None
elveszik	Present
hangerővel	None
földrésznek	None
leesnek	Present
alakítaná	Present
fejti	Present
csatlakoztak	Past
illatok	None
módosítja	Present
tömörítettétek	Past
emelkednek	Present
formálták	Past
akkreditálta	Past
elsodor	Present
rekviráló	Present
aláírtak	Past
jellemezték	Past
elemezzék	Present
kabinetből	None
kifejtettem	Past
nyávog	Present
tesztelünk	Present
költő	Present
bejegyzik	Present
rokonnál	None
visszaadtak	Past
takarta	Past
felszabadítsa	Present
állapotokat	None
kristálytisztán	None
ösztönözték	Past
spórolunk	Present
kiegészíti	Present
megtekintse	Present
diktatúrához	None
fedjenek	Present
csábította	Past
elveri	Present
átvegye	Present
kifolyik	Present
visszaélnek	Present
elnevezte	Past
elterjedő	Present
mesélnek	Present
lök	Present
szítja	Present
aggodalmak	None
fejlődnünk	None
licenceli	Present
kéretik	Present
megtekintsék	Present
mészárolták	Past
késtől	None
vonzódnak	Present
idézetek	None
vitat	Present
kétévesnél	None
szakmányoktól	None
nyilatkoznád	Present
úszkálnak	Present
vérről	None
diagnosztikában	None
marik	None
tacepao	None
fújnak	Present
lemondtál	Past
törekedtek	Past
megőriztétek	Past
hegységre	None
aposztrófokat	None
előfordulnak	Present
szobrocskákat	None
kelvint	None
üvöltene	Present
elküldték	Past
átneveztem	Past
előzték	Past
akadnak	Present
megvették	Past
burokban	None
javulnak	Present
raboltak	Past
mérgez	Present
szerelméért	None
tojik	Present
létesítették	Past
különöshöz	None
suhanó	Present
kezdeményeztél	Past
leesne	Present
elhanyagolta	Past
aláhúznák	Present
termeszteni	None
deprimálandó	Future
engedelmeskednek	Present
találkozzon	Present
cselekedte	Past
kontaktusra	None
maszturbálsz	Present
unióról	None
ösztönöznek	Present
kerülgeti	Present
keverékek	None
elnézte	Past
megköszönték	Past
frissítsük	Present
meggyőztetek	Past
fogalmaztál	Past
cukrozzanak	Present
válogatottal	None
vízszintesbe	None
tárgyalta	Past
megnyerték	Past
újraválasszuk	Present
egyforintosokért	None
fejleszted	Present
politikusért	None
kiolthatatlanokért	None
indítottak	Past
hozzáadtam	Past
sorol	Present
elbűvöl	Present
összegyűjtené	Present
alkalmazkodjanak	Present
kijavítják	Present
helyezkedik	Present
demokrácián	None
ziháltok	Present
intéző	Present
elvárta	Past
véled	Present
mindkettőt	None
elesnénk	Present
rendellenességhez	None
előadok	Present
belfölddel	None
hadaró	Present
kutyaugatásról	None
kölcsönöz	Present
fújj|or|	Present
határolnak	Present
konzolokon	None
meditál	Present
alábecsülnének	Present
vízisíelnének	Present
elveszti	Present
tagadták	Past
nyilatkozzon	Present
profanizálnák	Present
sportminisztériumnak	None
emeljünk	Present
indítanék	Present
felejtik	Present
benzinnel	None
emberéről	None
fakadnak	Present
támaszkodó	Present
keresztesek	None
bemutattam	Past
letartóztat	Present
szimbólummal	None
elvetéljetek	Present
újraéled	Present
megismertetitek	Present
hűlő	Present
képein	None
körülvesz	Present
szalámit	None
ugratja	Present
nyomtatják	Present
észlelnek	Present
ismertető	Present
csináljon	Present
bízta	Past
meglátjuk	Present
álmodtam	Past
megújítják	Present
szabályaival	None
arabeszkből	None
szállásként	None
feltegyék	Present
utcák	None
meggyőződésekért	None
hangszerelte	Past
moderátorból	None
igézzen	Present
felébresztette	Past
halászták	Past
rágalmazta	Past
szenvedésről	None
lakba	None
övezik	Present
engedélyeztem	Past
megjelölések	None
koncentráljanak	Present
foglalkoztattak	Past
nyávogó	Present
fúrtunk	Past
sanzonban	None
munkásságnak	None
irodalomtörténetből	None
elpusztuló	Present
felfrissítesz	Present
rombolta	Past
tombol	Present
bővítek	Present
erdész	None
molnárfecskéről	None
átnézték	Past
jezsuitákra	None
létrejöjjenek	Present
kérdjék	Present
látogassanak	Present
befolyj|or|	Present
javításon	None
hűtsék	Present
jutalmaztak	Past
feltartanom	None
beszállna	Present
megpróbálnak	Present
törvénykönyvekké	None
lepi	Present
visszafejteném|	Present
naivnak	None
hőmérsékletnél	None
lemaradtak	Past
bátorítjuk	Present
agának	None
ábrázatokon	None
dicsekedő	Present
kitűnjön	Present
megkezdtük	Past
céloztál	Past
szakítanám|	Present
anomália	None
vitatkozzatok	Present
nagyvonalúak	None
papagájnak	None
bevitték	Past
diplomáciával	None
jutalmazta	Past
termékek	None
vadászrepülőgép	None
keskenyekért	None
stabilizálta	Past
lekérdezőnyelvtől	None
megmérgezik	Present
lakókocsit	None
levegőből	None
cipeli	Present
márványok	None
táncosnőket	None
nyafogtátok	Past
leverték	Past
malájok	None
tolmácsol	Present
rögzítsenek	Present
megszüntesse	Present
hatosnál	None
autizmust	None
tervezésből	None
bálból	None
egybevágtál	Past
gesztusok	None
kísérje	Present
megpróbálnád	Present
idézőjelekből	None
ismertették	Past
szinteken	None
várakozik	Present
lapító	Present
lenyűgözzék	Present
tapasztotta	Past
legsúlyosabbak	None
megoldanak	Present
jegesmedvét	None
úszkáló	Present
megérkezzen	Present
ellenálltam	Past
javul	Present
avantgárddal	None
kérdezzen	Present
hintő	Present
féltestvérért	None
tönkretegye	Present
vitatod	Present
ellenkezik	Present
demonstráció	None
előírta	Past
dudákkal	None
hasznosítsuk	Present
meggyökerezel	Present
vadító	Present
harcoljak	Present
felmondta	Past
manipulálták	Past
tároljon	Present
barkochbáznál	Present
visszaveszi	Present
szavaztunk	Past
nagygépeket	None
feltételtől	None
felülírtátok	Past
szórták	Past
szinkronizál	Present
kitüntetendő	Future
körülmetélné	Present
megidéznéd	Present
hitre	None
klikkekre	None
megállít	Present
bekapcsoltad	Past
javítottunk	Past
kavartam	Past
részükkel	None
konstatálták	Past
sérülő	Present
szójegyzékben	None
leíró	Present
próbálkozásokkal	None
megelőz	Present
távolodunk	Present
kimutatta	Past
bemegyek	Present
üvöltő	Present
üvöltözik	Present
visszatérjünk	Present
elhiszi	Present
átalakultak	Past
hámozz|or|	Present
formában	None
alkotó	Present
eldobjak	Present
bűvölte	Past
agitáltak	Past
átlássa	Present
tárgyalnak	Present
megjegyeznéd	Present
elkezdtél	Past
előznie	None
problémáiról	None
kifejezné	Present
tárgyaljanak	Present
kijavítottak	Past
megismételjék	Present
felkészít	Present
legyőzzön	Present
erősödjön	Present
teniszhez	None
szaporodjon	Present
fejezzétek	Present
örököl	Present
tanúskodjak	Present
randevúztak	Past
szemlélő	Present
tanítanának	Present
rakétákhoz	None
beleírod	Present
buszra	None
alosztályt	None
hegyfokoknak	None
magazinnak	None
torzítottak	Past
értelmét	None
átvették	Past
sportol	Present
elhelyezendő	Future
zenélnéd	Present
tűzoltóautónál	None
erősítendő	Future
felajánlotta	Past
helyreállítandó	Future
összegyűjtsön	Present
bocsátjuk	Present
tanúskodna	Present
útjukról	None
alkimistákról	None
tudakoltam|	Past
félreérti	Present
farolnának	Present
rendezvényéig	None
rájövünk	Present
nyilvánítsanak	Present
beleszerettem	Past
áldozatokért	None
virul	Present
kezeket	None
demokráciából	None
időjárásokhoz	None
jegyeznek	Present
bókoltátok	Past
áldod	Present
honfitársakhoz	None
tupírozták	Past
elkezdje	Present
bíróvá	None
beszállnék	Present
libaúsztató	None
csináltatok	Past
bánok	Present
leckék	None
rendezvényének	None
társadalombiztosításról	None
majmoknak	None
beágyaztuk	Past
termesztették	Past
felépítő	Present
megállapítottuk	Past
módosító	Present
eleső	Present
kommunikáljon	Present
aranybányák	None
cipókat	None
gondozásába	None
felhasználókból	None
visszatérek	Present
kerítsék	Present
megöljék	Present
megpróbáltál	Past
kitiltják	Present
rögzítsük	Present
családjának	None
rablásban	None
ártottak	Past
látogatva	None
improvizálnád	Present
indexelik	Present
egészítették	Past
állapítjuk	Present
gyógyászatban	None
átírta	Past
mirigy	None
megengedő	Present
technológiákra	None
átalakít	Present
rúdon	None
faktoriálisok	None
dúlták	Past
emel	Present
üzenné	Present
támogatóktól	None
falaztam	Past
elfogyasztotta	Past
csórnak	Present
lektorálandó	Future
viselkedjenek	Present
hazákig	None
reagálunk	Present
vetekedtünk	Past
megfizették	Past
törekedtem	Past
megcsináltam	Past
kapitulál	Present
opponálta	Past
tagadta	Past
elismered	Present
elősegítették	Past
megtörténik	Present
gyarmaton	None
szentenciához	None
mulatnak	Present
vércse	None
nyersanyagokat	None
sértették	Past
csempészne	Present
húsgombócból	None
cimboráló	Present
kavar	Present
beállító	Present
hűtötte	Past
etikusakként	None
zeneszerzésbe	None
szentélyek	None
megoldaná	Present
nemességekből	None
intézendő	Future
blokkolná	Present
siklotok	Present
bezártak	Past
szexet	None
jegyzőkönyvek	None
kenyér	None
összevágta	Past
mammográfiánál	None
megszűnnének	Present
félreértette	Past
tönkretesznek	Present
kerítő	Present
válaszoljatok	Present
szerkesztőjénél	None
feloszlassa	Present
taksáljak	Present
klasszicizmusnak	None
nyugodjanak	Present
árbócok	None
paraméterekre	None
elkezdtem	Past
kiterjesztéshez	None
tartozásnak	None
felmerülne	Present
lassítják	Present
teniszezik	Present
kivisz	Present
akadályozná	Present
tartózkodó	Present
külügyminiszterré	None
beszólsz	Present
fordulatokra	None
figyeljék	Present
fosztottak	Past
ítélsz	Present
hozzájáruló	Present
liberalizáltunk	Past
összeraktak	Past
vigyázzatok	Present
megtervezte	Past
expresszívből	None
kannibállal	None
felkeresném|	Present
megálló	Present
idézték	Past
értékben	None
módosítsa	Present
tanítunk	Present
jóváhagyására	None
tolódik	Present
verdessek	Present
visszalépünk	Present
hétvégét	None
egybeírsz	Present
rombolunk	Present
fejtsék	Present
sütötted	Past
kontroll	None
improvizálnék	Present
redukáltak	Past
hangsúlyoz	Present
igya	Present
meggyújtva	None
lápok	None
múzeumnak	None
eltávolító	Present
támaszkodik	Present
udvarhölgyet	None
konszolidáló	Present
kádba	None
csomagokon	None
akadjanak	Present
visszaadó	Present
tökéletesítették	Past
elektronmikroszkópban	None
vonaglanánk	Present
kagylókban	None
viszonyulunk	Present
lemondanak	Present
kényszerülök	Present
birtokoljanak	Present
elszántig	None
jelképezik	Present
kimondó	Present
ikonná	None
fokozódnak	Present
elmulasztásokként	None
összeadó	Present
fokozódik	Present
bántja	Present
mérlegre	None
lélekben	None
renoválna	Present
megkérte	Past
normálisban	None
tranzakcióval	None
hegyhez	None
alkossak	Present
megírnák	Present
egyházaktól	None
javasoltam	Past
kedvedre	None
albummal	None
benyújtsa	Present
kiengedi	Present
hallucinációkkal	None
ácsként	None
szuggesztióra	None
feltüntetjük	Present
meghalok	Present
versenyben	None
nevezéssel	None
adataival	None
polgármesteren	None
jelentéktelenekre	None
tiszteletre	None
repülőterekről	None
ölel	Present
krízisre	None
ütköző	Present
tupíroznak	Present
kínoz	Present
elhalasztják	Present
megvédte	Past
felháborító	Present
nehezítse	Present
előfeltételek	None
történészről	None
titráltatok	Past
bőrében	None
rámutasson	Present
ingoványról	None
szerepének	None
erősít	Present
rece	None
beköltöztek	Past
feketepiacról	None
túlbecsülte	Past
módosításokról	None
átírok	Present
végző	Present
villannak	Present
napfogyatkozást	None
műtse	Present
ingadoznak	Present
veszélyeztet	Present
próbálkozások	None
lead	Present
tiltakozó	Present
gyümölcslevek	None
célzó	Present
meséltétek	Past
fűződtek	Past
elérkezik	Present
megengedte	Past
fedte	Past
eljussunk	Present
hozzájárulunk	Present
elfogyasztottak	Past
hegyekről	None
megszervezzék	Present
forogj|or|	Present
hajlongtok	Present
otológiáért	None
fojtottam|	Past
hullámtörő	None
vártaktól	None
jegyzetfüzeteknek	None
ellenségessé	None
szabályzatokra	None
javítsatok	Present
megakadályozná	Present
ésszerűnek	None
suhantok	Present
bántották	Past
távolodtak	Past
csatlakoznának	Present
veszítenéd	Present
valóban	None
admintól	None
bejegyezte	Past
bódulsz	Present
programjait	None
kitiltsanak	Present
elnevezzem|	Present
megteremtette	Past
megosztod	Present
elemezték	Past
atlétikából	None
mészárol	Present
jelévé	None
sorolnának	Present
elkülönítjük	Present
veszítenének	Present
kedveznek	Present
stírölő	Present
ússzon	Present
szinkronizálnak	Present
fajhoz	None
korszellem	None
szakosodtak	Past
szavaznék	Present
bombázta	Past
kantontól	None
dioxidhoz	None
kegyeltél	Past
rámutatunk	Present
tüntessenek	Present
portásról	None
gyereknek	None
kezelőket	None
kiszámítsunk	Present
hirdetik	Present
alszom	Present
eljuttatná	Present
szerkesztve	None
pezsgőkként	None
megálljon	Present
meglátnak	Present
joghatóságot	None
cincogjunk	Present
eléréssel	None
megtiltsa	Present
emelvényhez	None
kitiltották	Past
görkorcsolyáztunk	Past
engedelmeskedő	Present
felveszik	Present
idióták	None
megtanulod	Present
ellenkezzek	Present
megismeréséről	None
válaszoló	Present
megbocsásson	Present
viselte	Past
létrehozó	Present
helikopteren	None
törmelékektől	None
tiltsátok	Present
kivon	Present
sportoló	Present
közvetítse	Present
megkaparintotok	Present
megszünteti	Present
visszavettek	Past
emigrál	Present
kitüntette	Past
hordozták	Past
munkahelyen	None
mérgezték	Past
összeszedi	Present
ivor	None
szabványosítottak	Past
javítottam	Past
kergesse	Present
növelésének	None
imáknak	None
ültesse	Present
évfolyamokat	None
huny	Present
indukálnak	Present
hallgassák	Present
megkövesse	Present
molesztálták	Past
levonta	Past
vörösödő	Present
prezentáló	Present
bemutatta	Past
összegyűlik	Present
bántsátok	Present
gépelte	Past
kielégítő	Present
hatáskört	None
követeljen	Present
terhelésre	None
nevezünk	Present
üzemeltessetek	Present
meglep	Present
jóslatokban	None
blokkoltuk	Past
versenyeznie	None
bizottságokról	None
erősítették	Past
felháborították	Past
letartóztatta	Past
sajtótájékoztatók	None
teljesítenek	Present
tágíts|or|	Present
pénzmosással	None
szövegértéshez	None
szennyezték	Past
zúzzunk	Present
mikrorajonokig	None
utasítják	Present
rémültél	Past
valósulnak	Present
nézegettem	Past
nagyba	None
mellkasba	None
lenézte	Past
ítélnél	Present
megjavítottak	Past
kost	None
folyamattal	None
lemenő	Present
őznék	Present
jövedékről	None
lemondok	Present
nagyközönségekig	None
radíroznál	Present
díjaz	Present
fúró	Present
ünnepe	None
halát	None
akadályozta	Past
megvalósítani	None
ültető	Present
vetkőztetnél	Present
órákkal	None
indokoltak	Past
fedik	Present
bizonyítékban	None
lázadóval	None
idézendő	Future
tisztít	Present
kiskacsák	None
dajkát	None
doromboltál	Past
szakadékhoz	None
sérelmet	None
navigációra	None
fogyasszuk	Present
leintik	Present
beteszik	Present
sátorfától	None
exhumálnának	Present
kiengedik	Present
itták	Past
székesegyházzal	None
képezte	Past
revideáltam	Past
megerősítsetek	Present
egybekötötte	Past
elrejtsék	Present
elrepülnek	Present
elbocsátotta	Past
tágulna	Present
civilizációhoz	None
tisztaságban	None
permutációkat	None
megnézné	Present
műveltebbekként	None
szenvedélyről	None
lefordítsa	Present
diktáltak	Past
eredményezne	Present
népdalokat	None
polgárokhoz	None
mágnesektől	None
látványos	None
szavazva	None
dokumentáltak	Past
csatornáknak	None
egyesülne	Present
csatlakoznék	Present
harácsolod	Present
elnöksége	None
blogokra	None
terjedelmesebbé	None
elhelyezte	Past
régiókról	None
válaszából	None
telepakolj|or|	Present
egyesítettek	Past
pálmák	None
sorok	None
mellékelik	Present
elkerüljön	Present
megértettem	Past
soroltál	Past
sóvárognám|	Present
tétovázik	Present
zümmögtünk	Past
megmaradok	Present
legizzóbbakból	None
elkísérjék	Present
prosperitásért	None
megtart	Present
autózik	Present
műsorvezetőként	None
kerülget	Present
szunnyadó	Present
megfejtették	Past
elkorcsosodjon	Present
húzódna	Present
lelő	Present
gondolkodnánk	Present
megment	Present
beszólnék	Present
haragudjak	Present
szívemben	None
beiktatják	Present
kastélyokban	None
ápoltak	Past
megismertük	Past
húsvéttól	None
megállta	Past
szabaduló	Present
magnéziumot	None
összefüggésében	None
eltávolítunk	Present
ligán	None
kísérlettel	None
táplálkozzanak	Present
fagylal	Present
sarkig	None
ázó	Present
mozgattam	Past
megpróbálsz	Present
mulassuk	Present
halhatatlansággá	None
szélébe	None
hanyatlásnak	None
minősítesz	Present
ízelítőként	None
beszerzésével	None
elnyerjék	Present
indukáltunk	Past
vásároljon	Present
csinálna	Present
különbözik	Present
közéletekről	None
felvegyük	Present
elírtad	Past
felkértem	Past
feltesznek	Present
haditengerészettől	None
iktatja	Present
reflexedről	None
fogalmaz	Present
valóságról	None
elhelyező	Present
lezárulnak	Present
vacilláljanak	Present
hódolnak	Present
értesüljön	Present
felrobban	Present
anatómiaiaknál	None
füstölők	None
beadó	Present
részesüljön	Present
vigasztal	Present
vihogtuk	Past
beleír	Present
tájékozódjanak	Present
sózol	Present
nyálból	None
voksolnak	Present
megoldod	Present
levettek	Past
csöcsről	None
összegezi	Present
megkérdeztél	Past
aktiválták	Past
víkendeznek	Present
örményeknek	None
igényelnének	Present
klánon	None
üdvözít	Present
elbarikádozd|or|	Present
zenészhez	None
fojtották	Past
egybevágó	Present
elvárod	Present
gondolkodjanak	Present
indítsanak	Present
alkottatok	Past
nyilatkozol	Present
megfogalmazták	Past
recsegő	Present
formáira	None
sajtószabadságról	None
hazamegyek	Present
ásványtan	None
kézitáska	None
másolatában	None
elkülönítették	Past
szavaztuk	Past
bélyegeket	None
logaritmushoz	None
értesítsük	Present
mulattam	Past
követelik	Present
domináló	Present
robotoljatok	Present
elírták	Past
aratógépekre	None
feltalálták	Past
földművelésügyi	None
alakítanak	Present
lapjához	None
reagálna	Present
digitalizáló	Present
alkotva	None
betonozták	Past
gyűlölte	Past
viszonozták	Past
részlettől	None
száműztek	Past
előítéletek	None
hápog	Present
korrekcióért	None
befolyik	Present
ligában	None
fullad	Present
uraltunk	Past
rémül	Present
mozdítsák	Present
nevelőként	None
vágyódjanak	Present
megjavítottam	Past
lányból	None
egybeírunk	Present
öntöz	Present
kattintások	None
olaszokat	None
megosztanád	Present
professzor	None
diktál	Present
kijelölje	Present
észlelik	Present
alapoknak	None
kitöltöttem	Past
megkönnyítsék	Present
attribútumokat	None
kifejtetted	Past
ujjongó	Present
fogyasztjuk	Present
megnézzünk	Present
kormorán	None
ütésbe	None
berendeztél	Past
automatizálandó	Future
bowlingoznának	Present
virulnak	Present
lektoráltam	Past
alapoztak	Past
jelölnéd	Present
reagálok	Present
dühöngjétek	Present
megnyugtatja	Present
érdektől	None
teljesítettem	Past
szórakozzunk	Present
dobáló	Present
tanuljatok	Present
visszamentünk	Past
kiújuló	Present
megőrizze	Present
megfossza	Present
pázsitokból	None
jogarok	None
eladták	Past
megkoronázták	Past
szárnyakba	None
kikapcsolod	Present
elhalasztja	Present
százszorszépekre	None
sorolok	Present
unalommal	None
vállalkozik	Present
ökölharcokkal	None
gépgyár	None
garazsírozol	Present
elszalasztották	Past
soroltak	Past
megfigyeljék	Present
kódol	Present
intette	Past
mellénnyel	None
előfizetőknek	None
novella	None
építményként	None
kijön	Present
matrac	None
soroltuk	Past
elválasztandó	Future
feltételezné	Present
megsemmisíti	Present
átalakítják	Present
összetettnek	None
állapította	Past
utolértem|	Past
hegedű	None
rövidítesz	Present
felálltak	Past
kommunikáltam	Past
átadandó	Future
cintermekre	None
beküldenünk	None
kialakította	Past
halálossá	None
felfedezze	Present
megismernél	Present
tűrik	Present
hajórajokon	None
ártsanak	Present
egyenlőségért	None
megbántotta	Past
kárpitozunk	Present
összegyűjtő	Present
egyenlítették	Past
telepítésről	None
irányítson	Present
sekrestyékhez	None
perdítsem|	Present
elszalasszák	Present
hegedűművésztől	None
rávette	Past
szavaiból	None
fújtak	Past
konstrukciókkal	None
eladná	Present
bizonyítottam	Past
lefokoznál	Present
elváró	Present
kapcsolatot	None
vontassuk	Present
hosszúságtól	None
elektrifikáljon	Present
finanszírozzanak	Present
korosodó	Present
megértettük	Past
kistérségekkel	None
beöltöznek	Present
visszahelyezzék	Present
államtitkárokért	None
szemetelné	Present
feltettem	Past
nyusziba	None
minisztériumtól	None
alszol	Present
bírjanak	Present
elmaradnak	Present
végrehajt	Present
merészelte	Past
kondornak	None
mélyről	None
távozzon	Present
megvizsgálandó	Future
személyéről	None
keveredik	Present
érintettektől	None
konvertálták	Past
romboló	Present
felhívtatok	Past
egyezményekben	None
birodalmon	None
tapsolta	Past
kedvezőtleneket	None
tiszteletről	None
bumerángért	None
hiányoltak	Past
idéznek	Present
ültetjük	Present
sugallnál	Present
fejlesszék	Present
romosakon	None
utalásokat	None
odavesznek	Present
festményt	None
megölje	Present
elillan	Present
kifejező	Present
zűrzavarnak	None
elválasztják	Present
szabaduljanak	Present
diplomáciában	None
haladóknak	None
nyugodtam	Past
kéklettél	Past
kitöltik	Present
pilótákat	None
kiengedjék	Present
szereplőknek	None
elnyomták	Past
kipróbálok	Present
áttekintő	Present
köröztek	Past
ablakhoz	None
zajlottak	Past
esőre	None
megszüntettem	Past
megfordultam	Past
bosszant	Present
megtizedeljenek	Present
megjelölték	Past
randin	None
megmutat	Present
meghalad	Present
egyetértesz	Present
álmodunk	Present
hozzájárulnak	Present
számlával	None
részesítsék	Present
gyanúsítottnál	None
stadionokat	None
azonosítjátok	Present
vágánnyal	None
visszavágták	Past
zaklat	Present
csináljanak	Present
szerzetesrendeket	None
utálnak	Present
tanuljunk	Present
kötődjön	Present
kötődnek	Present
privatizáció	None
forgalom	None
emulziók	None
visszahelyezik	Present
látogassatok	Present
elindítja	Present
rövidítették	Past
vetélnétek	Present
fúrnak	Present
tapasztalta	Past
egyesüljetek	Present
tájékozódjon	Present
helybenhagytuk	Past
szűnik	Present
általánosság	None
kommunikálnak	Present
szószék	None
létrehozták	Past
ásványokban	None
invitáló	Present
keresztényre	None
beintettél	Past
szakemberei	None
kölyökkel	None
múló	Present
kaparta	Past
kezdettől	None
megkülönböztetünk	Present
fáradjon	Present
társuláshoz	None
kódolandó	Future
megbüntesse	Present
elkezdted	Past
teszteljék	Present
szökevénynek	None
cunami	None
szerkesztette	Past
glükózoknál	None
kiléptünk	Past
szerkesztettél	Past
rájöjjön	Present
zaklatják	Present
világaim	None
gyökereztél	Past
fusizol	Present
kavarta	Past
szentelünk	Present
azonosítottunk	Past
törődne	Present
kialakítsák	Present
okiraton	None
megvalósítva	None
beszed	Present
vigyázó	Present
elutasítjuk	Present
megmozgatja	Present
negyedévre	None
elfelejt	Present
vegyüljetek	Present
tiltakozzanak	Present
beállítottál	Past
átalakul	Present
ideírtatok	Past
szabályosakkal	None
megnézünk	Present
török	Present
érdekességnek	None
sportnál	None
rákok	None
frakción	None
éveiről	None
dzsippel	None
hallatszottunk	Past
sugározta	Past
részesülnek	Present
kaszabok	None
távolodta	Past
lezárnak	Present
számának	None
megkárosította	Past
felháborodtak	Past
hangsúlyokkal	None
feloszlattak	Past
vitatták	Past
forrásába	None
felel	Present
altatót	None
fagylaltok	Present
egyeztettünk	Past
kimutatja	Present
szeretkeznek	Present
kivonnak	Present
harmonizálnak	Present
elállok	Present
rendezi	Present
reklámoznak	Present
öltöznek	Present
csicseriborsóvá	None
birodalom	None
bebizonyítja	Present
szigeteljenek	Present
meghívásokért	None
tüzelsz	Present
visszalép	Present
feláldozták	Past
ültetvényekre	None
civilizáltak	Past
javítsák	Present
létesülj|or|	Present
forogna	Present
figyelmeztettük	Past
ciklusokon	None
fotóiig	None
kirúgnak	Present
leintették	Past
ködösítő	Present
jogosította	Past
megfogalmazta	Past
plébánosról	None
zavarosságokba	None
meséltem	Past
modellbe	None
blogolod	Present
szimbolizálták	Past
értelmesebbnek	None
tulaj	None
szüléshez	None
fújdogáltad	Past
megreformálták	Past
hódító	Present
átvettük	Past
horkolnak	Present
befolyásoljon	Present
megrendeljenek	Present
tanúskodó	Present
kiszámítsak	Present
kormányzat	None
drámákat	None
folyamokban	None
trónszékekig	None
üzenetként	None
méltányoljak	Present
kiegészítjük	Present
fűrészeled	Present
megnyissák	Present
bírálatok	None
szerkesztőknél	None
faktumra	None
képzelő	Present
picsába	None
elnézzék	Present
szerkesztettük	Past
prezentálta	Past
elhamvasztják	Present
torzítja	Present
megpróbáltuk	Past
mindenféle	None
megkezdődne	Present
cselekedetre	None
bolondítja	Present
bővüljön	Present
ismerkedjenek	Present
karnisig	None
költséghez	None
tágítja	Present
kornak	None
alagútra	None
megtaláltam	Past
szórakoztok	Present
nátrium	None
kéménynek	None
szenátusokat	None
foghatót	None
megfulladnak	Present
bérelte	Past
felhasználta	Past
uszítaná	Present
csomagolták	Past
beléptem	Past
vicceket	None
beint	Present
hódít	Present
aktivizáló	Present
gyötri	Present
tanultam	Past
minősítsem|	Present
lappanganak	Present
újabbakat	None
riasztják	Present
ösztönözd|or|	Present
boldoguljon	Present
festőművésztől	None
fakaszt	Present
ömlöttek	Past
feltünteti	Present
kockáztatnak	Present
aknászokká	None
tartósítja	Present
megrémültek	Past
átnéz	Present
kitűnik	Present
annektálok	Present
felállította	Past
módosíts|or|	Present
harcoltak	Past
eljutunk	Present
akaratát	None
siet	Present
emlékeiben	None
szédül	Present
visszaad	Present
kezemből	None
zárkózottak	None
biten	None
rögtönöztek	Past
sajtó	None
összekötendő	Future
jelölték	Past
megtanulták	Past
kijavították	Past
provokációkra	None
benyújtották	Past
szenteli	Present
összetételeknek	None
tárgyaláson	None
legrészletesebben	None
zsugorítjuk	Present
alkotáson	None
laktátok	Past
porba	None
fejlécek	None
közelítse	Present
alakokká	None
játékosnál	None
nehezít	Present
reprivatizálnék	Present
kiegészítené	Present
megdorgálnának	Present
bimbózó	Present
eltávolítsanak	Present
triumvirátustól	None
meghalunk	Present
kihúzod	Present
önfejűvel	None
kegyetlenebbekből	None
megfigyeljen	Present
üzente	Past
áramlottak	Past
elválasztotta	Past
tisztázol	Present
hűtik	Present
randevúzó	Present
vetélkednek	Present
tiltjuk	Present
lendületből	None
fejezték	Past
javasolna	Present
bizonyultak	Past
narrátorrá	None
undorodjunk	Present
kimondaná	Present
internetre	None
terjesztésben	None
hónapokig	None
nézőközönségnél	None
rövidítő	Present
megtud	Present
indító	Present
használatából	None
jóváhagy	Present
forrtak	Past
feltár	Present
megjavítja	Present
lélegezze	Present
őszinteséget	None
baksából	None
kiegészít	Present
ugrálsz	Present
vonakodnak	Present
rombusz	None
lökjem|	Present
taníttatsz	Present
gyaurokká	None
fordító	None
felhívtad	Past
teljesítsenek	Present
meglepnéd	Present
átkereszteljetek	Present
szállítja	Present
korszerűsítésekről	None
werkfilmen	None
halásztuk	Past
beleírunk	Present
gyilkosra	None
elismerjünk	Present
hattyúdalokért	None
szimbolizáltunk	Past
kontrolláltunk	Past
kormányozzon	Present
modellkedő	Present
megnyílnál	Present
kifejt	Present
elfelejtettek	Past
beszerezzék	Present
leveszed	Present
kommunikáltak	Past
gátig	None
ismertette	Past
hadard|or|	Present
újjáépítés	None
részletezte	Past
bűvös	None
megbocsátottak	Past
redukálta	Past
taoizmusként	None
megsemmisítse	Present
kommunikáljanak	Present
elindítják	Present
szerződik	Present
szitálunk	Present
eldöntené	Present
hivatkoztok	Present
elbólintotok	Present
összegyűlve	None
vágyódtunk	Past
üzletembert	None
részesítsük	Present
elfelejtenek	Present
nyilvánítottak	Past
tükröztek	Past
desztilláló	Present
megbüntet	Present
bőg	Present
felnagyítandó	Future
fúrok	Present
ruténiumokig	None
intrikálni	None
szüleihez	None
akcelerációkban	None
konstrukciókról	None
esdekelj|or|	Present
terjesszék	Present
életmódon	None
tágultok	Present
súlyemeléssel	None
hegesszek	Present
figyelmeztetik	Present
feliratkoztunk	Past
bankjegyek	None
meglátogattam	Past
szerkesztek	Present
fertőztek	Past
megelőzné	Present
nyomasztotta	Past
megjelöli	Present
sikoltsanak	Present
bekenve	None
úszkál	Present
megfertőző	Present
összegyűjtöttem	Past
kicserélném|	Present
egyensúlyra	None
egyenrangúakról	None
oxidálódik	Present
forrasztotta	Past
feltüntesse	Present
csempészi	Present
kandelábernél	None
mancsról	None
forogtak	Past
kedvében	None
teremtse	Present
örömeivel	None
majorokban	None
módosítson	Present
fúltak	Past
kimondod	Present
tartózkodjanak	Present
álldogálnának	Present
létesítmények	None
merülnek	Present
összehasonlítsa	Present
sötétednek	Present
gyöngytyúkba	None
utalnak	Present
összetételéből	None
létesítsen	Present
földeljenek	Present
megfigyelték	Past
megbeszélne	Present
bántana	Present
hasznosítsa	Present
beépítik	Present
klassz	None
vegyítettek	Past
lápokkal	None
megtestesíti	Present
teremtsen	Present
testű	None
legritkább	None
továbbította	Past
feldolgozásába	None
fenyegetünk	Present
kijelölte	Past
adoptálnák	Present
öltözzön	Present
vállalkozáson	None
lényeg	None
megszakító	Present
hitelkártyát	None
cseveg	Present
elmozdítja	Present
elindítanak	Present
megbántod	Present
koncentrál	Present
legyőzendő	Future
értéstől	None
ugráltak	Past
költségvetésnek	None
megnősül	Present
keltsen	Present
megbocsátunk	Present
leveszik	Present
jámborba	None
megreformálni	None
intenének	Present
behatoltak	Past
spórolnak	Present
zargatok	Present
összegezze	Present
köhög	Present
sértek	Present
előzőeknél	None
arzéneknek	None
utóbbiakon	None
bebizonyítsák	Present
növeszti	Present
belépsz	Present
többeken	None
varázsolnak	Present
tanítványához	None
világán	None
unatkoztam	Past
megrendelésekből	None
pályázó	Present
engedélyezné	Present
kitöltötték	Past
szalaszd|or|	Present
szerzetesnek	None
szenvedtünk	Past
sminkeljem|	Present
megköszöni	Present
lógnak	Present
elveszítettek	Past
kihagytak	Past
szennyezettként	None
robbannak	Present
idegesíti	Present
csináljatok	Present
csatlakozik	Present
lefejezném|	Present
kampányoljatok	Present
indokol	Present
megmentsen	Present
finanszíroztak	Past
készülékből	None
trolibuszokat	None
lokalizálnál	Present
oxidáljam|	Present
megtárgyaltuk	Past
passzívvá	None
előfordulok	Present
nekilátsz	Present
kiegészítettétek	Past
összehívta	Past
elpusztuljunk	Present
levelezünk	Present
javítaná	Present
megnyugodtak	Past
vezérelje	Present
sorozatról	None
szexissé	None
elnyeri	Present
szerelték	Past
aknán	None
minősülnének	Present
falaznék	Present
építészetté	None
elküldjek	Present
kifejtő	Present
viszonyulok	Present
bővítettem	Past
apródként	None
előjátékokba	None
ölti	Present
Velencén	None
múlik	Present
fejlődtem	Past
elnyerte	Past
zenéljenek	Present
öltöztek	Past
odavágtak	Past
átkereszteld|or|	Present
variálták	Past
elrejtettek	Past
megkérünk	Present
beépítettetek	Past
odafigyelő	Present
früstököltek	Past
megérintik	Present
utolérték	Past
gerincen	None
üzemelnek	Present
kifejtendő	Future
pamuttal	None
kedvezne	Present
eredményezze	Present
összeesküdtek	Past
leprában	None
bemutatjuk	Present
nyugdíjasok	None
kérelmező	Present
zeneszerzőknek	None
kerámiákból	None
reszelővel	None
szárítottak	Past
koncentráltak	Past
ismételtem	Past
hallgató	Present
számítást	None
kifejlesztés	None
megindítja	Present
eljutottam	Past
átneveztük	Past
nyomtatta	Past
szárítja	Present
kiállításokkal	None
vegyészhez	None
elfoglalni	None
trenírozta	Past
érzékelők	None
vitázzon	Present
pozícióban	None
sulinak	None
viszonyok	None
megelőzte	Past
beszerzésének	None
improvizálnak	Present
fogyasztották	Past
zavargok	Present
dandárba	None
találkoznánk	Present
szegénységről	None
megbocsát	Present
tiltakozna	Present
mosolyok	None
érzékszervekké	None
számláltak	Past
habokból	None
szentesít	Present
megfosztotta	Past
szitáltál	Past
meghatotta	Past
kinevezték	Past
megválasztandó	Future
mongolokból	None
elkövetnek	Present
kiviszi	Present
felfedeztem	Past
betegségéből	None
közvetítéseket	None
átalakították	Past
megállóként	None
bűnbánatról	None
részesülünk	Present
taoizmussal	None
melegedő	Present
álláspontot	None
megráztátok	Past
vigyázzunk	Present
lecsatolnunk	None
diagnosztizálsz	Present
tapasztanak	Present
szemléltetik	Present
megnyilvánultak	Past
ismertettem|	Past
lökd|or|lökjed	Present
gyapotot	None
kaproknak	None
rop	Present
felébredtem	Past
öltöző	Present
teológián	None
bejelentkeztél	Past
szállítandó	Future
interpretációk	None
felmondták	Past
legyőzik	Present
találkoztunk	Past
bűnözővel	None
hangoltak	Past
felszólít	Present
bebizonyította	Past
elkészíti	Present
megkérje	Present
vonzana	Present
elrejti	Present
taglaltunk	Past
indokoljam|	Present
kergeti	Present
elindulnátok	Present
tévesztik	Present
kéklettünk	Past
fertőző	Present
egybekötő	Present
stabilizál	Present
párkányokat	None
szemléltesse	Present
lemosó	Present
előzze	Present
megkönnyebbülő	Present
szalutáltál	Past
őrző	Present
kommandírozta	Past
bekerülsz	Present
világítsa	Present
áldozta	Past
lakatokból	None
kialakítja	Present
szerkesszék	Present
tapasztalatok	None
készítője	None
kábellel	None
összegyűjtsék	Present
megpróbálná	Present
megállapította	Past
kapcsolataiban	None
követeljünk	Present
találgassam|	Present
lemos	Present
gazdagodó	Present
tükrére	None
sarkantyú	None
svájciakként	None
alakítják	Present
vedlik	Present
határértékeket	None
gázpedálokról	None
egyszerűsítünk	Present
redukálták	Past
megtartotta	Past
hivatkozzanak	Present
letöltendő	Future
eltűntem	Past
csillapítsák	Present
bazsarózsa	None
rábeszélte	Past
héliummá	None
beiktattam|	Past
taníttatták	Past
lépcsőről	None
szívó	Present
indexeli	Present
fúgával	None
eltörték	Past
megtanultak	Past
átnézik	Present
tudósítja	Present
történetíróba	None
tiltották	Past
elismeritek	Present
elterjed	Present
feszültséggé	None
hallgattak	Past
vakítsátok	Present
biográfiáknál	None
tagjában	None
ketyegő	Present
megvalósítja	Present
kérdeztük	Past
hangszereli	Present
levélen	None
visszahat	Present
feltüntette	Past
körülírandó	Future
köteleznek	Present
összeadta	Past
vicsorgó	Present
továbbítandó	Future
tapasztottak	Past
összevetik	Present
ginzengeknek	None
teremtsünk	Present
rájönnének	Present
megfertőzte	Past
átkeresztelték	Past
fejeztem	Past
lezuhanó	Present
cenzúrázta	Past
hitelesíti	Present
jelentésen	None
karakterek	None
hiányolok	Present
elindul	Present
alkotnak	Present
tartózkodónál	None
gyűlölök	Present
komponens	None
tárgyaljatok	Present
bírtam	Past
meghaladta	Past
vőfélyek	None
csodálkozzon	Present
billennél	Present
firkál	Present
elkényeztették	Past
szigeteli	Present
elválasztok	Present
tanultunk	Past
megszervezi	Present
megosztjuk	Present
örököltek	Past
bombáztok	Present
konzultáljon	Present
tökéletesítsék	Present
megállítsa	Present
pingáltunk	Past
másolatokkal	None
varázsolták	Past
létrehozná	Present
boglya	None
fogyasszák	Present
kihaltok	Present
elfelejti	Present
módosítod	Present
kiáltani	None
rögtönöz	Present
kóstolta	Past
fájlokból	None
javító	Present
vakultunk	Past
vesztettek	Past
adókhoz	None
csengő	Present
megtegyük	Present
lóvá	None
megengedi	Present
kula	None
kalandoztatok	Past
gondoskodik	Present
bizonyították	Past
megnövekedjenek	Present
megszüntetendő	Future
személy	None
utáló	Present
kialakításokra	None
ürítse	Present
verejtékeznének	Present
kijavította	Past
bővítette	Past
zarándokolnának	Present
nyíltak	Past
kiegészítse	Present
lappang	Present
zsibbasszák	Present
összebeszélte	Past
tároló	Present
ellátta	Past
felfognék	Present
tájékoztatjuk	Present
félreértésen	None
tendál	Present
döfi	Present
feltételeztük	Past
összehív	Present
szintetizáltak	Past
kivontak	Past
ismétlődtél	Past
nyilvánító	Present
tönkretenné	Present
pozícióját	None
bajnokságokról	None
kiírtam	Past
átmenetre	None
cáfoltad	Past
landol	Present
átlagéletkor	None
ráadta	Past
magnitúdóval	None
továbbfejlessze	Present
hadar	Present
blokkolta	Past
csodálkoztok	Present
vibrálunk	Present
hallgattál	Past
régészetnek	None
akadozó	Present
weblap	None
egybegyűltek	Past
samponokban	None
kivinne	Present
felépítesz	Present
tömörül	Present
vicsorította	Past
variáló	Present
elérkezünk	Present
visszhangoztál	Past
markolná	Present
közelítettek	Past
létesítitek	Present
keletkezzen	Present
megírtuk	Past
alkossa	Present
megkárosítottad	Past
kihagyó	Present
szimulálva	None
rehabilitálnál	Present
telefonáló	Present
engedélyezi	Present
sajnálta	Past
elhagynak	Present
alapjaiban	None
helyesbítették	Past
aludjanak	Present
mosogatnának	Present
imádkozik	Present
kizárnák	Present
ultizod	Present
engedelmeskedik	Present
nyomoznak	Present
koordinátát	None
szemlél	Present
leoltok	Present
túlozzunk	Present
nyilatkozatban	None
stagnáltak	Past
feladta	Past
jogról	None
megismételje	Present
megmutattak	Past
tartósító	Present
fiúkról	None
akkreditálnék	Present
telítünk	Present
fertőtlenítették	Past
közvetítő	Present
előfizetési	None
visszahelyezzünk	Present
vesztettünk	Past
juniort	None
kedvesebb	None
albumtól	None
olvasást	None
megakadályozzanak	Present
keltik	Present
összevág	Present
rámutattak	Past
bombáztak	Past
jobbágyoknál	None
megrendelni	None
helyezéssel	None
nagymisét	None
alakúra	None
különbözne	Present
költsenek	Present
megmentse	Present
hurcoltak	Past
megszakítja	Present
megpróbáltam	Past
körmölik	Present
nemzetiségű	None
bíró	Present
féltő	Present
borotválta	Past
bombázásnak	None
kooperációt	None
postázta	Past
kásán	None
utasítja	Present
agyonütötte	Past
mellékelnek	Present
indítanak	Present
dinamikus	None
taglalta	Past
régi	None
körbevette	Past
palotákat	None
lelünk	Present
irányító	Present
boltkórosokba	None
kiveri	Present
várakoznak	Present
vágy	None
aknász	None
közelítette	Past
szurkolóként	None
üvöltötte	Past
taperolok	Present
növeltük	Past
módosítaná	Present
ringatta	Past
szabványosnak	None
megkülönböztessük	Present
szenteknek	None
komolyzene	None
szezonba	None
tájékoztasson	Present
ítélitek	Present
elhagyó	Present
ösztökéljék	Present
gamétára	None
becsapták	Past
elpusztulna	Present
nehezíteni	None
táncolna	Present
követeljék	Present
elkezdődne	Present
alkalmazkodva	None
lájnolta	Past
csizmadiákból	None
frissítsék	Present
gondozta	Past
ágyán	None
szolgálatként	None
elintéz	Present
idézzék	Present
biciklisták	None
átalakítsák	Present
állóvá	None
rendeznek	Present
kölcsönzik	Present
recsegnétek	Present
lenből	None
látogatnának	Present
mesélik	Present
dúltak	Past
megcsodáltam	Past
veszítsük	Present
kérdést	None
megszüntette	Past
tányérba	None
kiközösítsék	Present
fektettem	Past
motorról	None
visszhangzik	Present
feküdtek	Past
jogairól	None
tömörítették	Past
vetítettem	Past
meglátogassuk	Present
borogatjátok	Present
meglepje	Present
hozzáadtam|	Past
fosszák	Present
henyél	Present
kiterjesztő	Present
felbukkantak	Past
tantárgyakból	None
sértegetik	Present
megismertetik	Present
királyságra	None
illesztő	Present
feltételezünk	Present
felkészítsetek	Present
telepedjenek	Present
bordélyokra	None
regnáljak	Present
együttműködjenek	Present
kategorizálta	Past
keltették	Past
távirányítjátok	Present
megnézzen	Present
helyreállítasz	Present
növeli	Present
nyilvánít	Present
jegyzetfüzet	None
takaróként	None
gyümölcsössel	None
előadásról	None
átalakítanak	Present
kritériumokhoz	None
aktiválnak	Present
álcázták	Past
leintsék	Present
legszigorúbb	None
tömjént	None
temessék	Present
ionizáljatok	Present
hivatkoztunk	Past
cenzúráztak	Past
vacsorára	None
ellenvetném|	Present
ötletéhez	None
egyeztető	Present
rejtette	Past
dagonyáznak	Present
tapasztaltuk	Past
szerelte	Past
végeznének	Present
formátuma	None
beír	Present
veszedelmekben	None
vitorlázó	Present
intézi	Present
reprodukálták	Past
megcsináltuk	Past
szabadulnak	Present
reklámozó	Present
felszereljetek	Present
rágalmazták	Past
intézték	Past
tanulok	Present
jellemeznének	Present
tenyészteni	None
diskurzusoknak	None
fejlődik	Present
céhben	None
átnevezünk	Present
viseljenek	Present
megtestesítette	Past
megrongálták	Past
lefoglaltak	Past
kiherélte	Past
told	Present
megáld	Present
számjegyekből	None
tehetségben	None
megöltünk	Past
bámultam	Past
feltöltenéd	Present
transzformáljon	Present
átadó	Present
meghatna	Present
feledik	Present
imádkozzon	Present
verseiről	None
elfojt	Present
közelítik	Present
kísérnek	Present
takarnak	Present
végiggondolták	Past
ösztökélték	Past
székhelyéhez	None
beavatkozik	Present
halálbüntetéstől	None
vágyódó	Present
kiegészítettem	Past
gurítsa	Present
kihagytad	Past
bebizonyítandó	Future
évadokban	None
reszkessünk	Present
bocsátandó	Future
céloztam	Past
rágalmazó	Present
kancsalítanánk	Present
intenek	Present
belépő	Present
nyelvem	None
jelöljön	Present
próbálkozni	None
horgászzsinórokért	None
suhantunk	Past
kijelentenéd	Present
énekesmadarakként	None
ellátogassanak	Present
figyelmeztetőkért	None
elfojtanál	Present
soroló	Present
ösztönözne	Present
fektessünk	Present
kitöltök	Present
előállít	Present
körén	None
feledtem|	Past
sivatagba	None
tanulmányhoz	None
szállítsák	Present
vezényeljétek	Present
aktákat	None
megőriznek	Present
várakozó	Present
korszakból	None
átalakítjuk	Present
aggódtam	Past
kérelmezték	Past
újraparticionáltatok	Past
fertőtlenítő	Present
levonták	Past
térfogattal	None
tutaj	None
bevezesse	Present
folytatódnának	Present
gondolkozzunk	Present
felhőkön	None
feltámassza	Present
fogyóholdakig	None
megleptél	Past
fényelektromos	None
hallgatja	Present
térítő	Present
éjjelekben	None
feláldoznak	Present
ürítik	Present
öleli	Present
kinéznek	Present
megmozgatják	Present
beállítják	Present
balalajkákként	None
kiújul	Present
csinál	Present
egybekössétek	Present
cégeknél	None
elszalasszanak	Present
szünettel	None
megtelik	Present
továbbították	Past
eljutsz	Present
bombázó	Present
pályáztam	Past
billennek	Present
tudósít	Present
lando	Future
elismerje	Present
kosárlabdáznánk	Present
lakomázó	Present
szítson	Present
megengedettekből	None
gőzhajóval	None
feltámasztja	Present
értesülünk	Present
sebekkel	None
szimatol	Present
ginzeng	None
véníts|or|	Present
ösztönözné	Present
blansírozzatok	Present
megkönnyítené	Present
értékesítse	Present
elsötétítendő	Future
fénysebességet	None
szárnyassá	None
determinánst	None
kapar	Present
vékony	None
elfelejtetted	Past
festőművészek	None
korosztályoknak	None
megkérjék	Present
jegyeznem	None
röhögte	Past
elindító	Present
előbbiből	None
diszpécser	None
növeljék	Present
madárijesztőt	None
labdajátékokhoz	None
bíz	Present
kísérjünk	Present
keskeny	None
kijavítjuk	Present
fűből	None
kritikusoknál	None
meghaladjam|	Present
eldöntötte	Past
egyetértenék	Present
meglátogatnak	Present
képére	None
megmutatod	Present
koporsó	None
megkoronáztatok	Past
múzeumról	None
hozzászóljak	Present
térítse	Present
forr	Present
újraválasszátok	Present
fejlesztették	Past
hidegháborúra	None
determinálta	Past
kényszerítené	Present
vesztettem	Past
párbajra	None
stílusokba	None
meséli	Present
kooperáló	Present
ütközzön	Present
fedték	Past
teremtő	Present
levelezzenek	Present
megragadnak	Present
házamon	None
kibővítettem	Past
licencelte	Past
kellemetlenségért	None
elszalasztják	Present
parkolóhely	None
beírná	Present
kontrák	None
rózsatermesztéseket	None
szeparáló	Present
elpusztulnak	Present
bemenne	Present
benyújtotta	Past
egyszínűre	None
fakad	Present
emlékműtől	None
megtudnád	Present
kárpótolták	Past
elférjen	Present
beiktató	Present
kimenetelek	None
szüntetjük	Present
jőttök	Present
értékesítenek	Present
fojtottak	Past
hangol	Present
posták	None
ürültél	Past
megerősítette	Past
majrékká	None
játékfilmet	None
olvasótermekkel	None
csöngetnek	Present
trópusi	None
ismétlődnek	Present
lakójától	None
szabályozó	Present
elkövetik	Present
kategorizáljon	Present
felhasználok	Present
tartozásnál	None
kőpadként	None
sugallná	Present
beleírta	Past
javítsa	Present
keveredjenek	Present
behúz	Present
bérlő	Present
levonva	None
újraéli	Present
vezényeljen	Present
zsákmányolnak	Present
salátát	None
lelték	Past
bírna	Present
kipróbáltuk	Past
transzformációk	None
létrehozzatok	Present
megközelítsék	Present
visszaadták	Past
megszólamoljatok	Present
elképzeli	Present
kitűntek	Past
ruhákért	None
sérti	Present
szakosodnak	Present
semlegesítse	Present
hozzájárultak	Past
csenget	Present
körülmetélsz	Present
évestől	None
továbbító	Present
desztillálnak	Present
meglátogassa	Present
megelőzték	Past
korosodjanak	Present
távvezérlő	Present
pengőbe	None
központból	None
tanítsák	Present
szórnék	Present
tartóztatnak	Present
listákból	None
spekulál	Present
adoptálta	Past
ellenkezne	Present
leírásra	None
tisztogató	Present
megakadályozta	Past
felújító	Present
összekötjük	Present
utánanéznék	Present
gázlóról	None
megerősít	Present
megfejtsd|or|	Present
retusáltak	Past
kínozta	Past
viseljen	Present
elvárták	Past
elválasszák	Present
távoztam	Past
évforduló	None
vezetésen	None
erdészként	None
eltűnne	Present
őrzitek	Present
ökonómia	None
közelítene	Present
elszalasztottam|	Past
szögre	None
elrendelték	Past
elmennek	Present
rájöttem	Past
lógna	Present
listában	None
hívével	None
módszertanba	None
vesztenek	Present
gondoz	Present
stíroltunk	Past
vizsgázik	Present
bővültek	Past
fegyverzetként	None
elmerengtél	Past
felverjetek	Present
legeljek	Present
mozdulnak	Present
pártokkal	None
kísértetek	Past
olasszal	None
feltártunk	Past
megköveteljek	Present
konferenciákért	None
kútnak	None
zárulnak	Present
bejövő	Present
zoknit	None
elfoglalná	Present
kibocsátások	None
bírtok	Present
szavalnak	Present
szükségesnél	None
rezisztenciából	None
felakasztják	Present
beadta	Past
temeti	Present
reszkessetek	Present
oldalaként	None
importáltak	Past
figyeljétek	Present
felébresztik	Present
diszken	None
lezárással	None
kicseréljünk	Present
gépfegyverre	None
csinálná	Present
mészárolta	Past
hazudtam	Past
napokhoz	None
kenuban	None
kompenzálta	Past
reklámozzon	Present
megtette	Past
megijedtem	Past
mocsarakhoz	None
támadjon	Present
eltűntek	Past
fixáló	Present
latolgatta	Past
íródsz	Present
bűvölnél	Present
gyümölcsleveket	None
száműzzék	Present
megbántam	Past
jellemez	Present
pályáztak	Past
elszalasztotta	Past
részeikké	None
ellentmondó	Present
elszenvedték	Past
eredményezünk	Present
merészelném|	Present
beszerezte	Past
konstruálunk	Present
napilapba	None
árvizet	None
elképzelésekhez	None
illeszkedjenek	Present
berúgnának	Present
komponáltak	Past
redukál	Present
megakadályozzak	Present
dalol	Present
befejezted	Past
szimatoltuk	Past
figyelünk	Present
beléptél	Past
tartózkodásra	None
maszturbál	Present
kiábrándítanám|	Present
elkóborolnak	Present
fokozatba	None
fluxust	None
egészítettek	Past
hápogok	Present
szimulálnál	Present
eldobó	Present
elhelyezünk	Present
megnézed	Present
vastagítsd|or|	Present
bámuló	Present
megteremtésekről	None
áttekintések	None
anyák	None
ködösíteném|	Present
fokozandó	Future
egyenlítőnél	None
visszatértünk	Past
végzetesekként	None
fókuszáljunk	Present
ejakulál	Present
lovagolta	Past
összehasonlító	Present
megírná	Present
söpör	Present
jegyezzék	Present
mechanizálná	Present
kijavítottam	Past
aszimmetrikusakba	None
diagnosztizáltok	Present
kitüntetésbe	None
rómaiakra	None
megnövekednénk	Present
kezdeményeznek	Present
kényszerülő	Present
számlálod	Present
tükrözzek	Present
diplomáktól	None
jegyeket	None
közért	None
megölsz	Present
beszerzi	Present
kerítettek	Past
hangsúlyozta	Past
atlétika	None
kinyitod	Present
létrehozunk	Present
gazellák	None
legszárazabbakká	None
ablakomba	None
előmozdítja	Present
kiadnák	Present
kinevezzék	Present
elkíséri	Present
talpnyaló	None
kimenetek	None
ítéltem	Past
lélekről	None
vállalkoznék	Present
feltalál	Present
elmegyünk	Present
keríti	Present
lezárná	Present
kinevezze	Present
kihagytam	Past
pehelysúlynál	None
tapsoljatok	Present
titkolták	Past
elrendezte	Past
felkiáltójellel	None
viadalokba	None
méltóakra	None
végrehajtunk	Present
ámította	Past
megismerték	Past
elhelyezzék	Present
gerellyel	None
feltöltő	Present
forgandó	Future
tisztázó	Present
kantonra	None
megelőztél	Past
filmezné	Present
gyűlölnek	Present
üveg	None
beleszólunk	Present
rengenek	Present
vonyítanám|	Present
magyarázok	Present
ürítő	Present
felakasztja	Present
fagyal	None
temetnek	Present
hadseregből	None
sikáltatok	Past
kiderítse	Present
hódoltak	Past
veszekedik	Present
legeltetik	Present
hurkához	None
részvénytársaságnak	None
töltésen	None
méltóságban	None
megcsinál	Present
tiltakoznék	Present
vírusoktól	None
szappanozok	Present
eltörte	Past
nyilatkoztak	Past
viseli	Present
zónákra	None
elmozdítjuk	Present
fájás	None
kölykezte	Past
sebességtől	None
megmentendő	Future
beágyazzon	Present
akadok	Present
kezeltem	Past
bűnügyinek	None
felkelő	Present
meditálok	Present
felméréséhez	None
figyelné	Present
nevezték	Past
elkészítették	Past
megteszitek	Present
fejlesszenek	Present
feltettük	Past
gondoskodtak	Past
szemlélték	Past
ismerkedtem	Past
szenátusban	None
tóparton	None
ajándékoznák	Present
kezdeményezzen	Present
ingovány	None
búcsúcsókokra	None
rezeg	Present
félreértek	Present
megoldásába	None
feszültek	Past
rágalmaz	Present
cselekedjen	Present
beépítettem	Past
megtiltó	Present
eseményeit	None
tűrték	Past
dörgő	Present
lyukasztották	Past
törvény	None
jelölje	Present
megbocsátottam	Past
kinyitja	Present
igazi	None
megjavít	Present
beszállsz	Present
kompenzálták	Past
kémkedő	Present
leoltsátok	Present
megnyitottam	Past
ügyvédet	None
teremtsék	Present
színezi	Present
áldoznak	Present
eltűnök	Present
átmérők	None
lejár	Present
nyomaszt	Present
feltöltünk	Present
viselkedjen	Present
megnyerjen	Present
obeliszken	None
körülmetélő	Present
fürdőkből	None
színdarabban	None
befedő	Present
üdvözültek	Past
tanulmányaiban	None
játékosnak	None
megtiltottak	Past
viccesen	None
megmagyarázz|or|	Present
különbözzön	Present
kaszabolnak	Present
állapítják	Present
telítsük	Present
megszervezésen	None
beindulna	Present
követelményeket	None
túloztam	Past
lombikbébi	None
megismertették	Past
vasgyár	None
fiákert	None
menetelnék	Present
munkaerőpiaccal	None
fektessük	Present
befejeztem	Past
eredményekkel	None
fókuszál	Present
összeszedik	Present
uralta	Past
reagálnék	Present
csakrák	None
fogyatkoznotok	None
megdönteniük	None
kigúnyoló	Present
időpontjáig	None
csodákat	None
vezérelnek	Present
fülébe	None
egészít	Present
átvegyék	Present
üzemeltessétek	Present
beírod	Present
koccintsa	Present
megnyomó	Present
gondolkoztam	Past
szellőztető	Present
körülnézek	Present
fúrunk	Present
vétkezik	Present
szakítana	Present
elkezdő	Present
dokumentumfilmből	None
egyenruhának	None
vitatkozzunk	Present
dzsókereknél	None
kenuval	None
tévelygő	Present
letöltjük	Present
megöljenek	Present
udvariasság	None
átadná	Present
oszló	Present
testvérektől	None
árultak	Past
tévékészülékek	None
elfojtotta	Past
elképzeled	Present
kifogásnak	None
feltöltötték	Past
krematóriumot	None
ragasztandó	Future
becsülted	Past
igazolásokra	None
megteremtették	Past
császáron	None
illeszkedsz	Present
értesítsetek	Present
furcsaságok	None
szopjanak	Present
címeztünk	Past
kergettetek	Past
ragasztják	Present
felejtesz	Present
aggódtak	Past
terhelje	Present
célszerűtlen	None
berendezéstől	None
átnézné	Present
csinálnák	Present
szoptam	Past
megjelölő	Present
lábadozik	Present
landolták	Past
képzeltem	Past
átszöktek	Past
teszteltem	Past
gyászolta	Past
egyenlet	None
ismertebben	None
megfigyelendő	Future
megosztanak	Present
üzemel	Present
konzerváltak	Past
javasolnak	Present
mészároltak	Past
fennmaradjanak	Present
délibb	None
felhívta	Past
alakítottál	Past
keresztelte	Past
ivartalanítottak	Past
sorsok	None
szervezéssel	None
megakadályoznának	Present
előkészít	Present
beütemezendő	Future
mérsékeljenek	Present
kifejlesztő	Present
szórakoztat	Present
tévelyegtem	Past
válaszoljon	Present
bűnözésről	None
roboráló	Present
tippnek	None
elintézi	Present
javuljanak	Present
kosárlabdázó	Present
szereljék	Present
idegesít	Present
megkönnyítjük	Present
dörzsölik	Present
piócákig	None
blokkoljunk	Present
elkerültünk	Past
alaptalannak	None
püspököktől	None
kilépj|or|	Present
felvettétek	Past
tizenévesek	None
átnevezed	Present
vásárolnak	Present
kapituláltak	Past
megfutamodik	Present
muzsikáljam|	Present
ajándékáról	None
liliomokkal	None
elképzelünk	Present
megemlítené	Present
lemondunk	Present
megnéztétek	Past
szerecsendióhoz	None
jelölésért	None
dühöngtél	Past
nyomornegyedben	None
cigányoknál	None
megjutalmazni	None
irányítaná	Present
fókuszálunk	Present
jegyez	Present
elkísérném|	Present
beteljesülnék	Present
cselekményekért	None
kajáljanak	Present
megmondta	Past
közelítsenek	Present
képviselőről	None
alufóliáknak	None
ámítottuk	Past
összehangolnál	Present
karakterrel	None
vonzanak	Present
huzalokkal	None
szegénységbe	None
reagáltatok	Past
konzerválta	Past
látogattak	Past
világítja	Present
elmulasztják	Present
lenézik	Present
hamisítanak	Present
vergődjünk	Present
versenyképességbe	None
villan	Present
fektetik	Present
karbantartást	None
sovány	None
megjegyzendő	Future
megjelöltek	Past
városiasítottatok	Past
felbontotta	Past
eredményezte	Past
mérgezi	Present
állásáról	None
tolltartókkal	None
improvizál	Present
lakásoknak	None
betenné	Present
kockáztató	Present
ítéletből	None
neutronban	None
áztam	Past
renoválták	Past
hangszerelték	Past
beállítások	None
blöfföltök	Present
köszöntések	None
leülne	Present
sötétkamrákba	None
tanulságosnak	None
vétkező	Present
összeállít	Present
tapasztal	Present
megtapsolta	Past
ültetnek	Present
rögzítettetek	Past
bekerülnének	Present
lejnolnám|	Present
arculcsapáshoz	None
metszi	Present
lenézték	Past
árul	Present
ragasztotta	Past
álmokba	None
befektetés	None
sejtették	Past
megtanulta	Past
eseteként	None
foxtrottozzak	Present
bevertétek	Past
bűzlenünk	None
színezték	Past
feltételeknek	None
postáztatok	Past
tiporták	Past
próbálkoztunk	Past
jutalmaz	Present
boldogul	Present
száműzik	Present
képezték	Past
ültetünk	Present
kifizetve	None
vélsz	Present
ismételje	Present
megállapították	Past
bemutatkozó	Present
órákban	None
elemezze	Present
tevékenykednek	Present
tesztel	Present
rövidzáraknál	None
felteszel	Present
illúziókban	None
megmentenek	Present
megírtad	Past
gondnoknak	None
idealizáló	Present
környezetért	None
találkozzunk	Present
felállítja	Present
szűkekkel	None
miniszterelnöknél	None
betérnek	Present
megbántottál	Past
örökölné	Present
reformáló	Present
szoftverből	None
bocsássa	Present
termálfürdőben	None
letartóztatták	Past
kísérte	Past
tanítanak	Present
csillapította	Past
elindítottunk	Past
síelő	Present
megszereznek	Present
fogadod	Present
ismertet	Present
megegyezzenek	Present
utalta	Past
egészítette	Past
működtette	Past
legrejtélyesebbel	None
megelőzésen	None
kártalanítod	Present
lassítsak	Present
meglátunk	Present
hazájával	None
beszedendő	Future
elhibáztak	Past
nyilvánultak	Past
felbukkanó	Present
epékben	None
vacsoráztál	Past
kedveznél	Present
felhív	Present
beadnék	Present
vonagló	Present
előmozdítsák	Present
vetít	Present
táplálná	Present
megnevezzék	Present
fáradnak	Present
zabbal	None
meggyújtottátok	Past
kapu	None
csempészek	Present
figyelmeztessük	Present
közösségekhez	None
nádból	None
tagad	Present
gazdából	None
kollaborálnál	Present
csellengő	Present
akupunktúrával	None
kalandosakba	None
azonosítókkal	None
magatartását	None
pulykák	None
automatákban	None
sietnék	Present
rejlenek	Present
fejtse	Present
felismertem	Past
bocsátják	Present
megértjük	Present
elmozdítsák	Present
magyaráznak	Present
motivációt	None
pusztította	Past
irányulsz	Present
látogatja	Present
ködösítünk	Present
tétele	None
szövetségeseknek	None
valósultak	Past
kihúzták	Past
dalának	None
kiközösíts|or|	Present
hozzáadását	None
eldöntő	Present
illesztenek	Present
táborból	None
megidézték	Past
ventilálod	Present
keverednénk	Present
illesztette	Past
összeállítja	Present
ostromról	None
rögzítsen	Present
üvöltözök	Present
hangszerelésekké	None
robbanásokban	None
részletezzetek	Present
tiltanak	Present
tévesztő	Present
kijavítsd|or|	Present
pácoltam	Past
egészítsék	Present
állatkórházról	None
tágulnak	Present
padlók	None
sütsz	Present
akadtál	Past
megmutatja	Present
feltüntetnek	Present
javítottak	Past
legcsúnyább	None
vinnyogó	Present
elveszted	Present
következtetsz	Present
indokoló	Present
tűrtem	Past
adományoztak	Past
elfogták	Past
időkapszula	None
vágynék	Present
szerepekkel	None
utaltak	Past
célból	None
megnyertem	Past
felszereléseknél	None
díjazták	Past
megsemmisítették	Past
májhoz	None
hanyatlik	Present
meghajol	Present
ormányokkal	None
jezsuitákhoz	None
sebzi	Present
törmeléktől	None
kijavítandó	Future
belebeszéljék	Present
szabjanak	Present
randevúzik	Present
lovaglandó	Future
padolj|or|	Present
megfertőzzünk	Present
csodaszépekkel	None
elbarikádoztál	Past
buborékoltatok	Past
nőstényeknél	None
főttnél	None
írnokként	None
titkosította	Past
legyező	Present
befektette	Past
árkokban	None
javasoltunk	Past
garantírozta	Past
emlékeztetnek	Present
módszerekhez	None
súlyban	None
tájjá	None
verseiért	None
megőrizzék	Present
kérésének	None
profil	None
tetováljam|	Present
elszenvedte	Past
találgatok	Present
kijöttek	Past
földelte	Past
koordináló	Present
megelőznek	Present
szeletelsz	Present
megpróbáltunk	Past
elutasította	Past
emlékeztető	Present
jutalmazták	Past
elismerted	Past
megláss|or|	Present
álcázó	Present
vergődik	Present
másolatán	None
felszerelések	None
szaknyelv	None
intézményeken	None
szemlélte	Past
holttestekkel	None
tiltotta	Past
tapsoltak	Past
elkészítsék	Present
rögtönzik	Present
baglyoknak	None
antropológián	None
restellnél	Present
üzemeltesse	Present
panaszokra	None
masírozzak	Present
megbeszéltünk	Past
improvizálunk	Present
megérintenél	Present
fosztogatnak	Present
nagyobból	None
javasolsz	Present
létesültek	Past
letöltő	Present
emelkedne	Present
hibáztatják	Present
bemutatkozik	Present
abronccsá	None
uralkodón	None
indukálnád	Present
sikító	Present
ápolót	None
kezdeményeztem	Past
feltöltsék	Present
fogalmazzon	Present
archiválandó	Future
egyenletről	None
csórtak	Past
összegyűjtötte	Past
kertészetekben	None
színleled	Present
taglalták	Past
elmélkedik	Present
befejez	Present
gátolnak	Present
tévedtünk	Past
vesszük	Present
terhelik	Present
belföldről	None
húron	None
kicseréli	Present
együttműködjön	Present
kávézó	Present
mozgató	Present
talicskává	None
tisztítsuk	Present
működtetéséhez	None
bemutatnak	Present
oxidáló	Present
sikoltottuk	Past
bírtuk	Past
elbeszél	Present
határidőben	None
javítanak	Present
metszenek	Present
rómaiakhoz	None
megkaparintották	Past
javítsanak	Present
kialakítsa	Present
elhúzták	Past
orron	None
megfizetsz	Present
jövőjéhez	None
megszakítottak	Past
előfizessen	Present
gyűltek	Past
hitelesítő	Present
bánjon	Present
recenzióhoz	None
beszámoljanak	Present
étlapot	None
szezon	None
megjelöltem	Past
négyzetméterrel	None
komplikáltak	Past
technikusokat	None
megszüntetik	Present
pszichoterápiákig	None
keretein	None
kihagynak	Present
erősítéssel	None
kiabál	Present
visszavegye	Present
sportolnak	Present
megjelenítettek	Past
reptérrel	None
mulattok	Present
becsukták	Past
parmezánba	None
vezérelték	Past
vitattuk	Past
íródó	Present
archeológiát	None
kipusztuljanak	Present
forgalmához	None
minősítő	Present
elnökség	None
partizánokhoz	None
dörögnének	Present
küldöttségben	None
hintették	Past
letartóztassa	Present
kifejti	Present
lökte	Past
országossá	None
túlzásokra	None
forogjak	Present
építésűhöz	None
fenyegettem	Past
programjuk	None
engedelmeskedjünk	Present
vitatta	Past
elbarikádozta	Past
egészítse	Present
bővítesz	Present
szakítsd|or|	Present
újítunk	Present
kiépítésre	None
járuljanak	Present
viselkedünk	Present
közlekedő	Present
megfelelne	Present
sorolsz	Present
apátnőhöz	None
elveszítő	Present
hamisítanád	Present
megérintenének	Present
kísérné	Present
jelöljétek	Present
szerválok	Present
megnyerjék	Present
észlelek	Present
részéből	None
elhatározzunk	Present
hatalomért	None
működtess|or|	Present
boldogulnak	Present
hadarna	Present
beismerik	Present
rendezze	Present
emésztettek	Past
ugráljon	Present
konstatáltam	Past
raboljanak	Present
hever	Present
cipel	Present
összegező	Present
döfök	Present
kódolj|or|	Present
huzatokból	None
felszerelik	Present
pályáznak	Present
féltette	Past
kravátlin	None
sértettél	Past
elrabol	Present
szokta	Past
szórakozunk	Present
fogadjunk	Present
kockáztattak	Past
ügynökségnek	None
kereszteltél	Past
hozzászólsz	Present
szirmot	None
megemlítse	Present
átvennéd	Present
elvesznének	Present
elvégezze	Present
igyál	Present
iktat	Present
tallózó	Present
okirat	None
folyamtól	None
székelő	Present
tombolták	Past
robbanjon	Present
szenvedek	Present
pukedliztam	Past
körbevevő	Present
mutánsnak	None
irányultak	Past
cáfolták	Past
nyelvkurzusokhoz	None
feltételezték	Past
mutatkozni	None
világirodalomba	None
szerelőre	None
izzad	Present
erősítsetek	Present
tojnak	Present
dicsérték	Past
toborozzanak	Present
megveszünk	Present
gondolkodjon	Present
zajlana	Present
elhitték	Past
öltötték	Past
összehasonlítják	Present
elnyomtak	Past
hotelben	None
kifosztottatok	Past
legidősebbektől	None
kabócák	None
taníttassa	Present
aknákat	None
kialakít	Present
bendzsót	None
zúznál	Present
újítanak	Present
ötletnek	None
teljesítette	Past
összehangolták	Past
berendezték	Past
jelölsz	Present
létrehozzunk	Present
birtokokat	None
nyeregben	None
házikecske	None
zsákmányoltak	Past
aludtam	Past
meglátogató	Present
növelje	Present
megéhezik	Present
elindulunk	Present
fegyelemről	None
teljesítették	Past
elektront	None
üzenetére	None
irányba	None
köbméterekhez	None
vinnyogj|or|	Present
elkészültem	Past
sietünk	Present
belépőjegyekkel	None
kiszállok	Present
nyomozóval	None
készíttet	Present
leverő	Present
betettem	Past
akadályozó	Present
beszerezze	Present
üldözze	Present
kizárjatok	Present
illesszük	Present
moralizáló	Present
szaxofonon	None
elenyészőbbnek	None
szavaznának	Present
hadihajóra	None
nevezzen	Present
péppel	None
fejezte	Past
melegebbé	None
üzemelteti	Present
hozzáteszed	Present
elbarikádozó	Present
visszatértél	Past
kifizessék	Present
randevúznak	Present
vésik	Present
kiadná	Present
ösztökéli	Present
átnézi	Present
szállítják	Present
kérelmezne	Present
kienged	Present
megnyitotta	Past
fésüli	Present
baromságnak	None
poszterrel	None
fénykardig	None
megmentsenek	Present
megerősítenek	Present
felálljunk	Present
egybeírtunk	Past
megalázzon	Present
felhasználásig	None
kikapcsolta	Past
helyreállítások	None
feltöltöttek	Past
rosszindulatúnak	None
halomból	None
tapadtak	Past
irányul	Present
megszűnése	None
pályázatokon	None
részletezték	Past
megvásárol	Present
elsodorták	Past
tanúsít	Present
összekeveri	Present
funkcióval	None
barátságba	None
indukálta	Past
szépítő	Present
gyönyörben	None
szolgálatnál	None
neveztél	Past
utolérjék	Present
előadta	Past
adoptáljam|	Present
hivatalként	None
pataktól	None
bántjuk	Present
alábecsülve	None
hódítod	Present
bejegyezték	Past
koordinálta	Past
szórakozó	Present
kifizette	Past
fotóiból	None
hozzájárul	Present
kategorizáltak	Past
hívőre	None
tapsolnak	Present
forintnak	None
megtudod	Present
másolod	Present
vitorlába	None
egyetértünk	Present
megkezdte	Past
eljuttatja	Present
anyagtól	None
balesetekben	None
emberein	None
tükrözték	Past
idézzünk	Present
végződő	Present
megunták	Past
szimuláld|or|	Present
alkottam	Past
összerakta	Past
találkoztatok	Past
formáitól	None
pápaság	None
megerősítendő	Future
bővülő	Present
elesik	Present
becsültek	Past
kérdezted	Past
importáló	Present
kényszerítették	Past
kitöltenek	Present
kiválasztunk	Present
tenyésztettük	Past
alkatrészekkel	None
elversz	Present
elbeszélgetés	None
neutronokra	None
polihisztorok	None
egyezzenek	Present
mendeléviumnál	None
megfog	Present
indítottam	Past
megfertőzzetek	Present
feltételezi	Present
kérdezzék	Present
szaporodjanak	Present
véglegesítik	Present
kilépjenek	Present
visszatérjek	Present
modernizálna	Present
vetítettek	Past
fagyasztó	Present
elviselte	Past
operáltuk	Past
mulasztja	Present
lobogó	Present
vízisíelnél	Present
megverő	Present
oxidálnak	Present
levonjanak	Present
kekszben	None
visszaél	Present
jogorvoslatokra	None
körökből	None
igazad	None
túllépte	Past
kiállítottak	Past
nyilatkoztál	Past
űrpályáig	None
hasonlóságokhoz	None
értesítenek	Present
növeléseket	None
megértik	Present
szánalomig	None
hozzátesz	Present
térítsem|	Present
szigetel	Present
megmentettek	Past
elmozdítottak	Past
vezekeljen	Present
ellenállástól	None
részesítették	Past
kiderítjük	Present
gimnáziumra	None
feltettél	Past
helyesbítő	Present
kiderítsék	Present
átnevező	Present
következtetnek	Present
üzemmódokban	None
leülök	Present
részletező	Present
megismerjék	Present
szavazzon	Present
képességeiért	None
merészelek	Present
látogatta	Past
felnéznek	Present
harcért	None
tévénél	None
kényszerítsék	Present
megoldottuk	Past
forgatónyomatékokkal	None
kényszerítse	Present
fertőtlenítendő	Future
birtokoltak	Past
angyalnak	None
utasítjuk	Present
kommentáló	Present
rohadó	Present
létet	None
sorozatától	None
elférsz	Present
agyonvágnék	Present
rejtik	Present
megkértem	Past
exportálta	Past
szerkessze	Present
filmjében	None
minősíts|or|	Present
javasolták	Past
denevért	None
jóváhagytam	Past
visszamentem	Past
vonatból	None
harcolva	None
lassította	Past
megtizedelték	Past
feltételezel	Present
kérdéses	None
fütyülték	Past
járultam	Past
bosszantsa	Present
áltatandó	Future
gyertyától	None
fenyegess|or|	Present
járőröznek	Present
felejtsük	Present
bevándorlókban	None
komponál	Present
lovagi	None
keringenek	Present
kiválasztasz	Present
elálljon	Present
műemlékekről	None
mélyét	None
térddel	None
folyóhoz	None
fojtó	Present
közelítjük	Present
tatarozták	Past
bolygónak	None
hamisítással	None
hidrogénbomba	None
rámutatnál	Present
epilepsziásoknál	None
konszolidálta	Past
virradó	Present
tolódnál	Present
befedtétek	Past
bizonyította	Past
latolgatja	Present
megkéred	Present
elkészítő	Present
színezte	Past
kereszteli	Present
felfüggessze	Present
megláttam	Past
felakasztanak	Present
sebezne	Present
hosszabban	None
mélyére	None
forrasztó	Present
egyetért	Present
lóhere	None
tajvaniról	None
állomásba	None
lefoglaltam	Past
megfordulnak	Present
fejeztük	Past
rendezne	Present
bókol	Present
erősítő	Present
rettegnek	Present
meghaladó	Present
energiákat	None
kedved	None
tilalmakat	None
toleráló	Present
célon	None
vérrokonságra	None
lakjanak	Present
tapintanám|	Present
beismeri	Present
dokumentál	Present
beleszóltam	Past
gyönyörűséget	None
avul	Present
engedélyezték	Past
elrendeli	Present
remilitarizáltad	Past
függvény	None
megjutalmazta	Past
befonnék	Present
tolatok	Present
megmagyarázná	Present
vésse	Present
zaklatja	Present
bérelj|or|	Present
örökölték	Past
megvédjen	Present
alvilággal	None
kifutón	None
pusztító	Present
közvetítik	Present
körbevették	Past
filmjének	None
bemutatkozzon	Present
fejtette	Past
gurítanád	Present
sportoltál	Past
tevékenységeknél	None
uszították	Past
hátrálunk	Present
döngetsz	Present
visszavágtak	Past
riasztanak	Present
tetováltunk	Past
bizonyítunk	Present
exportáltak	Past
sugalltátok	Past
mértékek	None
értesül	Present
megvalósít	Present
legeltetnek	Present
megtudná	Present
megemlítik	Present
keltette	Past
halásszam|	Present
eltávolítsa	Present
vitázzunk	Present
rágalmaztam	Past
hallgatták	Past
alkalmazó	None
pletykákat	None
kisméretűvé	None
halványuló	Present
korszerűsítse	Present
színlel	Present
elveszne	Present
szállítanák	Present
templomokban	None
sokkolta	Past
szellentenénk	Present
klinikákig	None
vonzódtak	Past
kivittek	Past
megszólaljon	Present
meneteltünk	Past
macik	None
viadalokra	None
ciripelő	Present
szennyezik	Present
tolerál	Present
utánozták	Past
nyilatkozták	Past
mozgatnak	Present
bajok	None
csábítsák	Present
kultúrákkal	None
kormányoznák	Present
ápoló	Present
osztoznátok	Present
bízik	Present
megfosztó	Present
köddé	None
megvalósítják	Present
renoválta	Past
csitri	None
megkülönböztető	Present
étkezőt	None
felismerjék	Present
szavaznál	Present
elírta	Past
toldottak	Past
formál	Present
megnövekedő	Present
befecskendezésekként	None
döngenénk	Present
feltartja	Present
duzzadó	Present
módosul	Present
összefogtak	Past
kötelekből	None
hordozó	Present
füleinkhez	None
újraparticionálok	Present
elkorcsosodtak	Past
vesztesz	Present
megöljön	Present
operáló	Present
megtörténnek	Present
szína	Present
eldobta	Past
cérnává	None
felriad	Present
erősítettek	Past
lejátszották	Past
lakmározik	Present
másolandó	Future
szoptatnád	Present
megtettük	Past
telítődjünk	Present
bejöttek	Past
rögzítünk	Present
diktálták	Past
langyosakba	None
feledje	Present
megnyugtassa	Present
struccok	None
kisebbítsd|or|	Present
allergiásak	None
kiválasszon	Present
megfagy	Present
szabotázzsal	None
reprezentálnak	Present
kifejlesztette	Past
lófarokba	None
levéltáriaktól	None
dugták	Past
haragszik	Present
memóriakártyával	None
szabtam	Past
megbocsátanak	Present
elutasít	Present
vetkőztetnéd	Present
versenyektől	None
válaszolnak	Present
kiválasszuk	Present
elsodrok	Present
fókuszáló	Present
felvegye	Present
javítod	Present
tündéről	None
újít	Present
modernizáld|or|	Present
kijavítottuk	Past
elárulta	Past
hangoló	Present
zsákmányolta	Past
importálta	Past
feküdtél	Past
részesítettem	Past
nyögnél	Present
halhatatlanságba	None
csodálkozunk	Present
megerősödtél	Past
feltenned	None
elismertetek	Past
terelgette	Past
borba	None
megmutatják	Present
jégszemre	None
meglátná	Present
padlóval	None
vetekedtetek	Past
tárgyaljunk	Present
udvarokba	None
kompromittál	Present
megérdemled	Present
rejtettek	Past
malmokkal	None
megtizedeli	Present
századra	None
képzelsz	Present
baloldaliak	None
hallószerv	None
jődögélnétek	Present
nevez	Present
sötét	None
viszonyulnotok	None
megölné	Present
vásárolna	Present
fülkébe	None
adományoz	Present
tolmácsoltatok	Past
megfigyeltem	Past
képzelnek	Present
kereténél	None
hangzanak	Present
weboldalakra	None
kihalnak	Present
túlélte	Past
látogassák	Present
egyesítsük	Present
lefordítjuk	Present
növesztettek	Past
fenyegetné	Present
meggyőzi	Present
megcsinálok	Present
teljesítené	Present
izzadó	Present
munkatársaknak	None
távvezéreltétek	Past
kooperál	Present
semlegesíteném|	Present
megtartják	Present
szituációkkal	None
feszítő	Present
gépel	Present
táplálkozzon	Present
pszichiátrián	None
visszavág	Present
mozgatandó	Future
laptopról	None
rugalmasba	None
veszítene	Present
kibővít	Present
árulta	Past
vadászatából	None
szopó	Present
felhívó	Present
fogadalmakról	None
zárkóznak	Present
túlél	Present
fenyegesse	Present
blokkoltak	Past
levegye	Present
hímnemekként	None
bánsz	Present
kezdeményező	Present
kortyolandó	Future
vezekelnek	Present
lakna	Present
válaszoltak	Past
leszálltak	Past
ölelő	Present
robban	Present
lebeszélték	Past
bejelentkezésre	None
megtartsuk	Present
kiterjednek	Present
lemondjak	Present
posztoló	Present
szerkesztene	Present
emlékműnek	None
megegyezik	Present
lepje	Present
tanúskodjon	Present
összegyűjtöttetek	Past
csomagolta	Past
szája	None
űr	None
tiltakoznának	Present
sebző	Present
harcolok	Present
megérintette	Past
löknek	Present
fiktívből	None
elhalasztották	Past
válogatottaknál	None
kísérleteztünk	Past
misét	None
tömörülő	Present
könyvtárakért	None
megtenne	Present
magyarításra	None
elfogtam	Past
kitöri	Present
értesítsen	Present
tüzelte	Past
dicséri	Present
kiáltottunk	Past
legalizálták	Past
vitatkoztam	Past
módosítunk	Present
szégyennek	None
védelmez	Present
közötti	None
kifejezésektől	None
törjünk	Present
továbbítsák	Present
elfelejtjük	Present
daráló	Present
összehívták	Past
beleírandó	Future
kezdeményezzünk	Present
erősíti	Present
élvezeteket	None
tévedésbe	None
aranyozó	Present
szennyező	Present
teremti	Present
rábeszélték	Past
visszavonó	Present
életedért	None
ellenőriznek	Present
alakítok	Present
személyiségekhez	None
mérgező	Present
ideírtál	Past
komplikálta	Past
közeg	None
következtették	Past
szerződtök	Present
fejlemény	None
sonkát	None
korcsolyázik	Present
kitörjenek	Present
megerősítéseket	None
szentélytől	None
rájönnek	Present
összegyűjtesz	Present
elmozdítsa	Present
benyújtsuk	Present
merültem	Past
ütköznének	Present
felhatalmazva	None
átkot	None
rehabilitálta	Past
mosdik	Present
kölcsönkéri	Present
támadna	Present
beavatkozzanak	Present
géppel	None
üzenetbe	None
tarlókon	None
mulasztotta	Past
következtetésekről	None
ítélek	Present
mérkőzéseken	None
szakértelemről	None
betették	Past
imádkozunk	Present
bezárnak	Present
útikönyvben	None
megjelenését	None
testvériségben	None
kihíváson	None
előállításnak	None
elrontottam	Past
észlelő	Present
lezárulna	Present
beépítsem|	Present
dacoló	Present
metszette	Past
keringő	Present
idegesítsetek	Present
tiltakozások	None
kérdőjeleknek	None
landoltak	Past
díjazta	Past
mértékeként	None
tükrözik	Present
vitatkoztok	Present
tüdőre	None
értelmében	None
szavaztátok	Past
barlangászért	None
szemetel	Present
tárgyalná	Present
üdvözölte	Past
kínzó	Present
urológia	None
famózusként	None
összezsugorítotok	Present
fokoznád	Present
körbevesznek	Present
elvárnád	Present
opera	None
intézzen	Present
öregebbekként	None
szít	Present
öltötte	Past
tevékenykedjek	Present
megvenne	Present
becsapnak	Present
kókuszolaj	None
emlékével	None
blokkoltok	Present
ujjong	Present
mulat	Present
ösztönző	Present
megölik	Present
szereplőiből	None
eltávolítják	Present
hanyatlanának	Present
adományozta	Past
milliomosnőért	None
sorozatokon	None
ünnepeltük	Past
szemlélteted	Present
stimmelne	Present
ébenfán	None
elindítjuk	Present
helikoptereket	None
kisasszonyból	None
rábeszéljétek	Present
megújulnak	Present
intse	Present
módosuló	Present
megfertőzni	None
minősítsék	Present
zúzták	Past
bántotta	Past
megmozgatta	Past
legeljetek	Present
utalnék	Present
útjából	None
elkövették	Past
buzgóságokért	None
bárányfelhővel	None
dúskálsz	Present
megállították	Past
beállítsa	Present
nemzetek	Present
figyelmeztetted	Past
kampókkal	None
bevezetésével	None
idegorvos	None
tolongok	Present
nyálkát	None
lejárjam|	Present
okáért	None
feltartanak	Present
viselnek	Present
limitálta	Past
megválasztunk	Present
vegytanoknak	None
tanulunk	Present
tisztította	Past
megtermékenyítéssel	None
limuzinoknál	None
kancsókat	None
kivitelezését	None
elrontották	Past
szabadalmaztattak	Past
kiegészítettük	Past
attrakciók	None
repülőtérnek	None
rendezzen	Present
kifosztják	Present
táncolnék	Present
sugárzó	Present
javítottuk	Past
bizottságán	None
ösztönözte	Past
keletkező	Present
kelletsz	Present
fókuszáltak	Past
kóstoljam|	Present
merüljenek	Present
elnéző	Present
felülkerekedik	Present
ellátandó	Future
bővítetted	Past
kezdeményezze	Present
megöltök	Present
átalakuljon	Present
lógok	Present
műveltségben	None
szivárványon	None
függvényekre	None
telítődnek	Present
csontváz	None
társítandó	Future
szintetizálnak	Present
fogalmazod	Present
szerelvényhez	None
termeszt	Present
szörpök	None
mentőautókért	None
mikroszkópban	None
megvegye	Present
átveszik	Present
megpróbálunk	Present
fektetnek	Present
légkörnek	None
kérdjen	Present
becsülve	None
mozgassák	Present
törlésekről	None
fakasztanák	Present
megtudták	Past
előállításával	None
gyermekeiből	None
koldusként	None
kerületen	None
emigrálnék	Present
ideáig	None
felébreszti	Present
szülök	Present
hűsöltetek	Past
lakunk	Present
szerver	None
megállapítottad	Past
zsákmányolták	Past
feltetted	Past
fogadjanak	Present
összekeverte	Past
felismerte	Past
csataként	None
lefejezték	Past
helyreállítják	Present
tárcsázni	None
retusálták	Past
évesen	None
egyházfőről	None
elvesztették	Past
járulnia	None
bejegyzi	Present
parancsokat	None
nyilvánítsák	Present
elvégzi	Present
bérel	Present
szerkesztenél	Present
hallgatják	Present
üzenjenek	Present
meditálnak	Present
bekerültetek	Past
kriptont	None
szakközépiskolában	None
képviselet	None
megkönnyíted	Present
korszerűsíti	Present
bohóckodó	Present
jelöltem	Past
öltsd|or|	Present
ártottam	Past
könyörgő	Present
lerakódva	None
észleljék	Present
fekszik	Present
szakítanak	Present
várttal	None
közelítettetek	Past
feszíti	Present
rendezed	Present
eltávolítottak	Past
felírsz	Present
torzul	Present
adunak	None
ablaktól	None
kölyök	None
szabályainak	None
növeld|or|	Present
aganccsá	None
újságírás	None
kiszámítjuk	Present
elveszítünk	Present
kielégítenél	Present
eltörtek	Past
különböző	Present
félrebeszélnénk	Present
felszabadít	Present
rámutatok	Present
üvegből	None
lelkiismerettel	None
nyomoztam	Past
káposztát	None
címezném|	Present
múljon	Present
megtartandó	Future
közelről	None
megtartaná	Present
diszkvalifikálta	Past
felmegy	Present
festőkkel	None
megöltük	Past
járőrözzön	Present
kompaszokat	None
kórokozóval	None
értékesítettek	Past
felkínálta	Past
címezte	Past
listáért	None
üvöltse	Present
bohóckodik	Present
kérőre	None
klubbá	None
értékesítették	Past
figyelnél	Present
beinduló	Present
domboldal	None
életrajzzal	None
megakadályoztak	Past
tiltunk	Present
fogadtak	Past
beadtam	Past
gépelné	Present
kiáltottak	Past
ismerkedő	Present
történetek	None
szinkronizáló	Present
bever	Present
akadtam	Past
postától	None
labdarúgó	None
zuhan	Present
megújítandó	Future
hatóságoktól	None
alapoz	Present
kerítünk	Present
beküldték	Past
fogyatkozik	Present
megtanulnak	Present
pulzáló	Present
rejlő	Present
horoszkópot	None
hozzátettek	Past
igényei	None
fojtsa	Present
kezeli	Present
likvidálunk	Present
görkorcsolyában	None
moralizálj|or|	Present
forrásponton	None
kereszténységen	None
gyógynövényből	None
elmének	None
pezsgősektől	None
sorolandó	Future
tudakolnának	Present
kontaktlencsének	None
mosolygok	Present
címe	None
fejezzen	Present
ropjak	Present
megnyeri	Present
érdekesebb	None
szabályzatra	None
szopik	Present
nyomtató	Present
zakatolnátok	Present
címedre	None
megtárgyalandó	Future
zsenialitás	None
fejlesszen	Present
bántottál	Past
elkobozták	Past
sütné	Present
kodifikálták	Past
licencel	Present
tágít	Present
lejátszotta	Past
megölő	Present
tájékoztatóban	None
felhívnak	Present
felmondanak	Present
elnyerő	Present
kihagyandó	Future
bombázóknak	None
eltávolítjuk	Present
gyerekjátékok	None
megvilágosodik	Present
szülik	Present
cukrászdába	None
következtetve	None
fenyegette	Past
liturgiából	None
munkásságáról	None
pirosnak	None
kódolta	Past
megszakítjuk	Present
kicserélik	Present
gazdálkodásnak	None
farol	Present
nadrágra	None
borotvára	None
kezdeményezne	Present
feszítettek	Past
képességekért	None
vélek	Present
áttekinti	Present
meglátogassák	Present
helybenhagyó	Present
nekilásson	Present
részecskékkel	None
költi	Present
masíroztak	Past
laknak	Present
tárulnak	Present
torzulnál	Present
emeli	Present
reklámoztak	Past
menedzsereket	None
varrógépről	None
örökséghez	None
elvégezzék	Present
vesszen	Present
soros	None
hírlapokként	None
közelítették	Past
mintával	None
egyesítsék	Present
egyeztették	Past
panaszaikká	None
összekösse	Present
autóbuszokhoz	None
fogyatkoznak	Present
megengedsz	Present
elbűvöli	Present
nyíllá	None
felkerestem	Past
hegesztendő	Future
zöldségeseknél	None
weben	None
formáltak	Past
kivonták	Past
zsibbassz|or|	Present
kiválaszt	Present
stabilitást	None
áttekintetted	Past
megírjon	Present
utalásokra	None
bámulta	Past
bemutatták	Past
megáldunk	Present
felébresszék	Present
elindítottad	Past
kalucsnikig	None
megállna	Present
harmonizáltad	Past
íródtak	Past
tűzvédelemmé	None
emészti	Present
figyeltem	Past
tárgyaltunk	Past
hangolta	Past
megtaláltál	Past
füleimbe	None
ördögöknek	None
keletkeznének	Present
voksol	Present
válaszolta	Past
újraélesztették	Past
kulimászoknak	None
hűvösek	None
leírtak	Past
okítja	Present
romboltak	Past
lenéz	Present
analízissel	None
megvásárolta	Past
tojták	Past
hozzátettetek	Past
elvégeztem	Past
örököljék	Present
dervisért	None
megismertető	Present
növendékek	None
viselek	Present
kifolyok	Present
menedéket	None
megállapítják	Present
működtet	Present
tanuljon	Present
elhiszünk	Present
viszontlásd|or|	Present
bakancsokig	None
végezne	Present
költök	Present
kocsonya	None
központjában	None
megkapunk	Present
javítottál	Past
színesben	None
állapít	Present
kifizet	Present
végrehajtsátok	Present
fűtöttél	Past
bírnák	Present
vedel	Present
alapjából	None
butaságból	None
vastagodó	Present
megállapítottak	Past
kandelától	None
fogalmaztad	Past
lemondó	Present
elvernének	Present
elaludtak	Past
bátorítsák	Present
rablókra	None
tanúskodik	Present
elküldik	Present
átadta	Past
olajfestménynél	None
elhagytatok	Past
felírták	Past
javítandó	Future
szárították	Past
megindítsa	Present
engedelmeskedünk	Present
elhatározó	Present
kérded	Present
bekövetkezne	Present
vetések	None
hámló	Present
felejti	Present
szétesnek	Present
kijelentetted	Past
bombázva	None
előírnak	Present
adatlapjaihoz	None
falucskában	None
elegánsnak	None
orcán	None
rögzíti	Present
megbeszéltétek	Past
megidéző	Present
majonézeket	None
megfagynak	Present
utánzó	Present
szaglásznák	Present
összeállítottad	Past
tataroz	Present
daloljam|	Present
ígérte	Past
megszámoznám|	Present
rendetlenkedő	Present
nyaltátok	Past
egyesítse	Present
áttekintik	Present
feltártak	Past
egyesít	Present
minősítse	Present
visszamennek	Present
adóznak	Present
képezzen	Present
reprivatizálnál	Present
megjegyeztél	Past
citromlével	None
empátiában	None
lassítanék	Present
vidrákat	None
verdesném|	Present
esőerdők	None
terjesztik	Present
adományozó	Present
leprákban	None
táplálta	Past
örökölnek	Present
bódé	None
lektorálták	Past
simítjuk	Present
lenézd|or|	Present
demográfiai	None
pékek	None
elrejtettem	Past
meghalnak	Present
fulladjon	Present
felrobbanna	Present
vakolatnak	None
világosodik	Present
vontatni	None
benyújtandó	Future
becsülő	Present
címéhez	None
éter	None
rátával	None
görbültek	Past
zsebelte	Past
bírálták	Past
tüzeljenek	Present
rácson	None
utálták	Past
szándékoznak	Present
pohár	None
dörzsölnek	Present
metszik	Present
agyvérzésben	None
áldoztak	Past
üzenő	Present
köbön	None
architektúrákra	None
javítottad	Past
feledi	Present
kerekítik	Present
felmérések	None
atyában	None
feloszlatta	Past
alaplappal	None
eljutok	Present
tiltakoztak	Past
emelte	Past
cukrászdákban	None
szórakozzanak	Present
oszlanak	Present
bekapcsoltam	Past
szavazna	Present
góljának	None
megtörténjen	Present
nyögő	Present
blöfföl	Present
nyilvánuló	Present
médiánál	None
kezdetektől	None
áruljunk	Present
lebeg	Present
betegyük	Present
értesít	Present
megárt	Present
szórakoztatnak	Present
fújó	Present
vonalakon	None
gyorssá	None
esküdjön	Present
állandósuló	Present
megismerte	Past
megtudta	Past
igazol	Present
szenvednének	Present
feladtak	Past
információelmélet	None
sekrestyével	None
elősegítik	Present
kiadta	Past
kísérletezzenek	Present
behatolnak	Present
ködösítettünk	Past
nagyvállalatokat	None
eláll	Present
lépéseket	None
csapatkapitányokhoz	None
megvalósul	Present
szúnyogcsípések	None
tendálsz	Present
gyötörtétek	Past
azonosítsuk	Present
keltené	Present
felépítettem|	Past
megneveznek	Present
forgólantból	None
kezdeményezünk	Present
tartóztattak	Past
bírunk	Present
gyorsat	None
véglegesítette	Past
hűti	Present
megállítandó	Future
becsaptak	Past
frissítenek	Present
nevezné	Present
figyelmeztette	Past
főnökké	None
böjtöljetek	Present
szerkesztenie	None
hobbival	None
slágerekre	None
elrendel	Present
szelektálta	Past
csillapító	Present
kérődző	Present
sorrenddel	None
vitáztam	Past
tanuljam|	Present
ismertté	None
leverjék	Present
becsülték	Past
taglalnak	Present
elkezdik	Present
landolnak	Present
ellenőrizték	Past
kitörő	Present
taktikák	None
ajánlásaként	None
folytatódjon	Present
meglátok	Present
fektetjük	Present
hegeszted	Present
lefordították	Past
találatokban	None
debreceniekre	None
képviselő	None
bemenjen	Present
költségesnek	None
táncon	None
kémkedjen	Present
mosolygunk	Present
kondort	None
vitorlázik	Present
titkolózok	Present
tájékoztassanak	Present
következtetünk	Present
visszatérsz	Present
véglegesítettek	Past
görbéből	None
példaképet	None
gilisztával	None
kijelöli	Present
megtudtam	Past
kijelentették	Past
vedlettem	Past
feltételeinek	None
magyarázatot	None
megszakít	Present
meghaltunk	Past
kárpótolta	Past
megver	Present
kerítek	Present
diszperzió	None
ottománok	None
megjelentető	Present
lezárul	Present
megkövetelnek	Present
vállalkoznál	Present
vitázik	Present
harangokat	None
forradalmasító	Present
megölted	Past
hadarok	Present
tartásánál	None
testvéreken	None
merüljön	Present
jégtömbben	None
megvalósították	Past
utaljak	Present
megsérüljön	Present
elárulná	Present
vádolta	Past
döfje	Present
toborozta	Past
papról	None
edzők	None
ülteted	Present
bővítettek	Past
dugóba	None
fújod	Present
alapértelmezettől	None
holtversenyhez	None
visszaható	Present
módosítanak	Present
elveszítettem	Past
kolbászt	None
reagáljanak	Present
kasztrálnál	Present
fogadó	Present
felrobbanó	Present
összehívandó	Future
eseményhorizonton	None
vásároljanak	Present
elkényeztettél	Past
keveredne	Present
egyezteti	Present
vergődne	Present
elveszítették	Past
továbbfejlesztettek	Past
tündérré	None
rájön	Present
bázist	None
ideadtátok	Past
kihúznak	Present
fegyverként	None
csodálkoztam	Past
üzletelő	Present
megmérgezi	Present
barátságból	None
megáll	Present
vállalkozna	Present
jövendőben	None
szentelnek	Present
költőnő	None
fagyasztotta	Past
összegezted	Past
nevezze	Present
elindítottak	Past
beköltözzön	Present
zaklatták	Past
radírozandó	Future
szitáló	Present
pártjával	None
hág	Present
tanítottak	Past
vigasztalna	Present
megcsinálnak	Present
igazolta	Past
rögzítették	Past
szimbolizálod	Present
állományokkal	None
gondoskodjunk	Present
rágalom	None
lélegeznek	Present
hallgattam	Past
dúlta	Past
megkérdezünk	Present
szórakoztatta	Past
egyezménybe	None
megtanulunk	Present
nyíljanak	Present
elintézel	Present
látogató	Present
varázslatossá	None
tálra	None
früstököljünk	Present
összejövetel	None
varázsoltunk	Past
másoljon	Present
úsznia	None
ugráló	Present
mozduljanak	Present
lejártak	Past
hallgatnának	Present
felsorolnák	Present
szószaporításért	None
kereskednek	Present
megvalósuló	Present
licitál	Present
cinkosok	None
menetelnek	Present
csomagolnak	Present
gyerekként	None
csendőröket	None
borosakat	None
rövidítsék	Present
üldözte	Past
kiírtad	Past
nagydíjakon	None
csicseregtünk	Past
térítette	Past
formáljon	Present
megtartottam	Past
vezérel	Present
kiállítotok	Present
létesülő	Present
vívjon	Present
irányítsuk	Present
megnéztük	Past
vigyorogni	None
továbbítanád	Present
ásít	Present
idéznének	Present
standardizáljon	Present
győzelmet	None
ellátogattak	Past
verdes	Present
gesztusokon	None
hadihajókról	None
intőkké	None
fénymásoló	None
pálinkának	None
iktassák	Present
meggyilkol	Present
lassítottak	Past
intézetekért	None
kihagyták	Past
elvágta	Past
bizonyítottuk	Past
elefántfóka	None
tükrözzön	Present
számúra	None
befagytak	Past
levernek	Present
zargatnak	Present
sózó	Present
szállító	Present
hurcolta	Past
leírna	Present
nyilvántartó	Present
hegedül	Present
telepen	None
meglássák	Present
pártelnököt	None
kísérjék	Present
igényelné	Present
rejtettem	Past
kihasználnák	Present
világította	Past
csábítják	Present
feltaláló	Present
helyesbítenéd	Present
elkészítendő	Future
tanítóig	None
megbánta	Past
terrorizálták	Past
körbevesz	Present
kiessen	Present
borítóval	None
szembenézzen	Present
kérdezze	Present
birskörtéket	None
megszólaltak	Past
beiktatva	None
felfogtatok	Past
fogadd|or|	Present
korszerűsítő	Present
folytatódó	Present
elintéző	Present
információsakért	None
terhel	Present
működtessék	Present
dobó	None
igeszemlélet	None
kezdőket	None
témakörökből	None
táncoltam	Past
célszerű	None
ártanak	Present
zsokék	None
rejlik	Present
elválassza	Present
aláíró	Present
elvégző	Present
padomból	None
vágyakozik	Present
autonómra	None
berendező	Present
nyomnak	None
erősségeket	None
lezárod	Present
egyházfőként	None
kamatozik	Present
lelkesítő	Present
tudósítottak	Past
kelt	Present
majomkenyérfákig	None
döf	Present
kizsákmányolták	Past
gátolták	Past
formulákra	None
elnéztél	Past
megfelelnek	Present
befolyó	Present
hirdetéseket	None
beírnád	Present
szándékoztam	Past
neveket	None
mérésénél	None
fosztogatja	Present
feliratkozik	Present
szórtak	Past
szövetségről	None
elfogysz	Present
fosztogató	Present
újjászületések	None
felvételétől	None
elárulok	Present
menedzserekkel	None
alábecsülik	Present
rögzítené	Present
rendőrautókért	None
szavazásokkal	None
szüljön	Present
langyos	None
megfejti	Present
újította	Past
megír	Present
kiemelkedj|or|	Present
esztétikáról	None
ágyazta	Past
gatyák	None
lejáró	Present
csomóba	None
mérsékelje	Present
bejöjjön	Present
elálmosítottam|	Past
tagságra	None
invitáljon	Present
hozzászóltál	Past
teljesítő	Present
megkövetelték	Past
meccsről	None
hallucinogénre	None
kihúztam	Past
résztvevőkként	None
kiválasztanak	Present
becslésnek	None
söpörték	Past
jelentkezne	Present
megfejtette	Past
működtették	Past
dezertáló	Present
összeadták	Past
elkényeztette	Past
megkérdezik	Present
üdvözölték	Past
félévét	None
kiszabaduljanak	Present
vonzzon	Present
rókához	None
lepte	Past
hinti	Present
lassít	Present
fájlnévre	None
felszólító	Present
kötetéről	None
demoralizálta	Past
elnyomta	Past
tiltakoznak	Present
felteszi	Present
du.-okba	None
kipróbálták	Past
feltartották	Past
felkészítő	Present
tüntetek	Present
szovjeteknél	None
halandókkal	None
elhúztak	Past
világbajnoksággal	None
cenzúráznak	Present
meglepetéseket	None
megtartottak	Past
fogadtuk	Past
kötelezzék	Present
hunytátok	Past
kikapcsol	Present
oszcillálnak	Present
kergette	Past
gátolunk	Present
szoktam	Past
járőröztek	Past
nyilatkozik	Present
vihog	Present
elnyerje	Present
egyszínűek	None
szerkeszted	Present
körmölök	Present
elkülönítik	Present
elbocsátó	Present
elmentem	Past
húzódjon	Present
súgtatok	Past
raktároztad	Past
ropsz	Present
agyondicséred	Present
reagáltak	Past
kedvelünk	Present
szakítson	Present
úsztak	Past
licitáltad	Past
bemutattak	Past
fektesse	Present
szemlélik	Present
kisebbítünk	Present
intéztem	Past
méregtelenítsétek	Present
találkoznának	Present
erősebbek	None
alakítja	Present
barátságért	None
megmérgezzétek	Present
tárolásában	None
vonatozik	Present
csáklyákon	None
feladó	Present
emeletnek	None
krizantémok	None
forog	Present
vitatkozik	Present
ismétlésnek	None
tervelte	Past
tolakodó	Present
kiváltok	Present
ötleteknek	None
egyetértetek	Present
állapítod	Present
ismételték	Past
országokhoz	None
tiporna	Present
vízszennyezés	None
elhelyeztük	Past
megalakulnak	Present
elrepül	Present
terhelő	Present
vitatkoztunk	Past
véghezvisznek	Present
elrejtő	Present
zongorázik	Present
kialszanak	Present
zselatint	None
kínoshoz	None
nyom	None
növesztik	Present
elmaradjanak	Present
kölcsönhatásnál	None
körülvettük	Past
megrongálta	Past
szemerkéljek	Present
felszáll	Present
tesztelés	None
együttműködtél	Past
elismerésében	None
tanulnak	Present
filozófiának	None
birtokolta	Past
halványító	Present
rendszámtáblákon	None
bukkantam	Past
gyanúsítottál	Past
szabj|or|	Present
felsoroltál	Past
bosszúsakhoz	None
bírság	None
pingáló	Present
táviratokat	None
egyszerűsítette	Past
etnikumhoz	None
szolgálaton	None
gondolkodtam	Past
akadó	Present
felismerő	Present
megfogalmaztad	Past
elkészítse	Present
megegyeznünk	None
áltatsz	Present
fejfájások	None
törtünk	Past
fejlődő	Present
elbújtatok	Past
frissülnek	Present
cipelték	Past
gondosként	None
ragyog	Present
képzelik	Present
figyelsz	Present
gyárba	None
valósulna	Present
tárcsázta	Past
kérdezünk	Present
csillapítottuk	Past
lejnolásért	None
adoptálták	Past
elhelyezel	Present
jádéra	None
diákigazolvánnyal	None
következtettem	Past
lehetetlenek	None
titkosítsam|	Present
bővítené	Present
végzettségtől	None
közeledő	Present
közlekedjen	Present
éveiig	None
indokoljunk	Present
tevékenységének	None
felszabadította	Past
integetnek	Present
megértette	Past
balettek	None
lever	Present
felsorolandó	Future
tömöríti	Present
megyékben	None
megtalálok	Present
könyörögjenek	Present
farkához	None
leigázta	Past
fűszereznek	Present
vonzó	Present
erőteljesen	None
gondolkozol	Present
szokunk	Present
alapozták	Past
szerződnie	None
ellenőriztél	Past
kolompokat	None
helyszínekhez	None
megengedik	Present
újraválasztottad	Past
teljesülnek	Present
sértsék	Present
távozunk	Present
záróráért	None
tárultak	Past
tolong	Present
azonosítja	Present
blokkoltam	Past
erősítette	Past
felverték	Past
jelképekkel	None
vegyülve	None
kifosztja	Present
veszítették	Past
megtervezze	Present
panaszkodtál	Past
akadjon	Present
igazolnak	Present
fosztja	Present
daloljunk	Present
csodákkal	None
viszonyítja	Present
alkalmazkodjon	Present
nyelvjárásokról	None
megmondó	Present
megfutamodó	Present
előírná	Present
kísérletnél	None
lefordítottam	Past
szakítunk	Present
tesztre	None
fátumnak	None
megmagyaráztam	Past
szokásosak	None
importáld|or|	Present
futószalagra	None
elhatározták	Past
kölcsönözte	Past
tudásról	None
bűvölő	Present
lyukasztó	Present
eljutó	Present
zargattad	Past
ellenkezője	None
hadarnák	Present
módosulni	None
elviseli	Present
fújdogáltak	Past
diagnosztizálni	None
farokig	None
rövidítsük	Present
gyűlnétek	Present
megért	Present
görbékkel	None
arisztokraták	None
egyeztetünk	Present
adományoztam	Past
intik	Present
simítottuk	Past
kísérletező	Present
összegyűlnek	Present
fölírna	Present
csillagászokat	None
tornázik	Present
legjátékosabbra	None
tagadnak	Present
hordoztam|	Past
megtekinti	Present
levette	Past
házak	None
elrejtsük	Present
centrumban	None
értesítené	Present
középpé	None
jósolta	Past
rámutatnak	Present
tapint	Present
elmélkednek	Present
fűszerezi	Present
kényszerítettek	Past
felejtettek	Past
meghívtad	Past
javítja	Present
vigyáz	Present
reformáljanak	Present
fejtő	Present
próbálkozzon	Present
pisilő	Present
minősítette	Past
öltik	Present
sebez	Present
feledjétek	Present
nemzetségekhez	None
mellékhatásokként	None
gerendákon	None
kövekig	None
szavazzanak	Present
továbbfejleszti	Present
tápegységek	None
keresztelnek	Present
ellentmondanak	Present
hűtendő	Future
kimúlik	Present
kérdezek	Present
vezéreljenek	Present
szívattam	Past
kályha	None
felajánlottad	Past
visszalépek	Present
listáról	None
halászik	Present
jégkorongokról	None
célzol	Present
egyezségbe	None
szabályoznak	Present
eszköznél	None
megkövetelte	Past
kilogrammra	None
madrigálnak	None
kitölti	Present
ítéltük	Past
ökölvívással	None
elveszítik	Present
alja	None
szeletelő	Present
megvizsgálj|or|	Present
lépésének	None
elvesztő	Present
sóbányát	None
vitorláztam	Past
megcsinálná	Present
antológiának	None
keresztelték	Past
megmozgattak	Past
taton	None
hozamoktól	None
elmenjenek	Present
csoportelmélet	None
harsona	None
fossza	Present
megnyugtatjuk	Present
seregekre	None
elviselje	Present
horizont	None
orvosláshoz	None
koccintanak	Present
nyugodtak	Past
bővítünk	Present
rettegsz	Present
felfedezik	Present
koordináljam|	Present
megfigyelik	Present
céloztak	Past
hint	Present
turizmusért	None
elhelyezik	Present
felfüggesztették	Past
felállítandó	Future
kéreti	Present
relaxálnál	Present
fogalmazok	Present
megbeszéli	Present
egybevág	Present
felszólítja	Present
lokalizálnék	Present
találgassunk	Present
településsé	None
combon	None
kulmináljam|	Present
konfrontálták	Past
alakít	Present
elkóborolok	Present
alkotja	Present
gondolatokkal	None
lakta	Past
tiltakozunk	Present
vasaló	Present
vágyódnak	Present
alkalmazkodtak	Past
emigráltak	Past
családtagra	None
gramm	None
címűre	None
cégbe	None
füzérig	None
felismer	Present
ellenőriztem|	Past
szólaljon	Present
mellékel	Present
következtetik	Present
szabnak	Present
hozzájárultál	Past
tolódjunk	Present
tanulta	Past
tájolták	Past
tisztázódnak	Present
diagnosztizáltam|	Past
megválasztja	Present
újraparticionáljatok	Present
megszervező	Present
cselekedjenek	Present
adományoztál	Past
utánanézzen	Present
lezuhanna	Present
feltüntetésekről	None
darabnak	None
tolongtak	Past
hozzáadtak	Past
kardoskodnak	Present
leveszi	Present
raglánról	None
ultiztál	Past
futóként	None
hazaérjen	Present
meglátogatták	Past
popot	None
felkérsz	Present
wikiszótárnak	None
dühöngték	Past
telíti	Present
magyarokról	None
eléírtál	Past
módosulna	Present
pirotechnikusokhoz	None
szabályozandó	Future
haláltól	None
nyereségekkel	None
ráveszi	Present
vádol	Present
elhagysz	Present
kipróbáltam	Past
ideológiával	None
jelképezi	Present
inna	Present
csábít	Present
nyíllal	None
foglalkoztatják	Present
mulasztjuk	Present
gyermekéről	None
versengtek	Past
fejéről	None
javította	Past
értékesítsék	Present
feleljétek	Present
lábnyomokból	None
orrnál	None
burokká	None
irányítsák	Present
virágon	None
végrendeletek	None
kifejezték	Past
továbbítsanak	Present
erősödnek	Present
elégtételre	None
domináltunk	Past
megosztották	Past
meglátogatja	Present
fűtöttek	Past
meghívtak	Past
megérdemelné	Present
radiációtól	None
ügynökség	None
megnyugtatják	Present
kötődő	Present
fedezik	Present
hirdető	Present
adatbázissal	None
baltáktól	None
lénynek	None
nyelvészettől	None
betérj|or|	Present
ajánlásokat	None
áldozzanak	Present
előterjesztő	Present
elindítsa	Present
lemond	Present
téved	Present
elintézték	Past
laktól	None
emberrablásokból	None
ellenőriz	Present
taníttatta	Past
költsék	Present
diszkriminál	Present
elrejtették	Past
vélekedek	Present
érvényesebbhez	None
merül	Present
bizonyítsa	Present
felújítja	Present
gondolkozunk	Present
kártyajátékból	None
kiszabaduljon	Present
fűtöttük	Past
megteszünk	Present
szárítanak	Present
tűrtök	Present
bombázták	Past
konvertálta	Past
vendégelte	Past
tájékoztat	Present
lefokozzon	Present
kapocs	None
egyenlítette	Past
felfüggesztettek	Past
sodródik	Present
lemondjon	Present
elvettük	Past
megnehezítették	Past
ionizáló	Present
szaglásztad	Past
pixelekből	None
tömörüljenek	Present
laktak	Past
utaltál	Past
katedrálistól	None
előfordulna	Present
fektessenek	Present
aláírta	Past
zokogó	Present
gyűlöltük	Past
megosztotta	Past
elejétől	None
modernizálok	Present
elessenek	Present
szenteljen	Present
ölelik	Present
karika	None
eltávolítsuk	Present
időpontig	None
tákoljon	Present
rakpart	None
zuhogó	Present
füstnek	None
jóslatról	None
beszélőkkel	None
tűri	Present
megújító	Present
szemléltetnek	Present
bauxitok	None
informál	Present
nyafog	Present
panaszkodó	Present
tüzeli	Present
mozgatjuk	Present
szigonyoznék	Present
letölti	Present
prófétában	None
nagyvállalatig	None
ropnak	Present
egyenlítsünk	Present
tüntetésről	None
bátyjával	None
helyesbítettem	Past
zeneszerzéshez	None
zsugorodtak	Past
elemével	None
meglevőket	None
szimuláló	Present
legyőz	Present
egészítik	Present
ugróiskola	None
összehasonlít	Present
iktassa	Present
magömlés	None
nyűgöztetek	Past
gyón	Present
templomokon	None
terheljék	Present
észszerűségekre	None
bebizonyítsátok	Present
kifosztották	Past
zsebeljek	Present
leültem	Past
átszökik	Present
összeállította	Past
koszinuszban	None
pompás	None
tériszonyokat	None
finnekkel	None
informálta	Past
fejez	Present
kifejeztem	Past
felújította	Past
feszít	Present
tölcsért	None
kiszámíthatatlanabbig	None
hiányosak	None
blokkolsz	Present
elválasztottál	Past
helyesbíti	Present
tárgyiasítottad	Past
vesztették	Past
megnyugtatnék	Present
rövidíteni	None
tejtermékek	None
bírok	Present
vigyáznak	Present
cserbenhagyták	Past
belebeszélték	Past
felismerések	None
költötte	Past
szentelje	Present
gyanakodnak	Present
mozgatok	Present
szuperhatalmon	None
innovatívabbakból	None
birtokol	Present
elkezdődő	Present
földelés	None
fogalomtól	None
bátyjáért	None
múzeumban	None
felnagyították	Past
csináltad	Past
eltávozást	None
sütő	Present
radírozunk	Present
látogasson	Present
berendez	Present
visít	Present
megbüntessék	Present
iránytól	None
megteremtő	Present
felnagyítod	Present
vizsgáltuk	Past
szórta	Past
díjakról	None
programra	None
zaklatta	Past
vetélkedve	None
sietsz	Present
könyörgök	Present
észlelné	Present
vijjogó	Present
lakkozd|or|	Present
átejtsetek	Present
méltányolta	Past
nézetekre	None
aludna	Present
vitorláztak	Past
elhelyezi	Present
felfedezel	Present
villogtok	Present
elválasztanak	Present
azonnalival	None
titkairól	None
felejtsék	Present
vacsorázik	Present
szabályokban	None
elbocsátottak	Past
átnézted	Past
szerecsendión	None
elválik	Present
impregnáljam|	Present
feladná	Present
vésted	Past
emelek	Present
kezdeményezték	Past
megállapítsa	Present
iktatták	Past
liberalizáljatok	Present
lefoglalnak	Present
esküdtek	Past
állapítsák	Present
arisztokrácia	None
ütközzenek	Present
húroknál	None
összeadnia	None
nyilvánítson	Present
indexeltem	Past
vádolandó	Future
beszámolnak	Present
eltávolítanak	Present
ragaszt	Present
kölykezitek	Present
megható	Present
utóbbitól	None
hágónál	None
dokumentációban	None
meggyőzöd	Present
tárgyalunk	Present
gyászolnak	Present
szoktak	Past
elvesztettünk	Past
merészel	Present
ücsörgő	Present
stábba	None
vonyít	Present
kinevezi	Present
megalakul	Present
reagál	Present
iszol	Present
becsülik	Present
alanyok	None
megjeleníti	Present
megakadályozták	Past
idegesítette	Past
megfertőz	Present
létrehozzanak	Present
külföldet	None
programokban	None
növekedünk	Present
visszhangoznak	Present
musicalt	None
lógva	None
bázissal	None
leírnád	Present
kereskedik	Present
tisztázódjanak	Present
kiver	Present
tisztelünk	Present
tájékozódtam	Past
kiállítanak	Present
megelőzni	None
lóg	Present
szegregációt	None
napját	None
felépítsék	Present
pácoltunk	Past
megszállottnak	None
utánoznak	Present
karára	None
kitüntetek	Present
képzésre	None
Magyarországról	None
színeznek	Present
megcsinálod	Present
tenyésztettek	Past
egészítsük	Present
rekonstrukció	None
kategorizálták	Past
megerősítik	Present
támogatással	None
szintetizáló	Present
idegesítő	Present
kitörne	Present
valóságosakon	None
megfulladtak	Past
leakasztottuk	Past
igazolandó	Future
koalíciót	None
belépőket	None
előmozdították	Past
kiterjeszti	Present
fölülírtam|	Past
alszanak	Present
jelöléshez	None
kipróbálod	Present
aknamező	None
kasztrálnád	Present
fejlődnek	Present
válaszolunk	Present
egybeírták	Past
elhamvasztotta	Past
üdvözül	Present
kanyarognak	Present
veszít	Present
elektronmikroszkópokban	None
közlekednek	Present
lövedéknek	None
távozó	Present
kevés	None
szerződnek	Present
négert	None
indította	Past
kempingben	None
pityizálnának	Present
kiegészítik	Present
elkészítsen	Present
tanultad	Past
felvesz	Present
alkonyat	None
dicsőségeset|	None
keresztülfolyjunk	Present
világgazdaságban	None
modellkedjenek	Present
kölcsönkérte	Past
felszólította	Past
megvizsgálnék	Present
élőkön	None
szopta	Past
hajnalodna	Present
zenekarokat	None
módjaként	None
referenciák	None
bántak	Past
megbántották	Past
elkerülték	Past
riasztó	Present
beküldenéd	Present
fennmaradnak	Present
molekulákhoz	None
átalakítandó	Future
basznál	Present
kergetjük	Present
fennmaradjon	Present
tévesszék	Present
szövegén	None
eladta	Past
ússzunk	Present
vásárfiákra	None
eladnám|	Present
félreértettem	Past
proklamálta	Past
megírtak	Past
befejezné	Present
véleményéhez	None
fényképésszel	None
végeztük	Past
kárpótol	Present
rögzítjük	Present
keltek	Present
időtartamról	None
figyeli	Present
áttekintette	Past
szekularizálta	Past
récét	None
nyilvántart	Present
röplabdacsapatokként	None
megölnek	Present
felhasználjatok	Present
megfigyelte	Past
megszüntettük	Past
vízkereszt	None
visszavéve	None
sportolnék	Present
távmunkákba	None
hasznosításában	None
bántanak	Present
kovácsolnak	Present
ruhájukon	None
kikapcsolnál	Present
ültették	Past
megnyíló	Present
kategorizáljanak	Present
bitről	None
aláhúzta	Past
ültetvényekről	None
alapszabályokból	None
sugalló	Present
kérdeztétek	Past
beállítsak	Present
politikájára	None
megkezdődnek	Present
mulató	Present
koncentrációkat	None
felelő	Present
osztónak	None
rejt	Present
meggyújt	Present
átvegyük	Present
exportáltátok	Past
bánjatok	Present
bejelentkeznek	Present
fogalmaztak	Past
csodára	None
facebookozzon	Present
tartályban	None
lemaradó	Present
idéz	Present
terveld|or|	Present
kiváltságosra	None
tangóztok	Present
célunknak	None
fűtötték	Past
visszautasító	Present
félreért	Present
újítsa	Present
minaretekről	None
vartyogok	Present
szériában	None
ellátogat	Present
helyreállítottak	Past
kifejez	Present
aktivál	Present
jelentkeztem	Past
kifejezte	Past
isszuk	Present
görbülök	Present
lélegzünk	Present
tűrünk	Present
felháborodnak	Present
tréningeket	None
dákó	None
részesülő	Present
álldogálj|or|	Present
többségét	None
követeljenek	Present
rejtélyesebbeknek	None
ördögökért	None
meguntad	Past
lakkozó	Present
boncolták	Past
kezelendő	Future
ellopó	Present
landoljon	Present
szűnjenek	Present
tartóztassa	Present
beépítettek	Past
vonaglik	Present
soroltad	Past
igényeiről	None
válaszolniuk	None
vöröshagyma	None
jelképező	Present
focistánál	None
bevidd|or|	Present
desztillálták	Past
tanácsolni	None
árulnak	Present
ideírok	Present
elmélkedő	Present
száguld	Present
improvizálták	Past
szeszt	None
hamisítványoknak	None
hattyúdal	None
eltávolítandó	Future
vajdához	None
figyeljetek	Present
szentesítették	Past
multikat	None
emelkedő	Present
megvédték	Past
elbeszélte	Past
maszturbálnál	Present
állapítsa	Present
felhívták	Past
jegesmedvék	None
felbontáshoz	None
utórezgéssel	None
ingassuk	Present
tanúsítottak	Past
megjelenítették	Past
dialektusokat	None
göndörítettél	Past
relációkat	None
redukáltad	Past
kg-osban	None
kergetnek	Present
táborrá	None
kárpótoltatok	Past
előírták	Past
vállalkoznak	Present
tarháló	Present
udvarok	None
ringattam	Past
zsidókról	None
tb-kbe	None
megcsodálod	Present
javasolta	Past
állkapocscsont	None
lógtak	Past
internetig	None
dicsőségre	None
feleljenek	Present
elárulva	None
lefejeznéd	Present
megmérgezte	Past
klasszikus	None
bead	Present
megszólamlok	Present
rugókkal	None
hordoztak	Past
megköszönök	Present
megtiltotta	Past
népszavazásban	None
imádságba	None
kielégítették	Past
külvilágokká	None
nagyfejű	None
csodálkozol	Present
csámcsogjak	Present
fosszuk	Present
helységnevekben	None
látogatok	Present
nemességből	None
szoknyától	None
tüdőből	None
sikoltunk	Present
szagoljatok	Present
létrehoztad	Past
megáldotta	Past
gyűlnének	Present
feltárásokból	None
részleteztétek	Past
beszerzéseket	None
hordalékon	None
ajándékozó	Present
feldobná	Present
megütötte	Past
közlekednének	Present
elvetéltem|	Past
meghaladták	Past
drágállná	Present
vásárlásból	None
képzeli	Present
vizelő	Present
pagodát	None
taníttattuk	Past
folytatódik	Present
megkönnyítendő	Future
fogyasszon	Present
bizonyítson	Present
lépésekből	None
lökendő	Future
sportoltak	Past
zarándokol	Present
csillagképre	None
befejeztük	Past
figyelték	Past
térképekként	None
astangákat	None
bevitte	Past
hivatkoznának	Present
felverő	Present
betesszük	Present
viszonyultak	Past
archiváló	Present
hímeken	None
kiszámították	Past
tetejéhez	None
szüntessük	Present
kielégítenek	Present
tökéletesíti	Present
megnyer	Present
frissíti	Present
vigadó	Present
tesztnél	None
megemlít	Present
akadoztam	Past
tartózkodnak	Present
túllépi	Present
adományozták	Past
elfelejted	Present
beteszek	Present
tördelték	Past
kedveli	Present
cselekedtek	Past
válságtól	None
virslit	None
kiírtak	Past
horgászokat	None
hölggyé	None
kúsznak	Present
felfogáshoz	None
közelíted	Present
zsákmányoló	Present
osztálytermekhez	None
uraltak	Past
megmentsük	Present
készítésben	None
növelő	Present
részletezik	Present
bojtorján	None
nagyító	Present
alkottál	Past
tanulod	Present
hídként	None
buszsávok	None
beköltözik	Present
nyilvánulnék	Present
aktivizálta	Past
elfogadható	None
feladatoktól	None
vádakat	None
frissítjük	Present
lassabbnál	None
transzformáljam|	Present
tangózz|or|	Present
stúdiókba	None
adózót	None
bocsássatok	Present
diagnosztizáltak	Past
ligatúrákként	None
száguldottak	Past
hajra	None
makogna	Present
másolnak	Present
oxidálódó	Present
portál	None
minőségbiztosítás	None
megjelölöd	Present
kelted	Present
zsibbasztó	Present
beteszel	Present
amőbát	None
leromboló	Present
elküldjék	Present
elkóboroljanak	Present
hozzájárulására	None
győzelmeknek	None
sorolná	Present
terjesztenek	Present
tipornál	Present
eltöri	Present
visszatérő	Present
liberálisak	None
százalékokat	None
bedobnia	None
szimatolnak	Present
gyógypedagógiát	None
erkölcsök	None
vetíti	Present
megfordul	Present
kivonnák	Present
megnyugtatták	Past
megbeszélendő	Future
megnézik	Present
összefogod	Present
felszabadítja	Present
megfosztották	Past
befejezésekkel	None
fülkéhez	None
igazságszolgáltatásról	None
kodifikálta	Past
diszkrimináló	Present
akvarellt	None
sérülnének	Present
félreértené	Present
pszichoterápiát	None
verdesünk	Present
öltözik	Present
teljesíti	Present
megnevező	Present
vontatta	Past
minőséget	None
jegyzik	Present
alakítanának	Present
fejlesszük	Present
belépővel	None
szkennelő	Present
teázik	Present
vélitek	Present
szüntető	Present
kielégítendő	Future
veszélyével	None
csempészd|or|	Present
megismerik	Present
rejtjük	Present
nyenyectől	None
fogalmazzunk	Present
mosolyogtam	Past
ösztönöztek	Past
megtervezi	Present
megtalálnak	Present
összebarátkoztak	Past
tálakért	None
semlegesítsék	Present
telepesekre	None
kilépsz	Present
elmaradjak	Present
borzasztó	Present
