închegași	Second person Singular
țipasem	First person Singular
lunilor	None
muiaseră	Third person Plural
salamului	None
îndemna	Third person Singular
picta	Third person Singular
slăvești	Second person Singular
răspândirăți	Second person Plural
răzgândisem	First person Singular
rotunjim	First person Plural
distilase	Third person Singular
adormeați	Second person Plural
geneticei	None
vizibilități	None
arătase	Third person Singular
despărțiși	Second person Singular
secvența	None
aciuau	Third person Plural
prețuirăm	First person Plural
dușmănise	Third person Singular
lingușiseși	Second person Singular
jucăriei	None
râserăm	First person Plural
amărăști	Second person Singular
drăguț	None
vede	Third person Singular
lungului	None
isprăviseși	Second person Singular
păruși	Second person Singular
dialectali	None
interzicea	Third person Singular
drepturilor	None
așezăm	First person Plural
puricaseși	Second person Singular
introduceau	Third person Plural
ardem	First person Plural
cunoscurăți	Second person Plural
cumplitului	None
îndepărtași	Second person Singular
râios	None
grasa	None
eliberau	Third person Plural
scrii	Second person Singular
traduseși	Second person Singular
împăcase	Third person Singular
ghida	Third person Singular
strânseseși	Second person Singular
caviar	None
clătii	First person Singular
sărutasem	First person Singular
poștelor	None
eliminat	None
croiai	Second person Singular
suflăm	First person Plural
înfrăți	Third person Singular
clădim	First person Plural
transform	First person Singular
deranjezi	Second person Singular
panteism	None
neglijarăm	First person Plural
ciugulirăți	Second person Plural
cumpătaseră	Third person Plural
estimaseși	Second person Singular
scădem	First person Plural
depusese	Third person Singular
acațule	None
înverșunat	None
alungarăți	Second person Plural
castanii	None
capitula	Third person Singular
mutăm	First person Plural
inimoasa	None
probă	Third person Singular
mira	Third person Singular
sărise	Third person Singular
retragi	Second person Singular
ameninți	Second person Singular
pavă	Third person Singular
invizibilii	None
scăzuse	Third person Singular
veseli	None
armeanului	None
zdrobea	Third person Singular
decenței	None
amenințările	None
sufla	Third person Singular
sfulgeraseră	Third person Plural
contrazice	Third person Singular
gloanțele	None
cosea	Third person Singular
înfoiem	First person Plural
amenința	Third person Singular
justiția	None
macra	None
adăugase	Third person Singular
existaseră	Third person Plural
crudă	None
prietena	None
accesibila	None
inunda	Third person Singular
modificăm	First person Plural
mințirăți	Second person Plural
refeca	Third person Singular
demonule	None
ginerilor	None
accelerarăm	First person Plural
ezit	First person Singular
alungăm	First person Plural
surele	None
reînnoiseși	Second person Singular
boașele	None
aflară	Third person Plural
umed	None
pricepuserăți	Second person Plural
documentez	First person Singular
chițăiră	Third person Plural
plăti	Third person Singular
subterane	None
ieșiserăți	Second person Plural
descurcarăți	Second person Plural
atotputernic	None
dicta	Third person Singular
supusese	Third person Singular
despărțim	First person Plural
zărea	Third person Singular
năpârcă	None
glumit	None
plătim	First person Plural
răspândiși	Second person Singular
reluasem	First person Singular
exist	First person Singular
ocroti	Third person Singular
dezbinasem	First person Singular
desenaseră	Third person Plural
inutili	None
fuma	Third person Singular
aerisiși	Second person Singular
imaginasem	First person Singular
baltic	None
sluji	Third person Singular
adăparăm	First person Plural
indus	None
leagăn	First person Singular
răsuciseră	Third person Plural
omorî	Third person Singular
bazași	Second person Singular
umblăm	First person Plural
fericit	None
minunarăm	First person Plural
stabileau	Third person Plural
grasului	None
suveranitate	None
femeiesc	None
finisa	Third person Singular
slabe	None
îmbunătățeai	Second person Singular
pețești	Second person Singular
scânciseră	Third person Plural
forța	Third person Singular
urmezi	Second person Singular
subscrise	Third person Singular
înverzea	Third person Singular
cercetez	First person Singular
dezbinaseși	Second person Singular
urați	Second person Plural
dovedise	Third person Singular
răspundem	First person Plural
olandezul	None
patrie	None
pornirăm	First person Plural
platformă	None
redusese	Third person Singular
pometului	None
străinilor	None
atingem	First person Plural
uterului	None
zăceai	Second person Singular
echilibrule	None
tramvaiele	None
traversezi	Second person Singular
nemțescul	None
lărgise	Third person Singular
spânzuraseși	Second person Singular
încumetași	Second person Singular
deziseseră	Third person Plural
lungi	Third person Singular
necunoscute	None
porți	Second person Singular
așez	First person Singular
încălară	Third person Plural
îmbunătăți	Third person Singular
tânjea	Third person Singular
scăpa	Third person Singular
săturarăm	First person Plural
adăugau	Third person Plural
scriere	None
vigilența	None
dezavantajase	Third person Singular
vizită	Third person Singular
sclavilor	None
cuprinsese	Third person Singular
arătarăți	Second person Plural
naiv	None
apropiau	Third person Plural
minunase	Third person Singular
puricaserăți	Second person Plural
lăudăm	First person Plural
zborul	None
profesorului	None
frâna	Third person Singular
menținea	Third person Singular
germanilor	None
violeți	None
mândriserăți	Second person Plural
ameți	Third person Singular
evazivei	None
prevestii	First person Singular
judec	First person Singular
pășunaseră	Third person Plural
înclinăm	First person Plural
miri	Second person Singular
bucium	First person Singular
ascultăm	First person Plural
încurajăm	First person Plural
amenințau	Third person Plural
anulaseră	Third person Plural
uda	Third person Singular
furi	Second person Singular
luăm	First person Plural
milimetricii	None
depărtaserăm	First person Plural
trimitem	First person Plural
fetei	None
piciorule	None
placi	Second person Singular
numărăm	First person Plural
treierarăm	First person Plural
cântaseră	Third person Plural
autobiografii	None
reflectata	None
contraziceau	Third person Plural
comportăm	First person Plural
amestecară	Third person Plural
răsăreau	Third person Plural
miezurile	None
ținea	Third person Singular
perfecți	None
galvanizatilor	None
descurcaserăm	First person Plural
suveranitatea	None
ghicit	None
răsfirară	Third person Plural
toceau	Third person Plural
cerceta	Third person Singular
invizibil	None
rezistau	Third person Plural
renovași	Second person Singular
preferaseră	Third person Plural
apăs	First person Singular
fiica	None
turtirăți	Second person Plural
văzuși	Second person Singular
agățata	None
biscuiților	None
clădiși	Second person Singular
micșorezi	Second person Singular
fotoliile	None
stepa	None
amorți	Third person Singular
englezilor	None
țărmurilor	None
scânteiași	Second person Singular
îndes	First person Singular
apăr	First person Singular
săgeții	None
pețirăți	Second person Plural
stăruind	None
sfântul	None
masiv	None
preziseseră	Third person Plural
neglijași	Second person Singular
biata	None
susțineau	Third person Plural
reluăm	First person Plural
descrește	Third person Singular
stabilise	Third person Singular
nădăjduirăm	First person Plural
crescuși	Second person Singular
unduim	First person Plural
bălăiești	Second person Singular
prelungiră	Third person Plural
păziserăți	Second person Plural
aerisisem	First person Singular
îneca	Third person Singular
dispărea	Third person Singular
aplicară	Third person Plural
experimentata	None
convinsese	Third person Singular
descrise	Third person Singular
chiorăști	Second person Singular
împreună	Third person Singular
frânaseși	Second person Singular
târguiră	Third person Plural
frecaserăm	First person Plural
supuserăm	First person Plural
scrotul	None
omuleții	None
așezau	Third person Plural
irlandezul	None
depuneau	Third person Plural
asemeni	Second person Singular
întâmpla	Third person Singular
atlanticul	None
amuzară	Third person Plural
jigniși	Second person Singular
distrus	None
dominarăți	Second person Plural
bogățiilor	None
forțezi	Second person Singular
ostilitatea	None
întrebuințau	Third person Plural
chemasem	First person Singular
lucești	Second person Singular
mamutului	None
cânți	Second person Singular
rezolvaserăți	Second person Plural
închipuiau	Third person Plural
dominaseră	Third person Plural
încurcase	Third person Singular
jupui	Third person Singular
sfătuind	None
viermuia	Third person Singular
realei	None
împăuna	Third person Singular
compuse	Third person Singular
pregetaserăm	First person Plural
vărarăm	First person Plural
pripiseră	Third person Plural
propuseseră	Third person Plural
lăsase	Third person Singular
satisfăcu	Third person Singular
satira	None
aberant	None
prăda	Third person Singular
pompierul	None
înfoie	Third person Singular
arăduseserăm	First person Plural
metrule	None
cuceriseră	Third person Plural
prinserăm	First person Plural
îndeletniciră	Third person Plural
slujiserăm	First person Plural
verosimililor	None
minunară	Third person Plural
dezvolt	First person Singular
ferea	Third person Singular
insulta	Third person Singular
gemem	First person Plural
lucrase	Third person Singular
ascundeai	Second person Singular
lătra	Third person Singular
despădurirea	None
verbului	None
rodiile	None
veștejea	Third person Singular
fluierarăți	Second person Plural
leșini	Second person Singular
gustaseră	Third person Plural
estimau	Third person Plural
legănăm	First person Plural
funcționasem	First person Singular
înfuriem	First person Plural
cufurise	Third person Singular
activase	Third person Singular
exclusivitatea	None
conteniși	Second person Singular
declari	Second person Singular
muiau	Third person Plural
robi	Third person Singular
rasă	None
posibilului	None
rețineați	Second person Plural
speli	Second person Singular
zbatem	First person Plural
discuției	None
peninsulelor	None
mândriserăm	First person Plural
distrez	First person Singular
valsând	None
suiși	Second person Singular
suveranei	None
gurii	None
stăpânit	None
dezlipirăm	First person Plural
răstigniserăm	First person Plural
adora	Third person Singular
poruncii	First person Singular
botezând	None
prăpădiră	Third person Plural
copleșiși	Second person Singular
separau	Third person Plural
stabiliseră	Third person Plural
botez	First person Singular
înierbară	Third person Plural
glicină	None
vorbea	Third person Singular
mâhnirăm	First person Plural
oposumii	None
refuza	Third person Singular
mescurăți	Second person Plural
despuneați	Second person Plural
contrazisesem	First person Singular
servea	Third person Singular
nimerești	Second person Singular
conceptelor	None
anghinarele	None
desfășurară	Third person Plural
iubim	First person Plural
divorțaseră	Third person Plural
timpule	None
îndobitociși	Second person Singular
futeai	Second person Singular
divorța	Third person Singular
înghețași	Second person Singular
crezi	Second person Singular
glumirăți	Second person Plural
obstrucției	None
ciocniși	Second person Singular
semnasem	First person Singular
istorică	None
musca	None
ciracule	None
accelerăm	First person Plural
masturbării	None
oloagele	None
zăcuseră	Third person Plural
capitulezi	Second person Singular
bloca	Third person Singular
refuzarăți	Second person Plural
înota	Third person Singular
dopurilor	None
plicticos	None
prăbușiseră	Third person Plural
purpurii	None
rostim	First person Plural
încheiau	Third person Plural
misterioase	None
anglicana	None
amânăm	First person Plural
internului	None
cotropiserăm	First person Plural
mișcaserăți	Second person Plural
peninsula	None
ginerelui	None
olimpice	None
inserție	None
armenilor	None
conjugarăți	Second person Plural
excelaseși	Second person Singular
articula	Third person Singular
reluași	Second person Singular
așternuse	Third person Singular
aduce	Third person Singular
spinteca	Third person Singular
înmânasem	First person Singular
jenase	Third person Singular
refuzaseră	Third person Plural
scuturași	Second person Singular
dereticarăm	First person Plural
aminteați	Second person Plural
spuseseră	Third person Plural
menestrelul	None
iese	Third person Singular
învățăm	First person Plural
astupaserăm	First person Plural
dezmințirăm	First person Plural
ajun	First person Singular
vizitarăm	First person Plural
stătea	Third person Singular
dezamăgii	First person Singular
prelungi	Third person Singular
rugăm	First person Plural
femininului	None
franțuzești	None
copleșeau	Third person Plural
încetești	Second person Singular
nebunirăm	First person Plural
copie	Third person Singular
buluciseși	Second person Singular
împlântaserăm	First person Plural
pinii	None
preoților	None
nelucrat	None
îmbărbătară	Third person Plural
căutară	Third person Plural
subțiezi	Second person Singular
cotidiană	None
verde	None
așteptase	Third person Singular
înțelegeau	Third person Plural
împlinea	Third person Singular
urdinările	None
țăcăniserăm	First person Plural
hali	Third person Singular
răpuneați	Second person Plural
interacțiunile	None
urmăriserăți	Second person Plural
fă	Second person Singular
distruse	Third person Singular
căsătoriile	None
adeverea	Third person Singular
panterele	None
zăcămintelor	None
iertaserăți	Second person Plural
întâmplau	Third person Plural
zice	Third person Singular
binecuvântaseră	Third person Plural
nurorii	None
dispuse	Third person Singular
utilizaseră	Third person Plural
lucrez	First person Singular
zborule	None
găsiserăți	Second person Plural
descoperim	First person Plural
emoționară	Third person Plural
găurile	None
scuipaseră	Third person Plural
lepădaseși	Second person Singular
cerui	First person Singular
mărunțești	Second person Singular
analizatorului	None
îndesaseși	Second person Singular
împlinii	First person Singular
divorțat	None
onorurile	None
înnoadă	Third person Plural
atragi	Second person Singular
aștepți	Second person Singular
explicativă	None
dispusese	Third person Singular
murmur	First person Singular
nemilele	None
iedul	None
scăparăm	First person Plural
declaraseși	Second person Singular
povârnisem	First person Singular
începuși	Second person Singular
mișcărilor	None
încheiase	Third person Singular
cufuriserăți	Second person Plural
lingeau	Third person Plural
sfârticași	Second person Singular
confruntau	Third person Plural
căscarăți	Second person Plural
îmbuibaseră	Third person Plural
toiul	None
venerez	First person Singular
veștejirăți	Second person Plural
valorilor	None
brunului	None
economia	None
pistoanele	None
completăm	First person Plural
scornea	Third person Singular
răscopt	None
femeia	None
culturii	None
excursiei	None
futură	Third person Plural
slăbise	Third person Singular
orchestralilor	None
învelișurilor	None
narcotizarăm	First person Plural
prescurtării	None
mărginea	Third person Singular
faurului	None
preveniși	Second person Singular
mândrești	Second person Singular
maltrata	Third person Singular
pocniserăm	First person Plural
cerșind	None
gemeau	Third person Plural
altelor	None
capsulară	Third person Plural
înec	First person Singular
adevereați	Second person Plural
dovedeau	Third person Plural
adumbrești	Second person Singular
furase	Third person Singular
urmară	Third person Plural
algă	None
craniul	None
ingineriei	None
brazdelor	None
izbăvise	Third person Singular
iepurașul	None
întrebasem	First person Singular
dinozaurul	None
dezgust	First person Singular
termin	First person Singular
cetățenei	None
citeai	Second person Singular
slăbeau	Third person Plural
anim	First person Singular
jur	First person Singular
așezaseră	Third person Plural
atotștiutoarei	None
poftiseși	Second person Singular
ușuraticul	None
rupsese	Third person Singular
păruseși	Second person Singular
delictului	None
sistași	Second person Singular
înfrunzim	First person Plural
speriaților	None
înghețaseși	Second person Singular
răsculăm	First person Plural
posedării	None
animaseși	Second person Singular
strâmtase	Third person Singular
pregătise	Third person Singular
face	Third person Singular
bășiserăm	First person Plural
moldovenești	None
urbanizezi	Second person Singular
oneste	None
monoaxiala	None
slujiseră	Third person Plural
borcanul	None
leucemiei	None
stricată	None
pedepseau	Third person Plural
amenții	None
înfășuri	Second person Singular
ghicise	Third person Singular
dărăciși	Second person Singular
cuprindeați	Second person Plural
defăimă	Third person Singular
lupta	Third person Singular
menținuse	Third person Singular
despuiași	Second person Singular
visând	None
săltară	Third person Plural
grasul	None
dezmințit	None
vălului	None
slăvi	Third person Singular
caraghioasă	None
pripea	Third person Singular
românii	None
alcătuia	Third person Singular
încălzind	None
înzestra	Third person Singular
vrăjim	First person Plural
obosi	Third person Singular
limpezești	Second person Singular
congelaserăm	First person Plural
umilisem	First person Singular
returna	Third person Singular
scuturi	Second person Singular
învinsele	None
centrele	None
greii	None
dezvoltații	None
repauzez	First person Singular
făptuisem	First person Singular
purtarăți	Second person Plural
abandonase	Third person Singular
târgui	Third person Singular
marinelor	None
uitasem	First person Singular
stabilități	None
împărțeai	Second person Singular
misterioasei	None
temurăm	First person Plural
studiase	Third person Singular
sângeroase	None
spovedim	First person Plural
logarăți	Second person Plural
felurile	None
ajutase	Third person Singular
abacelor	None
blochezi	Second person Singular
migdalelor	None
căpețelei	None
emoționez	First person Singular
făleați	Second person Plural
elogiul	None
nerecunoscuta	None
istoricul	None
simțim	First person Plural
scânteie	Third person Singular
spărgeai	Second person Singular
omniprezentului	None
studiem	First person Plural
venerat	None
șovăirăți	Second person Plural
capsulezi	Second person Singular
bulbucarăm	First person Plural
prevestim	First person Plural
excursiilor	None
observa	Third person Singular
diriguiești	Second person Singular
utilizaseși	Second person Singular
rugarăți	Second person Plural
fotbalistului	None
probarăți	Second person Plural
oprim	First person Plural
supraviețuim	First person Plural
viezurii	None
acumulau	Third person Plural
perseveraserăm	First person Plural
descurca	Third person Singular
întreprindeau	Third person Plural
narcotiza	Third person Singular
circumscriau	Third person Plural
introduceați	Second person Plural
mușcând	None
insista	Third person Singular
atârnaserăți	Second person Plural
menții	Second person Singular
subterani	None
măsurăm	First person Plural
amuzi	Second person Singular
scărmănând	None
turbaseși	Second person Singular
încetiserăți	Second person Plural
văcarului	None
prețului	None
văzură	Third person Plural
augură	Third person Singular
stabiliserăm	First person Plural
speriem	First person Plural
angajase	Third person Singular
mărunțiseră	Third person Plural
desparți	Second person Singular
răzgândiseră	Third person Plural
ștergeai	Second person Singular
altului	None
întrevăzusem	First person Singular
terapia	None
depăraseși	Second person Singular
ponegriși	Second person Singular
călărețului	None
refecase	Third person Singular
încălecă	Third person Singular
suspensor	None
rușinaseși	Second person Singular
încetăm	First person Plural
venerase	Third person Singular
excelaseră	Third person Plural
înavuțiră	Third person Plural
mescuși	Second person Singular
modificase	Third person Singular
introduseră	Third person Plural
admirarăm	First person Plural
culegeau	Third person Plural
imputasem	First person Singular
circumscriseși	Second person Singular
slangului	None
cicliștii	None
lanul	None
olimpică	None
veștejii	First person Singular
rătăcise	Third person Singular
cronologiile	None
aciuasem	First person Singular
oblice	None
aciuași	Second person Singular
chiloților	None
rară	None
grăbeau	Third person Plural
țesut	None
curgeau	Third person Plural
logași	Second person Singular
leșina	Third person Singular
pisase	Third person Singular
destrăbălarăm	First person Plural
trăiseră	Third person Plural
ucizi	Second person Singular
păruiră	Third person Plural
ușurarăm	First person Plural
fereați	Second person Plural
învălurezi	Second person Singular
șchiopași	Second person Singular
memorizară	Third person Plural
închipuit	None
cinste	None
încărcaserăm	First person Plural
concepeai	Second person Singular
estimase	Third person Singular
veștejiși	Second person Singular
marină	None
întării	First person Singular
atingea	Third person Singular
pișași	Second person Singular
răspunseseși	Second person Singular
preziceau	Third person Plural
înfăinăm	First person Plural
asculți	Second person Singular
strânseseră	Third person Plural
reușisem	First person Singular
spuneau	Third person Plural
încurajau	Third person Plural
jenăm	First person Plural
răbojea	Third person Singular
tâmpise	Third person Singular
păduchiosul	None
fumegau	Third person Plural
repezeai	Second person Singular
gândit	None
fumega	Third person Singular
crescuse	Third person Singular
înotăm	First person Plural
anula	Third person Singular
întoarcem	First person Plural
decideau	Third person Plural
încurc	First person Singular
onirică	None
văduvea	Third person Singular
influențăm	First person Plural
fluxul	None
doreau	Third person Plural
unghiule	None
dormiserăm	First person Plural
crestași	Second person Singular
studiași	Second person Singular
securitatea	None
împuțiși	Second person Singular
legat	None
atacului	None
încununaseră	Third person Plural
temeliile	None
vrăjiseși	Second person Singular
emoționă	Third person Singular
suciserăm	First person Plural
tradusese	Third person Singular
prinseră	Third person Plural
șes	None
fachia	None
salinizau	Third person Plural
mulțumea	Third person Singular
mistreții	None
ocuparăm	First person Plural
invadau	Third person Plural
vânturăm	First person Plural
pătrunzi	Second person Singular
amanetaserăm	First person Plural
căpătaseși	Second person Singular
hămesiserăți	Second person Plural
certăm	First person Plural
transformaserăți	Second person Plural
cânt	First person Singular
asigurat	None
brotacule	None
încălțăm	First person Plural
reintroduseră	Third person Plural
zbârciseși	Second person Singular
căutau	Third person Plural
dansezi	Second person Singular
tinctura	Third person Singular
cuteza	Third person Singular
îmboldiseși	Second person Singular
intern	None
distractiv	None
ultime	None
erai	Second person Singular
atacau	Third person Plural
încercăm	First person Plural
dezmierdau	Third person Plural
mânea	Third person Singular
cuvioasă	None
înnoptaseși	Second person Singular
îndeletnicise	Third person Singular
săpând	None
fixase	Third person Singular
agăța	Third person Singular
numiseră	Third person Plural
blândelor	None
intenționași	Second person Singular
îmbunătățeați	Second person Plural
mergi	Second person Singular
preveni	Third person Singular
împovăraserăm	First person Plural
cerșim	First person Plural
circulară	Third person Plural
plinii	None
aureau	Third person Plural
existarăți	Second person Plural
dovediseră	Third person Plural
arătăm	First person Plural
satirei	None
amuzau	Third person Plural
apăra	Third person Singular
submarinul	None
deșideri	Second person Singular
tremur	First person Singular
sfântului	None
anulăm	First person Plural
mânecat	None
utilizăm	First person Plural
stăpâneați	Second person Plural
isprăvirăm	First person Plural
parazită	None
pupat	None
nenorocim	First person Plural
imprimau	Third person Plural
pumnalele	None
pasarăm	First person Plural
ghidezi	Second person Singular
lăuda	Third person Singular
înșeuaserăți	Second person Plural
îmbătași	Second person Singular
intenționăm	First person Plural
ustensila	None
terapeuticele	None
lămuri	Third person Singular
tamburinei	None
puturăți	Second person Plural
așteptăm	First person Plural
prăsiserăți	Second person Plural
pierisem	First person Singular
răscoapseserăm	First person Plural
sexuale	None
decădea	Third person Singular
învățase	Third person Singular
alții	None
râzi	Second person Singular
intervenii	First person Singular
ghicim	First person Plural
slujind	None
măritase	Third person Singular
ațipeați	Second person Plural
numiră	Third person Plural
risipiră	Third person Plural
creierule	None
finisaseră	Third person Plural
inflexibil	None
sorbiră	Third person Plural
coseau	Third person Plural
garajele	None
înnoptaseră	Third person Plural
acuzi	Second person Singular
adoptăm	First person Plural
alunecarăți	Second person Plural
observaseră	Third person Plural
orgasmic	None
sufoc	First person Singular
zdrobeau	Third person Plural
distilaserăți	Second person Plural
scurtarăți	Second person Plural
zăcea	Third person Singular
unseși	Second person Singular
animalului	None
tânjiră	Third person Plural
înjuri	Second person Singular
protejarăm	First person Plural
întorsese	Third person Singular
desfăș	First person Singular
dorești	Second person Singular
indusesem	First person Singular
albastra	None
dormiti	Second person Singular
smulgi	Second person Singular
urmăreați	Second person Plural
rinichiului	None
bucă	None
ședeau	Third person Plural
stricară	Third person Plural
dormea	Third person Singular
clipelor	None
acumulând	None
dinamica	None
confrunta	Third person Singular
zburaseră	Third person Plural
robea	Third person Singular
avalanșele	None
conjugau	Third person Plural
spânzurasem	First person Singular
desfășura	Third person Singular
intrăm	First person Plural
răzlețim	First person Plural
mergeau	Third person Plural
logodea	Third person Singular
usca	Third person Singular
gătii	First person Singular
crescurăm	First person Plural
narcotizaseși	Second person Singular
ardeiule	None
isprăvești	Second person Singular
sari	Second person Singular
îmbunarăți	Second person Plural
lipi	Third person Singular
salvau	Third person Plural
înnorarăm	First person Plural
dezamăgeau	Third person Plural
ghețarul	None
îmbunătățire	None
înmărmurisem	First person Singular
renovez	First person Singular
convenind	None
ghidăm	First person Plural
amiază	None
îngrămădiserăm	First person Plural
nasoalele	None
dobândeau	Third person Plural
împărțirăți	Second person Plural
încrezurăm	First person Plural
armă	None
alegi	Second person Singular
urcatelor	None
copiezi	Second person Singular
uniserăm	First person Plural
iernaserăți	Second person Plural
repeziși	Second person Singular
primire	None
închinăm	First person Plural
umflu	First person Singular
diminuase	Third person Singular
vulcanule	None
vaselor	None
previne	Third person Singular
mânca	Third person Singular
universitățile	None
înfățișase	Third person Singular
stana	None
caprelor	None
dezmântarăm	First person Plural
aținuserăm	First person Plural
logând	None
înconjura	Third person Singular
scoserăți	Second person Plural
afundat	None
leșinarăți	Second person Plural
tăbăcise	Third person Singular
umezi	None
tușiserăți	Second person Plural
muntosului	None
împiedici	Second person Singular
cădem	First person Plural
înmulțești	Second person Singular
deprindeau	Third person Plural
rezemaseră	Third person Plural
stânjeni	Third person Singular
împleti	Third person Singular
adăpaseră	Third person Plural
scurgeau	Third person Plural
apărea	Third person Singular
hulită	None
scuzase	Third person Singular
convinse	Third person Singular
răni	Third person Singular
bulucea	Third person Singular
fugise	Third person Singular
compatrioților	None
belise	Third person Singular
întrebaserăm	First person Plural
abacul	None
strungărețele	None
trimiți	Second person Singular
oniricul	None
bandajul	None
ceterară	Third person Plural
fluturi	Second person Singular
iconoclaștii	None
miresei	None
castraserăți	Second person Plural
merserăți	Second person Plural
asigurau	Third person Plural
înfricoșași	Second person Singular
mâhnit	None
porții	None
scumpind	None
arau	Third person Plural
încăpea	Third person Singular
vizualizez	First person Singular
întâmplase	Third person Singular
îndrăznim	First person Plural
împletit	None
brutale	None
preoțim	First person Plural
cuvine	Third person Singular
cuprindea	Third person Singular
eliminau	Third person Plural
indisponibile	None
veghea	Third person Singular
băui	First person Singular
circulăm	First person Plural
fluturelui	None
biologicului	None
lungilor	None
căsătorea	Third person Singular
stăteau	Third person Plural
poruncirăți	Second person Plural
destrăbălă	Third person Singular
întrevede	Third person Singular
secerasem	First person Singular
spânzurat	None
înnegurasem	First person Singular
domina	Third person Singular
curățau	Third person Plural
vânând	None
răpuse	Third person Singular
trecuși	Second person Singular
observase	Third person Singular
repauzaseră	Third person Plural
elementarul	None
glasurile	None
satisfacem	First person Plural
vorbii	First person Singular
alungaserăm	First person Plural
chefalul	None
băturăm	First person Plural
prefer	First person Singular
legase	Third person Singular
traductoarelor	None
groșilor	None
chemat	None
juvenilele	None
susținem	First person Plural
citești	Second person Singular
oftase	Third person Singular
blocaseră	Third person Plural
atac	First person Singular
delogau	Third person Plural
capitulași	Second person Singular
futerii	None
șerbii	First person Singular
boala	None
trânteați	Second person Plural
gemenei	None
adopt	First person Singular
comerciantul	None
încheiem	First person Plural
încântaserăm	First person Plural
introdusese	Third person Singular
furceaua	None
lungirăm	First person Plural
mistificaserăți	Second person Plural
presupunea	Third person Singular
dezbrăca	Third person Singular
pasa	Third person Singular
depuserăți	Second person Plural
clocisem	First person Singular
absorbind	None
râvnea	Third person Singular
chițcăiseși	Second person Singular
odihnești	Second person Singular
grăiserăm	First person Plural
sefardului	None
dezrădăcinau	Third person Plural
borâsem	First person Singular
cantautorului	None
îndobitoceați	Second person Plural
jucarăți	Second person Plural
amărăciunii	None
strecurăm	First person Plural
refuzi	Second person Singular
trădaserăți	Second person Plural
părăsim	First person Plural
rulăm	First person Plural
fericisem	First person Singular
înavuțirăți	Second person Plural
păcălisem	First person Singular
macin	First person Singular
invităm	First person Plural
comparaserăm	First person Plural
apuca	Third person Singular
scurtaserăți	Second person Plural
înlocuiseși	Second person Singular
temeliilor	None
secunda	None
deprimați	None
împodobiseși	Second person Singular
mărginiserăm	First person Plural
urcau	Third person Plural
îmbrățișase	Third person Singular
credinței	None
extrageai	Second person Singular
hrăni	Third person Singular
obținui	First person Singular
ștergeați	Second person Plural
vlăguia	Third person Singular
lungă	None
tăcem	First person Plural
chiorâră	Third person Plural
saturară	Third person Plural
urcata	None
alergaserăți	Second person Plural
înverzim	First person Plural
cufundi	Second person Singular
îmbătrâni	Third person Singular
intru	First person Singular
crescută	None
delogaserăm	First person Plural
obișnuiau	Third person Plural
treierară	Third person Plural
dizolvi	Second person Singular
chemarăți	Second person Plural
războaielor	None
făurești	Second person Singular
trăiau	Third person Plural
bengalezele	None
câștig	First person Singular
dezdoise	Third person Singular
construiau	Third person Plural
extinserăți	Second person Plural
obligi	Second person Singular
putuseră	Third person Plural
perindaserăm	First person Plural
voturilor	None
refeci	Second person Singular
îndepărtaseră	Third person Plural
înnoiești	Second person Singular
întremarăm	First person Plural
înlesneau	Third person Plural
milanului	None
deșiri	Second person Singular
întorceau	Third person Plural
scutur	First person Singular
dungat	None
onorezi	Second person Singular
pășunaserăm	First person Plural
amenințase	Third person Singular
brutalului	None
munții	None
destupaseră	Third person Plural
obișnuise	Third person Singular
bucurau	Third person Plural
jandarmii	None
acoperii	First person Singular
simțea	Third person Singular
reazem	First person Singular
împuns	None
încercuia	Third person Singular
temi	Second person Singular
soacra	None
retrasese	Third person Singular
prietenia	None
pregătim	First person Plural
iertași	Second person Singular
mincinoși	None
spărgea	Third person Singular
respirăm	First person Plural
dezgustătoarea	None
separi	Second person Singular
sătura	Third person Singular
tociră	Third person Plural
speriaseși	Second person Singular
tăcea	Third person Singular
aruncăm	First person Plural
îmbătară	Third person Plural
căsătorești	Second person Singular
înfăinarăm	First person Plural
aduceau	Third person Plural
pricepi	Second person Singular
cugeti	Second person Singular
racul	None
ascult	First person Singular
aminti	Third person Singular
ziseră	Third person Plural
desfășuraseră	Third person Plural
mulsese	Third person Singular
străvăzurăți	Second person Plural
rotunji	Third person Singular
cosmonautul	None
aruncaseră	Third person Plural
complexele	None
cearceafurilor	None
murdarele	None
anarhia	None
șalul	None
ruinăm	First person Plural
zgâriară	Third person Plural
mormintele	None
telefonule	None
saliniză	Third person Singular
crește	Third person Singular
aplaudaseși	Second person Singular
refuzași	Second person Singular
iarbă	None
cunoscute	None
sarcastică	None
făgăduiră	Third person Plural
falezelor	None
devenim	First person Plural
excavarăți	Second person Plural
cuvântul	None
răzgândi	Third person Singular
rezist	First person Singular
înmormântasem	First person Singular
numărătorul	None
zbârciși	Second person Singular
adulmec	First person Singular
hobby-urile	None
chitară	None
abdominali	None
ceru	Third person Singular
temperaturile	None
onora	Third person Singular
recuperăm	First person Plural
asistenților	None
întrerupseși	Second person Singular
înfuriarăm	First person Plural
făptuirăți	Second person Plural
furculița	None
dărăpănași	Second person Singular
interesantei	None
țepenelor	None
mangustele	None
licăriră	Third person Plural
țărăneștii	None
zarei	None
adopți	Second person Singular
îndemnase	Third person Singular
împletisem	First person Singular
subțiez	First person Singular
azaleei	None
gustarăm	First person Plural
subscriai	Second person Singular
ironicilor	None
frământa	Third person Singular
scoapseseși	Second person Singular
împrumut	First person Singular
genelor	None
oacheșelor	None
scuzași	Second person Singular
lucrările	None
prăpădeați	Second person Plural
melodiei	None
începură	Third person Plural
înmărmurești	Second person Singular
vizualizarăm	First person Plural
ungurească	None
hobby-ule	None
încarc	First person Singular
otrăvii	First person Singular
spunea	Third person Singular
iubea	Third person Singular
îngropară	Third person Plural
bulucisem	First person Singular
vânduseși	Second person Singular
golea	Third person Singular
împan	First person Singular
uimeau	Third person Plural
slugăriră	Third person Plural
susținuseră	Third person Plural
blocau	Third person Plural
celți	None
persoanele	None
răsăritul	None
lauzi	Second person Singular
trezisem	First person Singular
transcriem	First person Plural
grăiși	Second person Singular
cresta	Third person Singular
penarul	None
declar	First person Singular
persevera	Third person Singular
propusese	Third person Singular
călcăm	First person Plural
strâmba	Third person Singular
ședințele	None
cășunăm	First person Plural
experimentate	None
deșelaseră	Third person Plural
socializarăți	Second person Plural
futuserăm	First person Plural
desprindeau	Third person Plural
excelez	First person Singular
reducem	First person Plural
rezolvau	Third person Plural
sorbit	None
urmărim	First person Plural
observau	Third person Plural
crude	None
convins	None
inserțiilor	None
înnoraserăți	Second person Plural
înlocuise	Third person Singular
desface	Third person Singular
homosexualități	None
inexplicabile	None
cercetau	Third person Plural
vrăjii	First person Singular
supelor	None
donațiile	None
serveai	Second person Singular
împrumutase	Third person Singular
descoperiserăm	First person Plural
dăunez	First person Singular
împungi	Second person Singular
implicau	Third person Plural
descompuse	Third person Singular
împrumutaseră	Third person Plural
eliminaserăm	First person Plural
citea	Third person Singular
înotau	Third person Plural
mangustei	None
zgâii	First person Singular
tricourilor	None
înșela	Third person Singular
plini	None
foca	None
vino	Second person Singular
furiilor	None
răgazule	None
spânzurarăm	First person Plural
pierduseși	Second person Singular
alfabetele	None
închinau	Third person Plural
îmbătrâniră	Third person Plural
invitară	Third person Plural
surprindem	First person Plural
frământau	Third person Plural
izbăviseși	Second person Singular
spuma	Third person Singular
boteza	Third person Singular
traducem	First person Plural
țestoasei	None
adumbriserăți	Second person Plural
pupi	Second person Singular
invincibilei	None
părăsise	Third person Singular
strângeau	Third person Plural
aținuseră	Third person Plural
încununăm	First person Plural
terminăm	First person Plural
spovediserăm	First person Plural
polisierul	None
sărbătorii	First person Singular
partidul	None
urâră	Third person Plural
răsfirași	Second person Singular
cărnos	None
contagiosul	None
șantajiștii	None
cașalotul	None
descălecaseși	Second person Singular
trăgănasem	First person Singular
purcedeați	Second person Plural
înțelepților	None
mărgineați	Second person Plural
făgăduise	Third person Singular
creștea	Third person Singular
înșirară	Third person Plural
răbdaserăm	First person Plural
clociserăm	First person Plural
guvernase	Third person Singular
răsfăț	First person Singular
obținuseși	Second person Singular
desfășurase	Third person Singular
semnăm	First person Plural
berbecul	None
visăm	First person Plural
trepăd	First person Singular
putere	None
riști	Second person Singular
sunau	Third person Plural
înotat	None
îndemnaserăm	First person Plural
nelucratei	None
vrăjirăți	Second person Plural
omori	Second person Singular
refecaserăți	Second person Plural
desziceați	Second person Plural
plec	First person Singular
cioplind	None
spinoase	None
străpungea	Third person Singular
blocăm	First person Plural
юбисешь	Second person Singular
obținea	Third person Singular
spărgeau	Third person Plural
luarăți	Second person Plural
brazilianul	None
luna	None
podului	None
scurmaserăți	Second person Plural
stingherirăți	Second person Plural
strigi	Second person Singular
pingelea	Third person Singular
înșel	First person Singular
cercând	None
urâm	First person Plural
trăii	First person Singular
profund	None
îngreunat	None
bem	First person Plural
studiarăm	First person Plural
desfășase	Third person Singular
ferii	First person Singular
descoperea	Third person Singular
guvernamentala	None
dezvățase	Third person Singular
halucinogenele	None
șnițelelor	None
aplicau	Third person Plural
recuperau	Third person Plural
cărnoasă	None
luau	Third person Plural
simplifica	Third person Singular
pantofilor	None
rosei	First person Singular
dansa	Third person Singular
publicitatea	None
lovii	First person Singular
luptară	Third person Plural
traduseră	Third person Plural
salva	Third person Singular
auzim	First person Plural
valahă	None
ruină	Third person Singular
șezui	First person Singular
fălise	Third person Singular
asculta	Third person Singular
torseserăm	First person Plural
unchilor	None
convingi	Second person Singular
îngânarăți	Second person Plural
săgetași	Second person Singular
consulari	None
vopsim	First person Plural
ferici	Third person Singular
buciumi	Second person Singular
scurs	None
scaunele	None
simplitatea	None
conopidei	None
soarelui	None
trăgănarăți	Second person Plural
adulmecăm	First person Plural
japonezului	None
reintroduce	Third person Singular
nebunim	First person Plural
abandonarea	None
brânzeturilor	None
tremura	Third person Singular
curmalului	None
sunăm	First person Plural
băuseră	Third person Plural
tâmplarul	None
asimilez	First person Singular
inundarăți	Second person Plural
gemură	Third person Plural
obișnuim	First person Plural
lanurile	None
opririi	None
dezmierdaseși	Second person Singular
împodobiși	Second person Singular
rață	None
hotărau	Third person Plural
lămurise	Third person Singular
iluzoriilor	None
cronicele	None
susținuse	Third person Singular
cornutei	None
înlăturarăți	Second person Plural
deplasau	Third person Plural
întremarăți	Second person Plural
simplificăm	First person Plural
gălbuile	None
distrau	Third person Plural
complexa	None
eliminaseră	Third person Plural
simplificarăm	First person Plural
tipăriseră	Third person Plural
anul	None
chițcăiră	Third person Plural
denaturarea	None
dezmințiseși	Second person Singular
îndurerarăm	First person Plural
acoperișul	None
scurta	Third person Singular
deșirasem	First person Singular
chemărilor	None
stropiși	Second person Singular
treziserăm	First person Plural
încadra	Third person Singular
referendumului	None
temperaturii	None
trezea	Third person Singular
anticipare	None
sfecli	Third person Singular
viețuiau	Third person Plural
fișierelor	None
brav	None
vânjoaselor	None
înfulecarăți	Second person Plural
închinarăți	Second person Plural
atacară	Third person Plural
muștelor	None
delirului	None
veneraseși	Second person Singular
înzestrară	Third person Plural
încărunțise	Third person Singular
zburdaseră	Third person Plural
soarele	None
adevărați	None
umiliși	Second person Singular
custaserăți	Second person Plural
dansăm	First person Plural
implicase	Third person Singular
spurcaserăți	Second person Plural
spânzura	Third person Singular
aciuaserăți	Second person Plural
copleșiseși	Second person Singular
pătrunserăm	First person Plural
cufurii	First person Singular
părăsești	Second person Singular
înnegurezi	Second person Singular
răspândea	Third person Singular
pictez	First person Singular
civiizau	Third person Plural
porumbiște	None
cuvios	None
plăceai	Second person Singular
strâmtă	Third person Singular
convenim	First person Plural
suflu	First person Singular
vaginul	None
preferi	Second person Singular
părut	None
întâlniseră	Third person Plural
prinșilor	None
utiliza	Third person Singular
prăjit	None
cutreieraseși	Second person Singular
împerecheat	None
prânziră	Third person Plural
arinul	None
norii	None
întâmplu	First person Singular
descântaseși	Second person Singular
rupeau	Third person Plural
înveli	Third person Singular
strecuraseși	Second person Singular
obținu	Third person Singular
înclina	Third person Singular
socotite	None
știați	Second person Plural
spovedești	Second person Singular
numi	Third person Singular
tânjeau	Third person Plural
chițcăirăm	First person Plural
păți	Third person Singular
răscoapseși	Second person Singular
ezita	Third person Singular
împărțise	Third person Singular
scuipau	Third person Plural
poftiseră	Third person Plural
interfețelor	None
socializa	Third person Singular
împiedicaseși	Second person Singular
izbi	Third person Singular
învolburarăm	First person Plural
înțelepții	None
abilității	None
retraseși	Second person Singular
dezgustarăm	First person Plural
tăcurăți	Second person Plural
pieriserăți	Second person Plural
stricatei	None
harbuzul	None
injectaseră	Third person Plural
impuneau	Third person Plural
profunde	None
cântărirăm	First person Plural
estima	Third person Singular
rută	None
cobor	First person Singular
lipite	None
acceselor	None
urdinase	Third person Singular
răsunând	None
șuierau	Third person Plural
atenții	None
înlocuisem	First person Singular
înghețând	None
țuguielor	None
fundau	Third person Plural
reînnoia	Third person Singular
gemuseși	Second person Singular
sumeseși	Second person Singular
grăbea	Third person Singular
plângeau	Third person Plural
apăsat	None
reținuserăți	Second person Plural
atârnau	Third person Plural
traduce	Third person Singular
sinonimele	None
mouse-urile	None
murau	Third person Plural
pictezi	Second person Singular
dorinței	None
stupide	None
purificăm	First person Plural
nurorile	None
iscălea	Third person Singular
sufletului	None
rulat	None
afganii	None
deszis	None
bibanii	None
nuda	None
făuriserăm	First person Plural
împovăra	Third person Singular
înghițea	Third person Singular
încălzi	Third person Singular
șchiopă	Third person Singular
lămuriseră	Third person Plural
înțelegem	First person Plural
universitatea	None
înavuțești	Second person Singular
încuiarăm	First person Plural
însorirăți	Second person Plural
virotice	None
desprinse	Third person Singular
consoană	None
temelia	None
neglijând	None
încheiaseși	Second person Singular
construiseși	Second person Singular
raselor	None
cocoloșim	First person Plural
șeii	None
atotputernici	None
intrară	Third person Plural
plantară	Third person Plural
nădăjduii	First person Singular
minciună	None
încercasem	First person Singular
induse	Third person Singular
îmbrăca	Third person Singular
ciocnit	None
pedepsit	None
speriarăți	Second person Plural
deșteptaseră	Third person Plural
comportau	Third person Plural
lucrau	Third person Plural
învelișurile	None
cuțitelor	None
injectaseși	Second person Singular
gazela	None
ucidem	First person Plural
distrăm	First person Plural
compozitorilor	None
dansul	None
profundului	None
saturi	Second person Singular
adulmecaserăți	Second person Plural
sfârșiseră	Third person Plural
împodobiră	Third person Plural
prescriem	First person Plural
masturba	Third person Singular
prânzul	None
jurăm	First person Plural
spinteci	Second person Singular
preferând	None
întrezări	Third person Singular
cearceafurile	None
așezi	Second person Singular
mâncă	Third person Singular
supraviețuiești	Second person Singular
încetaseră	Third person Plural
bărbăția	None
închipuirăți	Second person Plural
dovedind	None
atrofii	None
înfățișez	First person Singular
gazat	None
pregătești	Second person Singular
scosese	Third person Singular
guduraseră	Third person Plural
măsuraserăți	Second person Plural
împreunăm	First person Plural
aprige	None
fusul	None
așezase	Third person Singular
măcina	Third person Singular
creșteau	Third person Plural
trăise	Third person Singular
ascultau	Third person Plural
vizitaseră	Third person Plural
strânsese	Third person Singular
aflu	First person Singular
antimaterie	None
sonetele	None
artistice	None
încălziseși	Second person Singular
înșeuară	Third person Plural
mișunarăți	Second person Plural
zbătea	Third person Singular
tăiaserăți	Second person Plural
amuzași	Second person Singular
învolburaserăm	First person Plural
înfocasem	First person Singular
ajunaseși	Second person Singular
măsurau	Third person Plural
prevenea	Third person Singular
îndemânării	None
jigni	Third person Singular
ierta	Third person Singular
adverbiale	None
cafeniu	None
picasem	First person Singular
spânzurau	Third person Plural
cererile	None
fierăstruirăți	Second person Plural
măcinași	Second person Singular
stabilea	Third person Singular
risc	First person Singular
lărgiserăm	First person Plural
descoperii	First person Singular
cercetaseși	Second person Singular
delogarăm	First person Plural
înfocași	Second person Singular
estonienilor	None
excitaserăți	Second person Plural
femininilor	None
înlocuiseră	Third person Plural
neglijat	None
scorni	Third person Singular
certase	Third person Singular
interzisese	Third person Singular
săra	Third person Singular
gravați	None
întorseseși	Second person Singular
folositori	None
construia	Third person Singular
accelerase	Third person Singular
cocoloșise	Third person Singular
bucureștenilor	None
nudul	None
stropi	Third person Singular
umbli	Second person Singular
graba	None
coborârăți	Second person Plural
animaseră	Third person Plural
răstigniseră	Third person Plural
zbori	Second person Singular
explicase	Third person Singular
descarci	Second person Singular
mirosirăm	First person Plural
apropia	Third person Singular
dizolvând	None
activistul	None
artistica	None
smintirăți	Second person Plural
estimară	Third person Plural
obișnuiși	Second person Singular
lămâia	None
cumpărași	Second person Singular
vopsiseră	Third person Plural
zânele	None
cuvenii	First person Singular
delicios	None
urmăriseră	Third person Plural
eterogenă	None
gâmbarăm	First person Plural
știi	Second person Singular
angaja	Third person Singular
răzlețești	Second person Singular
traduse	Third person Singular
oxizilor	None
înălțase	Third person Singular
nativul	None
zbătuseși	Second person Singular
cercetăm	First person Plural
tresări	Third person Singular
dărâmăm	First person Plural
admirau	Third person Plural
împingeau	Third person Plural
supraviețuiși	Second person Singular
tulburaseră	Third person Plural
accelera	Third person Singular
vătămase	Third person Singular
lugubru	None
tundeați	Second person Plural
liberarăți	Second person Plural
arătă	Third person Singular
adoptau	Third person Plural
muncisem	First person Singular
avalanșelor	None
găti	Third person Singular
sugruma	Third person Singular
meduza	None
cumnată	None
atacurile	None
aprindea	Third person Singular
mărar	None
septule	None
oratorului	None
izbăvirăți	Second person Plural
râmăm	First person Plural
rostit	None
rătăcești	Second person Singular
hrăneau	Third person Plural
bârsă	None
unidirecțional	None
pungă	None
mijloci	Third person Singular
lipseau	Third person Plural
țăcănise	Third person Singular
crucificaseși	Second person Singular
interesași	Second person Singular
schimbarăm	First person Plural
conținuși	Second person Singular
areților	None
salt	First person Singular
deschiseseră	Third person Plural
recuperezi	Second person Singular
păturilor	None
cârma	None
visase	Third person Singular
moașă	None
dumnezeule	None
oripilași	Second person Singular
tranzientă	None
dansez	First person Singular
central-europeni	None
pictă	Third person Singular
dezmățaserăți	Second person Plural
învechiseși	Second person Singular
trandafirii	None
rețineau	Third person Plural
înfulecaseși	Second person Singular
nasolul	None
înflori	Third person Singular
momeai	Second person Singular
furios	None
înflorirăm	First person Plural
înfunda	Third person Singular
prevestea	Third person Singular
concentratelor	None
trandafiriei	None
averilor	None
împădurise	Third person Singular
informatici	None
contraveni	Third person Singular
culcași	Second person Singular
conțineau	Third person Plural
cocoșilor	None
forjau	Third person Plural
străvede	Third person Singular
scrotală	None
trecea	Third person Singular
despărțeați	Second person Plural
reții	Second person Singular
cloci	Third person Singular
certaserăți	Second person Plural
instante	None
lemnarii	None
pregătii	First person Singular
sperase	Third person Singular
înșelau	Third person Plural
întărea	Third person Singular
aflau	Third person Plural
aperi	Second person Singular
posteritate	None
traducere	None
petreceau	Third person Plural
tăbăci	Third person Singular
dărăpănăm	First person Plural
pădurilor	None
tragi	Second person Singular
influențând	None
diriguiau	Third person Plural
circularăm	First person Plural
folosirii	None
minuscula	None
cercasem	First person Singular
comparau	Third person Plural
sufocau	Third person Plural
curățat	None
clătești	Second person Singular
vrăjeați	Second person Plural
trânti	Third person Singular
discutaseră	Third person Plural
răposau	Third person Plural
creștinismul	None
pruncilor	None
pictatele	None
rumegară	Third person Plural
conduce	Third person Singular
ud	First person Singular
este	Third person Singular
bengaleze	None
afundaserăm	First person Plural
simțeau	Third person Plural
încetiși	Second person Singular
unserăm	First person Plural
zonele	None
salvez	First person Singular
scăpaserăm	First person Plural
vomi	Second person Singular
apărăm	First person Plural
mândră	None
feminina	None
asfaltării	None
crezuși	Second person Singular
datoră	Third person Singular
ieșim	First person Plural
anghinare	None
elimin	First person Singular
cutremur	First person Singular
slăviseși	Second person Singular
slăveați	Second person Plural
atârnaseși	Second person Singular
închinară	Third person Plural
frunză	None
steagul	None
brăzași	Second person Singular
străbatem	First person Plural
tăticul	None
albina	None
cufurea	Third person Singular
perinealul	None
capacităților	None
pup	First person Singular
îmbrăcase	Third person Singular
întreprinseseră	Third person Plural
gâmbasem	First person Singular
zburd	First person Singular
fixară	Third person Plural
întină	Third person Singular
înfășurasem	First person Singular
gândim	First person Plural
otrăvim	First person Plural
încetaserăm	First person Plural
lărgimilor	None
pregetași	Second person Singular
descălțaserăm	First person Plural
răcnise	Third person Singular
orchestralele	None
șușuiai	Second person Singular
distrași	Second person Singular
adaugi	Second person Singular
devino	Second person Singular
bazezi	Second person Singular
înspăimânta	Third person Singular
circumcideai	Second person Singular
bășise	Third person Singular
scurse	Third person Singular
domnia	None
intimii	None
trecut	None
inteligibil	None
convinserăm	First person Plural
scăpărași	Second person Singular
țepeni	None
închidem	First person Plural
trandafirie	None
furnicasem	First person Singular
dezmințiră	Third person Plural
influențaserăți	Second person Plural
doreați	Second person Plural
învățarăți	Second person Plural
șchiopătase	Third person Singular
răscoapserăm	First person Plural
fericitului	None
riscat	None
glumea	Third person Singular
saluta	Third person Singular
culeseseră	Third person Plural
înnoptau	Third person Plural
astrucaseși	Second person Singular
venii	First person Singular
cuceri	Third person Singular
reluau	Third person Plural
ierți	Second person Singular
porumbiștii	None
aleseseră	Third person Plural
adunaseră	Third person Plural
târguia	Third person Singular
coreeanul	None
distinseră	Third person Plural
fântânile	None
sfârticaserăți	Second person Plural
susținea	Third person Singular
tindem	First person Plural
scutura	Third person Singular
împărași	Second person Singular
despicarăm	First person Plural
echilibraserăți	Second person Plural
ținusem	First person Singular
împlinim	First person Plural
călcarăți	Second person Plural
isprăvirăți	Second person Plural
arăduseserăți	Second person Plural
scuzi	Second person Singular
batracianului	None
descriau	Third person Plural
excava	Third person Singular
întreba	Third person Singular
caisă	None
porunci	Third person Singular
răzgândiră	Third person Plural
revoluțiile	None
cățelule	None
albii	None
petrecem	First person Plural
mulgeați	Second person Plural
rostogolise	Third person Singular
forțaseră	Third person Plural
cărarea	None
traversăm	First person Plural
cumpăraserăm	First person Plural
arnică	None
articulaserăți	Second person Plural
cinase	Third person Singular
formația	None
jenă	Third person Singular
cadavrul	None
purceseră	Third person Plural
urmașii	None
afurisiserăm	First person Plural
aleea	None
circulaserăți	Second person Plural
dormitarăți	Second person Plural
înlocuirăți	Second person Plural
împresurau	Third person Plural
alin	First person Singular
colajul	None
androceele	None
curăț	First person Singular
împiedica	Third person Singular
confruntat	None
aritmetică	None
intenționa	Third person Singular
răstignii	First person Singular
desfășaserăți	Second person Plural
vânasem	First person Singular
luptau	Third person Plural
mersese	Third person Singular
întărâtase	Third person Singular
halim	First person Plural
întâlnești	Second person Singular
trăsnise	Third person Singular
implicat	None
oftic	First person Singular
învioraseră	Third person Plural
susurase	Third person Singular
înfoiarăți	Second person Plural
sânge	None
înmormântaseși	Second person Singular
înălță	Third person Singular
valsaserăți	Second person Plural
ceterat	None
curvei	None
momi	Third person Singular
contopiși	Second person Singular
prindem	First person Plural
vorbitorii	None
împletise	Third person Singular
lungim	First person Plural
începuse	Third person Singular
umerașule	None
îngălbeneați	Second person Plural
apuci	Second person Singular
ațipise	Third person Singular
puma	None
secile	None
urmăm	First person Plural
înscriserăți	Second person Plural
conteneai	Second person Singular
lansa	Third person Singular
rulez	First person Singular
visătoare	None
reînnoi	Third person Singular
juisăm	First person Plural
nejudecații	None
mir	First person Singular
anormalitate	None
îngălbeniserăm	First person Plural
lucra	Third person Singular
lansaseră	Third person Plural
alina	Third person Singular
judeca	Third person Singular
nudismul	None
învelit	None
jucăm	First person Plural
îmblânzirăm	First person Plural
liberau	Third person Plural
topești	Second person Singular
porneau	Third person Plural
încălțasem	First person Singular
râmară	Third person Plural
răcori	Third person Singular
scânceai	Second person Singular
îngălbenit	None
cioplit	None
țăcăniși	Second person Singular
capitala	None
ieșise	Third person Singular
moștenirăm	First person Plural
instantaneu	None
pornografia	None
valină	None
șerbisem	First person Singular
stingeau	Third person Plural
aflăm	First person Plural
deranjăm	First person Plural
grația	None
obligau	Third person Plural
hrană	None
dezamăgeai	Second person Singular
modifici	Second person Singular
scâncisem	First person Singular
юбяць	Second person Plural
venezuelenii	None
amorțirăți	Second person Plural
câtime	None
halirăți	Second person Plural
deplasasem	First person Singular
compara	Third person Singular
majorat	None
îmbucasem	First person Singular
rătăcii	First person Singular
azotosul	None
cearșafurile	None
băga	Third person Singular
beleau	Third person Plural
căpreștii	None
întâmpinaseși	Second person Singular
învălurez	First person Singular
răgușeală	None
mânecaseși	Second person Singular
pătimea	Third person Singular
mergem	First person Plural
îndulci	Third person Singular
documentarăți	Second person Plural
vaccinară	Third person Plural
stropirăm	First person Plural
eliminarăți	Second person Plural
stimulau	Third person Plural
urli	Second person Singular
ghețarilor	None
mărețului	None
stupidă	None
cooperară	Third person Plural
prostit	None
cingem	First person Plural
zisei	First person Singular
acoperită	None
nevastă	None
întâmplaserăm	First person Plural
lipeau	Third person Plural
răbojii	First person Singular
plătea	Third person Singular
scriau	Third person Plural
plăcuse	Third person Singular
portughezii	None
răsei	First person Singular
leneșul	None
trimisesem	First person Singular
neguțaseră	Third person Plural
forță	Third person Singular
subțiem	First person Plural
dezmierdarăm	First person Plural
fericiși	Second person Singular
luară	Third person Plural
descurc	First person Singular
orhideei	None
învinsese	Third person Singular
ciugulea	Third person Singular
subscris	None
maestrule	None
putredele	None
belea	Third person Singular
închipuim	First person Plural
descărcau	Third person Plural
prevestiră	Third person Plural
discutau	Third person Plural
intervenirăm	First person Plural
răstignit	None
cercași	Second person Singular
fugii	First person Singular
temea	Third person Singular
sfâșia	Third person Singular
păroaselor	None
locuise	Third person Singular
catargul	None
judecaseră	Third person Plural
încălecau	Third person Plural
luptăm	First person Plural
botezatelor	None
nimeriseși	Second person Singular
tranzițional	None
urbanizase	Third person Singular
dăuna	Third person Singular
observarăm	First person Plural
negi	Second person Singular
utilizau	Third person Plural
răgușind	None
mijlocii	First person Singular
cooperau	Third person Plural
străjile	None
ocupăm	First person Plural
înfiem	First person Plural
ieftinului	None
crunta	None
salamurile	None
scâncești	Second person Singular
stingheriseră	Third person Plural
mușețeilor	None
deranjez	First person Singular
creativității	None
singură	None
culegi	Second person Singular
dezrădăcinară	Third person Plural
obligând	None
slugărea	Third person Singular
căpruii	None
comunitate	None
ședința	None
creez	First person Singular
botanici	None
încetiseră	Third person Plural
numărau	Third person Plural
ghidez	First person Singular
apăsăm	First person Plural
fremătase	Third person Singular
obținuseră	Third person Plural
jinduiseră	Third person Plural
încălecase	Third person Singular
hemoroidul	None
tremurau	Third person Plural
răneai	Second person Singular
modificau	Third person Plural
ascuțirăm	First person Plural
ferma	None
învecheai	Second person Singular
aduse	Third person Singular
urbanizării	None
îngerilor	None
căsătoriseră	Third person Plural
lansăm	First person Plural
zărirăți	Second person Plural
urâserăți	Second person Plural
rusesc	None
dărăpănasem	First person Singular
vasele	None
propunerea	None
întăreau	Third person Plural
societate	None
biscuitule	None
venea	Third person Singular
înșeuarăm	First person Plural
constrânse	Third person Singular
botezarăți	Second person Plural
recuperase	Third person Singular
sfințiserăți	Second person Plural
rezistibili	None
rezolvând	None
renova	Third person Singular
fierbeați	Second person Plural
respir	First person Singular
templierul	None
împiedicau	Third person Plural
ciocănitoare	None
grăsimea	None
propusesem	First person Singular
coroziunii	None
curgi	Second person Singular
plângea	Third person Singular
fetele	None
trădaseră	Third person Plural
datorau	Third person Plural
iertate	None
viețuim	First person Plural
vaccinaserăm	First person Plural
judeci	Second person Singular
conducem	First person Plural
retezară	Third person Plural
încărunțiseră	Third person Plural
liniștit	None
împingea	Third person Singular
învăță	Third person Singular
străzilor	None
interzice	Third person Singular
ardea	Third person Singular
discordiile	None
uit	First person Singular
viguros	None
aflând	None
căsătoreați	Second person Plural
amărât	None
istorici	None
haosurilor	None
înșeuase	Third person Singular
exportatorilor	None
sculaserăți	Second person Plural
întrezărim	First person Plural
grăbiseră	Third person Plural
circumscriați	Second person Plural
îmbunătățisem	First person Singular
dumnezeiesc	None
ruptă	None
cânta	Third person Singular
săriserăți	Second person Plural
produse	Third person Singular
răsfiraseră	Third person Plural
haiducilor	None
înăbușisem	First person Singular
excavezi	Second person Singular
supreme	None
înscriem	First person Plural
nebunirăți	Second person Plural
înțepa	Third person Singular
prim	None
scol	First person Singular
discutăm	First person Plural
lubrifiaseră	Third person Plural
sap	First person Singular
tincturase	Third person Singular
serioasă	None
biletelor	None
chemarăm	First person Plural
lățeați	Second person Plural
clocoti	Third person Singular
compari	Second person Singular
lății	First person Singular
încrucișa	Third person Singular
gusta	Third person Singular
adâncise	Third person Singular
beliră	Third person Plural
spălăm	First person Plural
imaginăm	First person Plural
îngrijorași	Second person Singular
rezolvase	Third person Singular
simbolului	None
mediocră	None
sfătuia	Third person Singular
plimbau	Third person Plural
cumplitul	None
surdă	None
lipea	Third person Singular
avansaseră	Third person Plural
feri	Third person Singular
închina	Third person Singular
muistelor	None
stânga	None
extinsese	Third person Singular
petrecu	Third person Singular
spurcară	Third person Plural
salvase	Third person Singular
zmeurii	None
înfăinară	Third person Plural
masive	None
înfulecase	Third person Singular
interzici	Second person Singular
întrevedea	Third person Singular
bătuse	Third person Singular
rezolvași	Second person Singular
distruseseră	Third person Plural
spumega	Third person Singular
terminării	None
îndesase	Third person Singular
întrevăzuserăm	First person Plural
existând	None
atârna	Third person Singular
stinsesem	First person Singular
aluminiferele	None
tisa	None
ardeiul	None
rugi	Third person Singular
sferturile	None
învățaseră	Third person Plural
astupase	Third person Singular
prețuim	First person Plural
naivi	None
neprietenos	None
îmbrățișezi	Second person Singular
rămâneai	Second person Singular
încărunțirăți	Second person Plural
venerarăm	First person Plural
urmărise	Third person Singular
bijuteriei	None
vărsaserăm	First person Plural
dulci	None
aflaseră	Third person Plural
folosii	First person Singular
augurarăți	Second person Plural
comunicat	None
programabilele	None
hienă	None
presupuse	Third person Singular
colegilor	None
împletiserăm	First person Plural
păruse	Third person Singular
mâncară	Third person Plural
îndrăzniră	Third person Plural
citim	First person Plural
cumpărau	Third person Plural
lepăda	Third person Singular
prinse	Third person Singular
ascunsese	Third person Singular
rozmarinii	None
loviseră	Third person Plural
cinsesem	First person Singular
clarifica	Third person Singular
cooperările	None
satisfăcuse	Third person Singular
disprețule	None
începusem	First person Singular
șchiopară	Third person Plural
vânduseră	Third person Plural
apuse	Third person Singular
sațietate	None
șerbiserăm	First person Plural
nebuneau	Third person Plural
robești	Second person Singular
acoperământule	None
afronturilor	None
sângerăm	First person Plural
lubrifia	Third person Singular
reținând	None
cinsti	Third person Singular
suspin	First person Singular
cetera	Third person Singular
pleca	Third person Singular
haliră	Third person Plural
pierim	First person Plural
urziră	Third person Plural
sfinții	First person Singular
ieftini	Third person Singular
expediat	None
articulară	Third person Plural
împac	First person Singular
comerțului	None
dispuneați	Second person Plural
cunoaștem	First person Plural
avansaserăm	First person Plural
suflecaserăm	First person Plural
slăvim	First person Plural
dușmăniserăți	Second person Plural
spermă	None
îndeletnicit	None
tranzitivi	None
înmulți	Third person Singular
tranziente	None
prezentare	None
dărâma	Third person Singular
temem	First person Plural
tipăreau	Third person Plural
inutilului	None
varicela	None
cucerim	First person Plural
ospătezi	Second person Singular
sângerarăți	Second person Plural
învinse	Third person Singular
împăcași	Second person Singular
reala	None
adulmecasem	First person Singular
lățești	Second person Singular
aerisea	Third person Singular
adăpa	Third person Singular
puteați	Second person Plural
insistarăm	First person Plural
studie	Third person Singular
văzu	Third person Singular
nutrisem	First person Singular
detaliile	None
adunau	Third person Plural
înjunghia	Third person Singular
număraseră	Third person Plural
înlesnim	First person Plural
prazi	Second person Singular
credem	First person Plural
orientau	Third person Plural
bășiserăți	Second person Plural
descria	Third person Singular
înnegri	Third person Singular
imputarăm	First person Plural
vorbeați	Second person Plural
izbăvi	Third person Singular
contribuția	None
abandonul	None
îngustăm	First person Plural
dormit	First person Singular
batem	First person Plural
înrădăcinarăm	First person Plural
antagonică	None
litera	None
petrecurăți	Second person Plural
jenaserăm	First person Plural
presupusese	Third person Singular
înlocuim	First person Plural
vizualizarea	None
mandrilule	None
interesa	Third person Singular
portocalele	None
încurau	Third person Plural
mărturisi	Third person Singular
înfumuraserăți	Second person Plural
corupserăm	First person Plural
sărata	None
acuzaseră	Third person Plural
întărâtași	Second person Singular
umili	Third person Singular
lupți	Second person Singular
stors	None
guvernarăm	First person Plural
indisponibil	None
dispăruse	Third person Singular
frânasem	First person Singular
capăt	First person Singular
barbă	None
harfelor	None
înmulțit	None
controla	Third person Singular
deger	First person Singular
guvernaserăm	First person Plural
sucului	None
servești	Second person Singular
munților	None
cerșiseși	Second person Singular
încăpuserăți	Second person Plural
culese	Third person Singular
pliviră	Third person Plural
întrețineau	Third person Plural
agrișa	None
scăpăraseși	Second person Singular
crezu	Third person Singular
scapăt	First person Singular
denaturez	First person Singular
elibera	Third person Singular
apăru	Third person Singular
leșin	First person Singular
discuți	Second person Singular
preoții	First person Singular
eliberă	Third person Singular
puțurilor	None
dezgustului	None
miroși	Second person Singular
spinoasele	None
vrăjilor	None
schimbi	Second person Singular
scăpăraserăți	Second person Plural
minții	First person Singular
asigurăm	First person Plural
stadionul	None
tace	Third person Singular
supărasem	First person Singular
alunga	Third person Singular
tremuraserăm	First person Plural
liberaseși	Second person Singular
antropologiei	None
dublez	First person Singular
adeverii	First person Singular
stinseserăm	First person Plural
frecaseși	Second person Singular
avânți	Second person Singular
puține	None
înscrise	Third person Singular
aciua	Third person Singular
treierând	None
violoncelul	None
traducea	Third person Singular
dezrobirăți	Second person Plural
peiorativule	None
torsesem	First person Singular
sticlelor	None
cuminecăm	First person Plural
înfrățise	Third person Singular
susținui	First person Singular
înțelesesem	First person Singular
jupuia	Third person Singular
ciotului	None
scăpăraserăm	First person Plural
îngrijorau	Third person Plural
însoțea	Third person Singular
mărgini	Third person Singular
înșelasem	First person Singular
unim	First person Plural
circumscrise	Third person Singular
rezistase	Third person Singular
topiseră	Third person Plural
izgonii	First person Singular
morcovului	None
coroziunilor	None
dezleg	First person Singular
cumințise	Third person Singular
mistificaseră	Third person Plural
încadrezi	Second person Singular
masturbarăm	First person Plural
luceau	Third person Plural
gândea	Third person Singular
făcuseră	Third person Plural
uscau	Third person Plural
laud	First person Singular
stăruit	None
măsor	First person Singular
obiectele	None
înscriau	Third person Plural
declarară	Third person Plural
afli	Second person Singular
zbăteau	Third person Plural
raționalizabilului	None
săreai	Second person Singular
plătise	Third person Singular
expediaserăți	Second person Plural
udaseră	Third person Plural
caselor	None
moare	Third person Singular
eprubetele	None
lansau	Third person Plural
maioneză	None
mărarul	None
baraseși	Second person Singular
respirau	Third person Plural
hiba	None
transatlantică	None
muncim	First person Plural
străveche	None
confrunți	Second person Singular
dezmeticeai	Second person Singular
plimbarăm	First person Plural
neteziserăm	First person Plural
dezvoltat	None
fraudaserăți	Second person Plural
ierarhiilor	None
cumpătară	Third person Plural
slujise	Third person Singular
frumuseții	None
rămânea	Third person Singular
puturoșilor	None
strămutași	Second person Singular
pețea	Third person Singular
vorba	None
enciclopediile	None
dure	None
răpise	Third person Singular
economie	None
pricepeau	Third person Plural
umilirăm	First person Plural
dispuneau	Third person Plural
satisface	Third person Singular
dulapule	None
ionosfere	None
leșinasem	First person Singular
închisă	None
bisexualitate	None
abandonăm	First person Plural
gemu	Third person Singular
sfârticau	Third person Plural
activităților	None
bibliotecilor	None
socoteau	Third person Plural
studiaseră	Third person Plural
întâlni	Third person Singular
lucise	Third person Singular
muntoșii	None
хомосексуалитэций	None
înfulecaseră	Third person Plural
sfințim	First person Plural
înlesniși	Second person Singular
liniștii	First person Singular
simplific	First person Singular
plata	None
profundele	None
încumetat	None
răzbun	First person Singular
otrăvi	Third person Singular
deplasarăm	First person Plural
principalelor	None
neadaptaților	None
scoci	Second person Singular
circumscriem	First person Plural
vizualizare	None
foloseau	Third person Plural
cucerisem	First person Singular
șchiopaseră	Third person Plural
îmbătrânirăți	Second person Plural
surpași	Second person Singular
făliră	Third person Plural
insistau	Third person Plural
constătuserăm	First person Plural
urangutanul	None
țigărilor	None
îmbulziră	Third person Plural
implicaserăți	Second person Plural
băgasem	First person Singular
luminoasa	None
piși	Second person Singular
datoarele	None
strecurarăți	Second person Plural
plimb	First person Singular
bestialei	None
pasteurizau	Third person Plural
coși	Second person Singular
îngrijora	Third person Singular
implic	First person Singular
visă	Third person Singular
săratul	None
alegeau	Third person Plural
sistaserăm	First person Plural
orgasmul	None
unse	Third person Singular
maghiarilor	None
avortau	Third person Plural
deschisesem	First person Singular
morsa	None
fierseși	Second person Singular
întortochease	Third person Singular
prelungeau	Third person Plural
trompetele	None
vindeați	Second person Plural
țestosului	None
înnodă	Third person Singular
râului	None
behaviorism	None
murise	Third person Singular
distrugem	First person Plural
tragem	First person Plural
fișierul	None
masivelor	None
ruginești	Second person Singular
bășica	Third person Singular
păstrez	First person Singular
adăugară	Third person Plural
iscăliră	Third person Plural
nisiposului	None
câmpenești	None
pătura	None
săpaseră	Third person Plural
observăm	First person Plural
dezunim	First person Plural
dezlipeau	Third person Plural
inundați	Second person Plural
judecăm	First person Plural
șchiopat	None
speteați	Second person Plural
mamuții	None
implicară	Third person Plural
pierdeau	Third person Plural
scumpești	Second person Singular
devenise	Third person Singular
crăpaserăm	First person Plural
amăgi	Third person Singular
vizitez	First person Singular
amânaseră	Third person Plural
invit	First person Singular
murdărești	Second person Singular
buchetul	None
rusul	None
pederaștilor	None
lansaseși	Second person Singular
îndrăgostea	Third person Singular
bătând	None
nenumărabil	None
concepuseră	Third person Plural
descărca	Third person Singular
ridicaserăm	First person Plural
compunea	Third person Singular
îngrijirăți	Second person Plural
ruta	None
învechise	Third person Singular
taină	None
caisului	None
nășteați	Second person Plural
cocea	Third person Singular
sonata	None
cuvenea	Third person Singular
adăugași	Second person Singular
nemeritată	None
șchiop	None
începea	Third person Singular
sacrificiul	None
deranja	Third person Singular
sarcasticelor	None
șmecherul	None
trezirăți	Second person Plural
asprul	None
crescuseră	Third person Plural
lucioșii	None
credeați	Second person Plural
norul	None
încumet	First person Singular
șerbiserăți	Second person Plural
dezamăgi	Third person Singular
deveneai	Second person Singular
genetic	None
sfătuiau	Third person Plural
induceau	Third person Plural
răsufla	Third person Singular
împerechearăm	First person Plural
tulburaserăți	Second person Plural
pasteurizasem	First person Singular
explica	Third person Singular
eliminase	Third person Singular
țigănisem	First person Singular
distila	Third person Singular
mijlociserăm	First person Plural
însoțiră	Third person Plural
privegheaseși	Second person Singular
sclavă	None
stupiditățile	None
modalităților	None
întinsurilor	None
trădau	Third person Plural
piticii	None
organului	None
completau	Third person Plural
rezolvară	Third person Plural
declarăm	First person Plural
așteptă	Third person Singular
curseserăm	First person Plural
străzii	None
serbarăți	Second person Plural
induseră	Third person Plural
pronume	None
mulțumești	Second person Singular
calendarelor	None
terminau	Third person Plural
scăpă	Third person Singular
pățiserăm	First person Plural
dezbinaserăți	Second person Plural
apăruse	Third person Singular
scoli	Second person Singular
sculă	Third person Singular
dărâmaseră	Third person Plural
curățăm	First person Plural
socializaseși	Second person Singular
intacte	None
denaturară	Third person Plural
depăna	Third person Singular
iertarăm	First person Plural
încadrași	Second person Singular
reală	None
merserăm	First person Plural
chitarei	None
înrâurit	None
tinse	Third person Singular
nerușinații	None
închinat	None
bobocul	None
îmbrățișaseră	Third person Plural
urdinasem	First person Singular
netezit	None
pregăti	Third person Singular
drăguță	None
documentăm	First person Plural
cântarăți	Second person Plural
prinseserăm	First person Plural
anulasem	First person Singular
inflorescența	None
închidea	Third person Singular
conveni	Third person Singular
cascadele	None
studiezi	Second person Singular
sonatele	None
cufuriseși	Second person Singular
surprindea	Third person Singular
virilă	None
pătrunseră	Third person Plural
purici	Second person Singular
doreai	Second person Singular
menținem	First person Plural
cooperăm	First person Plural
activaseră	Third person Plural
adiară	Third person Plural
servirăți	Second person Plural
conduci	Second person Singular
privegheară	Third person Plural
gălbuie	None
sunteți	Second person Plural
înghițise	Third person Singular
turbară	Third person Plural
lansasem	First person Singular
plictisești	Second person Singular
șoptirăm	First person Plural
iritase	Third person Singular
călcaseși	Second person Singular
obișnuiești	Second person Singular
estimez	First person Singular
sporea	Third person Singular
distinseseră	Third person Plural
imaginile	None
despărțea	Third person Singular
erecțiile	None
coastelor	None
lucraseră	Third person Plural
fulgera	Third person Singular
îmbunătățești	Second person Singular
copiau	Third person Plural
corcise	Third person Singular
crescu	Third person Singular
garajul	None
prăbușeau	Third person Plural
sfaturile	None
mahalaua	None
trepezi	Second person Singular
amintea	Third person Singular
lucraserăm	First person Plural
sporeau	Third person Plural
îmblânzirăți	Second person Plural
disponibilitatea	None
utilizez	First person Singular
prelungise	Third person Singular
asurziși	Second person Singular
magiștrii	None
subscriau	Third person Plural
locuim	First person Plural
împletii	First person Singular
grăbim	First person Plural
veninoasă	None
spurcăciunilor	None
polonezul	None
șmecheria	None
irit	First person Singular
naștem	First person Plural
risipiseră	Third person Plural
sumeseserăm	First person Plural
respira	Third person Singular
cercetezi	Second person Singular
afină	None
junghiarăm	First person Plural
înverzi	Third person Singular
vaccinăm	First person Plural
presupui	Second person Singular
împovăraserăți	Second person Plural
dușmănia	None
vâna	Third person Singular
memorizarăți	Second person Plural
prindeau	Third person Plural
copiară	Third person Plural
transformase	Third person Singular
tinsă	None
explicăm	First person Plural
anilor	None
dansaserăm	First person Plural
cunoscuse	Third person Singular
prețule	None
schimbaseși	Second person Singular
uterul	None
viticultorului	None
confluențele	None
zi	Second person Singular
vindeci	Second person Singular
răsfiraserăți	Second person Plural
îngrijeau	Third person Plural
robeați	Second person Plural
amuz	First person Singular
bivolul	None
făli	Third person Singular
pătrundeai	Second person Singular
americanii	None
căpătaseră	Third person Plural
urâtului	None
închizi	Second person Singular
răspândise	Third person Singular
capitalistelor	None
izolați	None
baie	None
zise	Third person Singular
înfumura	Third person Singular
jupuiau	Third person Plural
coceau	Third person Plural
uscă	Third person Singular
epuizase	Third person Singular
pășunarăți	Second person Plural
încerca	Third person Singular
subscriați	Second person Plural
șuierară	Third person Plural
crăp	First person Singular
vrabie	None
retrageau	Third person Plural
prezente	None
comporta	Third person Singular
cobori	Second person Singular
roti	Third person Singular
echilibra	Third person Singular
fugeau	Third person Plural
spulberarăți	Second person Plural
supravegheau	Third person Plural
gâmbat	None
înjunghiaseră	Third person Plural
întrebărilor	None
slăbea	Third person Singular
casele	None
încăpuseră	Third person Plural
grăbești	Second person Singular
alese	Third person Singular
umeda	None
culcat	None
îmbunătățim	First person Plural
isprăviseră	Third person Plural
lingvistic	None
spera	Third person Singular
îndepărtă	Third person Singular
fripților	None
apăruseră	Third person Plural
evingi	Second person Singular
obții	Second person Singular
pierzi	Second person Singular
roase	Third person Singular
excavasem	First person Singular
somarăm	First person Plural
lămurim	First person Plural
proprietatea	None
mărturisea	Third person Singular
bănuia	Third person Singular
irita	Third person Singular
turtea	Third person Singular
dublase	Third person Singular
biete	None
murmurase	Third person Singular
meritând	None
personalității	None
curățasem	First person Singular
rula	Third person Singular
impusesem	First person Singular
implicasem	First person Singular
plăteau	Third person Plural
comanda	Third person Singular
asiguri	Second person Singular
frățeștile	None
reziști	Second person Singular
cădea	Third person Singular
pătarăți	Second person Plural
socului	None
cutreiera	Third person Singular
uciderea	None
motorul	None
lăsaserăm	First person Plural
fălea	Third person Singular
implicaseră	Third person Plural
destrami	Second person Singular
dezdoim	First person Plural
judecară	Third person Plural
năluca	None
certa	Third person Singular
coborau	Third person Plural
vânăta	None
înlesneați	Second person Plural
frustrările	None
unise	Third person Singular
inutil	None
înseninași	Second person Singular
armeană	None
absorbea	Third person Singular
fumau	Third person Plural
săreau	Third person Plural
obrazul	None
rezolvi	Second person Singular
cari	Second person Singular
porniră	Third person Plural
învolți	None
supui	Second person Singular
oprea	Third person Singular
suim	First person Plural
discutaserăți	Second person Plural
lungea	Third person Singular
rupea	Third person Singular
metrul	None
descrescuseși	Second person Singular
obliga	Third person Singular
comândaseși	Second person Singular
sparseseși	Second person Singular
răsculă	Third person Singular
cerșirăm	First person Plural
ștergeau	Third person Plural
umbrise	Third person Singular
canonirăm	First person Plural
căpușelor	None
căzuserăm	First person Plural
donarăm	First person Plural
vaccinași	Second person Singular
țigănești	Second person Singular
județelor	None
trăiești	Second person Singular
străbătea	Third person Singular
răsziseseră	Third person Plural
pierdeai	Second person Singular
merizasem	First person Singular
dormitaserăți	Second person Plural
înfăș	First person Singular
șerbiseră	Third person Plural
narcotizau	Third person Plural
înfrunzești	Second person Singular
facem	First person Plural
fala	None
descălță	Third person Singular
introducea	Third person Singular
supraveghem	First person Plural
descriserăți	Second person Plural
maghiară	None
chemării	None
putusem	First person Singular
zbârliserăți	Second person Plural
comunici	Second person Singular
doriseră	Third person Plural
scuipa	Third person Singular
seduseși	Second person Singular
oprești	Second person Singular
șubrede	None
aurea	Third person Singular
cearșaful	None
dospisem	First person Singular
anarhie	None
iritat	None
topea	Third person Singular
vâscului	None
despuiaseră	Third person Plural
mursecaserăți	Second person Plural
milimetricele	None
filantropie	None
susceptibil	None
pingeliserăți	Second person Plural
cărând	None
însetezarăți	Second person Plural
bocetele	None
descoperirăm	First person Plural
citii	First person Singular
angajaseră	Third person Plural
protejezi	Second person Singular
iubise	Third person Singular
împresurară	Third person Plural
înșuruba	Third person Singular
actorului	None
custau	Third person Plural
prăsisem	First person Singular
dărăpănaseră	Third person Plural
jignea	Third person Singular
răposași	Second person Singular
vizitezi	Second person Singular
obligase	Third person Singular
bețivului	None
dezbina	Third person Singular
apicultorilor	None
viticultorilor	None
împinsesem	First person Singular
impunem	First person Plural
marinul	None
râdeau	Third person Plural
văzusem	First person Singular
mâhnești	Second person Singular
balconul	None
înțelegi	Second person Singular
lași	Second person Singular
norocoasa	None
arseserăți	Second person Plural
croi	Third person Singular
lipeai	Second person Singular
înveninase	Third person Singular
corupse	Third person Singular
chilotului	None
pipirigul	None
îmbulziserăți	Second person Plural
moașei	None
adversarului	None
extindem	First person Plural
înfășaserăți	Second person Plural
blestemul	None
gecii	None
băiețeii	None
bărbatului	None
absorbisem	First person Singular
bulgărească	None
micșorase	Third person Singular
acuz	First person Singular
cunoștea	Third person Singular
cumplisem	First person Singular
înghițiserăți	Second person Plural
insistară	Third person Plural
reduseră	Third person Plural
sinuciseră	Third person Plural
ilegalei	None
fertilitate	None
ieftinii	First person Singular
conducea	Third person Singular
mișunau	Third person Plural
dezrădăcinași	Second person Singular
bazilica	None
scriem	First person Plural
ofta	Third person Singular
aromânesc	None
împinseserăți	Second person Plural
întrebuințase	Third person Singular
admir	First person Singular
prinseseră	Third person Plural
ospătăriței	None
cuviosul	None
botezată	None
îmbulziseră	Third person Plural
îmbulzeai	Second person Singular
coniacurile	None
clătirăm	First person Plural
rănea	Third person Singular
contenea	Third person Singular
torsei	First person Singular
înfășaserăm	First person Plural
plânsesem	First person Singular
acoperise	Third person Singular
armelor	None
oblici	None
capsulași	Second person Singular
lingușiși	Second person Singular
împroprietăriserăm	First person Plural
apăsarăți	Second person Plural
secundelor	None
însoțise	Third person Singular
prăjită	None
trepădă	Third person Singular
cinsteați	Second person Plural
recuperat	None
traseși	Second person Singular
șuierarăți	Second person Plural
histologic	None
chelnerul	None
constătu	Third person Singular
refuzase	Third person Singular
lăsaseși	Second person Singular
împresurași	Second person Singular
portabilitate	None
afrontul	None
umplea	Third person Singular
asiguraserăți	Second person Plural
răzbuna	Third person Singular
discutase	Third person Singular
haoticele	None
îndrăgostiși	Second person Singular
ataraxicelor	None
răzbuni	Second person Singular
fremătarăm	First person Plural
însărcină	Third person Singular
oratorii	None
înrămaseși	Second person Singular
făurit	None
continentala	None
pierduseră	Third person Plural
fugim	First person Plural
măcinase	Third person Singular
perseverezi	Second person Singular
răbojeați	Second person Plural
tipări	Third person Singular
fumasem	First person Singular
concepea	Third person Singular
salutaserăți	Second person Plural
explici	Second person Singular
îmbătrânind	None
asigura	Third person Singular
tăiaseși	Second person Singular
omorâi	First person Singular
pasteurizez	First person Singular
alerga	Third person Singular
potabila	None
semnase	Third person Singular
deveneau	Third person Plural
forfecară	Third person Plural
lubrifiezi	Second person Singular
implica	Third person Singular
însetezau	Third person Plural
feminitatea	None
dezechilibrele	None
prânzeați	Second person Plural
farmaciștilor	None
îmbuna	Third person Singular
înnegrea	Third person Singular
cotropiserăți	Second person Plural
guvernamental	None
aninarăm	First person Plural
completarăm	First person Plural
sun	First person Singular
aiorilor	None
cerem	First person Plural
îmbinaserăm	First person Plural
luci	Third person Singular
forțăm	First person Plural
tatuarăți	Second person Plural
producea	Third person Singular
scuza	Third person Singular
micșorarăți	Second person Plural
tăgăduit	None
înălțat	None
acuzăm	First person Plural
deștept	First person Singular
zăcem	First person Plural
convingem	First person Plural
castelelor	None
amicul	None
ceri	Second person Singular
arbuștilor	None
găurisem	First person Singular
rețelelor	None
telefoanelor	None
aritmetice	None
trădase	Third person Singular
obstrucție	None
făgetele	None
îngrijea	Third person Singular
nimicea	Third person Singular
dormeau	Third person Plural
lungirăți	Second person Plural
urdinau	Third person Plural
identitate	None
însoțit	None
părăsea	Third person Singular
venerau	Third person Plural
pătrundeau	Third person Plural
câștigarăți	Second person Plural
datora	Third person Singular
zahărului	None
izgonim	First person Plural
fereau	Third person Plural
acumulase	Third person Singular
descoperise	Third person Singular
târguiai	Second person Singular
îmbulzirăm	First person Plural
bazase	Third person Singular
fluier	First person Singular
beliseși	Second person Singular
uciseseră	Third person Plural
iudaism	None
vindeau	Third person Plural
făuriră	Third person Plural
plătești	Second person Singular
puric	First person Singular
încărcăm	First person Plural
căsătorise	Third person Singular
spălasem	First person Singular
plantă	Third person Singular
lăcrimosului	None
odihni	Third person Singular
dezvoltaseră	Third person Plural
îmbogăți	Third person Singular
diriguim	First person Plural
străpunseseși	Second person Singular
stăpânea	Third person Singular
veghe	Third person Singular
salvezi	Second person Singular
stimă	Third person Singular
scremuseși	Second person Singular
interziceau	Third person Plural
depunând	None
însoțiseră	Third person Plural
nearticulat	None
induceai	Second person Singular
pierdem	First person Plural
tăieturile	None
biserica	None
lărgii	First person Singular
economicilor	None
zidărie	None
aburilor	None
morsei	None
cunoscuseră	Third person Plural
reușești	Second person Singular
încuia	Third person Singular
crăpat	None
scufundate	None
legasem	First person Singular
ținem	First person Plural
dușmăni	Third person Singular
devenii	First person Singular
astupi	Second person Singular
aduserăm	First person Plural
aplicăm	First person Plural
sugrumăm	First person Plural
descreșteau	Third person Plural
iconoclaștilor	None
înverzise	Third person Singular
ridicăm	First person Plural
înmărmurirăm	First person Plural
înfuria	Third person Singular
intrase	Third person Singular
învinseserăți	Second person Plural
întorseseră	Third person Plural
bogăție	None
împărți	Third person Singular
adânci	Third person Singular
petrecuseră	Third person Plural
forjă	Third person Singular
îmbătau	Third person Plural
jurase	Third person Singular
ocupând	None
scădeau	Third person Plural
străbătuse	Third person Singular
comandase	Third person Singular
zgâirăți	Second person Plural
aduseseră	Third person Plural
trăiați	Second person Plural
întemeiezi	Second person Singular
frământară	Third person Plural
devine	Third person Singular
înfuleca	Third person Singular
auzisem	First person Singular
scurtelor	None
zăpăci	Third person Singular
promisiunilor	None
greși	Third person Singular
tocești	Second person Singular
bășicaseră	Third person Plural
dezuniserăm	First person Plural
croia	Third person Singular
măsuraseră	Third person Plural
porcarul	None
magii	None
vrăjiră	Third person Plural
psihologiei	None
înfăptuiserăți	Second person Plural
înmâna	Third person Singular
cimpanzeul	None
suci	Third person Singular
desfăcuși	Second person Singular
întrevedeau	Third person Plural
mutase	Third person Singular
depărta	Third person Singular
leacurilor	None
încheiarăți	Second person Plural
reiei	Second person Singular
cenușiii	None
asprului	None
traversasem	First person Singular
guduraserăți	Second person Plural
scriseră	Third person Plural
rândurilor	None
terminație	None
anulau	Third person Plural
înnegrisem	First person Singular
susurarăm	First person Plural
intra	Third person Singular
sufocaserăm	First person Plural
dublă	Third person Singular
pictate	None
maghiarului	None
mânia	Third person Singular
aromânești	None
controlași	Second person Singular
dezvoltăm	First person Plural
munciserăți	Second person Plural
scădea	Third person Singular
zăpăceați	Second person Plural
chemă	Third person Singular
pietroiul	None
urăști	Second person Singular
meritaseși	Second person Singular
bărbierisem	First person Singular
calculatoarelor	None
craniule	None
meticulozitatea	None
astrucași	Second person Singular
schimbași	Second person Singular
conjuga	Third person Singular
absorbeați	Second person Plural
adunaserăm	First person Plural
adoptaseră	Third person Plural
îndurerând	None
împăturiseși	Second person Singular
lubrifie	Third person Singular
balcanică	None
găsise	Third person Singular
nălucile	None
ghiciși	Second person Singular
înșelaserăți	Second person Plural
articulezi	Second person Singular
întâmplăm	First person Plural
înfuriaserăți	Second person Plural
mutație	None
fierților	None
ponegriră	Third person Plural
măgarului	None
rugaserăți	Second person Plural
mișcare	None
mărginiră	Third person Plural
zăreau	Third person Plural
traversaseră	Third person Plural
apărem	First person Plural
vindeca	Third person Singular
creștinesc	None
adăugă	Third person Singular
rămăseseși	Second person Singular
imaginezi	Second person Singular
zbătu	Third person Singular
trăsnea	Third person Singular
plictisim	First person Plural
înfierbântau	Third person Plural
smulseseră	Third person Plural
toarcem	First person Plural
răsfirasem	First person Singular
buciumarăți	Second person Plural
aerisiseră	Third person Plural
bărbieriși	Second person Singular
bășic	First person Singular
îmboldea	Third person Singular
pripise	Third person Singular
cetățenilor	None
numărase	Third person Singular
admirase	Third person Singular
închipuii	First person Singular
sefarzi	None
cursei	First person Singular
intenționase	Third person Singular
arăm	First person Plural
trotuarele	None
leșie	None
cruzimile	None
cântau	Third person Plural
mâței	None
umbreați	Second person Plural
canonului	None
prinzi	Second person Singular
lipsise	Third person Singular
coopera	Third person Singular
jucase	Third person Singular
informaticii	None
mustraseși	Second person Singular
absintul	None
câștigași	Second person Singular
eroilor	None
minunasem	First person Singular
salamandră	None
păparăm	First person Plural
bietei	None
plecau	Third person Plural
ascundea	Third person Singular
înfocau	Third person Plural
abandonez	First person Singular
miloasă	None
păzea	Third person Singular
ruginii	First person Singular
denaturare	None
rodeai	Second person Singular
preferaseși	Second person Singular
puternicii	None
zgăuraserăți	Second person Plural
admirăm	First person Plural
prospătase	Third person Singular
străpungi	Second person Singular
imperiale	None
murdări	Third person Singular
afurisind	None
istețul	None
găsești	Second person Singular
globalizării	None
papi	Second person Singular
scremură	Third person Plural
mestecenii	None
zburdase	Third person Singular
râdea	Third person Singular
vătămat	None
jignim	First person Plural
lovise	Third person Singular
reintroduseserăm	First person Plural
zgâirăm	First person Plural
seceri	Second person Singular
închipuia	Third person Singular
reținuserăm	First person Plural
dispui	Second person Singular
staniferul	None
preveniră	Third person Plural
schimba	Third person Singular
pleci	Second person Singular
lățise	Third person Singular
bărbieri	Third person Singular
cărau	Third person Plural
bunicile	None
utilizaserăți	Second person Plural
cocorii	None
sfâșiau	Third person Plural
bârfiseși	Second person Singular
guvernăm	First person Plural
capsulaseși	Second person Singular
silabică	None
învinseși	Second person Singular
pianină	None
zonă	None
înmormântași	Second person Singular
extraseserăți	Second person Plural
omletei	None
dansatorului	None
făptuii	First person Singular
frustrare	None
făcură	Third person Plural
comportași	Second person Singular
insistă	Third person Singular
împărții	First person Singular
dramaticul	None
copia	Third person Singular
lăbărțații	None
împănat	None
ucenicilor	None
tăgăduiești	Second person Singular
urmări	Third person Singular
îngropase	Third person Singular
operațiilor	None
temeați	Second person Plural
orgasmicului	None
avortași	Second person Singular
speriau	Third person Plural
ferecase	Third person Singular
țeseau	Third person Plural
bănuiai	Second person Singular
purtau	Third person Plural
trimiseră	Third person Plural
spălau	Third person Plural
gândiseși	Second person Singular
contrazici	Second person Singular
stimat	None
slugărești	Second person Singular
flutura	Third person Singular
asprele	None
unea	Third person Singular
sfătuim	First person Plural
dobândea	Third person Singular
ilegală	None
storceați	Second person Plural
divorțase	Third person Singular
muzicalilor	None
ceruși	Second person Singular
juraseră	Third person Plural
semnă	Third person Singular
părăsitelor	None
aurorelor	None
isprăvii	First person Singular
fereca	Third person Singular
semivocalei	None
aciuase	Third person Singular
văduvirăți	Second person Plural
arșiță	None
orchestral	None
lătrasem	First person Singular
păduche	Third person Singular
oprire	None
bei	Second person Singular
producerea	None
gnosticism	None
centralei	None
pricepurăm	First person Plural
secundele	None
expediași	Second person Singular
sista	Third person Singular
riscau	Third person Plural
aspirinei	None
decapita	Third person Singular
sucii	First person Singular
continue	None
temuse	Third person Singular
flămânzim	First person Plural
gazară	Third person Plural
calendarele	None
zăpăciși	Second person Singular
înrudiserăm	First person Plural
umbla	Third person Singular
câștigase	Third person Singular
neglijau	Third person Plural
ziceau	Third person Plural
satisfăcut	None
înțelegeai	Second person Singular
tipărea	Third person Singular
uimirăm	First person Plural
inflamabilă	None
micșoraseși	Second person Singular
celebră	Third person Singular
chinului	None
sughițaseși	Second person Singular
târnăcopului	None
împărțiserăm	First person Plural
punctez	First person Singular
secreți	None
distingeau	Third person Plural
așezaserăți	Second person Plural
uscat	None
urmau	Third person Plural
amabilă	None
culcară	Third person Plural
tovărășescul	None
dușmănii	First person Singular
imaginase	Third person Singular
stric	First person Singular
caci	Second person Singular
realul	None
despicăm	First person Plural
liniștirăți	Second person Plural
mirăm	First person Plural
țipau	Third person Plural
împăca	Third person Singular
gândise	Third person Singular
cireșii	None
întrebau	Third person Plural
femininul	None
zbierase	Third person Singular
știind	None
sângerași	Second person Singular
circumcizi	Second person Singular
urla	Third person Singular
uniseră	Third person Plural
slugări	Third person Singular
exterioară	None
canoniserăm	First person Plural
animi	Second person Singular
distingem	First person Plural
sinistră	None
sărbătoriserăm	First person Plural
călcași	Second person Singular
simbolizași	Second person Singular
susurarăți	Second person Plural
înfăinarăți	Second person Plural
dispăreau	Third person Plural
apăsă	Third person Singular
răscoapseseși	Second person Singular
umerii	None
preferau	Third person Plural
zgâriarăți	Second person Plural
bandajele	None
mânecarăm	First person Plural
drăgălași	None
prunului	None
știucă	None
batjocori	Third person Singular
întreb	First person Singular
oprise	Third person Singular
satisfăcurăm	First person Plural
plângem	First person Plural
pripeai	Second person Singular
anihila	Third person Singular
unit	None
creativă	None
ținutul	None
președintelui	None
leg	First person Singular
ședea	Third person Singular
contraziceai	Second person Singular
sexoasele	None
dezbinat	None
soții	None
fripseseși	Second person Singular
transformi	Second person Singular
farfurioara	None
pictaserăți	Second person Plural
cuprinse	Third person Singular
putuse	Third person Singular
săpaseși	Second person Singular
descompuseseși	Second person Singular
cuprins	None
urlași	Second person Singular
căscă	Third person Singular
țineau	Third person Plural
încrucișau	Third person Plural
slabelor	None
funcționase	Third person Singular
scula	Third person Singular
satur	First person Singular
reducea	Third person Singular
stăruia	Third person Singular
așeza	Third person Singular
deprinsese	Third person Singular
urmăriserăm	First person Plural
îmbuc	First person Singular
deșelaserăți	Second person Plural
legănat	None
săgeta	Third person Singular
ciuguli	Third person Singular
sumeseseși	Second person Singular
gazare	None
mărturisiseși	Second person Singular
nejudecată	None
creștem	First person Plural
înjunghiat	None
locuiserăm	First person Plural
opreau	Third person Plural
încercuirăți	Second person Plural
întrebi	Second person Singular
înfrunzeai	Second person Singular
corneea	None
ofili	Third person Singular
muta	Third person Singular
împiedicase	Third person Singular
descheiași	Second person Singular
pregeta	Third person Singular
îngreunaseși	Second person Singular
spaniolul	None
suflecase	Third person Singular
viermuiai	Second person Singular
întrezăriseră	Third person Plural
caniculare	None
aglomerat	None
bețivanule	None
locui	Third person Singular
însoțirăți	Second person Plural
păruisem	First person Singular
stimei	None
îndepărtezi	Second person Singular
înghețatelor	None
întorci	Second person Singular
obosea	Third person Singular
cunoscuta	None
fuseră	Third person Plural
învingea	Third person Singular
grotelor	None
juisasem	First person Singular
chilotul	None
îndura	Third person Singular
auzeau	Third person Plural
distrugi	Second person Singular
înrâureau	Third person Plural
avansaseși	Second person Singular
pornea	Third person Singular
lua	Third person Singular
nebuni	Third person Singular
edificiului	None
loveau	Third person Plural
epocă	None
păci	None
surprindeai	Second person Singular
completa	Third person Singular
împodobi	Third person Singular
bârselor	None
afurisiseși	Second person Singular
aducem	First person Plural
răsărea	Third person Singular
rari	None
fâsele	None
arde	Third person Singular
putrezea	Third person Singular
putuserăm	First person Plural
murmura	Third person Singular
ucisese	Third person Singular
evazivul	None
avânt	First person Singular
vânturi	Second person Singular
înscria	Third person Singular
picase	Third person Singular
neașteptate	None
asprii	None
motoarele	None
lucioși	None
căzură	Third person Plural
mâne	Third person Singular
recupera	Third person Singular
vars	First person Singular
vizităm	First person Plural
perinda	Third person Singular
reprezentanților	None
înspăimânt	First person Singular
hotăra	Third person Singular
însoriseră	Third person Plural
rășină	None
produseseră	Third person Plural
nerușinatei	None
anglicane	None
becului	None
înfundaserăți	Second person Plural
terminase	Third person Singular
cununi	Second person Singular
punctaseși	Second person Singular
înfumurasem	First person Singular
utilele	None
oficială	None
doamna	None
maltezi	None
folosești	Second person Singular
picoloului	None
bârfiră	Third person Plural
odihnisem	First person Singular
scormonise	Third person Singular
produceai	Second person Singular
bucura	Third person Singular
asprime	None
memorizat	None
ocrotiserăți	Second person Plural
stropise	Third person Singular
preoțiseși	Second person Singular
curcanul	None
scornisem	First person Singular
ejacularăți	Second person Plural
acumularăm	First person Plural
ciuguleai	Second person Singular
introducem	First person Plural
greșiserăți	Second person Plural
mărit	First person Singular
sufocară	Third person Plural
desfiraseși	Second person Singular
zbăteai	Second person Singular
mărginind	None
ocupi	Second person Singular
refuz	First person Singular
trăi	Third person Singular
dictaserăți	Second person Plural
răcești	Second person Singular
amintiră	Third person Plural
cumineca	Third person Singular
șchioapă	None
închipuiseși	Second person Singular
identităților	None
răcnea	Third person Singular
spurcată	None
invitase	Third person Singular
împlântase	Third person Singular
creezi	Second person Singular
utilizarăm	First person Plural
planetară	None
onorăm	First person Plural
strâmbi	Second person Singular
ambianței	None
aera	Third person Singular
îmbiaseși	Second person Singular
bestiale	None
înfrățea	Third person Singular
fermierului	None
rămăsese	Third person Singular
scotea	Third person Singular
canadienilor	None
înzestrez	First person Singular
unicul	None
închipuind	None
păros	None
primirii	None
veștejit	None
perjei	None
slugăriserăm	First person Plural
cuprinserăți	Second person Plural
țăcăni	Third person Singular
supuseserăți	Second person Plural
zăcuseși	Second person Singular
răzlețirăm	First person Plural
sucurilor	None
mureau	Third person Plural
speraseră	Third person Plural
câștigăm	First person Plural
însuflețea	Third person Singular
fierbea	Third person Singular
strici	Second person Singular
neprevizibile	None
geamurile	None
îmblânzești	Second person Singular
javrelor	None
înflorisem	First person Singular
găinușa	None
imaginară	Third person Plural
întrezărirăm	First person Plural
pupa	Third person Singular
trecuseră	Third person Plural
lipiserăm	First person Plural
însărcinase	Third person Singular
depăraseră	Third person Plural
salvă	Third person Singular
încercarăm	First person Plural
reduci	Second person Singular
monocrome	None
bag	First person Singular
produsese	Third person Singular
ultimă	None
castraseși	Second person Singular
tinseserăm	First person Plural
stăpâneau	Third person Plural
adâncea	Third person Singular
ura	Third person Singular
tulbura	Third person Singular
vocativelor	None
prinsese	Third person Singular
plimbase	Third person Singular
batjocoriserăți	Second person Plural
roteau	Third person Plural
alungând	None
păcurarului	None
protocolului	None
gândiseră	Third person Plural
vrabiei	None
propuseserăm	First person Plural
înțeparăți	Second person Plural
purifica	Third person Singular
zicem	First person Plural
urcase	Third person Singular
străbătuși	Second person Singular
tăiaseră	Third person Plural
preziseseși	Second person Singular
adversarul	None
făceai	Second person Singular
umbrela	None
răgușise	Third person Singular
sporirăți	Second person Plural
plăcuși	Second person Singular
emoționaserăți	Second person Plural
tăbăcit	None
viermuiau	Third person Plural
tocarăți	Second person Plural
mulțumiseră	Third person Plural
întrebă	Third person Singular
diminua	Third person Singular
veniseși	Second person Singular
vorbiseră	Third person Plural
dezbrăcară	Third person Plural
broaștei	None
meșteai	Second person Singular
reținuse	Third person Singular
descuiaseră	Third person Plural
înierbasem	First person Singular
îndrăznise	Third person Singular
utilizezi	Second person Singular
explicativele	None
invitaseși	Second person Singular
înfășași	Second person Singular
alinta	Third person Singular
izbisem	First person Singular
prezicea	Third person Singular
închisa	None
închegaseși	Second person Singular
anticipările	None
beții	None
săturasem	First person Singular
flămânzeați	Second person Plural
CD-ul	None
anonimitate	None
declarau	Third person Plural
credeau	Third person Plural
supraveghea	Third person Singular
descrisese	Third person Singular
prescriseserăți	Second person Plural
aplec	First person Singular
corcim	First person Plural
interesarăm	First person Plural
degerasem	First person Singular
clarificaseși	Second person Singular
dregeau	Third person Plural
familiilor	None
încercaseră	Third person Plural
înierbă	Third person Singular
băuserăți	Second person Plural
maiestate	None
îndeletniciseși	Second person Singular
încheiași	Second person Singular
dărăceați	Second person Plural
salariatul	None
memorizaseră	Third person Plural
vizualizăm	First person Plural
individului	None
inund	First person Singular
trecuserăți	Second person Plural
ferim	First person Plural
legăm	First person Plural
transparenței	None
îmbulzea	Third person Singular
minuna	Third person Singular
dezvoltau	Third person Plural
înfăptuia	Third person Singular
încetase	Third person Singular
erau	Third person Plural
prinseserăți	Second person Plural
lubrifiasem	First person Singular
tastaturile	None
cimpoaielor	None
scăpătăm	First person Plural
închin	First person Singular
sorbea	Third person Singular
crestat	None
însărcinaserăți	Second person Plural
întrerupeau	Third person Plural
implicăm	First person Plural
gemurăm	First person Plural
decăzuserăți	Second person Plural
afundași	Second person Singular
cernu	Third person Singular
tovărășiei	None
bășici	Second person Singular
fierbeau	Third person Plural
supremii	None
sculau	Third person Plural
înveninez	First person Singular
încânt	First person Singular
vulpe	None
oițele	None
normalitate	None
desprindea	Third person Singular
înfățișarăm	First person Plural
ecranului	None
supraveghearăm	First person Plural
aeroplanelor	None
epoca	None
răsculau	Third person Plural
trăncănise	Third person Singular
îngâni	Second person Singular
umpli	Second person Singular
întăriserăți	Second person Plural
prelungit	None
olimpicului	None
încape	Third person Singular
corceai	Second person Singular
castorului	None
fracturaserăm	First person Plural
băgaseși	Second person Singular
genunchiul	None
producem	First person Plural
rămăseseră	Third person Plural
alga	None
ologului	None
cuveni	Third person Singular
oglindi	Third person Singular
prelungim	First person Plural
ispitiseși	Second person Singular
învioraserăm	First person Plural
adaug	First person Singular
sunarăți	Second person Plural
zărit	None
declinase	Third person Singular
instanta	None
înseninaserăți	Second person Plural
răsuci	Third person Singular
celte	None
măriți	Second person Singular
înțeleptului	None
trandafirul	None
minoritățile	None
mințise	Third person Singular
înnegreau	Third person Plural
cumpărasem	First person Singular
căpătau	Third person Plural
scoatem	First person Plural
donau	Third person Plural
componenta	None
mușca	Third person Singular
obosiră	Third person Plural
pasteuriza	Third person Singular
înnodară	Third person Plural
construise	Third person Singular
studiez	First person Singular
condusese	Third person Singular
vizualizezi	Second person Singular
purtat	None
scobiși	Second person Singular
înconjur	First person Singular
însetezăm	First person Plural
bursucilor	None
alegea	Third person Singular
semnau	Third person Plural
trăda	Third person Singular
focoșii	None
urmașul	None
strâmtasem	First person Singular
servim	First person Plural
justiții	None
desenase	Third person Singular
inteligentei	None
viperele	None
despăducheaserăți	Second person Plural
îmbini	Second person Singular
nucșoară	None
perseverasem	First person Singular
păducelului	None
răspândeai	Second person Singular
credea	Third person Singular
satisfăcând	None
atinsese	Third person Singular
îmbogățim	First person Plural
supuseseră	Third person Plural
împănase	Third person Singular
omorai	Second person Singular
poftit	None
cinstirăm	First person Plural
străvedeau	Third person Plural
donației	None
flexibilități	None
completezi	Second person Singular
privegheau	Third person Plural
echilibrasem	First person Singular
greșești	Second person Singular
zăcură	Third person Plural
câștigaserăți	Second person Plural
datorăm	First person Plural
creierii	None
hrănea	Third person Singular
юбисерэм	First person Plural
lăți	Third person Singular
confruntarăm	First person Plural
locuințelor	None
batjocoreau	Third person Plural
rănești	Second person Singular
arhipelagul	None
legau	Third person Plural
crescuți	None
deplasa	Third person Singular
țeapăn	None
imitarea	None
murim	First person Plural
mătura	Third person Singular
sufletească	None
logodiserăm	First person Plural
coapseseși	Second person Singular
guvernară	Third person Plural
scurgea	Third person Singular
decade	Third person Singular
anterioare	None
rostogolind	None
taurilor	None
văzuseră	Third person Plural
jignești	Second person Singular
propuse	Third person Singular
lovea	Third person Singular
busola	None
înăbușiseră	Third person Plural
bătu	Third person Singular
scormoniseși	Second person Singular
amicule	None
omuleților	None
exageratelor	None
înot	First person Singular
sistarăm	First person Plural
omor	First person Singular
dubla	Third person Singular
aurii	First person Singular
rugă	Third person Singular
scuzăm	First person Plural
încredeau	Third person Plural
lipseai	Second person Singular
scăpaseși	Second person Singular
porțile	None
termina	Third person Singular
porunceai	Second person Singular
veștedul	None
umpluseră	Third person Plural
înscris	None
câștigau	Third person Plural
zăpada	None
îndulcea	Third person Singular
căutarăm	First person Plural
trageai	Second person Singular
animaserăți	Second person Plural
moarta	None
îngreunau	Third person Plural
hotărâse	Third person Singular
sosule	None
ridicarea	None
îmbogățeau	Third person Plural
cununau	Third person Plural
râvniră	Third person Plural
mânecaseră	Third person Plural
lăcrimarăm	First person Plural
săpau	Third person Plural
orchestrele	None
îndeletnicisem	First person Singular
jucaseră	Third person Plural
borăști	Second person Singular
păstrezi	Second person Singular
inutilă	None
chestiunea	None
transcriseși	Second person Singular
chifteaua	None
îndulciseși	Second person Singular
încumetau	Third person Plural
căsătoria	None
biofizica	None
eliberezi	Second person Singular
înviorași	Second person Singular
lăsaseră	Third person Plural
bocești	Second person Singular
terminarăți	Second person Plural
robii	First person Singular
susuraseră	Third person Plural
fălim	First person Plural
scurseși	Second person Singular
arabului	None
interferențele	None
stabilim	First person Plural
ocrotit	None
păstrase	Third person Singular
memorizaseși	Second person Singular
robiserăm	First person Plural
bara	Third person Singular
însorești	Second person Singular
librăriile	None
râm	First person Singular
greșirăți	Second person Plural
satisfăcea	Third person Singular
surprinseseră	Third person Plural
perindă	Third person Singular
strâmtez	First person Singular
centralilor	None
îmbunătățeau	Third person Plural
fundaseră	Third person Plural
spumezi	Second person Singular
lansară	Third person Plural
avantajul	None
recunoaștea	Third person Singular
radem	First person Plural
agricultorilor	None
târgurilor	None
răsfățase	Third person Singular
exportatorii	None
atragea	Third person Singular
scânteia	Third person Singular
încurajez	First person Singular
amfibie	None
încălzea	Third person Singular
îngerul	None
tărăgănez	First person Singular
desfăceau	Third person Plural
delimităm	First person Plural
rescriseseși	Second person Singular
izraeliții	None
zebrele	None
înrădăcinaseși	Second person Singular
merizaseși	Second person Singular
săptămînă	None
dezgroparăți	Second person Plural
excavau	Third person Plural
mânăstirii	None
serviseră	Third person Plural
îndrăzni	Third person Singular
apăsau	Third person Plural
măseserăți	Second person Plural
tunse	Third person Singular
controlez	First person Singular
arsese	Third person Singular
urmă	Third person Singular
jupânii	None
virilității	None
veneai	Second person Singular
simboliza	Third person Singular
aplecarăți	Second person Plural
ușurăm	First person Plural
întăriseră	Third person Plural
înnoptezi	Second person Singular
oglindea	Third person Singular
părăsiră	Third person Plural
despărțise	Third person Singular
persoana	None
concentrat	None
rugea	Third person Singular
binefăcător	None
atingi	Second person Singular
alcătuiai	Second person Singular
mesteca	Third person Singular
salvăm	First person Plural
răsziseși	Second person Singular
răpi	Third person Singular
invizibilele	None
răcirăți	Second person Plural
halucinaserăm	First person Plural
divorțarăți	Second person Plural
injecta	Third person Singular
omenirii	None
așteptau	Third person Plural
italianul	None
arăduce	Third person Singular
paielor	None
furiile	None
dezghețară	Third person Plural
bărbierind	None
rugase	Third person Singular
doinele	None
staniferii	None
frânez	First person Singular
pluteau	Third person Plural
secundare	None
păcălirăm	First person Plural
lăudase	Third person Singular
răbdă	Third person Singular
ipocritul	None
mișcau	Third person Plural
țiparăm	First person Plural
înmormântezi	Second person Singular
masturbaseră	Third person Plural
iscăliserăm	First person Plural
proporționalele	None
cugeta	Third person Singular
mărturiei	None
urâseși	Second person Singular
juca	Third person Singular
tărăgănarăm	First person Plural
scumpa	None
covorul	None
contrazicem	First person Plural
pașca	None
sunaserăți	Second person Plural
apocalipticelor	None
pătrunsese	Third person Singular
deschideau	Third person Plural
pistonule	None
adâncile	None
tatua	Third person Singular
săgeților	None
slăbi	Third person Singular
guralivii	None
rostisem	First person Singular
înceta	Third person Singular
golise	Third person Singular
defăimat	None
sărbătorea	Third person Singular
coborâse	Third person Singular
tehnicienilor	None
maghiar	None
mulțumeau	Third person Plural
problemă	None
râpa	None
verși	Second person Singular
îndeletniciseră	Third person Plural
întâlnea	Third person Singular
stăpânești	Second person Singular
ajutăm	First person Plural
mențineau	Third person Plural
transformau	Third person Plural
perseverară	Third person Plural
induce	Third person Singular
bănuirăți	Second person Plural
porni	Third person Singular
incomplete	None
alunecase	Third person Singular
slujeau	Third person Plural
bacteria	None
intrat	None
dezmințeați	Second person Plural
învecina	Third person Singular
însemnătatea	None
împrumuta	Third person Singular
grabe	None
soției	None
desprinseră	Third person Plural
strâmtaseră	Third person Plural
logodirăm	First person Plural
încetim	First person Plural
tunzi	Second person Singular
săgetarăm	First person Plural
indiferente	None
fumegi	Second person Singular
întâlnii	First person Singular
încălzeai	Second person Singular
visez	First person Singular
auzise	Third person Singular
imputând	None
necontestat	None
ucidere	None
greșiră	Third person Plural
răspândiseră	Third person Plural
distrugeau	Third person Plural
numelui	None
pavaseră	Third person Plural
răneau	Third person Plural
dovedești	Second person Singular
teism	None
desfirară	Third person Plural
atârnară	Third person Plural
ședință	None
lipirăm	First person Plural
denatura	Third person Singular
anihilară	Third person Plural
îmboldirăm	First person Plural
punctă	Third person Singular
surde	None
defăima	Third person Singular
circumciserăm	First person Plural
pisau	Third person Plural
angajăm	First person Plural
seduserăm	First person Plural
ascunsă	None
proteja	Third person Singular
fântâna	None
filantropic	None
înfruntase	Third person Singular
ținteau	Third person Plural
pornografică	None
reintroducând	None
plafonul	None
îngerescul	None
cutremuraseră	Third person Plural
scurmarăm	First person Plural
delăsaserăm	First person Plural
rușina	Third person Singular
afurisisem	First person Singular
alungase	Third person Singular
dorii	First person Singular
jucau	Third person Plural
transparența	None
încălțau	Third person Plural
desziseseră	Third person Plural
înlocuiserăm	First person Plural
așteptaseră	Third person Plural
ții	Second person Singular
sfârtica	Third person Singular
admiraseră	Third person Plural
cutreierat	None
stingea	Third person Singular
stingi	Second person Singular
prăjești	Second person Singular
ținu	Third person Singular
ejaculă	Third person Singular
atrase	Third person Singular
crease	Third person Singular
încadraseși	Second person Singular
separ	First person Singular
întâmpinau	Third person Plural
deda	Third person Singular
porumbeii	None
uliului	None
îngustă	Third person Singular
scade	Third person Singular
complexitate	None
imprima	Third person Singular
tinzi	Second person Singular
voiosul	None
pitorească	None
profesionalismul	None
șopârlelor	None
inundasem	First person Singular
descrescut	None
profesoară	None
spatelui	None
răzlețeați	Second person Plural
soma	Third person Singular
informatică	None
înmulțeau	Third person Plural
căpușă	None
îmbărbătaserăm	First person Plural
grosimii	None
salutăm	First person Plural
ouălor	None
aplecat	None
sfeclise	Third person Singular
conjugat	None
răpeau	Third person Plural
deziserăm	First person Plural
ciocnii	First person Singular
mângâiaserăm	First person Plural
vărsa	Third person Singular
umilit	None
spăla	Third person Singular
mirările	None
benzina	None
angajasem	First person Singular
terminaseră	Third person Plural
pătat	None
lanterna	None
existași	Second person Singular
scoseseră	Third person Plural
înzestrăm	First person Plural
urechea	None
activezi	Second person Singular
ascunse	Third person Singular
învingem	First person Plural
delirurilor	None
șterserăm	First person Plural
extrasesem	First person Singular
trăia	Third person Singular
ocaua	None
căzu	Third person Singular
înfundasem	First person Singular
combina	Third person Singular
umbroși	None
holbaserăm	First person Plural
deciseseră	Third person Plural
caracterule	None
plimba	Third person Singular
simplilor	None
animaserăm	First person Plural
pierdut	None
halucinez	First person Singular
înmormântaserăți	Second person Plural
vomu	Third person Singular
încăleca	Third person Singular
apărusem	First person Singular
obezele	None
semnez	First person Singular
corcea	Third person Singular
locuiseră	Third person Plural
orezărie	None
vitregi	None
delogase	Third person Singular
inelarului	None
enorme	None
uscaserăți	Second person Plural
probezi	Second person Singular
supăr	First person Singular
închisei	First person Singular
întrebase	Third person Singular
tridimensional	None
împărțeați	Second person Plural
forjăm	First person Plural
achiziționările	None
turturea	None
deschisese	Third person Singular
întreprinzi	Second person Singular
vărsași	Second person Singular
pupară	Third person Plural
surprinsesem	First person Singular
bătuserăm	First person Plural
dezgustaseră	Third person Plural
ipocritului	None
trânteai	Second person Singular
lămurești	Second person Singular
încumeta	Third person Singular
risipisem	First person Singular
gâscanul	None
mofturile	None
introduci	Second person Singular
desfășarăm	First person Plural
îmbogățiși	Second person Singular
nădăjduiai	Second person Singular
învăluraseră	Third person Plural
glumești	Second person Singular
alotropică	None
înjugarăm	First person Plural
interesase	Third person Singular
mangusta	None
creștinii	None
împungeați	Second person Plural
deschizi	Second person Singular
finisaserăm	First person Plural
zburară	Third person Plural
cântărise	Third person Singular
nocturnii	None
desculțaseră	Third person Plural
politizare	None
veșnicia	None
plantaseră	Third person Plural
deciseră	Third person Plural
donase	Third person Singular
lătraseși	Second person Singular
călcau	Third person Plural
răscoli	Second person Singular
săraților	None
ciocneai	Second person Singular
răsturna	Third person Singular
înfometa	Third person Singular
aritmetica	None
erelor	None
șoptit	None
clădise	Third person Singular
încuraja	Third person Singular
domniile	None
tulburi	Second person Singular
desenară	Third person Plural
mângâiași	Second person Singular
preoțit	None
asimilarăm	First person Plural
atomului	None
meriți	Second person Singular
alunelul	None
însenină	Third person Singular
pici	Second person Singular
vlăgui	Third person Singular
ceruseși	Second person Singular
limpezi	Third person Singular
nevăzută	None
asistați	None
visară	Third person Plural
cumpăniseși	Second person Singular
împrumutau	Third person Plural
petrecură	Third person Plural
cufundăm	First person Plural
lăsarăți	Second person Plural
avântarăți	Second person Plural
ațâța	Third person Singular
planetare	None
arterei	None
sinonimul	None
sunasem	First person Singular
exotic	None
netezeai	Second person Singular
dezuniră	Third person Plural
murii	First person Singular
castrase	Third person Singular
posteritatea	None
criminalului	None
închipuiră	Third person Plural
pățisem	First person Singular
plutirăm	First person Plural
putu	Third person Singular
dezvoltase	Third person Singular
injectaserăți	Second person Plural
înghesuiau	Third person Plural
întâmpinând	None
lăsă	Third person Singular
arhipelagurile	None
fluturași	Second person Singular
arătară	Third person Plural
pute	Third person Singular
pătrundea	Third person Singular
adormit	None
turbau	Third person Plural
scald	First person Singular
sfatul	None
hibernase	Third person Singular
cercetarăți	Second person Plural
slujea	Third person Singular
înseraseră	Third person Plural
integrală	None
turtit	None
comand	First person Singular
pățeați	Second person Plural
tăgăduim	First person Plural
sărut	First person Singular
pantalonilor	None
desculțau	Third person Plural
supus	None
înfruntarăm	First person Plural
exteriorul	None
vedeai	Second person Singular
cioplii	First person Singular
înlăturaserăți	Second person Plural
pietrosului	None
înjosi	Third person Singular
căzuse	Third person Singular
dezrobirăm	First person Plural
amintești	Second person Singular
abceselor	None
regaliștilor	None
ulcerule	None
bășicaserăm	First person Plural
curcubeul	None
terminând	None
declarase	Third person Singular
tindea	Third person Singular
tehnologie	None
secerăm	First person Plural
flutur	First person Singular
compleților	None
turba	Third person Singular
primilor	None
traversase	Third person Singular
udau	Third person Plural
tocii	First person Singular
măreața	None
pitorești	None
ferec	First person Singular
compusesem	First person Singular
ascundem	First person Plural
declinat	None
văzuserăm	First person Plural
ciopleau	Third person Plural
aerisit	None
convinseși	Second person Singular
risipi	Third person Singular
ferestruise	Third person Singular
urc	First person Singular
desculțasem	First person Singular
desfaci	Second person Singular
acuzau	Third person Plural
futeați	Second person Plural
înțelesese	Third person Singular
surprizele	None
era	Third person Singular
pieptului	None
ascultarăți	Second person Plural
avortaseră	Third person Plural
loga	Third person Singular
strecura	Third person Singular
umblu	First person Singular
scurtat	None
gătea	Third person Singular
sparse	Third person Singular
recunoscuse	Third person Singular
aerisirăți	Second person Plural
binecuvântând	None
abandona	Third person Singular
amorurile	None
suna	Third person Singular
tăgăduiau	Third person Plural
mândreai	Second person Singular
răsturnaserăți	Second person Plural
deveneați	Second person Plural
exemplele	None
artisticii	None
impuseseră	Third person Plural
omniprezenți	None
orientării	None
lucrezi	Second person Singular
plecat	None
tentaserăm	First person Plural
răsculaserăți	Second person Plural
desprinsese	Third person Singular
sfâșiaseși	Second person Singular
dispari	Second person Singular
scormoniseră	Third person Plural
centrale	None
îmbunătățirilor	None
prostiseși	Second person Singular
mucoase	None
prezisese	Third person Singular
relua	Third person Singular
sfârșise	Third person Singular
cutia	None
accelerațiile	None
hrăniși	Second person Singular
codobaturii	None
însărcinaserăm	First person Plural
graniță	None
seducțiilor	None
închega	Third person Singular
lipise	Third person Singular
descopăr	First person Singular
plăcuserăm	First person Plural
înrămarăți	Second person Plural
chimicului	None
june	None
oftară	Third person Plural
iernau	Third person Plural
legi	Second person Singular
umpluseși	Second person Singular
aninilor	None
venera	Third person Singular
ofilii	First person Singular
înghețasem	First person Singular
îndeletnicea	Third person Singular
protejez	First person Singular
destupi	Second person Singular
dezmăț	First person Singular
flămânzeai	Second person Singular
întristă	Third person Singular
judecată	None
cioplești	Second person Singular
mărturisirăți	Second person Plural
scăldași	Second person Singular
întortoche	Third person Singular
azvârliră	Third person Plural
păstrăm	First person Plural
desmățau	Third person Plural
trezirile	None
anihilau	Third person Plural
domesticirii	None
dărâmară	Third person Plural
mințirăm	First person Plural
estimaseră	Third person Plural
purificat	None
inundaseră	Third person Plural
răstignea	Third person Singular
împrejur	First person Singular
sperau	Third person Plural
ecranul	None
călcase	Third person Singular
nufărule	None
unești	Second person Singular
naivilor	None
tăiau	Third person Plural
numeai	Second person Singular
clătinaseră	Third person Plural
stratul	None
moftului	None
pictată	None
depusesem	First person Singular
trăisem	First person Singular
oblig	First person Singular
creaseră	Third person Plural
nominativul	None
descălțară	Third person Plural
nuiaua	None
ridicata	None
activasem	First person Singular
plictisi	Third person Singular
făuriserăți	Second person Plural
religiilor	None
vizitând	None
nucile	None
vizitaserăm	First person Plural
interesau	Third person Plural
dospiși	Second person Singular
râdem	First person Plural
socializaseră	Third person Plural
cutreierau	Third person Plural
felurilor	None
exportatorului	None
crezuseși	Second person Singular
fuseseră	Third person Plural
trezești	Second person Singular
răcoriserăți	Second person Plural
despăduririlor	None
oglinzilor	None
adăpăm	First person Plural
aleile	None
jena	Third person Singular
fierbinții	None
aciuat	None
canonise	Third person Singular
intervine	Third person Singular
pornise	Third person Singular
încheiaseră	Third person Plural
îndrăgostești	Second person Singular
aspru	None
ocrotiseși	Second person Singular
cotiserăm	First person Plural
încerc	First person Singular
împaci	Second person Singular
sunase	Third person Singular
păduchele	None
cuvenit	None
frasinului	None
înnoi	Third person Singular
oratorul	None
scădeați	Second person Plural
treceau	Third person Plural
înrudea	Third person Singular
plânse	Third person Singular
așeză	Third person Singular
deprinzi	Second person Singular
leoparzii	None
returnași	Second person Singular
frunza	None
înrămarăm	First person Plural
contribuțiilor	None
descurcăreț	None
izbea	Third person Singular
dejugau	Third person Plural
electromagnetica	None
spulberaseră	Third person Plural
viermuiși	Second person Singular
zdrobirăți	Second person Plural
unii	First person Singular
donaseși	Second person Singular
rămâneau	Third person Plural
ador	First person Singular
lărgi	Third person Singular
pofticioaselor	None
utilizase	Third person Singular
bază	Third person Singular
asudași	Second person Singular
îmbătasem	First person Singular
șerbești	Second person Singular
furcelei	None
făinos	None
fuseși	Second person Singular
lucrară	Third person Plural
zburăm	First person Plural
purtase	Third person Singular
deprinse	Third person Singular
număr	First person Singular
închiserăți	Second person Plural
fluiera	Third person Singular
mâzgălirăm	First person Plural
înșirând	None
aliații	None
strecuraserăți	Second person Plural
musturilor	None
încurci	Second person Singular
slăvit	None
enologului	None
citeau	Third person Plural
planta	Third person Singular
păruirăți	Second person Plural
împăunară	Third person Plural
rescrii	Second person Singular
deranjasem	First person Singular
aerez	First person Singular
uzi	Second person Singular
cooperași	Second person Singular
găurii	First person Singular
descrii	Second person Singular
prospătăm	First person Plural
suedezului	None
asemănă	Third person Singular
angajarăm	First person Plural
dezvățarăți	Second person Plural
păruim	First person Plural
urmase	Third person Singular
verișoara	None
sărbătorim	First person Plural
pedepsiseră	Third person Plural
ospătăriță	None
terminațiile	None
mărturisise	Third person Singular
cade	Third person Singular
sfintelor	None
răszis	None
înlocuiau	Third person Plural
dezice	Third person Singular
polare	None
ari	Second person Singular
cuveneați	Second person Plural
învolții	None
societăților	None
scriseseră	Third person Plural
acvilă	None
lichidității	None
citisem	First person Singular
merizaserăți	Second person Plural
satisfăceau	Third person Plural
băgase	Third person Singular
cules	None
юбирэ	Third person Plural
auziseră	Third person Plural
traversat	None
supraviețuiseră	Third person Plural
remușcare	None
macabrului	None
alungat	None
făgădui	Third person Singular
gustase	Third person Singular
îngheț	First person Singular
imunologie	None
radiourile	None
stanei	None
poalei	None
acoperim	First person Plural
treierarăți	Second person Plural
distilaserăm	First person Plural
săpară	Third person Plural
îmbuiba	Third person Singular
comunicau	Third person Plural
înmormânta	Third person Singular
taifunurilor	None
dezghețarăm	First person Plural
motoarelor	None
serbară	Third person Plural
cumpăra	Third person Singular
schizofrenia	None
invadase	Third person Singular
spusese	Third person Singular
săriturilor	None
urmaseră	Third person Plural
plutiră	Third person Plural
fii	Second person Singular
înscrisese	Third person Singular
fluierase	Third person Singular
înmulțea	Third person Singular
ciopleai	Second person Singular
instantei	None
deplasaserăți	Second person Plural
teoricelor	None
ospătau	Third person Plural
conții	Second person Singular
arboricultorului	None
visau	Third person Plural
aurirăm	First person Plural
distinse	Third person Singular
vioiciunea	None
ucidea	Third person Singular
ciopli	Third person Singular
stăruise	Third person Singular
desena	Third person Singular
întreținu	Third person Singular
tenta	Third person Singular
președintele	None
parca	Third person Singular
viril	None
eliberaseși	Second person Singular
dispunem	First person Plural
vlăguiră	Third person Plural
heterosexualitate	None
constrângeai	Second person Singular
bagi	Second person Singular
bancnotei	None
muriseră	Third person Plural
lătraserăm	First person Plural
tundeau	Third person Plural
lăsata	None
artelor	None
preferarăți	Second person Plural
urzești	Second person Singular
terminațiilor	None
ridica	Third person Singular
integrabilele	None
gravitară	Third person Plural
încuiaseră	Third person Plural
orienta	Third person Singular
credeai	Second person Singular
dureros	None
insistăm	First person Plural
scormonirăm	First person Plural
descuiară	Third person Plural
cotidiana	None
lepezi	Second person Singular
cină	Third person Singular
coreenilor	None
amica	None
comunicași	Second person Singular
înțeleseseră	Third person Plural
cooperând	None
îmbărbătasem	First person Singular
nisipul	None
răbdăm	First person Plural
cântăm	First person Plural
întoarserăți	Second person Plural
lăsăm	First person Plural
muri	Third person Singular
diminuezi	Second person Singular
aducând	None
căpătat	None
leșinaseși	Second person Singular
supărau	Third person Plural
prăsise	Third person Singular
desfătăm	First person Plural
lovi	Third person Singular
arogante	None
dezavantajasem	First person Singular
aluneca	Third person Singular
cuminecaserăm	First person Plural
trântiși	Second person Singular
înmulțim	First person Plural
produceau	Third person Plural
aduna	Third person Singular
excavă	Third person Singular
rezista	Third person Singular
pedepsi	Third person Singular
decapitau	Third person Plural
stafidele	None
porno	None
crezuseră	Third person Plural
judecatelor	None
spânzuraserăm	First person Plural
vătăma	Third person Singular
iritași	Second person Singular
dezrobeau	Third person Plural
îngreunăm	First person Plural
Bucovină	None
inimoase	None
circula	Third person Singular
cântăriseși	Second person Singular
ziceai	Second person Singular
apropiară	Third person Plural
stadioanelor	None
prezise	Third person Singular
rugii	First person Singular
întemeiaseră	Third person Plural
fuge	Third person Singular
păcăleai	Second person Singular
convinsei	First person Singular
mărinimoasele	None
intuii	First person Singular
cuvenisem	First person Singular
întindem	First person Plural
prânzise	Third person Singular
balconului	None
fluturasem	First person Singular
pier	First person Singular
rotunzilor	None
lătrând	None
îmbin	First person Singular
închideau	Third person Plural
păcatelor	None
sfecliră	Third person Plural
ierbos	None
împodobim	First person Plural
îndulceați	Second person Plural
bănuii	First person Singular
curgea	Third person Singular
stabilești	Second person Singular
comunicând	None
gălbinare	None
nădăjduim	First person Plural
căutaserăm	First person Plural
ești	Second person Singular
cumpăneai	Second person Singular
nepopularul	None
cucerești	Second person Singular
neapărat	None
acoperirăm	First person Plural
caști	Second person Singular
urmării	First person Singular
susținusem	First person Singular
stătu	Third person Singular
clăti	Third person Singular
cerca	Third person Singular
loviră	Third person Plural
însufleți	Third person Singular
ros	None
veniserăm	First person Plural
semințele	None
îngrămădise	Third person Singular
auzule	None
salinizarăți	Second person Plural
înveninarăți	Second person Plural
înșeli	Second person Singular
râvniserăm	First person Plural
calitatea	None
omeniei	None
simțisem	First person Singular
halucinația	None
răzgândim	First person Plural
vărsă	Third person Singular
ascunselor	None
diminuăm	First person Plural
conformitatea	None
purceilor	None
holbară	Third person Plural
paraliticilor	None
fluierasem	First person Singular
ar	First person Singular
libelulele	None
mâhnirăți	Second person Plural
budismul	None
atlantice	None
contenit	None
veșteji	Third person Singular
lărgit	None
influența	Third person Singular
cumințiserăm	First person Plural
dezlipi	Third person Singular
senzualității	None
buzelor	None
imprimarăți	Second person Plural
comporți	Second person Singular
pasteurizase	Third person Singular
desprinserăți	Second person Plural
sărezi	Second person Singular
obosești	Second person Singular
înlocuii	First person Singular
zburase	Third person Singular
cunoști	Second person Singular
săltăm	First person Plural
surpase	Third person Singular
aminteau	Third person Plural
suptului	None
scumpi	Third person Singular
adăpă	Third person Singular
nuielelor	None
extindea	Third person Singular
elimina	Third person Singular
umbroșilor	None
tuna	Third person Singular
nivelaseră	Third person Plural
blestema	Third person Singular
mulțumirăți	Second person Plural
socotea	Third person Singular
înrămaserăți	Second person Plural
deschise	Third person Singular
fărâmaseră	Third person Plural
rugași	Second person Singular
comandăm	First person Plural
încurca	Third person Singular
constătură	Third person Plural
spăl	First person Singular
stabiliseși	Second person Singular
scriserăți	Second person Plural
reîmpădurire	None
vântur	First person Singular
alerg	First person Singular
încălțaseși	Second person Singular
bărbătești	None
cerni	Second person Singular
pușcărie	None
găsiși	Second person Singular
urmărești	Second person Singular
frigea	Third person Singular
scufunda	Third person Singular
sfâșiarăți	Second person Plural
logodise	Third person Singular
adusese	Third person Singular
arbuștii	None
mănânci	Second person Singular
belșugului	None
hotărî	Third person Singular
merizarăți	Second person Plural
citi	Third person Singular
iubeau	Third person Plural
urci	Second person Singular
presupuseseră	Third person Plural
răsării	First person Singular
invincibilii	None
șuierași	Second person Singular
săgetăm	First person Plural
olimpica	None
scurmi	Second person Singular
puternicele	None
culeserăți	Second person Plural
sfătuirăți	Second person Plural
curmalul	None
prostești	Second person Singular
ofticarăm	First person Plural
gazelei	None
fulgeraseră	Third person Plural
foamete	None
uităm	First person Plural
terțului	None
молдовенескул	None
generațiile	None
urcării	None
portocalii	None
pasarăți	Second person Plural
lărgiseși	Second person Singular
licărirăți	Second person Plural
configurării	None
zbiera	Third person Singular
băgau	Third person Plural
nutrea	Third person Singular
înfometase	Third person Singular
îngălbeneai	Second person Singular
plina	None
lucii	First person Singular
înghițeau	Third person Plural
emeritele	None
stângi	None
pilotau	Third person Plural
adoptaseși	Second person Singular
tăbăcirăți	Second person Plural
interzicând	None
rodeau	Third person Plural
mândrea	Third person Singular
ofticași	Second person Singular
văzurăm	First person Plural
argilosul	None
moștenise	Third person Singular
cosmica	None
făcuse	Third person Singular
numărat	None
guguștiucul	None
zburat	None
fermei	None
decădere	None
intui	Third person Singular
ciclostomule	None
bănuise	Third person Singular
deschidea	Third person Singular
sărași	Second person Singular
podișului	None
îndrăznea	Third person Singular
intuirăți	Second person Plural
cert	First person Singular
scurtez	First person Singular
răsturnăm	First person Plural
coteau	Third person Plural
făcut	None
legăturile	None
rabzi	Second person Singular
dobândi	Third person Singular
juri	Second person Singular
dormitorului	None
mânerelor	None
scăpase	Third person Singular
riscăm	First person Plural
scăzurăm	First person Plural
tărăgănași	Second person Singular
îmbinau	Third person Plural
tivea	Third person Singular
cufuriseră	Third person Plural
magazinele	None
sporii	First person Singular
jignise	Third person Singular
cadourilor	None
grotă	None
cernuseră	Third person Plural
ciuguleau	Third person Plural
îngropau	Third person Plural
vizitase	Third person Singular
ștersesem	First person Singular
puțeați	Second person Plural
înfloreau	Third person Plural
holbaseră	Third person Plural
jurasem	First person Singular
miroseau	Third person Plural
pragurilor	None
separa	Third person Singular
cosmic	None
înfrățit	None
spuseră	Third person Plural
șopârlele	None
cumpătăm	First person Plural
delicat	None
blestemară	Third person Plural
cerșeau	Third person Plural
trimiteau	Third person Plural
tresărisem	First person Singular
bară	Third person Singular
prăseau	Third person Plural
tărăgăna	Third person Singular
mâneci	Second person Singular
obez	None
pocnisem	First person Singular
decidem	First person Plural
aplaudi	Second person Singular
ariciul	None
gospodare	None
răsunau	Third person Plural
servule	None
influențau	Third person Plural
destramaseră	Third person Plural
încălzeau	Third person Plural
persanului	None
spovedirăți	Second person Plural
criminalul	None
zburdară	Third person Plural
mescurăm	First person Plural
vânduse	Third person Singular
bucuraserăți	Second person Plural
torceau	Third person Plural
insistaseră	Third person Plural
bulbuc	First person Singular
curăturile	None
mioriței	None
seduseserăm	First person Plural
țintești	Second person Singular
vindea	Third person Singular
ieșea	Third person Singular
îngrijiși	Second person Singular
străbătut	None
pricepurăți	Second person Plural
învecheau	Third person Plural
îngustul	None
blochez	First person Singular
scăpăm	First person Plural
canoniră	Third person Plural
alergasem	First person Singular
încărunțeați	Second person Plural
gâdilasem	First person Singular
agățaseși	Second person Singular
silaba	None
deismului	None
degerară	Third person Plural
silabici	None
amuțiseși	Second person Singular
faci	Second person Singular
grea	None
făptui	Third person Singular
mangustelor	None
păstraseră	Third person Plural
stindardului	None
încercui	Third person Singular
vesele	None
adăugăm	First person Plural
spumă	Third person Singular
unduiai	Second person Singular
culcase	Third person Singular
rabinilor	None
tavanele	None
înlocuiești	Second person Singular
comunica	Third person Singular
vapoarelor	None
diriguiseră	Third person Plural
deșteptat	None
scrisesem	First person Singular
produce	Third person Singular
modific	First person Singular
închegă	Third person Singular
tânjeați	Second person Plural
alungau	Third person Plural
prăsiră	Third person Plural
ocupase	Third person Singular
ursoaica	None
poți	Second person Singular
întreprinse	Third person Singular
lăbărțaților	None
ospătarului	None
joci	Second person Singular
semnaseră	Third person Plural
îngustau	Third person Plural
muncești	Second person Singular
luaseră	Third person Plural
rechinului	None
aplauda	Third person Singular
activară	Third person Plural
mângâia	Third person Singular
uimiră	Third person Plural
nemiloși	None
cuminți	Third person Singular
arma	None
eternității	None
gaura	None
catargele	None
omorârăți	Second person Plural
aplici	Second person Singular
capeți	Second person Singular
învolburară	Third person Plural
scurm	First person Singular
descurcarăm	First person Plural
eliberăm	First person Plural
hotărăști	Second person Singular
înnoiseși	Second person Singular
traduseseși	Second person Singular
încurajase	Third person Singular
vocativule	None
cămilelor	None
oblic	None
zgâriaseși	Second person Singular
lăsași	Second person Singular
lucrăm	First person Plural
bucurăm	First person Plural
dușmăneau	Third person Plural
folosise	Third person Singular
extrase	Third person Singular
întemeiau	Third person Plural
tânjiserăm	First person Plural
lesbienilor	None
discursurilor	None
desenau	Third person Plural
amuzăm	First person Plural
pilota	Third person Singular
uimise	Third person Singular
încercuiseră	Third person Plural
neutrii	None
îndrăznești	Second person Singular
băiețelului	None
benzinărie	None
neguța	Third person Singular
prăpădi	Third person Singular
afunda	Third person Singular
bondarule	None
zgăurasem	First person Singular
reținem	First person Plural
învelii	First person Singular
lampă	None
sugrumase	Third person Singular
înlocui	Third person Singular
împungea	Third person Singular
emoționăm	First person Plural
scarpini	Second person Singular
rădăcină	None
lăsa	Third person Singular
păcurii	None
lucirăm	First person Plural
construisem	First person Singular
centrul	None
frământași	Second person Singular
zgâiau	Third person Plural
curățase	Third person Singular
apui	Second person Singular
împreunaseră	Third person Plural
odihneau	Third person Plural
zicea	Third person Singular
uraganule	None
cartofii	None
stabilii	First person Singular
combinau	Third person Plural
jupuirăți	Second person Plural
trimiseși	Second person Singular
bufnițele	None
făceați	Second person Plural
cadavrului	None
răniseră	Third person Plural
însetezaseră	Third person Plural
mânecăm	First person Plural
fundași	Second person Singular
alcătui	Third person Singular
golești	Second person Singular
întrebăm	First person Plural
violului	None
umidități	None
răbojind	None
avansau	Third person Plural
arborelui	None
suveran	None
urcaseră	Third person Plural
onestul	None
coiotul	None
capitularăm	First person Plural
observi	Second person Singular
scăldau	Third person Plural
talciocului	None
vindecau	Third person Plural
înfăptuiau	Third person Plural
mârcedelor	None
binecuvântez	First person Singular
rugând	None
comunicase	Third person Singular
împliniserăți	Second person Plural
universităților	None
număra	Third person Singular
sapiență	None
tăieturilor	None
mișcarăți	Second person Plural
eliberez	First person Singular
zbârliseși	Second person Singular
udară	Third person Plural
atrocitățile	None
undiță	None
scularăm	First person Plural
aerasem	First person Singular
apleca	Third person Singular
dizolvaserăți	Second person Plural
safirului	None
furnicăm	First person Plural
reciprocitatea	None
mărunțiserăm	First person Plural
înconjurau	Third person Plural
înverzirăm	First person Plural
pricepea	Third person Singular
dezrădăcina	Third person Singular
muncise	Third person Singular
ascultași	Second person Singular
amintim	First person Plural
lipsi	Third person Singular
omorau	Third person Plural
halucinarăți	Second person Plural
dezmântară	Third person Plural
înlăturase	Third person Singular
scufundași	Second person Singular
cântăreau	Third person Plural
încăreați	Second person Plural
furnicaseși	Second person Singular
lipești	Second person Singular
instantele	None
stea	None
muriserăți	Second person Plural
priveghez	First person Singular
strămutat	None
chitara	None
mica	None
plantau	Third person Plural
scriai	Second person Singular
vizibilii	None
harfa	None
varule	None
prezice	Third person Singular
constrângi	Second person Singular
rescrisesem	First person Singular
subție	Third person Singular
dispăruserăm	First person Plural
frontierei	None
adulmecarăți	Second person Plural
mâncase	Third person Singular
asurziră	Third person Plural
amețiserăți	Second person Plural
înjunghiarăți	Second person Plural
acoperea	Third person Singular
potrivea	Third person Singular
gust	First person Singular
enormului	None
refuzarăm	First person Plural
legendarii	None
răpuseseră	Third person Plural
scorniși	Second person Singular
vindem	First person Plural
uitaseră	Third person Plural
născu	Third person Singular
veninul	None
măslinii	None
despunem	First person Plural
purta	Third person Singular
testicularele	None
posibilitatea	None
lăcrimaserăm	First person Plural
biotiturilor	None
cuști	Second person Singular
ironiilor	None
înscriseși	Second person Singular
iluzoriii	None
dezmeticea	Third person Singular
anusul	None
destinații	None
plătiserăm	First person Plural
funcționară	Third person Plural
răpuseși	Second person Singular
risca	Third person Singular
aducea	Third person Singular
urbanizau	Third person Plural
crea	Third person Singular
răpiserăm	First person Plural
părăsi	Third person Singular
suiai	Second person Singular
preistoria	None
convino	Second person Singular
dezamăgite	None
furnica	Third person Singular
găsiră	Third person Plural
dărapeni	Second person Singular
viteazul	None
modificarăți	Second person Plural
bizonii	None
diminuării	None
prânziși	Second person Singular
garoafei	None
mândrim	First person Plural
îngropăm	First person Plural
spălă	Third person Singular
depui	Second person Singular
gaza	Third person Singular
încăriși	Second person Singular
ponegreați	Second person Plural
împănaseră	Third person Plural
guvernau	Third person Plural
ajut	First person Singular
aburului	None
murmurasem	First person Singular
implici	Second person Singular
minunarăți	Second person Plural
arunca	Third person Singular
coci	Second person Singular
aprinse	Third person Singular
luând	None
pluti	Third person Singular
probară	Third person Plural
creau	Third person Plural
păru	Third person Singular
interveni	Third person Singular
discuta	Third person Singular
aprinsului	None
aiurezi	Second person Singular
încrezusem	First person Singular
rosteai	Second person Singular
învecină	Third person Singular
farmecelor	None
diastolicei	None
imperiali	None
prăbușiseși	Second person Singular
iei	Second person Singular
cuprindeau	Third person Plural
masturbaserăm	First person Plural
răsfiraseși	Second person Singular
orbim	First person Plural
ajuta	Third person Singular
dorea	Third person Singular
biclelor	None
ținurăm	First person Plural
fazi	None
pacientă	None
distruserăm	First person Plural
scoți	Second person Singular
forja	Third person Singular
critic	None
întortocheau	Third person Plural
ieșisem	First person Singular
reduserăm	First person Plural
discordiei	None
solstițiul	None
instant	None
prăjim	First person Plural
cosmicei	None
hotărâm	First person Plural
rămase	Third person Singular
intenționau	Third person Plural
frânăm	First person Plural
sfeșnicele	None
învechiseră	Third person Plural
ostilitățile	None
dizolva	Third person Singular
recunoscuseră	Third person Plural
intervenea	Third person Singular
criticabilul	None
încântase	Third person Singular
interferențelor	None
bănui	Third person Singular
socotind	None
stânjeniserăți	Second person Plural
isprăveai	Second person Singular
iobagii	None
aerisi	Third person Singular
fluturaseră	Third person Plural
amestecarăți	Second person Plural
mulse	Third person Singular
bobocii	None
cioplisem	First person Singular
încurcăm	First person Plural
înnegreai	Second person Singular
desișul	None
submarinule	None
ascuțeai	Second person Singular
plimbi	Second person Singular
picară	Third person Plural
sării	First person Singular
venim	First person Plural
holbarăți	Second person Plural
unduirăm	First person Plural
merit	First person Singular
dori	Third person Singular
înnopta	Third person Singular
turnaseși	Second person Singular
dezvoltaserăți	Second person Plural
scriitorul	None
alunecasem	First person Singular
sfârși	Third person Singular
filmelor	None
tulburase	Third person Singular
cerea	Third person Singular
alăptase	Third person Singular
proprietăților	None
razi	Second person Singular
măruntă	None
intervenim	First person Plural
lărgiră	Third person Plural
borî	Third person Singular
simțeai	Second person Singular
îmbrăcau	Third person Plural
proba	Third person Singular
sorbim	First person Plural
bârfii	First person Singular
dezmetici	Third person Singular
răpea	Third person Singular
înghițisem	First person Singular
presupusei	First person Singular
depănase	Third person Singular
cunoașterii	None
stăpâniseră	Third person Plural
pedepsele	None
murirăm	First person Plural
declinasem	First person Singular
despărțiseră	Third person Plural
vidrei	None
salivă	None
turiștii	None
curse	Third person Singular
izgonisem	First person Singular
aștepta	Third person Singular
masculinele	None
plăcui	First person Singular
închiseră	Third person Plural
pripim	First person Plural
evlavioasa	None
închipuiești	Second person Singular
urzise	Third person Singular
otrăvise	Third person Singular
împinseși	Second person Singular
arând	None
presupuneau	Third person Plural
împreunarăm	First person Plural
aninase	Third person Singular
scalzi	Second person Singular
atotputernica	None
înverșună	Third person Singular
apucaseră	Third person Plural
mișcași	Second person Singular
exagerăm	First person Plural
turb	First person Singular
mătaniei	None
rupseseră	Third person Plural
butonului	None
lumile	None
mișunaseși	Second person Singular
serbat	None
ameții	First person Singular
scufundaseră	Third person Plural
puteau	Third person Plural
trenule	None
ascundeau	Third person Plural
păreai	Second person Singular
transcrii	Second person Singular
știuse	Third person Singular
fulger	First person Singular
exista	Third person Singular
betonul	None
asigur	First person Singular
spumeg	First person Singular
șuieraseși	Second person Singular
împărau	Third person Plural
spuserăți	Second person Plural
ocrotise	Third person Singular
veniră	Third person Plural
văduviseși	Second person Singular
studiat	None
fixaserăți	Second person Plural
intraserăți	Second person Plural
scurtăm	First person Plural
intrau	Third person Plural
artistici	None
vădiserăți	Second person Plural
tăceai	Second person Singular
introduse	Third person Singular
dimineață	None
stăruiai	Second person Singular
isprăvisem	First person Singular
urdinaseră	Third person Plural
neguroasele	None
repauzând	None
văzuse	Third person Singular
folosiseră	Third person Plural
propunea	Third person Singular
strecurară	Third person Plural
desfăcuserăm	First person Plural
distingea	Third person Singular
întâmpin	First person Singular
astâmpăra	Third person Singular
cinstim	First person Plural
ciocni	Third person Singular
pasase	Third person Singular
cronologiei	None
apăsa	Third person Singular
muncilor	None
surdului	None
logodirăți	Second person Plural
preajma	None
bisericoasa	None
spulbera	Third person Singular
greceștii	None
amărâse	Third person Singular
începeau	Third person Plural
micșora	Third person Singular
anini	Second person Singular
uita	Third person Singular
încadrez	First person Singular
amuzarăți	Second person Plural
castravete	None
reînnoiși	Second person Singular
incompleți	None
scufundau	Third person Plural
caisele	None
bunicul	None
încăperilor	None
cuget	First person Singular
doinei	None
curățarăm	First person Plural
lungești	Second person Singular
vânau	Third person Plural
scăpasem	First person Singular
felația	None
clădea	Third person Singular
cobora	Third person Singular
negustorul	None
iobagilor	None
măseaua	None
pierise	Third person Singular
înnoirăți	Second person Plural
stingherea	Third person Singular
reduseserăm	First person Plural
îmbunătății	First person Singular
lincșii	None
combinași	Second person Singular
defăimase	Third person Singular
construi	Third person Singular
vânjoasa	None
îmblânzi	Third person Singular
construim	First person Plural
vorbim	First person Plural
furau	Third person Plural
rezistaseră	Third person Plural
striga	Third person Singular
învechiși	Second person Singular
peți	Third person Singular
propunerii	None
moșia	None
mărturisești	Second person Singular
orientare	None
aurești	Second person Singular
schimburile	None
pișaturilor	None
ipocritelor	None
extinzi	Second person Singular
neglija	Third person Singular
propunem	First person Plural
trăsniseși	Second person Singular
interni	None
sughițase	Third person Singular
vizualiză	Third person Singular
mut	First person Singular
stindardele	None
moșteneau	Third person Plural
prăpădiserăm	First person Plural
sfârșii	First person Singular
cuptoarelor	None
influențase	Third person Singular
încântasem	First person Singular
ezitași	Second person Singular
masturbase	Third person Singular
noul	None
desfășurau	Third person Plural
încărca	Third person Singular
clocotiseși	Second person Singular
civiizași	Second person Singular
spânzurase	Third person Singular
sexualitatea	None
reintroduse	Third person Singular
așezară	Third person Plural
emoționezi	Second person Singular
mușcară	Third person Plural
mișunaseră	Third person Plural
împăturise	Third person Singular
căsătoriseși	Second person Singular
dominau	Third person Plural
curățaserăm	First person Plural
fugiseși	Second person Singular
cinstea	Third person Singular
sapiențe	None
astâmpăraserăm	First person Plural
prescria	Third person Singular
turnarăm	First person Plural
microbiologică	None
oblicul	None
înfumurat	None
asimila	Third person Singular
argiloaselor	None
fractură	Third person Singular
uscatului	None
existăm	First person Plural
spumaseră	Third person Plural
împlineau	Third person Plural
reînnoind	None
cireașa	None
perja	None
parcăm	First person Plural
aerodromul	None
momiși	Second person Singular
chițcăirăți	Second person Plural
tunarăm	First person Plural
activăm	First person Plural
maioneza	None
întreținut	None
aciuaseși	Second person Singular
completez	First person Singular
poruncea	Third person Singular
stinsese	Third person Singular
pătrunseși	Second person Singular
zdrobise	Third person Singular
extinseseră	Third person Plural
împrejmuia	Third person Singular
librăria	None
alungară	Third person Plural
capitulară	Third person Plural
lasciv	None
păreau	Third person Plural
aținui	First person Singular
lingușiseră	Third person Plural
prescrise	Third person Singular
mândru	None
staulul	None
semnară	Third person Plural
fricoasa	None
aflaserăți	Second person Plural
întărâtară	Third person Plural
încetiserăm	First person Plural
șchiopez	First person Singular
stânjeneau	Third person Plural
trecem	First person Plural
răsuni	Second person Singular
declinarăm	First person Plural
ședem	First person Plural
modificaseră	Third person Plural
strada	None
ascunseseră	Third person Plural
răszisese	Third person Singular
superi	Second person Singular
medicii	None
mersesem	First person Singular
rotunjiserăm	First person Plural
întreprinzând	None
vătămaserăm	First person Plural
soare	None
virtuosul	None
plictiseați	Second person Plural
distanța	None
sugerii	None
îndemnăm	First person Plural
smulsese	Third person Singular
zdrobi	Third person Singular
apuseși	Second person Singular
decafeinizatelor	None
recunoscuserăți	Second person Plural
ulmilor	None
păruii	First person Singular
suspinară	Third person Plural
poftea	Third person Singular
dezbin	First person Singular
mândri	Third person Singular
greșim	First person Plural
electromagnetice	None
sturului	None
cuvii	Second person Singular
înfășurași	Second person Singular
pătrundem	First person Plural
afânase	Third person Singular
obiectul	None
împiedicaserăți	Second person Plural
asiguraserăm	First person Plural
zgăurase	Third person Singular
slavelor	None
piersica	Third person Singular
înșelase	Third person Singular
spurca	Third person Singular
lânii	None
schiorilor	None
stilurile	None
azvârlise	Third person Singular
apropiase	Third person Singular
amânau	Third person Plural
plafoanele	None
întortocheaserăm	First person Plural
distractive	None
începem	First person Plural
piedestalurilor	None
pavaserăți	Second person Plural
curăți	Second person Singular
urca	Third person Singular
șacalilor	None
ghimberul	None
răgușit	None
ferecând	None
tincturară	Third person Plural
respectului	None
bancnota	None
bărbierea	Third person Singular
înotătoarele	None
flămânzise	Third person Singular
paritatea	None
pricepuse	Third person Singular
răsfățăm	First person Plural
dedat	None
păstrau	Third person Plural
concentrați	None
înveninaseră	Third person Plural
încrucișară	Third person Plural
vitaminelor	None
socotim	First person Plural
delimitare	None
ventilatorului	None
despicaseși	Second person Singular
tărăgănaseși	Second person Singular
sare	Third person Singular
pungașilor	None
bulgarule	None
cernui	First person Singular
încoronase	Third person Singular
tincturași	Second person Singular
înverșunaseră	Third person Plural
piepteni	Second person Singular
țipetele	None
liniștirăm	First person Plural
analizatorul	None
nega	Third person Singular
purifici	Second person Singular
sfulgerau	Third person Plural
perișoarei	None
tincturi	Second person Singular
varză	None
învingeau	Third person Plural
nenoroceați	Second person Plural
înflorise	Third person Singular
virtuoasă	None
stâlpii	None
vizita	Third person Singular
dezlegau	Third person Plural
plăcu	Third person Singular
eliberase	Third person Singular
ciudatei	None
topisem	First person Singular
luceai	Second person Singular
măsura	Third person Singular
râma	Third person Singular
bălăia	Third person Singular
creăm	First person Plural
ruinez	First person Singular
seci	None
străpungeau	Third person Plural
măsuraseși	Second person Singular
gravat	None
grăi	Third person Singular
polonezului	None
delimitau	Third person Plural
măcinaseră	Third person Plural
pișatule	None
începu	Third person Singular
vânătăii	None
perineal	None
arbuzule	None
poșetele	None
botezatele	None
înșelară	Third person Plural
împunsei	First person Singular
întâlnim	First person Plural
înfrățești	Second person Singular
vamal	None
lanternă	None
alergau	Third person Plural
învingi	Second person Singular
convenise	Third person Singular
încercuim	First person Plural
umplusem	First person Singular
bălților	None
înnoiați	Second person Plural
poftim	First person Plural
aplic	First person Singular
inimoși	None
blândei	None
frână	Third person Singular
port	First person Singular
dramaticelor	None
balustradele	None
ancora	None
murmurăm	First person Plural
curgeai	Second person Singular
balta	None
chipul	None
interesezi	Second person Singular
preistoricii	None
mâniase	Third person Singular
afla	Third person Singular
înfrunziseși	Second person Singular
dezvolta	Third person Singular
engleza	None
halucinarăm	First person Plural
plăcinta	None
răspândeau	Third person Plural
folosea	Third person Singular
ținuse	Third person Singular
dușmănești	Second person Singular
frământaserăm	First person Plural
măcinară	Third person Plural
desișurile	None
ghicea	Third person Singular
nebuniseși	Second person Singular
enormă	None
atinsesem	First person Singular
păcătui	Third person Singular
prinsă	None
prevestiseși	Second person Singular
îndemn	First person Singular
abandonaseră	Third person Plural
cornee	None
îndeletniceau	Third person Plural
leopardului	None
cinstii	First person Singular
întunecaseră	Third person Plural
clarei	None
făureau	Third person Plural
păta	Third person Singular
admiraserăm	First person Plural
strica	Third person Singular
desenând	None
adoptase	Third person Singular
întuneca	Third person Singular
țintiseși	Second person Singular
asemănau	Third person Plural
deschisei	First person Singular
blestem	First person Singular
iluzorii	None
clarificat	None
strănuți	Second person Singular
îngriji	Third person Singular
înfometarăm	First person Plural
saturaserăm	First person Plural
omorâm	First person Plural
dobândeați	Second person Plural
elimini	Second person Singular
petrecuse	Third person Singular
moștenea	Third person Singular
dobândise	Third person Singular
apăreau	Third person Plural
noile	None
amanetat	None
luă	Third person Singular
minerul	None
limbii	None
știusem	First person Singular
supăraseră	Third person Plural
destrama	Third person Singular
răspunzi	Second person Singular
serba	Third person Singular
cioplim	First person Plural
inviți	Second person Singular
pasteurizaserăți	Second person Plural
spânzur	First person Singular
îmbogății	First person Singular
adăsta	Third person Singular
scăzuserăți	Second person Plural
proptiseră	Third person Plural
înjosiserăți	Second person Plural
sporirăm	First person Plural
astupa	Third person Singular
izoleucinei	None
mărunțirăți	Second person Plural
ațâțaserăți	Second person Plural
rămâne	Third person Singular
strămoșul	None
țara	None
decafeinizați	None
trepădaseși	Second person Singular
apucând	None
constituționalitate	None
frizerul	None
afixelor	None
îngrămădea	Third person Singular
tunăm	First person Plural
acuzară	Third person Plural
devenea	Third person Singular
serioasa	None
împăcăm	First person Plural
îndurerezi	Second person Singular
însărcina	Third person Singular
cuprinsului	None
alcătuise	Third person Singular
încăpățânaților	None
freca	Third person Singular
belim	First person Plural
descriem	First person Plural
înseninase	Third person Singular
răserăți	Second person Plural
șevaletul	None
împușc	First person Singular
spitalul	None
mișcară	Third person Plural
lucraserăți	Second person Plural
aduci	Second person Singular
prânzi	Third person Singular
daperi	Second person Singular
întunecaserăți	Second person Plural
anin	First person Singular
mâzgăliseră	Third person Plural
binecuvânta	Third person Singular
anulase	Third person Singular
scărmănau	Third person Plural
scurmasem	First person Singular
holbasem	First person Singular
merse	Third person Singular
reale	None
insurmontabile	None
scria	Third person Singular
oratorule	None
cucerirăm	First person Plural
dezuniseși	Second person Singular
bucuraseși	Second person Singular
macedonenilor	None
caisa	None
deplasase	Third person Singular
zbicești	Second person Singular
cântase	Third person Singular
adormise	Third person Singular
încărunțim	First person Plural
insistase	Third person Singular
celebrăm	First person Plural
pornografie	None
șovăia	Third person Singular
epocilor	None
turnau	Third person Plural
fluvial	None
nivela	Third person Singular
ciugulești	Second person Singular
răspândi	Third person Singular
spuseserăm	First person Plural
masculin	None
lai	None
supărarăți	Second person Plural
spălase	Third person Singular
conduseseră	Third person Plural
păstra	Third person Singular
învecinarăm	First person Plural
animarăți	Second person Plural
extinse	Third person Singular
scăparăți	Second person Plural
zgâim	First person Plural
căutase	Third person Singular
încânta	Third person Singular
bălăiserăți	Second person Plural
palmierului	None
sfințiși	Second person Singular
impuseserăți	Second person Plural
împodobii	First person Singular
socializasem	First person Singular
băgaseră	Third person Plural
îndesaserăm	First person Plural
clociși	Second person Singular
ascuțiserăți	Second person Plural
petreci	Second person Singular
genunchiului	None
împarți	Second person Singular
porniseși	Second person Singular
făptuiai	Second person Singular
trezeau	Third person Plural
treier	First person Singular
verișoarei	None
economica	None
muști	Second person Singular
bulbuci	Second person Singular
smintirăm	First person Plural
pensula	None
împlântarăți	Second person Plural
latru	First person Singular
tresare	Third person Singular
prevestirăm	First person Plural
celții	None
terapeuticelor	None
servise	Third person Singular
așteptarăm	First person Plural
mucilor	None
însușire	None
hotărârăți	Second person Plural
rugiserăți	Second person Plural
îngrijeai	Second person Singular
tăia	Third person Singular
staulele	None
donezi	Second person Singular
flămânzirăți	Second person Plural
trecu	Third person Singular
întrerupea	Third person Singular
străjerilor	None
glumind	None
dansaseși	Second person Singular
purceserăți	Second person Plural
economiilor	None
examenelor	None
reușiseră	Third person Plural
libera	Third person Singular
dughiei	None
studiau	Third person Plural
cuprindem	First person Plural
socotirăți	Second person Plural
clipei	None
dator	None
învăluraserăm	First person Plural
rectitudinea	None
oripilaseși	Second person Singular
ușurau	Third person Plural
excitat	None
gardurilor	None
înrădăcinaserăm	First person Plural
dezrădăcinaserăm	First person Plural
ofilise	Third person Singular
chiorâseră	Third person Plural
depărasem	First person Singular
continuei	None
vâscul	None
gâdilaseră	Third person Plural
transcrise	Third person Singular
învățau	Third person Plural
izgoni	Third person Singular
acrimi	None
urdinaseși	Second person Singular
lăudaseră	Third person Plural
făcea	Third person Singular
venerici	None
învălurasem	First person Singular
mișcând	None
spuzim	First person Plural
aplicase	Third person Singular
credință	None
înfuriași	Second person Singular
prad	First person Singular
încălțaserăți	Second person Plural
guverna	Third person Singular
nejudecatului	None
îmbărbătarăm	First person Plural
încercase	Third person Singular
iubirilor	None
venisem	First person Singular
holbă	Third person Singular
împodobea	Third person Singular
încercară	Third person Plural
strigarăți	Second person Plural
epuizară	Third person Plural
țărmului	None
fumarăți	Second person Plural
amestecăm	First person Plural
năștea	Third person Singular
uscaseși	Second person Singular
intrarăți	Second person Plural
rătăcită	None
pătrunseseră	Third person Plural
folosi	Third person Singular
roși	Third person Singular
studenții	None
mințim	First person Plural
mincinoaselor	None
bucuraseră	Third person Plural
fraged	None
neguțasem	First person Singular
cântărirăți	Second person Plural
greșeau	Third person Plural
neg	First person Singular
supărăm	First person Plural
chițăiai	Second person Singular
răzgândiserăm	First person Plural
tulburau	Third person Plural
prășisem	First person Singular
dona	Third person Singular
înveliseși	Second person Singular
petreceai	Second person Singular
amâna	Third person Singular
cântăriră	Third person Plural
atmosfera	None
căscaserăm	First person Plural
spermei	None
cântări	Third person Singular
încăpeau	Third person Plural
rescriseși	Second person Singular
îmboldiși	Second person Singular
căsătoreau	Third person Plural
fericea	Third person Singular
unghiilor	None
îmbinarăți	Second person Plural
fixau	Third person Plural
spumegase	Third person Singular
dezrobit	None
ungeau	Third person Plural
rușinarăm	First person Plural
singurei	None
ridicasem	First person Singular
ocupau	Third person Plural
echidna	None
conjugării	None
trezim	First person Plural
iertase	Third person Singular
abdicase	Third person Singular
deplasăm	First person Plural
existau	Third person Plural
acuzase	Third person Singular
funcțiile	None
locuiau	Third person Plural
îngheța	Third person Singular
virozei	None
învăț	First person Singular
suflaseși	Second person Singular
barași	Second person Singular
reflectat	None
vorbelor	None
extragem	First person Plural
aprinseserăți	Second person Plural
senatorule	None
cuveneau	Third person Plural
căință	None
împreuna	Third person Singular
capsula	Third person Singular
dublaserăm	First person Plural
englezului	None
balconule	None
înjura	Third person Singular
adăstat	None
pricepem	First person Plural
arăduse	Third person Singular
surei	None
spuse	Third person Singular
păcătuiserăm	First person Plural
răzbunase	Third person Singular
acuzaserăm	First person Plural
putut	None
închisese	Third person Singular
nimiciși	Second person Singular
rostea	Third person Singular
pășunez	First person Singular
exagerarăm	First person Plural
separăm	First person Plural
rostogoleau	Third person Plural
tehnologică	None
spori	Third person Singular
uni	Third person Singular
vâscoșii	None
conținea	Third person Singular
fundasem	First person Singular
scoceați	Second person Plural
cereau	Third person Plural
repauzăm	First person Plural
sfătuiați	Second person Plural
răcoreau	Third person Plural
săruta	Third person Singular
stafidelor	None
vindec	First person Singular
clădiserăți	Second person Plural
dauna	None
uscase	Third person Singular
durerosului	None
întemeiase	Third person Singular
încurajași	Second person Singular
îngânasem	First person Singular
zbicea	Third person Singular
plecăm	First person Plural
sorti	Third person Singular
odihnim	First person Plural
lingușiserăm	First person Plural
devenirăți	Second person Plural
atârnarea	None
porcul	None
tunetului	None
stabili	Third person Singular
venise	Third person Singular
dinamică	None
preferase	Third person Singular
interziceați	Second person Plural
desprinseseră	Third person Plural
virtuoși	None
decedase	Third person Singular
ageră	None
condu	Second person Singular
extragea	Third person Singular
îngrămădești	Second person Singular
plăcerile	None
conversațiile	None
observ	First person Singular
reținurăți	Second person Plural
glicina	None
amaneta	Third person Singular
proporțiilor	None
turtureaua	None
după-amiezii	None
coperiseși	Second person Singular
priveghea	Third person Singular
amorului	None
balcanici	None
încăpură	Third person Plural
sacrificiile	None
nepopularele	None
sălbatica	None
scremusem	First person Singular
inelule	None
strănutăm	First person Plural
reciprocități	None
sper	First person Singular
înnoptasem	First person Singular
murdari	None
tunarăți	Second person Plural
împiedicași	Second person Singular
scorpionului	None
amărâserăm	First person Plural
domini	Second person Singular
aromânescului	None
pisa	Third person Singular
zăriserăm	First person Plural
poștali	None
rătăcind	None
eliminăm	First person Plural
prânzisem	First person Singular
clătinau	Third person Plural
strunga	None
frunzoasă	None
dimineților	None
cobaiul	None
bora	Third person Singular
corcii	First person Singular
reduse	Third person Singular
odihnea	Third person Singular
întreținuse	Third person Singular
constă	Third person Singular
cășuna	Third person Singular
aprinzând	None
nimici	Third person Singular
băiețelule	None
rumegau	Third person Plural
chiorârăți	Second person Plural
imputa	Third person Singular
vădim	First person Plural
văraseși	Second person Singular
buricului	None
presupuseși	Second person Singular
ataraxie	None
degerași	Second person Singular
tranzienții	None
scoapsei	First person Singular
mirosea	Third person Singular
părintescului	None
carpelelor	None
licăreau	Third person Plural
târnăcopul	None
scuz	First person Singular
săraserăți	Second person Plural
izbăvisem	First person Singular
experimentați	None
făptuim	First person Plural
licărise	Third person Singular
găsi	Third person Singular
conjugase	Third person Singular
certau	Third person Plural
bănuiau	Third person Plural
mirosiseră	Third person Plural
brăză	Third person Singular
apucase	Third person Singular
zbârcim	First person Plural
forfotim	First person Plural
cutremura	Third person Singular
specialităților	None
voioaselor	None
pețisem	First person Singular
păstrarăm	First person Plural
șerbirăți	Second person Plural
pâinilor	None
însoți	Third person Singular
îngustez	First person Singular
acumula	Third person Singular
hămesiși	Second person Singular
aplecând	None
căsătorii	First person Singular
învelirăm	First person Plural
prăpădiseră	Third person Plural
prefera	Third person Singular
prețuiră	Third person Plural
lăsarăm	First person Plural
înfoiaseră	Third person Plural
strămuta	Third person Singular
lipim	First person Plural
îmbogățisem	First person Singular
grapele	None
gravității	None
îngrășa	Third person Singular
îndrăzniserăți	Second person Plural
apocalipsul	None
obișnui	Third person Singular
maghiare	None
ridicară	Third person Plural
piețelor	None
forfoteați	Second person Plural
cimpoiul	None
răseseră	Third person Plural
apăsaserăm	First person Plural
țăcăniseră	Third person Plural
semna	Third person Singular
fiți	Third person Plural
pic	First person Singular
copleși	Third person Singular
legă	Third person Singular
părăsirăți	Second person Plural
rulau	Third person Plural
amenințarăm	First person Plural
avansa	Third person Singular
constrânsese	Third person Singular
desfăcuseși	Second person Singular
mulțumim	First person Plural
explicasem	First person Singular
înnorase	Third person Singular
cutiilor	None
rotești	Second person Singular
rămăsesem	First person Singular
feriseși	Second person Singular
unghiului	None
spuneai	Second person Singular
rețineai	Second person Singular
integralul	None
sfârticasem	First person Singular
larg	None
pedepsim	First person Plural
înecase	Third person Singular
desmântară	Third person Plural
fura	Third person Singular
coapseși	Second person Singular
supunerii	None
strâmbasem	First person Singular
sfătuise	Third person Singular
sărăcie	None
socotit	None
distra	Third person Singular
păroasei	None
ataci	Second person Singular
refuzasem	First person Singular
răsăreai	Second person Singular
teiului	None
sângerul	None
bucurarăți	Second person Plural
împroprietărea	Third person Singular
descurcaseși	Second person Singular
asurziserăm	First person Plural
mănânc	First person Singular
negură	None
nimiceau	Third person Plural
aduni	Second person Singular
împovărarăți	Second person Plural
simbolizaseră	Third person Plural
plătiseră	Third person Plural
bârfisem	First person Singular
interesez	First person Singular
rămânem	First person Plural
narcotizez	First person Singular
vegheau	Third person Plural
orașelor	None
lătrarăți	Second person Plural
comportarăți	Second person Plural
bunicuță	None
legeni	Second person Singular
îmboldești	Second person Singular
fluierași	Second person Singular
terminasem	First person Singular
coborî	Third person Singular
sfințeai	Second person Singular
dezarmarea	None
zări	Third person Singular
surp	First person Singular
propuseserăți	Second person Plural
întorsei	First person Singular
rănise	Third person Singular
șoptiseși	Second person Singular
înfocării	None
simbolizez	First person Singular
preludiile	None
încredeai	Second person Singular
neadevărurile	None
cântăriserăți	Second person Plural
vlăguirăm	First person Plural
liniște	None
răzlețea	Third person Singular
sărăm	First person Plural
diminețile	None
adunase	Third person Singular
nivelași	Second person Singular
supraviețui	Third person Singular
compar	First person Singular
nebunii	First person Singular
închiseserăți	Second person Plural
aplicaserăți	Second person Plural
abiogeneză	None
primi	None
merităm	First person Plural
surilor	None
clocotești	Second person Singular
osoasă	None
îmbătrânești	Second person Singular
răzleți	Third person Singular
oacheșele	None
întâmplară	Third person Plural
păstraseși	Second person Singular
încercau	Third person Plural
ascuțise	Third person Singular
specificele	None
întrista	Third person Singular
murdărise	Third person Singular
rog	First person Singular
oripilase	Third person Singular
slugăriseși	Second person Singular
reușind	None
rupem	First person Plural
străjilor	None
loghez	First person Singular
celtă	None
atacase	Third person Singular
decisese	Third person Singular
deschis	None
înfrâna	Third person Singular
sculat	None
templierilor	None
Rusaliilor	None
beleați	Second person Plural
întindea	Third person Singular
mlaștina	None
măseseși	Second person Singular
amorul	None
punctau	Third person Plural
marinului	None
îngheți	Second person Singular
simbolizat	None
brăzasem	First person Singular
întâlnirăm	First person Plural
stinse	Third person Singular
excavaserăți	Second person Plural
susținu	Third person Singular
genetică	None
halirăm	First person Plural
crezusem	First person Singular
neglijase	Third person Singular
sfârtici	Second person Singular
asurzești	Second person Singular
muflonul	None
umpluse	Third person Singular
conduse	Third person Singular
produs	None
lepădarăm	First person Plural
plutiserăți	Second person Plural
anatomic	None
amical	None
sucirăm	First person Plural
potrivit	None
bazilicilor	None
principal	None
mândrit	None
încheiaserăm	First person Plural
împădureai	Second person Singular
batjocorești	Second person Singular
cufunda	Third person Singular
mură	Third person Singular
trunchiul	None
glandului	None
discutând	None
izvorului	None
pregetasem	First person Singular
puținii	None
observantelor	None
purcesei	First person Singular
sumeseră	Third person Plural
cunoscuți	None
ușuratic	None
încorona	Third person Singular
dezminți	Third person Singular
stimulând	None
copiez	First person Singular
strigaseși	Second person Singular
divorțarăm	First person Plural
tocase	Third person Singular
umilea	Third person Singular
distilau	Third person Plural
luării	None
declinași	Second person Singular
pătimiră	Third person Plural
tunseseși	Second person Singular
întrezărea	Third person Singular
cântecului	None
prinsoare	None
acopereau	Third person Plural
hibă	None
păsărească	None
vocile	None
testiculului	None
fraudarăm	First person Plural
schimbase	Third person Singular
morțile	None
cețurilor	None
recunoscuserăm	First person Plural
bați	Second person Singular
străvechi	None
celebraserăm	First person Plural
apropiem	First person Plural
deschidem	First person Plural
umbri	Third person Singular
spetiseși	Second person Singular
roșul	None
activitate	None
drese	Third person Singular
căraserăm	First person Plural
surprindeau	Third person Plural
coborâtă	None
farfuriei	None
bășicarăți	Second person Plural
pictaserăm	First person Plural
creativ	None
studia	Third person Singular
aparilor	None
îndupleca	Third person Singular
dispăruseră	Third person Plural
forțase	Third person Singular
descântarăți	Second person Plural
hotărâseră	Third person Plural
vedea	Third person Singular
cugetarăm	First person Plural
adormea	Third person Singular
îmbărbătau	Third person Plural
umpleau	Third person Plural
poftiserăți	Second person Plural
mâzgăleai	Second person Singular
semnași	Second person Singular
vâscos	None
domin	First person Singular
ficatul	None
reintroduserăți	Second person Plural
răspunse	Third person Singular
răceau	Third person Plural
veacului	None
crocodilii	None
înmărmuri	Third person Singular
citise	Third person Singular
creșteai	Second person Singular
vadului	None
fluierele	None
răsunași	Second person Singular
bazez	First person Singular
plânseși	Second person Singular
