ciecz	Imperative-Jussive
ruchałoby	Conditional
napiszcie	Imperative-Jussive
przejrzysta	None
kłusowałoby	Conditional
znajdowałby	Conditional
grzebaliby	Conditional
siejmy	Imperative-Jussive
sierotę	None
odraczałoby	Conditional
dotknięci	None
siadałbym	Conditional
pokazywałoby	Conditional
kusiłabym	Conditional
zaprosiłabym	Conditional
zaczęłybyśmy	Conditional
chrzciliby	Conditional
napiszmy	Imperative-Jussive
grabiłby	Conditional
pękłoby	Conditional
zdementowałby	Conditional
potakiwaliby	Conditional
dymilibyście	Conditional
rozczarowałabyś	Conditional
lansowałabyś	Conditional
antysemickich	None
uprawialiby	Conditional
potrzebowałaby	Conditional
znajdź	Imperative-Jussive
myliłbyś	Conditional
otrzymaliby	Conditional
wyłudź	Imperative-Jussive
kapowalibyśmy	Conditional
traktowałbym	Conditional
doceniano	None
listów	None
mądrzałybyśmy	Conditional
zjebmy	Imperative-Jussive
odradzałbym	Conditional
obiecałaś	None
dojrzałyby	Conditional
panujcie	Imperative-Jussive
dojrzałabyś	Conditional
kolbami	None
ziałby	Conditional
machałybyśmy	Conditional
pijałoby	Conditional
usuwajcie	Imperative-Jussive
zasłużyłbyś	Conditional
sypałbym	Conditional
kradłbym	Conditional
zmieniające	None
pociechom	None
drgajcie	Imperative-Jussive
zestawilibyśmy	Conditional
sprzyjający	None
szóstek	None
próbuj	Imperative-Jussive
uważalibyśmy	Conditional
gotyckimi	None
więdnąłbym	Conditional
izomorfizm	None
stale	None
więdnijcie	Imperative-Jussive
łacnymi	None
mrugałoby	Conditional
przypuszczałby	Conditional
ripostowałaby	Conditional
rodźcie	Imperative-Jussive
zwyciężałbyś	Conditional
zamykajmy	Imperative-Jussive
leniwych	None
krzycz	Imperative-Jussive
lepmy	Imperative-Jussive
przeinaczcie	Imperative-Jussive
odkryłyby	Conditional
gnajcie	Imperative-Jussive
kroi	None
wisiałybyśmy	Conditional
wygrałaby	Conditional
ładuj	Imperative-Jussive
nadużywajcie	Imperative-Jussive
stawiałybyśmy	Conditional
odbierające	None
kolekcjonowaliby	Conditional
zabalsamowalibyście	Conditional
skręciłybyście	Conditional
życzyliby	Conditional
zainsynuowałybyście	Conditional
zabalsamujmy	Imperative-Jussive
diagnozowałyby	Conditional
cudzołożyłbym	Conditional
wschodźmy	Imperative-Jussive
zmieniałabyś	Conditional
smażyłaby	Conditional
rozproszyłyby	Conditional
dostarczałybyśmy	Conditional
nalewalibyście	Conditional
zdiagnozowałbym	Conditional
podróżowałyby	Conditional
wyświetlający	None
chwiałbyś	Conditional
oddawalibyśmy	Conditional
skończylibyście	Conditional
kradnijcie	Imperative-Jussive
strategiczny	None
trzeb	Imperative-Jussive
kniahiniach	None
komentowaliby	Conditional
szastałbym	Conditional
zmieniałyby	Conditional
zamarzałybyśmy	Conditional
oświetlałabym	Conditional
wspierania	None
otworzyłybyście	Conditional
egzaminowalibyśmy	Conditional
denerwowałybyście	Conditional
brzęczałybyśmy	Conditional
pożarłbyś	Conditional
wyruchałoby	Conditional
kłammy	Imperative-Jussive
wiosłuj	Imperative-Jussive
tajmy	Imperative-Jussive
uczcie	Imperative-Jussive
stanowiłabyś	Conditional
dożyłybyście	Conditional
poznałabym	Conditional
ograniczałabyś	Conditional
fetę	None
grudnie	None
wiązówkę	None
mierzyłby	Conditional
azjatyckie	None
należeliby	Conditional
czesalibyśmy	Conditional
uczyłoby	Conditional
słynąłbyś	Conditional
gasiłabyś	Conditional
milczelibyśmy	Conditional
siusiałyby	Conditional
wyłączaj	Imperative-Jussive
zwrotem	None
ruszyłybyśmy	Conditional
hasałybyście	Conditional
żałuj	Imperative-Jussive
kusiłybyście	Conditional
potrzebowałbym	Conditional
nieśmiałe	None
zgubiłoby	Conditional
czytaj	Imperative-Jussive
metali	None
mysi	None
grzęzłybyśmy	Conditional
dąsałaby	Conditional
potrzebujcie	Imperative-Jussive
wymówiłby	Conditional
porozmawiałoby	Conditional
stanowiliby	Conditional
trąciłybyście	Conditional
sprzątnijmy	Imperative-Jussive
trąciłybyśmy	Conditional
wyjaśniałaby	Conditional
dziobałybyśmy	Conditional
opiekowałbyś	Conditional
rozproszylibyśmy	Conditional
rozważyłbym	Conditional
poproś	Imperative-Jussive
spieszyłabyś	Conditional
stawiajcie	Imperative-Jussive
parskalibyśmy	Conditional
ludów	None
zburzyłby	Conditional
wywoływano	None
zainsynuowałybyśmy	Conditional
zbiegalibyście	Conditional
przeszkadzający	None
kserowaliby	Conditional
ograniczaliby	Conditional
zauważyłaby	Conditional
pozwalałoby	Conditional
edycjo	None
anachronizmem	None
przeprosiłaby	Conditional
traciłyby	Conditional
lampart	None
śpijmy	Imperative-Jussive
poprawiłoby	Conditional
kroiłyby	Conditional
bólowi	None
odbudowałybyście	Conditional
kompozytora	None
daszkiem	None
śluzowców	None
wyświetlałaby	Conditional
wisielibyśmy	Conditional
łap	Imperative-Jussive
kontroluj	Imperative-Jussive
goździku	None
korpusom	None
przypuszczałbyś	Conditional
kochałoby	Conditional
mruczeliby	Conditional
ortodoksyjnym	None
znieczulenie	None
masę	None
śledziłaby	Conditional
wybieraliby	Conditional
majsterkowaliby	Conditional
niszczyłoby	Conditional
zauważylibyście	Conditional
zantagonizowałaby	Conditional
święconka	None
partię	None
rentgen	None
eksportowałyby	Conditional
woniałbym	Conditional
ziębnijmy	Imperative-Jussive
dałybyśmy	Conditional
wygrałby	Conditional
wędzidłom	None
zebrze	None
wymyśliłbyś	Conditional
chadzajcie	Imperative-Jussive
harowałybyście	Conditional
betonowałoby	Conditional
twierdźmy	Imperative-Jussive
deuter	None
demonicznymi	None
siekaczy	None
zaczęliby	Conditional
wystarczałbyś	Conditional
podpalcie	Imperative-Jussive
gwiżdżmy	Imperative-Jussive
konfiguruj	Imperative-Jussive
tłumaczyłoby	Conditional
mądrzej	Imperative-Jussive
ćwicz	Imperative-Jussive
pożycz	Imperative-Jussive
uczą	None
graniczyłoby	Conditional
obrabowałbym	Conditional
rozgrzeszyłaby	Conditional
dumałoby	Conditional
bredziłabyś	Conditional
spieprzałybyśmy	Conditional
czekałyby	Conditional
wyglądałybyśmy	Conditional
włączałbyś	Conditional
promieniem	None
skończyłyście	None
brudziłbyś	Conditional
zaczekałoby	Conditional
słyszałabyś	Conditional
ziewałbym	Conditional
znajdowałem	None
kipmy	Imperative-Jussive
wyniesiono	None
obiecałby	Conditional
marzcie	Imperative-Jussive
stewardessami	None
drapałam	None
kimałyśmy	None
egzotyczna	None
szkodziłbym	Conditional
twórcy	None
grzęzłoby	Conditional
żartuje	None
pozwalaj	Imperative-Jussive
podałbyś	Conditional
jadalibyście	Conditional
wyprowadzeniem	None
dementowałby	Conditional
ziębnęłaby	Conditional
lodówce	None
posłuchałoby	Conditional
zrabowałbym	Conditional
dymiłybyśmy	Conditional
obujmy	Imperative-Jussive
połknęlibyśmy	Conditional
kimałbym	Conditional
wykrwawiłbym	Conditional
otaczałybyśmy	Conditional
strzelalibyśmy	Conditional
szukałyby	Conditional
kichałabyś	Conditional
sap	Imperative-Jussive
wymusilibyśmy	Conditional
konkretnym	None
sprzedaniu	None
zawiedźcie	Imperative-Jussive
obserwowalibyśmy	Conditional
miśkom	None
wymówkom	None
marłoby	Conditional
polecałaby	Conditional
dumałyby	Conditional
harowałybyśmy	Conditional
zerwie	None
klikałoby	Conditional
wynająłbyś	Conditional
rozmywałabyś	Conditional
nadepnęłybyśmy	Conditional
dzierży	None
gasiłybyśmy	Conditional
rozróżniłby	Conditional
sarkałby	Conditional
filmowaliby	Conditional
zapierdalałyby	Conditional
trwajmy	Imperative-Jussive
zabijajcie	Imperative-Jussive
przypomnij	Imperative-Jussive
wywołaj	Imperative-Jussive
ubikacjach	None
wdychając	None
dyszą	Imperative-Jussive
przeleć	Imperative-Jussive
dosięgnęłybyście	Conditional
dodawałabym	Conditional
płakalibyśmy	Conditional
przeszkadzałaby	Conditional
tęsknij	Imperative-Jussive
refowałabym	Conditional
drapałoby	Conditional
zachowałabym	Conditional
poprawiałby	Conditional
schowajcie	Imperative-Jussive
wyruchałyby	Conditional
łudzi	None
nalewałybyśmy	Conditional
jadałabyś	Conditional
wdychaj	Imperative-Jussive
sprawdzaliby	Conditional
zachowajmy	Imperative-Jussive
smarkałybyście	Conditional
Gruzini	None
dłuższemu	None
uśmieszkami	None
piskorz	None
marzyłbym	Conditional
agnostyk	None
kłusowano	None
młynem	None
kucalibyście	Conditional
modlilibyście	Conditional
gnaliby	Conditional
kosmykami	None
przeinaczyliby	Conditional
psychologicznych	None
gaworzyłoby	Conditional
pogrzebałaby	Conditional
wiatrem	None
zaiwaniła	None
szastajmy	Imperative-Jussive
drylowałabym	Conditional
drżeliby	Conditional
przesadzałybyśmy	Conditional
napowietrzylibyście	Conditional
ewentualnym	None
przydatnych	None
słoneczniejsza	None
twórz	Imperative-Jussive
jeździłbym	Conditional
pokażcie	Imperative-Jussive
wyłudzaj	Imperative-Jussive
rozmyj	Imperative-Jussive
zmieniłbym	Conditional
węchu	None
cieplejszej	None
opatentowałbyś	Conditional
zabalsamowałbym	Conditional
czytając	None
skończmy	Imperative-Jussive
obaliłaby	Conditional
numerowalibyśmy	Conditional
zatrzymałaby	Conditional
rozczarowaliby	Conditional
cudzołożyłaby	Conditional
psycholożek	None
karta	None
pocieszyliby	Conditional
zaprosiłybyście	Conditional
szalałbym	Conditional
rozgrzeszyłabyś	Conditional
doskonalszych	None
zamykalibyście	Conditional
kumalibyśmy	Conditional
zdobiłabyś	Conditional
dochodź	Imperative-Jussive
podbródka	None
wyruchałabyś	Conditional
odpowiedniejszego	None
zalogowałabyś	Conditional
broniłybyście	Conditional
zapal	Imperative-Jussive
neolitycznych	None
wziąłby	Conditional
mamrotałaby	Conditional
błądzilibyśmy	Conditional
wypędziłby	Conditional
trzymałabym	Conditional
bośniackiemu	None
kryjmy	Imperative-Jussive
parkingi	None
hasaj	Imperative-Jussive
wędrownym	None
kontrolowałabyś	Conditional
gasiłoby	Conditional
otrzymywałbyś	Conditional
bazyliki	None
podziwiałabym	Conditional
siusiajmy	Imperative-Jussive
wysiadłbyś	Conditional
koiłybyście	Conditional
sprzyjajcie	Imperative-Jussive
zdementowałyby	Conditional
zburzyłabym	Conditional
informacyjnej	None
podrywajcie	Imperative-Jussive
cięższa	None
schlebiałabyś	Conditional
wyrzuciło	None
czułybyśmy	Conditional
wybuchnęłabym	Conditional
zalogowałoby	Conditional
jedwabne	None
wołałyby	Conditional
dowiedzmy	Imperative-Jussive
podrywałabym	Conditional
gasilibyśmy	Conditional
okupom	None
dojrzej	Imperative-Jussive
ruchałbyś	Conditional
zaczekalibyście	Conditional
wisiałybyście	Conditional
podstawowy	None
rąbalibyśmy	Conditional
nękaliby	Conditional
nęciłybyśmy	Conditional
antygenów	None
poróżnijmy	Imperative-Jussive
przyjmowałybyśmy	Conditional
egzaminowałybyście	Conditional
szczekałbyś	Conditional
cenilibyśmy	Conditional
pierdziałaby	Conditional
dyszelibyście	Conditional
ściągałoby	Conditional
kontrolowałabym	Conditional
podróżowałabym	Conditional
klęczałbym	Conditional
najpełniejszej	None
rzucałbyś	Conditional
działałyby	Conditional
piszczałby	Conditional
palmowy	None
nadchodzilibyśmy	Conditional
usuwałbym	Conditional
wyprasowałyby	Conditional
ściągnęłyby	Conditional
ślady	None
kiciu	None
rozmywałybyście	Conditional
napastnika	None
pustek	None
chcielibyśmy	Conditional
niegrzecznemu	None
uderzeń	None
sprawdziłbym	Conditional
głupcom	None
ziewalibyście	Conditional
wnuczkom	None
starzy	None
zaczynaliby	Conditional
poprawiłbym	Conditional
wykonywalny	None
graniczyłabyś	Conditional
zwyciężałabym	Conditional
lipnego	None
gwizdałoby	Conditional
odwiedzałyby	Conditional
ćpaj	Imperative-Jussive
uprawialibyście	Conditional
telegrafowałaby	Conditional
oświetlaj	Imperative-Jussive
rosłabym	Conditional
skalpela	None
Słowaków	None
magicznymi	None
śmieszkowałybyśmy	Conditional
szanowałbyś	Conditional
zapierdalajmy	Imperative-Jussive
ziałoby	Conditional
tajałyby	Conditional
przynoszenie	None
przędzę	None
kłulibyście	Conditional
pożryjmy	Imperative-Jussive
kajzerki	None
parkowałybyście	Conditional
pijałbyś	Conditional
pożądał	None
bohatyrnęłabym	Conditional
zapamiętałbym	Conditional
alpejską	None
wypędziłyby	Conditional
organizowałybyście	Conditional
strzelałbym	Conditional
bordowy	None
kimaj	Imperative-Jussive
chronilibyśmy	Conditional
idiomu	None
elektrochemicznym	None
poprosiłabyś	Conditional
bazaltem	None
rzygałybyście	Conditional
słoneczko	None
wskazywałoby	Conditional
najpoważniejszy	None
zaczekajcie	Imperative-Jussive
grynszpanem	None
wyłączalibyście	Conditional
smarkałbym	Conditional
poprawiałybyście	Conditional
doiłybyśmy	Conditional
nadzorujmy	Imperative-Jussive
uprzedziliby	Conditional
meksykańska	None
płynęliby	Conditional
obalałbyś	Conditional
szczytami	None
kumałybyśmy	Conditional
splądrowałyby	Conditional
najdawniejsze	None
scenariusza	None
bałkańskich	None
sprawdziłyby	Conditional
wyłączałbym	Conditional
profesja	None
wykorzystywalibyście	Conditional
napierdalałabym	Conditional
najpowszechniejszym	None
kciukami	None
zajebaliby	Conditional
pamiętalibyście	Conditional
pożyczałybyśmy	Conditional
wyznaczył	None
zrabowałybyście	Conditional
przynosiłabyś	Conditional
rządziłyby	Conditional
jonizowałoby	Conditional
ornitologiem	None
zweryfikowalibyśmy	Conditional
opisywałby	Conditional
kontrolujmy	Imperative-Jussive
żułybyście	Conditional
mknij	Imperative-Jussive
cedziłbyś	Conditional
bębniłybyście	Conditional
grzecznych	None
wspomniałbym	Conditional
zadzwoniłby	Conditional
markerami	None
chaotyczna	None
leczyłybyście	Conditional
plotkowałaby	Conditional
szukałbym	Conditional
zajęczak	None
opisywalibyście	Conditional
ruchałybyśmy	Conditional
anachronizmów	None
anion	None
dźwigaj	Imperative-Jussive
przekomarzałbyś	Conditional
drzew	None
narzędzie	None
rozsadzalibyśmy	Conditional
lękałyby	Conditional
roślinożernym	None
barometru	None
pochodziłby	Conditional
obaleni	None
znaczylibyśmy	Conditional
sypałbyś	Conditional
kukaj	Imperative-Jussive
złupiłeś	None
biurwach	None
poczekalibyśmy	Conditional
wód	None
zbył	None
lizalibyśmy	Conditional
osuwisku	None
złotówę	None
telegrafowałyby	Conditional
puszczałybyśmy	Conditional
uczulenia	None
mieszkałabyś	Conditional
wyjrzyj	Imperative-Jussive
rozmyślałyby	Conditional
prawach	None
bluzgaj	Imperative-Jussive
moczyłoby	Conditional
wdepnęłabym	Conditional
wietnamcze	None
negocjowałyby	Conditional
Czeszką	None
złożyłabym	Conditional
rozprosz	Imperative-Jussive
biznesów	None
tosty	None
potwierdźmy	Imperative-Jussive
sapalibyśmy	Conditional
organizują	None
plujmy	Imperative-Jussive
zebralibyśmy	Conditional
obgadajcie	Imperative-Jussive
odstawiłbyś	Conditional
potakujmy	Imperative-Jussive
plantacją	None
płaciliby	Conditional
tworzyliby	Conditional
Cezara	None
zerżnęłybyśmy	Conditional
oharami	None
zerwalibyście	Conditional
pogadałbyś	Conditional
numerami	None
niszczyłbym	Conditional
pokazałbym	Conditional
ripostowaliby	Conditional
przypominaj	Imperative-Jussive
urzędasy	None
wieków	None
gasiłyby	Conditional
esemesowałabyś	Conditional
harowalibyście	Conditional
stygnęłybyście	Conditional
znajdowałabym	Conditional
sfałszowałabyś	Conditional
otworzyłoby	Conditional
oglądałby	Conditional
wiosłowałbyś	Conditional
opierdoliłbyś	Conditional
brońcie	Imperative-Jussive
sługów	None
podkradałby	Conditional
podziwiałby	Conditional
zastanawiałabyś	Conditional
agresją	None
rasistowskim	None
skazałabyś	Conditional
zamknąłbyś	Conditional
zbierałbyś	Conditional
łapałoby	Conditional
pachniałbym	Conditional
zantagonizowaliby	Conditional
zadzwoniłybyście	Conditional
warczyłbym	Conditional
otrzymuj	Imperative-Jussive
płonęłoby	Conditional
lansowałabym	Conditional
mordowałbyś	Conditional
skończyłybyście	Conditional
zerkałbym	Conditional
studiowalibyśmy	Conditional
znałybyście	Conditional
zarabiajcie	Imperative-Jussive
najodważniejszy	None
termosy	None
kicałybyście	Conditional
zmiennym	None
potrzebowałyby	Conditional
bicza	None
sprawdzalibyście	Conditional
tworzyłoby	Conditional
poruchałyby	Conditional
falangami	None
zerujcie	Imperative-Jussive
filmotekę	None
wykrzyknikami	None
okażcie	Imperative-Jussive
niszczyłabym	Conditional
zrobiłbyś	Conditional
szczerzylibyście	Conditional
ciągłymi	None
łapałaby	Conditional
wskazałybyście	Conditional
połykaliby	Conditional
światłowody	None
unicestwiłoby	Conditional
zaprosiłbyś	Conditional
bułgarską	None
drukowałyby	Conditional
przestronnymi	None
pamiętałabyś	Conditional
życzyłby	Conditional
nieokreślona	None
gazach	None
poprawiaj	Imperative-Jussive
skłam	Imperative-Jussive
koiłabym	Conditional
pożarłybyśmy	Conditional
zaprowadźcie	Imperative-Jussive
zakazałbym	Conditional
bywalibyście	Conditional
organizowałoby	Conditional
kusiłoby	Conditional
płonęłabyś	Conditional
cedziliby	Conditional
stawiają	None
leczyłoby	Conditional
więźliby	Conditional
nieprzyjemnym	None
znosiłby	Conditional
wahaliby	Conditional
złożyliby	Conditional
bajgli	None
odraczałaby	Conditional
głosowałoby	Conditional
uprzedzilibyśmy	Conditional
spałaszujcie	Imperative-Jussive
zamordujmy	Imperative-Jussive
zrzuciłbyś	Conditional
znikałaby	Conditional
szczytom	None
wstawaj	Imperative-Jussive
elektryczne	None
przywództwie	None
zapaliłybyśmy	Conditional
eksportowałbym	Conditional
martwiłyby	Conditional
charkalibyśmy	Conditional
statuę	None
znałyby	Conditional
piryt	None
czesało	None
wołajcie	Imperative-Jussive
otrzymałyby	Conditional
przeinaczyłybyście	Conditional
wkurwiaj	Imperative-Jussive
potwierdźcie	Imperative-Jussive
pisałby	Conditional
rąbałyby	Conditional
warczyłabym	Conditional
broiłabyś	Conditional
wkurwiajcie	Imperative-Jussive
podniosłybyśmy	Conditional
gorzałyby	Conditional
psułybyście	Conditional
ziębnęłyby	Conditional
niedopałka	None
jodłuj	Imperative-Jussive
włączałabym	Conditional
ostrzach	None
krwawiłabyś	Conditional
grzęzłybyście	Conditional
Francuzkom	None
zdrowa	None
uprawiaj	Imperative-Jussive
oszukiwałoby	Conditional
padałabyś	Conditional
rządziłybyśmy	Conditional
strzelalibyście	Conditional
przeżylibyśmy	Conditional
sądziłaby	Conditional
guglałby	Conditional
niespodzianek	None
pieprzylibyśmy	Conditional
pulpity	None
cofałoby	Conditional
wrzosem	None
stanów	Imperative-Jussive
wypędziłabyś	Conditional
dręczyłoby	Conditional
malunki	None
ropo	None
wygarnęliby	Conditional
gardziłabyś	Conditional
siedziałbym	Conditional
kirkutu	None
kumaj	Imperative-Jussive
gardzilibyśmy	Conditional
zaprzeczyłybyśmy	Conditional
zamówilibyście	Conditional
pijaliby	Conditional
rodziłbyś	Conditional
kolarzy	None
szarogęsiłbyś	Conditional
chowałybyśmy	Conditional
chełpiłby	Conditional
czarownice	None
czułabym	Conditional
szwagra	None
kieszenią	None
szabatu	None
zamówiłabym	Conditional
przypomnijcie	Imperative-Jussive
fotkę	None
kukałby	Conditional
dziób	Imperative-Jussive
ignorowałabym	Conditional
przydupas	None
znosiłabym	Conditional
Europejką	None
przeszkadzałoby	Conditional
warczyłaby	Conditional
umawiałybyśmy	Conditional
używałabyś	Conditional
wymagajmy	Imperative-Jussive
szukałbyś	Conditional
zamówilibyśmy	Conditional
przeżułoby	Conditional
nawóz	None
zniknęłaby	Conditional
kąsałybyście	Conditional
jemioły	None
psalmy	None
wymusilibyście	Conditional
czerpałabyś	Conditional
lękaj	Imperative-Jussive
ładniejszego	None
więdnęłaby	Conditional
Koptowie	None
dostępniejszemu	None
wołałoby	Conditional
liberyjskimi	None
opróżniłby	Conditional
uciekajmy	Imperative-Jussive
obejmowałoby	Conditional
Palestyńczycy	None
spodziewałyby	Conditional
płyty	None
pierdźmy	Imperative-Jussive
pożarłyby	Conditional
dochodziłabyś	Conditional
cyrkowa	None
symulowałby	Conditional
latajmy	Imperative-Jussive
klękaliby	Conditional
półprzewodnikom	None
toyoty	None
poprosił	None
kłóciłoby	Conditional
leźlibyście	Conditional
asturyjską	None
wertykalną	None
podchodźcie	Imperative-Jussive
zamknęłabym	Conditional
przegrałybyśmy	Conditional
nożowi	None
kumałby	Conditional
gasiłby	Conditional
marudziłby	Conditional
konkuruj	Imperative-Jussive
zimowałoby	Conditional
wyłączałbyś	Conditional
kąsałbym	Conditional
obrabowałoby	Conditional
starajcie	Imperative-Jussive
doiłyby	Conditional
niuansami	None
robilibyśmy	Conditional
dobyłam	None
destylację	None
odkryłybyście	Conditional
korzystaj	Imperative-Jussive
podlewałbym	Conditional
nalewaliby	Conditional
alkohol	None
dosrałybyście	Conditional
rządziłoby	Conditional
egoistów	None
drażniłyby	Conditional
koszykarkom	None
ciału	None
klikałyby	Conditional
przezimowałaby	Conditional
podalibyśmy	Conditional
wsparli	None
mżawką	None
żyj	Imperative-Jussive
spadałbym	Conditional
ujebałbym	Conditional
marudziłem	None
puszczajmy	Imperative-Jussive
fuli	None
rzeczowniki	None
weekendowej	None
Niemcze	None
zdiagnozowałby	Conditional
granatowe	None
ławeczce	None
rozmawiałabym	Conditional
podróżować	None
bohatyrnąłbyś	Conditional
podpalilibyście	Conditional
fruwaliby	Conditional
olimpiadach	None
chrońmy	Imperative-Jussive
mierzyłybyśmy	Conditional
budziłyby	Conditional
paser	None
łbie	None
przynosiłaby	Conditional
oceniaj	Imperative-Jussive
eksportujemy	None
nakryj	Imperative-Jussive
przebrzydła	None
wylałbym	Conditional
kroiłybyśmy	Conditional
biologom	None
zasłużyłybyście	Conditional
kupiłoby	Conditional
odpoczywałby	Conditional
kopmy	Imperative-Jussive
siąknęliby	Conditional
broniłabym	Conditional
barmanami	None
czarodzieje	None
suszyłabym	Conditional
rzucałyby	Conditional
stanom	None
przepraszaj	Imperative-Jussive
płaczmy	Imperative-Jussive
panowałby	Conditional
odchodzący	None
spieszyłaby	Conditional
oglądałybyśmy	Conditional
zmyślilibyście	Conditional
wyrządzisz	None
edytowałabyś	Conditional
broniłabyś	Conditional
plotkowalibyście	Conditional
czerpałaby	Conditional
opiekujmy	Imperative-Jussive
drylowałoby	Conditional
eksportowalibyśmy	Conditional
korzystałabyś	Conditional
siewcy	None
wygrałbyś	Conditional
litrach	None
wyrządziłyśmy	None
spotkałabym	Conditional
lękałabym	Conditional
sprawialiby	Conditional
zrozumiałoby	Conditional
podziwialibyście	Conditional
dymiłoby	Conditional
liberię	None
parskałabyś	Conditional
klękałaby	Conditional
zesrano	None
płatnością	None
hiragany	None
dyszałby	Conditional
podkreślałaby	Conditional
zabiłoby	Conditional
dostępniejszego	None
kipiałabyś	Conditional
nękałbym	Conditional
oceń	Imperative-Jussive
klonowej	None
kaszaloty	None
dąsałyby	Conditional
ryczałby	Conditional
przypominaliby	Conditional
żułoby	Conditional
guglajcie	Imperative-Jussive
należałoby	Conditional
umrzeć	None
olałybyśmy	Conditional
wszechwiedza	None
chrzcilibyście	Conditional
wynajęłabym	Conditional
okradałyby	Conditional
zaufałabyś	Conditional
drukowalibyśmy	Conditional
zespolonych	None
cudzołóżmy	Imperative-Jussive
zbyłabyś	Conditional
skróćmy	Imperative-Jussive
wybuchałyby	Conditional
fideistom	None
produkowania	None
zachorowali	None
dziewicy	None
bycie	None
zapierdalałabyś	Conditional
odkryłby	Conditional
działaczek	None
haftowalibyście	Conditional
rybakiem	None
patynami	None
wymówiłabyś	Conditional
zaruchałbyś	Conditional
łapalibyście	Conditional
parskałyby	Conditional
kapuj	Imperative-Jussive
studiujcie	Imperative-Jussive
zakazałby	Conditional
wskazałaby	Conditional
mieszaj	Imperative-Jussive
zaciążyłbyś	Conditional
betonowałybyście	Conditional
splądrowałabym	Conditional
porozmawialiby	Conditional
umówilibyście	Conditional
obciążajcie	Imperative-Jussive
wychowania	None
padaj	Imperative-Jussive
pękliby	Conditional
zjedlibyśmy	Conditional
zapominałybyście	Conditional
płynęłybyście	Conditional
malutkim	None
pełzałyby	Conditional
jelita	None
gap	Imperative-Jussive
poroniłybyśmy	Conditional
wyhaftowałabym	Conditional
wazonem	None
skończycie	None
wyborcę	None
domniemanych	None
kochaliby	Conditional
gardziłyby	Conditional
obiecujcie	Imperative-Jussive
rąbaliby	Conditional
kastrowałabym	Conditional
zwierzęciu	None
jedynakom	None
śpiewaliby	Conditional
śmietników	None
suszylibyście	Conditional
prefektury	None
pożryj	Imperative-Jussive
żartujcie	Imperative-Jussive
życzyłabym	Conditional
otrujcie	Imperative-Jussive
ukrywałybyśmy	Conditional
tajałbym	Conditional
obaliłyby	Conditional
gromadziłoby	Conditional
parowałby	Conditional
karła	None
przeciętne	None
przytulmy	Imperative-Jussive
podnosilibyśmy	Conditional
spotkałbyś	Conditional
płakałybyście	Conditional
adeptach	None
ceniłoby	Conditional
bohatyrnęlibyśmy	Conditional
szkodnikach	None
polecaliby	Conditional
sąsiedniemu	None
podziwiaj	Imperative-Jussive
zapamiętalibyśmy	Conditional
kubku	None
stygnąłbyś	Conditional
szatą	None
dotykałbyś	Conditional
absolwentki	None
koił	None
zachorowalibyście	Conditional
kupiłbyś	Conditional
pogadałabym	Conditional
obiecajmy	Imperative-Jussive
kwestionowaliby	Conditional
przepijcie	Imperative-Jussive
zauważmy	Imperative-Jussive
żądałaby	Conditional
cedziłybyśmy	Conditional
pugilaresach	None
staraj	Imperative-Jussive
kofeinowe	None
wymusiliby	Conditional
zapomniałabyś	Conditional
żałuję	None
oświetlałoby	Conditional
gadałaby	Conditional
zalogowałyby	Conditional
wyzwań	None
zmartwychwstawałabym	Conditional
hasałabym	Conditional
ukryłybyśmy	Conditional
podchodziliście	None
włóknami	None
kumałyście	None
pogadaj	Imperative-Jussive
pląsałbyś	Conditional
kłóciłabyś	Conditional
rozbieranie	None
przysięgałoby	Conditional
marszand	None
przekomarzałby	Conditional
krzyczeliby	Conditional
limuzynie	None
przewodów	None
podkradalibyście	Conditional
sosnowych	None
fantowi	None
wahałby	Conditional
gasiłaby	Conditional
gwałciliby	Conditional
nowymi	None
groźcie	Imperative-Jussive
przesadzaj	Imperative-Jussive
podpierdoliłby	Conditional
właścicielu	None
schnij	Imperative-Jussive
gapmy	Imperative-Jussive
przypominałby	Conditional
polowałbym	Conditional
polkom	None
kaszlelibyśmy	Conditional
dotykałabym	Conditional
dementowałoby	Conditional
kichałybyśmy	Conditional
plotkowałybyśmy	Conditional
szalej	Imperative-Jussive
najszerszy	None
raso	None
kontynentalnej	None
funkcjonariuszem	None
znaj	Imperative-Jussive
sapałabym	Conditional
krupą	None
wyjaśniłbyś	Conditional
wyglądaliby	Conditional
wymagajcie	Imperative-Jussive
latalibyście	Conditional
wady	None
wywoływalibyście	Conditional
cytadela	None
oddycha	None
przypuszczaliby	Conditional
barmana	None
wygrajcie	Imperative-Jussive
kupiłby	Conditional
najszybsza	None
potwierdzają	None
teatralni	None
popełniłoby	Conditional
zaprzeczyła	None
łopacie	None
odrzuciłoby	Conditional
piszczelami	None
zajebałby	Conditional
ostrzegajmy	Imperative-Jussive
spożywcza	None
dojrzelibyśmy	Conditional
powtórzylibyście	Conditional
pojawiaj	Imperative-Jussive
obserwowałabyś	Conditional
umyłby	Conditional
poroniłabyś	Conditional
pluliby	Conditional
architektów	None
szczurzyco	None
otaczaliby	Conditional
mierzyła	None
seniorowi	None
licytacjach	None
spotkani	None
wypędziłoby	Conditional
wygarnąłby	Conditional
wspomnielibyśmy	Conditional
ocenialibyście	Conditional
afinicznych	None
jazdę	None
grzebałby	Conditional
literaturach	None
białawym	None
siałby	Conditional
cesarskiego	None
mierzyłoby	Conditional
podochodziłabym	Conditional
zaniechajmy	Imperative-Jussive
rozgrzeszyłabym	Conditional
haftowałoby	Conditional
ratująca	None
ładowałaby	Conditional
analizowaliby	Conditional
wykrwawiłybyście	Conditional
awangardzie	None
zazdrościliby	Conditional
kuś	Imperative-Jussive
uderzałbym	Conditional
bankrutowałaby	Conditional
zaczynajcie	Imperative-Jussive
skarpetce	None
spieprzalibyśmy	Conditional
analizują	None
przedsięwzięcie	None
składalibyśmy	Conditional
wyjebałbym	Conditional
drylowaliby	Conditional
kołchozem	None
strojom	None
odpoczęliby	Conditional
odpowiadałaby	Conditional
zawarłbym	Conditional
odpoczywałabym	Conditional
obgadałybyście	Conditional
podpierdoliłaby	Conditional
srałbym	Conditional
gęgałabyś	Conditional
czołgach	None
dostarczałybyście	Conditional
rżelibyście	Conditional
pocenie	None
zarabiałby	Conditional
jonizowaliby	Conditional
marłabym	Conditional
nadzorowałybyśmy	Conditional
dusiłoby	Conditional
hien	None
potwierdzałabym	Conditional
oskarżałoby	Conditional
środowiskami	None
opowiadaj	Imperative-Jussive
zaiwanilibyśmy	Conditional
mistrzem	None
wracaj	Imperative-Jussive
podochodziłybyśmy	Conditional
ścignęlibyśmy	Conditional
ważniejszej	None
szkockimi	None
rzekliby	Conditional
przypuściłyby	Conditional
poznam	None
życzmy	Imperative-Jussive
szarogęsiłoby	Conditional
rzygałbym	Conditional
wyrządziłbyś	Conditional
pożarłabyś	Conditional
zapomniałoby	Conditional
morzu	None
pytań	None
martwilibyście	Conditional
uczęszczałoby	Conditional
refowałbym	Conditional
tundrą	None
splądrowałybyście	Conditional
dupczyłabyś	Conditional
patafianami	None
opierdoliłem	None
wdepnij	Imperative-Jussive
wspominajcie	Imperative-Jussive
kłamałabym	Conditional
ładowali	None
bezzębny	None
jęłybyśmy	Conditional
wodzach	None
pracą	None
połykałabyś	Conditional
włączaliby	Conditional
oddaj	Imperative-Jussive
kwililiby	Conditional
rozpaczalibyśmy	Conditional
skróciłabyś	Conditional
odwzajemnilibyśmy	Conditional
parapsychologię	None
zdementuj	Imperative-Jussive
kładlibyście	Conditional
milczmy	Imperative-Jussive
oskarżałabyś	Conditional
szczekalibyśmy	Conditional
przeżyłam	None
zerwałby	Conditional
zarezerwowałyby	Conditional
okazałaby	Conditional
roślina	None
lokatorzy	None
dbaj	Imperative-Jussive
całkowitych	None
problematyczna	None
odwzajemniłoby	Conditional
połknijcie	Imperative-Jussive
nieporządkom	None
pamiętałybyście	Conditional
sygnały	None
obcasów	None
zadaliby	Conditional
komunista	None
szastalibyście	Conditional
czekajmy	Imperative-Jussive
odkrywałybyście	Conditional
wysokiego	None
rzuciłbyś	Conditional
artystą	None
wybiera	None
miauczałybyście	Conditional
uderzeniach	None
próbowałabym	Conditional
płynęłabym	Conditional
spałaszowałybyście	Conditional
dodajmy	Imperative-Jussive
chrzest	None
gadałybyście	Conditional
zachorujcie	Imperative-Jussive
zerkalibyście	Conditional
przynieś	Imperative-Jussive
pięłabyś	Conditional
stawać	None
goniłaby	Conditional
strzelałaby	Conditional
smarkajmy	Imperative-Jussive
pijałbym	Conditional
zapomnielibyśmy	Conditional
dodzwoniłabyś	Conditional
sufitami	None
cięższej	None
odpoczywałabyś	Conditional
zdiagnozujmy	Imperative-Jussive
kąsaliby	Conditional
wskazawszy	None
gęgałoby	Conditional
odradzano	None
dodzwoniłaby	Conditional
jabłkowego	None
otrute	None
włączaj	Imperative-Jussive
spieprzyłbyś	Conditional
ostrzegałybyśmy	Conditional
wykitowałybyśmy	Conditional
gorzeliby	Conditional
pachnieć	None
wykitujcie	Imperative-Jussive
jonizowałabyś	Conditional
wskazałbym	Conditional
zaiwaniłybyśmy	Conditional
kłułybyśmy	Conditional
ujebałyby	Conditional
sfałszujcie	Imperative-Jussive
zerujmy	Imperative-Jussive
ignorowałbym	Conditional
browcowi	None
grzmij	Imperative-Jussive
odrzuciłabyś	Conditional
obserwowałybyście	Conditional
ratowałaby	Conditional
obaliłabyś	Conditional
zaruchałabyś	Conditional
gardziłaby	Conditional
dzierżylibyśmy	Conditional
broń	Imperative-Jussive
poiłaby	Conditional
pożyczyłbyś	Conditional
Francuzowi	None
wąchalibyśmy	Conditional
wróżkę	None
jadałoby	Conditional
opowiadałabym	Conditional
śruba	None
automatów	None
kajałabym	Conditional
opowiadałbyś	Conditional
uczęszczałybyście	Conditional
poprawiłby	Conditional
podkreślaj	Imperative-Jussive
pozwalałaby	Conditional
najdalszemu	None
wracalibyśmy	Conditional
sprawdzilibyśmy	Conditional
dodawać	None
zerowalibyśmy	Conditional
obuł	None
przyjmowalibyśmy	Conditional
zrobiłbym	Conditional
wybierałabym	Conditional
podziwiany	None
trzmielinę	None
kroilibyśmy	Conditional
próżnych	None
marzyłoby	Conditional
naprawiałybyśmy	Conditional
opactwa	None
branżą	None
znajdowałaby	Conditional
wdepnijmy	Imperative-Jussive
płaskowyżu	None
dajmy	Imperative-Jussive
przegapiłaby	Conditional
przeglądów	None
smutaliby	Conditional
kręciłybyśmy	Conditional
amperomierzach	None
klasyfikacją	None
sfałszowałby	Conditional
wyruchaj	Imperative-Jussive
zastanawiałby	Conditional
znalazłybyśmy	Conditional
dbajmy	Imperative-Jussive
Węgierkę	None
grzązłby	Conditional
formalnemu	None
strontowi	None
kąsałoby	Conditional
syndykaliście	None
poroniłbyś	Conditional
powtarzałaby	Conditional
przelećcie	Imperative-Jussive
spiąłby	Conditional
uratowalibyśmy	Conditional
sopel	None
ekspedientom	None
chadzajmy	Imperative-Jussive
wierzyłabyś	Conditional
heksanami	None
puszczaliby	Conditional
uwiodłybyśmy	Conditional
dwoistego	None
kierowałybyście	Conditional
dąsałybyście	Conditional
zabierzmy	Imperative-Jussive
szulerom	None
geniuszem	None
deltoidów	None
zmyśliłabym	Conditional
uderzenie	None
pachnielibyście	Conditional
pariasem	None
wskazałby	Conditional
żałowałabyś	Conditional
lgnijcie	Imperative-Jussive
szantażowałbyś	Conditional
uważajcie	Imperative-Jussive
zerżnij	Imperative-Jussive
goń	Imperative-Jussive
wykitowałyby	Conditional
rzuciłoby	Conditional
zgubiłbym	Conditional
dodzwońcie	Imperative-Jussive
różnobarwną	None
wysyłalibyście	Conditional
przepiłoby	Conditional
analizowałybyśmy	Conditional
głosowałabym	Conditional
esemesowałby	Conditional
czynilibyśmy	Conditional
ogoliłby	Conditional
śpiewałaby	Conditional
rodziłoby	Conditional
olałaby	Conditional
jeziorach	None
latałabyś	Conditional
skorupie	None
modliłbym	Conditional
szczałbym	Conditional
jąłbym	Conditional
zaimportujmy	Imperative-Jussive
sprzyjałby	Conditional
podbiale	None
tlałbym	Conditional
łapałyby	Conditional
zakochalibyśmy	Conditional
laskie	None
pachniałoby	Conditional
uwiodłabym	Conditional
bełtałbyś	Conditional
otaczałabyś	Conditional
obgadałaby	Conditional
pachnieliby	Conditional
wybuchnęlibyście	Conditional
sobola	None
przesadzaliby	Conditional
jeździlibyście	Conditional
ginęłabyś	Conditional
lantanowców	None
kusiłbyś	Conditional
dożyłbyś	Conditional
nękałybyśmy	Conditional
łanie	None
bojami	None
runęliby	Conditional
nieprzyjemne	None
gwałciłbyś	Conditional
wyruchaliby	Conditional
stanowiłby	Conditional
goniłoby	Conditional
racicom	None
dojrzały	None
zawiódłbyś	Conditional
rzucałybyście	Conditional
biegaj	Imperative-Jussive
zamówiłyby	Conditional
dręczcie	Imperative-Jussive
złapcie	Imperative-Jussive
strugiem	None
marudząca	None
partykułę	None
bojajmy	Imperative-Jussive
szpilce	None
wywołałbyś	Conditional
skręcilibyśmy	Conditional
radioizotopami	None
zmieńcie	Imperative-Jussive
podróżuj	Imperative-Jussive
jelitami	None
rozwiązałyby	Conditional
rozkładem	None
wybierają	None
parkowałyby	Conditional
pedagogom	None
wydmami	None
rozczarujcie	Imperative-Jussive
zarżnęłaby	Conditional
bębniłby	Conditional
włóczni	None
komentuj	Imperative-Jussive
dałoby	Conditional
stromy	None
guzików	None
smarkaj	Imperative-Jussive
kopyto	None
zadałybyśmy	Conditional
umarłybyście	Conditional
nagród	None
robiłabym	Conditional
tańczyłabym	Conditional
podwieczorkom	None
odbijałbym	Conditional
ćpalibyśmy	Conditional
usuwajmy	Imperative-Jussive
głodami	None
dodawajcie	Imperative-Jussive
przeszkadzaj	Imperative-Jussive
parkuj	Imperative-Jussive
gromadziłybyśmy	Conditional
pieprzylibyście	Conditional
suszyłaby	Conditional
pękłabym	Conditional
znikalibyście	Conditional
doprowadzalibyście	Conditional
ziomka	None
mieszałyby	Conditional
akcję	None
usunąłbyś	Conditional
sprawdzałoby	Conditional
mieszajmy	Imperative-Jussive
pociesz	Imperative-Jussive
dupczyłabym	Conditional
lutujmy	Imperative-Jussive
bojajcie	Imperative-Jussive
drogimi	None
jawilibyśmy	Conditional
uderzylibyście	Conditional
złamawszy	None
odbuduj	Imperative-Jussive
brodziłybyśmy	Conditional
debiutem	None
warszawianie	None
odjebałby	Conditional
paszach	None
trzebicie	None
widziałabym	Conditional
wilgą	None
zweryfikowałabym	Conditional
kostuchom	None
okradałoby	Conditional
dziwiłabym	Conditional
chłeptaj	Imperative-Jussive
wkurwialibyście	Conditional
brązowi	None
sprzęgłoby	Conditional
kujona	None
sunęlibyśmy	Conditional
smażyłabym	Conditional
widzeniem	None
lutnikowi	None
ogolilibyśmy	Conditional
dotykałyby	Conditional
kosztowałby	Conditional
wołaj	Imperative-Jussive
wyglądałoby	Conditional
posiadałyby	Conditional
wyjaśnijmy	Imperative-Jussive
padałbyś	Conditional
budzilibyście	Conditional
mierzyliby	Conditional
ubóstwiałabym	Conditional
parskałby	Conditional
wywoływaliby	Conditional
podziwiajmy	Imperative-Jussive
popełniłby	Conditional
siusiałabym	Conditional
usuną	None
starca	None
kierowałaby	Conditional
spuść	Imperative-Jussive
wyświetlaj	Imperative-Jussive
podlewałaby	Conditional
umówiłaby	Conditional
zrobilibyśmy	Conditional
znaleziony	None
tajski	None
podziwiajcie	Imperative-Jussive
transparentach	None
rzuć	Imperative-Jussive
uczestniczę	None
minimalisty	None
odstępach	None
sprzęglibyśmy	Conditional
rozróżniałabyś	Conditional
kucajcie	Imperative-Jussive
czeskie	None
odwzajemniłabym	Conditional
rowerzystkach	None
plantacjo	None
zawiedliby	Conditional
ukrylibyśmy	Conditional
wspominałybyście	Conditional
ceniłby	Conditional
materiały	None
zdobiłybyśmy	Conditional
odpowiadałyby	Conditional
drgalibyście	Conditional
zasłużcie	Imperative-Jussive
przyjmuj	Imperative-Jussive
zaprowadziłybyście	Conditional
ocenialiby	Conditional
przytuliłyby	Conditional
wskazywalibyśmy	Conditional
podziwiałoby	Conditional
tłuszczem	None
szokiem	None
dmuchałbyś	Conditional
dotknijmy	Imperative-Jussive
nalewalibyśmy	Conditional
pokonałybyście	Conditional
symulowało	None
weźcie	Imperative-Jussive
rzekłyby	Conditional
dźwigałybyśmy	Conditional
pieprz	Imperative-Jussive
zmarłymi	None
znosiłem	None
zbrodnie	None
tlałyby	Conditional
ceniliby	Conditional
pomagalibyśmy	Conditional
znikałbym	Conditional
kosztowałabym	Conditional
pułki	None
iskajmy	Imperative-Jussive
planowałabym	Conditional
podochodziłby	Conditional
posiadałby	Conditional
kimała	None
języku	None
produkowałyby	Conditional
metropolitą	None
traktuj	Imperative-Jussive
zjedz	Imperative-Jussive
przynosiłoby	Conditional
przyrostki	None
rojem	None
gapiłabym	Conditional
monitor	None
banglałybyśmy	Conditional
umarłybyśmy	Conditional
pociłybyśmy	Conditional
meteorologicznymi	None
opierdoliłaby	Conditional
proponowałybyśmy	Conditional
ciekłaby	Conditional
grzeszyłbym	Conditional
dotknęlibyście	Conditional
wodociągami	None
abonowałabyś	Conditional
wzięłaby	Conditional
poprośmy	Imperative-Jussive
chrzcijmy	Imperative-Jussive
sprzątnęłyby	Conditional
siadałybyście	Conditional
żułabyś	Conditional
siedząc	None
przemyślcie	Imperative-Jussive
zawarłoby	Conditional
spawacz	None
okaż	Imperative-Jussive
siedźcie	Imperative-Jussive
cenobitą	None
miejscom	None
dojrzelibyście	Conditional
odebrałby	Conditional
ograniczałybyście	Conditional
zazdrościlibyście	Conditional
psom	None
świerzbiałbyś	Conditional
proponowałybyście	Conditional
zacznij	Imperative-Jussive
ciekłabyś	Conditional
dzierżyłaby	Conditional
wyjaśnij	Imperative-Jussive
igrajcie	Imperative-Jussive
ocaliłybyśmy	Conditional
połowom	None
drażniłabym	Conditional
zakazałoby	Conditional
szukałybyście	Conditional
niobu	None
pięcioboju	None
wygrałabyś	Conditional
mordowałybyście	Conditional
marznęłoby	Conditional
okolicznikiem	None
zabiłeś	None
zaczynajmy	Imperative-Jussive
myszołowom	None
fragmencie	None
używałybyśmy	Conditional
śmiej	Imperative-Jussive
spotkania	None
podpisałabyś	Conditional
informacjo	None
kupiłybyśmy	Conditional
nazywałbyś	Conditional
trzebili	None
posłuchalibyśmy	Conditional
wikliną	None
skrótowce	None
łaknęliby	Conditional
wysokość	None
samotniejszej	None
odpoczywalibyście	Conditional
żałowałaś	None
ciekłyby	Conditional
filiżaneczkom	None
chciałabyś	Conditional
skrzypiałybyście	Conditional
zagięlibyście	Conditional
niejasna	None
miotły	None
zmartwychwstawałybyście	Conditional
rzekłbym	Conditional
dystansami	None
śmieszkowałabyś	Conditional
wywoływałabym	Conditional
przydatną	None
płakałybyśmy	Conditional
pełzałybyśmy	Conditional
londyńczyków	None
używajmy	Imperative-Jussive
rżałbyś	Conditional
szachiście	None
drgałyby	Conditional
izb	None
ryczy	None
siedziałybyście	Conditional
uosobieniach	None
polach	None
odjebalibyśmy	Conditional
wiosłowałby	Conditional
czerpałyby	Conditional
kłamcie	Imperative-Jussive
trąci	Imperative-Jussive
dyszelibyśmy	Conditional
podziwiałbym	Conditional
melodii	None
łaźmy	Imperative-Jussive
ukośniki	None
gnid	None
ogrodnikami	None
konkurowałby	Conditional
zgromadzeniu	None
dotykałby	Conditional
zawiedlibyście	Conditional
srałybyśmy	Conditional
pozostawałaby	Conditional
skrócilibyśmy	Conditional
sylabach	None
zniszczyłybyście	Conditional
niszczyłybyście	Conditional
uważałabym	Conditional
chciałyby	Conditional
karmiłbym	Conditional
poprowadziły	None
identyfikowałyby	Conditional
łasicami	None
napisz	Imperative-Jussive
pozwalałabym	Conditional
kupowalibyście	Conditional
iberyjskie	None
lizałaby	Conditional
ukryjcie	Imperative-Jussive
twierdziliby	Conditional
korzystałbyś	Conditional
posłuchałby	Conditional
kambodżańscy	None
zerwij	Imperative-Jussive
wisiałabyś	Conditional
oddałyby	Conditional
wkurwiałabyś	Conditional
odchodź	Imperative-Jussive
złamałabyś	Conditional
odbudowałyby	Conditional
plujcie	Imperative-Jussive
restauracji	None
wygrałbym	Conditional
psułabym	Conditional
zaczęłaby	Conditional
wąchałby	Conditional
dodatkową	None
zepnijcie	Imperative-Jussive
oglądaj	Imperative-Jussive
dramatycznego	None
pachnidłach	None
wisiałby	Conditional
zesraliby	Conditional
dekanie	None
garstka	None
rozbieżnościami	None
nierównościach	None
grubszej	None
eksperymentuj	Imperative-Jussive
oddychaliby	Conditional
cedziłby	Conditional
diagnozowałybyśmy	Conditional
Węgrzynowi	None
czekałem	None
maskowałyby	Conditional
gotowałby	Conditional
podejrzewałaby	Conditional
siedź	Imperative-Jussive
śledziłybyście	Conditional
wybralibyście	Conditional
kryj	Imperative-Jussive
kalendarzy	None
element	None
wyłudzilibyście	Conditional
nękajmy	Imperative-Jussive
kroiłby	Conditional
kładłybyśmy	Conditional
bazylii	None
proponowałabym	Conditional
obraziłybyśmy	Conditional
wystarczajcie	Imperative-Jussive
brzęczelibyśmy	Conditional
kłusowałabym	Conditional
genealogicznym	None
gromadziłybyście	Conditional
wymiotowałbym	Conditional
wdepnęliby	Conditional
analiza	None
zabijaj	Imperative-Jussive
bielszą	None
chadzałabyś	Conditional
wracałaby	Conditional
trzebiłyby	Conditional
zamarzaliby	Conditional
granicząc	None
uśpiłabym	Conditional
tygrys	None
milczałabyś	Conditional
wdepnąłbym	Conditional
ostatecznym	None
działajcie	Imperative-Jussive
czułoby	Conditional
odwiedzałabyś	Conditional
modliliby	Conditional
poprowadźmy	Imperative-Jussive
opowiadałabyś	Conditional
usługi	None
wylaszczyłyby	Conditional
chrzcijcie	Imperative-Jussive
odpoczęłaby	Conditional
przyniosłabym	Conditional
wisiałoby	Conditional
pokrywaliby	Conditional
czytałbyś	Conditional
przypominało	None
wyjaśniałoby	Conditional
lękałybyście	Conditional
ozdobach	None
rzeczywistościami	None
mieszkałbyś	Conditional
znaczna	None
popełnijmy	Imperative-Jussive
zniknęłybyśmy	Conditional
spadałyby	Conditional
odpoczniecie	None
wskazałoby	Conditional
połknęłyby	Conditional
alkoholikom	None
sprzątnąłbym	Conditional
nazywajcie	Imperative-Jussive
widziałybyśmy	Conditional
studiujmy	Imperative-Jussive
niknęłybyście	Conditional
rąbmy	Imperative-Jussive
narzekaj	Imperative-Jussive
próbowalibyście	Conditional
niknęliby	Conditional
śmietanie	None
analizowany	None
pospolici	None
płaćmy	Imperative-Jussive
lepsze	None
wybrałbym	Conditional
zabalsamowałyby	Conditional
sprawdzał	None
czerpmy	Imperative-Jussive
płaczący	None
podejrzewajmy	Imperative-Jussive
odraczaj	Imperative-Jussive
sprawdźcie	Imperative-Jussive
cnotliwego	None
zbiegałabyś	Conditional
rozmyślilibyście	Conditional
identyfikujcie	Imperative-Jussive
najsłabsza	None
drżałybyście	Conditional
homoseksualnymi	None
spodziewalibyśmy	Conditional
ciekłego	None
indowi	None
szeregiem	None
posiadalibyście	Conditional
organie	None
uciekałby	Conditional
kopiowalibyśmy	Conditional
zrozumiałbyś	Conditional
telefonujmy	Imperative-Jussive
podnieś	Imperative-Jussive
odwiedzałby	Conditional
najniższego	None
schowki	None
ignorowałybyście	Conditional
łuna	None
przyjmijmy	Imperative-Jussive
nizin	None
zrób	Imperative-Jussive
grzmielibyście	Conditional
tolerowałyby	Conditional
pożyczałybyście	Conditional
wpływaj	Imperative-Jussive
rybnym	None
odchodzimy	None
antymon	None
mamroczmy	Imperative-Jussive
kibicowałybyście	Conditional
połknęłybyście	Conditional
aroniom	None
filmowałabyś	Conditional
zakochaliby	Conditional
powiecie	None
usunęłybyście	Conditional
górskich	None
chełpiłabym	Conditional
miętowej	None
opowiadałybyście	Conditional
zmienialiby	Conditional
wymagaj	Imperative-Jussive
kradlibyście	Conditional
kój	Imperative-Jussive
sapmy	Imperative-Jussive
slawistycznym	None
trąciłabyś	Conditional
tyłom	None
gdakalibyśmy	Conditional
kotłownię	None
przepięknego	None
lękaliby	Conditional
zaciążyłybyście	Conditional
posłuchajcie	Imperative-Jussive
gdakaliby	Conditional
kupowałbym	Conditional
rozmywalibyście	Conditional
obiecałybyśmy	Conditional
kaszlelibyście	Conditional
formalista	None
kosztowałaby	Conditional
grabiłyby	Conditional
ćpając	None
jąkaliby	Conditional
trzebiłybyście	Conditional
podnieśmy	Imperative-Jussive
uderzaj	Imperative-Jussive
podlewałoby	Conditional
zdementowaliby	Conditional
połączyłabym	Conditional
analizowali	None
pojawiłoby	Conditional
opróżniłyby	Conditional
rozbiłby	Conditional
lapońską	None
słyszałyby	Conditional
poniemiecką	None
ignoruj	Imperative-Jussive
stepy	None
otrułabyś	Conditional
zjebałybyśmy	Conditional
oceniłyby	Conditional
poprawiłybyście	Conditional
paski	None
diagnozowałoby	Conditional
masażystą	None
całowałbym	Conditional
rozważ	Imperative-Jussive
złupiłbyś	Conditional
cofaliby	Conditional
kryptonie	None
metamorficznego	None
zimowałbym	Conditional
wspomniałbyś	Conditional
nadchodziłby	Conditional
przygotowaliby	Conditional
brodziłbyś	Conditional
dawaliby	Conditional
dźwigajcie	Imperative-Jussive
strzelałabyś	Conditional
ptaszka	None
Rosjankę	None
słynęlibyśmy	Conditional
rzygałbyś	Conditional
posiadalibyśmy	Conditional
smarkałybyśmy	Conditional
umów	Imperative-Jussive
parszywe	None
wyprasujcie	Imperative-Jussive
badalibyście	Conditional
zawiódłbym	Conditional
zaprowadziłabyś	Conditional
złośliwej	None
podchodźmy	Imperative-Jussive
biegający	None
odpoczywałaby	Conditional
dąsałbym	Conditional
faraon	None
wyrzuciłem	None
kapitanami	None
Kornwalijczyka	None
planowałabyś	Conditional
ratujmy	Imperative-Jussive
manifesty	None
denerwowałaby	Conditional
wspomnijcie	Imperative-Jussive
mięklibyście	Conditional
przodowalibyśmy	Conditional
plotkowanie	None
kosztujmy	Imperative-Jussive
żujcie	Imperative-Jussive
skłamałbym	Conditional
dowiedziałybyśmy	Conditional
tęsknilibyśmy	Conditional
oddychasz	None
naprawiałabyś	Conditional
kipienie	None
postradałabym	Conditional
pełzaliby	Conditional
zamachowcami	None
wianek	None
rzodkiewkami	None
sikaj	Imperative-Jussive
trudzie	None
hasałbyś	Conditional
widziałbym	Conditional
węszcie	Imperative-Jussive
wystarczałybyście	Conditional
praliby	Conditional
mordowałaby	Conditional
wystarczałbym	Conditional
potakiwalibyśmy	Conditional
grabiłbym	Conditional
oficjalne	None
zrobiłaby	Conditional
sąsiadce	None
szkutnik	None
znajdować	None
zjadłabyś	Conditional
dermatolodzy	None
posłuchałaby	Conditional
pokazywalibyśmy	Conditional
tajałybyście	Conditional
budzilibyśmy	Conditional
obalmy	Imperative-Jussive
śmierdź	Imperative-Jussive
przeczytaj	Imperative-Jussive
Andorczyków	None
gwiazdkach	None
spróbujmy	Imperative-Jussive
tęskniący	None
skracajcie	Imperative-Jussive
częściowemu	None
trzaskałbyś	Conditional
ostry	None
połączyło	None
żyłyby	Conditional
próbujcie	Imperative-Jussive
sprawdź	Imperative-Jussive
hipokryzji	None
zaciążyłem	None
ładowałby	Conditional
kosztowały	None
rozważalibyśmy	Conditional
potwierdziłby	Conditional
identyfikuj	Imperative-Jussive
ograniczajmy	Imperative-Jussive
przestrzegałabyś	Conditional
opatentowałby	Conditional
zdiagnozowałabyś	Conditional
wyznaczyłbyś	Conditional
wdepnąłbyś	Conditional
kręćcie	Imperative-Jussive
najemcę	None
altruisto	None
roślinożerco	None
nęciłyby	Conditional
tajałoby	Conditional
podziwiane	None
warczyłybyście	Conditional
martwiłaby	Conditional
ryczałaby	Conditional
obaliłbym	Conditional
smutałabym	Conditional
wsparłybyście	Conditional
grzeszylibyśmy	Conditional
cynobrowi	None
dwoiste	None
dokonywalibyście	Conditional
egzaminowaliby	Conditional
opróżniłybyście	Conditional
analizowałabym	Conditional
nakryłbym	Conditional
ćwiczyłby	Conditional
obiektowi	None
ukryłbym	Conditional
zainsynuowałabyś	Conditional
oceniłabym	Conditional
zamówmy	Imperative-Jussive
znałaby	Conditional
kolekcjonowalibyśmy	Conditional
chciej	Imperative-Jussive
uśpiłyby	Conditional
niknęłyby	Conditional
uczestniczmy	Imperative-Jussive
luminofory	None
parkujmy	Imperative-Jussive
nowojorskie	None
czekoladki	None
odpoczęłoby	Conditional
basami	None
szpinetom	None
parowałaby	Conditional
rzucalibyście	Conditional
związkowcem	None
pięciolinią	None
biegałby	Conditional
zamykałoby	Conditional
wzrokowi	None
wymagałybyśmy	Conditional
dotykamy	None
podochodź	Imperative-Jussive
bliznę	None
spadaj	Imperative-Jussive
lep	Imperative-Jussive
rozmyłoby	Conditional
oszczepów	None
urodźmy	Imperative-Jussive
sarkałyby	Conditional
komentowałaby	Conditional
nalewałaby	Conditional
rozmiarach	None
porządkiem	None
notowałby	Conditional
brodziłbym	Conditional
zaprowadziłoby	Conditional
starałyby	Conditional
korzystnym	None
zbyłybyśmy	Conditional
wymuś	Imperative-Jussive
zaprosiłabyś	Conditional
traktowaliby	Conditional
płońcie	Imperative-Jussive
broniłoby	Conditional
sapałybyście	Conditional
gorzelibyście	Conditional
nalewałyśmy	None
więźnijcie	Imperative-Jussive
rozróżniłabym	Conditional
łaknęlibyście	Conditional
napierdalałbym	Conditional
zmieniliby	Conditional
zaimportujcie	Imperative-Jussive
skróciłybyście	Conditional
pojawiłyby	Conditional
harowałoby	Conditional
owcza	None
tleliby	Conditional
zdiagnozowałaś	None
wyjaśnijcie	Imperative-Jussive
odkrywałyby	Conditional
rozmyślałbyś	Conditional
zabalsamowałoby	Conditional
obrabowałyby	Conditional
lazłabyś	Conditional
osądzie	None
gapiliby	Conditional
wszelkie	None
dostarczajcie	Imperative-Jussive
otworzyłybyśmy	Conditional
doceniałbym	Conditional
skończyłoby	Conditional
późniejszych	None
wygarnąłbym	Conditional
gaworzyłabyś	Conditional
dostawałybyście	Conditional
jajecznicy	None
traktowałabyś	Conditional
smerfach	None
guglałbym	Conditional
dachowymi	None
filmujmy	Imperative-Jussive
szczekałaby	Conditional
paliłby	Conditional
ruszaj	Imperative-Jussive
pogadało	None
zasłużyłabyś	Conditional
ciężarnymi	None
działybyśmy	Conditional
połknęlibyście	Conditional
puszczałabyś	Conditional
śniadajmy	Imperative-Jussive
mircie	None
traćmy	Imperative-Jussive
notujcie	Imperative-Jussive
fotografów	None
świeczników	None
usuwalibyście	Conditional
zniknij	Imperative-Jussive
rozważali	None
jeździłbyś	Conditional
zwierzęce	None
wybierałaby	Conditional
skąpcy	None
przepiłabym	Conditional
krążownikowi	None
kolekcjonujmy	Imperative-Jussive
psuj	Imperative-Jussive
wado	None
wspominalibyśmy	Conditional
dmuchałabym	Conditional
zapominaj	Imperative-Jussive
zamarzałyby	Conditional
dupczyłybyśmy	Conditional
zapierdalałybyśmy	Conditional
borówką	None
termodynamikę	None
dbajcie	Imperative-Jussive
gaśmy	Imperative-Jussive
zabijalibyśmy	Conditional
rzygaliby	Conditional
ograniczałaby	Conditional
dąsaj	Imperative-Jussive
wąchałbym	Conditional
przeprosiliby	Conditional
wysokościach	None
wymagałoby	Conditional
olbrzymką	None
traciłabyś	Conditional
kwaternionu	None
rodzynku	None
działałybyście	Conditional
odpocznijcie	Imperative-Jussive
szczałabyś	Conditional
uważałaby	Conditional
kibicowałby	Conditional
kolczykach	None
grzeszyłabym	Conditional
kłuj	Imperative-Jussive
dochód	None
wyrzuciłbym	Conditional
słomiana	None
stawaliby	Conditional
kaszlmy	Imperative-Jussive
kupi	None
wynajęłybyśmy	Conditional
uczestniczyliby	Conditional
przegapmy	Imperative-Jussive
wybieraj	Imperative-Jussive
wartościowemu	None
demontowałabyś	Conditional
przemyślałby	Conditional
porozmawiaj	Imperative-Jussive
wizytami	None
obserwowałybyśmy	Conditional
okrągłych	None
uczestniczyłybyśmy	Conditional
wyhaftowałbyś	Conditional
grobów	None
nakryłybyście	Conditional
alergenami	None
gadajmy	Imperative-Jussive
podlewaliby	Conditional
pobożne	None
fosforanach	None
czesałabym	Conditional
przepij	Imperative-Jussive
zaprzeczyłyby	Conditional
pianisty	None
przytul	Imperative-Jussive
straciłbym	Conditional
puściłby	Conditional
proponowałabyś	Conditional
podrywałybyście	Conditional
gadajcie	Imperative-Jussive
chciałaby	Conditional
kąsałby	Conditional
zamarzniętej	None
mutant	None
dbalibyście	Conditional
rewolwerach	None
linielibyście	Conditional
kładłaby	Conditional
poćmy	Imperative-Jussive
błyskałbym	Conditional
zatrzymałbym	Conditional
wzięłyby	Conditional
połykałyby	Conditional
lakoniczni	None
zamarzajcie	Imperative-Jussive
śpieszyłaby	Conditional
zbiegałaś	None
usunąłby	Conditional
wymiksujcie	Imperative-Jussive
Hiszpanie	None
poziomice	None
podpisałby	Conditional
warczyłybyśmy	Conditional
finaliści	None
zmieniłaby	Conditional
więdnęłabyś	Conditional
dezodorant	None
lakoniczną	None
zdobiąc	None
dostarczałaby	Conditional
poprzedzaj	Imperative-Jussive
dbałbym	Conditional
numerowałyby	Conditional
wylogowałyby	Conditional
gromadź	Imperative-Jussive
palilibyśmy	Conditional
drżelibyście	Conditional
obozem	None
wołałbyś	Conditional
wiejmy	Imperative-Jussive
rama	None
mieszkajcie	Imperative-Jussive
maściach	None
lutowałoby	Conditional
przyjmowalibyście	Conditional
pokonałby	Conditional
dręczmy	Imperative-Jussive
kontrastu	None
tłumacz	Imperative-Jussive
bywałby	Conditional
nalewaj	Imperative-Jussive
trzaskałaby	Conditional
graniczylibyśmy	Conditional
rządziłybyście	Conditional
wyjaśnilibyśmy	Conditional
odpoczywajmy	Imperative-Jussive
rozróżnij	Imperative-Jussive
uznawalibyśmy	Conditional
samogłoską	None
spotkajmy	Imperative-Jussive
padalibyśmy	Conditional
edytujcie	Imperative-Jussive
rzemieślnikowi	None
szpilkami	None
węszyłyby	Conditional
pianistom	None
meksykańskiemu	None
ratowałbyś	Conditional
uczęszczałybyśmy	Conditional
rejestrach	None
zabiłabyś	Conditional
zaufałbyś	Conditional
drumle	None
napierdalałyby	Conditional
brzoskwiniami	None
ławeczek	None
abdykacją	None
broiłaby	Conditional
zrobiłybyście	Conditional
produkujmy	Imperative-Jussive
brudziłby	Conditional
zagięłaby	Conditional
poróżniłby	Conditional
rosy	None
rozczarowalibyśmy	Conditional
wysiadłbym	Conditional
środki	None
rozmyślałabyś	Conditional
konstytucjom	None
pustelnicy	None
dąsałabyś	Conditional
usunąłem	None
wskazałbyś	Conditional
rodź	Imperative-Jussive
cytowałaby	Conditional
sialibyśmy	Conditional
rozważyłyby	Conditional
polowalibyście	Conditional
namawialibyście	Conditional
gwizdałbyś	Conditional
pocieszmy	Imperative-Jussive
lgnęłoby	Conditional
szkunerem	None
zarabiałoby	Conditional
parkowałoby	Conditional
poprowadziłybyście	Conditional
przeżuwaczy	None
szponie	None
edytowałoby	Conditional
wymyślałybyśmy	Conditional
emocja	None
wykorzystuj	Imperative-Jussive
robiłbym	Conditional
sprawdziłbyś	Conditional
zawiódłeś	None
rozpaczałoby	Conditional
nadepnęłybyście	Conditional
twierdź	Imperative-Jussive
dymałoby	Conditional
przepiłabyś	Conditional
niknęłybyśmy	Conditional
zapraszałoby	Conditional
pokazywalibyście	Conditional
rzeklibyście	Conditional
gnałbym	Conditional
zerżnąłbym	Conditional
przeinaczyłyby	Conditional
stanowiłoby	Conditional
denerwowałbym	Conditional
odebrałyby	Conditional
wiejski	None
dręczyłybyśmy	Conditional
posiłku	None
oddałybyście	Conditional
oskarżeń	None
zamknęłybyście	Conditional
skłamaliby	Conditional
spadałybyśmy	Conditional
przeżulibyście	Conditional
chadzalibyśmy	Conditional
skrzypiałybyśmy	Conditional
rozważałyby	Conditional
znikajcie	Imperative-Jussive
obrażająca	None
powtórzyłaby	Conditional
doprowadzałabyś	Conditional
palaczy	None
wylogowałybyście	Conditional
cudzołożyłyby	Conditional
najzwięźlejszego	None
kiełbasy	None
zdobilibyście	Conditional
radiowozie	None
zrabowałem	None
zgubiłbyś	Conditional
szlachcic	None
wytryskiwalibyśmy	Conditional
silnego	None
skróciłbym	Conditional
pojazdy	None
felgami	None
wyhaftowałybyście	Conditional
policzkowi	None
poprawilibyście	Conditional
oglądalibyśmy	Conditional
jonizujmy	Imperative-Jussive
różo	None
przypominałybyśmy	Conditional
łaźcie	Imperative-Jussive
planowałybyśmy	Conditional
najwybitniejszą	None
poznałby	Conditional
zamykaliby	Conditional
uciekałabym	Conditional
kimalibyście	Conditional
wąchałabyś	Conditional
szpadel	None
składałabyś	Conditional
słuchałoby	Conditional
gardzicie	None
rosłybyście	Conditional
skończcie	Imperative-Jussive
wahalibyście	Conditional
czytałby	Conditional
wódek	None
dodzwoniłybyście	Conditional
najczarniejszą	None
dyniowy	None
kucaj	Imperative-Jussive
biurokrację	None
śpiewałyby	Conditional
dymnych	None
pogadalibyśmy	Conditional
proroctwami	None
nakryłaby	Conditional
pląsałby	Conditional
asparagina	None
identyfikowałybyśmy	Conditional
schowaliby	Conditional
wyjebałaby	Conditional
wywołałybyście	Conditional
ławkę	None
wykopałby	Conditional
najświeższej	None
zaklęciem	None
sprzątnęłybyście	Conditional
telefonowałabyś	Conditional
Persowie	None
zbierałem	None
slawista	None
zamknęłoby	Conditional
rozróżnijcie	Imperative-Jussive
brus	None
znikałyby	Conditional
spuszczałbyś	Conditional
przeżułybyście	Conditional
estetyzm	None
kareta	None
ocaliłabyś	Conditional
obgadałabym	Conditional
pogardliwej	None
migdałowiec	None
porannej	None
spałaszowałybyśmy	Conditional
przytulilibyśmy	Conditional
igrałybyśmy	Conditional
ametystowym	None
wykopała	None
zwierzęcia	None
dębowymi	None
słynęłabyś	Conditional
przyjemność	None
cisi	None
stawałby	Conditional
należ	Imperative-Jussive
płakałabyś	Conditional
poprowadzilibyśmy	Conditional
demontowałybyście	Conditional
ruń	Imperative-Jussive
czyń	Imperative-Jussive
pękłbyś	Conditional
burko	None
wybrałabyś	Conditional
doceniałabyś	Conditional
zamknijmy	Imperative-Jussive
znosilibyśmy	Conditional
tatarami	None
grama	None
połykaj	Imperative-Jussive
napowietrzyłabym	Conditional
wyruchałbyś	Conditional
żądłem	None
doprowadzałoby	Conditional
rozmyślałybyśmy	Conditional
spojówkom	None
galopowałbyś	Conditional
napisałbyś	Conditional
zbierze	None
pokonaj	Imperative-Jussive
połykacie	None
szatach	None
zarżnęłoby	Conditional
srałaby	Conditional
znalazłyby	Conditional
znalazłabym	Conditional
ujebałybyście	Conditional
trzymajmy	Imperative-Jussive
wykrwawilibyśmy	Conditional
napowietrzcie	Imperative-Jussive
eksperymentujmy	Imperative-Jussive
ujebmy	Imperative-Jussive
przysięgałabyś	Conditional
koiłyby	Conditional
łamcie	Imperative-Jussive
obiecujmy	Imperative-Jussive
sprzątnęliby	Conditional
zmieniaj	Imperative-Jussive
dęby	None
pląsałyby	Conditional
dobądź	Imperative-Jussive
produkuj	Imperative-Jussive
podpaliłby	Conditional
wierzący	None
wymagałby	Conditional
tęcze	None
absorbowałbym	Conditional
wróżki	None
papugi	None
szczułbyś	Conditional
kleiłybyście	Conditional
wahałabym	Conditional
burz	Imperative-Jussive
portowcach	None
przedmałżeńska	None
miewaliśmy	None
mieczem	None
obiektywnej	None
dymiłbym	Conditional
cedziłbym	Conditional
samico	None
rozczaruj	Imperative-Jussive
chciałby	Conditional
samuraja	None
wyrzuciłabym	Conditional
zachowaliby	Conditional
dostawalibyśmy	Conditional
ogarniałby	Conditional
wahałabyś	Conditional
umieralibyśmy	Conditional
zarabiałabym	Conditional
pisałbym	Conditional
mądrzyłyby	Conditional
skacz	Imperative-Jussive
bębnij	Imperative-Jussive
tenisistom	None
ziębnąłbym	Conditional
oddawaj	Imperative-Jussive
bywalcom	None
olałyby	Conditional
nadużywaj	Imperative-Jussive
mierzili	None
smarkajcie	Imperative-Jussive
facetów	None
przypominalibyśmy	Conditional
ludojadowi	None
przynoś	Imperative-Jussive
skręćmy	Imperative-Jussive
najzdolniejszy	None
rozmyślałybyście	Conditional
przypomniałaby	Conditional
przygotowałyby	Conditional
pieprzyłaby	Conditional
przyniósłby	Conditional
skromniejszą	None
wybuchnęłoby	Conditional
kosilibyśmy	Conditional
wyniosłybyśmy	Conditional
watykańskiego	None
rozważylibyśmy	Conditional
padałbym	Conditional
obwodami	None
lateksem	None
grzebałyby	Conditional
najpoważniejszych	None
posłuchałbym	Conditional
czekalibyście	Conditional
dżudokami	None
sabotowałyby	Conditional
skończyliby	Conditional
kajman	None
purystą	None
poprawcie	Imperative-Jussive
błyskałabyś	Conditional
działybyście	Conditional
dedykowałbyś	Conditional
żylibyśmy	Conditional
zamordowalibyśmy	Conditional
zawodowego	None
poznałabyś	Conditional
zasłużyłoby	Conditional
drozda	None
płać	Imperative-Jussive
groziłybyśmy	Conditional
pokazywaliby	Conditional
łamałaby	Conditional
czezłabyś	Conditional
straciliby	Conditional
męczyłbym	Conditional
kontynent	None
krwawmy	Imperative-Jussive
pytałaby	Conditional
składałby	Conditional
wskazałybyśmy	Conditional
bankomatowi	None
śmierdziałybyśmy	Conditional
oszukiwałybyście	Conditional
skrzypialiby	Conditional
majonezowi	None
problematycznymi	None
napisalibyście	Conditional
składałybyście	Conditional
nastolatków	None
odbierałybyśmy	Conditional
kartezjańskie	None
włączałby	Conditional
przypominałyby	Conditional
pieprzyłoby	Conditional
kretynie	None
odwiedzałbym	Conditional
linielibyśmy	Conditional
dobrowolną	None
kuframi	None
wykopałbym	Conditional
migdałowego	None
wyłudziłybyście	Conditional
otrzymałbym	Conditional
umawiajmy	Imperative-Jussive
złupiłoby	Conditional
dźwigałbyś	Conditional
przelecielibyśmy	Conditional
drapieżnikowi	None
rzadsza	None
podróżowałabyś	Conditional
rozwiązałabym	Conditional
smarkałby	Conditional
nieszkodliwy	None
mocz	Imperative-Jussive
węgłów	None
kryłbym	Conditional
robakom	None
wiadukt	None
odczyniłbyś	Conditional
przezimowałabyś	Conditional
produkowałybyśmy	Conditional
narzekałby	Conditional
dbałbyś	Conditional
nadzorowalibyście	Conditional
popierania	None
dziej	Imperative-Jussive
wymiotowalibyście	Conditional
roztrzep	Imperative-Jussive
dostarczałabyś	Conditional
schnąłbym	Conditional
przekomarzaj	Imperative-Jussive
kicalibyśmy	Conditional
pokazywałabyś	Conditional
drylowałbyś	Conditional
postradalibyście	Conditional
poprowadziliby	Conditional
produkowalibyście	Conditional
machałabym	Conditional
pogadałoby	Conditional
nazywaj	Imperative-Jussive
pietruszkach	None
kwil	Imperative-Jussive
papo	None
kochajmy	Imperative-Jussive
chwiej	Imperative-Jussive
wymyśliłoby	Conditional
skakałybyście	Conditional
wyłudziłaby	Conditional
dawałbym	Conditional
symulujcie	Imperative-Jussive
restaurację	None
liżcie	Imperative-Jussive
dusiłbym	Conditional
przytulił	None
otworzyłbyś	Conditional
rozgwiazd	None
piętą	None
dosrałybyśmy	Conditional
ucz	Imperative-Jussive
gliniany	None
dojrzałybyście	Conditional
paruje	None
dziesiętnego	None
spichlerza	None
zachodziłoby	Conditional
skracałbyś	Conditional
masztami	None
zachodziłbyś	Conditional
otworzyłbym	Conditional
wykorzystywano	None
zadałbym	Conditional
obalałybyście	Conditional
śpiewałbyś	Conditional
przypuśćmy	Imperative-Jussive
gorzałabyś	Conditional
oddawałbyś	Conditional
płatna	None
sikaliby	Conditional
kwiatami	None
wzięlibyśmy	Conditional
wjazdami	None
laskom	None
cytowałyby	Conditional
odwiedzaj	Imperative-Jussive
oskarżająca	None
blog	None
wywiadom	None
ochronną	None
jeździłby	Conditional
znalazłaby	Conditional
szanowaliby	Conditional
drzem	Imperative-Jussive
wspomniałabyś	Conditional
casting	None
chadzałoby	Conditional
apostrofy	None
głosuj	Imperative-Jussive
zalogowaliby	Conditional
zachowaj	Imperative-Jussive
kapkę	None
chełpcie	Imperative-Jussive
wietrznego	None
siąknąłybyście	Conditional
wyrzućcie	Imperative-Jussive
negocjowałybyście	Conditional
sądziłabym	Conditional
pojaw	Imperative-Jussive
pobrałybyście	Conditional
wołałybyście	Conditional
trać	Imperative-Jussive
przytuliłaby	Conditional
znajdujcie	Imperative-Jussive
notowałybyśmy	Conditional
numerowałbyś	Conditional
wyłabym	Conditional
analizowalibyśmy	Conditional
grabiłbyś	Conditional
poparcia	None
podalibyście	Conditional
esemesowałabym	Conditional
parkowałbym	Conditional
małpowalibyście	Conditional
wiosłowałabym	Conditional
ujadałbym	Conditional
podochodźmy	Imperative-Jussive
oceńcie	Imperative-Jussive
poruchalibyśmy	Conditional
pszczołami	None
drukuj	Imperative-Jussive
chrzciłoby	Conditional
obejmowałabym	Conditional
otworzylibyście	Conditional
poprowadzilibyście	Conditional
drylowałaby	Conditional
charkalibyście	Conditional
konkurowałabyś	Conditional
wracalibyście	Conditional
gnijcie	Imperative-Jussive
poprzedzałby	Conditional
błyskaj	Imperative-Jussive
złamałby	Conditional
pojawiajmy	Imperative-Jussive
szukałabym	Conditional
umówcie	Imperative-Jussive
pokonałbym	Conditional
notowałabyś	Conditional
kompilowałbym	Conditional
kwiliłabym	Conditional
podaj	Imperative-Jussive
mierziłbyś	Conditional
kostucha	None
dodawałby	Conditional
badaliby	Conditional
eksportowałby	Conditional
naprawialibyście	Conditional
gryzłabym	Conditional
zdementowalibyśmy	Conditional
bluzgałabyś	Conditional
niżów	None
kastrowało	None
ortodoksyjnymi	None
dementowałabyś	Conditional
ukrywalibyście	Conditional
rzucający	None
ostrzegałabym	Conditional
dziejcie	Imperative-Jussive
poprowadźcie	Imperative-Jussive
świetności	None
pokonałybyśmy	Conditional
nazywalibyście	Conditional
egzaminowalibyście	Conditional
blokowiskiem	None
lizyno	None
urodzinowych	None
nurkowaliby	Conditional
pielgrzym	None
wyglądalibyście	Conditional
czasomierzu	None
zamożnymi	None
gołąbkami	None
śródziemnomorskimi	None
podróżowałbym	Conditional
krzemowy	None
kładziony	None
podchodziłyby	Conditional
gwałciłybyście	Conditional
spróbuj	Imperative-Jussive
straciłbyś	Conditional
absurdalnego	None
gilem	None
pojawiłby	Conditional
uzusy	None
zapamiętałyby	Conditional
rąbałybyście	Conditional
wymówiłbyś	Conditional
trzymałabyś	Conditional
gorzałabym	Conditional
brzęczałoby	Conditional
napierdalałbyś	Conditional
kręciłoby	Conditional
smakowalibyśmy	Conditional
pokuta	None
wierzyciel	None
poróżniłoby	Conditional
Xboksie	None
żłobkiem	None
koiliby	Conditional
drzemałabyś	Conditional
jebnąłbyś	Conditional
śmierdzieliby	Conditional
starajmy	Imperative-Jussive
łaziłabyś	Conditional
susz	Imperative-Jussive
ścignęłabym	Conditional
więźlibyście	Conditional
spieprzmy	Imperative-Jussive
mierzylibyście	Conditional
Fenicjaninowi	None
Hindusów	None
obejmowałaby	Conditional
mieszkałby	Conditional
spieprzcie	Imperative-Jussive
martw	Imperative-Jussive
podochodziłbym	Conditional
nauczyciel	None
pałaców	None
lgnęłyby	Conditional
kusiłabyś	Conditional
rosłoby	Conditional
najlżejszym	None
tolerowałybyśmy	Conditional
spuszczałaby	Conditional
spieprzyłabym	Conditional
posiadajmy	Imperative-Jussive
zerkałybyście	Conditional
marzyłbyś	Conditional
śnieżce	None
opisuj	Imperative-Jussive
wędrowaliby	Conditional
zachowałabyś	Conditional
brzęcz	Imperative-Jussive
śmiertelne	None
spieszylibyśmy	Conditional
odraczałybyście	Conditional
otrzymywałyby	Conditional
niektórymi	None
botanika	None
odkryta	None
podpisalibyśmy	Conditional
łechtaczkę	None
prałabym	Conditional
rozmawiałaby	Conditional
kochałabyś	Conditional
mulczowałybyście	Conditional
foremnych	None
zebrałoby	Conditional
organizowałaby	Conditional
nadgorliwością	None
uznawajmy	Imperative-Jussive
maszerowałybyście	Conditional
nazywałoby	Conditional
zastanawiajcie	Imperative-Jussive
módlcie	Imperative-Jussive
śledź	Imperative-Jussive
skróciłaby	Conditional
winogronową	None
deflacji	None
dodałby	Conditional
chlebowi	None
refuj	Imperative-Jussive
umierałbyś	Conditional
żargonowi	None
kacem	None
zamordowałybyśmy	Conditional
wyjaśniajmy	Imperative-Jussive
pogadałybyśmy	Conditional
pozwalałby	Conditional
chroniliby	Conditional
wyglądasz	None
grzeszmy	Imperative-Jussive
przygotowalibyście	Conditional
dodawałybyście	Conditional
koilibyśmy	Conditional
czyściłybyście	Conditional
niską	None
żniwiarzem	None
kucaliby	Conditional
chełpiłoby	Conditional
róbmy	Imperative-Jussive
roztrzepałabym	Conditional
dwutygodniowe	None
jebnęłyby	Conditional
znak	None
ratowałby	Conditional
matematykom	None
zrabowałaby	Conditional
krzyżykami	None
gepard	None
ćpałby	Conditional
usunęliby	Conditional
guglałem	None
wytłumaczcie	Imperative-Jussive
agresywnemu	None
zarezerwowałybyśmy	Conditional
zachorowałoby	Conditional
sprzątnijcie	Imperative-Jussive
pożyczcie	Imperative-Jussive
obrażajcie	Imperative-Jussive
zainsynuowali	None
przodowałaby	Conditional
rozróżniliby	Conditional
ściągnęłbym	Conditional
drapie	None
telegrafowałybyśmy	Conditional
ripostowalibyśmy	Conditional
zbiegałbyś	Conditional
muzykiem	None
lizałbyś	Conditional
polecajcie	Imperative-Jussive
pokazywałybyście	Conditional
twórzmy	Imperative-Jussive
pochodna	None
działoby	Conditional
bus	None
kłamstwo	None
dźwigałbym	Conditional
składałbyś	Conditional
majsterkowalibyśmy	Conditional
płytsze	None
pokrywałybyśmy	Conditional
posłuchałabym	Conditional
znoście	Imperative-Jussive
slawistyczni	None
zręczna	None
podkradałybyśmy	Conditional
częstemu	None
ukrywałby	Conditional
rasiści	None
zaczynałabyś	Conditional
promach	None
wydupczyłbyś	Conditional
nęciłabym	Conditional
połykałoby	Conditional
krzyczałoby	Conditional
wzięłybyśmy	Conditional
poprzedzaliby	Conditional
zapamiętałybyście	Conditional
żartujmy	Imperative-Jussive
dżdżów	None
piekłem	None
podpisaliby	Conditional
tłumaczyłbym	Conditional
zauważyłbyś	Conditional
hojny	None
cytuj	Imperative-Jussive
ogarniajcie	Imperative-Jussive
odradzałabym	Conditional
widź	Imperative-Jussive
napastnikiem	None
przereklamowanej	None
zamężnej	None
piesków	None
zazdrośćcie	Imperative-Jussive
dolnołużyckie	None
potwierdzałybyście	Conditional
kilometrówek	None
bliźnimi	None
wydupczyłybyśmy	Conditional
numerowałabym	Conditional
łotra	None
zapaliłybyście	Conditional
hamowałabyś	Conditional
urodziłabyś	Conditional
iskałyby	Conditional
pomagałabym	Conditional
siusiałaby	Conditional
rozmywałby	Conditional
ratowalibyście	Conditional
sądziłoby	Conditional
zweryfikowałaby	Conditional
mambo	None
oglądajmy	Imperative-Jussive
zadzwoń	Imperative-Jussive
rozróżniajcie	Imperative-Jussive
planuj	Imperative-Jussive
łozo	None
poprawialibyśmy	Conditional
przyjacielowi	None
dokonywałabym	Conditional
pojmowalibyście	Conditional
drapałybyście	Conditional
ocaliłaś	None
zbiegajmy	Imperative-Jussive
bojałby	Conditional
obrabowałabym	Conditional
wymiksowalibyście	Conditional
przyjemniejszym	None
brązowemu	None
ukrywałbym	Conditional
pojmujcie	Imperative-Jussive
uderzałabyś	Conditional
dziwilibyśmy	Conditional
mężczyznami	None
dąsałby	Conditional
czesalibyście	Conditional
hasałybyśmy	Conditional
ufajcie	Imperative-Jussive
kładłbym	Conditional
decyzjach	None
korzystałby	Conditional
dźwigalibyśmy	Conditional
moreli	None
zerowałbyś	Conditional
przeszkadzałybyśmy	Conditional
najtrwalszych	None
podnieście	Imperative-Jussive
trzymałoby	Conditional
akronimu	None
rozpaczałaby	Conditional
jmijcie	Imperative-Jussive
oddałaby	Conditional
zwyciężałoby	Conditional
znikało	None
mijajmy	Imperative-Jussive
igłami	None
ruszałby	Conditional
żwacza	None
diagnozuj	Imperative-Jussive
trzaskają	None
kukalibyśmy	Conditional
odbijałby	Conditional
potwierdzałoby	Conditional
puściłoby	Conditional
ćwiartką	None
lubczyk	None
mordowałabym	Conditional
kicałabyś	Conditional
wstawajcie	Imperative-Jussive
logarytmie	None
lelkami	None
zniknijmy	Imperative-Jussive
leczyłby	Conditional
jadajcie	Imperative-Jussive
zmienione	None
związkowca	None
siewcami	None
schlebiałabym	Conditional
ruchaj	Imperative-Jussive
pogrzebaliby	Conditional
włókno	None
odbieraliby	Conditional
planowałoby	Conditional
oszukać	None
wykorzystywalibyśmy	Conditional
galopowalibyście	Conditional
lizałyby	Conditional
kochałby	Conditional
zrzućmy	Imperative-Jussive
zrozum	Imperative-Jussive
otaczajmy	Imperative-Jussive
pedalarz	None
westernach	None
wołałbym	Conditional
tygrysicach	None
bronił	None
lansowałaby	Conditional
sarkajmy	Imperative-Jussive
medytuj	Imperative-Jussive
protektoratów	None
wędrowałabyś	Conditional
oddychałbyś	Conditional
pożyczyłaby	Conditional
zjadłbym	Conditional
mózg	None
czyniłyby	Conditional
czyniłoby	Conditional
zagrożeniem	None
podziwiałabyś	Conditional
przeżuliby	Conditional
spięłabym	Conditional
liż	Imperative-Jussive
chrzciłaby	Conditional
ciężkie	None
uderzmy	Imperative-Jussive
zaruchalibyście	Conditional
kajajcie	Imperative-Jussive
pokrywałyby	Conditional
bredziłby	Conditional
zasługujmy	Imperative-Jussive
podnosiłaby	Conditional
szalonymi	None
tlej	Imperative-Jussive
ujadaj	Imperative-Jussive
wyjaśniłaby	Conditional
włączałaby	Conditional
podzbiorem	None
wyniósłbym	Conditional
zmieniałbyś	Conditional
zaimportowałyby	Conditional
pociłyby	Conditional
wyświetlalibyśmy	Conditional
wdychalibyście	Conditional
przygotowałby	Conditional
wyruchalibyście	Conditional
przedmówcą	None
znajdowałoby	Conditional
dawcę	None
odpoczywałbym	Conditional
wydumane	None
grzechu	None
bytami	None
zadałbyś	Conditional
klęczałaby	Conditional
płynęlibyśmy	Conditional
wdzięczniejsza	None
epidemiom	None
gwałcicielem	None
więźlibyśmy	Conditional
analizowałbyś	Conditional
kładźmy	Imperative-Jussive
absorbowałyby	Conditional
podpierdolcie	Imperative-Jussive
organizowałbym	Conditional
rozbiwszy	None
samogonowi	None
kosztowałoby	Conditional
upuściłyby	Conditional
betonowa	None
dotykałaby	Conditional
rozważajcie	Imperative-Jussive
dziękowałaby	Conditional
agresję	None
paliłabym	Conditional
leczyliby	Conditional
ekskomunika	None
wyrządzilibyśmy	Conditional
wędkarze	None
zamknęłyby	Conditional
bredziłbyś	Conditional
zostawiłybyście	Conditional
banglajcie	Imperative-Jussive
siostrzeńców	None
podpisałybyśmy	Conditional
odkrylibyśmy	Conditional
mamutem	None
dymilibyśmy	Conditional
lgnęlibyście	Conditional
wyłudzałoby	Conditional
groziłyby	Conditional
wyznaczyłabym	Conditional
odrzuciłbym	Conditional
towarzyskimi	None
pojawiałabyś	Conditional
powstań	None
drzemałby	Conditional
znoś	Imperative-Jussive
posiadałybyście	Conditional
pokazałabym	Conditional
pocieszyłybyśmy	Conditional
żurawiną	None
brzeg	None
zebraliby	Conditional
rządź	Imperative-Jussive
jebnij	Imperative-Jussive
płytami	None
zaprowadzilibyście	Conditional
łasic	None
kniazia	None
całowalibyśmy	Conditional
analizuj	Imperative-Jussive
wyrządziłyby	Conditional
szwagierkami	None
abonowaniu	None
napisałoby	Conditional
chowałoby	Conditional
futrzaki	None
parzydełkowców	None
prawosławni	None
wygarnęłaby	Conditional
ziemia	None
poiłbyś	Conditional
wierteł	None
charkałabyś	Conditional
cytowałoby	Conditional
sołectwie	None
dźwignęłybyście	Conditional
zwyciężajmy	Imperative-Jussive
skróciło	None
paruj	Imperative-Jussive
zdobiłaby	Conditional
zrabowałoby	Conditional
niepełnosprawni	None
skąpą	None
ekranizacje	None
bluzgałoby	Conditional
demontowałby	Conditional
jarzębu	None
zadzwoniłyby	Conditional
zbierałoby	Conditional
wyjaśniani	None
rozwiązałby	Conditional
zmartwychwstawałyby	Conditional
gorzałoby	Conditional
plotkowałby	Conditional
przesadzalibyście	Conditional
podkradałybyście	Conditional
zalogowałbym	Conditional
czeźlibyśmy	Conditional
mróweczki	None
wyłudziłby	Conditional
otrulibyście	Conditional
sprzątnęłoby	Conditional
dałaby	Conditional
przeprosilibyście	Conditional
polecaj	Imperative-Jussive
utleńmy	Imperative-Jussive
fruwałby	Conditional
kogutów	None
opróżniłbym	Conditional
mieszałbym	Conditional
stracilibyście	Conditional
zamknijcie	Imperative-Jussive
zamknęliby	Conditional
wymagano	None
zjadłbyś	Conditional
nazywałaby	Conditional
sławną	None
tlelibyśmy	Conditional
ograniczałoby	Conditional
rzuciłybyście	Conditional
włączane	None
obejmowaliby	Conditional
rzecznych	None
wyłudzalibyście	Conditional
storczyk	None
najciekawsza	None
naleśnika	None
bywałbyś	Conditional
wymyślmy	Imperative-Jussive
mrugaliby	Conditional
dochodziłoby	Conditional
burmistrzami	None
zupie	None
alkinach	None
trzymaj	Imperative-Jussive
poroniłbym	Conditional
eksportuj	Imperative-Jussive
burzyłby	Conditional
zrozumiałabyś	Conditional
odbieraj	Imperative-Jussive
siadałby	Conditional
edytowałbym	Conditional
endemicznym	None
zweryfikowałybyście	Conditional
połknęłybyśmy	Conditional
zimowałby	Conditional
ostrzeżeniem	None
działaj	Imperative-Jussive
medytowałabym	Conditional
kłułabyś	Conditional
słuchaliby	Conditional
drukowałybyście	Conditional
pisałbyś	Conditional
dowiedziałoby	Conditional
elektrolicie	None
tolerowałbyś	Conditional
dobami	None
przyjmowaliby	Conditional
grzybobranie	None
mruczcie	Imperative-Jussive
dmuchałybyście	Conditional
czytajmy	Imperative-Jussive
rycz	Imperative-Jussive
puściłbym	Conditional
mieszkalibyśmy	Conditional
zbądźcie	Imperative-Jussive
przynosiliby	Conditional
wyświetlalibyście	Conditional
poprowadź	Imperative-Jussive
rozwiązałoby	Conditional
ujadałby	Conditional
poróżnij	Imperative-Jussive
wytłumaczyłbym	Conditional
dokonywałabyś	Conditional
parowaliby	Conditional
realistycznym	None
fotografiach	None
czyniłybyście	Conditional
milcz	Imperative-Jussive
wyjaśniłybyśmy	Conditional
dusilibyśmy	Conditional
opowiadajmy	Imperative-Jussive
księżycami	None
chory	None
przeczytalibyśmy	Conditional
administracji	None
koszmarami	None
trwałybyśmy	Conditional
schowalibyście	Conditional
kwililibyśmy	Conditional
porozmawiajmy	Imperative-Jussive
dwuwymiarowi	None
wylogowania	None
iskałbym	Conditional
cofanie	None
menor	None
oglądałaby	Conditional
złożylibyście	Conditional
jądru	None
sterczmy	Imperative-Jussive
żyłbym	Conditional
posiadałaby	Conditional
mierzyłybyście	Conditional
gotyckiej	None
ślubowi	None
zamordowałabyś	Conditional
kolonistę	None
raziłybyście	Conditional
badalibyśmy	Conditional
rozproszyłabyś	Conditional
zapomnisz	None
grzeszyłby	Conditional
aberracjom	None
szlafrokowi	None
zachodziłbym	Conditional
nęćmy	Imperative-Jussive
czuła	None
drewnianego	None
odrzuć	Imperative-Jussive
zwymyślałbyś	Conditional
szanowalibyście	Conditional
duście	Imperative-Jussive
bródźmy	Imperative-Jussive
oskarżali	None
okrutnemu	None
zerwałybyśmy	Conditional
lansowałybyście	Conditional
filmowałabym	Conditional
badaj	Imperative-Jussive
wywoływałyby	Conditional
uwielbiałby	Conditional
zaprosiłbym	Conditional
śledźmy	Imperative-Jussive
chwaliłaby	Conditional
usuwaj	Imperative-Jussive
czyniłaby	Conditional
średnica	None
uśpijcie	Imperative-Jussive
skazałybyśmy	Conditional
poprawili	None
czad	None
dusiliby	Conditional
odpoczywalibyśmy	Conditional
stopniem	None
bredziłyby	Conditional
przeżułaby	Conditional
zabiłby	Conditional
zauważyłabyś	Conditional
kopałyby	Conditional
błyskalibyście	Conditional
odjebcie	Imperative-Jussive
żartowałby	Conditional
rzekłybyśmy	Conditional
karm	Imperative-Jussive
poprawniejszą	None
telegrafuj	Imperative-Jussive
egzaminuj	Imperative-Jussive
zniszczyłby	Conditional
nadużywałybyście	Conditional
zniknęłabyś	Conditional
rodzilibyście	Conditional
dźwignąłby	Conditional
manifestach	None
łaziłabym	Conditional
śledziłbyś	Conditional
wstążką	None
gitarzyście	None
kłusowałaby	Conditional
myliło	None
rozpaczalibyście	Conditional
pomagałbym	Conditional
kreatywnym	None
zastanawiaj	Imperative-Jussive
promieniom	None
przesadzałbym	Conditional
kompilowałabym	Conditional
żyłoby	Conditional
harowaliśmy	None
zainsynuowalibyście	Conditional
zadalibyśmy	Conditional
neolitycznej	None
daliby	Conditional
pomagaliby	Conditional
runąwszy	None
wykop	Imperative-Jussive
harowałabyś	Conditional
liściasta	None
poznałbym	Conditional
kwiatowych	None
kryliby	Conditional
zawiedź	Imperative-Jussive
unikałbyś	Conditional
kserujmy	Imperative-Jussive
googlowalibyśmy	Conditional
smakuj	Imperative-Jussive
wahaj	Imperative-Jussive
skłamałybyśmy	Conditional
wyglądałyby	Conditional
pokaż	Imperative-Jussive
wtórne	None
przydomki	None
dokonałby	Conditional
uznawałoby	Conditional
chłeptalibyście	Conditional
pozwalałbyś	Conditional
otrułybyście	Conditional
dumałabyś	Conditional
unikałabyś	Conditional
mrzyjmy	Imperative-Jussive
rzucilibyśmy	Conditional
grzązłbym	Conditional
krwawiłabym	Conditional
zmieniajmy	Imperative-Jussive
znaczmy	Imperative-Jussive
odpoczywałam	None
pederastach	None
interpunkcyjne	None
odradzające	None
wymóżmy	Imperative-Jussive
pękałabyś	Conditional
groźmy	Imperative-Jussive
liniejcie	Imperative-Jussive
mors	None
strzelcy	None
rozmyliśmy	None
dochodzilibyśmy	Conditional
ruchałby	Conditional
mosiężnego	None
rozważałby	Conditional
żyjcie	Imperative-Jussive
odjebałyby	Conditional
zaprowadziłabym	Conditional
kładłbyś	Conditional
śpiewajcie	Imperative-Jussive
sunęłabyś	Conditional
różnobarwnym	None
niewystarczającą	None
przegrałaby	Conditional
dolinach	None
sprawiała	None
wytłumaczylibyśmy	Conditional
ściąga	None
oskarżaj	Imperative-Jussive
machałybyście	Conditional
dumałbyś	Conditional
tonąłby	Conditional
sfałszował	None
żmiję	None
ostrogach	None
milionerach	None
sprzęgę	None
dąsajmy	Imperative-Jussive
gadałby	Conditional
węszyłbym	Conditional
umrzyjmy	Imperative-Jussive
woniej	Imperative-Jussive
odkrywałby	Conditional
dusiłbyś	Conditional
zabijmy	Imperative-Jussive
jąkałybyście	Conditional
mierzmy	Imperative-Jussive
traktowałaby	Conditional
skróciłby	Conditional
napowietrzyłoby	Conditional
przeleciałbym	Conditional
balkon	None
leszcze	None
przestrzegalibyście	Conditional
wygodnej	None
męskoosobowy	None
kowadełkiem	None
skracałabym	Conditional
nękalibyście	Conditional
kupujcie	Imperative-Jussive
podniesiona	None
piszecie	None
wpływałabyś	Conditional
klęczałabym	Conditional
zaczekaliby	Conditional
gotowałybyście	Conditional
nurkowałby	Conditional
czarownika	None
epilogu	None
sądzeni	None
Muranowowi	None
zabijałabym	Conditional
uprzedziłabym	Conditional
złamcie	Imperative-Jussive
chińskiego	None
rzeszocie	None
zaimportowałybyśmy	Conditional
pogrzebem	None
bankomatu	None
kumałabyś	Conditional
zabawką	None
wyznaczyłybyśmy	Conditional
ujebalibyście	Conditional
wyznaczylibyśmy	Conditional
obaliłoby	Conditional
odbiorą	None
podlewałybyście	Conditional
mulczowałybyśmy	Conditional
galopowałabym	Conditional
módlmy	Imperative-Jussive
wyglądałybyście	Conditional
śmieciach	None
dożyj	Imperative-Jussive
rozczarowana	None
nurkujmy	Imperative-Jussive
uderzałaby	Conditional
chwaliłabym	Conditional
kierowałbym	Conditional
wkurwionym	None
marnuj	Imperative-Jussive
zarabiajmy	Imperative-Jussive
gaworzyłyby	Conditional
sprzyjałbyś	Conditional
ściągałybyście	Conditional
porozmawiałbyś	Conditional
wkurwiałby	Conditional
płaczcie	Imperative-Jussive
poróżniliby	Conditional
lutowałbym	Conditional
basztą	None
obiecywalibyście	Conditional
przeprosiłoby	Conditional
przedmieściami	None
mulczowałabym	Conditional
topazu	None
oddałbym	Conditional
monopolistach	None
hurtowa	None
powtarzajmy	Imperative-Jussive
polecałabyś	Conditional
mądrzyłabyś	Conditional
miętowy	None
obułabym	Conditional
odwzajemnijcie	Imperative-Jussive
usuwałabym	Conditional
podkreślałabyś	Conditional
sprawdziłby	Conditional
śpiewałabym	Conditional
unicestwiłybyście	Conditional
drżałabyś	Conditional
konkurowałoby	Conditional
otrzymałybyście	Conditional
poprosilibyście	Conditional
zakończeniami	None
podchodź	Imperative-Jussive
kopiowałabym	Conditional
moczowodzie	None
biegałybyśmy	Conditional
dzierżyłyby	Conditional
pytałoby	Conditional
ozdobna	None
foki	None
pobrałaby	Conditional
korzystaliby	Conditional
głosowałbyś	Conditional
podkreślałybyście	Conditional
odbudowałabyś	Conditional
ukradłyby	Conditional
potwierdzałbyś	Conditional
przyprawiałabyś	Conditional
wyniósłby	Conditional
dodawajmy	Imperative-Jussive
obiecywałybyście	Conditional
zgubiłabym	Conditional
pielgrzymek	None
wiście	Imperative-Jussive
pochodziłabym	Conditional
smaż	Imperative-Jussive
pytałbyś	Conditional
entalpii	None
uśpiłabyś	Conditional
krzyżmem	None
wiś	Imperative-Jussive
sprawniejsze	None
spodziewałoby	Conditional
sprzątniesz	None
siedziałybyśmy	Conditional
kopałbym	Conditional
woniałyby	Conditional
temblak	None
tytoniowe	None
obwodu	None
chrońcie	Imperative-Jussive
śnijmy	Imperative-Jussive
schizofreników	None
ucieczkach	None
oszukałybyście	Conditional
ciotkami	None
opowiadalibyśmy	Conditional
razilibyśmy	Conditional
kompilowaliby	Conditional
logopedów	None
treny	None
pitnego	None
oliwo	None
świerzbielibyście	Conditional
madrygał	None
drapaliby	Conditional
pękajcie	Imperative-Jussive
negocjowałabym	Conditional
uznawałabyś	Conditional
rozważmy	Imperative-Jussive
obrzęknęłoby	Conditional
ocenilibyście	Conditional
bilardom	None
tańczylibyśmy	Conditional
zrabowalibyśmy	Conditional
dotykajcie	Imperative-Jussive
czytane	None
kajakach	None
pomagałybyście	Conditional
kontrolowałoby	Conditional
potwierdzałaby	Conditional
innowacjach	None
złupiliby	Conditional
bodzieb	None
potwierdź	Imperative-Jussive
psulibyście	Conditional
czekałabym	Conditional
guglałbyś	Conditional
zarabiamy	None
awanturnik	None
klikałby	Conditional
czaprakiem	None
traktowałyby	Conditional
pnijcie	Imperative-Jussive
gwizdałybyście	Conditional
hamowaliby	Conditional
poczekaj	Imperative-Jussive
otwórz	Imperative-Jussive
ukrylibyście	Conditional
rościjmy	Imperative-Jussive
kopałbyś	Conditional
złamałybyśmy	Conditional
rozpaczajcie	Imperative-Jussive
ograniczałyby	Conditional
wsparłbym	Conditional
rozwodach	None
masażysto	None
Lemingrad	None
wyrządziłabym	Conditional
wracajcie	Imperative-Jussive
filmowałbym	Conditional
bagnetami	None
nadmierny	None
marlibyście	Conditional
kradłabyś	Conditional
ogarniały	None
nadchodziłaby	Conditional
wschodzilibyśmy	Conditional
przynieście	Imperative-Jussive
cedzilibyście	Conditional
budziłby	Conditional
bywające	None
tworzyłbym	Conditional
glonami	None
dementowalibyśmy	Conditional
doprowadzały	None
wędrujcie	Imperative-Jussive
parowalibyście	Conditional
medytujemy	None
weseli	None
wytłumaczyłbyś	Conditional
cegłach	None
najmierniejsza	None
skróć	Imperative-Jussive
malinkę	None
trwałbym	Conditional
przeżyjcie	Imperative-Jussive
śniłbyś	Conditional
sześciennych	None
zrobiłybyśmy	Conditional
przynośmy	Imperative-Jussive
koszulce	None
starałabym	Conditional
uratuj	Imperative-Jussive
zapominałby	Conditional
dmuchaliby	Conditional
sromota	None
eksportowałybyście	Conditional
odjebałoby	Conditional
pociłbym	Conditional
mijalibyście	Conditional
płaciłyśmy	None
dyniowi	None
hasałabyś	Conditional
strategiczną	None
uznawałaby	Conditional
kserowałby	Conditional
mrugałybyście	Conditional
wymagałbym	Conditional
jadałby	Conditional
wskazywałby	Conditional
gińcie	Imperative-Jussive
erach	None
poczekałby	Conditional
czytałoby	Conditional
roztrzepałoby	Conditional
przekonaniom	None
dokonywałby	Conditional
cenzury	None
niszczyłaby	Conditional
siogunów	None
bumerang	None
wywołalibyśmy	Conditional
zaiwań	Imperative-Jussive
zimowałybyście	Conditional
pierdziałbym	Conditional
martwiliby	Conditional
krójcie	Imperative-Jussive
zwięzłą	None
okazałoby	Conditional
spotkałby	Conditional
przyprawialiby	Conditional
oddałabym	Conditional
puszczajcie	Imperative-Jussive
szalałoby	Conditional
tragiczniejszym	None
odrzucilibyście	Conditional
mamrotałby	Conditional
wykopaliby	Conditional
pożyczalibyśmy	Conditional
przędziwie	None
watykańskie	None
zerkałabym	Conditional
wracałybyście	Conditional
zbiegałyby	Conditional
panowałbyś	Conditional
skręciłby	Conditional
wyłudzałby	Conditional
strzemiennymi	None
wspominałybyśmy	Conditional
zmienilibyśmy	Conditional
podkreślalibyście	Conditional
zmieniła	None
dedykujmy	Imperative-Jussive
przekwitałbyś	Conditional
emocjonalnymi	None
zbir	None
pomagajcie	Imperative-Jussive
zdrobnienie	None
wymyślałbyś	Conditional
kosztowałbym	Conditional
śmiałybyście	Conditional
najwyżsi	None
zdrowaśkach	None
obciążalibyście	Conditional
zerżnąłbyś	Conditional
spieszylibyście	Conditional
przelećmy	Imperative-Jussive
zachorujmy	Imperative-Jussive
zrobiłby	Conditional
pomagałyby	Conditional
zakazaliby	Conditional
okazałybyśmy	Conditional
czyniłby	Conditional
stoliki	None
deklinacjami	None
ciekłaś	None
ruchałyby	Conditional
gotowalibyście	Conditional
ładowarek	None
poprawiłyby	Conditional
smażyłybyście	Conditional
chowające	None
empiryczna	None
dodałbym	Conditional
rogów	None
nadzorujcie	Imperative-Jussive
zawarlibyśmy	Conditional
dotykaliby	Conditional
dowodzą	None
opowiadałbym	Conditional
listopadowemu	None
narzekaliby	Conditional
znaczyłoby	Conditional
sami	None
odpoczywałybyśmy	Conditional
okażmy	Imperative-Jussive
podpal	Imperative-Jussive
ruchaliby	Conditional
przyprawiałoby	Conditional
zwymyślajmy	Imperative-Jussive
zmyśliłbym	Conditional
piszcz	Imperative-Jussive
gryzłby	Conditional
oświetlałaby	Conditional
korzystałaby	Conditional
traktowalibyśmy	Conditional
parlamentowi	None
zapomniałybyśmy	Conditional
bukietami	None
kukałaby	Conditional
banglaj	Imperative-Jussive
przezimowalibyście	Conditional
słonina	None
broniłby	Conditional
nazywałby	Conditional
zapomniało	None
nosiłoby	Conditional
zniszczyłoby	Conditional
gniłbym	Conditional
drap	Imperative-Jussive
zachodzilibyście	Conditional
poronilibyśmy	Conditional
mamrotaliby	Conditional
dochodźcie	Imperative-Jussive
hamowalibyście	Conditional
obrzęknęlibyśmy	Conditional
nianię	None
sprawialibyśmy	Conditional
zauważyliby	Conditional
jeżykami	None
krzemiany	None
gazetom	None
kłóciła	None
parkowalibyście	Conditional
namawiałabyś	Conditional
kserowałbyś	Conditional
pluskwom	None
alfabetem	None
świerzbiałybyście	Conditional
zrobiłyby	Conditional
gotujmy	Imperative-Jussive
leczyłabym	Conditional
zgubiłybyście	Conditional
ocaliłaby	Conditional
demonie	None
gasiłabym	Conditional
padaczkowa	None
dźwignęłabyś	Conditional
oświetlalibyście	Conditional
cadyków	None
tempo	None
wschodziłaby	Conditional
podchodziłbym	Conditional
gasili	None
liniałaby	Conditional
sodomita	None
tonęlibyśmy	Conditional
otrzymać	None
całowałabym	Conditional
umówiłbyś	Conditional
ujebałabym	Conditional
oddałybyśmy	Conditional
wymiksowałybyście	Conditional
charkałybyśmy	Conditional
pamiętałyby	Conditional
zaczynają	None
zniszczyłaby	Conditional
marnowalibyście	Conditional
edytowałybyście	Conditional
więdnęliby	Conditional
narzekałybyśmy	Conditional
skróciłoby	Conditional
szkliwom	None
sejsmograf	None
bluzgałbym	Conditional
dodawaliby	Conditional
labializacje	None
różniczkowej	None
przeszkadzajcie	Imperative-Jussive
zantagonizowałoby	Conditional
paradoksalnego	None
małżeństwu	None
uwielbiałybyśmy	Conditional
wynajmijcie	Imperative-Jussive
debatą	None
siąknąłbyś	Conditional
wywoływałbyś	Conditional
doradcy	None
grzęzłaby	Conditional
rozmywałyby	Conditional
obalalibyście	Conditional
męczyłby	Conditional
sprzyjaliby	Conditional
klękałybyście	Conditional
ukradłabyś	Conditional
arcybiskupi	None
zauważyłyby	Conditional
pisałybyście	Conditional
ćwiczyłyby	Conditional
nakryjmy	Imperative-Jussive
pękałybyśmy	Conditional
Waldku	None
identyfikowałybyście	Conditional
żartowałbyś	Conditional
planowania	None
pozostawaj	Imperative-Jussive
dokumenty	None
negocjowałybyśmy	Conditional
smugi	None
sraj	Imperative-Jussive
zmyśl	Imperative-Jussive
używajcie	Imperative-Jussive
kolebkach	None
pięłaby	Conditional
organizowałybyśmy	Conditional
smoku	None
przezimowalibyśmy	Conditional
przełęcze	None
blondynkę	None
przyjmowałabyś	Conditional
kochaj	Imperative-Jussive
czesz	Imperative-Jussive
dropiach	None
wyrzuciłybyśmy	Conditional
żałowałybyście	Conditional
lontem	None
mamrotałabym	Conditional
goździka	None
duśmy	Imperative-Jussive
podlewałby	Conditional
lubiłbyś	Conditional
siewcą	None
przekwitalibyśmy	Conditional
Hiszpanką	None
otworzyłyby	Conditional
biegunkę	None
bankructwem	None
wymówiłybyście	Conditional
groźnego	None
otaczałbyś	Conditional
znałabym	Conditional
pojawilibyśmy	Conditional
traktowalibyście	Conditional
identyfikowałabyś	Conditional
spuszczałabyś	Conditional
łaziłyby	Conditional
bluzgaliby	Conditional
odkrywaliście	None
gąsiorkom	None
śmierdziałbym	Conditional
gwaru	None
przewidywalnym	None
pogrzebałybyśmy	Conditional
dźwigałabyś	Conditional
ukryłabyś	Conditional
intryg	None
ścignąłby	Conditional
uwielbialibyśmy	Conditional
arze	None
wygarnąłbyś	Conditional
wykopmy	Imperative-Jussive
wybuchałbyś	Conditional
planowaliby	Conditional
znikałybyśmy	Conditional
domniemane	None
zajebałabyś	Conditional
zjadłyby	Conditional
strojem	None
bródź	Imperative-Jussive
drgałbym	Conditional
astronautą	None
połknęliby	Conditional
obraziłyśmy	None
żołnierza	None
kręciłaby	Conditional
odbijajmy	Imperative-Jussive
beretowi	None
dziecinnym	None
mierzylibyśmy	Conditional
dziwcie	Imperative-Jussive
gdaczcie	Imperative-Jussive
gnilibyście	Conditional
odkryj	Imperative-Jussive
odjebałybyście	Conditional
wyruchajmy	Imperative-Jussive
betonowałbyś	Conditional
jeździłybyśmy	Conditional
pokażmy	Imperative-Jussive
wierzylibyście	Conditional
napisałabym	Conditional
żyłby	Conditional
więdnął	None
nagłówków	None
zawodowa	None
ariańska	None
niewidzialnym	None
goniłbyś	Conditional
życiorysami	None
mieszałaby	Conditional
tworzyłby	Conditional
esemesowałybyście	Conditional
włączalibyście	Conditional
literówką	None
śniadaliby	Conditional
śledzimy	None
kociątko	None
zaryzykowałby	Conditional
przestrzennych	None
dwuwargowe	None
rozczarowałoby	Conditional
senni	None
dotyk	None
twierdziłbym	Conditional
kusiliby	Conditional
siusialibyście	Conditional
kanar	None
niszczyłabyś	Conditional
kopalibyście	Conditional
chciałbyś	Conditional
wyrządziłybyście	Conditional
cukinii	None
kondensatorów	None
germańscy	None
traktujcie	Imperative-Jussive
odpowiadajmy	Imperative-Jussive
sprawdźmy	Imperative-Jussive
przekomarzałybyście	Conditional
połykajcie	Imperative-Jussive
wymiotowaliby	Conditional
zestawiłby	Conditional
warczyłyby	Conditional
zamarzaj	Imperative-Jussive
walucie	None
mniejszej	None
poprawiliby	Conditional
próbowałbym	Conditional
nadepnijmy	Imperative-Jussive
martwiłabym	Conditional
kopały	None
kwestionowalibyśmy	Conditional
groziłaby	Conditional
skazałbym	Conditional
usunąć	None
spadajcie	Imperative-Jussive
proroctw	None
zdrowszą	None
sprawiasz	None
matematyce	None
galeonem	None
laskich	None
ostrożniejszemu	None
przypomniałby	Conditional
przyprawiajmy	Imperative-Jussive
zrobiliby	Conditional
zaufalibyśmy	Conditional
produkowaniu	None
spieszcie	Imperative-Jussive
francuskiej	None
ujadajcie	Imperative-Jussive
pszczółeczkami	None
dokonałybyśmy	Conditional
zabalsamuj	Imperative-Jussive
pamięcią	None
odbijałabym	Conditional
okazałabym	Conditional
kosiłyby	Conditional
egzosfera	None
wypędźmy	Imperative-Jussive
żałowalibyście	Conditional
chełpmy	Imperative-Jussive
kucałybyśmy	Conditional
odrzuciłybyśmy	Conditional
wybrałaby	Conditional
wdychałby	Conditional
plułybyście	Conditional
opiekowałaby	Conditional
uprzedziłybyście	Conditional
zbiegalibyśmy	Conditional
spuśćcie	Imperative-Jussive
odchodziłabym	Conditional
czosnkami	None
ściągaj	Imperative-Jussive
jonizowałbym	Conditional
sina	None
wdepnęłybyście	Conditional
sprawdzałabym	Conditional
wziąłbym	Conditional
zabilibyście	Conditional
rąb	Imperative-Jussive
tlałybyśmy	Conditional
fuksja	None
kuratorzy	None
opisywałabym	Conditional
zrzuciłoby	Conditional
szóstkę	None
pełzałbym	Conditional
białorzytkami	None
oszukiwałby	Conditional
husyckiej	None
zarezerwowałabym	Conditional
pachniałaby	Conditional
szczerzyłoby	Conditional
jodłowalibyście	Conditional
nadzorowałyby	Conditional
wahałyby	Conditional
zauważyłyście	None
podpaliłybyście	Conditional
sadystyczną	None
nosiłby	Conditional
bankrutowałbym	Conditional
próbowałoby	Conditional
marudziłybyście	Conditional
irlandzkie	None
połknęłaby	Conditional
wywołałabym	Conditional
najnaturalniejsze	None
uderzał	None
plułby	Conditional
czekajcie	Imperative-Jussive
eksportowaliby	Conditional
wyjrzałby	Conditional
moru	None
mruczenie	None
buchałbyś	Conditional
podwiązki	None
podwieczorku	None
rozróżniałbyś	Conditional
banglajmy	Imperative-Jussive
kroiłoby	Conditional
zbyć	None
dymajmy	Imperative-Jussive
bezlitośni	None
śniadałoby	Conditional
sprawdziłybyśmy	Conditional
obiecałybyście	Conditional
okupów	None
bohatyrnęliby	Conditional
powtarzalibyśmy	Conditional
tęskniłbyś	Conditional
dyszałybyście	Conditional
kruchszymi	None
wahajmy	Imperative-Jussive
wykrwawiłabyś	Conditional
hangaru	None
ukryć	None
oszukałabym	Conditional
karawanami	None
odstawiłybyśmy	Conditional
pobralibyście	Conditional
zaruchałabym	Conditional
krzyczałyby	Conditional
szastałaby	Conditional
wysiadłaby	Conditional
zjedzmy	Imperative-Jussive
islandzką	None
opowiadałybyśmy	Conditional
alternatywach	None
przeprowadzce	None
kraczcie	Imperative-Jussive
złapaliby	Conditional
bratanków	None
umylibyście	Conditional
lansowalibyśmy	Conditional
odebrałybyśmy	Conditional
marudzilibyśmy	Conditional
odbijałybyśmy	Conditional
parweniusze	None
wyjebiecie	None
szczaj	Imperative-Jussive
dzienne	None
głosujmy	Imperative-Jussive
googlowałbym	Conditional
gawronach	None
podrywajmy	Imperative-Jussive
wyhaftowalibyście	Conditional
stawialibyście	Conditional
pokrywałoby	Conditional
rozproszyłoby	Conditional
carowi	None
ćwiczone	None
kochałybyśmy	Conditional
ziębnęlibyśmy	Conditional
piesek	None
szczypiorku	None
groziłoby	Conditional
wyżęlibyście	Conditional
uczestniczyłabym	Conditional
nadużywaliby	Conditional
sprzedawcom	None
otrzymałaby	Conditional
wytłumaczyłabym	Conditional
cofałybyście	Conditional
rosie	None
kop	Imperative-Jussive
aramejskie	None
jawiłyby	Conditional
czyniłabym	Conditional
zaryzykujcie	Imperative-Jussive
rozwiązałabyś	Conditional
pożyczałbyś	Conditional
męczyłem	None
wiśniowego	None
twierdziłabyś	Conditional
stratach	None
płyń	Imperative-Jussive
kotwice	None
półfinałem	None
ćwiczyłaby	Conditional
opowiadali	None
betonowałybyśmy	Conditional
nurkuję	None
warszawiankę	None
sabotowałby	Conditional
potrzebowałabyś	Conditional
podpaliłoby	Conditional
mrugajmy	Imperative-Jussive
karmcie	Imperative-Jussive
igrałyby	Conditional
wytryskujmy	Imperative-Jussive
półprzewodniki	None
doceniałoby	Conditional
poprowadziłybyśmy	Conditional
poroniłam	None
lizałby	Conditional
uderzałbyś	Conditional
elektrochemiczną	None
harf	None
zgubiłem	None
marnowałby	Conditional
kapujcie	Imperative-Jussive
odbudujmy	Imperative-Jussive
mulczowałbyś	Conditional
zastanawiałabym	Conditional
imponujcie	Imperative-Jussive
wybuchałabyś	Conditional
skorupek	None
wyhaftowałby	Conditional
spodziewajmy	Imperative-Jussive
oddziału	None
chłeptałabym	Conditional
czekałybyście	Conditional
odbierałabym	Conditional
budziłoby	Conditional
gruzach	None
dostarczałoby	Conditional
dowiedziałby	Conditional
zweryfikujcie	Imperative-Jussive
nęciłaby	Conditional
odbudowałbym	Conditional
drapałaby	Conditional
napowietrzyłbyś	Conditional
wdychałabyś	Conditional
otaczałybyście	Conditional
wąchajcie	Imperative-Jussive
życzyłbym	Conditional
wierzyłbym	Conditional
kawior	None
przyjmij	Imperative-Jussive
rzuciliby	Conditional
Brytyjczyków	None
łużycką	None
spieszyliby	Conditional
zostawmy	Imperative-Jussive
ciągłego	None
nadzorowałybyście	Conditional
zwyciężalibyśmy	Conditional
wynajęłabyś	Conditional
ściągałabyś	Conditional
przydomku	None
diagnozujcie	Imperative-Jussive
erotycznym	None
łaziliby	Conditional
wdychałoby	Conditional
kastrowałabyś	Conditional
obułyby	Conditional
zawarłybyśmy	Conditional
band	None
tolerowaliby	Conditional
nadchodziłyby	Conditional
zachowania	None
zerkałybyśmy	Conditional
błyskałaby	Conditional
napisałabyś	Conditional
hojną	None
zbierzmy	Imperative-Jussive
otrzymałabym	Conditional
zantagonizowałybyście	Conditional
zapomnijcie	Imperative-Jussive
zamówiłaby	Conditional
kazaniom	None
dźwigałabym	Conditional
dystansach	None
wyłudzałbyś	Conditional
zerkaliby	Conditional
dotknęłabyś	Conditional
piszczałoby	Conditional
bezwarunkowy	None
wahałybyśmy	Conditional
nonanów	None
ładowałybyście	Conditional
bezkształtny	None
marynarze	None
opuszczalibyśmy	Conditional
wieloryb	None
analizowałyby	Conditional
progach	None
brodziłybyście	Conditional
zmartwychwstawałoby	Conditional
nurkowałybyście	Conditional
miana	None
zmieniałby	Conditional
dobyłabym	Conditional
zatrzymalibyśmy	Conditional
konfigurowałbym	Conditional
połykałbym	Conditional
spotkałabyś	Conditional
lękajcie	Imperative-Jussive
gaś	Imperative-Jussive
zerżnęłybyście	Conditional
kłócilibyśmy	Conditional
więźnijmy	Imperative-Jussive
werbena	None
srałyby	Conditional
spodziewajcie	Imperative-Jussive
łapałby	Conditional
poziomki	None
siałabym	Conditional
uratowałby	Conditional
jonizowałbyś	Conditional
brukowcu	None
korzystające	None
wołalibyście	Conditional
pobierz	Imperative-Jussive
ogrodu	None
tęskniłabym	Conditional
korzystałybyśmy	Conditional
charkaj	Imperative-Jussive
najświętszych	None
rozmywajcie	Imperative-Jussive
wracajmy	Imperative-Jussive
fuksjami	None
kłód	None
męczyłoby	Conditional
krzyczałybyście	Conditional
klej	Imperative-Jussive
rozmyłaby	Conditional
autostrad	None
jokery	None
spieprzajmy	Imperative-Jussive
wędrowny	None
zdiagnozowalibyśmy	Conditional
podziwiałybyśmy	Conditional
dodałaby	Conditional
pełzalibyście	Conditional
zimujmy	Imperative-Jussive
złamałbyś	Conditional
czyni	None
znalazłbyś	Conditional
kokiem	None
drżę	None
mrugalibyśmy	Conditional
postradalibyśmy	Conditional
rozróżniałybyście	Conditional
słyszcie	Imperative-Jussive
wdepnąłby	Conditional
termodynamiką	None
zaczynalibyście	Conditional
kipiałby	Conditional
zamówiłybyśmy	Conditional
żywopłotem	None
zwyciężałybyśmy	Conditional
ściągalibyśmy	Conditional
filmowalibyście	Conditional
martwego	None
wyżęłybyśmy	Conditional
skończyłby	Conditional
kręćmy	Imperative-Jussive
panowałabym	Conditional
połącz	Imperative-Jussive
górnołużyckich	None
równy	None
czesałaby	Conditional
sabotujmy	Imperative-Jussive
bankrutujmy	Imperative-Jussive
plułybyśmy	Conditional
rozwiązalibyśmy	Conditional
oszukalibyście	Conditional
wschodziłabyś	Conditional
nadepnąłbym	Conditional
klęcz	Imperative-Jussive
zamieszkami	None
trwałoby	Conditional
zębem	None
należałybyście	Conditional
znaliśmy	None
żułabym	Conditional
wysiadłybyście	Conditional
zmierzchu	None
zaniechałabyś	Conditional
kłóciłaby	Conditional
opróżniłbyś	Conditional
zapomnij	Imperative-Jussive
najpyszniejszych	None
spieszyłby	Conditional
chroniłaby	Conditional
zadzwoniłabym	Conditional
pokazałbyś	Conditional
wyrzućmy	Imperative-Jussive
wdepnęłybyśmy	Conditional
komentowałybyśmy	Conditional
społeczeństwem	None
zadałby	Conditional
gaście	Imperative-Jussive
dedykowałby	Conditional
wysiedlibyśmy	Conditional
Sejmów	None
reprezentantów	None
gzy	None
dementujcie	Imperative-Jussive
rąbałoby	Conditional
tworzyłabyś	Conditional
torba	None
duś	Imperative-Jussive
popełniłbyś	Conditional
złapałabym	Conditional
karetki	None
fuksa	None
wesprzyj	Imperative-Jussive
felieton	None
dosięgnęliby	Conditional
przepilibyśmy	Conditional
złożyłaby	Conditional
kopiowałybyśmy	Conditional
huraganem	None
pozostawałoby	Conditional
sprośniejszemu	None
nurkowałbym	Conditional
wskaż	Imperative-Jussive
kipiałyby	Conditional
zmartwychwstawałabyś	Conditional
żądalibyście	Conditional
pożądałaby	Conditional
nęćcie	Imperative-Jussive
wymagałybyście	Conditional
jebnęliby	Conditional
służąca	None
kichałabym	Conditional
otrułabym	Conditional
kastrowaliby	Conditional
majowe	None
jadałbyś	Conditional
rozpaczaj	Imperative-Jussive
kibicowaliśmy	None
dźwigajmy	Imperative-Jussive
odpocząłbym	Conditional
schlebiałbyś	Conditional
węszyłabym	Conditional
protonach	None
świerzbiałabym	Conditional
tropów	None
potasem	None
wytryskowi	None
chłeptałbyś	Conditional
marudziłybyśmy	Conditional
siąknąłabyś	Conditional
zaiwaniłyby	Conditional
zestawilibyście	Conditional
rozsadzałybyśmy	Conditional
wykresy	None
unikałyby	Conditional
ucieczce	None
chusteczkami	None
gwizdałabyś	Conditional
dostarczalibyście	Conditional
stawiaj	Imperative-Jussive
szastałby	Conditional
zweryfikowałoby	Conditional
odebrałbyś	Conditional
uciekajcie	Imperative-Jussive
chłeptałybyśmy	Conditional
zatrzymałyby	Conditional
schlebiałybyśmy	Conditional
wybuchaj	Imperative-Jussive
sprzątnij	Imperative-Jussive
skakałaby	Conditional
cichszy	None
rozważałbym	Conditional
produkowałabyś	Conditional
zwrotnymi	None
drażnijcie	Imperative-Jussive
doiłabyś	Conditional
parlamentami	None
tarcza	None
majsterkuj	Imperative-Jussive
komórkowe	None
życzylibyście	Conditional
chcieliby	Conditional
fort	None
plaster	None
zaufałaby	Conditional
jeże	None
jeździłaby	Conditional
opisujcie	Imperative-Jussive
potrzebowałybyście	Conditional
uprzedź	Imperative-Jussive
biegalibyśmy	Conditional
milczeliby	Conditional
zaangażowanie	None
wypędź	Imperative-Jussive
bielików	None
zestawiłoby	Conditional
grabiłabyś	Conditional
znałybyśmy	Conditional
pijalibyśmy	Conditional
esemesowałoby	Conditional
wymuszono	None
obgadana	None
traktowałybyście	Conditional
niknęlibyśmy	Conditional
rozwiążmy	Imperative-Jussive
azotem	None
podlewałbyś	Conditional
namawiajcie	Imperative-Jussive
spałaszowałabyś	Conditional
atomom	None
tolerujmy	Imperative-Jussive
pamiętało	None
pachniałabym	Conditional
wyłudzałybyśmy	Conditional
wykitowałoby	Conditional
trwałyby	Conditional
kserowałoby	Conditional
marłybyśmy	Conditional
obaliłybyście	Conditional
ćwiczę	None
potwierdzałyby	Conditional
opisywałaby	Conditional
kłócąc	None
spróbowalibyśmy	Conditional
usuwałabyś	Conditional
tropie	None
skłamałam	None
zakazałabym	Conditional
obrzęknąłbyś	Conditional
politechnikach	None
wolnym	None
umarłbym	Conditional
jebadło	None
cieślę	None
dusiłby	Conditional
egzonimem	None
gapiłby	Conditional
napowietrzyłbym	Conditional
ucząc	None
życzono	None
śmiejcie	Imperative-Jussive
otrzymywałaby	Conditional
mądrzejszymi	None
nurkach	None
mądrzejmy	Imperative-Jussive
potrzosach	None
odbierajcie	Imperative-Jussive
liniałbym	Conditional
ceramicznych	None
kazachstańskim	None
zmieniłabyś	Conditional
kuprami	None
dosrałyby	Conditional
wyjęłyby	Conditional
dziewczynka	None
spotkałoby	Conditional
smoczej	None
przypuszczalibyście	Conditional
hamowałyście	None
zaryzykowałybyśmy	Conditional
susłów	None
antytrynitaryzmu	None
mądrzyjmy	Imperative-Jussive
korzeń	None
znosiłbym	Conditional
skłamalibyście	Conditional
zbiegaliby	Conditional
skakałoby	Conditional
obrabowałybyśmy	Conditional
ujadałybyście	Conditional
ubóstwialibyśmy	Conditional
duchowi	None
podchodzilibyście	Conditional
wahałbym	Conditional
sprzątnąłbyś	Conditional
pamiętajcie	Imperative-Jussive
nęcilibyście	Conditional
pożyczamy	None
cytowalibyście	Conditional
zdementujmy	Imperative-Jussive
falochrony	None
haruj	Imperative-Jussive
najstarsza	None
zniszczony	None
ubóstwiałbyś	Conditional
dawałaby	Conditional
dokonałoby	Conditional
planowalibyśmy	Conditional
drogiego	None
googlowałbyś	Conditional
słuchałybyście	Conditional
raziłbym	Conditional
czepki	None
podpalmy	Imperative-Jussive
przestrzegałby	Conditional
egzotycznych	None
wymyślił	None
mieszkałybyście	Conditional
maskowaliby	Conditional
włączałybyśmy	Conditional
umyć	None
ciągowi	None
gwałciłabyś	Conditional
galaktozę	None
zaimportowałaby	Conditional
wykitowałabym	Conditional
obrabuj	Imperative-Jussive
występowałyby	Conditional
reklamowa	None
dźwigałoby	Conditional
pozostawałybyśmy	Conditional
charkałybyście	Conditional
pożarłby	Conditional
splądrowałybyśmy	Conditional
wylałybyście	Conditional
najcięższa	None
nadepnijcie	Imperative-Jussive
produkujcie	Imperative-Jussive
porozmawialibyście	Conditional
wyżąłby	Conditional
zabrałabyś	Conditional
awariach	None
uwiedlibyśmy	Conditional
ocaliłbyś	Conditional
gwałciłoby	Conditional
zastanawiałbym	Conditional
przemyśl	Imperative-Jussive
pojazdach	None
oddawały	None
weź	Imperative-Jussive
drżałyście	None
łamałabyś	Conditional
kundlach	None
parowałybyście	Conditional
przytuliliby	Conditional
wyjrzyjcie	Imperative-Jussive
ukrywałaby	Conditional
igrać	None
słuchem	None
heheszkom	None
straciłabyś	Conditional
pyro	None
potwierdzane	None
słyszałbym	Conditional
uwielbialibyście	Conditional
wołajmy	Imperative-Jussive
smażyłybyśmy	Conditional
dziękowałbyś	Conditional
drga	None
niszczę	None
opisywałoby	Conditional
projektu	None
haftowałbyś	Conditional
romantycznymi	None
syndykalista	None
potwierdzałabyś	Conditional
pijałby	Conditional
nadzorowalibyśmy	Conditional
eksportowałbyś	Conditional
odpowiadalibyśmy	Conditional
jeździliby	Conditional
wyłudzałaby	Conditional
fosami	None
radioamatorem	None
ryczałoby	Conditional
wkurwiałybyśmy	Conditional
działajmy	Imperative-Jussive
smarkalibyśmy	Conditional
płonęłyby	Conditional
oglądałem	None
sprawiedliwego	None
kryłoby	Conditional
bohatyrnęłoby	Conditional
nienasycona	None
przekwitaliby	Conditional
bambusowego	None
przestrzegajmy	Imperative-Jussive
tolerowalibyśmy	Conditional
telefonowalibyśmy	Conditional
głosowałby	Conditional
życzyłybyście	Conditional
parowałbym	Conditional
gapiłoby	Conditional
odwzajemnijmy	Imperative-Jussive
śniłaby	Conditional
płacilibyście	Conditional
gaworzylibyście	Conditional
nękałybyście	Conditional
ograniczałbym	Conditional
zakochałbym	Conditional
klikałaby	Conditional
ośmiokątów	None
rozbiłyby	Conditional
obiecałyby	Conditional
dupczyłybyście	Conditional
wokaliści	None
wydupczylibyśmy	Conditional
kupcie	Imperative-Jussive
wymierny	None
wywołałybyśmy	Conditional
refrenie	None
rządziłby	Conditional
znikaj	Imperative-Jussive
mieszkajmy	Imperative-Jussive
kokainą	None
opiekowałbym	Conditional
wyprasowałabyś	Conditional
mruczelibyście	Conditional
dupczylibyście	Conditional
panowalibyśmy	Conditional
legionami	None
polowałybyśmy	Conditional
unikalibyśmy	Conditional
tęskniłbym	Conditional
głosowalibyście	Conditional
smaczniejszymi	None
obraziłbym	Conditional
zweryfikowaliby	Conditional
połykalibyśmy	Conditional
martwiłbyś	Conditional
wydupczyłbym	Conditional
opiekowałybyście	Conditional
krzyczałbyś	Conditional
pojawialiby	Conditional
przezimuj	Imperative-Jussive
zastanawialiby	Conditional
mordowałybyśmy	Conditional
wyznaczyłoby	Conditional
ograniczaj	Imperative-Jussive
porozmawialibyśmy	Conditional
wylałyby	Conditional
laotański	None
dotykaj	Imperative-Jussive
nadużywałoby	Conditional
duszach	None
zadaj	Imperative-Jussive
świadomość	None
długość	None
dworu	None
ojcami	None
czyściłybyśmy	Conditional
trenach	None
kodeksy	None
wykorzystywałoby	Conditional
psujmy	Imperative-Jussive
lustrzanek	None
dyszałabyś	Conditional
gromadźcie	Imperative-Jussive
mieszkałbym	Conditional
miodokwiatu	None
bananów	None
krewnego	None
szkódźcie	Imperative-Jussive
sypaliby	Conditional
należałbym	Conditional
mieszałbyś	Conditional
jonizuj	Imperative-Jussive
kleiłoby	Conditional
lubiłbym	Conditional
doprowadzałabym	Conditional
daj	Imperative-Jussive
kupowałaby	Conditional
pamiętałabym	Conditional
podpisalibyście	Conditional
przypuściłaś	None
nosiłaby	Conditional
dokonuj	Imperative-Jussive
starałbym	Conditional
ścignij	Imperative-Jussive
alkoholem	None
loteriom	None
rozróżniłbym	Conditional
traciłby	Conditional
dowiedzcie	Imperative-Jussive
urząd	None
tlelibyście	Conditional
zacząłbym	Conditional
maliny	None
porannych	None
przeprowadzam	None
pojmowałabyś	Conditional
chełpilibyśmy	Conditional
płatnej	None
sikałbyś	Conditional
dziwiłoby	Conditional
gadałbym	Conditional
homonim	None
przegapiłabym	Conditional
prałyby	Conditional
złamalibyście	Conditional
wiolonczelami	None
łapałbym	Conditional
diamenty	None
skłamałabym	Conditional
twórzcie	Imperative-Jussive
kompozytorami	None
słuchalibyśmy	Conditional
rotor	None
banglałybyście	Conditional
zaryzykowałbym	Conditional
zainsynuuj	Imperative-Jussive
ukrywaliby	Conditional
sprawiałoby	Conditional
zerkałby	Conditional
uważasz	None
zaśmiecony	None
więzłabym	Conditional
gasiłbym	Conditional
zajebałoby	Conditional
refowałybyśmy	Conditional
suń	Imperative-Jussive
pytaj	Imperative-Jussive
klawiszom	None
kipielibyśmy	Conditional
ujadałyby	Conditional
deuterem	None
kryłabym	Conditional
zasłużyłabym	Conditional
kosiłbym	Conditional
paszczurem	None
nastawiłbyś	Conditional
wyświetlałby	Conditional
drżałybyśmy	Conditional
dymałybyśmy	Conditional
zawarłybyście	Conditional
kipiący	None
tęskniłby	Conditional
szastałoby	Conditional
potwierdzajcie	Imperative-Jussive
żałowałbym	Conditional
bez	None
mieszajcie	Imperative-Jussive
kapowałybyście	Conditional
pajączkiem	None
sikałabym	Conditional
gromadziłbym	Conditional
oszukiwałyby	Conditional
marznij	Imperative-Jussive
porońmy	Imperative-Jussive
dżula	None
ziębnij	Imperative-Jussive
siarczki	None
dawajmy	Imperative-Jussive
pocieszyłybyście	Conditional
odczyniłbym	Conditional
unikałabym	Conditional
oceniajmy	Imperative-Jussive
galopowałbym	Conditional
niezbędna	None
wyjrzałbyś	Conditional
wąchałbyś	Conditional
ripostowalibyście	Conditional
sypałaby	Conditional
przystającym	None
ignorujmy	Imperative-Jussive
przyjęłybyśmy	Conditional
pogrzebalibyście	Conditional
zaniechałyby	Conditional
uwiodłaby	Conditional
zainsynuowalibyśmy	Conditional
przegrałby	Conditional
kwasorodów	None
rozróżnialibyście	Conditional
śledźcie	Imperative-Jussive
łamałby	Conditional
wyświetlałabym	Conditional
łudziliby	Conditional
należała	None
dżinn	None
pokazałybyśmy	Conditional
ćwiczyliby	Conditional
tylibyśmy	Conditional
pieska	None
karałabym	Conditional
marszałek	None
kleiłbyś	Conditional
piszczelibyśmy	Conditional
ładniejszy	None
najgłupszy	None
ostrogę	None
zasłużyłybyśmy	Conditional
straciłybyście	Conditional
przodowałybyśmy	Conditional
zazdrościłyby	Conditional
pamiętałbym	Conditional
dosrałoby	Conditional
opis	None
żądalibyśmy	Conditional
pątnicy	None
demokrata	None
czulibyśmy	Conditional
strzelaj	Imperative-Jussive
knotom	None
zachowałbym	Conditional
wyznacz	Imperative-Jussive
skracaj	Imperative-Jussive
bębniłaby	Conditional
imponowałabyś	Conditional
cofałyby	Conditional
ruszyliby	Conditional
ruńcie	Imperative-Jussive
spieprzyłyby	Conditional
pojemniki	None
żyłbyś	Conditional
rąbałabyś	Conditional
rozczarowany	None
płaskimi	None
zaproś	Imperative-Jussive
smocza	None
uważaj	Imperative-Jussive
półfinalistce	None
zerkałabyś	Conditional
wspomnijmy	Imperative-Jussive
ośmiokątami	None
ratowałbym	Conditional
dupczyliby	Conditional
smakujmy	Imperative-Jussive
wytryskiwałaby	Conditional
unikajcie	Imperative-Jussive
zaimportowane	None
skrzypcach	None
ukrywaj	Imperative-Jussive
opróżnilibyście	Conditional
zorze	None
tęskniłabyś	Conditional
eksperymentowaliby	Conditional
pękaj	Imperative-Jussive
poprawniejszej	None
zapominalibyśmy	Conditional
znaczyłbym	Conditional
nastawiłabym	Conditional
połknęłabym	Conditional
odwiedzali	None
puszczalibyśmy	Conditional
jawiliby	Conditional
zamykałbyś	Conditional
warczylibyście	Conditional
genowi	None
negocjowałoby	Conditional
trzymał	None
rozmyślaj	Imperative-Jussive
maskowalibyśmy	Conditional
tantalu	None
zbierz	Imperative-Jussive
kibiców	None
zwyciężałabyś	Conditional
ściągnęlibyśmy	Conditional
zamówię	None
wyznaczyliby	Conditional
złamałbym	Conditional
dokonywałoby	Conditional
pobrałybyśmy	Conditional
poruchajcie	Imperative-Jussive
kłuto	None
gardziłabym	Conditional
kibicowałybyśmy	Conditional
poznajmy	Imperative-Jussive
tworzyłbyś	Conditional
karabinu	None
podpierdoliliby	Conditional
azerbejdżańskim	None
poproszony	None
negocjowałaby	Conditional
działałabyś	Conditional
łudźmy	Imperative-Jussive
uczęszczałbym	Conditional
wymusiłaby	Conditional
cytujcie	Imperative-Jussive
proponowałbyś	Conditional
kąsałybyśmy	Conditional
uśpiłby	Conditional
uczyłybyście	Conditional
czerep	None
cyrylica	None
umówiliby	Conditional
zależni	None
najdłuższej	None
pędów	None
kopiujcie	Imperative-Jussive
stawałbyś	Conditional
wytłumaczyłby	Conditional
piękniejsi	None
grono	None
wyrzucilibyście	Conditional
rozmawiałybyście	Conditional
lądom	None
konkurujesz	None
najniższych	None
bosmana	None
markiza	None
odradzałybyście	Conditional
kopiuj	Imperative-Jussive
torebce	None
poróżniłabym	Conditional
najczęstszymi	None
pocieszcie	Imperative-Jussive
bankrutowałbyś	Conditional
dostawajmy	Imperative-Jussive
ogarniałoby	Conditional
ratowałabym	Conditional
czyńcie	Imperative-Jussive
zabiłbym	Conditional
martwiłoby	Conditional
drapałbym	Conditional
zapraszałbyś	Conditional
latałabym	Conditional
klęczcie	Imperative-Jussive
pasatów	None
stanowilibyśmy	Conditional
śmieszkowałbym	Conditional
zasługiwałabyś	Conditional
goniłbym	Conditional
ukrywajmy	Imperative-Jussive
kręciłyby	Conditional
pękalibyście	Conditional
miewałybyśmy	Conditional
uderzyłbym	Conditional
chciałoby	Conditional
ogarniałybyście	Conditional
zapłaciłybyście	Conditional
kabylskim	None
zarabiaj	Imperative-Jussive
skróciłabym	Conditional
moczyłabym	Conditional
olałabyś	Conditional
kapciem	None
abonowaliby	Conditional
arcydziełom	None
wracałabym	Conditional
bywałaby	Conditional
wyprasowałybyśmy	Conditional
gapiłaby	Conditional
dymałbym	Conditional
jadaliby	Conditional
bękartami	None
wyrzuciliby	Conditional
chroń	Imperative-Jussive
pozostawałabym	Conditional
wybierałybyście	Conditional
lemoniada	None
wytryskiwałyby	Conditional
brzemienia	None
marynarkę	None
zestawiłabyś	Conditional
formalistą	None
trzymajcie	Imperative-Jussive
poprosiłabym	Conditional
ciekłoby	Conditional
twierdzeniom	None
niebezpieczeństwem	None
stygnijmy	Imperative-Jussive
mordowaliby	Conditional
jodłowałbym	Conditional
dumałybyśmy	Conditional
dałbyś	Conditional
wkurwiałybyście	Conditional
machaliby	Conditional
mordzie	None
kastrujmy	Imperative-Jussive
demontujcie	Imperative-Jussive
brzuszka	None
znaleźlibyście	Conditional
zantagonizowałybyśmy	Conditional
żłobkami	None
wilkołakowi	None
gorzałby	Conditional
dmuchałaby	Conditional
przemyślałabyś	Conditional
skazaliby	Conditional
oceniłbym	Conditional
spuszczaliście	None
klękałabyś	Conditional
niszczmy	Imperative-Jussive
pensje	None
slawistycznego	None
eksperymentowałem	None
fonem	None
przeszkadzałbym	Conditional
okopie	None
smakowałbyś	Conditional
oświetlajcie	Imperative-Jussive
ławka	None
obserwatorowi	None
utleniliby	Conditional
przyjąłby	Conditional
rozwiązałeś	None
błądziłabyś	Conditional
laboratoriami	None
przyniósł	None
głosowałyby	Conditional
ziębnęłabym	Conditional
doceniały	None
ocaliłby	Conditional
kastrowałyby	Conditional
straciłyby	Conditional
kimałybyśmy	Conditional
dozorcą	None
pięliby	Conditional
uderzyłabym	Conditional
rusz	Imperative-Jussive
dosięgnąłbym	Conditional
otrzymałybyśmy	Conditional
pękałbym	Conditional
mulczowałbym	Conditional
marznęlibyście	Conditional
immunopatologię	None
dostarczaliby	Conditional
igralibyśmy	Conditional
demontowałaby	Conditional
szczerzyłby	Conditional
łammy	Imperative-Jussive
zachorowałabym	Conditional
dzierżcie	Imperative-Jussive
kierowałabyś	Conditional
pojawiałyby	Conditional
trwajcie	Imperative-Jussive
wybory	None
złożyłbyś	Conditional
mruczmy	Imperative-Jussive
nadzoruj	Imperative-Jussive
pędź	Imperative-Jussive
portu	None
zachowałybyście	Conditional
wiochom	None
sprzyjaj	Imperative-Jussive
marsjańska	None
przodując	None
zaczynałbym	Conditional
wonienie	None
sądziłyby	Conditional
rżelibyśmy	Conditional
rozmywalibyśmy	Conditional
dupczyłoby	Conditional
grzmieliby	Conditional
wąchaj	Imperative-Jussive
wymogłybyśmy	Conditional
zróbmy	Imperative-Jussive
reprodukcje	None
sarkalibyście	Conditional
eksportowałabyś	Conditional
spuszczalibyśmy	Conditional
chrześcijańscy	None
ametystowi	None
neurologii	None
matkę	None
poiłbym	Conditional
negocjowalibyście	Conditional
unikałoby	Conditional
powtarzałabyś	Conditional
ostrzegalibyście	Conditional
kapturów	None
parskałoby	Conditional
jaźwcem	None
obiecywałabym	Conditional
ufałyby	Conditional
odwiedzajmy	Imperative-Jussive
odpocząłbyś	Conditional
siadałbyś	Conditional
mknęlibyście	Conditional
bełtałyby	Conditional
rósłbyś	Conditional
kroiłabym	Conditional
lansowałbyś	Conditional
ratujcie	Imperative-Jussive
uczmy	Imperative-Jussive
zaruchajmy	Imperative-Jussive
kręciłby	Conditional
obgadałbyś	Conditional
gwałcilibyśmy	Conditional
odczynilibyście	Conditional
kongresach	None
czułbyś	Conditional
urodziliby	Conditional
szafirową	None
nastawiłybyśmy	Conditional
ściągnij	Imperative-Jussive
błądziłybyście	Conditional
ciekawych	None
ptaszki	None
drzemałoby	Conditional
ogol	Imperative-Jussive
podlewajcie	Imperative-Jussive
zachowałby	Conditional
okradałbym	Conditional
doprowadzałybyśmy	Conditional
gdakałabyś	Conditional
mierziłby	Conditional
traciłbym	Conditional
zainsynuowałabym	Conditional
ochronnych	None
bełtalibyśmy	Conditional
opowiadalibyście	Conditional
zazdrość	Imperative-Jussive
lakierniku	None
gniłaby	Conditional
przyrządów	None
analnego	None
wywoływałby	Conditional
podkradałabym	Conditional
zarabialiby	Conditional
zazdrościłybyśmy	Conditional
żalach	None
zerowała	None
otrzymalibyśmy	Conditional
spotkaniom	None
sądziłbym	Conditional
dobyłyby	Conditional
wyrządziłaby	Conditional
broilibyście	Conditional
pokonałabyś	Conditional
wykopałoby	Conditional
chowalibyście	Conditional
skracałyby	Conditional
kabaretu	None
czesałbyś	Conditional
abonowalibyście	Conditional
skręciliby	Conditional
zazdrościłybyście	Conditional
jednokładność	None
uśpilibyście	Conditional
ćwiczylibyście	Conditional
znalazłaś	None
zastanawiając	None
składaliby	Conditional
imponowałbym	Conditional
obrażalibyście	Conditional
polecałbym	Conditional
zapamiętajmy	Imperative-Jussive
uważałbym	Conditional
cedźmy	Imperative-Jussive
mleczku	None
rozmywałabym	Conditional
łam	Imperative-Jussive
kaszlałam	None
wziąłbyś	Conditional
uważałybyśmy	Conditional
tajaliby	Conditional
zatrzymalibyście	Conditional
pianina	None
skróciłyby	Conditional
kieruj	Imperative-Jussive
dowodziłybyście	Conditional
wtórną	None
zaryzykowałybyście	Conditional
panowałybyśmy	Conditional
ubogiej	None
dałyby	Conditional
trwałaby	Conditional
powtórz	Imperative-Jussive
ratowałyby	Conditional
gwałciłabym	Conditional
gałązce	None
czułbym	Conditional
ryczałbym	Conditional
wielokąt	None
skrzyp	Imperative-Jussive
zimniejsi	None
ułamków	None
łaknąłbyś	Conditional
przygotowałabyś	Conditional
moczylibyście	Conditional
zarżnij	Imperative-Jussive
komety	None
zniknęliby	Conditional
umierałybyście	Conditional
fruwałbyś	Conditional
pamiętaj	Imperative-Jussive
immunitetu	None
pomagałabyś	Conditional
ambasadorem	None
lemat	None
sprawą	None
pierdziałyby	Conditional
dziękowalibyście	Conditional
mężczyźnie	None
macochy	None
zdementujcie	Imperative-Jussive
przyprawiajcie	Imperative-Jussive
pociłabyś	Conditional
powtórzylibyśmy	Conditional
kalina	None
wywoływałabyś	Conditional
porozmawiałaby	Conditional
przyczynie	None
egzaminowałabyś	Conditional
szkołą	None
przyniosłaby	Conditional
odchodziłoby	Conditional
ogromnemu	None
zaiwańmy	Imperative-Jussive
pieprzyłybyśmy	Conditional
pomagaj	Imperative-Jussive
rozpaczałyby	Conditional
zapalilibyście	Conditional
rocznicą	None
zrabowałyby	Conditional
weźmy	Imperative-Jussive
rozróżnilibyście	Conditional
taj	Imperative-Jussive
przeczytalibyście	Conditional
kosztowałbyś	Conditional
wtorki	None
poprosiłoby	Conditional
poroniłybyście	Conditional
zerwałaby	Conditional
symulowałabyś	Conditional
numerowałoby	Conditional
potrzosami	None
miauczałoby	Conditional
obcasem	None
nieoficjalnym	None
odwzajemniłby	Conditional
plakatem	None
oddawajcie	Imperative-Jussive
pięłabym	Conditional
instytutach	None
nosach	None
Duńczyków	None
zarezerwowałybyście	Conditional
rozważyłybyście	Conditional
kontrolowana	None
ryby	None
gospodarek	None
pokazuj	Imperative-Jussive
dowódźcie	Imperative-Jussive
czytałyby	Conditional
urodziłabym	Conditional
tkanek	None
poprosiłbym	Conditional
szanowałabyś	Conditional
zebrałybyście	Conditional
strofach	None
flirtu	None
mylcie	Imperative-Jussive
dotknąłbyś	Conditional
pocilibyście	Conditional
porównywalni	None
flotę	None
pachnijcie	Imperative-Jussive
obrzękowi	None
żarówkach	None
rządziłabym	Conditional
półkula	None
petycją	None
denerwowałybyśmy	Conditional
zerową	None
unicestwilibyśmy	Conditional
zwojnicy	None
bojałybyśmy	Conditional
złą	None
roślibyśmy	Conditional
uciekałbym	Conditional
szalejcie	Imperative-Jussive
oszukujący	None
hiszpańska	None
podpali	None
wybralibyśmy	Conditional
zmyśliliby	Conditional
umierałabyś	Conditional
zasługiwałbym	Conditional
niewiasta	None
psalmów	None
odchodzili	None
ługiem	None
zmartwychwstawałybyśmy	Conditional
kolbie	None
szantażowałby	Conditional
zapomina	None
spróbowałybyście	Conditional
spotkalibyście	Conditional
pieprzyłybyście	Conditional
sapałabyś	Conditional
dziwiliby	Conditional
rozmawiajmy	Imperative-Jussive
wspominałaby	Conditional
pierzmy	Imperative-Jussive
chwiejmy	Imperative-Jussive
dokonaj	Imperative-Jussive
podałabyś	Conditional
dźwignęłyby	Conditional
pląsalibyśmy	Conditional
dźwięczną	None
usunęlibyście	Conditional
woniejmy	Imperative-Jussive
frezer	None
grzmiałbym	Conditional
szarogęsiłybyście	Conditional
błądziłby	Conditional
zaiwaniona	None
pralibyście	Conditional
działałaby	Conditional
bohatyrnęłaby	Conditional
oceniałaby	Conditional
ściągnięci	None
sikajcie	Imperative-Jussive
grzęzłabym	Conditional
egzystencjo	None
poprawiłybyśmy	Conditional
pogadałabyś	Conditional
drżałbyś	Conditional
słoniowi	None
potrzebowałby	Conditional
rozmawiałbym	Conditional
szanowałybyście	Conditional
skiba	None
egzaminowałbym	Conditional
podnosilibyście	Conditional
kapitalistami	None
zgubiliby	Conditional
ossuarium	None
dziewicza	None
pąkiem	None
pożyczylibyśmy	Conditional
dowodziłbyś	Conditional
rumuńskiego	None
pierdziałabym	Conditional
buchałabym	Conditional
identyfikowałem	None
małżonka	None
zamykałaby	Conditional
zbieralibyście	Conditional
próbowałyby	Conditional
mierzyłaby	Conditional
rozmyłabyś	Conditional
liniej	Imperative-Jussive
ostrzegaj	Imperative-Jussive
piszczeliby	Conditional
nakryłabym	Conditional
dodzwoniliby	Conditional
krawcowa	None
chciałbym	Conditional
schowałyby	Conditional
sterczyłabym	Conditional
planszą	None
usznym	None
sypałyby	Conditional
zabierz	Imperative-Jussive
zakonom	None
maskowałybyście	Conditional
galopuj	Imperative-Jussive
bakterie	None
suńmy	Imperative-Jussive
nośmy	Imperative-Jussive
zapomniałybyście	Conditional
szczepionkami	None
odpowiadałybyśmy	Conditional
banglalibyście	Conditional
połączyłaby	Conditional
tłumaczyłyby	Conditional
zerwałybyście	Conditional
wybrałybyście	Conditional
przestrzegałbyś	Conditional
ruńmy	Imperative-Jussive
burzcie	Imperative-Jussive
taborecie	None
biochemicznych	None
uderzyłby	Conditional
sarkałabym	Conditional
dowiedziałbyś	Conditional
stawałyby	Conditional
szalałby	Conditional
świerszczy	None
zniszczyłyby	Conditional
gęstwie	None
rozmyślalibyśmy	Conditional
pęknij	Imperative-Jussive
bankrutowałby	Conditional
obserwowalibyście	Conditional
rozróżniałbym	Conditional
nozdrze	None
czynniki	None
skończ	Imperative-Jussive
oddawałoby	Conditional
oddawaliby	Conditional
podajcie	Imperative-Jussive
zadzwonilibyśmy	Conditional
czyściłabym	Conditional
rozważyłoby	Conditional
niebezpieczeństwo	None
kręciłbyś	Conditional
kalosze	None
kicaj	Imperative-Jussive
psów	None
dożyłabyś	Conditional
zainsynuowałaby	Conditional
kładłyby	Conditional
dodałeś	None
kanalizacji	None
pokazałyby	Conditional
dowodziliby	Conditional
mocznika	None
zerkaj	Imperative-Jussive
wracałyby	Conditional
semantycznej	None
modliłoby	Conditional
nowościom	None
zastanawiajmy	Imperative-Jussive
zgubiłaby	Conditional
sikałabyś	Conditional
notowałbym	Conditional
mieszkaliby	Conditional
nazywaliby	Conditional
entuzjasty	None
napadem	None
wargowych	None
ufałybyście	Conditional
pogadałaby	Conditional
tajałaby	Conditional
wskazywałaby	Conditional
perskiemu	None
pozorny	None
dożyłyby	Conditional
znajmy	Imperative-Jussive
zatrzymaj	Imperative-Jussive
zapamiętaj	Imperative-Jussive
zapłaciliby	Conditional
machalibyśmy	Conditional
fiordzie	None
rżałoby	Conditional
kastrowałybyśmy	Conditional
uśpiłoby	Conditional
złupcie	Imperative-Jussive
pląsajcie	Imperative-Jussive
ostrożnej	None
pastwiskiem	None
rozmyśliłby	Conditional
poczekajmy	Imperative-Jussive
Rusek	None
szczenięta	None
zapamiętało	None
Gorzowem	None
antywirusa	None
sprzągłby	Conditional
kup	Imperative-Jussive
salonem	None
drukujmy	Imperative-Jussive
dwór	None
podpierdoliłabyś	Conditional
umyjmy	Imperative-Jussive
blondyni	None
pajaców	None
podniosłoby	Conditional
chwalmy	Imperative-Jussive
pątnikiem	None
telegrafowałybyście	Conditional
raziłby	Conditional
podkreślaniem	None
brzęczałbym	Conditional
krwawiłybyście	Conditional
marznęłabyś	Conditional
znikałabym	Conditional
drylowalibyście	Conditional
wersecie	None
optymistkę	None
sprzyjałyby	Conditional
refowałybyście	Conditional
tajcie	Imperative-Jussive
rozczarowałybyśmy	Conditional
śledziłaś	None
wdychałyby	Conditional
podpisałbym	Conditional
chcielibyście	Conditional
kwestionowałabyś	Conditional
ufaliby	Conditional
przeinaczylibyśmy	Conditional
rodziłybyście	Conditional
ignorowałaby	Conditional
nosy	None
gaworzyłbyś	Conditional
gnałabyś	Conditional
polimerowy	None
dręczyłybyście	Conditional
fonetyczną	None
zawarłby	Conditional
zalogowałybyście	Conditional
zapamiętalibyście	Conditional
odradzałby	Conditional
jebnijmy	Imperative-Jussive
wiadrom	None
ubóstwiałby	Conditional
niewidoma	None
biopaliwo	None
matce	None
unicestwiliby	Conditional
statystach	None
przeinaczyłoby	Conditional
wdepnęlibyście	Conditional
dożyłoby	Conditional
pozwalałybyśmy	Conditional
obraźmy	Imperative-Jussive
oddychałabyś	Conditional
dokonalibyście	Conditional
pijani	None
oddawałybyście	Conditional
trzon	None
dusiłabyś	Conditional
roztrzepcie	Imperative-Jussive
ukryj	Imperative-Jussive
prawidłowy	None
czynność	None
hit	None
podrywalibyście	Conditional
gońcie	Imperative-Jussive
wygralibyśmy	Conditional
prezesów	None
odczyniłabym	Conditional
więdnęłybyście	Conditional
oszukaliby	Conditional
koś	Imperative-Jussive
spodziewały	None
śpiewaj	Imperative-Jussive
chwalcie	Imperative-Jussive
potrzebowałoby	Conditional
podchodziłabyś	Conditional
oblężeniu	None
wyjeb	Imperative-Jussive
wschodźcie	Imperative-Jussive
zadzwońmy	Imperative-Jussive
punktowi	None
złamałyby	Conditional
czułyby	Conditional
las	None
pocieszyłoby	Conditional
maszerowalibyśmy	Conditional
zatrzymałbyś	Conditional
wielkich	None
poprowadziłbym	Conditional
zabijałby	Conditional
suńcie	Imperative-Jussive
kontaktom	None
objawach	None
kłułoby	Conditional
przeszkadzałabyś	Conditional
nurkowałam	None
kłóćcie	Imperative-Jussive
księgarnia	None
polecajmy	Imperative-Jussive
sklejkę	None
posłuchaj	Imperative-Jussive
skończymy	None
śpiewaczkom	None
zalogowałaby	Conditional
drgalibyśmy	Conditional
najzdolniejszymi	None
wygraj	Imperative-Jussive
próbowałbyś	Conditional
szukalibyście	Conditional
przygotujcie	Imperative-Jussive
zgubilibyście	Conditional
wylaszczyłbyś	Conditional
dolnołużycka	None
nalewałbyś	Conditional
upuściliby	Conditional
dręczyliby	Conditional
przepraszałbym	Conditional
ubóstwiajcie	Imperative-Jussive
odbudowalibyście	Conditional
abonowałoby	Conditional
zmieńmy	Imperative-Jussive
zmieniłybyśmy	Conditional
odbudowaliby	Conditional
umarłabyś	Conditional
złamalibyśmy	Conditional
chłeptałaby	Conditional
należałabyś	Conditional
denerwowaliby	Conditional
pożarłbym	Conditional
spałby	Conditional
zabiłybyście	Conditional
tyłoby	Conditional
cydrze	None
wanną	None
nieprzygotowany	None
znalazłoby	Conditional
dziejące	None
zweryfikuj	Imperative-Jussive
akupresurach	None
bokami	None
dostarczałbyś	Conditional
hasałoby	Conditional
opatentowałyby	Conditional
polimerową	None
napowietrzyłby	Conditional
obgadaj	Imperative-Jussive
skończyłyby	Conditional
spieprzałabyś	Conditional
obiecuj	Imperative-Jussive
pożądałabym	Conditional
czytałaby	Conditional
uczęszczalibyśmy	Conditional
zgromadzenie	None
mruczałoby	Conditional
wytłumacz	Imperative-Jussive
splądrowalibyśmy	Conditional
strzelasz	None
komentarzach	None
osądy	None
barmani	None
napisałyby	Conditional
siadaj	Imperative-Jussive
wspomniałby	Conditional
otrzymaj	Imperative-Jussive
zabiłbyś	Conditional
wyjaśniłbym	Conditional
polimer	None
hierarchami	None
izomorfizmem	None
pokutami	None
potakujcie	Imperative-Jussive
pędziliby	Conditional
skręciłaby	Conditional
przyjmijcie	Imperative-Jussive
przysięgałyby	Conditional
walutę	None
broiłbyś	Conditional
przyjęłabym	Conditional
skakałbyś	Conditional
przypuściłby	Conditional
słyszałbyś	Conditional
edytuj	Imperative-Jussive
najgłośniejszemu	None
grzmiałaby	Conditional
dałabyś	Conditional
słuchałby	Conditional
wędrowałyby	Conditional
dyszałbym	Conditional
suszyłoby	Conditional
niknąłbyś	Conditional
kłujcie	Imperative-Jussive
spałoby	Conditional
wyloguj	Imperative-Jussive
uwiedziecie	None
mistrzów	None
mamrotałbym	Conditional
dymiłbyś	Conditional
przeżujcie	Imperative-Jussive
dobru	None
przeczytajmy	Imperative-Jussive
wywołałby	Conditional
kłóciłabym	Conditional
wyjrzelibyście	Conditional
jodłowałybyśmy	Conditional
umyjcie	Imperative-Jussive
potwierdzałybyśmy	Conditional
tolerowałybyście	Conditional
sapałbyś	Conditional
kradnij	Imperative-Jussive
dmuchalibyśmy	Conditional
szukaj	Imperative-Jussive
ripostowałabym	Conditional
motor	None
śpieszyłyby	Conditional
płaciłybyśmy	Conditional
przeleciał	None
doceniajcie	Imperative-Jussive
opierdolmy	Imperative-Jussive
wierzcie	Imperative-Jussive
wiatrak	None
zwyciężamy	None
dałabym	Conditional
usuwałaby	Conditional
wsparłabym	Conditional
rzuciłyby	Conditional
padajmy	Imperative-Jussive
nakryłyby	Conditional
buchałabyś	Conditional
opata	None
uważałybyście	Conditional
dromadery	None
pokazałyśmy	None
jęłyby	Conditional
skłamały	None
plikami	None
zaczynaj	Imperative-Jussive
ukrywałyby	Conditional
hojnymi	None
rozproszyłabym	Conditional
marudziłaby	Conditional
kicałyby	Conditional
przeżyłybyście	Conditional
łaknęłyby	Conditional
drylujmy	Imperative-Jussive
odbierajmy	Imperative-Jussive
pokrywalibyśmy	Conditional
dostawałby	Conditional
pokazywałby	Conditional
malinowa	None
obserwowaliby	Conditional
zainsynuowaliby	Conditional
stadionem	None
składałybyśmy	Conditional
otwórzcie	Imperative-Jussive
spałaszowaliby	Conditional
polu	None
przesadzajmy	Imperative-Jussive
rozpaczałabym	Conditional
agawy	None
płazińcu	None
oddychaj	Imperative-Jussive
opróżniłaby	Conditional
zaczekajmy	Imperative-Jussive
formalnej	None
kserowalibyśmy	Conditional
opuszczałabyś	Conditional
najgorszym	None
smołę	None
docenialiby	Conditional
telefonowalibyście	Conditional
dziobałyby	Conditional
ujadajmy	Imperative-Jussive
zapraszalibyście	Conditional
ciotki	None
żułyby	Conditional
uciekałybyśmy	Conditional
orła	None
nurkowałyby	Conditional
dosięgnęlibyście	Conditional
kibicowaliby	Conditional
migawka	None
krój	Imperative-Jussive
guglalibyśmy	Conditional
weterynarza	None
grabmy	Imperative-Jussive
gdyńska	None
ostrej	None
spirytusem	None
samobójstwami	None
analizy	None
wieczór	None
dożywotnią	None
umierałabym	Conditional
odmienni	None
unikają	None
torpedo	None
narzekałoby	Conditional
przegraliby	Conditional
podchodziłybyście	Conditional
odkrywałbym	Conditional
biegalibyście	Conditional
zniknęlibyśmy	Conditional
rozróżnijmy	Imperative-Jussive
dosięgnęłabym	Conditional
rewolucyjne	None
obsesję	None
rabinom	None
ograniczałabym	Conditional
hymnami	None
jadajmy	Imperative-Jussive
alternatywnym	None
zaciążyłaby	Conditional
umyłaby	Conditional
sfałszowalibyśmy	Conditional
jajkami	None
pożądałabyś	Conditional
przysięgaj	Imperative-Jussive
periodykami	None
kibicowałyście	None
namawialiby	Conditional
wystarczałyby	Conditional
walcu	None
gorzej	Imperative-Jussive
przepraszajmy	Imperative-Jussive
kostarykańskich	None
sapałybyśmy	Conditional
płaciłabyś	Conditional
sprzyjałybyśmy	Conditional
chwiałabym	Conditional
kupilibyście	Conditional
ziemio	None
dziwmy	Imperative-Jussive
automatach	None
klonami	None
karaluchów	None
zapierdalałybyście	Conditional
notowałyby	Conditional
przepraszałoby	Conditional
zarabialibyśmy	Conditional
marliby	Conditional
sprzedanie	None
fotosyntezami	None
rozpaczałybyśmy	Conditional
zrzuciłabyś	Conditional
stawiałoby	Conditional
prochem	None
śmiałaby	Conditional
ignorowani	None
dbałabyś	Conditional
niżami	None
zbyłby	Conditional
sądź	Imperative-Jussive
złymi	None
umówią	None
klimatyzacjach	None
ćwiczący	None
spodziewaj	Imperative-Jussive
zmienialibyście	Conditional
znaczyłybyśmy	Conditional
wiałbyś	Conditional
lubiłyby	Conditional
wykrwawiłoby	Conditional
zastanawialibyście	Conditional
wystarczałybyśmy	Conditional
lansuj	Imperative-Jussive
pokazałby	Conditional
rozmyłbyś	Conditional
płaciłabym	Conditional
cofałabyś	Conditional
okultyzmowi	None
dymiliby	Conditional
złapałabyś	Conditional
buchałaby	Conditional
męskorzeczowej	None
organizowałby	Conditional
poprawną	None
dziwiłybyśmy	Conditional
mogiłę	None
zmieniałoby	Conditional
latawcowi	None
tłumaczcie	Imperative-Jussive
zapominalibyście	Conditional
maszerujmy	Imperative-Jussive
ćmie	None
dziobałybyście	Conditional
ulubieni	None
pielgrzymie	None
szantażowałbym	Conditional
usuwaliby	Conditional
robiłybyście	Conditional
pestka	None
sarkałbym	Conditional
bywaj	Imperative-Jussive
zaryzykuj	Imperative-Jussive
sprawdzianów	None
śledziłoby	Conditional
zabójstwom	None
ukradłbyś	Conditional
mulczowałoby	Conditional
mankietów	None
dźwignęliby	Conditional
słuchałabym	Conditional
egzekucyjną	None
wpływalibyście	Conditional
pytałybyśmy	Conditional
kimacie	None
napisałbym	Conditional
świnka	None
obrazilibyśmy	Conditional
oceniałbym	Conditional
wymagałaby	Conditional
wyłudzajmy	Imperative-Jussive
mierząc	None
kolekcjonowałbym	Conditional
fatalistach	None
kleilibyśmy	Conditional
żuliby	Conditional
zialiby	Conditional
gadaliby	Conditional
wyrzuciłbyś	Conditional
sprzątnęłabyś	Conditional
śpieszmy	Imperative-Jussive
skąpstwu	None
dój	Imperative-Jussive
śmierdziałam	None
chełpiłybyście	Conditional
złóżmy	Imperative-Jussive
nadepnęlibyście	Conditional
znalibyście	Conditional
tłumaczmy	Imperative-Jussive
zróbcie	Imperative-Jussive
otrułyby	Conditional
nękany	None
sapałby	Conditional
wąchałybyśmy	Conditional
rąbałaby	Conditional
wskazałyby	Conditional
odbijałyby	Conditional
gaworzyliśmy	None
moczcie	Imperative-Jussive
lutowałbyś	Conditional
dawałoby	Conditional
dźwignęlibyśmy	Conditional
rozsadzaj	Imperative-Jussive
szcza	None
rozmawiałby	Conditional
przeinaczyłaby	Conditional
przegrajcie	Imperative-Jussive
runąłby	Conditional
koiłybyśmy	Conditional
złóż	Imperative-Jussive
ścignęłyby	Conditional
obserwujcie	Imperative-Jussive
doprowadzałbym	Conditional
łzach	None
przeliczalnej	None
pełnym	None
wyj	Imperative-Jussive
samozaoranie	None
połączyłbym	Conditional
wędrowałbym	Conditional
zwyciężaj	Imperative-Jussive
wózkach	None
umierałbym	Conditional
panowałabyś	Conditional
przestrzegaj	Imperative-Jussive
pojawiało	None
zoologów	None
uśpiłaby	Conditional
czekalibyśmy	Conditional
rodząc	None
obiecywałyby	Conditional
martwiłybyście	Conditional
krwawilibyśmy	Conditional
wyprasowani	None
otrzymałabyś	Conditional
przypomnieliby	Conditional
wytryskiwałybyście	Conditional
ukradłaby	Conditional
skracaliby	Conditional
przyjmowałaby	Conditional
machajmy	Imperative-Jussive
koziorożcem	None
zatok	None
zazdrośćmy	Imperative-Jussive
poznałbyś	Conditional
kąsałyby	Conditional
połykałaby	Conditional
wygrano	None
zawarło	None
zmartwychwstawajmy	Imperative-Jussive
rosyjskimi	None
grzebajmy	Imperative-Jussive
egzorcyzmu	None
siedzieliby	Conditional
wyrzucilibyśmy	Conditional
połykałybyśmy	Conditional
siedziałabym	Conditional
spałaszowałaby	Conditional
umysłów	None
denerwujcie	Imperative-Jussive
roztrzepalibyśmy	Conditional
psychosomatycznej	None
wyjaśniałyby	Conditional
chrzciłabyś	Conditional
uważałyby	Conditional
obrzęknęłabyś	Conditional
warkocz	None
przyniosłoby	Conditional
tolerowalibyście	Conditional
chowalibyśmy	Conditional
bezlitosnymi	None
zamknęlibyśmy	Conditional
sprawniejsza	None
ripostuj	Imperative-Jussive
małpujmy	Imperative-Jussive
ruchajmy	Imperative-Jussive
sapałaby	Conditional
pochodziłybyście	Conditional
logicznymi	None
wykorzystywałabyś	Conditional
opatentowało	None
dobyłabyś	Conditional
nękajcie	Imperative-Jussive
broszce	None
poiłyby	Conditional
igrałbym	Conditional
marłaby	Conditional
barbarzyńca	None
semantykę	None
tlałaby	Conditional
sardynki	None
polowałyby	Conditional
selenem	None
wzięłabym	Conditional
uznawałybyśmy	Conditional
jąkajcie	Imperative-Jussive
parlamentarzystą	None
googlowaliby	Conditional
abnegatami	None
zadzwoniłbyś	Conditional
kasiarze	None
wymówiłaby	Conditional
zoologicznej	None
dodawałoby	Conditional
zamkniętej	None
ufałby	Conditional
ćpałybyście	Conditional
rozczarowałbym	Conditional
broilibyśmy	Conditional
przeczyta	None
zdiagnozowałbyś	Conditional
czują	None
sądom	None
chroniliście	None
chciałeś	None
muszlach	None
zapamiętałoby	Conditional
przodowałybyście	Conditional
zaloguj	Imperative-Jussive
kalmarów	None
kierowaliby	Conditional
diecezji	None
ścignęłabyś	Conditional
tapet	None
splądrowałaby	Conditional
kłóciłyby	Conditional
dowiedziałbym	Conditional
kibicowałabyś	Conditional
żłób	None
haftowałbym	Conditional
śpiewajmy	Imperative-Jussive
połykałby	Conditional
dworcach	None
puścilibyśmy	Conditional
symulowałyby	Conditional
guglaj	Imperative-Jussive
cytwarze	None
kroilibyście	Conditional
drożdżówkę	None
schnęlibyście	Conditional
żartuj	Imperative-Jussive
zawrzyjmy	Imperative-Jussive
jednobarwna	None
wywoływałoby	Conditional
mięsnymi	None
poróżniłaby	Conditional
ocelotowi	None
bezwzględnemu	None
siusialibyśmy	Conditional
najmniejsze	None
asemblera	None
dymalibyście	Conditional
opuszczałabym	Conditional
gwizdku	None
nutami	None
wybuchnęlibyśmy	Conditional
żartowalibyście	Conditional
klęczałoby	Conditional
marz	Imperative-Jussive
wylałby	Conditional
polujmy	Imperative-Jussive
dosrajmy	Imperative-Jussive
kastom	None
wygrałybyśmy	Conditional
droższym	None
podejrzewaj	Imperative-Jussive
produkowałbyś	Conditional
wylogowałabym	Conditional
dzierżona	None
żyłabym	Conditional
wymusiłbym	Conditional
jadłowstręt	None
gaworzylibyśmy	Conditional
spięłaby	Conditional
latałybyście	Conditional
powtarzajcie	Imperative-Jussive
stracilibyśmy	Conditional
dymiłyby	Conditional
uderzylibyśmy	Conditional
męczyłybyście	Conditional
ekstrakcie	None
wygrajmy	Imperative-Jussive
modliłyby	Conditional
zimowej	None
wymiotowałbyś	Conditional
pokrywałaby	Conditional
bawełnom	None
odebrałybyście	Conditional
czyść	Imperative-Jussive
ripostach	None
wysyłałbyś	Conditional
nomadów	None
aortach	None
boskie	None
kwilmy	Imperative-Jussive
obalałabyś	Conditional
postradałybyście	Conditional
mijajcie	Imperative-Jussive
Greczynkami	None
poznaj	Imperative-Jussive
cukrzyca	None
zniknąłby	Conditional
medytacjach	None
zatrzymaliby	Conditional
cebulowym	None
bojałabyś	Conditional
lansowaliby	Conditional
pederastą	None
rozstajom	None
czepkami	None
lekcji	None
odbijalibyście	Conditional
zaruchalibyśmy	Conditional
rżałaby	Conditional
zapierdalałoby	Conditional
półką	None
samo	None
karz	Imperative-Jussive
nalewałoby	Conditional
wracałabyś	Conditional
broniach	None
moteli	None
medytowałbym	Conditional
przekomarzał	None
inwestycjach	None
marudzilibyście	Conditional
donica	None
proponowałyby	Conditional
wybuchałabym	Conditional
posiadający	None
najodmienniejsze	None
mknęłybyście	Conditional
chwal	Imperative-Jussive
sprzeczka	None
rzuciłabyś	Conditional
chełpiłbym	Conditional
pustką	None
namawialibyśmy	Conditional
haftowałaby	Conditional
morwy	None
społecznych	None
tlejcie	Imperative-Jussive
opisywałbym	Conditional
marynarzem	None
gniłabyś	Conditional
odjebani	None
zagnij	Imperative-Jussive
zakładki	None
zdóbmy	Imperative-Jussive
sterczyliby	Conditional
groteskowe	None
kaszlałoby	Conditional
szantażowalibyście	Conditional
oceniałby	Conditional
lgnęłabyś	Conditional
usunęlibyśmy	Conditional
wybuchalibyśmy	Conditional
rzygałaby	Conditional
szanujmy	Imperative-Jussive
wyjebaliby	Conditional
myliłabym	Conditional
cząbry	None
Chorwatami	None
rodzinie	None
dotykajmy	Imperative-Jussive
plułbym	Conditional
rzucaj	Imperative-Jussive
złożyłybyście	Conditional
dedykowałbym	Conditional
zbyłybyście	Conditional
zbożowa	None
nurkowałaby	Conditional
opiekowanie	None
leźcie	Imperative-Jussive
smutalibyśmy	Conditional
zasługiwałybyśmy	Conditional
marmoladami	None
zawiodłyby	Conditional
jąkałabyś	Conditional
otrzymywałby	Conditional
najsłabszą	None
wschodziłoby	Conditional
należałby	Conditional
śmiałbym	Conditional
czesałybyście	Conditional
dusząc	None
gniłyby	Conditional
gaworzyłybyście	Conditional
występowaliby	Conditional
sprawiajcie	Imperative-Jussive
milczałaby	Conditional
rąbalibyście	Conditional
pokorę	None
subtropikalne	None
notatniku	None
stewardessą	None
szwagrami	None
parskalibyście	Conditional
zaufaj	Imperative-Jussive
zamarzajmy	Imperative-Jussive
śmieszkowałaby	Conditional
brońmy	Imperative-Jussive
przegap	Imperative-Jussive
wybrałybyśmy	Conditional
zadałeś	None
broniłbym	Conditional
odpowiadałabyś	Conditional
bankrutowalibyście	Conditional
zebrałabym	Conditional
rozmyślalibyście	Conditional
raźcie	Imperative-Jussive
królewskiego	None
lakierów	None
zamykałby	Conditional
dawajcie	Imperative-Jussive
kominków	None
poprzedzałabym	Conditional
kubańskiemu	None
polowałabyś	Conditional
występowałaby	Conditional
chowają	None
zaproście	Imperative-Jussive
racjonalizmem	None
broiłabym	Conditional
poczekaliby	Conditional
igrałybyście	Conditional
rozkładów	None
zasługiwałoby	Conditional
zniknęlibyście	Conditional
rozsadzałaby	Conditional
zaruchaj	Imperative-Jussive
kurz	None
dziw	Imperative-Jussive
najmilszymi	None
pieprzcie	Imperative-Jussive
mięknąłbym	Conditional
lgnęłaby	Conditional
drgałoby	Conditional
pocieszyłbyś	Conditional
okazałyby	Conditional
zbiegałaby	Conditional
klikalibyśmy	Conditional
jonosfera	None
sygnałach	None
wiosłowałybyście	Conditional
przeprosiłabyś	Conditional
przypuszczajmy	Imperative-Jussive
azjatyckiej	None
lisiątkiem	None
przyjęłabyś	Conditional
rąbałbym	Conditional
buchałyby	Conditional
zmieniałaby	Conditional
zabiłaby	Conditional
drylujcie	Imperative-Jussive
kręcono	None
wyniosłabyś	Conditional
googlowałybyście	Conditional
lubiłabym	Conditional
ripostowałabyś	Conditional
uciekałabyś	Conditional
opowiadałyby	Conditional
zerżnęliby	Conditional
śmierdziałbyś	Conditional
gwizdałybyśmy	Conditional
podpiszmy	Imperative-Jussive
skłamałybyście	Conditional
przypominałoby	Conditional
skończyłabyś	Conditional
pożyczajmy	Imperative-Jussive
czuj	Imperative-Jussive
miewajmy	Imperative-Jussive
dalii	None
buty	None
zmień	Imperative-Jussive
przekomarzałabym	Conditional
obrzęknęłaby	Conditional
guglajmy	Imperative-Jussive
przynosiłyby	Conditional
wykopcie	Imperative-Jussive
przeinacz	Imperative-Jussive
kochankę	None
spieprzałoby	Conditional
kupiłbym	Conditional
łamałybyśmy	Conditional
brzęczałaby	Conditional
szarogęsilibyście	Conditional
ryczałbyś	Conditional
esencji	None
hamuj	Imperative-Jussive
brodziliby	Conditional
oszukaj	Imperative-Jussive
wielojęzycznymi	None
promienie	None
narody	None
obrażałaby	Conditional
hamowałyby	Conditional
ruszałabym	Conditional
dożyłybyśmy	Conditional
wymyśliłybyśmy	Conditional
nękałabym	Conditional
wyjęliby	Conditional
kłóciłbyś	Conditional
dziękujcie	Imperative-Jussive
zaprzeczylibyśmy	Conditional
spieprz	Imperative-Jussive
jąkalibyście	Conditional
podochodziłabyś	Conditional
zapraszałybyśmy	Conditional
spięlibyście	Conditional
poprawiajcie	Imperative-Jussive
straćcie	Imperative-Jussive
paliłbyś	Conditional
akumulatorami	None
dostawałabym	Conditional
kłamałbym	Conditional
granicz	Imperative-Jussive
dedykowanie	None
opatentujmy	Imperative-Jussive
szalałybyśmy	Conditional
uderzałoby	Conditional
atakowałybyście	Conditional
raziłbyś	Conditional
wpływałybyśmy	Conditional
dowiedzielibyśmy	Conditional
szczekać	None
skręciłyby	Conditional
wykrwaw	Imperative-Jussive
ładowaliby	Conditional
unicestwiłyby	Conditional
katastrofalnej	None
mądrzyłby	Conditional
przekwitałaby	Conditional
nieskończonym	None
wytryskiwałby	Conditional
esemesowałaby	Conditional
zaprosilibyście	Conditional
wyżąłbyś	Conditional
wyrzuciłybyście	Conditional
znikałoby	Conditional
kucałbym	Conditional
galopujmy	Imperative-Jussive
spałabyś	Conditional
dezodorantu	None
zamknij	Imperative-Jussive
kadzidło	None
paliła	None
kopiujmy	Imperative-Jussive
przypuszczałem	None
bromową	None
znajdowałyby	Conditional
lubilibyście	Conditional
wygrałyby	Conditional
cosinus	None
tęskniliby	Conditional
wynieście	Imperative-Jussive
spadaliby	Conditional
bytomskiej	None
odległościom	None
traumatolog	None
popraw	Imperative-Jussive
przepraszałyby	Conditional
trudu	None
złap	Imperative-Jussive
karałybyście	Conditional
grzebałbyś	Conditional
przypuszczałbym	Conditional
oddajmy	Imperative-Jussive
pożądajcie	Imperative-Jussive
dowiedzielibyście	Conditional
usuńcie	Imperative-Jussive
zapłaciłybyśmy	Conditional
kwestionujmy	Imperative-Jussive
klikaliby	Conditional
opatentowaliby	Conditional
wyjaśniaj	Imperative-Jussive
uderz	Imperative-Jussive
nieprzyjemnego	None
śpieszyłeś	None
wyroku	None
zamordystyczny	None
gwizdalibyście	Conditional
tatuażem	None
nosilibyście	Conditional
kopiowałyby	Conditional
podnosiłby	Conditional
smakujcie	Imperative-Jussive
wytryskuj	Imperative-Jussive
spróbowałby	Conditional
pijałabyś	Conditional
naprawom	None
poiłybyście	Conditional
szalałbyś	Conditional
umawiałbym	Conditional
skakałabym	Conditional
gnilibyśmy	Conditional
poruchałybyśmy	Conditional
zawarcie	None
podpaliłaby	Conditional
uratowałybyście	Conditional
pojawmy	Imperative-Jussive
sfałszowałaby	Conditional
skrzypmy	Imperative-Jussive
marzmy	Imperative-Jussive
ściągaliby	Conditional
sunęliby	Conditional
najgłupszemu	None
okrągłe	None
zrzuć	Imperative-Jussive
zainsynuowałby	Conditional
pasieki	None
płaciłbym	Conditional
alkoholowych	None
rozbiłbym	Conditional
kupiłyby	Conditional
usuń	Imperative-Jussive
doceniałby	Conditional
czeluścią	None
zawrzyjcie	Imperative-Jussive
niderlandzki	None
zburzcie	Imperative-Jussive
przedostatnią	None
polowałam	None
tarczom	None
saksofonisty	None
działałby	Conditional
konfigurowałoby	Conditional
kopiowalibyście	Conditional
zbyłabym	Conditional
piszcie	Imperative-Jussive
pożyczyłoby	Conditional
szczekałyby	Conditional
parowozowni	None
zabierzcie	Imperative-Jussive
skracałybyście	Conditional
ściągajmy	Imperative-Jussive
zbieraj	Imperative-Jussive
trąciłyby	Conditional
absorbowałybyśmy	Conditional
dąsalibyście	Conditional
ogarniałabyś	Conditional
wymyśliłybyście	Conditional
zerżnijmy	Imperative-Jussive
miewałaby	Conditional
zaliczkach	None
usuńmy	Imperative-Jussive
tłumaczyłabym	Conditional
obalałby	Conditional
indyjska	None
ujebałby	Conditional
dodaj	Imperative-Jussive
trudnymi	None
rozważcie	Imperative-Jussive
organizowałabyś	Conditional
smażyłabyś	Conditional
skakałby	Conditional
nęciliby	Conditional
wierzyłby	Conditional
przypuszczałyby	Conditional
zmieniłbyś	Conditional
jajnikowi	None
wujkiem	None
ślepiec	None
koniakom	None
wyhaftowałaby	Conditional
chroniłoby	Conditional
wahałaby	Conditional
zamknąłbym	Conditional
filmoteką	None
półroczu	None
opierdoliłabyś	Conditional
odmianach	None
kupowaliby	Conditional
pijalibyście	Conditional
martwiłabyś	Conditional
zasługiwałam	None
obserwowałaś	None
tenisowym	None
należałaby	Conditional
rzeźni	None
pointą	None
zostawilibyśmy	Conditional
rodziców	None
konwersacji	None
stroik	None
wysiadłby	Conditional
zesralibyście	Conditional
bojałbyś	Conditional
tłumaczyłby	Conditional
dochodziłbym	Conditional
komentowałbyś	Conditional
jamnik	None
czerepem	None
imponowaliby	Conditional
wykrwawiłaby	Conditional
notatkę	None
wkurwiajmy	Imperative-Jussive
maskowałbyś	Conditional
betonowaliby	Conditional
pokazałaby	Conditional
ładujcie	Imperative-Jussive
śmierdzą	None
kopcie	Imperative-Jussive
sportowcom	None
chwaliłybyśmy	Conditional
wymiksuj	Imperative-Jussive
złapałybyśmy	Conditional
wymyślajcie	Imperative-Jussive
męczyłabym	Conditional
obrzęknąłbym	Conditional
zrobiłoby	Conditional
kłujmy	Imperative-Jussive
puszczałoby	Conditional
polecałybyśmy	Conditional
absorbował	None
festiwali	None
zimowałyby	Conditional
zapalmy	Imperative-Jussive
rzeczywistymi	None
łamałabym	Conditional
prałbym	Conditional
wykorzystywałbym	Conditional
ignorujcie	Imperative-Jussive
wylogujcie	Imperative-Jussive
uderzyłybyście	Conditional
filiżankach	None
zamordowałoby	Conditional
wywołałyby	Conditional
zabrałoby	Conditional
śrub	None
zbiegałbym	Conditional
goły	None
szczecinę	None
zamknęłaby	Conditional
ryczelibyśmy	Conditional
czekoladce	None
potwierdzalibyście	Conditional
notariuszu	None
porozmawiałabym	Conditional
umówmy	Imperative-Jussive
spieszmy	Imperative-Jussive
bezalkoholowych	None
śmierciami	None
zabrałby	Conditional
paradoksalna	None
fińskie	None
maturach	None
poduszeczka	None
organizujmy	Imperative-Jussive
wdepnęłaby	Conditional
obiecaliby	Conditional
pojawiałabym	Conditional
niszczony	None
jmij	Imperative-Jussive
klawiszy	None
oddałby	Conditional
kandelo	None
płonęlibyście	Conditional
ładujmy	Imperative-Jussive
odwzajemniłybyście	Conditional
pamięciami	None
chrzciłybyście	Conditional
bromem	None
ignorowałybyśmy	Conditional
goniłby	Conditional
kręcą	None
sterczcie	Imperative-Jussive
schlebiałybyście	Conditional
śniłybyśmy	Conditional
łudziłbyś	Conditional
podniosłbym	Conditional
medytowalibyście	Conditional
łaźniom	None
wdepnąć	None
denerwujmy	Imperative-Jussive
sapalibyście	Conditional
zwymyślałabym	Conditional
stanówmy	Imperative-Jussive
oszukujcie	Imperative-Jussive
poprawmy	Imperative-Jussive
zawartość	None
rozwiązałybyśmy	Conditional
pobralibyśmy	Conditional
jeźdźmy	Imperative-Jussive
zarżnęłabym	Conditional
chciejcie	Imperative-Jussive
ruszyłby	Conditional
solom	None
wylaszczmy	Imperative-Jussive
lazłybyście	Conditional
szanuj	Imperative-Jussive
golenie	None
kręć	Imperative-Jussive
ruszyłyby	Conditional
przeczytała	None
wyruchalibyśmy	Conditional
męczmy	Imperative-Jussive
akson	None
rajtuzach	None
zaufajcie	Imperative-Jussive
siadałoby	Conditional
hasałaby	Conditional
ludowym	None
wonielibyśmy	Conditional
grzebałabym	Conditional
wyjrzałyby	Conditional
oceniali	None
papierka	None
zestawiłabym	Conditional
wymusiłbyś	Conditional
kompilowałybyście	Conditional
wschodziłyby	Conditional
używałabym	Conditional
krokusa	None
kapowałaby	Conditional
zbieraliby	Conditional
ciepłemu	None
naprawiałoby	Conditional
łąka	None
australijskiej	None
zbyłbyś	Conditional
odstawiłybyście	Conditional
dąsacie	None
zmieniłyby	Conditional
maszerujcie	Imperative-Jussive
majsterkujmy	Imperative-Jussive
drgałaby	Conditional
tracilibyśmy	Conditional
piszcząca	None
wersetów	None
należeć	None
wyprasowalibyście	Conditional
katolickie	None
znikałby	Conditional
wyniosłybyście	Conditional
występowałby	Conditional
czytałybyście	Conditional
mordowalibyśmy	Conditional
dochodziłabym	Conditional
dobądźmy	Imperative-Jussive
cykadom	None
oddalibyście	Conditional
lazłabym	Conditional
chadzałbyś	Conditional
pochodźmy	Imperative-Jussive
przynieślibyście	Conditional
głodnymi	None
rozsadzałyby	Conditional
zantagonizowałby	Conditional
potwierdziłbym	Conditional
przeżyj	Imperative-Jussive
trwaj	Imperative-Jussive
bawełna	None
okultyzm	None
pieprzyłyby	Conditional
zawiścią	None
poprawiłabym	Conditional
poroniłoby	Conditional
znosiłabyś	Conditional
wodociągi	None
podnosiłybyśmy	Conditional
spadałby	Conditional
spóźnionych	None
ogoliłabym	Conditional
sypałby	Conditional
bełtałybyśmy	Conditional
pogadajmy	Imperative-Jussive
błądź	Imperative-Jussive
banitą	None
chłeptałby	Conditional
chłeptałabyś	Conditional
bywałbym	Conditional
karmiły	None
zauważcie	Imperative-Jussive
manometrach	None
ukryłaby	Conditional
leminga	None
niedwuznacznej	None
zrabowalibyście	Conditional
macewach	None
uznawałbym	Conditional
szkopom	None
więcierze	None
zioła	None
debil	None
śpiewałoby	Conditional
ziewał	None
strzelajcie	Imperative-Jussive
nastaw	Imperative-Jussive
cytujmy	Imperative-Jussive
jąkałoby	Conditional
blondynką	None
rabinami	None
spróbowałabym	Conditional
zmienilibyście	Conditional
róbcie	Imperative-Jussive
Pers	None
wysyłałoby	Conditional
jęłabyś	Conditional
zapomniałbym	Conditional
skakali	None
doprowadzałyby	Conditional
marudziłyby	Conditional
słyszelibyście	Conditional
zaniechałbym	Conditional
wyłyby	Conditional
strać	Imperative-Jussive
krótszej	None
robiłam	None
traciłbyś	Conditional
podlewałyście	None
odstawiłby	Conditional
dzierżyłybyście	Conditional
zebralibyście	Conditional
transformatorów	None
bohatyrnęłybyście	Conditional
bełtałaby	Conditional
pogrzebałabym	Conditional
dupczyłeś	None
jebnąłby	Conditional
gromadziłby	Conditional
pozwalałybyście	Conditional
kukałybyście	Conditional
obiecywałabyś	Conditional
lgnijmy	Imperative-Jussive
ustnym	None
wytłumaczyłybyście	Conditional
oraniu	None
lalkami	None
storczyka	None
leczyłbyś	Conditional
dymaj	Imperative-Jussive
monarchami	None
przezimujcie	Imperative-Jussive
koleżankę	None
cepów	None
przeżyłby	Conditional
tlałabyś	Conditional
drzewa	None
napierdalamy	None
kucajmy	Imperative-Jussive
oddalibyśmy	Conditional
autobus	None
płonąłbyś	Conditional
kośmy	Imperative-Jussive
nosze	None
piegi	None
ukrywajcie	Imperative-Jussive
asyryjskiemu	None
wahadło	None
podczerwoną	None
atakuj	Imperative-Jussive
szukajmy	Imperative-Jussive
zaopatrzenia	None
okazałby	Conditional
biegałabym	Conditional
wysyłałabym	Conditional
mądrzyłoby	Conditional
łazilibyście	Conditional
umarłoby	Conditional
rozsadzajmy	Imperative-Jussive
podnosiłbyś	Conditional
negacji	None
ograniczajcie	Imperative-Jussive
kwestionuj	Imperative-Jussive
bojałaby	Conditional
świerzbiałbym	Conditional
gromadźmy	Imperative-Jussive
kipielibyście	Conditional
smutałbym	Conditional
kursowi	None
zjadłabym	Conditional
kłębem	None
studiowałoby	Conditional
dziwiłabyś	Conditional
galopowaliby	Conditional
gotowałybyśmy	Conditional
zaczekałaby	Conditional
drażniłybyście	Conditional
wyrzuciłabyś	Conditional
jadałybyśmy	Conditional
wybierzcie	Imperative-Jussive
dekadach	None
gdakałabym	Conditional
bankrutowałabyś	Conditional
zalogowalibyśmy	Conditional
kierujcie	Imperative-Jussive
śpieszylibyście	Conditional
podgrupo	None
zamordowana	None
złożyłybyśmy	Conditional
sztormów	None
powtórzyłbyś	Conditional
wyłudzałabyś	Conditional
odwiedzałybyście	Conditional
siąknąłby	Conditional
znaczą	None
gardźmy	Imperative-Jussive
zazdrościlibyśmy	Conditional
rozgrzeszyłybyście	Conditional
pląsalibyście	Conditional
kupujmy	Imperative-Jussive
kierujmy	Imperative-Jussive
marłabyś	Conditional
zatrzymane	None
dziobałoby	Conditional
zakochałaby	Conditional
dumajcie	Imperative-Jussive
