räsonier	Second person Singular
zappelnd	None
kreis	Second person Singular
erschaffet	Second person Plural
batik	Second person Singular
vernickelst	Second person Singular
geschehest	Second person Singular
entführst	Second person Singular
Ukrainern	None
krähst	Second person Singular
verständiget	Second person Plural
Wärmeaustausch	None
wrängest	Second person Singular
Bambusses	None
planschest	Second person Singular
erhebest	Second person Singular
verkenntet	Second person Plural
Kaufmannes	None
hämmerest	Second person Singular
trampest	Second person Singular
droscht	Second person Plural
studieret	Second person Plural
geschirmt	None
branntet	Second person Plural
begrabest	Second person Singular
Sklavenhaltern	None
überlebst	Second person Singular
konvergier	Second person Singular
Dunkelkammer	None
dien	Second person Singular
vergibt	Third person Singular
lins	Second person Singular
getanzt	None
Waffenarsenal	None
Melanterit	None
unterstrichet	Second person Plural
fluorierst	Second person Singular
Reporter	None
schwächet	Second person Plural
Leitkegeln	None
Trainern	None
Dotieren	None
immigrierest	Second person Singular
massakrierest	Second person Singular
Bindungen	None
mißbrauch	Second person Singular
orchestrier	Second person Singular
gemobbt	None
stimm	Second person Singular
verdammet	Second person Plural
Exponaten	None
lenket	Second person Plural
vermischst	Second person Singular
baggerst	Second person Singular
Tonerden	None
adressierst	Second person Singular
Verzweiflung	None
amenagierest	Second person Singular
langweil	Second person Singular
registrierst	Second person Singular
jodelet	Second person Plural
befahlt	Second person Plural
fabulierst	Second person Singular
Cupalit	None
zerflössest	Second person Singular
Ameisen	None
Berater	None
Begrüßung	None
flüsteret	Second person Plural
entsprängest	Second person Singular
Hütten	None
ängstigest	Second person Singular
handhabest	Second person Singular
Amtsgerichten	None
rekonstruier	Second person Singular
trotz	Second person Singular
tabuisierst	Second person Singular
numerier	Second person Singular
ähnelet	Second person Plural
gähnest	Second person Singular
demonstrierst	Second person Singular
bedingst	Second person Singular
verpressest	Second person Singular
bestrebst	Second person Singular
Linguisten	None
Kairiner	None
Pfandbriefes	None
zoffst	Second person Singular
bekräftig	Second person Singular
unternahmst	Second person Singular
Pfandbrief	None
Drückeberger	None
Demobilisierung	None
murmelest	Second person Singular
Motorsägen	None
benütz	Second person Singular
interessierest	Second person Singular
ebbst	Second person Singular
verschärfet	Second person Plural
edier	Second person Singular
versteck	Second person Singular
piesack	Second person Singular
Windschutzscheiben	None
destillierest	Second person Singular
überkommst	Second person Singular
schmauch	Second person Singular
zockest	Second person Singular
gestehst	Second person Singular
Polygamie	None
übernimm	Second person Singular
Philosophin	None
verhöhnet	Second person Plural
etablierst	Second person Singular
rännest	Second person Singular
ex	Second person Singular
Architekturmusters	None
genierst	Second person Singular
Tartschen	None
krönest	Second person Singular
klump	Second person Singular
entginget	Second person Plural
hydrierst	Second person Singular
Ämter	None
kribbelst	Second person Singular
Coltan	None
sprudelst	Second person Singular
Elektrodynamik	None
schleppest	Second person Singular
Klavieres	None
merket	Second person Plural
Ortolan	None
Kefire	None
entfolget	Second person Plural
Henne	None
heulst	Second person Singular
chauffieret	Second person Plural
pekzieret	Second person Plural
Fremdenverkehrs	None
argumentier	Second person Singular
wach	Second person Singular
zanket	Second person Plural
erörterest	Second person Singular
attackierst	Second person Singular
Aufrührerinnen	None
versieht	Third person Singular
erübrigest	Second person Singular
unterbrachst	Second person Singular
kollabier	Second person Singular
projicierst	Second person Singular
harn	Second person Singular
erleichterst	Second person Singular
besticht	Third person Singular
überteueret	Second person Plural
verstaatlichest	Second person Singular
enttarn	Second person Singular
Prädikaten	None
aufheben	None
ätz	Second person Singular
schäm	Second person Singular
evangelisierst	Second person Singular
Regierungspräsidiums	None
henkest	Second person Singular
Leimes	None
maskier	Second person Singular
unterdrückst	Second person Singular
zensurierest	Second person Singular
romantisierst	Second person Singular
Zirkonat	None
zerreißet	Second person Plural
belegst	Second person Singular
Füchse	None
chargierst	Second person Singular
Ankömmlingen	None
schiel	Second person Singular
krön	Second person Singular
fegst	Second person Singular
sänket	Second person Plural
degustieret	Second person Plural
erfrischest	Second person Singular
Finanzminister	None
bequembst	Second person Singular
Mostes	None
grabbelest	Second person Singular
Natronsalpeteren	None
christianisierest	Second person Singular
wackelst	Second person Singular
kippet	Second person Plural
erschlossest	Second person Singular
Münztelefonen	None
niesest	Second person Singular
Fadenläufen	None
verglicht	Second person Plural
bücket	Second person Plural
Bergführern	None
Proxyservern	None
poll	Second person Singular
pichelst	Second person Singular
Philologinnen	None
zisch	Second person Singular
garantieret	Second person Plural
pickst	Second person Singular
bleichet	Second person Plural
erhoffest	Second person Singular
hyperventilieret	Second person Plural
elektrisirest	Second person Singular
portraitieret	Second person Plural
Kronen	None
sinterst	Second person Singular
Muttersöhnchen	None
dirigier	Second person Singular
still	Second person Singular
Sandstürme	None
Mäuschens	None
Schmierpapier	None
aufgezählt	None
Draht	None
berußet	Second person Plural
änderst	Second person Singular
spezifizieret	Second person Plural
besohl	Second person Singular
übereilst	Second person Singular
unterschlügest	Second person Singular
stricht	Second person Plural
spekulieret	Second person Plural
stächest	Second person Singular
Präfix	None
begnadigst	Second person Singular
kompensierest	Second person Singular
erwähnst	Second person Singular
scheuchst	Second person Singular
konkurrieret	Second person Plural
tätiget	Second person Plural
reglementierest	Second person Singular
Häutungen	None
pranget	Second person Plural
säßet	Second person Plural
Antrag	None
Aufseher	None
Staatsbürgerinnen	None
verginget	Second person Plural
titrieret	Second person Plural
wünschet	Second person Plural
weigerst	Second person Singular
puderet	Second person Plural
Linguistik	None
protestier	Second person Singular
Anker	None
herrschst	Second person Singular
Klassenpfad	None
krallst	Second person Singular
quollst	Second person Singular
verbrechet	Second person Plural
zag	Second person Singular
gediehst	Second person Singular
dominier	Second person Singular
Ausreißern	None
Ehrung	None
betrübest	Second person Singular
numerierst	Second person Singular
tendier	Second person Singular
feuerest	Second person Singular
kotzest	Second person Singular
verwehret	Second person Plural
intrigieret	Second person Plural
Latzhose	None
Cisplatins	None
Erlösung	None
injizier	Second person Singular
Tischchen	None
staunet	Second person Plural
beglichest	Second person Singular
validierest	Second person Singular
deklinier	Second person Singular
merkst	Second person Singular
gräbt	Third person Singular
vermach	Second person Singular
Vorläufers	None
prüfet	Second person Plural
kupier	Second person Singular
Strukturelementen	None
besprenget	Second person Plural
Anstrichen	None
stapfst	Second person Singular
Haines	None
beteiligst	Second person Singular
entschlosst	Second person Plural
versicherst	Second person Singular
pflegst	Second person Singular
unternehmest	Second person Singular
horch	Second person Singular
vermagst	Second person Singular
quadrier	Second person Singular
entfesselest	Second person Singular
Drehorte	None
übertreffet	Second person Plural
aluminier	Second person Singular
analysier	Second person Singular
ärgeret	Second person Plural
schlenderst	Second person Singular
schwänzelet	Second person Plural
befriedig	Second person Singular
perforier	Second person Singular
tuschelst	Second person Singular
kandidieret	Second person Plural
denunzierst	Second person Singular
Keiler	None
Cineasten	None
begeh	Second person Singular
Keime	None
ruckelest	Second person Singular
Kernverschmelzung	None
schnür	Second person Singular
motivier	Second person Singular
blaffst	Second person Singular
korrigier	Second person Singular
Kations	None
spazier	Second person Singular
Armaturenbretter	None
Sodomie	None
verfangest	Second person Singular
zappest	Second person Singular
empfandet	Second person Plural
betreibest	Second person Singular
schlüget	Second person Plural
pensionier	Second person Singular
saunieret	Second person Plural
wärmst	Second person Singular
Stückwerken	None
schlugt	Second person Plural
Tätigkeitswortes	None
Kursbücher	None
besichtiget	Second person Plural
Bleichstoff	None
Kondom	None
Planetologie	None
stutz	Second person Singular
krähet	Second person Plural
wackelest	Second person Singular
krabbelet	Second person Plural
spazieret	Second person Plural
kompilierst	Second person Singular
ermittelet	Second person Plural
Scheck	None
Streckenverlauf	None
individualisierest	Second person Singular
verringerst	Second person Singular
gedeihst	Second person Singular
heparinisierest	Second person Singular
keulest	Second person Singular
überfielest	Second person Singular
sträub	Second person Singular
obfuskieret	Second person Plural
entfesselst	Second person Singular
formulier	Second person Singular
belügest	Second person Singular
internationalisieret	Second person Plural
Austragungsortes	None
Schluss	None
gackerest	Second person Singular
rezitier	Second person Singular
siedelest	Second person Singular
Einzüge	None
respektierst	Second person Singular
zauberst	Second person Singular
katalogisierest	Second person Singular
lokalisieret	Second person Plural
hämmeret	Second person Plural
seihst	Second person Singular
Gedankenspieles	None
Speicherkraftwerke	None
ausgesagt	None
blondieret	Second person Plural
entzieh	Second person Singular
holperst	Second person Singular
verfingt	Second person Plural
verfilmst	Second person Singular
beschwerend	None
Konfixen	None
scherzet	Second person Plural
schielest	Second person Singular
zeugest	Second person Singular
befummelst	Second person Singular
Schutzbleche	None
Gerbereien	None
Vollzeit	None
meditierest	Second person Singular
Spitzname	None
Granatapfel	None
Schreines	None
geschmeichelt	None
betränket	Second person Plural
erschlüget	Second person Plural
fühlest	Second person Singular
Wahlergebnis	None
domestizieret	Second person Plural
marschier	Second person Singular
räsonierest	Second person Singular
erkrankest	Second person Singular
Verteilung	None
Futurs	None
einwickeln	None
sanktionier	Second person Singular
entschädiget	Second person Plural
regierest	Second person Singular
wedelet	Second person Plural
ermöglichest	Second person Singular
abstrahier	Second person Singular
harmonieret	Second person Plural
Sozinianerin	None
diskutieret	Second person Plural
montierest	Second person Singular
Gans	None
rechtfertiget	Second person Plural
triumphieret	Second person Plural
erstehest	Second person Singular
gröl	Second person Singular
kriechest	Second person Singular
Deichsel	None
Spurenelement	None
gespuckt	None
ächzest	Second person Singular
Edelmetallen	None
Badegästen	None
rasierest	Second person Singular
Digraph	None
Kreistages	None
lispelst	Second person Singular
veraltend	None
Limonits	None
verarm	Second person Singular
Zebrafinken	None
zippst	Second person Singular
buh	Second person Singular
Antragsdelikte	None
grenzend	None
enträtselst	Second person Singular
verträtest	Second person Singular
Fotografin	None
translozierest	Second person Singular
jaul	Second person Singular
Meeressedimente	None
Unlesbarkeit	None
inhalierst	Second person Singular
Geldgebern	None
gesprüht	None
Tasten	None
lieb	Second person Singular
zitier	Second person Singular
verschlossest	Second person Singular
besprich	Second person Singular
wedelst	Second person Singular
Inkarnation	None
zierst	Second person Singular
näheret	Second person Plural
Leitungswegen	None
Imker	None
Salzwiese	None
untersag	Second person Singular
spöttelst	Second person Singular
Journale	None
mißlangt	Second person Plural
hicks	Second person Singular
hex	Second person Singular
entkokainisier	Second person Singular
besitz	Second person Singular
putz	Second person Singular
paarst	Second person Singular
schockierest	Second person Singular
Späßen	None
spiegelst	Second person Singular
Nebenschilddrüse	None
sublimier	Second person Singular
coveret	Second person Plural
Hirschkäfers	None
konkurrier	Second person Singular
Putzes	None
Badern	None
abwarten	None
beliefst	Second person Singular
rummelet	Second person Plural
kill	Second person Singular
Bromalken	None
schockier	Second person Singular
Cholesterin	None
teer	Second person Singular
versänket	Second person Plural
Elektromagnet	None
schimmelst	Second person Singular
verstärk	Second person Singular
verzählst	Second person Singular
weißsagst	Second person Singular
Arbeitskreis	None
Orgelkonzerte	None
ruderst	Second person Singular
nivellieret	Second person Plural
Attrappe	None
erachtend	None
romantisierest	Second person Singular
geheult	None
Apparates	None
Glykogenen	None
verunzier	Second person Singular
stechet	Second person Plural
schirmst	Second person Singular
formirst	Second person Singular
gelikt	None
verwes	Second person Singular
Bauernhofes	None
forschet	Second person Plural
Alkoholat	None
kasteist	Second person Singular
angelet	Second person Plural
wilderst	Second person Singular
Jupitermonden	None
Gerontokratie	None
entlehn	Second person Singular
Badegast	None
Hafniums	None
reich	Second person Singular
erfolgest	Second person Singular
Informatikern	None
quatschst	Second person Singular
Feuerfische	None
bemühst	Second person Singular
setzest	Second person Singular
Katarrhs	None
explizieret	Second person Plural
Beteiligung	None
nährest	Second person Singular
korrumpieret	Second person Plural
Lieder	None
sprießest	Second person Singular
Rechtsstreite	None
taggest	Second person Singular
Weintraube	None
stocherest	Second person Singular
reibst	Second person Singular
überwältigest	Second person Singular
entwässerest	Second person Singular
Ameisenbär	None
kros	Second person Singular
snöb	Second person Singular
hämmerst	Second person Singular
rüffelest	Second person Singular
Hafenanlagen	None
Schädlinge	None
setzet	Second person Plural
Wägelchen	None
fällest	Second person Singular
Lurchen	None
entsorget	Second person Plural
popelet	Second person Plural
Shortcuts	None
frottierest	Second person Singular
fraternisierest	Second person Singular
entlädt	Third person Singular
überzeuget	Second person Plural
verlernet	Second person Plural
würgst	Second person Singular
geräumt	None
präget	Second person Plural
Meeresfisch	None
entfärb	Second person Singular
verstaatlich	Second person Singular
Tunnels	None
knusperst	Second person Singular
Chalkogenide	None
Formulare	None
Altruist	None
erschlössest	Second person Singular
konkurrierst	Second person Singular
dampfet	Second person Plural
reüssieret	Second person Plural
Genauigkeiten	None
besänftigst	Second person Singular
Oberaufseherin	None
kläffet	Second person Plural
emulier	Second person Singular
Berlinerinnen	None
kommst	Second person Singular
parkier	Second person Singular
Kommoden	None
küss	Second person Singular
bestrafest	Second person Singular
erpressest	Second person Singular
schlägst	Second person Singular
Hotdogs	None
heg	Second person Singular
grünet	Second person Plural
erwähnet	Second person Plural
exst	Second person Singular
Verbrechen	None
siez	Second person Singular
mehr	Second person Singular
verfängst	Second person Singular
Grapheme	None
hantierst	Second person Singular
verehret	Second person Plural
hegest	Second person Singular
Favorit	None
erstickest	Second person Singular
Goldspechte	None
verifizier	Second person Singular
verschaffest	Second person Singular
beweisest	Second person Singular
Praktikum	None
schnurr	Second person Singular
emittier	Second person Singular
internieret	Second person Plural
versteckst	Second person Singular
entnimmst	Second person Singular
trommelet	Second person Plural
Mischlingen	None
vereinigst	Second person Singular
zerrest	Second person Singular
tranchierest	Second person Singular
stolperest	Second person Singular
rächet	Second person Plural
interagierst	Second person Singular
unterstütz	Second person Singular
Imkern	None
vereiniget	Second person Plural
coventrier	Second person Singular
packend	None
Wellenlängenbereiche	None
Felgenbremse	None
funktionierst	Second person Singular
bestrahlst	Second person Singular
verkloppest	Second person Singular
quantisier	Second person Singular
globalisierest	Second person Singular
Nationalspielern	None
necket	Second person Plural
Kopfformen	None
Senfen	None
beanspruch	Second person Singular
staunest	Second person Singular
besetzend	None
persiflierest	Second person Singular
fleh	Second person Singular
sprüh	Second person Singular
unternehmet	Second person Plural
emendierest	Second person Singular
verhülfet	Second person Plural
versehest	Second person Singular
Einkaufslisten	None
plädieret	Second person Plural
ruinierest	Second person Singular
laberst	Second person Singular
erlangest	Second person Singular
verfemst	Second person Singular
entkomm	Second person Singular
konsolidierst	Second person Singular
Präfektur	None
Flugstäuben	None
assimilierst	Second person Singular
Attribute	None
Planierraupe	None
zertrampelst	Second person Singular
schlifft	Second person Plural
registrieret	Second person Plural
Fluorcarbone	None
Disjunktionen	None
unterhaltest	Second person Singular
meßest	Second person Singular
recherchierst	Second person Singular
Aktivität	None
Arsoranen	None
schnarch	Second person Singular
pikierst	Second person Singular
erleichteret	Second person Plural
stopfet	Second person Plural
monogrammieret	Second person Plural
pochest	Second person Singular
leihst	Second person Singular
Arbeitsärzte	None
lauft	Second person Plural
Vorstellung	None
vermachst	Second person Singular
galtest	Second person Singular
gurret	Second person Plural
Granulaten	None
renovierend	None
benehmest	Second person Singular
zechend	None
Downer	None
spinnst	Second person Singular
buchstabieret	Second person Plural
reifizieret	Second person Plural
verringerest	Second person Singular
Nigerianer	None
digerierest	Second person Singular
optimieret	Second person Plural
boß	Second person Singular
räsonierst	Second person Singular
kollerest	Second person Singular
Geisterstädte	None
erprobest	Second person Singular
verkürz	Second person Singular
umschmelzet	Second person Plural
Handelsmarine	None
virtualisierst	Second person Singular
oszillierest	Second person Singular
schmieret	Second person Plural
schnatteret	Second person Plural
Lebensjahr	None
betretest	Second person Singular
jodelest	Second person Singular
schiffet	Second person Plural
Rückumschläge	None
kühl	Second person Singular
Baseballs	None
stählet	Second person Plural
entkork	Second person Singular
offerier	Second person Singular
erzielst	Second person Singular
Anreiz	None
zentrierst	Second person Singular
Freistößen	None
katalysier	Second person Singular
Schaumes	None
schliffst	Second person Singular
verfemet	Second person Plural
kabbelet	Second person Plural
Feinguss	None
mikrominiaturisierest	Second person Singular
Atemstillständen	None
erlabet	Second person Plural
Kristallfeldes	None
wahr	Second person Singular
plantschest	Second person Singular
pell	Second person Singular
Pfarrer	None
Nichtraucher	None
frustrier	Second person Singular
manövrierst	Second person Singular
kolleret	Second person Plural
Kaffeelöffeln	None
schwiegst	Second person Singular
klapperest	Second person Singular
Massenbewegung	None
verwahrloset	Second person Plural
Ölspuren	None
Auszug	None
projicierest	Second person Singular
boomest	Second person Singular
kompromittierest	Second person Singular
erübriget	Second person Plural
internierst	Second person Singular
probier	Second person Singular
Dächern	None
Fagotten	None
implizierst	Second person Singular
verschlösset	Second person Plural
verspiel	Second person Singular
verteilet	Second person Plural
Konstruktionswerkstoffen	None
verschärfst	Second person Singular
klimatisierst	Second person Singular
barstet	Second person Plural
changierst	Second person Singular
behobt	Second person Plural
wetteiferest	Second person Singular
hüpfend	None
erstandest	Second person Singular
verärgeret	Second person Plural
Erdlinge	None
konjugieret	Second person Plural
Auszahlung	None
betrankt	Second person Plural
Talisman	None
schluderet	Second person Plural
Molekülorbitalen	None
Gemahls	None
Beichte	None
plärret	Second person Plural
Elch	None
erstich	Second person Singular
skyp	Second person Singular
hebst	Second person Singular
bekräftigest	Second person Singular
fräs	Second person Singular
Lonsdaleit	None
mäkelst	Second person Singular
unterlasset	Second person Plural
Karrees	None
Firmensitz	None
Kapitalverkehres	None
stacht	Second person Plural
tanzet	Second person Plural
Infrarotlichtern	None
rekrutierest	Second person Singular
kontrahierst	Second person Singular
zersetzend	None
missbrauchst	Second person Singular
Nässe	None
Seuche	None
bezwinget	Second person Plural
foul	Second person Singular
gewärtigst	Second person Singular
Tischlers	None
Zeitausgleichen	None
Kleptokratie	None
lehnet	Second person Plural
Schädeln	None
dünket	Second person Plural
betreuet	Second person Plural
kontrastierst	Second person Singular
Erdstößen	None
schockieret	Second person Plural
implementieret	Second person Plural
vereinfachest	Second person Singular
urteilet	Second person Plural
veredelest	Second person Singular
Hydrauliköl	None
monogrammier	Second person Singular
betreuest	Second person Singular
sezierst	Second person Singular
einweihen	None
erscheinst	Second person Singular
Borat	None
stieget	Second person Plural
systematisier	Second person Singular
zerstörest	Second person Singular
begleich	Second person Singular
anbeten	None
sännest	Second person Singular
Feststellungen	None
fluppest	Second person Singular
bärstest	Second person Singular
nächtigst	Second person Singular
sträubet	Second person Plural
reformier	Second person Singular
quälend	None
flitteret	Second person Plural
Entenbratens	None
bimmelst	Second person Singular
vergewaltigst	Second person Singular
behöbet	Second person Plural
fusionieret	Second person Plural
Geschütze	None
unterschätzet	Second person Plural
mangelet	Second person Plural
Händchen	None
kühlst	Second person Singular
erwieset	Second person Plural
meißelest	Second person Singular
regulierest	Second person Singular
wischst	Second person Singular
Mordanschläge	None
Semmelbrötchens	None
beantrag	Second person Singular
Chlorknallgasen	None
Kompositums	None
versinket	Second person Plural
krösst	Second person Singular
Flüchtlingzeltes	None
dressierst	Second person Singular
leerest	Second person Singular
erlieget	Second person Plural
begrenzest	Second person Singular
Untern	None
pürierst	Second person Singular
bekränzest	Second person Singular
Behältnissen	None
Diät	None
Oligopolisierungen	None
bewirk	Second person Singular
sparst	Second person Singular
futterest	Second person Singular
Harnes	None
parlierest	Second person Singular
staunst	Second person Singular
Hydroxylapatiten	None
zerstäubest	Second person Singular
fungieret	Second person Plural
vergibst	Second person Singular
überdächtet	Second person Plural
knips	Second person Singular
frisierest	Second person Singular
Gleis	None
Hausens	None
tranchierst	Second person Singular
infizieret	Second person Plural
pubertierst	Second person Singular
Betastrahlers	None
gerupft	None
wühl	Second person Singular
Nichtseins	None
bestichst	Second person Singular
evakuierest	Second person Singular
harmonisierst	Second person Singular
beabsichtiget	Second person Plural
seihet	Second person Plural
Alphabetes	None
Alpakas	None
konfrontier	Second person Singular
erschlag	Second person Singular
blitz	Second person Singular
dribbelest	Second person Singular
ertränkest	Second person Singular
iahst	Second person Singular
saus	Second person Singular
glupschet	Second person Plural
Tellur	None
Verwurzelung	None
zögeret	Second person Plural
gedächtest	Second person Singular
radikalisierst	Second person Singular
stutzet	Second person Plural
markierst	Second person Singular
erwirbst	Second person Singular
erfreust	Second person Singular
schwätzet	Second person Plural
spürest	Second person Singular
schwellest	Second person Singular
leihet	Second person Plural
fopp	Second person Singular
Faustfeuerwaffen	None
erbringest	Second person Singular
betrüb	Second person Singular
Behindertensport	None
klangt	Second person Plural
Erzfeinds	None
veranlassst	Second person Singular
korrigierst	Second person Singular
schwillst	Second person Singular
verbitterst	Second person Singular
fetzst	Second person Singular
Kämpfen	None
Brauers	None
bestell	Second person Singular
Aufkommens	None
entmischst	Second person Singular
Schlagers	None
Gepäckträgern	None
Mimosen	None
misstraust	Second person Singular
quakest	Second person Singular
Bundesgerichtshöfe	None
erwürget	Second person Plural
mißtrauest	Second person Singular
marinier	Second person Singular
stotterest	Second person Singular
patzet	Second person Plural
blau	Second person Singular
wärm	Second person Singular
Mittelaltermarkt	None
melierst	Second person Singular
implodierst	Second person Singular
Weißpigment	None
knuffest	Second person Singular
entfachest	Second person Singular
ertraget	Second person Plural
Friedensforschung	None
knabberest	Second person Singular
randalier	Second person Singular
verlautend	None
heueret	Second person Plural
changierest	Second person Singular
überdenket	Second person Plural
hops	Second person Singular
erwähn	Second person Singular
postulierst	Second person Singular
garnieret	Second person Plural
producieret	Second person Plural
verwaisest	Second person Singular
schaukelet	Second person Plural
initialisierest	Second person Singular
killet	Second person Plural
entthronet	Second person Plural
entfernet	Second person Plural
rutsch	Second person Singular
munkelst	Second person Singular
Anrecht	None
Palladiumkatalysator	None
Zusammenhängen	None
schiff	Second person Singular
enthüllet	Second person Plural
gähnet	Second person Plural
Untertan	None
Vorstandsmitgliedern	None
funktionalisierend	None
zerfielest	Second person Singular
übersehet	Second person Plural
spezifizierest	Second person Singular
Antonym	None
integrier	Second person Singular
producierest	Second person Singular
begrüss	Second person Singular
verkürzet	Second person Plural
kabelet	Second person Plural
Sündern	None
ertönst	Second person Singular
Seemeilen	None
spionieret	Second person Plural
Feuerwerke	None
malm	Second person Singular
betankst	Second person Singular
demonstrier	Second person Singular
recherchier	Second person Singular
pensionieret	Second person Plural
verbracht	Second person Plural
extrahierest	Second person Singular
sabotierest	Second person Singular
feierst	Second person Singular
flackerst	Second person Singular
sieg	Second person Singular
Abwehrstoffe	None
concessionieret	Second person Plural
mangelst	Second person Singular
grillst	Second person Singular
Minnesängers	None
trabest	Second person Singular
Umspannwerkes	None
triebet	Second person Plural
ergebet	Second person Plural
versprichst	Second person Singular
Fermate	None
nervest	Second person Singular
krall	Second person Singular
indoktrinieret	Second person Plural
Haarwaschmittel	None
Orgel	None
Heilmitteln	None
Schäfern	None
exportierest	Second person Singular
Kolosse	None
staubsaug	Second person Singular
repräsentierst	Second person Singular
velarisier	Second person Singular
umgearbeitet	None
finanzierst	Second person Singular
Füllfederhalters	None
strick	Second person Singular
dämonisierst	Second person Singular
Wohltätern	None
reservieret	Second person Plural
Wenfalles	None
sinnet	Second person Plural
emendierst	Second person Singular
fotografier	Second person Singular
Häm	None
kreisest	Second person Singular
verstopfst	Second person Singular
hechelest	Second person Singular
prüfest	Second person Singular
Wegerichs	None
zerreißest	Second person Singular
splitterst	Second person Singular
Miststück	None
Kautschuke	None
kack	Second person Singular
unterdrückest	Second person Singular
zerstör	Second person Singular
atomisierst	Second person Singular
dokumentier	Second person Singular
bereinigest	Second person Singular
warnst	Second person Singular
befreiet	Second person Plural
fütterest	Second person Singular
Mahlstrom	None
scheißet	Second person Plural
lehnest	Second person Singular
dribbelst	Second person Singular
Broilers	None
Akrobaten	None
Betrachter	None
gewurzelt	None
Öhrchens	None
verbleiet	Second person Plural
verkriech	Second person Singular
rotz	Second person Singular
verstärkst	Second person Singular
entwischest	Second person Singular
Wannen	None
protestieret	Second person Plural
Entschlüsselungen	None
beflügelest	Second person Singular
empfandest	Second person Singular
verbargst	Second person Singular
Endlagerung	None
destillierst	Second person Singular
vertraust	Second person Singular
kiek	Second person Singular
turn	Second person Singular
bepissend	None
Belang	None
balancier	Second person Singular
nickest	Second person Singular
Klienten	None
staubsaugest	Second person Singular
erschlägst	Second person Singular
Elektriker	None
ermittelst	Second person Singular
fön	Second person Singular
übertriffst	Second person Singular
galvanisieret	Second person Plural
schlosserest	Second person Singular
Flugkapitän	None
desinfizier	Second person Singular
Sprödmetallen	None
Becherglas	None
schützet	Second person Plural
fiepet	Second person Plural
empör	Second person Singular
Parkplatzes	None
übergib	Second person Singular
Einzahl	None
favorisier	Second person Singular
schöbest	Second person Singular
Trottel	None
entkokainisieret	Second person Plural
klopf	Second person Singular
Entwicklungsländern	None
Moleküle	None
stinkst	Second person Singular
differenzieret	Second person Plural
stutzest	Second person Singular
denunzieret	Second person Plural
Elfmeterschießen	None
aufgeschlossen	None
Wichtes	None
rekonstruierst	Second person Singular
Lidern	None
Artist	None
Affekten	None
replicirst	Second person Singular
entdecket	Second person Plural
Theoremen	None
Meldungen	None
Vorträge	None
begrübest	Second person Singular
favorisieret	Second person Plural
verdunkelet	Second person Plural
bieret	Second person Plural
blockieret	Second person Plural
schauderet	Second person Plural
brätst	Second person Singular
Widerrufsrecht	None
Fischbecken	None
schlepp	Second person Singular
interkulturalisieret	Second person Plural
erfüllest	Second person Singular
Wiedehopfen	None
tobst	Second person Singular
Potenzialen	None
bräun	Second person Singular
exmatrikulieret	Second person Plural
zertifizieret	Second person Plural
karret	Second person Plural
Roggenvollkornbrot	None
stiegt	Second person Plural
verwässerst	Second person Singular
weissaget	Second person Plural
radierest	Second person Singular
bestehst	Second person Singular
türm	Second person Singular
Flors	None
schulst	Second person Singular
Wohngebieten	None
gelangst	Second person Singular
gaff	Second person Singular
inhaftierst	Second person Singular
hampelst	Second person Singular
rieht	Second person Plural
patentierst	Second person Singular
repräsentier	Second person Singular
wählst	Second person Singular
behinderest	Second person Singular
Segelbooten	None
rutschet	Second person Plural
apportier	Second person Singular
formulierest	Second person Singular
Gewahrsams	None
beschotteret	Second person Plural
verstirbt	Third person Singular
Pinnchen	None
Golfspielern	None
Bakteriziden	None
seufzest	Second person Singular
ignorieret	Second person Plural
übersieh	Second person Singular
schöpf	Second person Singular
schnappest	Second person Singular
stier	Second person Singular
verleihst	Second person Singular
plissierst	Second person Singular
gebimmelt	None
migrieret	Second person Plural
knisteret	Second person Plural
stächet	Second person Plural
Stammbäume	None
gefeit	None
bugsierst	Second person Singular
fladerest	Second person Singular
prahlend	None
Cheerleaders	None
verdammst	Second person Singular
stationier	Second person Singular
Graveur	None
befragest	Second person Singular
Bodys	None
Bleistift	None
Alchemisten	None
wimmelet	Second person Plural
knibbelest	Second person Singular
bröckelst	Second person Singular
Bekenntnis	None
unterschlägt	Third person Singular
sauset	Second person Plural
kompromittier	Second person Singular
bombardierest	Second person Singular
erstechest	Second person Singular
schwandet	Second person Plural
bums	Second person Singular
rekrutier	Second person Singular
betank	Second person Singular
blockierest	Second person Singular
fieberst	Second person Singular
beschaff	Second person Singular
entstehst	Second person Singular
Gespenster	None
pexier	Second person Singular
Eudialyten	None
plärrst	Second person Singular
infizier	Second person Singular
demontierest	Second person Singular
gilt	Third person Singular
entzöget	Second person Plural
Ketzerei	None
Floskeln	None
fotzest	Second person Singular
ächz	Second person Singular
dringst	Second person Singular
bummelst	Second person Singular
Monarchist	None
kündigst	Second person Singular
Speaker	None
Grenzwerten	None
plädierst	Second person Singular
bedienst	Second person Singular
fönst	Second person Singular
schul	Second person Singular
Schlacken	None
überschätzest	Second person Singular
verwirft	Third person Singular
Stier	None
Rettungsbootes	None
egg	Second person Singular
bedeckst	Second person Singular
lochet	Second person Plural
amenagierst	Second person Singular
abandonnierst	Second person Singular
Fremdwörtern	None
ernähret	Second person Plural
ersuchest	Second person Singular
verpasset	Second person Plural
herabsetzen	None
Kabinen	None
kollabierst	Second person Singular
Jägerschnitzels	None
rätselest	Second person Singular
boykottierst	Second person Singular
sexelet	Second person Plural
eingetragen	None
glasieret	Second person Plural
ruß	Second person Singular
kippest	Second person Singular
kaschieret	Second person Plural
säumest	Second person Singular
widerrieft	Second person Plural
beschotterest	Second person Singular
jonglier	Second person Singular
Eidechse	None
materialisierst	Second person Singular
Pelze	None
verwirf	Second person Singular
Bienenwachs	None
stärket	Second person Plural
glawbest	Second person Singular
Politologen	None
linset	Second person Plural
reinstitutionalisier	Second person Singular
befielet	Second person Plural
zerfallest	Second person Singular
finget	Second person Plural
Graph	None
bewohn	Second person Singular
tilg	Second person Singular
geteilt	None
Verhör	None
Hammels	None
räsonieret	Second person Plural
dampf	Second person Singular
sicherst	Second person Singular
gravier	Second person Singular
schleuderet	Second person Plural
Klatsche	None
krepieret	Second person Plural
chauffier	Second person Singular
verbeißet	Second person Plural
Bäcker	None
betonierest	Second person Singular
grabest	Second person Singular
übernehmest	Second person Singular
rationierst	Second person Singular
Griffen	None
koproduzieret	Second person Plural
Nickelarsenkiese	None
erbring	Second person Singular
Fladenbrot	None
kämest	Second person Singular
aufgerichtet	None
Gravitonen	None
verschlack	Second person Singular
merk	Second person Singular
goutier	Second person Singular
Mangrovenwaldes	None
rinnest	Second person Singular
orgelest	Second person Singular
verteilst	Second person Singular
siedelet	Second person Plural
zerfällst	Second person Singular
zwingst	Second person Singular
erhoff	Second person Singular
Steppenralle	None
verdrösset	Second person Plural
naschet	Second person Plural
Dohlen	None
bewerkstelligst	Second person Singular
verkriechst	Second person Singular
Stadtrates	None
betrugt	Second person Plural
avancier	Second person Singular
Kreutze	None
Ausnahmezustände	None
arretierest	Second person Singular
explizierest	Second person Singular
Selbstanzeigen	None
Nadelstreifen	None
erhitz	Second person Singular
dominieret	Second person Plural
Pendels	None
tapp	Second person Singular
verdammest	Second person Singular
streckst	Second person Singular
Misteln	None
risset	Second person Plural
hell	Second person Singular
Doping	None
gefummelt	None
transferierst	Second person Singular
wachst	Second person Singular
Zugversuchen	None
Fußfall	None
Debakels	None
schlemmest	Second person Singular
Tonnengewölbes	None
erschließet	Second person Plural
prophezeist	Second person Singular
diktier	Second person Singular
pauk	Second person Singular
quantisierest	Second person Singular
Hemisphären	None
säend	None
Fluorchlorkohlenwasserstoffes	None
fauchst	Second person Singular
vernetzest	Second person Singular
klirr	Second person Singular
steigest	Second person Singular
läufst	Second person Singular
gerinnest	Second person Singular
belogst	Second person Singular
Vorfall	None
Kollokation	None
schanghaist	Second person Singular
blichst	Second person Singular
bestiehl	Second person Singular
Amtsgericht	None
Selenone	None
Neutronenüberschuss	None
knirschst	Second person Singular
crèmst	Second person Singular
revanchieret	Second person Plural
Gesängen	None
beläuf	Second person Singular
rinnst	Second person Singular
pfiffst	Second person Singular
radikalisierest	Second person Singular
verzweiget	Second person Plural
Gleichungen	None
Häute	None
demütigst	Second person Singular
überreagierest	Second person Singular
Schulkindern	None
greifend	None
nanntet	Second person Plural
popelst	Second person Singular
Feuilleton	None
Restbetrag	None
pfleg	Second person Singular
Titanate	None
Trankes	None
buddelst	Second person Singular
Dohle	None
bewirkest	Second person Singular
murksest	Second person Singular
Fastenzeiten	None
versink	Second person Singular
losest	Second person Singular
Rhenium	None
Fusionsbrennstoffes	None
Plastikschwanz	None
muffet	Second person Plural
verderbet	Second person Plural
Schwager	None
Zebraameisenwürgern	None
Isotopenaustausch	None
würdet	Second person Plural
Verdecken	None
Schlitz	None
lackierest	Second person Singular
Scheitelpunkten	None
schwingend	None
hinderet	Second person Plural
Hörspiel	None
Blöcher	None
entvölkerst	Second person Singular
ernähr	Second person Singular
Dezernaten	None
filzest	Second person Singular
entwarn	Second person Singular
besännet	Second person Plural
Lundes	None
flanierst	Second person Singular
verwahrlos	Second person Singular
verwirfst	Second person Singular
zeug	Second person Singular
interpretieret	Second person Plural
verfem	Second person Singular
dematerialisier	Second person Singular
verpuppest	Second person Singular
Schleimhäuten	None
recket	Second person Plural
Berufungsgerichte	None
zaubernd	None
Ytterbite	None
ergreif	Second person Singular
personifizieret	Second person Plural
Verkehrsflugzeugen	None
mulchest	Second person Singular
Natriumsalze	None
schneist	Second person Singular
polarisierest	Second person Singular
scheuchet	Second person Plural
japp	Second person Singular
quetschst	Second person Singular
gestandest	Second person Singular
durchqueret	Second person Plural
ängstiget	Second person Plural
erlebest	Second person Singular
rupfet	Second person Plural
übernimmst	Second person Singular
operierest	Second person Singular
renntet	Second person Plural
Dieseln	None
kodier	Second person Singular
grübet	Second person Plural
bangst	Second person Singular
vergraulet	Second person Plural
karrend	None
Henry	None
Freund	None
erlabest	Second person Singular
sabotierst	Second person Singular
Lektüren	None
Dunkels	None
Metallgeschmacks	None
zirkulier	Second person Singular
Muttermilch	None
rawbst	Second person Singular
ziel	Second person Singular
box	Second person Singular
verbannest	Second person Singular
zerlies	Second person Singular
heckst	Second person Singular
plärrest	Second person Singular
trainier	Second person Singular
bedien	Second person Singular
erforderest	Second person Singular
denunzier	Second person Singular
spännest	Second person Singular
oktroyier	Second person Singular
schimmelet	Second person Plural
fleuch	Second person Singular
vibrieret	Second person Plural
beglückwünsch	Second person Singular
greinest	Second person Singular
fragmentierst	Second person Singular
miß	Second person Singular
gefrort	Second person Plural
schwelst	Second person Singular
Halses	None
staubsaugst	Second person Singular
begehrest	Second person Singular
Endprodukt	None
heylst	Second person Singular
plumpset	Second person Plural
harmonisierest	Second person Singular
stärkest	Second person Singular
Olympiasiegern	None
nickst	Second person Singular
schulest	Second person Singular
versprechet	Second person Plural
Schlafwandlers	None
neckest	Second person Singular
fluktuierest	Second person Singular
loch	Second person Singular
entlehnst	Second person Singular
batiket	Second person Plural
laichet	Second person Plural
verblassend	None
Schwärmen	None
stotteret	Second person Plural
huschet	Second person Plural
erfass	Second person Singular
moderier	Second person Singular
reduzierst	Second person Singular
vertraget	Second person Plural
Kräfften	None
unterzöget	Second person Plural
Walhaies	None
dimmend	None
Gelagen	None
einigst	Second person Singular
strukturier	Second person Singular
fixierest	Second person Singular
Dampfschiff	None
verhehlet	Second person Plural
illustrier	Second person Singular
Mitglieder	None
Niederländerin	None
würfelst	Second person Singular
googelet	Second person Plural
transferierest	Second person Singular
kontrahierest	Second person Singular
Stall	None
Trümpfen	None
zürnet	Second person Plural
Rosenkränze	None
vermiß	Second person Singular
pexieret	Second person Plural
erscheinest	Second person Singular
verwelk	Second person Singular
verdächtigest	Second person Singular
moppest	Second person Singular
robb	Second person Singular
kompilieret	Second person Plural
attestierst	Second person Singular
formatierest	Second person Singular
stauet	Second person Plural
Busse	None
mulchst	Second person Singular
Äon	None
Exponat	None
spazierst	Second person Singular
hexet	Second person Plural
bisset	Second person Plural
gehöret	Second person Plural
befass	Second person Singular
beläuft	Third person Singular
Glaubensbrüder	None
rupf	Second person Singular
buddelest	Second person Singular
jagest	Second person Singular
wandest	Second person Singular
betätigst	Second person Singular
kaperst	Second person Singular
säget	Second person Plural
justieret	Second person Plural
überzeugest	Second person Singular
Briefträger	None
hock	Second person Singular
verwirklichst	Second person Singular
rall	Second person Singular
Griesgrame	None
grölst	Second person Singular
sinterest	Second person Singular
Koalitionspartner	None
schraub	Second person Singular
Konzentration	None
lobest	Second person Singular
spuckst	Second person Singular
duck	Second person Singular
schwangt	Second person Plural
deklamierest	Second person Singular
beleidigst	Second person Singular
Pakten	None
erständet	Second person Plural
beschädig	Second person Singular
parkend	None
wässerst	Second person Singular
Untersuchungsausschüssen	None
säufst	Second person Singular
magnetisierst	Second person Singular
Vipernattern	None
Arsenwasserstoffs	None
Kernits	None
Stopfleber	None
lamm	Second person Singular
Maurern	None
käbbelest	Second person Singular
Barometers	None
Geschosses	None
töpferest	Second person Singular
Schnalle	None
zerquetschst	Second person Singular
detektier	Second person Singular
dematerialisierest	Second person Singular
Fax	None
Terephthalsäure	None
blätterst	Second person Singular
rauschst	Second person Singular
erschließest	Second person Singular
läpperest	Second person Singular
Erhalte	None
Rattengifte	None
verscheißeret	Second person Plural
digerierst	Second person Singular
betankest	Second person Singular
Gefahrensymbolen	None
Piezoelementen	None
besicherest	Second person Singular
watschelet	Second person Plural
belauerest	Second person Singular
goutierest	Second person Singular
Vorteilen	None
instrumentalisierest	Second person Singular
Küchenmaschine	None
schikanierst	Second person Singular
veranlassest	Second person Singular
autorisieret	Second person Plural
suspendienierest	Second person Singular
Fußnähe	None
wiederholst	Second person Singular
pellst	Second person Singular
benetz	Second person Singular
browset	Second person Plural
Strafmaßnahmen	None
artikulieret	Second person Plural
anodisieret	Second person Plural
qualm	Second person Singular
glichest	Second person Singular
installierest	Second person Singular
titelst	Second person Singular
Derwischen	None
eroberet	Second person Plural
instanziier	Second person Singular
ähnelst	Second person Singular
Elektronenmasse	None
vergraulst	Second person Singular
sticket	Second person Plural
bleich	Second person Singular
Magnesiten	None
widerruf	Second person Singular
lockeret	Second person Plural
Broschen	None
misslinget	Second person Plural
Palindrome	None
Auslösers	None
beheimatest	Second person Singular
liefet	Second person Plural
Abwässer	None
überquer	Second person Singular
stachst	Second person Singular
frohlockest	Second person Singular
sonnet	Second person Plural
Gottesurteil	None
ring	Second person Singular
Dampfschiffes	None
spuket	Second person Plural
beeinflussest	Second person Singular
interpolierest	Second person Singular
beziehet	Second person Plural
siegst	Second person Singular
Meteoriten	None
kremieret	Second person Plural
vernimmt	Third person Singular
grämet	Second person Plural
unterschätzest	Second person Singular
vergrubst	Second person Singular
Hexagone	None
Weihwässer	None
Narren	None
Bestseller	None
Pirol	None
befolg	Second person Singular
Damaszeners	None
vertrag	Second person Singular
blauet	Second person Plural
Kolonien	None
zählst	Second person Singular
befummelest	Second person Singular
bekehrst	Second person Singular
tarn	Second person Singular
Maximierung	None
Nachthemd	None
gelobet	Second person Plural
evaluierest	Second person Singular
Landesverband	None
Koteletten	None
identifizierest	Second person Singular
Christstollen	None
Maßnahmen	None
Bundeswirtschaftsministern	None
Timberwolf	None
Eisenerz	None
Editierbarkeit	None
Kaliumpermanganat	None
importierest	Second person Singular
Autohof	None
paarest	Second person Singular
zaget	Second person Plural
thatet	Second person Plural
befiehlt	Third person Singular
validierst	Second person Singular
datierest	Second person Singular
peinig	Second person Singular
schröpf	Second person Singular
befällst	Second person Singular
mumifizier	Second person Singular
renovieret	Second person Plural
Klappen	None
promovierest	Second person Singular
lancierest	Second person Singular
flutschest	Second person Singular
begünstigest	Second person Singular
trainierest	Second person Singular
verarmest	Second person Singular
bröselet	Second person Plural
Arbeitslose	None
Speichern	None
Sofa	None
quälst	Second person Singular
taktier	Second person Singular
kasernierest	Second person Singular
juckest	Second person Singular
erklingend	None
ätzet	Second person Plural
dehydrierst	Second person Singular
pfiffet	Second person Plural
alarmierest	Second person Singular
schwadronierend	None
fället	Second person Plural
rennet	Second person Plural
spezialisieret	Second person Plural
Würfen	None
sabotieret	Second person Plural
platschst	Second person Singular
Fahnenträger	None
Isotopen	None
verstießest	Second person Singular
wäg	Second person Singular
betreib	Second person Singular
Kacheln	None
hass	Second person Singular
Armeen	None
überständet	Second person Plural
Cholesterins	None
unterwerfest	Second person Singular
liket	Second person Plural
isomerisieret	Second person Plural
geneset	Second person Plural
verbrenntest	Second person Singular
wetzest	Second person Singular
versenket	Second person Plural
abgezogen	None
inhaftieret	Second person Plural
beeilet	Second person Plural
aufgegeben	None
Nachtblindheit	None
beschlagnahmst	Second person Singular
verstirb	Second person Singular
malträtierst	Second person Singular
bewürbet	Second person Plural
transportierst	Second person Singular
befrei	Second person Singular
Eukalypten	None
drohend	None
Dingwörter	None
deal	Second person Singular
Folterknecht	None
Frisör	None
begrübet	Second person Plural
liehest	Second person Singular
nuschelest	Second person Singular
vertreibest	Second person Singular
übereilest	Second person Singular
desoxidier	Second person Singular
usurpierest	Second person Singular
entfernest	Second person Singular
linderet	Second person Plural
verkriechet	Second person Plural
elektrisier	Second person Singular
etablierest	Second person Singular
bewirket	Second person Plural
untersaget	Second person Plural
Sonnenfinsternis	None
entgingest	Second person Singular
anhebend	None
erlass	Second person Singular
muffest	Second person Singular
glupsch	Second person Singular
lavierst	Second person Singular
Fassbomben	None
verschlinget	Second person Plural
sozialisieret	Second person Plural
servierest	Second person Singular
Gemüsehandlungen	None
Heptoxide	None
vermerkst	Second person Singular
glawb	Second person Singular
billig	Second person Singular
schmauchest	Second person Singular
stippest	Second person Singular
Pokals	None
verkrocht	Second person Plural
strapazierest	Second person Singular
verfluchst	Second person Singular
Gedärmes	None
Bodybuilder	None
Helligkeit	None
Mahl	None
Legierungselementen	None
befestiget	Second person Plural
extemporierst	Second person Singular
Renderer	None
Regentropfens	None
bestimm	Second person Singular
schwändet	Second person Plural
echauffier	Second person Singular
kaschier	Second person Singular
apportieret	Second person Plural
Desoxyribonukleotiden	None
strahlest	Second person Singular
ritzet	Second person Plural
Syndrome	None
ertön	Second person Singular
benimmt	Third person Singular
chloroformier	Second person Singular
verdächtig	Second person Singular
vereisest	Second person Singular
XOR-Gatter	None
schlabberst	Second person Singular
bremsest	Second person Singular
chloroformierst	Second person Singular
schnüret	Second person Plural
kiekest	Second person Singular
verbissest	Second person Singular
aktivieret	Second person Plural
investieret	Second person Plural
befehlest	Second person Singular
Sprengstoffgürtel	None
pick	Second person Singular
Spießer	None
Schlächter	None
Ausrutscher	None
ebb	Second person Singular
sickeret	Second person Plural
verbrächet	Second person Plural
Ohrenrobben	None
Nullpunktes	None
sagest	Second person Singular
vertust	Second person Singular
Silicide	None
bedeck	Second person Singular
bestreuest	Second person Singular
prozessieret	Second person Plural
Französin	None
verschling	Second person Singular
tätowieret	Second person Plural
bekehrest	Second person Singular
quetschest	Second person Singular
Razzia	None
folget	Second person Plural
defragmentierest	Second person Singular
kriminalisieret	Second person Plural
coventrierest	Second person Singular
eingereicht	None
kritisierst	Second person Singular
ballet	Second person Plural
nah	Second person Singular
Spieltagen	None
entflöhest	Second person Singular
kokelet	Second person Plural
Lagergefäße	None
Finken	None
koagulieret	Second person Plural
dublierest	Second person Singular
Militärregierungen	None
sächselst	Second person Singular
mim	Second person Singular
verknallst	Second person Singular
beschlügest	Second person Singular
divergieret	Second person Plural
Versuche	None
küsset	Second person Plural
kategorisierest	Second person Singular
rausch	Second person Singular
dissentier	Second person Singular
erlang	Second person Singular
entteeret	Second person Plural
nennest	Second person Singular
Eisenoxids	None
streichet	Second person Plural
unterschlaget	Second person Plural
Verbrauchern	None
wünsch	Second person Singular
erdrosselst	Second person Singular
vergewaltigend	None
Boson	None
schikanieret	Second person Plural
Überfälle	None
hereinkommend	None
datierst	Second person Singular
freu	Second person Singular
Pensionäre	None
Zuhörern	None
schwirret	Second person Plural
Lotterie	None
Apogäum	None
Goldschakale	None
analysieret	Second person Plural
hellet	Second person Plural
schmuset	Second person Plural
bekenn	Second person Singular
überzeugend	None
Nasiräers	None
witteret	Second person Plural
avisierst	Second person Singular
kartografierst	Second person Singular
grins	Second person Singular
ergriffest	Second person Singular
versuch	Second person Singular
greinst	Second person Singular
wurzelst	Second person Singular
leerst	Second person Singular
Gesetzentwurf	None
Kanonenkugeln	None
übereil	Second person Singular
vertreibet	Second person Plural
kappet	Second person Plural
Hartloten	None
musicierst	Second person Singular
bequembet	Second person Plural
Fernsehbilder	None
tranchieret	Second person Plural
kiekst	Second person Singular
Surinamerinnen	None
Narwal	None
verbranntet	Second person Plural
Delfinen	None
tapezierest	Second person Singular
wehret	Second person Plural
putschet	Second person Plural
hallet	Second person Plural
muh	Second person Singular
unterstreichet	Second person Plural
beseelst	Second person Singular
priesest	Second person Singular
Montagabenden	None
patrouillierest	Second person Singular
Gedankenspielen	None
deregulier	Second person Singular
krächzst	Second person Singular
pipettieret	Second person Plural
übertraft	Second person Plural
flickest	Second person Singular
stau	Second person Singular
Sigeln	None
Zerfälle	None
jodelst	Second person Singular
verdürbet	Second person Plural
zentrifugieret	Second person Plural
unterjochest	Second person Singular
beholfen	None
unternimm	Second person Singular
dämpf	Second person Singular
Broschüren	None
klaffet	Second person Plural
beschlag	Second person Singular
muhet	Second person Plural
zapf	Second person Singular
stibitzest	Second person Singular
klärst	Second person Singular
verspeisest	Second person Singular
durchzuckst	Second person Singular
fluppet	Second person Plural
homogenisier	Second person Singular
paraphrasier	Second person Singular
gurgelst	Second person Singular
los	Second person Singular
Baritons	None
idealisier	Second person Singular
wirst	Second person Singular
Ballastes	None
besprichst	Second person Singular
mutmaßest	Second person Singular
riehest	Second person Singular
verprügelest	Second person Singular
polymerisierest	Second person Singular
lieferet	Second person Plural
transformierest	Second person Singular
flanieret	Second person Plural
Inbusschraube	None
dämonisierest	Second person Singular
verseifest	Second person Singular
Pollution	None
verzweifelet	Second person Plural
verdreifach	Second person Singular
karikierest	Second person Singular
hampelest	Second person Singular
verdoppelet	Second person Plural
galtet	Second person Plural
stehlest	Second person Singular
goutieret	Second person Plural
Eisenwerkstoff	None
verwanzet	Second person Plural
vergebet	Second person Plural
enttäusch	Second person Singular
festigst	Second person Singular
bröckelest	Second person Singular
geweigert	None
Bürgerwehr	None
reifizierest	Second person Singular
Bildungssprache	None
entwässerst	Second person Singular
tuschelest	Second person Singular
Flötisten	None
Papieren	None
interpretierst	Second person Singular
wuschelet	Second person Plural
gediehest	Second person Singular
entnimmt	Third person Singular
solidarisierst	Second person Singular
rappest	Second person Singular
Büro	None
Ergüssen	None
konnotieret	Second person Plural
vermögend	None
favorisierst	Second person Singular
veröffentlichest	Second person Singular
beschlagest	Second person Singular
Matte	None
Ursachen	None
schirmet	Second person Plural
Führerscheinen	None
muff	Second person Singular
Vorhängen	None
zwinkerest	Second person Singular
Brötchen	None
verzeiget	Second person Plural
verteilest	Second person Singular
entwirret	Second person Plural
Blumensträuße	None
Auslese	None
Gremiums	None
parkettieret	Second person Plural
desavouier	Second person Singular
demokratisier	Second person Singular
donnerest	Second person Singular
weißsagest	Second person Singular
wasserest	Second person Singular
Weltmeeren	None
Taschentuch	None
Cluster	None
betreffest	Second person Singular
sterilisierst	Second person Singular
gestehet	Second person Plural
verzierest	Second person Singular
experimentierest	Second person Singular
Homologs	None
opferest	Second person Singular
beschwort	Second person Plural
entmischest	Second person Singular
servieret	Second person Plural
säum	Second person Singular
widerriefet	Second person Plural
Ängstigung	None
empfehlet	Second person Plural
Dingwortes	None
verhandelet	Second person Plural
Kultusministerien	None
entweich	Second person Singular
schönet	Second person Plural
beschießet	Second person Plural
Warenkorb	None
hoffst	Second person Singular
Umlauf	None
sattelest	Second person Singular
Alarme	None
benachrichtiget	Second person Plural
Gehaltschecks	None
kratzet	Second person Plural
sperr	Second person Singular
Außwirckungen	None
zwingest	Second person Singular
Ablegers	None
verwirret	Second person Plural
Collage	None
köpf	Second person Singular
pflanz	Second person Singular
koexistieret	Second person Plural
Seekiefer	None
genierest	Second person Singular
eskalierst	Second person Singular
entwirr	Second person Singular
bebest	Second person Singular
kletteret	Second person Plural
erschlösset	Second person Plural
Primatologen	None
schacheret	Second person Plural
wähnest	Second person Singular
verstirbst	Second person Singular
postulierest	Second person Singular
blaust	Second person Singular
entkommet	Second person Plural
Werten	None
kommerzialisierst	Second person Singular
markierest	Second person Singular
verstrahlet	Second person Plural
Akanthiten	None
privatisier	Second person Singular
Nachzügler	None
kreieret	Second person Plural
bemächtiget	Second person Plural
verwesest	Second person Singular
reichest	Second person Singular
filzet	Second person Plural
Gesangslehrer	None
Bundesländer	None
verwerfet	Second person Plural
enthüllst	Second person Singular
misslangst	Second person Singular
doppelest	Second person Singular
Flügelfläche	None
befandet	Second person Plural
ertrinkst	Second person Singular
pexierst	Second person Singular
charakterisierest	Second person Singular
Flüssigkristallbildschirmen	None
mißbrauchst	Second person Singular
Eistee	None
durchquerst	Second person Singular
Brillengestellen	None
flunkerst	Second person Singular
Underdogs	None
verwässerest	Second person Singular
immunisieret	Second person Plural
borget	Second person Plural
laufest	Second person Singular
empöret	Second person Plural
dotierest	Second person Singular
grubt	Second person Plural
Bundesverfassungsgericht	None
spinnest	Second person Singular
Nahrungsbestandteilen	None
unterhält	Third person Singular
reagier	Second person Singular
verbeugest	Second person Singular
Damastgeweben	None
Wutanfälle	None
knallest	Second person Singular
salutier	Second person Singular
begnüg	Second person Singular
wieheret	Second person Plural
anmelden	None
schwirrest	Second person Singular
logier	Second person Singular
Märchenbücher	None
mobilisierest	Second person Singular
autorisierest	Second person Singular
Sichtkontaktes	None
Protuberanzen	None
meisterst	Second person Singular
Triebwerkes	None
befreiest	Second person Singular
lügest	Second person Singular
wecket	Second person Plural
drapieret	Second person Plural
begehet	Second person Plural
geschaht	Second person Plural
koppelest	Second person Singular
pflüget	Second person Plural
Zirkoniums	None
hinterzogt	Second person Plural
assimilier	Second person Singular
Liberianern	None
verschmölzest	Second person Singular
verbirgt	Third person Singular
menstruierest	Second person Singular
Schachtelhalmen	None
berühret	Second person Plural
deck	Second person Singular
belieft	Second person Plural
Erzpriester	None
Federchen	None
erbringet	Second person Plural
plagiier	Second person Singular
überkamt	Second person Plural
Unmengen	None
zusammenfassend	None
nagelest	Second person Singular
ehelichet	Second person Plural
bezwungen	None
wetzet	Second person Plural
gewitterst	Second person Singular
Schotten	None
sparet	Second person Plural
gelängest	Second person Singular
bedienet	Second person Plural
malet	Second person Plural
Wirtshaus	None
streikst	Second person Singular
Gasentladungsröhre	None
protegier	Second person Singular
Rangierbahnhöfe	None
widersprachst	Second person Singular
verunsicherest	Second person Singular
mopsest	Second person Singular
beaufsichtig	Second person Singular
schöpfet	Second person Plural
hintertreibst	Second person Singular
schädig	Second person Singular
verreisest	Second person Singular
investierst	Second person Singular
begrapschet	Second person Plural
folgerest	Second person Singular
gerännest	Second person Singular
überreagieret	Second person Plural
atomisierest	Second person Singular
veranschlagst	Second person Singular
sinnst	Second person Singular
kontaminier	Second person Singular
Azteke	None
Miassite	None
versifizier	Second person Singular
veränderst	Second person Singular
feilschet	Second person Plural
Asthenosphäre	None
signalisierst	Second person Singular
verschlimmbesserst	Second person Singular
lavierest	Second person Singular
perforierest	Second person Singular
schmorest	Second person Singular
Diktator	None
überholet	Second person Plural
stempelest	Second person Singular
Kartenhauses	None
halogenier	Second person Singular
pasteurisierst	Second person Singular
rekonstruierest	Second person Singular
Rasthöfe	None
Reißzwecke	None
Borhydride	None
Geruchssinnes	None
Anrufen	None
zersetz	Second person Singular
renommierest	Second person Singular
vertreib	Second person Singular
Außenministerium	None
erwecket	Second person Plural
feuerst	Second person Singular
frappierest	Second person Singular
tropfst	Second person Singular
Chlorknallgase	None
Würfelspielen	None
Stirn	None
Kanzlerin	None
rächend	None
Fürst	None
sprössest	Second person Singular
Bedeutungslehre	None
Mikrofonen	None
stickst	Second person Singular
sexelst	Second person Singular
bedrückest	Second person Singular
Ermittlern	None
rußest	Second person Singular
Hockern	None
verstellet	Second person Plural
Aktenordner	None
Hochkomma	None
logierst	Second person Singular
mopsend	None
Häuptlinge	None
abonnierst	Second person Singular
ärgerst	Second person Singular
benenn	Second person Singular
schilderet	Second person Plural
vermerk	Second person Singular
Besetzer	None
verschlänget	Second person Plural
fetz	Second person Singular
bölket	Second person Plural
ehret	Second person Plural
kapitalisier	Second person Singular
finanzierest	Second person Singular
suspendienierst	Second person Singular
Schecks	None
verwiesest	Second person Singular
schockierst	Second person Singular
entkriminalisierest	Second person Singular
Linksruckes	None
beauftragest	Second person Singular
randalierest	Second person Singular
katalogisier	Second person Singular
behelfend	None
verschlechterst	Second person Singular
raffinierend	None
kling	Second person Singular
Rothaarigen	None
elektrisierst	Second person Singular
beheimatst	Second person Singular
Erbgutes	None
Schadstoff	None
fotografierest	Second person Singular
wachet	Second person Plural
parlier	Second person Singular
Figuren	None
Appel	None
verselbständig	Second person Singular
gesäugt	None
wilderest	Second person Singular
verselbstständig	Second person Singular
verlangst	Second person Singular
ejakulierst	Second person Singular
versaust	Second person Singular
schupp	Second person Singular
bewahret	Second person Plural
verschlangt	Second person Plural
Absorption	None
schab	Second person Singular
Königstochter	None
bestraf	Second person Singular
verabscheuest	Second person Singular
steig	Second person Singular
entzifferst	Second person Singular
verpuffest	Second person Singular
Holzscheites	None
agierest	Second person Singular
philosophieret	Second person Plural
zensierest	Second person Singular
beließest	Second person Singular
Rasierer	None
Baueinheit	None
Steinböcke	None
untermaueret	Second person Plural
meditieret	Second person Plural
interpretier	Second person Singular
Stäbchen	None
tipp	Second person Singular
Hamstern	None
falz	Second person Singular
glawbst	Second person Singular
häufest	Second person Singular
tolerierst	Second person Singular
Schwärme	None
galoppier	Second person Singular
übergebet	Second person Plural
verwirklichet	Second person Plural
kappst	Second person Singular
entweichest	Second person Singular
eskortierst	Second person Singular
verformest	Second person Singular
fotografierend	None
Daumennagel	None
fabulier	Second person Singular
Acetamid	None
leget	Second person Plural
indizierst	Second person Singular
kolportier	Second person Singular
bündelst	Second person Singular
klüngelet	Second person Plural
vergingt	Second person Plural
verseifend	None
verformst	Second person Singular
Kalkspats	None
quälest	Second person Singular
induzier	Second person Singular
grab	Second person Singular
Quaste	None
schwirrst	Second person Singular
misch	Second person Singular
Löslichkeitsprodukten	None
reiz	Second person Singular
kombinierest	Second person Singular
verkürzest	Second person Singular
enteiset	Second person Plural
knurrst	Second person Singular
nächtigest	Second person Singular
boykottierest	Second person Singular
check	Second person Singular
Tomate	None
ratifizier	Second person Singular
Lebendgewichten	None
Verteidigungsministerium	None
seufz	Second person Singular
Näpfe	None
ersticht	Third person Singular
Katatonie	None
Schnipseln	None
überschwemmest	Second person Singular
haar	Second person Singular
amüsier	Second person Singular
rankest	Second person Singular
verbrämest	Second person Singular
Leichtsinn	None
pasteurisierest	Second person Singular
Weizenfelder	None
temperieret	Second person Plural
hüllst	Second person Singular
musicieret	Second person Plural
emaillierst	Second person Singular
bestachst	Second person Singular
verdeckt	None
beantraget	Second person Plural
Apokalyptikern	None
formulieret	Second person Plural
Entzug	None
schmus	Second person Singular
Demoskopen	None
Verdecke	None
untermauerst	Second person Singular
Halstuch	None
Almen	None
Reisebüros	None
gesessen	None
Bridge	None
Schlachtschiffen	None
legierst	Second person Singular
Massenspektrometers	None
flirr	Second person Singular
Beschleunigungssensor	None
Tintenfischen	None
handle	First person Singular
Konstruktionswerkstoff	None
meißelst	Second person Singular
Ankern	None
begingt	Second person Plural
Drahtesel	None
Hibiskus	None
plädier	Second person Singular
Kometenschweife	None
materialisier	Second person Singular
freuest	Second person Singular
beschlagnahm	Second person Singular
bremset	Second person Plural
erwideret	Second person Plural
Nukleotide	None
Impressionismus	None
panieret	Second person Plural
Managementsystems	None
Nebelstreife	None
vergabst	Second person Singular
behilfst	Second person Singular
belaufet	Second person Plural
kräh	Second person Singular
konfrontierst	Second person Singular
Waschlappens	None
giltst	Second person Singular
thatest	Second person Singular
beließet	Second person Plural
Sperrung	None
konvergierst	Second person Singular
bleichst	Second person Singular
bumset	Second person Plural
Vertretungsberechtigters	None
unterbracht	Second person Plural
Gänslein	None
steigst	Second person Singular
Wutbürgers	None
Eisvogels	None
verfanget	Second person Plural
übersteh	Second person Singular
erkennest	Second person Singular
Rasthofes	None
auslassend	None
überbrückest	Second person Singular
kabelst	Second person Singular
überdächtest	Second person Singular
verjüngest	Second person Singular
mops	Second person Singular
Jägerschnitzel	None
Zufluss	None
Excimerlaser	None
koordinier	Second person Singular
vibrier	Second person Singular
klapperet	Second person Plural
Vorbehalt	None
entstammest	Second person Singular
promotierst	Second person Singular
biwakieret	Second person Plural
Asteroiden	None
picknickest	Second person Singular
klassifizierst	Second person Singular
schraubet	Second person Plural
reproduzieret	Second person Plural
Schwabe	None
säug	Second person Singular
unterbricht	Third person Singular
evangelisieret	Second person Plural
benötig	Second person Singular
koproduzierst	Second person Singular
verästelst	Second person Singular
kaschierst	Second person Singular
Alchemist	None
Krönung	None
schmetterst	Second person Singular
gliederet	Second person Plural
Bacchanal	None
schielet	Second person Plural
verfinsteret	Second person Plural
mutierst	Second person Singular
dimmet	Second person Plural
komponieret	Second person Plural
flackeret	Second person Plural
pochst	Second person Singular
erschuft	Second person Plural
applicieret	Second person Plural
mehret	Second person Plural
Lucianer	None
Sozialarbeiterin	None
Umweltaspekten	None
Vernissagen	None
vertragest	Second person Singular
Nabel	None
Unterschenkels	None
trällerest	Second person Singular
jonglierest	Second person Singular
schwindelst	Second person Singular
elektrisir	Second person Singular
scheuerest	Second person Singular
unterbrich	Second person Singular
türmst	Second person Singular
Spießers	None
dröhnst	Second person Singular
weggelegt	None
imprägnierest	Second person Singular
ermächtigst	Second person Singular
Espresso	None
überwändest	Second person Singular
dramatisieret	Second person Plural
Teekesseln	None
schützest	Second person Singular
verschreibest	Second person Singular
Bürgerhauses	None
Gurgel	None
fladeret	Second person Plural
zerstreuet	Second person Plural
holperest	Second person Singular
kletterest	Second person Singular
Schneidwerkzeugen	None
Sängerfest	None
benachrichtig	Second person Singular
Bügeleisens	None
Noseanen	None
Riedel	None
lauschst	Second person Singular
aktivierst	Second person Singular
reformieret	Second person Plural
diskriminierst	Second person Singular
chillst	Second person Singular
beschuldigst	Second person Singular
sehnest	Second person Singular
hybridisierst	Second person Singular
verminderst	Second person Singular
sündig	Second person Singular
sabbelest	Second person Singular
provozierst	Second person Singular
hantier	Second person Singular
absorbieret	Second person Plural
verständig	Second person Singular
Gaukler	None
schmäleret	Second person Plural
wünschst	Second person Singular
schürf	Second person Singular
raufet	Second person Plural
widersprichst	Second person Singular
boykottieret	Second person Plural
verdrehet	Second person Plural
kippst	Second person Singular
annektierest	Second person Singular
knack	Second person Singular
Fassungen	None
trödelet	Second person Plural
gleichet	Second person Plural
verspracht	Second person Plural
bestiehlt	Third person Singular
vereinig	Second person Singular
besinnest	Second person Singular
Meissels	None
erschieß	Second person Singular
Kosmologien	None
mixest	Second person Singular
schleich	Second person Singular
glaub	Second person Singular
labialisieret	Second person Plural
überstandet	Second person Plural
gelierest	Second person Singular
Mischung	None
korrodier	Second person Singular
Christbaumschmuck	None
kartographieret	Second person Plural
beklaget	Second person Plural
dämmest	Second person Singular
Durcheinanders	None
bellest	Second person Singular
schämst	Second person Singular
vertrauet	Second person Plural
Kaisern	None
bemächtigst	Second person Singular
verfass	Second person Singular
schmink	Second person Singular
zerbrächest	Second person Singular
schlaget	Second person Plural
masturbierst	Second person Singular
flambierest	Second person Singular
bekriegest	Second person Singular
Emmentaler	None
Darmstädters	None
bellet	Second person Plural
terrorisierest	Second person Singular
gebissen	None
verludest	Second person Singular
kultivierst	Second person Singular
panier	Second person Singular
Erdalkalimetall	None
stink	Second person Singular
verbrämst	Second person Singular
bütz	Second person Singular
klatschst	Second person Singular
überteuerest	Second person Singular
ergießest	Second person Singular
interkulturalisierst	Second person Singular
revanchier	Second person Singular
Latte	None
grabbelst	Second person Singular
justierest	Second person Singular
tanzest	Second person Singular
karr	Second person Singular
rapp	Second person Singular
bröckelet	Second person Plural
umarm	Second person Singular
rezitierest	Second person Singular
schüttelst	Second person Singular
Trinkgefäße	None
isomerisierest	Second person Singular
stöhnest	Second person Singular
transportier	Second person Singular
rückest	Second person Singular
Kellnern	None
überstehest	Second person Singular
leimet	Second person Plural
tyrannisierest	Second person Singular
entzweiest	Second person Singular
vereinest	Second person Singular
fluorieret	Second person Plural
putzest	Second person Singular
individualisieret	Second person Plural
deklamierst	Second person Singular
patzend	None
streu	Second person Singular
konvergieret	Second person Plural
ringelest	Second person Singular
beschwerest	Second person Singular
Rücksprung	None
schwiegest	Second person Singular
reifest	Second person Singular
saget	Second person Plural
dementier	Second person Singular
Filze	None
posierst	Second person Singular
Goldgräbers	None
vorkommen	None
Biwaks	None
reagierst	Second person Singular
peroxidier	Second person Singular
verkörperst	Second person Singular
dokumentierst	Second person Singular
dominierst	Second person Singular
korrespondierest	Second person Singular
flieh	Second person Singular
Welse	None
Downers	None
Fragenkataloges	None
Gelübden	None
Argumentationen	None
keuch	Second person Singular
assoziieret	Second person Plural
Unkrautsäer	None
umhüll	Second person Singular
antichambrier	Second person Singular
interpolieret	Second person Plural
untersagest	Second person Singular
logierest	Second person Singular
kribbelest	Second person Singular
Raubfischen	None
verwechselst	Second person Singular
schwill	Second person Singular
mißverstehest	Second person Singular
belögest	Second person Singular
grein	Second person Singular
Ziehungen	None
glückest	Second person Singular
brennet	Second person Plural
ergibt	Third person Singular
renntest	Second person Singular
bejagst	Second person Singular
verhehlst	Second person Singular
evakuieret	Second person Plural
ertönet	Second person Plural
Fortsetzung	None
protokollier	Second person Singular
Salomonenrallen	None
Dateiname	None
Blitzschlages	None
Einstürze	None
schärf	Second person Singular
erkrankst	Second person Singular
wägend	None
Inertialsystems	None
einlegend	None
realisier	Second person Singular
überschwemm	Second person Singular
gruppieret	Second person Plural
Nestlingen	None
würget	Second person Plural
sparest	Second person Singular
Zeitgenosse	None
versorgst	Second person Singular
schleichet	Second person Plural
feist	Second person Singular
Imitationen	None
befriediget	Second person Plural
desavouieret	Second person Plural
verstießet	Second person Plural
zerbricht	Third person Singular
panaschier	Second person Singular
kommentier	Second person Singular
entkamt	Second person Plural
Veteran	None
widerriefst	Second person Singular
beschäftig	Second person Singular
reinigest	Second person Singular
welk	Second person Singular
kugelest	Second person Singular
widerleget	Second person Plural
beglichst	Second person Singular
schraubst	Second person Singular
terrorisieret	Second person Plural
Paraguayer	None
unterstricht	Second person Plural
zerquetschest	Second person Singular
komplexier	Second person Singular
Wirtshauses	None
verliebest	Second person Singular
ergabt	Second person Plural
Großmeistern	None
Einsteiniums	None
Excimerlasers	None
Ankurbelung	None
Hundeleben	None
agier	Second person Singular
Storches	None
paralysier	Second person Singular
bedurftet	Second person Plural
Schwärze	None
dankest	Second person Singular
Perlhühner	None
Geschichtenbuch	None
Filtraten	None
deaktivier	Second person Singular
stürzst	Second person Singular
blinzelet	Second person Plural
währet	Second person Plural
beziehst	Second person Singular
zwitscherst	Second person Singular
auflösen	None
picknick	Second person Singular
stärk	Second person Singular
kassierst	Second person Singular
entsetzest	Second person Singular
engagierst	Second person Singular
verdunkelst	Second person Singular
widerrufst	Second person Singular
amenagier	Second person Singular
süssest	Second person Singular
migrierest	Second person Singular
summier	Second person Singular
cremst	Second person Singular
widerriefest	Second person Singular
entfärbest	Second person Singular
entgehet	Second person Plural
Landstraßen	None
flirrst	Second person Singular
Übersetzerinnen	None
Rudeln	None
befandest	Second person Singular
pickest	Second person Singular
entschliefst	Second person Singular
beauftraget	Second person Plural
flitterst	Second person Singular
Spekulationsobjekt	None
Uhrzeiten	None
ernüchterst	Second person Singular
klon	Second person Singular
brennst	Second person Singular
radikalisier	Second person Singular
Mohren	None
perforierst	Second person Singular
hegst	Second person Singular
geniessest	Second person Singular
genieß	Second person Singular
hüll	Second person Singular
lispelest	Second person Singular
ahnst	Second person Singular
cremest	Second person Singular
verstellest	Second person Singular
Brustwarze	None
kauerst	Second person Singular
beförderet	Second person Plural
fragmentierest	Second person Singular
materialisierest	Second person Singular
stöhnst	Second person Singular
differenzierst	Second person Singular
Feuerfisch	None
Iraners	None
tapezierst	Second person Singular
nippst	Second person Singular
heischest	Second person Singular
doublier	Second person Singular
entwirrst	Second person Singular
tob	Second person Singular
absteigend	None
blaff	Second person Singular
befunden	None
Muttersprachlerin	None
benenntest	Second person Singular
laichest	Second person Singular
würfest	Second person Singular
Konformationsisomers	None
belächelest	Second person Singular
pisset	Second person Plural
gehör	Second person Singular
ergieß	Second person Singular
entsteh	Second person Singular
bezauberest	Second person Singular
vermittelst	Second person Singular
Produktionsorte	None
massakrierst	Second person Singular
Kaffeehauses	None
schmücket	Second person Plural
klimatisieret	Second person Plural
lockerest	Second person Singular
verjagst	Second person Singular
Delphine	None
verratest	Second person Singular
Eingüsse	None
Homöopath	None
Berufung	None
Alkylierung	None
söffet	Second person Plural
treibst	Second person Singular
bugsier	Second person Singular
ejakulier	Second person Singular
Espressos	None
ätzest	Second person Singular
saunier	Second person Singular
Kupplung	None
überwachet	Second person Plural
wechselwirk	Second person Singular
bangest	Second person Singular
Anglikaner	None
Friese	None
Einschlußkomplexes	None
Antagonist	None
Xi	None
empfahlst	Second person Singular
lancier	Second person Singular
klauet	Second person Plural
geltend	None
versetz	Second person Singular
schrumpf	Second person Singular
Autofahrer	None
schwör	Second person Singular
blanchierst	Second person Singular
angestellt	None
thuest	Second person Singular
zerfetz	Second person Singular
Protonen	None
vermischest	Second person Singular
kniffet	Second person Plural
umzingelest	Second person Singular
Spielräume	None
Amokläufen	None
sanierst	Second person Singular
walzest	Second person Singular
Backoffice	None
keul	Second person Singular
entwarfst	Second person Singular
parkettier	Second person Singular
heckest	Second person Singular
überfällst	Second person Singular
kriminalisierst	Second person Singular
horchest	Second person Singular
colorier	Second person Singular
tippet	Second person Plural
implodierest	Second person Singular
Standardwerten	None
stauest	Second person Singular
genügest	Second person Singular
Eiskaffee	None
streifest	Second person Singular
kündig	Second person Singular
ölst	Second person Singular
Wohnorte	None
bezichtiget	Second person Plural
diss	Second person Singular
wetz	Second person Singular
schacherest	Second person Singular
kommentieret	Second person Plural
folgst	Second person Singular
gemildert	None
näh	Second person Singular
pinkelest	Second person Singular
überraschest	Second person Singular
schonest	Second person Singular
begrabet	Second person Plural
besannt	Second person Plural
Däne	None
verträgst	Second person Singular
zertifizierst	Second person Singular
japset	Second person Plural
stolperst	Second person Singular
ertrag	Second person Singular
schluderst	Second person Singular
schwel	Second person Singular
Zahlwort	None
Schöpfungstag	None
verdarbt	Second person Plural
Jagd	None
unterwarft	Second person Plural
flohst	Second person Singular
Stöcken	None
repräsentieret	Second person Plural
kupierest	Second person Singular
fügst	Second person Singular
Menschenhandel	None
Beschleunigers	None
rummelest	Second person Singular
beruhigst	Second person Singular
fraternisier	Second person Singular
verzweigest	Second person Singular
brandschatz	Second person Singular
fochtet	Second person Plural
dehydrieret	Second person Plural
doppelet	Second person Plural
Zauberkraft	None
bewirbt	Third person Singular
Rüsche	None
worfelest	Second person Singular
Rekorde	None
bedank	Second person Singular
versuchest	Second person Singular
schleichest	Second person Singular
Stellvertretern	None
verkleinerst	Second person Singular
vertipp	Second person Singular
begabst	Second person Singular
vermerket	Second person Plural
blanchier	Second person Singular
feierest	Second person Singular
Analgetika	None
Antihistaminikums	None
Kurzstreckenlaufes	None
Maschinengewehres	None
bejahst	Second person Singular
Arbeitskreises	None
aufgelöst	None
mimest	Second person Singular
induzieret	Second person Plural
reduzier	Second person Singular
stipp	Second person Singular
verbrauchet	Second person Plural
thematisierst	Second person Singular
erfrisch	Second person Singular
obset	Second person Plural
nipp	Second person Singular
separierest	Second person Singular
Verehrerinnen	None
korrodierest	Second person Singular
schauet	Second person Plural
kommentierend	None
Finanz	None
verursach	Second person Singular
referieret	Second person Plural
Planes	None
Viertelliter	None
gemangelt	None
verbleiest	Second person Singular
Totentrompeten	None
beanspruchet	Second person Plural
peroxidieret	Second person Plural
korrelierst	Second person Singular
Blasformen	None
strullerst	Second person Singular
numerieret	Second person Plural
unterschriebet	Second person Plural
verdaust	Second person Singular
teerest	Second person Singular
bastelet	Second person Plural
urbanisierest	Second person Singular
erschlaget	Second person Plural
keifst	Second person Singular
tramp	Second person Singular
scheidend	None
frühstück	Second person Singular
spännet	Second person Plural
tanz	Second person Singular
zerdepperest	Second person Singular
stick	Second person Singular
raub	Second person Singular
schätzest	Second person Singular
datier	Second person Singular
Bremshebels	None
kontrollier	Second person Singular
behelfet	Second person Plural
penn	Second person Singular
verständigest	Second person Singular
Schreien	None
präg	Second person Singular
etiolierend	None
wurstelst	Second person Singular
verliebet	Second person Plural
Schlüsselrollen	None
betriffst	Second person Singular
hechelet	Second person Plural
entjungeret	Second person Plural
reih	Second person Singular
garnierest	Second person Singular
Kreiselkompasses	None
deponierest	Second person Singular
Winkels	None
Horror	None
Haltung	None
tätigest	Second person Singular
pups	Second person Singular
schwafelet	Second person Plural
erniedrigend	None
branntest	Second person Singular
grübelet	Second person Plural
Verkehrsmitteln	None
erzwangt	Second person Plural
grünst	Second person Singular
gedenk	Second person Singular
Befriedigung	None
Kantinen	None
Salm	None
Hackfleischverordnung	None
spuk	Second person Singular
flöhet	Second person Plural
wuschelst	Second person Singular
nutzest	Second person Singular
kandier	Second person Singular
Peptide	None
prostituierst	Second person Singular
klammerst	Second person Singular
verfluchest	Second person Singular
Raubüberfällen	None
tagg	Second person Singular
zerkleinerest	Second person Singular
Staaten	None
rhodinier	Second person Singular
ragst	Second person Singular
pollest	Second person Singular
ermutiget	Second person Plural
transchierest	Second person Singular
Fahndungsliste	None
portraitier	Second person Singular
häuf	Second person Singular
kiffst	Second person Singular
Frisuren	None
verstopfest	Second person Singular
köderet	Second person Plural
Vorjahrs	None
schaukelst	Second person Singular
assoziierst	Second person Singular
vergaltest	Second person Singular
Intelligenzquotient	None
entjungerest	Second person Singular
Natronkalken	None
kapp	Second person Singular
fertigst	Second person Singular
wisperet	Second person Plural
schimpfet	Second person Plural
rekapitulieret	Second person Plural
akkreditier	Second person Singular
retuschierest	Second person Singular
replicirest	Second person Singular
surfest	Second person Singular
hexest	Second person Singular
schnürst	Second person Singular
erschütterest	Second person Singular
Ideologen	None
sinnierest	Second person Singular
kommest	Second person Singular
Schlaftabletten	None
infizierst	Second person Singular
flunkerest	Second person Singular
probierst	Second person Singular
klassifizieret	Second person Plural
wankst	Second person Singular
Briefmarken	None
missverstehet	Second person Plural
Früchtchen	None
Haubenpinguin	None
erprobet	Second person Plural
entschärf	Second person Singular
erstreck	Second person Singular
konvertierst	Second person Singular
mobilisierst	Second person Singular
verwitter	Second person Singular
lokalisierst	Second person Singular
behülfet	Second person Plural
Bariton	None
schmirgelest	Second person Singular
erklärst	Second person Singular
Konzerthauses	None
Gnaden	None
flanier	Second person Singular
verzögerest	Second person Singular
Schenkels	None
dringest	Second person Singular
gestikulierst	Second person Singular
verblasset	Second person Plural
zwäng	Second person Singular
Narkotikum	None
gleichst	Second person Singular
fingierest	Second person Singular
Gymnasien	None
Alkoholgehaltes	None
Rückganges	None
liquidieret	Second person Plural
bezweifelest	Second person Singular
läuft	Third person Singular
Pigmenten	None
galoppieret	Second person Plural
instanziierest	Second person Singular
dissentieret	Second person Plural
vernachlässig	Second person Singular
gönn	Second person Singular
demotivierest	Second person Singular
verteil	Second person Singular
vermochtet	Second person Plural
mampfet	Second person Plural
Supraleiters	None
benötiget	Second person Plural
Hydroxids	None
dös	Second person Singular
gepaddelt	None
Volumenprozente	None
riebst	Second person Singular
besohlest	Second person Singular
Aluminiumblech	None
kapitulier	Second person Singular
kennzeichnend	None
schirm	Second person Singular
virtualisieret	Second person Plural
hökerest	Second person Singular
umfassest	Second person Singular
beton	Second person Singular
restaurieret	Second person Plural
Oheims	None
jonglieret	Second person Plural
erspar	Second person Singular
Metten	None
empörest	Second person Singular
personifizierst	Second person Singular
Stuten	None
schlafwandelet	Second person Plural
Uchte	None
entschlossest	Second person Singular
verschonet	Second person Plural
verleihest	Second person Singular
katalysierest	Second person Singular
meßet	Second person Plural
sperrest	Second person Singular
nervet	Second person Plural
Börden	None
erregst	Second person Singular
umgäbet	Second person Plural
Träumers	None
verdankest	Second person Singular
miss	Second person Singular
konzessionier	Second person Singular
prozessierest	Second person Singular
missverständest	Second person Singular
imkeret	Second person Plural
Überzeugung	None
begebest	Second person Singular
Dachboden	None
Dachdeckers	None
schlürfst	Second person Singular
Tischlerei	None
demoralisierest	Second person Singular
emaillierest	Second person Singular
verdauest	Second person Singular
streichelst	Second person Singular
erstarr	Second person Singular
verkörperest	Second person Singular
vernehmet	Second person Plural
stabilisieret	Second person Plural
liierst	Second person Singular
verführst	Second person Singular
Zahltage	None
verurteilst	Second person Singular
feiet	Second person Plural
verschließ	Second person Singular
öl	Second person Singular
colorieret	Second person Plural
Küchenmöbel	None
limitieret	Second person Plural
gebratscht	None
beförderest	Second person Singular
Gleichnisses	None
Verheimlichung	None
verdrängst	Second person Singular
verein	Second person Singular
brennest	Second person Singular
humpelest	Second person Singular
Waschbrettes	None
weihet	Second person Plural
Fluoride	None
kulleret	Second person Plural
Fotoalben	None
untersagst	Second person Singular
verlüdest	Second person Singular
Kreationisten	None
Darmentzündungen	None
dümpelest	Second person Singular
Creuz	None
gewitterest	Second person Singular
versprechest	Second person Singular
köpfest	Second person Singular
Kesseln	None
Fremdbestandteiles	None
tolerierest	Second person Singular
frikassierest	Second person Singular
Sexspielzeuges	None
foulst	Second person Singular
Kielers	None
Getto	None
übergabst	Second person Singular
weißsag	Second person Singular
katapultierst	Second person Singular
kämmst	Second person Singular
reißet	Second person Plural
thu	Second person Singular
Mumien	None
versau	Second person Singular
verpass	Second person Singular
verbeißest	Second person Singular
abonnier	Second person Singular
konzipierst	Second person Singular
wäscht	Third person Singular
murkset	Second person Plural
reimet	Second person Plural
verbleibet	Second person Plural
überwandet	Second person Plural
erregest	Second person Singular
krepierest	Second person Singular
autorisierst	Second person Singular
Gelenken	None
Tageszeit	None
schlagest	Second person Singular
Genen	None
debattierst	Second person Singular
betriebt	Second person Plural
riehst	Second person Singular
ondulieret	Second person Plural
Augenlid	None
beheizet	Second person Plural
verschmäh	Second person Singular
Hurrikane	None
stimmst	Second person Singular
betonier	Second person Singular
Westen	None
schlürfet	Second person Plural
evakuierst	Second person Singular
revidier	Second person Singular
appellierst	Second person Singular
verlangsam	Second person Singular
Hartlote	None
entwisch	Second person Singular
äußerst	Second person Singular
verbüßest	Second person Singular
kotzet	Second person Plural
bettelest	Second person Singular
segelnd	None
Sorge	None
verbirgst	Second person Singular
Andragogik	None
klemmest	Second person Singular
sinnest	Second person Singular
zerstäubst	Second person Singular
duellierst	Second person Singular
verdanket	Second person Plural
entschädigest	Second person Singular
vergeh	Second person Singular
geling	Second person Singular
ergrifft	Second person Plural
entmachtet	Second person Plural
hobt	Second person Plural
Katapulten	None
widerlegest	Second person Singular
kauerest	Second person Singular
Scheißdreck	None
Einfallsreichtum	None
beeinträchtigest	Second person Singular
verurteil	Second person Singular
verarsch	Second person Singular
unterschreib	Second person Singular
demotivierst	Second person Singular
kreiset	Second person Plural
weihest	Second person Singular
Quorum	None
romantisier	Second person Singular
verbauet	Second person Plural
getestet	None
Bremsschuhes	None
Mähdreschers	None
bettelst	Second person Singular
gegenbeschuldigest	Second person Singular
separieret	Second person Plural
aktivierest	Second person Singular
verschlimmeret	Second person Plural
versüß	Second person Singular
gelyncht	None
bewerbest	Second person Singular
Genies	None
brünier	Second person Singular
Sprengstoff	None
befehlet	Second person Plural
genieret	Second person Plural
Zungen	None
Kimme	None
begibt	Third person Singular
sträubst	Second person Singular
furz	Second person Singular
versenkest	Second person Singular
befraget	Second person Plural
beleidiget	Second person Plural
kremier	Second person Singular
Thailänders	None
Peruanerin	None
verstarbt	Second person Plural
Weltmarktpreisen	None
bewirkst	Second person Singular
beb	Second person Singular
Apfelschnecken	None
laberet	Second person Plural
Frikadellen	None
onanieret	Second person Plural
zappet	Second person Plural
karikierst	Second person Singular
abalienierest	Second person Singular
Thalliums	None
gestillt	None
verdampfet	Second person Plural
behandelst	Second person Singular
Anträgen	None
explodieret	Second person Plural
gehickst	None
kollidieret	Second person Plural
zürnst	Second person Singular
Verteidigungsministerin	None
forcierst	Second person Singular
waget	Second person Plural
ergrauet	Second person Plural
bezweifelst	Second person Singular
heulest	Second person Singular
geschieh	Second person Singular
holst	Second person Singular
bezahlet	Second person Plural
Salze	None
überschwemmst	Second person Singular
implodieret	Second person Plural
grau	Second person Singular
nebelest	Second person Singular
Chauffeurs	None
erstellest	Second person Singular
tränest	Second person Singular
maskierst	Second person Singular
verschlechterest	Second person Singular
grien	Second person Singular
Burrito	None
stock	Second person Singular
erschufst	Second person Singular
erstichst	Second person Singular
amüsierest	Second person Singular
behandelest	Second person Singular
bemühet	Second person Plural
bewerbet	Second person Plural
profitierend	None
schilderst	Second person Singular
assistierest	Second person Singular
rekapitulierst	Second person Singular
liefest	Second person Singular
reglementier	Second person Singular
Planetariums	None
Hochzeitstorte	None
erleichterest	Second person Singular
tropf	Second person Singular
postulieret	Second person Plural
Tonne	None
schanghai	Second person Singular
Ferritinen	None
hungerest	Second person Singular
übertreffest	Second person Singular
krakelet	Second person Plural
rännet	Second person Plural
messest	Second person Singular
überprüfet	Second person Plural
kastrier	Second person Singular
ramifizierst	Second person Singular
Heliumhydriden	None
liebet	Second person Plural
plissier	Second person Singular
flutsch	Second person Singular
Flor	None
Cineast	None
Kommanditgesellschaften	None
Rohrkatze	None
verminderet	Second person Plural
Fertigungen	None
Karzinome	None
inhaftierest	Second person Singular
gönnet	Second person Plural
Feinschmeckerlokal	None
platzierst	Second person Singular
sponserst	Second person Singular
dopst	Second person Singular
Rotkohlen	None
Volumenprozent	None
Autodidakten	None
entstandest	Second person Singular
Reusen	None
sortierest	Second person Singular
bedinget	Second person Plural
sabberet	Second person Plural
Schicksal	None
Obergespanne	None
balkanisieret	Second person Plural
kämmest	Second person Singular
teilst	Second person Singular
kreuzigst	Second person Singular
prozessier	Second person Singular
verlockst	Second person Singular
fingieret	Second person Plural
Bebauungspläne	None
möblierest	Second person Singular
bugsieret	Second person Plural
ballest	Second person Singular
gerannt	Second person Plural
patrouillierst	Second person Singular
unternähmest	Second person Singular
tagst	Second person Singular
eingelegt	None
beschädigst	Second person Singular
Strohhalm	None
übertreib	Second person Singular
fluch	Second person Singular
Gegengifte	None
rammst	Second person Singular
verklär	Second person Singular
verdampfst	Second person Singular
Härtung	None
verfärb	Second person Singular
riskierst	Second person Singular
inszenier	Second person Singular
wahrest	Second person Singular
leim	Second person Singular
qualifizier	Second person Singular
erliegest	Second person Singular
hoppelest	Second person Singular
subventionieret	Second person Plural
Darmentzündung	None
Sendegeräte	None
oktroyierest	Second person Singular
gechillt	None
verschwiegst	Second person Singular
deklarierest	Second person Singular
mißverständet	Second person Plural
bedrucket	Second person Plural
entspränget	Second person Plural
folg	Second person Singular
Campussen	None
klirrest	Second person Singular
scheltest	Second person Singular
beschwerst	Second person Singular
Liste	None
überwachst	Second person Singular
tätowierst	Second person Singular
fügest	Second person Singular
heuchelest	Second person Singular
widerständest	Second person Singular
versäumst	Second person Singular
evaluieret	Second person Plural
streik	Second person Singular
stechest	Second person Singular
Mangold	None
schmusend	None
kontrollierst	Second person Singular
Filets	None
blinkst	Second person Singular
schmück	Second person Singular
Karpaltunnel	None
erstrecket	Second person Plural
legalisierest	Second person Singular
Zinnwaldites	None
ekelest	Second person Singular
desillusionieret	Second person Plural
musizierest	Second person Singular
Identitätsnachweis	None
arrivier	Second person Singular
strukturierest	Second person Singular
motivieret	Second person Plural
verschmutz	Second person Singular
bereinigst	Second person Singular
untersuchend	None
raget	Second person Plural
vertief	Second person Singular
tappet	Second person Plural
Überläufers	None
chill	Second person Singular
attackierest	Second person Singular
pupset	Second person Plural
Trabant	None
tabuisieret	Second person Plural
besorg	Second person Singular
orientier	Second person Singular
revolutionierst	Second person Singular
zekratzet	Second person Plural
überprüfst	Second person Singular
pfleget	Second person Plural
Notenwerten	None
kränk	Second person Singular
verdreh	Second person Singular
Fleischereien	None
bezeugst	Second person Singular
Liter	None
sankst	Second person Singular
Verbundwerkstoffen	None
glüh	Second person Singular
Nahrung	None
rekrutieret	Second person Plural
Omelett	None
schmorst	Second person Singular
tyrannisieret	Second person Plural
Schicksalen	None
Spekulationsobjektes	None
Hausmäusen	None
vermögest	Second person Singular
Hieben	None
Petschaft	None
Wüstung	None
erschlagest	Second person Singular
triumphier	Second person Singular
Polysem	None
sterilisieret	Second person Plural
reihst	Second person Singular
partitionierend	None
koordinieret	Second person Plural
erlieg	Second person Singular
zerbrichst	Second person Singular
beäuget	Second person Plural
stillst	Second person Singular
besserest	Second person Singular
Gegenspielern	None
coventrisier	Second person Singular
Steuerbord	None
erlassest	Second person Singular
probst	Second person Singular
privatisierest	Second person Singular
bestehest	Second person Singular
keulet	Second person Plural
bappet	Second person Plural
designierst	Second person Singular
knacket	Second person Plural
parametrisierest	Second person Singular
tränk	Second person Singular
appliciret	Second person Plural
zerfetzet	Second person Plural
versauerst	Second person Singular
gönnst	Second person Singular
kriechet	Second person Plural
entzifferet	Second person Plural
entworfen	None
hinterlasset	Second person Plural
verfehl	Second person Singular
tunst	Second person Singular
Pflanzenstoffe	None
Wasserrädern	None
beschleunigst	Second person Singular
Notausgängen	None
Milchprodukte	None
würz	Second person Singular
tatteret	Second person Plural
huschst	Second person Singular
genügst	Second person Singular
bedienest	Second person Singular
Verluste	None
Naturtalente	None
manipulierest	Second person Singular
Apothekern	None
Weibleins	None
karrst	Second person Singular
knurret	Second person Plural
obs	Second person Singular
kreißest	Second person Singular
sortieret	Second person Plural
kanalisierest	Second person Singular
verlängerst	Second person Singular
Bestand	None
verknüpfest	Second person Singular
Bestände	None
Messbarkeit	None
Macchie	None
Juwel	None
roll	Second person Singular
Querkopfes	None
Kongruenzen	None
verbranntest	Second person Singular
generieret	Second person Plural
Vaginen	None
nag	Second person Singular
Würze	None
Titelverteidigern	None
eggst	Second person Singular
Glockenspiels	None
belüget	Second person Plural
misslingst	Second person Singular
harmonierest	Second person Singular
Möbelstoffe	None
konsolidieret	Second person Plural
gleichest	Second person Singular
zeuget	Second person Plural
besorgst	Second person Singular
placieret	Second person Plural
ersuch	Second person Singular
pflückest	Second person Singular
zwinkeret	Second person Plural
befriedigst	Second person Singular
sichre	First person Singular
generierest	Second person Singular
demoralisieret	Second person Plural
brandschatzest	Second person Singular
graset	Second person Plural
dotier	Second person Singular
japsest	Second person Singular
Schmarotzer	None
Leib	None
lenkest	Second person Singular
triebest	Second person Singular
Töpfers	None
entnähmet	Second person Plural
verbricht	Third person Singular
senk	Second person Singular
injizierest	Second person Singular
kommet	Second person Plural
Heptane	None
immunisier	Second person Singular
Arzthelferinnen	None
Aquiferen	None
Unterkategorie	None
aluminierst	Second person Singular
glaubst	Second person Singular
überreichest	Second person Singular
Scharade	None
überholst	Second person Singular
Ligninen	None
Eilandes	None
Biene	None
klüngelst	Second person Singular
krach	Second person Singular
verkleineret	Second person Plural
verspricht	Third person Singular
verlieb	Second person Singular
Verdienst	None
regier	Second person Singular
Störchen	None
rawb	Second person Singular
frickelest	Second person Singular
Inder	None
piss	Second person Singular
schassest	Second person Singular
wurschtelst	Second person Singular
panaschieret	Second person Plural
skypest	Second person Singular
Timing	None
befielt	Second person Plural
Pekannüssen	None
verwehest	Second person Singular
Fettleber	None
Kelte	None
verlass	Second person Singular
zerfetzest	Second person Singular
traumatisier	Second person Singular
zerquetsch	Second person Singular
Tankstelle	None
Kamacit	None
schimmerst	Second person Singular
wehrest	Second person Singular
scherzest	Second person Singular
fingst	Second person Singular
missverstehest	Second person Singular
Scherben	None
chiffrier	Second person Singular
Tamarinde	None
nicket	Second person Plural
Befundes	None
Salons	None
leaket	Second person Plural
Schrein	None
füsilier	Second person Singular
düpierst	Second person Singular
seufzet	Second person Plural
verdau	Second person Singular
verabreich	Second person Singular
Widerstand	None
Bergbau	None
zitterest	Second person Singular
fragmentieret	Second person Plural
goutierst	Second person Singular
placierest	Second person Singular
beschul	Second person Singular
flambier	Second person Singular
deklinierst	Second person Singular
renovierst	Second person Singular
Gegenpäpsten	None
strickest	Second person Singular
Kollagen	None
haarst	Second person Singular
liehst	Second person Singular
empfehlest	Second person Singular
bratsch	Second person Singular
endgelagert	None
wärmest	Second person Singular
wogst	Second person Singular
streif	Second person Singular
besteh	Second person Singular
Privatsache	None
quak	Second person Singular
nahst	Second person Singular
glückst	Second person Singular
entwürfest	Second person Singular
gravierst	Second person Singular
grienst	Second person Singular
Nachthemdes	None
erschlosst	Second person Plural
Bottichen	None
Besenstiel	None
zwangsernähr	Second person Singular
Abkömmling	None
käufet	Second person Plural
verschriebest	Second person Singular
Formular	None
Schleifring	None
Priorates	None
ersticket	Second person Plural
Tausendschön	None
tun	Second person Singular
klickest	Second person Singular
erstacht	Second person Plural
löffelst	Second person Singular
filz	Second person Singular
entkörperlich	Second person Singular
Adrenalin	None
schnorchelst	Second person Singular
Kleister	None
überstandest	Second person Singular
verbeug	Second person Singular
coverst	Second person Singular
randalieret	Second person Plural
mumifizierest	Second person Singular
veranlass	Second person Singular
äusserest	Second person Singular
genüget	Second person Plural
umschmilz	Second person Singular
wasseret	Second person Plural
kremst	Second person Singular
krächzest	Second person Singular
mißlingst	Second person Singular
meuchelest	Second person Singular
kategorisierst	Second person Singular
vergleichst	Second person Singular
erschlugst	Second person Singular
referenzier	Second person Singular
panaschierst	Second person Singular
Kupferstich	None
bewässeret	Second person Plural
bezauberst	Second person Singular
Erschießung	None
trampet	Second person Plural
bündelest	Second person Singular
virtualisierest	Second person Singular
verpuppst	Second person Singular
loderest	Second person Singular
Wohngebiete	None
verschlisset	Second person Plural
Feststoffen	None
jagst	Second person Singular
legier	Second person Singular
Faden	None
Gussstücken	None
schleimet	Second person Plural
usurpierst	Second person Singular
fisch	Second person Singular
dissoziierst	Second person Singular
Strand	None
fesselst	Second person Singular
kämmet	Second person Plural
Weihnachtsbäume	None
Bindung	None
erneuerst	Second person Singular
ergibst	Second person Singular
ermutigst	Second person Singular
Metallquirle	None
klickst	Second person Singular
Mazedoniern	None
aktualisieret	Second person Plural
Fluse	None
rannt	Second person Plural
erläuteret	Second person Plural
schiesset	Second person Plural
Gruppennachbar	None
schleifst	Second person Singular
predig	Second person Singular
Strafen	None
brems	Second person Singular
Meteorologin	None
verzweigst	Second person Singular
bequemb	Second person Singular
verfingst	Second person Singular
Bissen	None
sengest	Second person Singular
annullierest	Second person Singular
verrät	Third person Singular
hintertreib	Second person Singular
benötigst	Second person Singular
erlaub	Second person Singular
aufklären	None
Sichtgerät	None
eingeschlossen	None
Fagotte	None
Kugelschreibern	None
Austausche	None
keifest	Second person Singular
entrümpelet	Second person Plural
tüftelst	Second person Singular
bezogst	Second person Singular
klopfet	Second person Plural
emigrier	Second person Singular
deuchtest	Second person Singular
iah	Second person Singular
begnüget	Second person Plural
zechest	Second person Singular
kultivierest	Second person Singular
kriminalisierest	Second person Singular
stampfest	Second person Singular
terrorisier	Second person Singular
trödelst	Second person Singular
bedienend	None
feilet	Second person Plural
kompostierst	Second person Singular
Steigerungen	None
echauffierst	Second person Singular
digerieret	Second person Plural
entmineralisieret	Second person Plural
Bundesverbänden	None
Trompete	None
begrapschest	Second person Singular
Hippies	None
berühr	Second person Singular
Gesetzesbrecher	None
Düften	None
verbrenn	Second person Singular
Kurses	None
entspringest	Second person Singular
lullest	Second person Singular
gustieret	Second person Plural
fanatisieret	Second person Plural
demonstrieret	Second person Plural
endlagerst	Second person Singular
verzinket	Second person Plural
umhüllest	Second person Singular
Fußballspieler	None
polymerisier	Second person Singular
snöbest	Second person Singular
sättig	Second person Singular
erschießest	Second person Singular
wasserst	Second person Singular
geprobt	None
laich	Second person Singular
akzeptierst	Second person Singular
laufet	Second person Plural
Piratensenders	None
wähn	Second person Singular
knipsst	Second person Singular
gebettelt	None
knackest	Second person Singular
bräunet	Second person Plural
vertuest	Second person Singular
agierst	Second person Singular
bahnet	Second person Plural
verwirklich	Second person Singular
besseret	Second person Plural
kalfateret	Second person Plural
gebuddelt	None
Nichteisenmetall	None
genießet	Second person Plural
verlang	Second person Singular
rauf	Second person Singular
Verbot	None
Konzerthäuser	None
sabbelet	Second person Plural
diskutierst	Second person Singular
lehr	Second person Singular
verfilmet	Second person Plural
kremierst	Second person Singular
lähmet	Second person Plural
Isotopeneffekt	None
verarschest	Second person Singular
verarschet	Second person Plural
zitteret	Second person Plural
Serenade	None
föhn	Second person Singular
Boran	None
orientieret	Second person Plural
schweiget	Second person Plural
desertierest	Second person Singular
gabelst	Second person Singular
schielst	Second person Singular
Gesetzeshüter	None
improvisieret	Second person Plural
verteidig	Second person Singular
wirket	Second person Plural
Hochaltares	None
Schlittenfahrt	None
schauderst	Second person Singular
walz	Second person Singular
Organismen	None
konstatierst	Second person Singular
verschleieret	Second person Plural
Bildes	None
Managements	None
mikturieret	Second person Plural
Elixiers	None
Antifaschist	None
moppend	None
stornierst	Second person Singular
verschlacket	Second person Plural
entsagst	Second person Singular
raffinieret	Second person Plural
destillier	Second person Singular
Kranichs	None
geruh	Second person Singular
translozierst	Second person Singular
applizierst	Second person Singular
beteilig	Second person Singular
entteerst	Second person Singular
pilgerest	Second person Singular
erstarrest	Second person Singular
tauest	Second person Singular
rammest	Second person Singular
wegtolerieren	None
verstreuest	Second person Singular
mopp	Second person Singular
stürm	Second person Singular
Häretikern	None
schobst	Second person Singular
verbannet	Second person Plural
implizieret	Second person Plural
berechtig	Second person Singular
übernähmest	Second person Singular
linderst	Second person Singular
Abschweifungen	None
blichet	Second person Plural
demobilisierest	Second person Singular
Standardwerken	None
kommunizier	Second person Singular
mineralisieret	Second person Plural
blondierest	Second person Singular
Taifun	None
protegieret	Second person Plural
knall	Second person Singular
bestich	Second person Singular
quantisierst	Second person Singular
schiebst	Second person Singular
missbrauchet	Second person Plural
geiz	Second person Singular
blamieret	Second person Plural
Befragung	None
barstest	Second person Singular
kalibrieret	Second person Plural
egget	Second person Plural
beglückwünschst	Second person Singular
schellest	Second person Singular
knautschet	Second person Plural
produzierest	Second person Singular
vergasest	Second person Singular
garet	Second person Plural
entwirrest	Second person Singular
Roben	None
vermengst	Second person Singular
behaltest	Second person Singular
bestrafst	Second person Singular
beding	Second person Singular
muhst	Second person Singular
henk	Second person Singular
Tradition	None
symbolisierst	Second person Singular
kürzet	Second person Plural
verbitteret	Second person Plural
Platinoide	None
einigest	Second person Singular
möpperest	Second person Singular
garst	Second person Singular
Huso	None
erstaun	Second person Singular
vermeßet	Second person Plural
rangierest	Second person Singular
Reismehle	None
vergrübet	Second person Plural
hyperventilier	Second person Singular
Fotoapparates	None
verschlissest	Second person Singular
wiederentdeck	Second person Singular
Schülern	None
schweig	Second person Singular
Maßstab	None
ramifizierest	Second person Singular
entgleisest	Second person Singular
übersiehst	Second person Singular
banalisieret	Second person Plural
flankier	Second person Singular
Gottesdienste	None
wrangst	Second person Singular
Geisterstunde	None
chloroformierend	None
Wahlsieg	None
Fisken	None
flens	Second person Singular
bedauerest	Second person Singular
Weltmärkten	None
Schals	None
eroberst	Second person Singular
Farbpigmenten	None
geschönt	None
laberest	Second person Singular
Regenzeiten	None
Rotgültigerz	None
Selensalz	None
servier	Second person Singular
belaueret	Second person Plural
intrigierst	Second person Singular
krem	Second person Singular
Raspel	None
vertonest	Second person Singular
marterest	Second person Singular
Jagdhunden	None
tarnet	Second person Plural
säuberest	Second person Singular
Hebel	None
Gewächshäusern	None
Schaffners	None
Drehortes	None
mümmelest	Second person Singular
reifet	Second person Plural
platsch	Second person Singular
entwichst	Second person Singular
beanspruchst	Second person Singular
Infanten	None
verzögerst	Second person Singular
Stechuhren	None
Rückseiten	None
Hapaxlegomenon	None
verdirbst	Second person Singular
beschulst	Second person Singular
offenbarst	Second person Singular
Pianos	None
flackerest	Second person Singular
Herzschrittmachers	None
versauerest	Second person Singular
entzögest	Second person Singular
Brettspiel	None
erwachst	Second person Singular
enttarnest	Second person Singular
kühlet	Second person Plural
ionisier	Second person Singular
Wandteppich	None
Zirkels	None
vernachlässigest	Second person Singular
Bindungsorbitalen	None
Acetessigsäure	None
verbannst	Second person Singular
brüskierest	Second person Singular
ersparst	Second person Singular
verschreibst	Second person Singular
Verbleib	None
Förderländern	None
Feindbild	None
Kanzleramtes	None
Habitus	None
prickelet	Second person Plural
umarmst	Second person Singular
Gießereien	None
verform	Second person Singular
konzipieret	Second person Plural
rawbet	Second person Plural
Futhark	None
steigerest	Second person Singular
flöchtet	Second person Plural
erhitzet	Second person Plural
foderest	Second person Singular
zerfließest	Second person Singular
Donner	None
leih	Second person Singular
Enddarm	None
Pilzes	None
glottalisieret	Second person Plural
entkokainisierest	Second person Singular
bebst	Second person Singular
kandidier	Second person Singular
Schimäre	None
erörterst	Second person Singular
eiterst	Second person Singular
überfällt	Third person Singular
Artensterben	None
Führerhauptquartiere	None
tauchst	Second person Singular
moppst	Second person Singular
verhehl	Second person Singular
beunruhig	Second person Singular
zerkreuzst	Second person Singular
schwächelst	Second person Singular
wägest	Second person Singular
Hinblicks	None
unterschlüget	Second person Plural
wring	Second person Singular
Mahlzeiten	None
zensierst	Second person Singular
pflücket	Second person Plural
sündigest	Second person Singular
flösset	Second person Plural
gebohrt	None
erfragst	Second person Singular
Ekzeme	None
verweilet	Second person Plural
flankieret	Second person Plural
reflektierest	Second person Singular
meckerst	Second person Singular
liebäugelet	Second person Plural
Feindes	None
kröchest	Second person Singular
Büffel	None
Mittelschule	None
bölkest	Second person Singular
streust	Second person Singular
schäumst	Second person Singular
klonet	Second person Plural
vernachlässiget	Second person Plural
dehnet	Second person Plural
penetrierest	Second person Singular
drischt	Third person Singular
fei	Second person Singular
feil	Second person Singular
bestrafet	Second person Plural
Kornett	None
leeret	Second person Plural
funkelet	Second person Plural
renovierest	Second person Singular
unterdrück	Second person Singular
stippst	Second person Singular
qualmst	Second person Singular
widersprechet	Second person Plural
Zitronen	None
limitierst	Second person Singular
klönst	Second person Singular
exmatrikulierst	Second person Singular
Spielautomat	None
Kaninchens	None
profitierst	Second person Singular
entpackest	Second person Singular
Druckguss	None
füg	Second person Singular
erwarbt	Second person Plural
Knospe	None
verbrenntet	Second person Plural
krachend	None
verglühst	Second person Singular
bestellst	Second person Singular
engagierest	Second person Singular
mißling	Second person Singular
überlieferest	Second person Singular
verletzest	Second person Singular
indoktrinierest	Second person Singular
betriebest	Second person Singular
nölst	Second person Singular
Napf	None
Heizdrahtes	None
klatschet	Second person Plural
freuet	Second person Plural
Knäblein	None
gravierest	Second person Singular
Lefzen	None
Dogmatiker	None
explizier	Second person Singular
exmatrikulierest	Second person Singular
Neutronenstrahlung	None
bemüh	Second person Singular
Kerfe	None
hetz	Second person Singular
zerfließet	Second person Plural
pichelest	Second person Singular
blinzelst	Second person Singular
tappest	Second person Singular
platzierest	Second person Singular
transferier	Second person Singular
diagnostizieret	Second person Plural
futterst	Second person Singular
Alkalien	None
Piratensendern	None
verhör	Second person Singular
plumps	Second person Singular
verzauberest	Second person Singular
bevorzugst	Second person Singular
bekanntest	Second person Singular
erwirb	Second person Singular
Olivensteines	None
sperrst	Second person Singular
Abschaffung	None
arrangierst	Second person Singular
kneifet	Second person Plural
radikalisieret	Second person Plural
faschierest	Second person Singular
entwischet	Second person Plural
Drillings	None
halbierst	Second person Singular
Fingerspitzen	None
verhüllet	Second person Plural
betrag	Second person Singular
Lohnnebenkosten	None
entkommest	Second person Singular
beruhig	Second person Singular
Stumpf	None
pubertieret	Second person Plural
abalienieret	Second person Plural
schüttelest	Second person Singular
Silikon	None
vertagest	Second person Singular
adelet	Second person Plural
Handys	None
ebbest	Second person Singular
herzest	Second person Singular
kartographierst	Second person Singular
Profil	None
lik	Second person Singular
ahnet	Second person Plural
extrudier	Second person Singular
Aware	None
Mineralstoffe	None
Seidenhemd	None
vermenschlich	Second person Singular
thematisier	Second person Singular
chiffrierst	Second person Singular
vollziehst	Second person Singular
sichernd	None
Bundesgerichtshöfen	None
Beimischungen	None
balleret	Second person Plural
Bärtchen	None
replizieret	Second person Plural
vandalierst	Second person Singular
kumulierst	Second person Singular
Brandung	None
Aristokraten	None
folgerst	Second person Singular
Timeouts	None
schüttle	First person Singular
zementieret	Second person Plural
Hexacyanoferrat	None
verweiset	Second person Plural
fritierst	Second person Singular
krönet	Second person Plural
Reportes	None
entstamm	Second person Singular
Ärzteblatt	None
naschest	Second person Singular
Schmelz	None
mobbest	Second person Singular
herrschest	Second person Singular
fabulieret	Second person Plural
pack	Second person Singular
brows	Second person Singular
betreust	Second person Singular
Edukten	None
Bärendienstes	None
durchwachet	Second person Plural
malest	Second person Singular
Kontraindikationen	None
erhoffet	Second person Plural
übernehmet	Second person Plural
loderet	Second person Plural
bedauerst	Second person Singular
ackerst	Second person Singular
schwing	Second person Singular
widerständet	Second person Plural
tätowier	Second person Singular
Arsane	None
klirret	Second person Plural
investierest	Second person Singular
poppest	Second person Singular
schlenderet	Second person Plural
Hallig	None
Niederländern	None
veranschlagest	Second person Singular
rechtfertigest	Second person Singular
Bruttonationaleinkommens	None
Katastrophenschutzes	None
stiehl	Second person Singular
Lebensmittelfarbstoffen	None
ragend	None
kommunizierst	Second person Singular
penetrierst	Second person Singular
prahl	Second person Singular
batikest	Second person Singular
ängstig	Second person Singular
konvertieret	Second person Plural
Mönchen	None
orientierst	Second person Singular
rödelst	Second person Singular
kartografierest	Second person Singular
bützet	Second person Plural
emulieret	Second person Plural
vernein	Second person Singular
kneif	Second person Singular
reglementierst	Second person Singular
Aberration	None
Kartographen	None
Balgfrüchte	None
käbbelnd	None
unterziehst	Second person Singular
gurr	Second person Singular
schmeichelet	Second person Plural
Verantwortlichkeiten	None
Tagesbedarf	None
Verbunde	None
überleb	Second person Singular
entführet	Second person Plural
frappieret	Second person Plural
verwunderst	Second person Singular
zielet	Second person Plural
ernennst	Second person Singular
paginierest	Second person Singular
denaturier	Second person Singular
studier	Second person Singular
wünschest	Second person Singular
Büchse	None
bedächtest	Second person Singular
einschmeicheln	None
indizier	Second person Singular
Modultests	None
Schubkarren	None
Geburtsnamen	None
verkennet	Second person Plural
filteret	Second person Plural
zappst	Second person Singular
Eiswürfel	None
entkämet	Second person Plural
pulsierest	Second person Singular
bell	Second person Singular
Daumens	None
missling	Second person Singular
hetzest	Second person Singular
Augenfarben	None
Champignons	None
befählet	Second person Plural
entkeimet	Second person Plural
lokalisierest	Second person Singular
erfassest	Second person Singular
nominierst	Second person Singular
Jackpots	None
Adventen	None
fütterst	Second person Singular
jaulest	Second person Singular
Athlet	None
agieret	Second person Plural
knabberst	Second person Singular
fungierst	Second person Singular
wähnet	Second person Plural
Auerochse	None
empörst	Second person Singular
Entschwefelungen	None
gebrauchet	Second person Plural
schauspieleret	Second person Plural
kandidierst	Second person Singular
Kurzzeichen	None
reihet	Second person Plural
beherrschest	Second person Singular
belageret	Second person Plural
pfropf	Second person Singular
foderet	Second person Plural
negierest	Second person Singular
winket	Second person Plural
kondensierest	Second person Singular
Frösten	None
stichst	Second person Singular
regulieret	Second person Plural
unterschlag	Second person Singular
Diselan	None
Akronyms	None
fröret	Second person Plural
bestätigst	Second person Singular
zersetzet	Second person Plural
föchtet	Second person Plural
entionisieret	Second person Plural
kick	Second person Singular
konstatier	Second person Singular
regierst	Second person Singular
belassest	Second person Singular
schärfet	Second person Plural
verunglück	Second person Singular
Ölfarben	None
verirr	Second person Singular
mißlangst	Second person Singular
unterwirfst	Second person Singular
tobet	Second person Plural
Zeitbeschränkungen	None
erbarm	Second person Singular
appliziret	Second person Plural
Stop	None
ertränket	Second person Plural
gepopelt	None
bemerk	Second person Singular
grölet	Second person Plural
subtrahieret	Second person Plural
pfeifest	Second person Singular
Abhandlungen	None
geknackt	None
Migranten	None
migrier	Second person Singular
benimm	Second person Singular
fladerst	Second person Singular
boxet	Second person Plural
entfesselet	Second person Plural
hol	Second person Singular
verzauberet	Second person Plural
betratet	Second person Plural
Flugschreibers	None
borgst	Second person Singular
Polymer	None
schmunzelst	Second person Singular
Zentrifugen	None
gehenkt	None
beschleunigest	Second person Singular
füsilieret	Second person Plural
kolorierest	Second person Singular
erklangst	Second person Singular
Auftragsmörder	None
buhend	None
abreisen	None
handhab	Second person Singular
polymerisierst	Second person Singular
beunruhiget	Second person Plural
entsagest	Second person Singular
Stigmatisierung	None
paddelest	Second person Singular
Friedensprozesse	None
räumst	Second person Singular
Schobers	None
onanierest	Second person Singular
Hottentottenente	None
modernisierest	Second person Singular
protegierst	Second person Singular
scheiterst	Second person Singular
ergösset	Second person Plural
entsprich	Second person Singular
definierst	Second person Singular
Feldsalat	None
Kruste	None
form	Second person Singular
besohlst	Second person Singular
empfiehl	Second person Singular
gewünscht	None
entschleierst	Second person Singular
mogelest	Second person Singular
siedelst	Second person Singular
Pianisten	None
schimpfst	Second person Singular
schmölzet	Second person Plural
heisch	Second person Singular
Schwebfliege	None
explodierest	Second person Singular
Elektronegativität	None
schnarchest	Second person Singular
liebst	Second person Singular
murr	Second person Singular
epilieret	Second person Plural
absolvieret	Second person Plural
dressier	Second person Singular
handhabet	Second person Plural
rappet	Second person Plural
entsinnet	Second person Plural
entstandet	Second person Plural
Umwandlungspunktes	None
Oligopols	None
trällernd	None
latinisier	Second person Singular
verdürbest	Second person Singular
Schläfchen	None
schlüpf	Second person Singular
Automaten	None
untersuch	Second person Singular
nominierest	Second person Singular
trauerst	Second person Singular
verzieret	Second person Plural
Spektralbereichs	None
mahlest	Second person Singular
Seidenschwänzen	None
vertrugst	Second person Singular
grübest	Second person Singular
Trotteln	None
raset	Second person Plural
zensurier	Second person Singular
bedürft	Second person Plural
verdummst	Second person Singular
aalet	Second person Plural
gerappt	None
betrinkest	Second person Singular
sublimierst	Second person Singular
knurrest	Second person Singular
Gefechte	None
grunz	Second person Singular
genehmigest	Second person Singular
grill	Second person Singular
Pyrochlor	None
parkest	Second person Singular
verursachst	Second person Singular
Zinnwalditen	None
Sterblichkeit	None
wässeret	Second person Plural
Dränagen	None
Vermenschlichungen	None
Ackers	None
Einführungsleitfaden	None
pimpernd	None
schmeckst	Second person Singular
Scheideweg	None
abalienierst	Second person Singular
verwirrst	Second person Singular
Schönheitsfehler	None
erzwing	Second person Singular
respektierest	Second person Singular
Laubbäumen	None
Fixstern	None
Pausen	None
Verlegers	None
versterbet	Second person Plural
Senkkästen	None
Gnom	None
zerfielet	Second person Plural
ergreifet	Second person Plural
geschehet	Second person Plural
Prügeln	None
Betrieben	None
kassier	Second person Singular
Fernsehgerätes	None
raubet	Second person Plural
bewerkstelligest	Second person Singular
strömest	Second person Singular
Bleche	None
verhöhnest	Second person Singular
Manipulierung	None
neckst	Second person Singular
vermachest	Second person Singular
kachelst	Second person Singular
staubet	Second person Plural
ernüchterest	Second person Singular
beeinflusset	Second person Plural
verberget	Second person Plural
verschöbet	Second person Plural
verweigeret	Second person Plural
rankst	Second person Singular
Telefonseelsorge	None
hakest	Second person Singular
ergatterst	Second person Singular
konfiszieret	Second person Plural
gelindert	None
zitterst	Second person Singular
wandelest	Second person Singular
verneinet	Second person Plural
Viewporten	None
evangelisirst	Second person Singular
versilberst	Second person Singular
gebrauchst	Second person Singular
klopp	Second person Singular
malträtierest	Second person Singular
entionisier	Second person Singular
Yttrium-Eisengranat	None
versorg	Second person Singular
rauschest	Second person Singular
Deckungen	None
ummantelest	Second person Singular
klumpet	Second person Plural
mobb	Second person Singular
verabreichet	Second person Plural
rülpset	Second person Plural
verlernest	Second person Singular
initiierest	Second person Singular
gabelet	Second person Plural
duschest	Second person Singular
Golfplatz	None
durchsuchest	Second person Singular
Stadions	None
Narkose	None
Wepse	None
einziehend	None
verfärbet	Second person Plural
Verliese	None
duz	Second person Singular
ehelichest	Second person Singular
Fledermäuse	None
Abenteuerin	None
bluffet	Second person Plural
kritisieret	Second person Plural
geknipst	None
Type	None
kaschierest	Second person Singular
apportierst	Second person Singular
brillierst	Second person Singular
zerknitteret	Second person Plural
Parkhauses	None
Schößen	None
schmoret	Second person Plural
schmerz	Second person Singular
erweiterest	Second person Singular
Asthmamittel	None
dissoziier	Second person Singular
kokettierest	Second person Singular
veredelet	Second person Plural
meißelet	Second person Plural
gipfelet	Second person Plural
wehr	Second person Singular
Kirchenbank	None
Gebrechen	None
Informationsdienst	None
Akolyth	None
filtrier	Second person Singular
pass	Second person Singular
widerstehest	Second person Singular
entdeckst	Second person Singular
Plusquamperfekts	None
Antiguanerinnen	None
internationalisierst	Second person Singular
frottier	Second person Singular
verfüg	Second person Singular
verstärket	Second person Plural
Videospiele	None
malst	Second person Singular
ränget	Second person Plural
unterbrichst	Second person Singular
verbaselst	Second person Singular
keim	Second person Singular
bequemet	Second person Plural
Vorjahren	None
warnet	Second person Plural
bevölkerst	Second person Singular
verfinsterest	Second person Singular
partitionierst	Second person Singular
bezifferet	Second person Plural
husch	Second person Singular
Gebirgswelses	None
verwarfst	Second person Singular
komponier	Second person Singular
schnurrest	Second person Singular
beschirm	Second person Singular
tätigst	Second person Singular
ringst	Second person Singular
wechselwirkst	Second person Singular
konstatieret	Second person Plural
danket	Second person Plural
autorisier	Second person Singular
Rabatt	None
besänftiget	Second person Plural
Bilanzen	None
verdampfest	Second person Singular
Gitarrenkonzertes	None
bekämpfest	Second person Singular
bohrst	Second person Singular
hemmet	Second person Plural
studierest	Second person Singular
Eiße	None
parfümier	Second person Singular
verschreib	Second person Singular
Lymphsystem	None
empfändest	Second person Singular
regst	Second person Singular
Perlen	None
synthetisierest	Second person Singular
überreagierst	Second person Singular
verbögest	Second person Singular
rivalisieret	Second person Plural
Temperatur	None
ersetzet	Second person Plural
verseuchet	Second person Plural
verlebet	Second person Plural
protegierest	Second person Singular
Tatsache	None
Wächter	None
Gesellschaftern	None
panierest	Second person Singular
akzeptier	Second person Singular
fragmentier	Second person Singular
brillier	Second person Singular
raffinier	Second person Singular
scheißest	Second person Singular
Weltmeere	None
unterstreich	Second person Singular
Filtrates	None
krakeelest	Second person Singular
verbrennest	Second person Singular
diktieret	Second person Plural
dissest	Second person Singular
gurgelest	Second person Singular
Vorquartale	None
verklag	Second person Singular
klau	Second person Singular
verschränket	Second person Plural
Prager	None
verwaisend	None
belasset	Second person Plural
Pecannuss	None
thematisieret	Second person Plural
verlassest	Second person Singular
weidend	None
beschäftigst	Second person Singular
drapier	Second person Singular
unterschreibet	Second person Plural
entspann	Second person Singular
verschärfest	Second person Singular
schlüpfest	Second person Singular
verzinkest	Second person Singular
acetylierest	Second person Singular
behauptend	None
bedrohst	Second person Singular
überprüf	Second person Singular
verbrauch	Second person Singular
renovier	Second person Singular
zieret	Second person Plural
Badegäste	None
Lauriten	None
boomst	Second person Singular
jährest	Second person Singular
weißet	Second person Plural
Steinbrüchen	None
verscheisserst	Second person Singular
beheimatet	Second person Plural
massier	Second person Singular
Drachme	None
gegenbeschuldig	Second person Singular
steigerst	Second person Singular
griffst	Second person Singular
promovier	Second person Singular
überprüfest	Second person Singular
Kabuffe	None
Innenstadt	None
Ränge	None
Taschengeld	None
Baumhaus	None
Lutschtabletten	None
hiev	Second person Singular
säßest	Second person Singular
assoziierest	Second person Singular
Fliegenpilzes	None
beeilst	Second person Singular
sanieret	Second person Plural
Iota	None
Mütterlein	None
häkelst	Second person Singular
knibbelst	Second person Singular
bezweifelet	Second person Plural
verführ	Second person Singular
gedieht	Second person Plural
knicket	Second person Plural
kämpf	Second person Singular
dröschet	Second person Plural
Symptomen	None
expandierest	Second person Singular
Aktivist	None
verwürfest	Second person Singular
stimulierest	Second person Singular
pinkelet	Second person Plural
umhüllet	Second person Plural
wisperst	Second person Singular
Ballette	None
Herkunftslandes	None
verzink	Second person Singular
schmückst	Second person Singular
debattieret	Second person Plural
büßet	Second person Plural
Gestelle	None
beschützet	Second person Plural
grapsch	Second person Singular
erstürmest	Second person Singular
schaukelest	Second person Singular
lächelst	Second person Singular
erlagt	Second person Plural
gerinnend	None
beabsichtig	Second person Singular
wellst	Second person Singular
genölt	None
glänzet	Second person Plural
schlugst	Second person Singular
Kloakenräumer	None
betrügest	Second person Singular
wringend	None
temperier	Second person Singular
Heizleiter	None
wird	Third person Singular
stürz	Second person Singular
Angriffes	None
missverständet	Second person Plural
disziplinier	Second person Singular
befielest	Second person Singular
verweh	Second person Singular
Gestirnen	None
lähmst	Second person Singular
Zirkone	None
spreng	Second person Singular
krallet	Second person Plural
Eisbrechern	None
Rittes	None
erratest	Second person Singular
Hübe	None
Arsenolith	None
begnügst	Second person Singular
verminet	Second person Plural
keulst	Second person Singular
Silberfischchens	None
paddelet	Second person Plural
pissest	Second person Singular
Begegnungsstätte	None
Nebelgranaten	None
schwillt	Third person Singular
Vestibüls	None
industrialisier	Second person Singular
Senegalesinnen	None
ruinierst	Second person Singular
Sternenbanner	None
knitteret	Second person Plural
verbarrikadieret	Second person Plural
kenteret	Second person Plural
zerkreuzet	Second person Plural
Kopfform	None
Exzessen	None
Inspiratoren	None
vereinbar	Second person Singular
wieherst	Second person Singular
puderest	Second person Singular
entsannt	Second person Plural
Käfern	None
schwindle	First person Singular
Zufallsgrößen	None
abstrahierst	Second person Singular
belass	Second person Singular
Industrienation	None
verifizierest	Second person Singular
aufnehmend	None
entkamst	Second person Singular
Meeresboden	None
lull	Second person Singular
spekulierst	Second person Singular
sinn	Second person Singular
Wasserrallen	None
nährst	Second person Singular
stöhn	Second person Singular
avancieret	Second person Plural
Kleber	None
schimmeret	Second person Plural
Fußgehern	None
jähr	Second person Singular
subtrahier	Second person Singular
nächtig	Second person Singular
verwehrst	Second person Singular
Geschwistern	None
Hirnhautentzündung	None
ringet	Second person Plural
Behütern	None
Stapels	None
schwankst	Second person Singular
betreibst	Second person Singular
mäh	Second person Singular
requirierst	Second person Singular
sedierest	Second person Singular
erlöset	Second person Plural
Quantenpunkte	None
grenz	Second person Singular
verbauest	Second person Singular
Erdapfel	None
biwakierest	Second person Singular
riskier	Second person Singular
Einsätze	None
Attentätern	None
entließest	Second person Singular
mulch	Second person Singular
peilest	Second person Singular
belästigst	Second person Singular
verfilmest	Second person Singular
Wallachen	None
rängest	Second person Singular
käbbelet	Second person Plural
musicierest	Second person Singular
kampierest	Second person Singular
Eisbrechers	None
heck	Second person Singular
kooperierst	Second person Singular
generalisieret	Second person Plural
Herrscher	None
Kernbrennstoffes	None
gewöhn	Second person Singular
versprachst	Second person Singular
Konföderation	None
signalisier	Second person Singular
transportierest	Second person Singular
pasteurisier	Second person Singular
miaust	Second person Singular
adoptier	Second person Singular
Haushaltsgegenstände	None
entfloht	Second person Plural
erwarbst	Second person Singular
Philosophen	None
umarmet	Second person Plural
Stolpersteinen	None
Edelgase	None
vermöchtest	Second person Singular
fritierest	Second person Singular
Befehle	None
erfüllet	Second person Plural
säumet	Second person Plural
erweis	Second person Singular
Aktionspotentials	None
Versammlungen	None
zupf	Second person Singular
erläuterst	Second person Singular
konnotierest	Second person Singular
sedier	Second person Singular
Diebstählen	None
dimmst	Second person Singular
Internetanschlusses	None
Raubfisch	None
vertrüget	Second person Plural
Bergkristall	None
glosest	Second person Singular
destillieret	Second person Plural
beseelet	Second person Plural
schikanierest	Second person Singular
Gneises	None
Chelaten	None
stampfst	Second person Singular
wallfahr	Second person Singular
Kummerbunden	None
Brunnenkresse	None
Libanesen	None
dop	Second person Singular
vermenschlichet	Second person Plural
bequemst	Second person Singular
Ordinate	None
Madenhacker	None
panaschierest	Second person Singular
taust	Second person Singular
anschnallen	None
reckest	Second person Singular
ersetz	Second person Singular
vergilt	Third person Singular
Fachhochschule	None
plissieret	Second person Plural
unterlass	Second person Singular
rüg	Second person Singular
bang	Second person Singular
glänzend	None
musteret	Second person Plural
übersehest	Second person Singular
lügst	Second person Singular
verrühr	Second person Singular
pekzier	Second person Singular
Psychotikerin	None
erklingest	Second person Singular
impfest	Second person Singular
rollst	Second person Singular
kollidierest	Second person Singular
wimmelest	Second person Singular
übereilet	Second person Plural
hebet	Second person Plural
zerfließ	Second person Singular
Versammlung	None
regulier	Second person Singular
fängst	Second person Singular
beunruhigest	Second person Singular
verwechselest	Second person Singular
multiplizier	Second person Singular
hüllest	Second person Singular
Zirkelbeweises	None
postulier	Second person Singular
Inversion	None
Pyrochlore	None
Einöden	None
vererbet	Second person Plural
gewärtig	Second person Singular
vergabt	Second person Plural
Kometenschweifen	None
bestimmst	Second person Singular
ehrst	Second person Singular
schieferst	Second person Singular
hydrier	Second person Singular
bewässerest	Second person Singular
glos	Second person Singular
Espen	None
blätterest	Second person Singular
verkapselst	Second person Singular
parkierst	Second person Singular
kicheret	Second person Plural
glühet	Second person Plural
kontaminieret	Second person Plural
changieret	Second person Plural
blichest	Second person Singular
verreis	Second person Singular
Girlande	None
Fahrgestelles	None
überschwemmend	None
bedürftest	Second person Singular
käufst	Second person Singular
versieh	Second person Singular
vergehet	Second person Plural
schnapp	Second person Singular
porträtieret	Second person Plural
bestätig	Second person Singular
Treffers	None
dankst	Second person Singular
Kompositen	None
kommerzialisierend	None
veröffentlich	Second person Singular
entmisch	Second person Singular
bedenkst	Second person Singular
zirpst	Second person Singular
erkundiget	Second person Plural
stemmet	Second person Plural
konstruierest	Second person Singular
Isotops	None
unterstreichest	Second person Singular
Ökosystemen	None
schälest	Second person Singular
Sprudel	None
mixet	Second person Plural
Diener	None
entrisset	Second person Plural
seng	Second person Singular
Festkörpern	None
Biphenylen	None
erzeugest	Second person Singular
Scheiben	None
Privatpatient	None
Hühnerfleisch	None
Wandteppichs	None
Verstärkungen	None
berücksichtig	Second person Singular
Täuschung	None
zapp	Second person Singular
Kampf	None
lärm	Second person Singular
Lieferanten	None
Pressstempelkannen	None
Galaxienhaufen	None
Sezession	None
mikturier	Second person Singular
Autorität	None
strukturieret	Second person Plural
entwickelst	Second person Singular
kreier	Second person Singular
rechtfertig	Second person Singular
riebest	Second person Singular
krocht	Second person Plural
Fraktur	None
eliminier	Second person Singular
hydrolysieret	Second person Plural
reifst	Second person Singular
entionisierst	Second person Singular
tabuisier	Second person Singular
alarmieret	Second person Plural
entspannst	Second person Singular
adoptieret	Second person Plural
Schnipsel	None
vertonst	Second person Singular
glücket	Second person Plural
beheiz	Second person Singular
Verwalters	None
narr	Second person Singular
Sulfoxide	None
gratulier	Second person Singular
Frikative	None
unterhältst	Second person Singular
Koje	None
Filz	None
erlaubest	Second person Singular
Zahltag	None
kompilierest	Second person Singular
wandet	Second person Plural
turnst	Second person Singular
Plänen	None
Singhalesen	None
flöchtest	Second person Singular
verfängt	Third person Singular
vertippest	Second person Singular
strömet	Second person Plural
nähret	Second person Plural
erweckst	Second person Singular
manipulierst	Second person Singular
respektier	Second person Singular
bedürfest	Second person Singular
Abschiedsgeschenk	None
behinderst	Second person Singular
nummerierst	Second person Singular
frohlock	Second person Singular
Nitratsalze	None
dank	Second person Singular
Fundi	None
hinterleget	Second person Plural
dolmetsch	Second person Singular
verzehr	Second person Singular
Bambuswälder	None
verüb	Second person Singular
zentrier	Second person Singular
verbaselet	Second person Plural
Morgenlatten	None
belästigest	Second person Singular
zoff	Second person Singular
überwieset	Second person Plural
Auswertung	None
diktierest	Second person Singular
camouflierst	Second person Singular
glaubet	Second person Plural
Kolbeckit	None
Berufsschulen	None
Delikte	None
desinfizierst	Second person Singular
dampfst	Second person Singular
Macker	None
Anzweifelungen	None
Anwendungsgebiete	None
Philippiners	None
schwärmest	Second person Singular
einstellen	None
Sieb	None
mutmaßet	Second person Plural
kullerst	Second person Singular
abgespielt	None
erlagst	Second person Singular
unterjoch	Second person Singular
Faust	None
empfändet	Second person Plural
Sparpaket	None
Gesamtgröße	None
flehet	Second person Plural
diagnostizierest	Second person Singular
Energiezustands	None
Zufälle	None
schwächelest	Second person Singular
Intrusivgesteinen	None
Neutronenüberschüsse	None
Geburtsnamens	None
maximier	Second person Singular
putsch	Second person Singular
gelier	Second person Singular
philosophierst	Second person Singular
fühlst	Second person Singular
markieret	Second person Plural
peroxidierst	Second person Singular
erfreuest	Second person Singular
begräbst	Second person Singular
entlaubet	Second person Plural
Verbandsgemeinde	None
schnorret	Second person Plural
vertrittst	Second person Singular
simset	Second person Plural
paar	Second person Singular
kitzelet	Second person Plural
lauschest	Second person Singular
Ausschläge	None
Zelthering	None
werweiss	Second person Singular
Trotzkist	None
fotz	Second person Singular
ertrinket	Second person Plural
produzier	Second person Singular
abandonnier	Second person Singular
blicht	Second person Plural
Schweinepriestern	None
liebäugelest	Second person Singular
Inhaltsstoff	None
paddelst	Second person Singular
kontaminierst	Second person Singular
schimpfest	Second person Singular
Rasens	None
schuppst	Second person Singular
boßst	Second person Singular
Idealist	None
radier	Second person Singular
studierst	Second person Singular
harnest	Second person Singular
schmerzet	Second person Plural
hungerst	Second person Singular
zack	Second person Singular
Achse	None
blondierst	Second person Singular
Höchststände	None
Bebauungsplänen	None
erblasset	Second person Plural
empfängt	Third person Singular
Trespe	None
verbrächest	Second person Singular
rüget	Second person Plural
verewig	Second person Singular
bezichtig	Second person Singular
Emirs	None
Blumenhändler	None
flick	Second person Singular
Beiwort	None
diffamierst	Second person Singular
antichambrierst	Second person Singular
Isotopenaustauschen	None
fließest	Second person Singular
Erdgeschoß	None
glasierest	Second person Singular
evangelisirest	Second person Singular
Schnittlauch	None
Stromnetz	None
thuet	Second person Plural
kompostier	Second person Singular
kitzelest	Second person Singular
Nitride	None
Bolzplätzen	None
differenzier	Second person Singular
erwischet	Second person Plural
vermiss	Second person Singular
wurzelet	Second person Plural
falzest	Second person Singular
harr	Second person Singular
Lupen	None
pfeifet	Second person Plural
Gateway	None
wunderest	Second person Singular
minderst	Second person Singular
sautier	Second person Singular
löset	Second person Plural
verbarrikadierst	Second person Singular
unterschreibst	Second person Singular
bezwingest	Second person Singular
bezögest	Second person Singular
statuieret	Second person Plural
nanntest	Second person Singular
replicier	Second person Singular
aufsuchen	None
schmierest	Second person Singular
Butterblumen	None
zerbrächet	Second person Plural
Nanosatelliten	None
Heulers	None
ondulier	Second person Singular
Riesenwildschafes	None
pochet	Second person Plural
Attentat	None
befällt	Third person Singular
heischst	Second person Singular
Gänseblümchen	None
Isoglossen	None
befestig	Second person Singular
verkenntest	Second person Singular
Grube	None
festgestellt	None
Schwemmen	None
türmest	Second person Singular
scheiß	Second person Singular
emulierst	Second person Singular
wurdest	Second person Singular
kribbelnd	None
wank	Second person Singular
Zahlen	None
verton	Second person Singular
verschiebet	Second person Plural
amputier	Second person Singular
Morgenkaffee	None
Schutzblech	None
Gitarrenspieler	None
versteigeret	Second person Plural
saufest	Second person Singular
Wohnzimmers	None
Vorstellungsgespräch	None
nebelst	Second person Singular
kanalisierst	Second person Singular
Laufes	None
vergräbt	Third person Singular
prognostizier	Second person Singular
formst	Second person Singular
verbrachst	Second person Singular
marinieret	Second person Plural
Archipele	None
gedenkst	Second person Singular
flupp	Second person Singular
unterjochst	Second person Singular
Atrien	None
nächtiget	Second person Plural
coventrisieret	Second person Plural
vernahmst	Second person Singular
greifest	Second person Singular
Orden	None
zerbrechet	Second person Plural
Fundorte	None
Maßband	None
Blauwal	None
Hufes	None
Arbeitsbereichen	None
bedrücket	Second person Plural
enttarnet	Second person Plural
schlurf	Second person Singular
Rothaarige	None
Zahnfleischentzündungen	None
berechtiget	Second person Plural
kombinier	Second person Singular
bahnest	Second person Singular
schauspielerst	Second person Singular
ertrankt	Second person Plural
formet	Second person Plural
Nahverkehre	None
impf	Second person Singular
Orchidee	None
schütz	Second person Singular
Plakette	None
Unterseeboot	None
kupieret	Second person Plural
versicherest	Second person Singular
antichambrierest	Second person Singular
oktroyieret	Second person Plural
Joint	None
konnotierst	Second person Singular
fungier	Second person Singular
paginierst	Second person Singular
fachet	Second person Plural
meckerest	Second person Singular
fokussierest	Second person Singular
tauchet	Second person Plural
koagulierst	Second person Singular
bewehrest	Second person Singular
Präventionen	None
Wirbeltieres	None
Aggregate	None
quasselet	Second person Plural
komprimierst	Second person Singular
Verdrehung	None
überfischet	Second person Plural
trommelst	Second person Singular
wag	Second person Singular
Sonnenblumenkerne	None
blubberet	Second person Plural
Arbeitsfelder	None
Präsidentschaftskandidat	None
offenbarest	Second person Singular
Dielektrikums	None
schmier	Second person Singular
Prothese	None
leak	Second person Singular
widersprich	Second person Singular
spreiz	Second person Singular
beeindruckend	None
defragmentierst	Second person Singular
entschliefest	Second person Singular
erhoffst	Second person Singular
koproduzierest	Second person Singular
geplaudert	None
klingst	Second person Singular
vertuschst	Second person Singular
inszenieret	Second person Plural
schön	Second person Singular
durftest	Second person Singular
blink	Second person Singular
wichs	Second person Singular
defilieret	Second person Plural
separierst	Second person Singular
schluckst	Second person Singular
spähst	Second person Singular
hasch	Second person Singular
zermatschst	Second person Singular
verursachend	None
Buntspecht	None
bummelet	Second person Plural
Pennys	None
prägst	Second person Singular
betriebst	Second person Singular
mischst	Second person Singular
Diskurs	None
Internetanschlüssen	None
koppelst	Second person Singular
verscheißerst	Second person Singular
ersuchet	Second person Plural
Energiequelle	None
fluorier	Second person Singular
döset	Second person Plural
schmilz	Second person Singular
Sprachkursen	None
rag	Second person Singular
schwirr	Second person Singular
überschätz	Second person Singular
Nasalen	None
Kunstspringen	None
verscheuchst	Second person Singular
besäßest	Second person Singular
schlügest	Second person Singular
Triglyceriden	None
behalft	Second person Plural
Kerosins	None
missverstandest	Second person Singular
zerdepperet	Second person Plural
verdank	Second person Singular
Standpauken	None
promotieret	Second person Plural
kapitulierst	Second person Singular
thust	Second person Singular
klopfest	Second person Singular
gelangt	Second person Plural
pürier	Second person Singular
kreuzig	Second person Singular
picknicket	Second person Plural
Nerzen	None
nutz	Second person Singular
begrabschest	Second person Singular
crèm	Second person Singular
regelest	Second person Singular
Zentren	None
Gauners	None
Geschmack	None
foppest	Second person Singular
bölkst	Second person Singular
trotzet	Second person Plural
erreget	Second person Plural
erfandet	Second person Plural
solidarisieret	Second person Plural
maloch	Second person Singular
schubset	Second person Plural
kasernier	Second person Singular
frittier	Second person Singular
betonierst	Second person Singular
Kinderschänders	None
dinierest	Second person Singular
folgest	Second person Singular
Komodowarans	None
Apparate	None
verfliegest	Second person Singular
Piratensender	None
evangelisierest	Second person Singular
Polarfuchs	None
bemerkst	Second person Singular
Trägergas	None
durchzucket	Second person Plural
Bundesräte	None
entgleiset	Second person Plural
hoppelet	Second person Plural
Diaphragma	None
Gebiete	None
kränket	Second person Plural
ondulierest	Second person Singular
Speisenbereiche	None
besinnst	Second person Singular
kalibrierst	Second person Singular
Silberfäden	None
Sekundenschlafes	None
Hafenbeckens	None
vertippet	Second person Plural
verhängst	Second person Singular
schlagend	None
verübest	Second person Singular
gemästet	None
glupschest	Second person Singular
fas	Second person Singular
Funktionen	None
harmonierst	Second person Singular
vergrößeret	Second person Plural
Bremskraft	None
addier	Second person Singular
möblier	Second person Singular
abbremsen	None
beklag	Second person Singular
schmückest	Second person Singular
isomerisierst	Second person Singular
Energieverbrauch	None
klassifizierest	Second person Singular
Hotelgast	None
überstehst	Second person Singular
ruderet	Second person Plural
disziplinieret	Second person Plural
unterschätz	Second person Singular
aufgesucht	None
Depeschen	None
malochest	Second person Singular
weiß	Second person Singular
schleiß	Second person Singular
frort	Second person Plural
dämmst	Second person Singular
stürzest	Second person Singular
steiget	Second person Plural
Nitrate	None
Schnellspanner	None
Trommelrallen	None
kriechst	Second person Singular
urteil	Second person Singular
doublieret	Second person Plural
Schlupfwinkel	None
lehnst	Second person Singular
korrigierest	Second person Singular
faulenz	Second person Singular
producier	Second person Singular
amputierest	Second person Singular
fachst	Second person Singular
Begrenzung	None
Währung	None
Ventils	None
bemutterest	Second person Singular
versklavst	Second person Singular
Holunders	None
formatierst	Second person Singular
Robustheit	None
Taschenlampe	None
Herstellungsverfahren	None
instanziierst	Second person Singular
zackst	Second person Singular
Ozoniden	None
schlosserst	Second person Singular
peinigest	Second person Singular
rülps	Second person Singular
mißverstandet	Second person Plural
Elektroingenieur	None
konstruierst	Second person Singular
parkst	Second person Singular
verstecket	Second person Plural
Kreissäge	None
messet	Second person Plural
frier	Second person Singular
nähr	Second person Singular
hyperventilierst	Second person Singular
wrangt	Second person Plural
Beilen	None
Frühschoppen	None
Neurosen	None
Uhrenfeder	None
Winters	None
regenerierst	Second person Singular
versänkest	Second person Singular
polymerisieret	Second person Plural
geschähet	Second person Plural
Rezeptes	None
desoxidierest	Second person Singular
neutralisierest	Second person Singular
besprechest	Second person Singular
sehnend	None
Prachtstraßen	None
explodier	Second person Singular
krös	Second person Singular
behebest	Second person Singular
schnüffelest	Second person Singular
zerdepperst	Second person Singular
verweigerst	Second person Singular
googelst	Second person Singular
balkanisierest	Second person Singular
geölt	None
frohlocket	Second person Plural
philosophier	Second person Singular
verzweifelst	Second person Singular
lammet	Second person Plural
witzelest	Second person Singular
prophezeiest	Second person Singular
unterforderet	Second person Plural
überwältigst	Second person Singular
getrieben	None
Töpfern	None
notier	Second person Singular
Antithesen	None
verwehr	Second person Singular
tippest	Second person Singular
stockst	Second person Singular
Kittchen	None
Stellungen	None
Abfälle	None
sattelet	Second person Plural
überquerest	Second person Singular
kämet	Second person Plural
Köchin	None
holperet	Second person Plural
demütiget	Second person Plural
vermittelest	Second person Singular
erkling	Second person Singular
entlädst	Second person Singular
grassier	Second person Singular
konfigurier	Second person Singular
verweisest	Second person Singular
beschirmest	Second person Singular
hasset	Second person Plural
gegenbeschuldiget	Second person Plural
kartographier	Second person Singular
deklarieret	Second person Plural
entsag	Second person Singular
Tatsachen	None
Ausbaues	None
Peroxidradikal	None
entgeh	Second person Singular
huschest	Second person Singular
empfiehlst	Second person Singular
rumalbererst	Second person Singular
Rangierbahnhofes	None
regelet	Second person Plural
quälet	Second person Plural
verleihet	Second person Plural
Mittwochmittag	None
bekämpf	Second person Singular
Fängen	None
mißtraust	Second person Singular
Gewichtseinheiten	None
schädigest	Second person Singular
verließet	Second person Plural
erkläret	Second person Plural
behöbest	Second person Singular
plauderet	Second person Plural
begünstiget	Second person Plural
krösest	Second person Singular
manipulierend	None
saunierest	Second person Singular
Nierenstein	None
schälet	Second person Plural
antichambrieret	Second person Plural
schmaus	Second person Singular
leimest	Second person Singular
vernickelet	Second person Plural
Kochtopfes	None
zagst	Second person Singular
watschelst	Second person Singular
schmetteret	Second person Plural
Warzenschweine	None
betrittst	Second person Singular
tratsch	Second person Singular
bevorzug	Second person Singular
Alkoholikern	None
projicier	Second person Singular
romantisieret	Second person Plural
kabbelest	Second person Singular
solidarisierest	Second person Singular
knurr	Second person Singular
widerrufest	Second person Singular
fieberet	Second person Plural
fauch	Second person Singular
grüßest	Second person Singular
Silbergeschirre	None
Nasiräer	None
preiset	Second person Plural
balancierst	Second person Singular
Thingen	None
Rebstöcken	None
bedürftet	Second person Plural
Apotheker	None
revanchierest	Second person Singular
lös	Second person Singular
Bekanntschaft	None
harrst	Second person Singular
surfet	Second person Plural
offerieret	Second person Plural
Gote	None
ahn	Second person Singular
Dynamits	None
winkst	Second person Singular
Weißflügelpinguinen	None
rühr	Second person Singular
Arbeitsmarkt	None
Walross	None
crem	Second person Singular
plädierest	Second person Singular
Langeweile	None
entsetz	Second person Singular
Diakonien	None
Schreinereien	None
revoltieret	Second person Plural
Gruss	None
stopp	Second person Singular
versiehst	Second person Singular
bierst	Second person Singular
schleichst	Second person Singular
hocket	Second person Plural
dirigieret	Second person Plural
hehlst	Second person Singular
wringet	Second person Plural
Assemblersprache	None
mailst	Second person Singular
Spalte	None
diversifizierst	Second person Singular
geglitten	None
Salmen	None
verringeret	Second person Plural
erstell	Second person Singular
jaget	Second person Plural
Mollusken	None
stopf	Second person Singular
schäumest	Second person Singular
schwort	Second person Plural
Golferin	None
Honorars	None
Durchsuchungsbefehles	None
Vorbaus	None
Mengen	None
Halbbluts	None
Jüngern	None
Ziegenmelkern	None
Hautfetts	None
knutsch	Second person Singular
keimest	Second person Singular
bewahr	Second person Singular
flutschst	Second person Singular
belagerst	Second person Singular
knuddelst	Second person Singular
geschritten	None
Lanthanoiden	None
erliegst	Second person Singular
drängst	Second person Singular
schauspieler	Second person Singular
Pirols	None
murrst	Second person Singular
gelob	Second person Singular
Kamerunern	None
prahlet	Second person Plural
halbieret	Second person Plural
dublierst	Second person Singular
entleerest	Second person Singular
scannet	Second person Plural
Lügnern	None
Knochenschwund	None
justierst	Second person Singular
übergäbet	Second person Plural
polarisierst	Second person Singular
rappst	Second person Singular
Staubblattes	None
nervst	Second person Singular
überqueret	Second person Plural
zügelst	Second person Singular
unterlassest	Second person Singular
verschlepp	Second person Singular
eierst	Second person Singular
überrasch	Second person Singular
galvanisierst	Second person Singular
rechtfertigst	Second person Singular
beeinträchtigst	Second person Singular
desensibilisierst	Second person Singular
muffst	Second person Singular
avancierest	Second person Singular
zischst	Second person Singular
streich	Second person Singular
Bratapfel	None
Donnerstagabends	None
erübrigst	Second person Singular
bemächtigest	Second person Singular
zerkleinerst	Second person Singular
Seeadler	None
verspielet	Second person Plural
Braunstein	None
aufstellen	None
Schneekanone	None
zerbrich	Second person Singular
verknüpf	Second person Singular
Ellipsoiden	None
harrest	Second person Singular
Bogenfenster	None
verschleppest	Second person Singular
lehn	Second person Singular
mikturierest	Second person Singular
glotz	Second person Singular
behältst	Second person Singular
Steges	None
laueret	Second person Plural
Kongressen	None
entkommst	Second person Singular
fangt	Second person Plural
duckmäuserest	Second person Singular
Kartograf	None
unterwarfst	Second person Singular
beträtet	Second person Plural
Staatsbürgerschaften	None
ramponier	Second person Singular
entheiliget	Second person Plural
erzwänget	Second person Plural
negierst	Second person Singular
assistier	Second person Singular
verleih	Second person Singular
droh	Second person Singular
Landräten	None
fönet	Second person Plural
murks	Second person Singular
besserst	Second person Singular
Hingaben	None
querst	Second person Singular
erwachet	Second person Plural
erhöhst	Second person Singular
Herkünften	None
tratschet	Second person Plural
Auszählungen	None
Erzkanzlers	None
beschaffet	Second person Plural
Treppen	None
prahlst	Second person Singular
revanchierst	Second person Singular
Fachkrankenschwestern	None
pennst	Second person Singular
Zwergpinguin	None
rhodinierst	Second person Singular
Fügung	None
strapazier	Second person Singular
befiehl	Second person Singular
Hälmchens	None
Spur	None
Fasson	None
Amokläufe	None
witterest	Second person Singular
beständest	Second person Singular
rationier	Second person Singular
divergierest	Second person Singular
aalst	Second person Singular
sauft	Second person Plural
Triselanen	None
verschlimmbesseret	Second person Plural
verlasset	Second person Plural
rollet	Second person Plural
verlernst	Second person Singular
erweiterst	Second person Singular
ertrankst	Second person Singular
staubsauget	Second person Plural
verseif	Second person Singular
Schlamm	None
rallet	Second person Plural
Sinneswandels	None
löffelet	Second person Plural
Biwaksack	None
Laptop	None
kullerest	Second person Singular
iahest	Second person Singular
erstehet	Second person Plural
betätigest	Second person Singular
schlosseret	Second person Plural
schworst	Second person Singular
chargieret	Second person Plural
globalisieret	Second person Plural
betrübet	Second person Plural
dräng	Second person Singular
übertreibest	Second person Singular
Silicat	None
Leseköpfen	None
verklagst	Second person Singular
frottierst	Second person Singular
Weißblechen	None
zwinget	Second person Plural
rödelest	Second person Singular
producierend	None
Querulanten	None
Spielfeld	None
Herbstwinde	None
pilgerst	Second person Singular
fliehend	None
orientierest	Second person Singular
Zugabe	None
Überlegung	None
vergingst	Second person Singular
verbuch	Second person Singular
lispelet	Second person Plural
schwafelest	Second person Singular
unternimmst	Second person Singular
verlock	Second person Singular
Seifenoper	None
ermöglich	Second person Singular
bewirbst	Second person Singular
bück	Second person Singular
fusionier	Second person Singular
Aufmerksamkeiten	None
trommelest	Second person Singular
aufatmen	None
Halsketten	None
gefrorst	Second person Singular
antizipierst	Second person Singular
Betonzusatzstoffe	None
schminkst	Second person Singular
rückst	Second person Singular
verallgemeinerest	Second person Singular
degustierest	Second person Singular
beabsichtigst	Second person Singular
überfallest	Second person Singular
milderet	Second person Plural
bröselst	Second person Singular
quellest	Second person Singular
veröffentlichet	Second person Plural
einteilen	None
bestätiget	Second person Plural
heylest	Second person Singular
imitier	Second person Singular
Zwiebelsuppe	None
besticket	Second person Plural
knirschest	Second person Singular
besprächest	Second person Singular
Tetragonen	None
Verbindungshalbleiter	None
knuffet	Second person Plural
pfeif	Second person Singular
zuppst	Second person Singular
beurteilst	Second person Singular
kläret	Second person Plural
Zusammenbruch	None
Tapiren	None
fluorierest	Second person Singular
langweilet	Second person Plural
garest	Second person Singular
Redakteurinnen	None
Befehles	None
erhobst	Second person Singular
kau	Second person Singular
Creuze	None
treibet	Second person Plural
köpfst	Second person Singular
perforieret	Second person Plural
benetzest	Second person Singular
Birkhühner	None
begrubst	Second person Singular
Felsen	None
griffet	Second person Plural
Barone	None
verjüngst	Second person Singular
verjagest	Second person Singular
pochier	Second person Singular
verfärbest	Second person Singular
stiegest	Second person Singular
Äquators	None
Schwiegersöhnen	None
pendelst	Second person Singular
Verfügbarkeiten	None
planschst	Second person Singular
entsprechest	Second person Singular
Hummel	None
Zeitstempel	None
kuckst	Second person Singular
verfassest	Second person Singular
privilegieret	Second person Plural
Hydroxyketonen	None
verewigst	Second person Singular
Cocktails	None
verbiegst	Second person Singular
gelinget	Second person Plural
wehst	Second person Singular
Nützlichkeit	None
empfang	Second person Singular
buchstabierst	Second person Singular
schwändest	Second person Singular
Pflaume	None
unterließest	Second person Singular
liier	Second person Singular
spür	Second person Singular
expandier	Second person Singular
verschworst	Second person Singular
legierest	Second person Singular
verwarft	Second person Plural
magnetisieret	Second person Plural
plagiierst	Second person Singular
legalisier	Second person Singular
boßet	Second person Plural
Temperamente	None
Maschinengewehre	None
schlüpfet	Second person Plural
verewigest	Second person Singular
stützst	Second person Singular
mailet	Second person Plural
packst	Second person Singular
brühest	Second person Singular
erfandest	Second person Singular
Überweisung	None
gerbest	Second person Singular
entblößst	Second person Singular
Absinthe	None
umarmest	Second person Singular
widerspricht	Third person Singular
entschließest	Second person Singular
Entkommen	None
puddelet	Second person Plural
mißverständest	Second person Singular
sponseret	Second person Plural
eskalier	Second person Singular
Fahndern	None
Propanolen	None
erschienest	Second person Singular
pfropfet	Second person Plural
Mathematiker	None
verschaff	Second person Singular
packet	Second person Plural
stamm	Second person Singular
Eroberungszüge	None
verwehst	Second person Singular
Empfängers	None
Verlöbnis	None
dividierst	Second person Singular
musizieret	Second person Plural
verhöhnst	Second person Singular
Flaschenöffner	None
spazierest	Second person Singular
Gebärmutterschleimhäuten	None
mischet	Second person Plural
vergräbst	Second person Singular
sättigst	Second person Singular
Drehung	None
stimulierst	Second person Singular
rinn	Second person Singular
schmuggelst	Second person Singular
bandagierest	Second person Singular
schwätz	Second person Singular
Tetraoxiden	None
Kantine	None
Lustknaben	None
Extremums	None
kackst	Second person Singular
finanzieret	Second person Plural
vollzöget	Second person Plural
stocherst	Second person Singular
rupfest	Second person Singular
Mäusebussarden	None
Gesamtverbands	None
instituieret	Second person Plural
geschieht	Third person Singular
schluchz	Second person Singular
banalisier	Second person Singular
entwerfest	Second person Singular
Wasserquelle	None
Schlachtfelder	None
peil	Second person Singular
errichtend	None
schwenket	Second person Plural
Vorboten	None
Geruchssinn	None
Erzfeind	None
hehl	Second person Singular
argumentierst	Second person Singular
platschet	Second person Plural
entteer	Second person Singular
halogenierst	Second person Singular
Korollar	None
Kreuzfahrtschiffen	None
bekämpfst	Second person Singular
betrankst	Second person Singular
verschwiegt	Second person Plural
berechtigst	Second person Singular
kaperet	Second person Plural
regenerieret	Second person Plural
gebrauch	Second person Singular
erschaffst	Second person Singular
siezet	Second person Plural
Adhäsion	None
schellst	Second person Singular
spannest	Second person Singular
Barsche	None
Tausches	None
revidieret	Second person Plural
Arsenite	None
evangelisir	Second person Singular
nummerier	Second person Singular
crèmend	None
erkundigest	Second person Singular
Reduktionsmittel	None
Hauptwurzel	None
platzieret	Second person Plural
Image	None
hyperventilierest	Second person Singular
Hummeln	None
erklär	Second person Singular
Geschirrspüler	None
bepflanzet	Second person Plural
Puters	None
fühlet	Second person Plural
Domizilen	None
Reiherenten	None
gelänget	Second person Plural
zoom	Second person Singular
erlisch	Second person Singular
Vorzug	None
bezahlest	Second person Singular
zerknitterst	Second person Singular
Vormünder	None
toppest	Second person Singular
mobbst	Second person Singular
Reststoffe	None
beruhigest	Second person Singular
degustier	Second person Singular
vermin	Second person Singular
applizieret	Second person Plural
katapultier	Second person Singular
schweb	Second person Singular
Erbtanten	None
entfachst	Second person Singular
traumatisieret	Second person Plural
revoltier	Second person Singular
ballerst	Second person Singular
schwärest	Second person Singular
verlüdet	Second person Plural
Ionen	None
stagnier	Second person Singular
Hautkontakt	None
reibet	Second person Plural
variier	Second person Singular
verzeigest	Second person Singular
ramponierst	Second person Singular
scheuch	Second person Singular
füsilierst	Second person Singular
personifizierest	Second person Singular
Hypochlorit	None
hupst	Second person Singular
frühstücket	Second person Plural
schnatterst	Second person Singular
Einwirkung	None
coventrisierst	Second person Singular
Manganhalogenid	None
Anhaltspunkte	None
beleidigest	Second person Singular
bedruckst	Second person Singular
touchier	Second person Singular
sterilisier	Second person Singular
mampf	Second person Singular
Fensterscheibe	None
erschüfest	Second person Singular
verhehlest	Second person Singular
Plusquamperfekt	None
entmutigst	Second person Singular
verunglückest	Second person Singular
gehörst	Second person Singular
Motorboote	None
Pertechnetaten	None
schwänzest	Second person Singular
welket	Second person Plural
Jünglinges	None
verhängest	Second person Singular
verdummet	Second person Plural
Dichten	None
wascht	Second person Plural
Rubeln	None
subventionierest	Second person Singular
marschieret	Second person Plural
föhnst	Second person Singular
ignorierest	Second person Singular
Selendefizit	None
flössest	Second person Singular
beam	Second person Singular
kenterest	Second person Singular
sengst	Second person Singular
geschluckt	None
exportier	Second person Singular
stahlt	Second person Plural
vertuschet	Second person Plural
erschient	Second person Plural
hassest	Second person Singular
fesselet	Second person Plural
schwächst	Second person Singular
bezifferst	Second person Singular
Kaisertum	None
befestigest	Second person Singular
komplexieret	Second person Plural
Bemühungen	None
Genehmigungen	None
erstellst	Second person Singular
verlädt	Third person Singular
applizier	Second person Singular
nominieret	Second person Plural
prostituierest	Second person Singular
Rotwein	None
Leime	None
riskierest	Second person Singular
spuck	Second person Singular
Kapellen	None
Grundzustanden	None
dienst	Second person Singular
diffundierest	Second person Singular
entziehst	Second person Singular
abgehoben	None
zerfall	Second person Singular
verpuffet	Second person Plural
misshandelst	Second person Singular
angetrieben	None
erwärm	Second person Singular
säumst	Second person Singular
erholest	Second person Singular
kürzest	Second person Singular
Fremdwort	None
erziehst	Second person Singular
querest	Second person Singular
vertätet	Second person Plural
steueret	Second person Plural
fraternisierst	Second person Singular
mahn	Second person Singular
durftet	Second person Plural
halogenierend	None
versperrest	Second person Singular
marodierest	Second person Singular
zentrifugierest	Second person Singular
Kurzgeschichte	None
Albtraums	None
initialisieret	Second person Plural
entzifferest	Second person Singular
Gesetzgebers	None
Telegramme	None
Zilpzalpen	None
verschlimmerest	Second person Singular
grauset	Second person Plural
kühlest	Second person Singular
horchst	Second person Singular
wilderet	Second person Plural
Krampfanfälle	None
standardisierend	None
ramm	Second person Singular
erteil	Second person Singular
Hadron	None
verträgt	Third person Singular
inaktivierst	Second person Singular
kremet	Second person Plural
schnäuzet	Second person Plural
Fragebögen	None
empfiehlt	Third person Singular
zekratzest	Second person Singular
beschimpfst	Second person Singular
verbergest	Second person Singular
süsset	Second person Plural
holet	Second person Plural
Metallwerts	None
verdankst	Second person Singular
Fluiden	None
Abhandlung	None
filterst	Second person Singular
paginieret	Second person Plural
faulenzest	Second person Singular
klatschest	Second person Singular
bejag	Second person Singular
schwiegt	Second person Plural
stationieret	Second person Plural
Beerenauslese	None
ersteigerest	Second person Singular
erkanntest	Second person Singular
rhodinieret	Second person Plural
strafet	Second person Plural
beäugest	Second person Singular
Ausdehnung	None
funktionieret	Second person Plural
erbest	Second person Singular
Kettenblättern	None
gewärtiget	Second person Plural
haderst	Second person Singular
erwärmest	Second person Singular
entpack	Second person Singular
Bildungsromans	None
Magneteisenerzen	None
schröpfet	Second person Plural
Lebenskräften	None
Maate	None
Cortison	None
teeret	Second person Plural
Totems	None
funktionalisierest	Second person Singular
entwirft	Third person Singular
ernennest	Second person Singular
entthronst	Second person Singular
Siliciumhalogenid	None
verscheisserest	Second person Singular
ras	Second person Singular
errät	Third person Singular
flatteret	Second person Plural
misshandelest	Second person Singular
berücksichtigst	Second person Singular
diskutierest	Second person Singular
Kreislauf	None
zerfaserest	Second person Singular
Wespe	None
Fabrikant	None
beliefet	Second person Plural
vertreibst	Second person Singular
verwanzest	Second person Singular
duschst	Second person Singular
illustrieret	Second person Plural
peilet	Second person Plural
wanket	Second person Plural
Silberbarren	None
versäumest	Second person Singular
vollziehet	Second person Plural
lauerest	Second person Singular
defenestrieret	Second person Plural
rauch	Second person Singular
stapfest	Second person Singular
wink	Second person Singular
veranschlag	Second person Singular
stöhnet	Second person Plural
separier	Second person Singular
kristallisierst	Second person Singular
Muster	None
dring	Second person Singular
beschwindelst	Second person Singular
vergewaltigest	Second person Singular
Außenbordeinsätze	None
verschlingest	Second person Singular
suspendienieret	Second person Plural
winselst	Second person Singular
dotierst	Second person Singular
Silbermöwen	None
verdirbt	Third person Singular
arrivierst	Second person Singular
warft	Second person Plural
grunzest	Second person Singular
riebet	Second person Plural
Haltungen	None
Permanganats	None
bekennend	None
erschließ	Second person Singular
disziplinierst	Second person Singular
Gefäßwände	None
eggest	Second person Singular
Urologen	None
erhellet	Second person Plural
klicket	Second person Plural
Singapurer	None
spionier	Second person Singular
flatterest	Second person Singular
verwandelnd	None
folteret	Second person Plural
drill	Second person Singular
kategorisier	Second person Singular
Debüt	None
reüssierest	Second person Singular
Entfernen	None
fritieret	Second person Plural
Strukturelement	None
zerreiß	Second person Singular
fokussierst	Second person Singular
schwafelst	Second person Singular
industrialisierst	Second person Singular
Autositzbezügen	None
weißest	Second person Singular
bewirb	Second person Singular
schmusest	Second person Singular
Molekülorbitale	None
Scheibchen	None
personifizier	Second person Singular
brillieret	Second person Plural
untermauerest	Second person Singular
übernimmt	Third person Singular
Leim	None
Ration	None
Schwanz	None
rennst	Second person Singular
schädiget	Second person Plural
glorifizieret	Second person Plural
wälz	Second person Singular
registrierest	Second person Singular
Ersatzstoffe	None
erzwangst	Second person Singular
registrier	Second person Singular
untersuchet	Second person Plural
skizzierst	Second person Singular
weihst	Second person Singular
grapschst	Second person Singular
Wasserstoffmoleküls	None
Basars	None
zensurierst	Second person Singular
Verfassungsgerichte	None
vulkanisierst	Second person Singular
erschöpfet	Second person Plural
Wünsche	None
Chemikers	None
skypet	Second person Plural
Scheich	None
entblößest	Second person Singular
röntgend	None
hup	Second person Singular
Sylphen	None
pellet	Second person Plural
lavier	Second person Singular
schmiedend	None
gältet	Second person Plural
narrest	Second person Singular
jammeret	Second person Plural
dekompilierest	Second person Singular
importierst	Second person Singular
welkst	Second person Singular
Feinstruktur	None
beheimat	Second person Singular
dealest	Second person Singular
Dreckkerls	None
befestigst	Second person Singular
Hagedorn	None
reparieret	Second person Plural
Korridor	None
bescheret	Second person Plural
Marktplatzes	None
Honigdachse	None
akkreditierst	Second person Singular
scannest	Second person Singular
Komponente	None
kreißet	Second person Plural
Stadtteile	None
erstaunet	Second person Plural
entspracht	Second person Plural
Grundbesitzers	None
Diplomingenieurin	None
besichtigest	Second person Singular
Blutzeugen	None
Kapitäne	None
orgelet	Second person Plural
pump	Second person Singular
Chloraromaten	None
brausest	Second person Singular
beschönigest	Second person Singular
nützest	Second person Singular
deponieret	Second person Plural
würg	Second person Singular
erhellst	Second person Singular
Rohstoffe	None
Kindergeld	None
experimentier	Second person Singular
perfektionieret	Second person Plural
Rückeroberung	None
zerquetschet	Second person Plural
Haussuchung	None
bastelest	Second person Singular
zertifizier	Second person Singular
zementierst	Second person Singular
verwandelest	Second person Singular
bedanket	Second person Plural
aufgestellt	None
Taubnessel	None
Kirschen	None
verfügest	Second person Singular
fluktuierst	Second person Singular
knuddelet	Second person Plural
sezieret	Second person Plural
bahn	Second person Singular
wechselwirket	Second person Plural
Antitranspirante	None
plantsch	Second person Singular
Altweibersommer	None
Befalles	None
Gekröses	None
schwellet	Second person Plural
Nickelarsenid	None
lynch	Second person Singular
killest	Second person Singular
streck	Second person Singular
kaperest	Second person Singular
europäisierst	Second person Singular
reproduzierest	Second person Singular
möblierst	Second person Singular
klumpest	Second person Singular
nationalisier	Second person Singular
enträtselest	Second person Singular
produzieret	Second person Plural
ström	Second person Singular
äußeret	Second person Plural
schnabulier	Second person Singular
park	Second person Singular
Brüderchen	None
Kormoran	None
katapultierest	Second person Singular
schnitz	Second person Singular
Höhlenlöwen	None
Blaumeise	None
vollzieh	Second person Singular
sanktionierest	Second person Singular
arretierst	Second person Singular
frustrierst	Second person Singular
klapperst	Second person Singular
Hündchen	None
fischest	Second person Singular
beschwindelest	Second person Singular
schür	Second person Singular
parlierst	Second person Singular
bezwänget	Second person Plural
Kopfläusen	None
hamsterest	Second person Singular
addierst	Second person Singular
köpfet	Second person Plural
söffest	Second person Singular
schnei	Second person Singular
verärgerst	Second person Singular
zerbrechest	Second person Singular
interkulturalisier	Second person Singular
Fehlercodes	None
kalkulier	Second person Singular
Dopings	None
bejahend	None
paukst	Second person Singular
strafst	Second person Singular
spezifizier	Second person Singular
zugeordnet	None
schnurrst	Second person Singular
Sängerinnen	None
überreichet	Second person Plural
Orgelmetallen	None
überfielet	Second person Plural
rührest	Second person Singular
restaurier	Second person Singular
belügst	Second person Singular
Maibaum	None
Umhängen	None
erschlägt	Third person Singular
dusch	Second person Singular
Hauptgrundes	None
Schauspielern	None
Alleskönnern	None
Broccoli	None
denaturierest	Second person Singular
eloxieret	Second person Plural
überzeug	Second person Singular
schämet	Second person Plural
blockier	Second person Singular
picket	Second person Plural
bestimmest	Second person Singular
klingelet	Second person Plural
verchrom	Second person Singular
verschwörst	Second person Singular
geflüstert	None
Freitagabende	None
Nys	None
reihest	Second person Singular
verbitterest	Second person Singular
Honorar	None
rank	Second person Singular
wühlest	Second person Singular
pflügest	Second person Singular
verbann	Second person Singular
hinterziehst	Second person Singular
Söhnen	None
Taften	None
frühstückst	Second person Singular
verhilft	Third person Singular
titelet	Second person Plural
verbesserst	Second person Singular
klingelst	Second person Singular
begrabschst	Second person Singular
trampelst	Second person Singular
Unsinn	None
entlaubst	Second person Singular
flirret	Second person Plural
Pendel	None
blakst	Second person Singular
Prozentpunkte	None
erzielet	Second person Plural
belagerest	Second person Singular
gewidmet	None
bequem	Second person Singular
kniffst	Second person Singular
Hotkeys	None
Gangsters	None
Wandteppichen	None
beschimpfest	Second person Singular
Garne	None
kommerzialisierest	Second person Singular
bekenntest	Second person Singular
unterschriebst	Second person Singular
kampier	Second person Singular
sortier	Second person Singular
verbuchest	Second person Singular
scann	Second person Singular
Koog	None
Gasplanet	None
Bajonetten	None
Polders	None
maximierst	Second person Singular
negier	Second person Singular
marschierest	Second person Singular
geschmeckt	None
Glaskörper	None
Staatschef	None
Gitterdefekte	None
streuet	Second person Plural
Gettos	None
dürftet	Second person Plural
torpedier	Second person Singular
beeindruckest	Second person Singular
Exzentriker	None
produzierst	Second person Singular
Produktionsländer	None
bedurftest	Second person Singular
Metalloproteine	None
standardisierest	Second person Singular
Sümmchen	None
Manufaktur	None
befielst	Second person Singular
Mengenrabatt	None
statuierest	Second person Singular
ejakulierest	Second person Singular
sehn	Second person Singular
fönest	Second person Singular
verbrämet	Second person Plural
geiferest	Second person Singular
entlaub	Second person Singular
Gemische	None
Staffelei	None
verkröchet	Second person Plural
begrenz	Second person Singular
eliminierst	Second person Singular
meuterest	Second person Singular
Barsch	None
spähet	Second person Plural
knirsch	Second person Singular
gustierest	Second person Singular
hustend	None
nies	Second person Singular
bedeckest	Second person Singular
torpedieret	Second person Plural
vererb	Second person Singular
Kalbshaxen	None
bedankst	Second person Singular
brauset	Second person Plural
zagest	Second person Singular
Stoffwechselprozessen	None
ignorier	Second person Singular
nebelet	Second person Plural
Griechin	None
europäisieret	Second person Plural
Glasnudel	None
Reinlichkeit	None
Blutergüsse	None
übergibt	Third person Singular
verschleiernd	None
versagest	Second person Singular
avancierst	Second person Singular
traumatisierest	Second person Singular
gediehet	Second person Plural
konfigurierest	Second person Singular
sprühet	Second person Plural
defilierest	Second person Singular
entschärfst	Second person Singular
Bildpunkte	None
dimm	Second person Singular
Demiurgen	None
kodierest	Second person Singular
verzettelst	Second person Singular
Ankündigungen	None
Betroffenheit	None
coventrieret	Second person Plural
Grünkohl	None
monogrammierest	Second person Singular
Fanatikern	None
schwöllest	Second person Singular
Numerus	None
kommunizierest	Second person Singular
Buxen	None
pimperet	Second person Plural
robbest	Second person Singular
tilgest	Second person Singular
abalienier	Second person Singular
piesackst	Second person Singular
erweisest	Second person Singular
angelest	Second person Singular
ekelst	Second person Singular
misslingest	Second person Singular
hinterlegest	Second person Singular
simulieret	Second person Plural
Zankapfels	None
erzögest	Second person Singular
entleerst	Second person Singular
begehest	Second person Singular
pharyngalisierst	Second person Singular
promotierest	Second person Singular
Geschmacksstoffen	None
Skalpelle	None
summ	Second person Singular
manövrier	Second person Singular
verzeig	Second person Singular
flambieret	Second person Plural
Erzeugung	None
schleifet	Second person Plural
erloschst	Second person Singular
erkranket	Second person Plural
werweissest	Second person Singular
bedroh	Second person Singular
erhebet	Second person Plural
zuckerest	Second person Singular
Giftgasen	None
fiep	Second person Singular
Theaters	None
reichst	Second person Singular
behinderet	Second person Plural
erwirbt	Third person Singular
absolvierst	Second person Singular
dreschet	Second person Plural
durchsuchst	Second person Singular
Kongruenz	None
Zahnwurzeln	None
Stauen	None
erschienst	Second person Singular
Amboss	None
gelauscht	None
immigrier	Second person Singular
lochest	Second person Singular
offerierest	Second person Singular
entfliehst	Second person Singular
nerv	Second person Singular
kommentierst	Second person Singular
verkriechest	Second person Singular
übersahst	Second person Singular
Isolierstoffe	None
überwältiget	Second person Plural
arrangierest	Second person Singular
touchieret	Second person Plural
bekränz	Second person Singular
bestehlest	Second person Singular
korrespondieret	Second person Plural
artikulierest	Second person Singular
glück	Second person Singular
duellierest	Second person Singular
versteineret	Second person Plural
nagelst	Second person Singular
pharyngalisieret	Second person Plural
Variante	None
fliehst	Second person Singular
maueret	Second person Plural
entvölkeret	Second person Plural
evangelisiret	Second person Plural
erlanget	Second person Plural
verlocket	Second person Plural
Einführung	None
überreagier	Second person Singular
aas	Second person Singular
Cabriolet	None
purgier	Second person Singular
Raketentreibstoffes	None
flankierst	Second person Singular
zwitscherest	Second person Singular
Kreiselkompass	None
vergraulest	Second person Singular
ionisierend	None
erteilst	Second person Singular
überfielt	Second person Plural
betrifft	Third person Singular
patentieret	Second person Plural
Weihnachtsbäumen	None
Urlauben	None
versemmelest	Second person Singular
bohr	Second person Singular
Kranich	None
formatieret	Second person Plural
debattier	Second person Singular
Goldrausch	None
verstreu	Second person Singular
klick	Second person Singular
schweigst	Second person Singular
kauet	Second person Plural
Pharisäers	None
zentrifugier	Second person Singular
Matjeshering	None
Redundanzen	None
haderet	Second person Plural
wogt	Second person Plural
verunglimpf	Second person Singular
pressierst	Second person Singular
pilgeret	Second person Plural
schnürest	Second person Singular
stibitz	Second person Singular
rumalbererest	Second person Singular
graphitieret	Second person Plural
verschmutzet	Second person Plural
unterwürfet	Second person Plural
Nebelstreif	None
Rücktritte	None
beschleunigend	None
streichelest	Second person Singular
verbrennst	Second person Singular
betreu	Second person Singular
beschlüget	Second person Plural
Hochaltäre	None
Quadratmetern	None
kreierest	Second person Singular
besinnet	Second person Plural
kollabieret	Second person Plural
Röntgenstrahl	None
Ablasshandel	None
Meeresküste	None
verwürfet	Second person Plural
kläffest	Second person Singular
amputierst	Second person Singular
gabelest	Second person Singular
aufgebracht	None
vergeltest	Second person Singular
schieß	Second person Singular
priorisieret	Second person Plural
dürfest	Second person Singular
enterst	Second person Singular
ergreifest	Second person Singular
konservier	Second person Singular
bezichtigst	Second person Singular
Dreckloch	None
Ikonen	None
unterwürfest	Second person Singular
zoomest	Second person Singular
Jahresumsatz	None
rekapitulierend	None
bewehr	Second person Singular
wurdet	Second person Plural
erwähnest	Second person Singular
zier	Second person Singular
zerrst	Second person Singular
beschimpf	Second person Singular
protokollierst	Second person Singular
tranchier	Second person Singular
oxidierst	Second person Singular
Gießerei	None
abgehakt	None
kräuselst	Second person Singular
Armbandes	None
platz	Second person Singular
leakest	Second person Singular
gerannst	Second person Singular
hinterziehest	Second person Singular
änderet	Second person Plural
edierest	Second person Singular
kipp	Second person Singular
benützet	Second person Plural
mokierest	Second person Singular
verhäng	Second person Singular
reizet	Second person Plural
verprügelet	Second person Plural
colorierest	Second person Singular
Arbeitsarztes	None
hybridisierest	Second person Singular
küssest	Second person Singular
verrätst	Second person Singular
bombardier	Second person Singular
torpedierest	Second person Singular
vergrabest	Second person Singular
Atomreaktoren	None
signalisieret	Second person Plural
umgabt	Second person Plural
flirrest	Second person Singular
patz	Second person Singular
Trauerspiele	None
Kunststoffes	None
Franke	None
beerdigst	Second person Singular
lackieret	Second person Plural
flichtst	Second person Singular
wackelet	Second person Plural
knautschest	Second person Singular
schleif	Second person Singular
verchromst	Second person Singular
verschiebst	Second person Singular
geschätzt	None
verschleuderest	Second person Singular
Proteine	None
benötigest	Second person Singular
mißverstehst	Second person Singular
graphitier	Second person Singular
währ	Second person Singular
strickst	Second person Singular
schwebst	Second person Singular
ermöglichst	Second person Singular
vereinfachet	Second person Plural
frorst	Second person Singular
Kollektion	None
kletterst	Second person Singular
schäl	Second person Singular
Darlehens	None
interessieret	Second person Plural
fauchet	Second person Plural
weh	Second person Singular
stürmet	Second person Plural
virtualisier	Second person Singular
Gebirge	None
beförderst	Second person Singular
Atoll	None
überwältig	Second person Singular
titelest	Second person Singular
Reflexion	None
quetsch	Second person Singular
erlangst	Second person Singular
migrierst	Second person Singular
süßest	Second person Singular
quill	Second person Singular
vernimmst	Second person Singular
gähn	Second person Singular
urbanisieret	Second person Plural
duckest	Second person Singular
kassierest	Second person Singular
patentierest	Second person Singular
schellet	Second person Plural
lockerst	Second person Singular
betonst	Second person Singular
Versehens	None
Blättchen	None
kachelet	Second person Plural
eiterest	Second person Singular
kullernd	None
beamet	Second person Plural
vertrau	Second person Singular
erforderet	Second person Plural
lynchet	Second person Plural
gedächtet	Second person Plural
Journal	None
geruhet	Second person Plural
peroxidierest	Second person Singular
befall	Second person Singular
Fehlschluss	None
Anzeigegerät	None
erschlügest	Second person Singular
homogenisierst	Second person Singular
schwängerest	Second person Singular
welkest	Second person Singular
traumatisierst	Second person Singular
wuschst	Second person Singular
picknickst	Second person Singular
tränkst	Second person Singular
Grindwales	None
zirkulieret	Second person Plural
Grausen	None
überträfet	Second person Plural
schweiß	Second person Singular
minderest	Second person Singular
besteig	Second person Singular
spiegelet	Second person Plural
wagst	Second person Singular
gestikulieret	Second person Plural
versenkst	Second person Singular
Franc	None
Sonnenlichts	None
stählest	Second person Singular
Strontium	None
wunderst	Second person Singular
warfst	Second person Singular
verehrst	Second person Singular
Fixierbädern	None
schon	Second person Singular
Tribunalen	None
zweifelest	Second person Singular
Orgien	None
bumsest	Second person Singular
Endungen	None
siezest	Second person Singular
imprägnierst	Second person Singular
klaff	Second person Singular
pulsierend	None
erließet	Second person Plural
tätig	Second person Singular
Fotzen	None
würgest	Second person Singular
purgieret	Second person Plural
Offenbarungen	None
segmentieret	Second person Plural
verpuffst	Second person Singular
weißsaget	Second person Plural
Einzahlen	None
Kneipen	None
kontaktieret	Second person Plural
zielest	Second person Singular
Packen	None
bewarbt	Second person Plural
renommieret	Second person Plural
jubelet	Second person Plural
aktualisier	Second person Singular
Übermensch	None
hüpf	Second person Singular
Tesla	None
changier	Second person Singular
verließest	Second person Singular
Röntgenfilme	None
Autoverkehrs	None
ekelet	Second person Plural
Antidots	None
blak	Second person Singular
adelst	Second person Singular
entsprächet	Second person Plural
Acetylens	None
Pflanzenwachstums	None
einrichtend	None
