միացնեն	Third person Plural
չքերեր	Third person Singular
չբաղձաք	Second person Plural
դարվինիզմի	None
կանզգայանայիք	Second person Plural
զազրոտիով	None
չփայփայեք	Second person Plural
ներկայացրեց	Third person Singular
չմեծաբանեցիր	Second person Singular
բանեցնեի	First person Singular
կզեռային	Third person Plural
ունկնդրեցին	Third person Plural
առաջադիմես	Second person Singular
միացնում	None
ագրեգատավորեն	Third person Plural
կտրամադրեն	Third person Plural
կուրսի	None
բրթեցիք	Second person Plural
թթվասեր	None
ավտոմեքենա	None
թուլացար	Second person Singular
քրթմնջացիր	Second person Singular
միանար	Third person Singular
կհոլաթեւես	Second person Singular
չըմպեցին	Third person Plural
գիտակցեն	Third person Plural
չտարածեցիր	Second person Singular
ագուցվեցին	Third person Plural
չհաճախեցրինք	First person Plural
պատրաստեինք	First person Plural
չսրտառի	Third person Singular
սելը	None
սարսափները	None
քոչենք	First person Plural
աջակցեմ	First person Singular
կողպեց	Third person Singular
չուժեղանանք	First person Plural
կլափեն	Third person Plural
պանիրների	None
ատի	Third person Singular
կարդարացնեին	Third person Plural
ապարանջանի	None
չհեղեիք	Second person Plural
ամայացան	Third person Plural
մեծությամբ	None
հանգեիք	Second person Plural
ապարանջան	None
աշուղները	None
ճաշեի	First person Singular
չխոպոպանայիր	Second person Singular
շփոթվենք	First person Plural
չսառչեցին	Third person Plural
չհենող	None
չոռոգես	Second person Singular
չճեմեք	Second person Plural
վանկեի	First person Singular
մաղադանոսի	None
կառավարեց	Third person Singular
կկարեկցեմ	First person Singular
փռշտա՛	Second person Singular
քարշեցի	First person Singular
հեգնեմ	First person Singular
կսփոփվեմ	First person Singular
պայմանավորվեցինք	First person Plural
չգոհանանք	First person Plural
սիկտիրվեցիք	Second person Plural
առաքի՛ր	Second person Singular
համոզեց	Third person Singular
փայփայեին	Third person Plural
կելտերը	None
չսնգուրվես	Second person Singular
տավիղ	None
քանդած	None
մոլեն	Third person Plural
դղեզներիցդ	None
կարբեին	Third person Plural
սրտաշարժեի	First person Singular
վտարմանը	None
շքերթներիցդ	None
մղոնով	None
էտեն	Third person Plural
չզետեղեինք	First person Plural
նարինջ	None
համբերեիր	Second person Singular
չհայտնեմ	First person Singular
մանրամաս	None
չգելեիք	Second person Plural
բաղխենք	First person Plural
կնիրհես	Second person Singular
օգտագործեցի	First person Singular
կհակազդեք	Second person Plural
չտկռեինք	First person Plural
չփողոտեցիր	Second person Singular
բուրժուազիայի	None
անհեթեթություն	None
առոգանեմ	First person Singular
հետազոտեցին	Third person Plural
կկեին	Third person Plural
չգիտակցեցիր	Second person Singular
չհանգստանայիք	Second person Plural
եկեր	None
ջեռուցեք	Second person Plural
խմես	Second person Singular
կապտավուն	None
կորեինք	First person Plural
հրճվեինք	First person Plural
մտադիր	None
հուռթացանք	First person Plural
տեղեկացրեց	Third person Singular
կմղձկեինք	First person Plural
շահագործական	None
ձագերը	None
փայլումդ	None
շուշանների	None
չհեգեցի	First person Singular
թանաք	Second person Plural
գոմեշ	None
լրթացե՛ք	Second person Plural
չշիջեի	First person Singular
չէտեք	Second person Plural
չապահովանաս	Second person Singular
անզգայանաս	Second person Singular
կխածատեիք	Second person Plural
պոլիոմիելիտը	None
հաստատեք	Second person Plural
չկանխեցիր	Second person Singular
չուսանեցիք	Second person Plural
կկեղեքես	Second person Singular
ծլարձակենք	First person Plural
շշնջար	Third person Singular
չհայհոյեն	Third person Plural
կձուլեի	First person Singular
էստոներեն	None
քառյակներ	None
չատեիք	Second person Plural
չբնութագրենք	First person Plural
միացնեի	First person Singular
կփքվեինք	First person Plural
գողտրիկ	None
մեղկանայի	First person Singular
չշատանայինք	First person Plural
պարանոցներ	None
կարողացանք	First person Plural
դիեցիկդ	None
մոծակներ	None
ողբերգություններ	None
չհուզեիր	Second person Singular
համարի	Third person Singular
սոսինձների	None
չհղփանաք	Second person Plural
լքեր	Third person Singular
կագուցվեմ	First person Singular
կկիրառվեն	Third person Plural
կվերադառնամ	First person Singular
չաղաղակեիք	Second person Plural
մետաղով	None
մարդաբաններ	None
խոչընդոտեիք	Second person Plural
չբորբոքեցինք	First person Plural
կերկբայանային	Third person Plural
կփութայի	First person Singular
կմատնեի	First person Singular
կխածեի	First person Singular
չտենչացին	Third person Plural
աստվածուհիներ	None
չծնվեք	Second person Plural
մագմա	None
քայլերին	None
զգենայի	First person Singular
սպորտում	None
չկիրառեցի	First person Singular
կաշառես	Second person Singular
չհուռթանայիք	Second person Plural
չործկաց	Third person Singular
կկամենային	Third person Plural
ստուգեց	Third person Singular
հատակեց	Third person Singular
մուճակդ	None
աշխատասեր	None
կբավարարեինք	First person Plural
փոխարինենք	First person Plural
չքերեինք	First person Plural
չտրամադրեցինք	First person Plural
կհանգեիք	Second person Plural
զգեցա	First person Singular
չբողբոջեցինք	First person Plural
առատը	None
չհրկիզեն	Third person Plural
վերագրեցին	Third person Plural
քաղցեինք	First person Plural
շպրտենք	First person Plural
չբաղխեք	Second person Plural
չսխալվենք	First person Plural
չառերեսվեի	First person Singular
չփոխարինեին	Third person Plural
լափես	Second person Singular
շիմպանզեների	None
տիք	None
դրդեց	Third person Singular
չմոլորվեցի	First person Singular
ոտնակին	None
ստարտափներով	None
չհոլաթեւեի	First person Singular
եպերի	Third person Singular
չախտորոշեի	First person Singular
կաթոդը	None
չկենդանանաս	Second person Singular
կատակերգության	None
նատրիումով	None
փախցներ	Third person Singular
կնվագեր	Third person Singular
չհարբենային	Third person Plural
հոգացիր	Second person Singular
աբորտս	None
բեկորը	None
քրտն	None
չկամենայինք	First person Plural
մագնիսականության	None
չգովենք	First person Plural
կտրամադրի	Third person Singular
կընտրվեիր	Second person Singular
չփորձեիր	Second person Singular
պատվանդանը	None
չկարողացան	Third person Plural
ծափահարես	Second person Singular
աքսորվեցի	First person Singular
կհառենք	First person Plural
դատապարտեցին	Third person Plural
առաջադիմեցին	Third person Plural
նազե՛ք	Second person Plural
չկերտեն	Third person Plural
չերկայնեց	Third person Singular
գոգի	Third person Singular
չզարթնեցի	First person Singular
արտադրություններից	None
վռնդես	Second person Singular
գովազդներից	None
նախասրահը	None
վերուվարեին	Third person Plural
սահմանի	Third person Singular
չատեն	Third person Plural
սառի	Third person Singular
ընդունակություններին	None
ազդվեցին	Third person Plural
գոմաղբով	None
զգուշանանք	First person Plural
կնազեք	Second person Plural
ամբարտավանանայի	First person Singular
հագեմ	First person Singular
չգուրար	Third person Singular
ալոճենովդ	None
կպաճուճաբանեի	First person Singular
կաղապարները	None
ֆիլիպինցի	None
հենեի	First person Singular
չսանրեցինք	First person Plural
չվճռեն	Third person Plural
թարգմանչին	None
անձնանունից	None
կսրամտեիր	Second person Singular
ճողոպրեք	Second person Plural
պարոնին	None
կողպեցի	First person Singular
չլքեց	Third person Singular
շենքում	None
հորիզոններ	None
չմատուցեցիր	Second person Singular
կարմանաս	Second person Singular
հեռախոսը	None
բուլղարացու	None
սգայի	First person Singular
ջինսի	None
կառաջադիմեի	First person Singular
խմբագրած	None
զվարճացնեմ	First person Singular
կփչեն	Third person Plural
կզանգեինք	First person Plural
ծանոթի	None
տեղեկանային	Third person Plural
հոգան	Third person Plural
արհեստանոցից	None
լայնալիճ	None
զարկերակից	None
սիգայինք	First person Plural
չմեղանչեցիր	Second person Singular
բացատրեի	First person Singular
բառակապակցությունից	None
հայցի	Third person Singular
չկծեցինք	First person Plural
կխոստանա	Third person Singular
տարվեց	Third person Singular
չնպաստեք	Second person Plural
նազենք	First person Plural
ներկայացնենք	First person Plural
խռմփացնեիր	Second person Singular
արագիլի	None
մշուշի	None
թռչունից	None
ծլել	None
խոստացավ	Third person Singular
չվարեք	Second person Plural
որմնախորշերը	None
ստուգենք	First person Plural
չայցելեցին	Third person Plural
մատչեցինք	First person Plural
ազդեցին	Third person Plural
ծուռմուռներովդ	None
վարպետին	None
չգլդորեցիք	Second person Plural
կկատակի	Third person Singular
կզղջայիք	Second person Plural
հրթիռին	None
սպառնալիք	None
այրվեցին	Third person Plural
թեոսոֆիան	None
գողանամ	First person Singular
ըմպելիք	None
կսաղացնեիք	Second person Plural
խորխի	Third person Singular
կկանխի	Third person Singular
ագնոստիցիզմումս	None
կողբա	Third person Singular
տնօրեն	None
կապահովեն	Third person Plural
գործոնը	None
վանեցին	Third person Plural
լծվել	None
ծածանեիր	Second person Singular
տեղեկանա	Third person Singular
շտապեցի	First person Singular
դողայինք	First person Plural
կգոլանան	Third person Plural
գերդաստանները	None
արքատս	None
կմերկանաս	Second person Singular
ուզենա	Third person Singular
քրդի	None
կարեն	Third person Plural
կթոտեն	Third person Plural
կլքեր	Third person Singular
հայտերը	None
ենթարկեցին	Third person Plural
չխորհրդանշեցիր	Second person Singular
կզաքիս	None
կմիանա	Third person Singular
չխանդեիր	Second person Singular
պագանե՛ք	Second person Plural
չարձագանքեիք	Second person Plural
հեղեցին	Third person Plural
առողջացներ	Third person Singular
չաբսորբեցին	Third person Plural
չհոխորտացի	First person Singular
ոխանայիք	Second person Plural
հետեւանք	None
չբխեց	Third person Singular
թավուտներիդ	None
չարբեցած	None
փնտրի	Third person Singular
մենամարտի	None
հիմարացներ	Third person Singular
չծնվի	Third person Singular
չերկայնեին	Third person Plural
չխայթեցին	Third person Plural
Մխիթարով	None
նազեց	Third person Singular
մողեսների	None
կմեղկանաք	Second person Plural
լողակներիս	None
ապացուցեն	Third person Plural
կգնչեիք	Second person Plural
բարբառեինք	First person Plural
օդայինը	None
քնամուկ	None
չպաճուճաբանեն	Third person Plural
շուրթերով	None
կպայմանավորես	Second person Singular
օծանելիքը	None
ձաղեիր	Second person Singular
չորանաս	Second person Singular
խմեցիք	Second person Plural
հաստատենք	First person Plural
կբդկեինք	First person Plural
չգթայինք	First person Plural
չեմպիոններին	None
վաճառե՛ք	Second person Plural
ուսանի	Third person Singular
պրոսպեկտներում	None
ընդելուզի	Third person Singular
կթոտեցիր	Second person Singular
ծնվեն	Third person Plural
ճաշասրահներումս	None
խմիչքով	None
կգողանաս	Second person Singular
ճամփորդեր	Third person Singular
քշեցին	Third person Plural
չխրտնեցիր	Second person Singular
ցավի՛ր	Second person Singular
կզետեղես	Second person Singular
հանգստացա	First person Singular
կզարմացնեին	Third person Plural
հոլանեի	First person Singular
թաղեց	Third person Singular
կքրթմնջանք	First person Plural
չապացուցեցիր	Second person Singular
թույներով	None
խեթկեիք	Second person Plural
շաղախները	None
չուղեկցի	Third person Singular
չմտադրվի	Third person Singular
գավաթին	None
թարգմանեք	Second person Plural
միանամ	First person Singular
հատիկներով	None
առույգի	None
արտասունքներիդ	None
կլուծի	Third person Singular
չարորեցին	Third person Plural
գործառնությունները	None
չփչանաք	Second person Plural
չերգիծեցիք	Second person Plural
չպանծացին	Third person Plural
չծպտեցի	First person Singular
կարօտենք	First person Plural
կազմակերպեց	Third person Singular
գնդացրին	None
չշարժվեին	Third person Plural
քորեք	Second person Plural
հասկացան	Third person Plural
կհմայեի	First person Singular
աճացրի	First person Singular
ստի	Third person Singular
անհանգստանայի	First person Singular
չառաջադիմեք	Second person Plural
կհյուծեինք	First person Plural
չմրսի	Third person Singular
աղաչանքներումդ	None
սսկվեն	Third person Plural
կկատակեմ	First person Singular
չհամեին	Third person Plural
չառերեսեցիք	Second person Plural
մետրանոցների	None
աճեն	Third person Plural
բանաց	Third person Singular
վճռեին	Third person Plural
չտանջեցին	Third person Plural
չբողոքեի	First person Singular
պահպանի	Third person Singular
ներկայացնես	Second person Singular
կրծի	Third person Singular
չհաստես	Second person Singular
կբխեի	First person Singular
չհաճախեինք	First person Plural
չգիտակցվեինք	First person Plural
գործընկերների	None
չհեռեիր	Second person Singular
խառնեք	Second person Plural
չզառամացար	Second person Singular
չնիրհեիր	Second person Singular
ուսումնասիրեն	Third person Plural
երկբայեցիր	Second person Singular
չդայլայլեցիք	Second person Plural
արխիվներ	None
չճոռոմախոսեց	Third person Singular
չտարվեցիք	Second person Plural
չկենդանացար	Second person Singular
չթքենք	First person Plural
կասկածի	Third person Singular
հանգեք	Second person Plural
դրսեւորեցին	Third person Plural
չհատուցես	Second person Singular
չնազեց	Third person Singular
կսրտաշարժեք	Second person Plural
սեզոնումդ	None
հսկան	None
կկալեի	First person Singular
կքաքեի	First person Singular
ուսաներ	Third person Singular
չխնկեին	Third person Plural
ջունգլիներ	None
սովոր	None
կգոչեի	First person Singular
չշարունակեց	Third person Singular
քաղաքագետներիս	None
չհրապուրեցին	Third person Plural
պիստակենու	None
չտոկացի	First person Singular
պաղատեք	Second person Plural
թլվատես	Second person Singular
վերծանեց	Third person Singular
խմածների	None
բարքերի	None
կիրառվի	Third person Singular
ոխանամ	First person Singular
կգորովեինք	First person Plural
չշփոթվեցիք	Second person Plural
չպատկերենք	First person Plural
կառավարության	None
զրուցեցին	Third person Plural
սովորենք	First person Plural
կազմակերպեր	Third person Singular
քորե՛ք	Second person Plural
կլանես	Second person Singular
պոլիոմիելիտ	None
մրցեիր	Second person Singular
կերկբայանայիր	Second person Singular
կաղամբը	None
բուծենք	First person Plural
աշխատեց	Third person Singular
չմտադրեիր	Second person Singular
չերկայնենք	First person Plural
սորեն	Third person Plural
մոլեկուլներ	None
խորխել	None
գելեց	Third person Singular
գավաթից	None
հարցմամբ	None
կրեր	Third person Singular
չկոտրեիք	Second person Plural
չմածվեր	Third person Singular
հայացքներին	None
չհատանք	First person Plural
փութացնես	Second person Singular
կարծեմ	First person Singular
առաջադիմությունս	None
չբռնաբարեք	Second person Plural
կմաքառեինք	First person Plural
տնօրինի՛ր	Second person Singular
կարողացավ	Third person Singular
կզանգահարեր	Third person Singular
չբորբոքեր	Third person Singular
կխոպոպացնենք	First person Plural
փչի	Third person Singular
կպաշտեինք	First person Plural
չքշենք	First person Plural
փախստյայովդ	None
հեղինակը	None
կհափափեի	First person Singular
կհակազդեմ	First person Singular
պահածոյացնեիք	Second person Plural
թրեյլերում	None
կհոտես	Second person Singular
մոլի՛ր	Second person Singular
խրոխտային	Third person Plural
հղացավ	Third person Singular
ահաբեկեին	Third person Plural
պահպանեն	Third person Plural
առաքելությանը	None
կմերձենաս	Second person Singular
կմիզես	Second person Singular
ճոռոմախոսեիր	Second person Singular
արգելոցներ	None
կտուժվեիր	Second person Singular
խմեցնել	None
չսրտառեի	First person Singular
կաճեցնեմ	First person Singular
չխանձեցին	Third person Plural
չաքսորվեն	Third person Plural
չկոչեին	Third person Plural
կտակեին	Third person Plural
դողացե՛ք	Second person Plural
կխռմփացնեն	Third person Plural
օգտագործեր	Third person Singular
կպոռոչեի	First person Singular
հրեայիցս	None
հնարամտությունը	None
չտրամադրեցիք	Second person Plural
կղբենիներս	None
փտեց	Third person Singular
անխելքումս	None
մոգոնեք	Second person Plural
չօղողեցիր	Second person Singular
չագուցեի	First person Singular
ճմլեր	Third person Singular
կախարդվենք	First person Plural
հրամանից	None
կբավարարես	Second person Singular
չգնահատի	Third person Singular
կորեցի	First person Singular
չգլտորեցիր	Second person Singular
չկերտեիր	Second person Singular
վառարանների	None
պատրաստեն	Third person Plural
ստորագրություններում	None
աստվածաշունչ	None
չբնակվեի	First person Singular
կհափափի	Third person Singular
չհամառեցիր	Second person Singular
կճեցի	First person Singular
չկկես	Second person Singular
սառել	None
բակլաս	None
թթուներ	None
իսլանդերեն	None
հոպոպ	None
կպապանձվեի	First person Singular
չստեցին	Third person Plural
կագռավանամ	First person Singular
ծխի	None
հորդորեի	First person Singular
կրծքանշանը	None
հազ	None
որբացար	Second person Singular
բաջաղեինք	First person Plural
սերունդը	None
ղափամաներ	None
կբուծանեիք	Second person Plural
հանձնեցիր	Second person Singular
քննեց	Third person Singular
չհամառեցի	First person Singular
կոռուպցիայի	None
էրբիումը	None
տարակուսեմ	First person Singular
պատկերեց	Third person Singular
կոգեմ	First person Singular
հասկանաք	Second person Plural
չհանվեմ	First person Singular
չհրամայեի	First person Singular
արդյունքներում	None
սնդուկը	None
խոցես	Second person Singular
փնտրենք	First person Plural
իրանահայերի	None
կողերով	None
գայթակղի	Third person Singular
դրդեցիր	Second person Singular
հայի	Third person Singular
պիրոլ	None
չբանտարկեր	Third person Singular
հայը	None
շշնջա՛	Second person Singular
զղջանք	First person Plural
սոուսներ	None
փչեիր	Second person Singular
բացատրեք	Second person Plural
հատեմ	First person Singular
կուռթեր	Third person Singular
սանրվեց	Third person Singular
հոլաթեւես	Second person Singular
կտրցակեիք	Second person Plural
կմրմնջայինք	First person Plural
չծիծաղայինք	First person Plural
միզեր	Third person Singular
չվճարեն	Third person Plural
մատնեն	Third person Plural
չըմպեն	Third person Plural
բանան	Third person Plural
չփայլունանայիք	Second person Plural
կեղծեիր	Second person Singular
պայթեք	Second person Plural
հարգեն	Third person Plural
կտարամիտեմ	First person Singular
լեզվակներումդ	None
կարյունահոսեի	First person Singular
դարանակալեիք	Second person Plural
կբարբաջենք	First person Plural
մորենին	None
կոռոգի	Third person Singular
կրճատումները	None
քչերին	None
կառավարություններ	None
ածանցի	Third person Singular
կհղիանայիք	Second person Plural
չապստամբեցինք	First person Plural
կեղեքում	None
չքորեին	Third person Plural
չփրփրացիր	Second person Singular
վայրով	None
սեւիս	None
ֆերմիոններ	None
խնամի	Third person Singular
հեռացնեք	Second person Plural
տուժել	None
չուզեց	Third person Singular
գետաձիերի	None
ձախիցդ	None
լայնատարածներումդ	None
չմտմտացի	First person Singular
տարածեցիք	Second person Plural
միզապարկում	None
կախցիդ	None
բուսան	None
կհամբուրվեինք	First person Plural
վարանեք	Second person Plural
կզենեիր	Second person Singular
կիսեն	Third person Plural
չգորովեցինք	First person Plural
կփքեինք	First person Plural
չհարբենայի	First person Singular
լուծեն	Third person Plural
չբուսնեցինք	First person Plural
կմտմտան	Third person Plural
սնգուրեմ	First person Singular
ցուցակից	None
կուռի	Third person Singular
կսարսափեի	First person Singular
կկաղկանձի	Third person Singular
հրկիզեցին	Third person Plural
մարտնչելու	None
ներկայացնեք	Second person Plural
ջորին	None
կքաղեինք	First person Plural
կապանքների	None
շողացիր	Second person Singular
ստրուկին	None
սադրեք	Second person Plural
գրտնակում	None
կվհատեիք	Second person Plural
համաձայնի	Third person Singular
թեփուկի	None
հաճախությունից	None
չներկայացրի	First person Singular
խաղաքարտեր	None
շառավիղները	None
վարդապետներից	None
կնքի	Third person Singular
չլուծեց	Third person Singular
կոբալտի	None
համեցին	Third person Plural
լրտեսներ	None
հայտնեն	Third person Plural
կարողացան	Third person Plural
չտուժվեցի	First person Singular
սպանությամբս	None
չխածատես	Second person Singular
թվանշանները	None
զննես	Second person Singular
թոթովեն	Third person Plural
հատեց	Third person Singular
բուսնեի	First person Singular
ըմպակներումդ	None
գոհացրեց	Third person Singular
թախտ	None
կռիվներ	None
չկարմրեիր	Second person Singular
մաղթել	None
չարձագանքեց	Third person Singular
կխեթկեր	Third person Singular
լիբիդո	None
ծլարձակեք	Second person Plural
շփոթի	Third person Singular
կրեի	First person Singular
կգրգռեին	Third person Plural
պանծանք	First person Plural
վանեն	Third person Plural
աճել	None
բահերից	None
թողության	None
հատկացնի	Third person Singular
նախարարին	None
կհեծեծի	Third person Singular
խօսան	Third person Plural
կցանկանային	Third person Plural
չգլորեցինք	First person Plural
զարմացնես	Second person Singular
խնչես	Second person Singular
աղոթեցիք	Second person Plural
ծափահարեք	Second person Plural
աչեղներ	None
կոլորակես	Second person Singular
հանձնեց	Third person Singular
խայթեցին	Third person Plural
ափսեն	None
գրազների	None
չհպատակվեինք	First person Plural
քեռիներովդ	None
ապշեին	Third person Plural
ճամփի	Third person Singular
հալի	Third person Singular
սրտաշարժեցին	Third person Plural
կշատանա	Third person Singular
միջատաբաններդ	None
դպրոցականներից	None
կկռանայիր	Second person Singular
զգուշանայիք	Second person Plural
գյուղերին	None
գոհացնում	None
կչորացնես	Second person Singular
չկաշկանդեցիր	Second person Singular
մոլորվեիր	Second person Singular
թատրոնին	None
կծածկես	Second person Singular
միացրեց	Third person Singular
ենթակայականներումդ	None
ուռի	Third person Singular
ուռեիք	Second person Plural
չներխուժեն	Third person Plural
աշխատեք	Second person Plural
կչափեինք	First person Plural
սենատը	None
թաքչեն	Third person Plural
չպահպանեն	Third person Plural
չդողայիք	Second person Plural
կառաքես	Second person Singular
գանգրացվենք	First person Plural
կծափահարես	Second person Singular
տեղեկացրին	Third person Plural
քյոմուր	None
խաժին	None
շարժվեն	Third person Plural
գրիպով	None
բարբանջեցինք	First person Plural
կոկաին	None
խնչեցինք	First person Plural
չցտեցիք	Second person Plural
ազդեք	Second person Plural
չառաքեի	First person Singular
ծածկեցին	Third person Plural
չտրցակեցիք	Second person Plural
մղեց	Third person Singular
չջանացինք	First person Plural
չգովես	Second person Singular
չկողոպտեիք	Second person Plural
չարորեինք	First person Plural
ճահուկը	None
մղվել	None
արվեստները	None
կրծքանշաններովս	None
չցուցանենք	First person Plural
եռան	Third person Plural
տրամադրեինք	First person Plural
չմոռանանք	First person Plural
սանձահարենք	First person Plural
աջակցեն	Third person Plural
ծխախոտը	None
կատի	Third person Singular
կհերքեինք	First person Plural
կօգտագործի	Third person Singular
չճողոպրեի	First person Singular
չողորմեցինք	First person Plural
կրող	None
ագուցահանեիք	Second person Plural
աշխատեր	Third person Singular
եբրայեցիս	None
կապահովեր	Third person Singular
զույգ	None
կձգտեիք	Second person Plural
կբավարարեն	Third person Plural
վանքերին	None
մարզասրահ	None
չկրեց	Third person Singular
չբարձրաձայնեիր	Second person Singular
չկարծեք	Second person Plural
պաղատեին	Third person Plural
կթեինք	First person Plural
վաստակին	None
չփորձեն	Third person Plural
հայելու	None
կներբեռներ	Third person Singular
ջղայնացրե՛ք	Second person Plural
չլվանան	Third person Plural
թեշուդ	None
սազեմ	First person Singular
չհեռեցիր	Second person Singular
կհորջորջեիր	Second person Singular
չկտցեք	Second person Plural
հղիացել	None
ներբեռնեց	Third person Singular
բարբանջեք	Second person Plural
չգիտակցվի	Third person Singular
չգանգրացրինք	First person Plural
փութամ	First person Singular
թարթող	None
կոլաժներ	None
չհորդի	Third person Singular
ծնգցնեին	Third person Plural
կոճակով	None
կփորձեմ	First person Singular
սպանախը	None
պատառեցի	First person Singular
զարդարանք	None
տաճարներ	None
նազի	Third person Singular
չլիզեցիր	Second person Singular
գնահատի	Third person Singular
չափեցի	First person Singular
աղբերումդ	None
կզգուշանային	Third person Plural
չհյուսեք	Second person Plural
ցանկացավ	Third person Singular
կուզենային	Third person Plural
չխնչեցիր	Second person Singular
կատիոններ	None
խոտերով	None
չհասցրին	Third person Plural
հանձնի	Third person Singular
շրջվես	Second person Singular
տարածությունները	None
արկի	Third person Singular
սոսիսկայիցդ	None
ցանկանաք	Second person Plural
հետեւեիր	Second person Singular
քվես	None
փոխարինի	Third person Singular
կտեսնաս	Second person Singular
շնորհում	None
ձկնկուլներիդ	None
չպագնեի	First person Singular
ուղարկեց	Third person Singular
կշտկեր	Third person Singular
չթաղեցի	First person Singular
կփոխհատուցեինք	First person Plural
քննարկի	Third person Singular
կմտմտայիք	Second person Plural
չքցի	Third person Singular
կկողոպտեր	Third person Singular
շիջե՛ք	Second person Plural
կամբարտավանանաք	Second person Plural
անկանես	Second person Singular
չհատկացնես	Second person Singular
հանձնեն	Third person Plural
շիկնեցին	Third person Plural
զեյթունի	None
քելեն	Third person Plural
կոտորածներով	None
բիոլոգիա	None
կթենք	First person Plural
բողոքեցին	Third person Plural
կհանվեիր	Second person Singular
օբյեկտով	None
ծաղկյա	None
դրդեի	First person Singular
ներքինացաք	Second person Plural
հարգենք	First person Plural
երկխոսությանը	None
փրփրա՛	Second person Singular
չբանայիր	Second person Singular
չործկանք	First person Plural
ալբաներենը	None
սկուտեղիդ	None
չմրմնջա	Third person Singular
սպրդեի	First person Singular
ագուցավորես	Second person Singular
տարվող	None
չդրսեւորեի	First person Singular
չմղձկեն	Third person Plural
կեղծիքը	None
խանձեցիր	Second person Singular
չընդգծեին	Third person Plural
չփչանայիք	Second person Plural
չարտագաղթեցին	Third person Plural
վճռեցին	Third person Plural
մերձեցե՛ք	Second person Plural
խուզեցիք	Second person Plural
ճնշման	None
սիգար	Third person Singular
չխնամեցի	First person Singular
շորը	None
կհալեմ	First person Singular
կգեղգեղեին	Third person Plural
աքսիոմումս	None
գնահատի՛ր	Second person Singular
կդարսեմ	First person Singular
շինվածքի	None
մրջյունի	None
ազդվենք	First person Plural
կանգնեցնել	None
տաշը	None
որմերը	None
հոգեբանին	None
կուզի	Third person Singular
պաղատեմ	First person Singular
հրամայեց	Third person Singular
կալնենք	First person Plural
պահպանեի	First person Singular
կսլանանք	First person Plural
հուռթիներովս	None
չզոդեցի	First person Singular
հերոսները	None
կծափահարեի	First person Singular
չշպռտեք	Second person Plural
հանգույցից	None
չինքնահավանենք	First person Plural
չսանրվեցինք	First person Plural
կուղեկցեք	Second person Plural
կախտորոշեն	Third person Plural
կերկկտտացնեմ	First person Singular
կկառավարեին	Third person Plural
կտրոհեք	Second person Plural
կախես	Second person Singular
կազմի	None
չհափափեցիր	Second person Singular
չկողոպտեիր	Second person Singular
արմունկը	None
բաղաձայնները	None
կխոպոպվեին	Third person Plural
չդարանակալեիք	Second person Plural
ներքինանային	Third person Plural
ճանապարհորդությամբս	None
կողպեցինք	First person Plural
լիկիերենում	None
կարձագանքենք	First person Plural
չհոլաթեւեցիր	Second person Singular
օդակայանները	None
չճմլեր	Third person Singular
երախ	None
աբոլիցիոնիզմ	None
ուզենք	First person Plural
կարօտի	Third person Singular
կհատակի	Third person Singular
անկանեիր	Second person Singular
չհեղեցիր	Second person Singular
չփլեիք	Second person Plural
չզգուշանամ	First person Singular
ասպանդակի	None
չաղան	Third person Plural
սնգուրեի	First person Singular
չլոգացան	Third person Plural
գիտակից	None
քարոզեց	Third person Singular
փղով	None
չստեցիք	Second person Plural
կխանձատես	Second person Singular
կուղխի	None
կհերքվեն	Third person Plural
շքեղություն	None
չհագնի	Third person Singular
կճաքեիր	Second person Singular
չստրկացրեց	Third person Singular
չանիծեինք	First person Plural
ծպտի	Third person Singular
ֆտորիդ	None
խազեցիք	Second person Plural
չխրտնես	Second person Singular
խոխոջայինք	First person Plural
եղծանեցի	First person Singular
մոռանային	Third person Plural
կարտաքսի	Third person Singular
գնեցի	First person Singular
թարգմանեցիր	Second person Singular
օգտագործեցին	Third person Plural
չխոպոպեցնեի	First person Singular
պոլիմեր	None
չանորոշանային	Third person Plural
կրպակների	None
չհատեինք	First person Plural
մոխրագույնից	None
ճեմասրահի	None
մեկնեն	Third person Plural
կոնֆետը	None
կվասիցդ	None
չպայմանավորվես	Second person Singular
պոռոտախոսեինք	First person Plural
ցանկանային	Third person Plural
խոստանար	Third person Singular
կաքսորեի	First person Singular
չտեղեկանայիր	Second person Singular
չքրտնեցիք	Second person Plural
մալայալամ	None
չապացուցվեի	First person Singular
հյուսկեններումս	None
ֆիլմը	None
զեռան	Third person Plural
փչանում	None
տիեզերագնաց	None
կհամբուրվես	Second person Singular
կստրկացնեմ	First person Singular
կցտես	Second person Singular
կկալնեմ	First person Singular
կտցարները	None
չըմպեցինք	First person Plural
չհերքեր	Third person Singular
կավելացնեմ	First person Singular
առորմի	None
վարեին	Third person Plural
չկատաղեցի	First person Singular
բարբանջովս	None
զանգում	None
տշեր	Third person Singular
սաղ	None
հածեք	Second person Plural
ատենք	First person Plural
ագուցվեցինք	First person Plural
կհամարենք	First person Plural
չմօտենար	Third person Singular
բեկտեցինք	First person Plural
ընդոստնենք	First person Plural
կգարշեիք	Second person Plural
չապացուցվեց	Third person Singular
կոտրեց	Third person Singular
գործվածքներ	None
ագուցանես	Second person Singular
զառամացաք	Second person Plural
կհողդողդեի	First person Singular
ստորագրենք	First person Plural
հեռեիք	Second person Plural
հաշվիչ	None
խռթաք	Second person Plural
վերքերիդ	None
նիշում	None
կահաբեկվեինք	First person Plural
կհոտոտեք	Second person Plural
կքննարկեր	Third person Singular
հագեցրիք	Second person Plural
ատամնաբույժի	None
բարբանջեինք	First person Plural
ստե՛ք	Second person Plural
ատյան	None
լացիս	None
կճեմեի	First person Singular
բողոքարկե՛ք	Second person Plural
կենսաբանությունս	None
ակումբներով	None
հսկաները	None
չաղոթեն	Third person Plural
կբեկանեք	Second person Plural
սառած	None
մեծատառով	None
կորովաձիգներովս	None
կորսայինք	First person Plural
ընտրվեն	Third person Plural
չհիացան	Third person Plural
խրոխտացաք	Second person Plural
չէտեց	Third person Singular
զրույցին	None
չհեռացնել	None
մեռյալի	None
իշխանությունների	None
կազդեն	Third person Plural
չմոլեմ	First person Singular
կփորեր	Third person Singular
կազմակերպիչներ	None
միջատաբանները	None
հագնեիր	Second person Singular
չհամաձայնենք	First person Plural
աշխարհաբար	None
կկախարդեն	Third person Plural
պահպանենք	First person Plural
համոզեիք	Second person Plural
խափանելու	None
համակարգես	Second person Singular
չորբանայիր	Second person Singular
քցեինք	First person Plural
կսպասարկեիր	Second person Singular
բիլս	None
չփայլունացվեցին	Third person Plural
կխածեք	Second person Plural
ինքնաթիռներին	None
մախաթներում	None
չկատաղեցիր	Second person Singular
ամառանոցով	None
օդապարիկի	None
վաստակի	None
կալեց	Third person Singular
ցանկացա	First person Singular
կդողաս	Second person Singular
ֆուտբոլիստին	None
ագռավացե՛ք	Second person Plural
կարօտի՛ր	Second person Singular
շվեդերենը	None
չգրգռեցիք	Second person Plural
ուրախացրեց	Third person Singular
տաղանդով	None
ճահճում	None
ճկույթի	None
կսլանայիր	Second person Singular
չհայհոյես	Second person Singular
որոճացիք	Second person Plural
չզատենք	First person Plural
չկարմրեն	Third person Plural
կորեիր	Second person Singular
չճաշեին	Third person Plural
ճոռոմախոսեիք	Second person Plural
շառաչեցիք	Second person Plural
վարկածի	None
քերեն	Third person Plural
չառոգանեցինք	First person Plural
օծերից	None
լուտեցիում	None
կտեղեկացնեմ	First person Singular
վարդապետից	None
ռեպին	None
չհերքեցի	First person Singular
մարդագայլի	None
զույգը	None
տարամիտես	Second person Singular
ագարականացին	Third person Plural
հակազդեք	Second person Plural
կզենեիք	Second person Plural
չօթեի	First person Singular
տելուրի	None
բանակցություններին	None
չձգտեիր	Second person Singular
կգերծեինք	First person Plural
ներբողներում	None
չշատանայի	First person Singular
մատնությամբ	None
հասարակ	None
գոգեիք	Second person Plural
չհամբուրեցինք	First person Plural
հոգաք	Second person Plural
հավատանք	First person Plural
աղարտի	Third person Singular
ներից	None
առանցքը	None
ընդգծի	Third person Singular
չուռեցին	Third person Plural
կանգնեինք	First person Plural
մեղկացի՛ր	Second person Singular
սխալվեցիր	Second person Singular
կկարմրանաս	Second person Singular
չհրեցինք	First person Plural
հողդողդեր	Third person Singular
կանգնեցին	Third person Plural
բույր	None
մռայլ	None
առաջադրանքից	None
կթլփատեի	First person Singular
կցանկանան	Third person Plural
ուղեկցեր	Third person Singular
ուռթանաք	Second person Plural
անալիդ	None
բնակվեցին	Third person Plural
ղարաբաղյանից	None
բորբոքած	None
վիճաբանեն	Third person Plural
կհավատամ	First person Singular
ճաշեր	Third person Singular
բգերիցս	None
կուղարկեիր	Second person Singular
չլքնի	Third person Singular
շուշտերդ	None
զառամանայինք	First person Plural
քաղցից	None
կցորդի	None
գովեմ	First person Singular
կխոպոպացվեմ	First person Singular
կերակրեք	Second person Plural
զրուցեց	Third person Singular
աներկյուղացաք	Second person Plural
չարածեցին	Third person Plural
կիրառվես	Second person Singular
ապստամբությունների	None
չլուծեն	Third person Plural
չկարօտեցինք	First person Plural
կքշեր	Third person Singular
արթնանում	None
չերկայնանաս	Second person Singular
հանվեիք	Second person Plural
դրդեիր	Second person Singular
ծանուցենք	First person Plural
կմուրանք	First person Plural
կարբենամ	First person Singular
մրցեց	Third person Singular
մալուխը	None
թամադա	None
կդարանակալեք	Second person Plural
կբլբլայինք	First person Plural
մոլեր	Third person Singular
չմեղանչեցի	First person Singular
խազեի	First person Singular
կգոչեիք	Second person Plural
կբնակվի	Third person Singular
չսպանեն	Third person Plural
մաղթանքը	None
ողբացի	First person Singular
ռեբուսներ	None
օդանավակայանում	None
հաճեցին	Third person Plural
կշփոթվես	Second person Singular
հաճույքի	None
ծաղկունքի	None
մամ	None
կկառավարեն	Third person Plural
հասիումովս	None
չհարսնացնեիք	Second person Plural
խափանեց	Third person Singular
կապահովվենք	First person Plural
կհիանեն	Third person Plural
խոստացան	Third person Plural
ուժեղանաս	Second person Singular
հիմնադրամով	None
անիծեինք	First person Plural
կբխեիք	Second person Plural
կկրծի	Third person Singular
վայելած	None
դիես	Second person Singular
չառոգանենք	First person Plural
կճամփորդեմ	First person Singular
կատեն	Third person Plural
լիացան	Third person Plural
չանին	None
հուսահատվե՛ք	Second person Plural
հետազոտի	Third person Singular
չծպտեց	Third person Singular
քանդեին	Third person Plural
կարգահատեք	Second person Plural
ծայր	None
սխալվեր	Third person Singular
ցտես	Second person Singular
բաճկոն	None
կբուսնեի	First person Singular
մնչեի	First person Singular
ավելացնեք	Second person Plural
կողողվեն	Third person Plural
հետազոտեիր	Second person Singular
կառավարությունդ	None
չքայլեցիք	Second person Plural
թաքցրիր	Second person Singular
կներկայացնեի	First person Singular
կկայանանք	First person Plural
չվճարեինք	First person Plural
թարգմանենք	First person Plural
գուրգուրացի	First person Singular
արգելեց	Third person Singular
գիտակցեմ	First person Singular
կփնտրես	Second person Singular
հարայի	None
չփրփրեիք	Second person Plural
չտարամիտեի	First person Singular
առու	None
կողողվենք	First person Plural
աբստրահվեցին	Third person Plural
կսաղանան	Third person Plural
ահազդիկներովս	None
չուռթեիք	Second person Plural
շարունակես	Second person Singular
այգեստանը	None
վալսիս	None
կերկմտեր	Third person Singular
խուզես	Second person Singular
չեխեր	None
ձեղնահարկի	None
կշնորհենք	First person Plural
արգելել	None
հորանջեցիք	Second person Plural
չափեր	Third person Singular
անկանեցիք	Second person Plural
սաղացրո՛ւ	Second person Singular
չփչեց	Third person Singular
հոբելյանս	None
թքի	Third person Singular
ռինգից	None
ընդոստեց	Third person Singular
կկարոտեք	Second person Plural
չտարբերեինք	First person Plural
բեկորները	None
չմղձկեմ	First person Singular
ռինգի	None
ծածկի	Third person Singular
մոշաներդ	None
չբուսաներ	Third person Singular
երգիծենք	First person Plural
կհասկանաս	Second person Singular
չցտի	Third person Singular
ուզի	Third person Singular
կատարեց	Third person Singular
բողոքարկեմ	First person Singular
շտկի	Third person Singular
կհղանանք	First person Plural
կգթանք	First person Plural
ցնորքներ	None
չծանուցեք	Second person Plural
չսառչեի	First person Singular
հանգեր	Third person Singular
կաղարտեիք	Second person Plural
շահագործվել	None
չկկեմ	First person Singular
չթորշոմեր	Third person Singular
դատապարտեմ	First person Singular
ձուլելու	None
չխթանեցինք	First person Plural
չխոսացիք	Second person Plural
արտադրությունները	None
աքսորեն	Third person Plural
քանդեք	Second person Plural
պարեր	None
կքայլենք	First person Plural
խեթկեք	Second person Plural
կորեց	Third person Singular
ոսկեդրամի	None
կրաքարերի	None
չզոդեցիք	Second person Plural
տեւողությունիցդ	None
մահացավ	Third person Singular
զեն	None
չկաշառեիր	Second person Singular
համալսարաններ	None
կաշկանդեիր	Second person Singular
քիչ	None
քարավանների	None
տարվեցիք	Second person Plural
կփայլունացնեի	First person Singular
չկորենք	First person Plural
նավազներ	None
կքորեն	Third person Plural
չգլեցի	First person Singular
պայմանագրերը	None
կացարաններում	None
քավեիք	Second person Plural
չհղեինք	First person Plural
չմոգոնեցիր	Second person Singular
պատկանի	Third person Singular
մրսածության	None
դարանակալեցինք	First person Plural
սպասարկեց	Third person Singular
որոջներիդ	None
բավարարեն	Third person Plural
կմիանային	Third person Plural
չնավեն	Third person Plural
տարիքը	None
ջղայնացի՛ր	Second person Singular
չհյուծես	Second person Singular
գոչեին	Third person Plural
կարեր	Third person Singular
կբարեւեին	Third person Plural
գանձարանից	None
ժանիքներից	None
առողջին	None
չխեղդեիք	Second person Plural
վարեց	Third person Singular
ռադոնների	None
չընկճեիք	Second person Plural
կողջագուրեի	First person Singular
դոնորությունների	None
հուների	None
սիրուէիք	Second person Plural
այցելեք	Second person Plural
լեռնագնացի	None
կփրփրաք	Second person Plural
բեկտեր	Third person Singular
սվիններով	None
կգարշեք	Second person Plural
կպաղատեն	Third person Plural
կզգենամ	First person Singular
չխոստանայինք	First person Plural
ազոտից	None
կառավարե՛ք	Second person Plural
չլրթանար	Third person Singular
ամորձատեցինք	First person Plural
տառադարձեց	Third person Singular
էլեկտրոնում	None
չզանգահարեիք	Second person Plural
չփնտրեք	Second person Plural
չանզգայացվեք	Second person Plural
մշակույթով	None
գանգրանայիր	Second person Singular
խցում	None
պողոտաների	None
պագեմ	First person Singular
ոստրեների	None
քայլեի	First person Singular
չխուզեիք	Second person Plural
չբավարարեիր	Second person Singular
գազանանոցի	None
կատարներիցդ	None
չափի	Third person Singular
սառույցում	None
վաճառքների	None
վհատեցնեմ	First person Singular
չագուցենք	First person Plural
նախագահությունը	None
չեպերեր	Third person Singular
կարմրե՛ք	Second person Plural
կմօտենար	Third person Singular
ապշի	Third person Singular
կավելացնես	Second person Singular
հնագետին	None
կապահովացնեք	Second person Plural
ժանր	None
համակարգի	Third person Singular
չխուզեք	Second person Plural
ընկղմեցինք	First person Plural
չկանգնի	Third person Singular
չմտմտամ	First person Singular
հանդիսականի	None
բանակցությունների	None
բորբոքեց	Third person Singular
քաղեն	Third person Plural
զգուշացում	None
չսգայիր	Second person Singular
չհալեց	Third person Singular
փաստին	None
քերականագետ	None
աստծով	None
անձնագիր	None
չկանգնեի	First person Singular
ավել	None
կարապներով	None
կվասներումդ	None
հարկադրեց	Third person Singular
բնութագրեցին	Third person Plural
կքեցիք	Second person Plural
սանրեիր	Second person Singular
չգնահատեք	Second person Plural
կթանաս	Second person Singular
կհամարեմ	First person Singular
սարքավորումներում	None
չքարոզես	Second person Singular
համացանցում	None
կհաստես	Second person Singular
պղծես	Second person Singular
կքավեինք	First person Plural
տենչար	Third person Singular
կհառնենք	First person Plural
սպասարկեցի	First person Singular
ավանդեիք	Second person Plural
աղարտեին	Third person Plural
հանգեցին	Third person Plural
կխածնեի	First person Singular
չստուգեցինք	First person Plural
պատկերեցինք	First person Plural
սորեին	Third person Plural
հեղեինք	First person Plural
շշնջա	Third person Singular
կբլբլաս	Second person Singular
կջեռուցեք	Second person Plural
կապացուցվի	Third person Singular
կհարսնանան	Third person Plural
կխոստանայիր	Second person Singular
ազգանուններով	None
կճշգրտեի	First person Singular
չկախարդվեին	Third person Plural
պատվիրակությունիցդ	None
մտմտացե՛ք	Second person Plural
արբեր	Third person Singular
հստակ	None
ուռչեինք	First person Plural
կծնեիր	Second person Singular
վարես	Second person Singular
զառանցեիք	Second person Plural
խոստացա	First person Singular
չկճեք	Second person Plural
ընթացավ	Third person Singular
մերձենար	Third person Singular
վեղարը	None
արտեր	None
անկանեցիր	Second person Singular
հարակիրիում	None
չսանրեմ	First person Singular
չկիսեց	Third person Singular
խրոխտացար	Second person Singular
համակարգիչներում	None
չհեգնեն	Third person Plural
չգարշեիր	Second person Singular
հինդիին	None
չկատակենք	First person Plural
կտակի	Third person Singular
չծաղրեցին	Third person Plural
չհանգեր	Third person Singular
ողորմեցիր	Second person Singular
կցուցանեք	Second person Plural
չկրեր	Third person Singular
գործիքներով	None
գրասեղանը	None
չհատուցի	Third person Singular
չպաշտեցի	First person Singular
կտշեք	Second person Plural
չողբային	Third person Plural
ուլենիիդ	None
չազդվեն	Third person Plural
հայտնեցին	Third person Plural
սառեն	Third person Plural
սիգաք	Second person Plural
կկրի	Third person Singular
կէտենք	First person Plural
ծառայի	Third person Singular
շնաձկներին	None
չեպերեին	Third person Plural
խռմփայիք	Second person Plural
չհուսահատեցնեի	First person Singular
չընթեռներ	Third person Singular
բավարարեց	Third person Singular
ներքինացրինք	First person Plural
չխոցեք	Second person Plural
վարանեին	Third person Plural
գելեր	Third person Singular
կիսեր	Third person Singular
նախընտրի	Third person Singular
կդայլայլի	Third person Singular
ներկային	None
վճարեր	Third person Singular
արտադրությանը	None
խռմփացրիք	Second person Plural
կճշգրտեր	Third person Singular
չարթնանաք	Second person Plural
ռուբլուդ	None
չհելնեիք	Second person Plural
ավելացրիք	Second person Plural
նորույթի	None
չվանեցիք	Second person Plural
չապահովեցինք	First person Plural
արքայազնի	None
կեռնեխ	None
կծծի	Third person Singular
ձուլեիր	Second person Singular
չխեղդեցիք	Second person Plural
նախանձի	Third person Singular
կալան	Third person Plural
սահմանենք	First person Plural
բաժանվեր	Third person Singular
աղքատներիցդ	None
չզետեղեիր	Second person Singular
չվայելեմ	First person Singular
հարի	Third person Singular
օդաչուները	None
կտուժի	Third person Singular
կտղեինք	First person Plural
հույրը	None
կրեց	Third person Singular
ճողոպրեց	Third person Singular
բաղնիքները	None
չկախեց	Third person Singular
չտնօրինեն	Third person Plural
չմտցրին	Third person Plural
չստրկացնեիք	Second person Plural
կվճռեք	Second person Plural
կպագանեին	Third person Plural
կըմպեինք	First person Plural
հիացավ	Third person Singular
տեղեկացներ	Third person Singular
մարտնչեց	Third person Singular
չզարմացրիր	Second person Singular
սկզբունքները	None
կհարկանեիր	Second person Singular
չքշեց	Third person Singular
անտարբերության	None
աստվածներ	None
անձի	None
խօսի՛ր	Second person Singular
հեքիաթներով	None
բտեց	Third person Singular
աճեցին	Third person Plural
քաղեց	Third person Singular
կխոխոջեն	Third person Plural
չհարկադրես	Second person Singular
կկամենաս	Second person Singular
հղիացա	First person Singular
հայցեր	Third person Singular
կմղձկեիք	Second person Plural
կմիանան	Third person Plural
չհայցեիք	Second person Plural
աստիճանավորների	None
չգերծեիք	Second person Plural
բնութագրեց	Third person Singular
տանձին	None
արահետը	None
կոկոսի	None
սաղանանք	First person Plural
չմաքրեի	First person Singular
ուզենայիր	Second person Singular
ծոծրակներով	None
չկթոտեցին	Third person Plural
կվճարեք	Second person Plural
գիշեր	None
օղողեմ	First person Singular
չբարեւեց	Third person Singular
սաղարթ	None
գիշատեցինք	First person Plural
կհիրեինք	First person Plural
քննարկեց	Third person Singular
ըլնեիր	Second person Singular
խածանեին	Third person Plural
մխիթարի	Third person Singular
հաստեն	Third person Plural
կթեին	Third person Plural
մոլորվեր	Third person Singular
չկաշկանդեիր	Second person Singular
չափանիշներից	None
բացատրությունները	None
չհպարտանար	Third person Singular
հաճախեց	Third person Singular
օժանդակող	None
չպոռոտաբանեցին	Third person Plural
կերակրեն	Third person Plural
քվե	None
խրթեմ	First person Singular
կատակերգությունում	None
կնետեին	Third person Plural
համրը	None
չարդարացնի	Third person Singular
կթլվատեինք	First person Plural
ամորձատեի	First person Singular
չշառաչեցիր	Second person Singular
կբարեւեիր	Second person Singular
մղձկի	Third person Singular
չպառկեցինք	First person Plural
կոշկոճեիր	Second person Singular
շարունակեին	Third person Plural
ազերիով	None
թափվեց	Third person Singular
կպայմանավորվեմ	First person Singular
լազերային	None
ստվար	None
կահագնանաք	Second person Plural
աշխատավարձին	None
թզուկներ	None
սորան	Third person Plural
ողորմածիկները	None
փորեցին	Third person Plural
ստորագրեն	Third person Plural
բողբոջի՛ր	Second person Singular
կփորձենք	First person Plural
բարձեցին	Third person Plural
եփեն	Third person Plural
կենսագրություններով	None
կտուժվենք	First person Plural
հանգույցդ	None
չտարվեն	Third person Plural
չաճեինք	First person Plural
անգլիացիներից	None
կուզենա	Third person Singular
հարցազրույցի	None
կերկնչես	Second person Singular
կակտուսի	None
չամբարտավանացան	Third person Plural
չհաստի	Third person Singular
ճամփորդեց	Third person Singular
չհղեցիք	Second person Plural
չզրուցի	Third person Singular
կարձագանքի	Third person Singular
մեծարեք	Second person Plural
հուսահատեցրինք	First person Plural
քաջալերությամբ	None
առնիս	None
մեծացան	Third person Plural
կմեծանա	Third person Singular
մաղթի՛ր	Second person Singular
նպաստեն	Third person Plural
չփայլունացվեն	Third person Plural
մաքրելու	None
զգածվի	Third person Singular
պլաստիկից	None
չերազի	Third person Singular
կըմպեն	Third person Plural
կընդոստեք	Second person Plural
շրջվեց	Third person Singular
հիվանդության	None
արկեք	Second person Plural
թաքչեր	Third person Singular
բեգեմոտներիդ	None
թանաքը	None
համարեինք	First person Plural
վռնդեց	Third person Singular
չոգեցիք	Second person Plural
գայթակղում	None
կվերծանեինք	First person Plural
մղեր	Third person Singular
հղումներին	None
արծվաբնիցս	None
սելեն	None
դրվատեր	Third person Singular
կընդոստնեն	Third person Plural
կխնկեմ	First person Singular
չկթեինք	First person Plural
ունակությունից	None
չդրդեի	First person Singular
երկչոտիս	None
կատակես	Second person Singular
չճվատես	Second person Singular
թեորեմին	None
հարկահավաք	None
կցանկանա	Third person Singular
պատրաստելու	None
մեծահանդեսում	None
կգրգռեիր	Second person Singular
բաղբանջեցիք	Second person Plural
չծփեինք	First person Plural
չսառչեցիք	Second person Plural
կաթսաները	None
մտմտացի	First person Singular
մոլես	Second person Singular
քաղեին	Third person Plural
հատուցեիր	Second person Singular
գրասեղանի	None
կաշկանդիդ	None
ներխուժեցին	Third person Plural
չհամբերեին	Third person Plural
կռվեց	Third person Singular
կխրթեմ	First person Singular
թոքախտումդ	None
կուզենամ	First person Singular
միացան	Third person Plural
բիբլիոգրաֆիա	None
խորշում	None
պսակների	None
ոխանան	Third person Plural
սպասարկի՛ր	Second person Singular
նետեիք	Second person Plural
մահանա	Third person Singular
մեղկացան	Third person Plural
կփքեմ	First person Singular
մնջախաղ	None
չգրադարձեցիք	Second person Plural
շարժումներից	None
ջանային	Third person Plural
մետաքսյա	None
հաշվումների	None
ապացուցվեց	Third person Singular
պանդոկը	None
մեկնի	Third person Singular
կոգեն	Third person Plural
կազմակերպեմ	First person Singular
թռավ	Third person Singular
չագուցեին	Third person Plural
շփոթեիր	Second person Singular
կցանկանայի	First person Singular
կկտղեի	First person Singular
ապերախտությունում	None
կհայցենք	First person Plural
չշեշտեց	Third person Singular
չվհատեցնենք	First person Plural
ճամփեիք	Second person Plural
պետություններ	None
հաստատեցին	Third person Plural
կարծեն	Third person Plural
չագարակացնեն	Third person Plural
բորենիները	None
լափեք	Second person Plural
խրախուսանք	None
կուզեք	Second person Plural
կորբանայիր	Second person Singular
չարորեիք	Second person Plural
կոպեռնիցիումներիցդ	None
զոդի	Third person Singular
կաթողիկոսի	None
կպագնեն	Third person Plural
պանդոկին	None
չկաշկանդեցի	First person Singular
հիասթափվեի	First person Singular
հյուսկեն	None
ոլորանների	None
բաժանումներով	None
փորձեցի	First person Singular
չխափանեի	First person Singular
զանգակներ	None
աղոթի	Third person Singular
կդրդեր	Third person Singular
չսանձահարեի	First person Singular
չհատես	Second person Singular
չնվաղեինք	First person Plural
չառերեսվեցիր	Second person Singular
քանդակը	None
վհատեմ	First person Singular
սագը	None
ընդոստնես	Second person Singular
փայփայեցիք	Second person Plural
փոխհատուցեցիր	Second person Singular
մեղմ	None
մոծակները	None
դարբիններ	None
հայտարարեց	Third person Singular
քրթմնջաս	Second person Singular
կփռթկացնի	Third person Singular
կշշնջաք	Second person Plural
կնքեն	Third person Plural
չմեծարեցիր	Second person Singular
կերտես	Second person Singular
ծանոթները	None
կգոհացնեինք	First person Plural
չթրծեցինք	First person Plural
չոռնաց	Third person Singular
չողբայիր	Second person Singular
մեղադրե՛ք	Second person Plural
երազի	Third person Singular
ուրանային	Third person Plural
կորեերենը	None
նավեր	Third person Singular
չստրկացրին	Third person Plural
ուրացան	Third person Plural
մալենք	First person Plural
սահմանեինք	First person Plural
կնպաստեն	Third person Plural
բանտարկեմ	First person Singular
ծառայեց	Third person Singular
ավարերեններիցս	None
արդյունաբերությունում	None
կաղատեն	Third person Plural
չհոլանեինք	First person Plural
կակազեին	Third person Plural
չճանապարհորդեցին	Third person Plural
չքավի	Third person Singular
անտեր	None
չբուսնեի	First person Singular
չտարբերեր	Third person Singular
կունկնդրի	Third person Singular
կանգնի	Third person Singular
կթարգմանես	Second person Singular
կարյունահոսեք	Second person Plural
տշեք	Second person Plural
վայելի	Third person Singular
բախի	None
հարավում	None
կկարողանա	Third person Singular
բորբոքի՛ր	Second person Singular
փախ	None
բղավեն	Third person Plural
վիճեց	Third person Singular
հռետորի	None
զխկտեցիր	Second person Singular
ցավեր	Third person Singular
կահազանգեն	Third person Plural
քանդել	None
ճախրեցիք	Second person Plural
չբուսնենք	First person Plural
կշռեց	Third person Singular
մոլի	Third person Singular
ճոռոմախոսեցինք	First person Plural
անձրեւեմ	First person Singular
չհեգեցինք	First person Plural
աժդահակի	None
կվախենայինք	First person Plural
կպանծա	Third person Singular
վախենում	None
չհաճախեցի	First person Singular
հաշվիչի	None
անիծեր	Third person Singular
պատրաստի	Third person Singular
հոխորտաց	Third person Singular
չհեգնեց	Third person Singular
հորթերը	None
հարգանքը	None
ծիրանին	None
ընդունակություններով	None
չքրթմնջան	Third person Plural
կհարթուկեիք	Second person Plural
ողբացին	Third person Plural
կճոռոմաբաներ	Third person Singular
հայեցի	First person Singular
կիսեին	Third person Plural
կներբեռնենք	First person Plural
տարվեր	Third person Singular
ֆլեյտային	None
մասունքները	None
վրձնին	None
քելեր	Third person Singular
ներգաղթի	Third person Singular
կարծես	Second person Singular
զավթեցին	Third person Plural
հոնքերը	None
տնօրենը	None
կխոպոպվեմ	First person Singular
հորդեց	Third person Singular
կռվես	Second person Singular
բազեներ	None
չսրտաշարժեին	Third person Plural
պանդոկներ	None
արդյունաբերության	None
նավաստիները	None
ոսպնյակներ	None
չզառանցեիր	Second person Singular
օդանավում	None
շրջանագիծը	None
կհասցնեմ	First person Singular
նվերները	None
լվացվեն	Third person Plural
աղախնից	None
շառաչ	None
կփայլունացվեիր	Second person Singular
կճոռոմաբանեք	Second person Plural
չբաղձա	Third person Singular
առաքյալներին	None
կզրուցեք	Second person Plural
կարկին	None
կվաճառեի	First person Singular
կմիացնեիք	Second person Plural
մատնում	None
պոռոչեցիր	Second person Singular
կհագեցնենք	First person Plural
կեչուան	None
կործկա	Third person Singular
հաստատեց	Third person Singular
հոլանդացիները	None
տարվեցին	Third person Plural
չուզեցաք	Second person Plural
աքսորատեղիով	None
վայելեց	Third person Singular
մեկնենք	First person Plural
ողջույններիցս	None
աղոթելիս	None
չվերընթերցենք	First person Plural
ծաղրեց	Third person Singular
շաչեցինք	First person Plural
կսրտաշարժեիք	Second person Plural
հասցեին	None
խնամիները	None
չծնգցնեք	Second person Plural
կվերադառնայինք	First person Plural
շարժվի՛ր	Second person Singular
չնետեք	Second person Plural
չվախեին	Third person Plural
օժանդակեց	Third person Singular
կանխագրես	Second person Singular
կխնամեին	Third person Plural
բռնությունումս	None
հանրապետության	None
կբառնայիք	Second person Plural
մատղաշի	None
հայտնի	Third person Singular
հոտեցին	Third person Plural
շրջակայքեր	None
չաճացնեիք	Second person Plural
անձնանունները	None
կկեղտոտեմ	First person Singular
կկայանան	Third person Plural
ողնուղեղում	None
չընկղմեց	Third person Singular
մաքառած	None
հեգեմ	First person Singular
չթաքչեիք	Second person Plural
չզարմացրի	First person Singular
օձիքներով	None
աստղաֆիզիկայումս	None
խոյացավ	Third person Singular
գիտակցած	None
բաժանումներ	None
աննպաստի	None
առանցքների	None
ընթանային	Third person Plural
վագոններից	None
ատեիք	Second person Plural
աղաղակեինք	First person Plural
մերձավորում	None
մայաներ	None
նավեի	First person Singular
ներկայացմամբ	None
ձաղկեց	Third person Singular
կհանվի	Third person Singular
կոկաինի	None
չհայեք	Second person Plural
ռութենիում	None
կգանգրվես	Second person Singular
չհավատայիք	Second person Plural
չագուցավորեք	Second person Plural
չպանծայիք	Second person Plural
լեհերենով	None
խայթես	Second person Singular
չգորովեցի	First person Singular
աբստրահե՛ք	Second person Plural
զանգահարեց	Third person Singular
սպաներ	Third person Singular
չոռնացի	First person Singular
խնամել	None
կներբեռնեի	First person Singular
բարեկամը	None
բացառեն	Third person Plural
վռնդեցիր	Second person Singular
կոալաներս	None
ջունգլիի	None
կհեռացնեիր	Second person Singular
չապստամբենք	First person Plural
չտարբերեցիք	Second person Plural
թռչունին	None
առերեսվի	Third person Singular
սնկապուրներիցդ	None
չօգտագործեիր	Second person Singular
շեշտ	None
ցինկ	None
հաղարջիդ	None
կլքնեիք	Second person Plural
չտռզենք	First person Plural
երեւայի	First person Singular
չոստնեմ	First person Singular
ուռթանար	Third person Singular
ստերը	None
հնդեվրոպաբաններս	None
չոլորեին	Third person Plural
ծառայությունից	None
կվասը	None
հեղինակին	None
ձողիկների	None
պատարագ	None
մոլիբդեններիցս	None
կխօսէիք	Second person Plural
արյունահոսեիք	Second person Plural
լիանա	Third person Singular
չգնես	Second person Singular
չխրոխտացանք	First person Plural
անոթի	None
չկատարեց	Third person Singular
արթնանանք	First person Plural
կարածենք	First person Plural
չլրտեսեց	Third person Singular
հաճախենք	First person Plural
արթնանալ	None
չվիճես	Second person Singular
թանանք	First person Plural
խանդեմ	First person Singular
կհաճախեցնենք	First person Plural
կախարդի	Third person Singular
ներխուժեն	Third person Plural
չճոռոմախոսեր	Third person Singular
հոսի՛ր	Second person Singular
ինքնաթիռների	None
ընտրվեցին	Third person Plural
ուռչենք	First person Plural
ֆոսֆոր	None
մեծաշուք	None
չգոչեցին	Third person Plural
եռայիր	Second person Singular
սրճենի	None
կղբենիներիցս	None
ներկայացնի	Third person Singular
խրթես	Second person Singular
կսանրվեիր	Second person Singular
երդվում	None
հոտոտեր	Third person Singular
կստորագրեին	Third person Plural
դարձվածքների	None
կողոպտեցիր	Second person Singular
ճաշի	Third person Singular
չզանգահարեցիք	Second person Plural
կեղծաներ	Third person Singular
չընգնի	Third person Singular
կարդուկեք	Second person Plural
գալակտիկայում	None
կկարմրեին	Third person Plural
չկրես	Second person Singular
ավանդի	Third person Singular
գողոնքներին	None
նախադասությունները	None
չծղրտայիք	Second person Plural
գումարից	None
կարողանային	Third person Plural
կհարկանեիք	Second person Plural
չթուլանայինք	First person Plural
կմղեմ	First person Singular
կըլնեին	Third person Plural
կձաղկեիք	Second person Plural
ձեռնոցներով	None
պայմանավորեցի	First person Singular
չնքողի	Third person Singular
կզղջայիր	Second person Singular
կփսխենք	First person Plural
նահանգապետերին	None
ծլարձակե՛ք	Second person Plural
չվարանեիր	Second person Singular
կքամեմ	First person Singular
արտագաղթի	Third person Singular
չկթոտեք	Second person Plural
ձվաբջիջ	None
ընդգծեիք	Second person Plural
չհեծեծեիր	Second person Singular
տուժեց	Third person Singular
չամորձատեցի	First person Singular
չչափեցիք	Second person Plural
վխտայինք	First person Plural
տես	None
առաքած	None
կառչեմ	First person Singular
կարմիր	None
գարուց	None
կապահովանան	Third person Plural
հաստություններիցս	None
սխրանքները	None
հեծան	Third person Plural
չկործանես	Second person Singular
շարժիչներ	None
կկաշառենք	First person Plural
կանտոններից	None
չհառեիք	Second person Plural
կխոցեմ	First person Singular
չբուծանեցինք	First person Plural
գոհանաս	Second person Singular
թրեի	First person Singular
կնվաք	Second person Plural
սիրահարը	None
փափուկ	None
հարցազրույցից	None
մագնեզիումով	None
արորի	Third person Singular
կչարանամ	First person Singular
չնեխեինք	First person Plural
չոլորեցիք	Second person Plural
կեղեքի	Third person Singular
կընդգծես	Second person Singular
չապացուցվեիք	Second person Plural
հղիությունից	None
հանվեցին	Third person Plural
փորձեր	Third person Singular
հածես	Second person Singular
ընթանար	Third person Singular
չհաճախեր	Third person Singular
պատառի	Third person Singular
շնչեի	First person Singular
կսաղանայիք	Second person Plural
բացառեիր	Second person Singular
չհարեին	Third person Plural
տնտեսագետ	None
կգրադարձեի	First person Singular
չշարունակեր	Third person Singular
չբարելավեց	Third person Singular
կմերկանար	Third person Singular
կփորձեն	Third person Plural
աքլոր	None
սգայիք	Second person Plural
թոքերում	None
կքրթմնջային	Third person Plural
չհարսնացնեն	Third person Plural
արդարացրիր	Second person Singular
ապահովեցնեիք	Second person Plural
չխոցոտեցիր	Second person Singular
հազարամյակներում	None
չապահովվենք	First person Plural
չսառենք	First person Plural
չգործարկեք	Second person Plural
տարածի	Third person Singular
շիջեն	Third person Plural
վհատեին	Third person Plural
գրաստներդ	None
մագլցի՛ր	Second person Singular
հատեցին	Third person Plural
հանվեցի	First person Singular
նիստի	None
հանձներ	Third person Singular
պարսկերենը	None
օժանդակեցին	Third person Plural
գովեստ	None
ավելացնեի	First person Singular
թիկունքը	None
խանութներով	None
մրցավարներին	None
թեկնածու	None
ցավային	Third person Plural
գարշեին	Third person Plural
զարթօնքի	None
չհատաք	Second person Plural
կզրնգային	Third person Plural
չլկստվեցինք	First person Plural
վիճաբանել	None
չխափանեցի	First person Singular
կամայանար	Third person Singular
չառաջադիմեինք	First person Plural
բամբասանքից	None
չսորեք	Second person Plural
տոկուններովս	None
հավատացին	Third person Plural
կործանեց	Third person Singular
ախտորոշե՛ք	Second person Plural
փաշայի	None
կփլես	Second person Singular
ճաշեմ	First person Singular
կբաժանվի	Third person Singular
կպոռոչեինք	First person Plural
հարցազրույցներում	None
արհամարհեցիր	Second person Singular
չսարսափեցի	First person Singular
չհողդողդես	Second person Singular
նեղուցի	None
սկզբունքով	None
կհղենան	Third person Plural
կերակրեցին	Third person Plural
գոյակցության	None
դատարանին	None
ուղեկցեցին	Third person Plural
պորտում	None
մաղթեիր	Second person Singular
չենթարկեց	Third person Singular
խոցի	Third person Singular
կալեկոծեիր	Second person Singular
նախաճաշի	Third person Singular
գործարկեց	Third person Singular
չտռզեցիք	Second person Plural
կերկայնանան	Third person Plural
բեկտեին	Third person Plural
երկկտտացնի	Third person Singular
զանգեի	First person Singular
սպանի՛ր	Second person Singular
քոչես	Second person Singular
չթաքչեի	First person Singular
աղատեի	First person Singular
օժանդակի	Third person Singular
չհոսեցին	Third person Plural
կրեցին	Third person Plural
ուժեղանան	Third person Plural
հորդորանքով	None
մղձկային	Third person Plural
ուռթանա	Third person Singular
օթելիք	None
չաբսորբեիր	Second person Singular
կարեմ	First person Singular
հրի՛ր	Second person Singular
պատարագումս	None
ճամփորդելու	None
հիմունքներով	None
չկասկածի	Third person Singular
հյուծեք	Second person Plural
չբաղձաց	Third person Singular
վանկարկել	None
չածանցեի	First person Singular
չմարտնչեք	Second person Plural
բացատրեցինք	First person Plural
կռվեր	Third person Singular
ձայնավորը	None
արխիվները	None
առաջավորասիական	None
կբաժանվեք	Second person Plural
կկռնչեիք	Second person Plural
չհեռացնեի	First person Singular
կատակեք	Second person Plural
արաբերենով	None
պանրից	None
փորեց	Third person Singular
կրակեք	Second person Plural
քամու	None
չծպտեի	First person Singular
արորենք	First person Plural
տիկնիկային	None
չխուզեինք	First person Plural
չինքնահավանես	Second person Singular
չկալնի	Third person Singular
հարցումներով	None
աղջությունումս	None
սառնամանիքների	None
մենակատարները	None
փոխհատուցի	Third person Singular
հայտնեց	Third person Singular
հիասթափեցնող	None
փախան	Third person Plural
առաջադիմումներումս	None
կսահմանեինք	First person Plural
աստղաբաշխությունովս	None
զննեցինք	First person Plural
գրախանութում	None
ծանրությամբ	None
պարկեշտ	None
չտնօրինեց	Third person Singular
գողացե՛ք	Second person Plural
երգիծեին	Third person Plural
աջակցեիր	Second person Singular
վաճառեմ	First person Singular
պարտեզների	None
սիգա	Third person Singular
փնտրեցի	First person Singular
կարողանար	Third person Singular
չսիգայինք	First person Plural
կմղձկայինք	First person Plural
կբարձրաձայնեն	Third person Plural
չմեղադրեց	Third person Singular
անցք	None
կմոլեգնեինք	First person Plural
չողբացին	Third person Plural
կմղեր	Third person Singular
թի	None
չհարբենար	Third person Singular
թոթովեր	Third person Singular
ճանապարհորդները	None
ճաշենք	First person Plural
մաղթում	None
չսազա	Third person Singular
վտակը	None
կախարդվածությունը	None
անկածիս	None
հարգես	Second person Singular
կիրառվեց	Third person Singular
չգնչեցին	Third person Plural
ստրկացնեինք	First person Plural
պոռոչեին	Third person Plural
միացնի	Third person Singular
պատկանեն	Third person Plural
ներբեռնում	None
պարերի	None
ավեստերենումդ	None
կդրսեւորի	Third person Singular
խեչակներովդ	None
փքես	Second person Singular
հառե՛ք	Second person Plural
կտրոնի	None
կոտրե՛ք	Second person Plural
չնետեն	Third person Plural
չագուցվեցինք	First person Plural
իրավազուրկ	None
կմեկնեին	Third person Plural
չտրցակեիք	Second person Plural
շիկանանք	First person Plural
պատճենները	None
շարժերի	None
նիրհեցիք	Second person Plural
չկթոտես	Second person Singular
կհոխորտայինք	First person Plural
հիմնավորի	Third person Singular
չկշռեինք	First person Plural
հածի՛ր	Second person Singular
քայլի	Third person Singular
չկարողանան	Third person Plural
տոռներից	None
աղոթեց	Third person Singular
բացվածքներով	None
կներկայացնեմ	First person Singular
կսրտաշարժեիր	Second person Singular
ուղեկցի	Third person Singular
ազդրոսկրերումդ	None
ապարոշ	None
գելի	Third person Singular
փնտրեց	Third person Singular
անզգայացուցիչներս	None
գոռա	Third person Singular
չվրդովվեցիք	Second person Plural
չքորեիր	Second person Singular
կարոտես	Second person Singular
շռես	Second person Singular
կկաղկանձեն	Third person Plural
ճեմեցինք	First person Plural
վեհանձնից	None
շփոթեր	Third person Singular
չկարողացանք	First person Plural
կողին	None
կպատկանի	Third person Singular
գանդոնին	None
գյուտեր	None
սովորեք	Second person Plural
կատակեց	Third person Singular
գրավիտոններիս	None
հայտարարեցիք	Second person Plural
նամականիշի	None
չվճռեր	Third person Singular
չփութացնես	Second person Singular
հասցնի	Third person Singular
հեղափոխությանը	None
չարկանեք	Second person Plural
չնազեցին	Third person Plural
չբաղբանջեմ	First person Singular
կայցելեինք	First person Plural
չթոռոմես	Second person Singular
հառաչականը	None
ստորգետնյայիցս	None
սուզեցին	Third person Plural
կհարբեիք	Second person Plural
բայոցով	None
մայրցամաքին	None
քամեց	Third person Singular
կամայանայինք	First person Plural
կզտեիր	Second person Singular
կարողանալու	None
բուժքույր	None
կանխամտածեինք	First person Plural
չարտագաղթեց	Third person Singular
նավի	Third person Singular
գովի՛ր	Second person Singular
հանգեի	First person Singular
կմագլցենք	First person Plural
կճաշեի	First person Singular
կազակով	None
չսաղացներ	Third person Singular
գոհացնեի	First person Singular
բարելավի	Third person Singular
պոռոտաբանի	Third person Singular
կբացատրի	Third person Singular
պահպանեցին	Third person Plural
չմրսեի	First person Singular
կկճեիր	Second person Singular
կողպեք	Second person Plural
չապահովեցնեիր	Second person Singular
նկուղը	None
հանրախանութներդ	None
ենթակայի	None
բռնություններ	None
մակեդոներեն	None
չաքսորեի	First person Singular
դիեցիկիդ	None
չընդարմացա	First person Singular
ժամաններովդ	None
ծնկոսկրերումս	None
փնտրեք	Second person Plural
փոխարինումից	None
կմտցներ	Third person Singular
սահմանեց	Third person Singular
պատկանեցիր	Second person Singular
չկեղեցինք	First person Plural
չքրթմնջանք	First person Plural
բաղձայի	First person Singular
տառապի	Third person Singular
կագռավանայիք	Second person Plural
կփռշտար	Third person Singular
խրախուսե՛ք	Second person Plural
թրջեց	Third person Singular
հեռուստաընկերությունում	None
երիտասարդ	None
չցանկանաս	Second person Singular
չհնանա	Third person Singular
լեյտենանտ	None
կցանկանայինք	First person Plural
գնչի	Third person Singular
հոլաթեւեցինք	First person Plural
չինացիները	None
չապացուցվեինք	First person Plural
հիդրոլիզով	None
բանտարկեց	Third person Singular
կզանգեն	Third person Plural
քաղաքապետը	None
ծիրանը	None
չհղիանար	Third person Singular
ագուցահանեցինք	First person Plural
ձեռնոցներ	None
հավելեց	Third person Singular
ճաքած	None
խազեցինք	First person Plural
կեռամ	First person Singular
չփռթկացնեիք	Second person Plural
կայարանները	None
սպանեին	Third person Plural
չգոչես	Second person Singular
կպահածոյացնեիք	Second person Plural
պատրաստեցին	Third person Plural
չտառապեիք	Second person Plural
մոտեցնող	None
ճոռոմաբանեիր	Second person Singular
կկաշկանդեք	Second person Plural
չպարապենք	First person Plural
ձախից	None
չարդարացրեց	Third person Singular
ապահովանային	Third person Plural
օղողեք	Second person Plural
ալմասի	None
չքշեինք	First person Plural
հրվանդանի	None
չփրփրայիր	Second person Singular
չհրամայեցի	First person Singular
վաճառեցին	Third person Plural
մօտեցաք	Second person Plural
չխոչընդոտի	Third person Singular
լքեցին	Third person Plural
չհրենք	First person Plural
չխմեիք	Second person Plural
կտեսնանք	First person Plural
չխորհրդանշեցին	Third person Plural
նավեցի	First person Singular
դրդեցինք	First person Plural
անշեջ	None
չզրնգաք	Second person Plural
ատոմը	None
ուռչեմ	First person Singular
հասկանամ	First person Singular
էմիգրանտներ	None
չտարածեցինք	First person Plural
չուղեկցեցինք	First person Plural
չչաղանաք	Second person Plural
վճարի	Third person Singular
ծածանի	Third person Singular
մղձկացիք	Second person Plural
գլդորեց	Third person Singular
կհոլաթեւեն	Third person Plural
սպասարկեինք	First person Plural
քոչեմ	First person Singular
գրենականումդ	None
չներբեռնեմ	First person Singular
չխմբագրեին	Third person Plural
զարմիկների	None
երգիծանք	None
բառացանկերումդ	None
կչարանար	Third person Singular
կբարելավեին	Third person Plural
թոք	None
կուժի	None
չարանայինք	First person Plural
չփախցրի	First person Singular
աճեր	Third person Singular
հողեղենով	None
չտոկացինք	First person Plural
դողացինք	First person Plural
արորեք	Second person Plural
ձգտեցիք	Second person Plural
կարտաքսեիք	Second person Plural
չմղեցի	First person Singular
տարբերեմ	First person Singular
մխիթարեիր	Second person Singular
դեկտեմբերներիցս	None
նավատորմով	None
գրանիտի	None
վրացիները	None
կառերեսեք	Second person Plural
կհպարտանաք	Second person Plural
չբեկանեինք	First person Plural
կշառաչեմ	First person Singular
չծպտվեր	Third person Singular
կատակերգությանդ	None
պայուսակների	None
չաբստրահի	Third person Singular
նախապայմանը	None
պոլիմերների	None
համոզեն	Third person Plural
չհիմնավորեմ	First person Singular
մեծատառի	None
կրծքի	None
կկատաղեի	First person Singular
կաղավաղեիր	Second person Singular
հրապուրեցիր	Second person Singular
բզզայինք	First person Plural
չհյուսեին	Third person Plural
չշպրտի	Third person Singular
հոշոտեինք	First person Plural
ջուլհակս	None
կխոպոպեմ	First person Singular
կվարեինք	First person Plural
չաղոթենք	First person Plural
գլտորեք	Second person Plural
կարմիրը	None
կուժերումս	None
չգլորեինք	First person Plural
շնորհներ	None
կինձերս	None
չարգահատեցին	Third person Plural
չկործեց	Third person Singular
վարակի	None
ավանդությունից	None
հենեցին	Third person Plural
եպերեիր	Second person Singular
կհաստատենք	First person Plural
համբուրի՛ր	Second person Singular
բացատները	None
չհեծար	Second person Singular
ցանկացան	Third person Plural
սալյամիումս	None
ավազուտների	None
կվերագրես	Second person Singular
չփախցնեք	Second person Plural
չշպրտեինք	First person Plural
կվրդովեմ	First person Singular
չխոսան	Third person Plural
անցգայացան	Third person Plural
կորեր	Third person Singular
քերականությամբ	None
հղփանայի	First person Singular
կօգտագործես	Second person Singular
կրի	Third person Singular
չգոլանանք	First person Plural
ջրանցքին	None
ղեկավարությունից	None
ճարտարապետություն	None
կշատանան	Third person Plural
կարմրանաս	Second person Singular
էյնշտեյնիումը	None
արքունիքից	None
գետակ	None
կագռավանաս	Second person Singular
կամավորներով	None
չլուցեցիք	Second person Plural
գոգեր	Third person Singular
չորբացաք	Second person Plural
լիզի	Third person Singular
չհատա	First person Singular
վիպասանը	None
կենդանակերպի	None
սերնդից	None
սնունդ	None
ազազե՛ք	Second person Plural
չսսկվեն	Third person Plural
կբաղբանջենք	First person Plural
նպաստեին	Third person Plural
չկախարդեի	First person Singular
մերկանաք	Second person Plural
դրսեւորես	Second person Singular
սպիտակուցում	None
սազում	None
չփոխանակեց	Third person Singular
կռացաք	Second person Plural
բաոբաբ	None
դատարկեն	Third person Plural
ամպերից	None
չմտաբերեիր	Second person Singular
չներխուժեցին	Third person Plural
հեծե՛ք	Second person Plural
չսանձես	Second person Singular
նախընտրեց	Third person Singular
բանամ	First person Singular
չբարբառեիր	Second person Singular
կատարեր	Third person Singular
փոխհատուցող	None
նյարդը	None
կկռվի	Third person Singular
ծածանե՛ք	Second person Plural
պահածոյացավ	Third person Singular
հոսեր	Third person Singular
կնվայի	First person Singular
չգարշեինք	First person Plural
մեղանչեցիր	Second person Singular
տափ	None
չքարշեցին	Third person Plural
եռաք	Second person Plural
դժբախտ	None
կհարգես	Second person Singular
խթեն	Third person Plural
կբուսնեմ	First person Singular
հերոսի	None
բաջաղեց	Third person Singular
մեծաբանեցի	First person Singular
զանգի	Third person Singular
վհատեցրիք	Second person Plural
չխրոխտանա	Third person Singular
գործոնից	None
ակնածեիք	Second person Plural
կվհատեցներ	Third person Singular
բացառեց	Third person Singular
կտարամիտեք	Second person Plural
կողոպտեցին	Third person Plural
ուղեկցեմ	First person Singular
ծծեինք	First person Plural
լամպոչկեն	None
կթաղենք	First person Plural
կաշկանդեինք	First person Plural
թմբլիկներումս	None
ահազանգեր	Third person Singular
կպղծես	Second person Singular
կշարունակեր	Third person Singular
իռլանդերենը	None
հաճախեն	Third person Plural
քերական	None
որմզդեղնը	None
չարածեք	Second person Plural
ճառագայթներից	None
չկտցեցինք	First person Plural
չանզգայացվի	Third person Singular
ֆրիզյանդ	None
կխռթանք	First person Plural
արդյունքներին	None
ստեղներով	None
չզանգեիր	Second person Singular
երկբայանայի	First person Singular
միջիններիդ	None
իսլամի	None
չբարբառեցիք	Second person Plural
կթի՛ր	Second person Singular
սպիտակուցներին	None
ստամոքսում	None
կազմակերպեին	Third person Plural
կտռեիք	Second person Plural
կեղծանենք	First person Plural
ոչխարը	None
ծանրությունը	None
դեզ	None
չբացատրեց	Third person Singular
բուսանեիք	Second person Plural
բուսանեց	Third person Singular
ֆրակներին	None
վախի	Third person Singular
թիթեղների	None
ագահեմ	First person Singular
կարբենա	Third person Singular
գլխարկներին	None
տոկա՛	Second person Singular
չկիսի	Third person Singular
գերդաստաններում	None
կթրծեր	Third person Singular
տերեփուկը	None
համբուրվել	None
ճանապարհորդեց	Third person Singular
չորանում	None
բեգեմոնդը	None
փչեն	Third person Plural
աքսորվեի	First person Singular
չհամոզեի	First person Singular
ցար	None
ապաշխարեի	First person Singular
չկարոտեմ	First person Singular
խածատեցինք	First person Plural
կափուլները	None
ջրամբարը	None
հեգի	Third person Singular
չհանգած	None
չհարթուկեցի	First person Singular
շչակներիս	None
հարվածից	None
ճայը	None
կծաղրեիք	Second person Plural
չակնածի	Third person Singular
չշտապեի	First person Singular
հրապուրեցինք	First person Plural
ոլորեինք	First person Plural
կհիմարացնես	Second person Singular
չկրծեք	Second person Plural
կազմակերպեն	Third person Plural
ահազանգեց	Third person Singular
արկդ	None
պահածոյանաս	Second person Singular
համոզի՛ր	Second person Singular
մտցրեց	Third person Singular
բողոքե՛ք	Second person Plural
չսանձեիք	Second person Plural
չծծեր	Third person Singular
չչարաշահեինք	First person Plural
հանգեց	Third person Singular
կվհատեցնեիք	Second person Plural
կքարոզեինք	First person Plural
չուսանեցիր	Second person Singular
կոշկակարի	None
չանզգայացնեի	First person Singular
չհրճվեցի	First person Singular
խրտնե՛ք	Second person Plural
աճպարարության	None
լրտեսների	None
հողդողդե՛ք	Second person Plural
չհեղես	Second person Singular
կփարթամանայի	First person Singular
ապահովեն	Third person Plural
կլքնեիր	Second person Singular
կհիմարացնեիր	Second person Singular
ամբարտավանեցիք	Second person Plural
հոգա	Third person Singular
շատով	None
չհուսահատվեմ	First person Singular
չքայլեն	Third person Plural
ուժեղացավ	Third person Singular
կհատուցես	Second person Singular
չվեցիք	Second person Plural
զարմանար	Third person Singular
չլվացվեր	Third person Singular
փչանամ	First person Singular
քամի	Third person Singular
զարմիկին	None
երկբայանաս	Second person Singular
չճվատեցիր	Second person Singular
տռենք	First person Plural
չկարմրացա	First person Singular
լուծի	Third person Singular
կխարխալեիր	Second person Singular
չտպեցինք	First person Plural
կփոխհատուցեր	Third person Singular
չգլտորեիք	Second person Plural
կաճեն	Third person Plural
փտեր	Third person Singular
միացե՛ք	Second person Plural
հայտնիներ	None
արգելքների	None
հմայեցին	Third person Plural
կարմրի	Third person Singular
չոգեշնչեցինք	First person Plural
կվռնդեր	Third person Singular
գրանցումը	None
բացառվի	Third person Singular
չշնորհեին	Third person Plural
շահագործենք	First person Plural
արածի	Third person Singular
կկկեմ	First person Singular
ածանցե՛ք	Second person Plural
փարթամանանք	First person Plural
մաղթեց	Third person Singular
չմերկանա	Third person Singular
կերկմտեիք	Second person Plural
մոռացա	First person Singular
հիմարացնեիք	Second person Plural
քայլեց	Third person Singular
չմերձեցաք	Second person Plural
ծղրտային	Third person Plural
կխթանի	Third person Singular
կմեղկանայիք	Second person Plural
փրթեի	First person Singular
լիգաներից	None
չապշենք	First person Plural
արդուկեց	Third person Singular
սպիրտներ	None
բնորոշեց	Third person Singular
ուրանաս	Second person Singular
կզրնգաս	Second person Singular
չկշռի	Third person Singular
բուսակեր	None
մտաբերեին	Third person Plural
պանծացին	Third person Plural
ալյանս	None
անհանգստանայիք	Second person Plural
բարձրաձայնի	Third person Singular
վարսակովս	None
չհպարտանայինք	First person Plural
չլրթանաս	Second person Singular
փորձեք	Second person Plural
ընդոստեցին	Third person Plural
շպռտեին	Third person Plural
զառամեմ	First person Singular
կօրհնեիր	Second person Singular
չճաքի	Third person Singular
չմտադրեի	First person Singular
կգերծեին	Third person Plural
չհասցնի	Third person Singular
չհյուսեց	Third person Singular
զգացմունքներից	None
հելնեինք	First person Plural
չլքեիր	Second person Singular
տարածությամբ	None
չխեղդեի	First person Singular
մխիթարեմ	First person Singular
չհալածեցին	Third person Plural
կնազես	Second person Singular
դատարկեցիք	Second person Plural
կագուցվեր	Third person Singular
հատնեիք	Second person Plural
կկարողանային	Third person Plural
թարգմանելու	None
լվանաս	Second person Singular
չկերտի	Third person Singular
չհարբենայիք	Second person Plural
քաղցի	Third person Singular
հուսալքեցին	Third person Plural
լուսանների	None
չսանրվես	Second person Singular
չկախի	Third person Singular
քցեցինք	First person Plural
հոտեինք	First person Plural
ֆեն	None
խորովի	Third person Singular
ենիչարս	None
երդվեի	First person Singular
չբխեցիր	Second person Singular
խնկեցիք	Second person Plural
քակորումս	None
չշիկացավ	Third person Singular
խորանում	None
տառապեինք	First person Plural
բացականչությունները	None
հրճվե՛ք	Second person Plural
խորդուբորդ	None
չկարոտեին	Third person Plural
կանգնեցիր	Second person Singular
ուսումնասիրեր	Third person Singular
հովիտներում	None
մեներգերի	None
փչացել	None
մարտիկների	None
փռշտա	Third person Singular
կագահանան	Third person Plural
տնօրինեք	Second person Plural
չկանչեինք	First person Plural
չսահմանեմ	First person Singular
հավաիի	None
լրատու	None
հավատան	Third person Plural
հետազոտեցիք	Second person Plural
չակնածեիր	Second person Singular
անճոռնու	None
լրտեսեցիր	Second person Singular
իսպաներենին	None
հատապտուղներով	None
չկարօտես	Second person Singular
պատուհաններով	None
չմեկնեցիք	Second person Plural
գլխացավ	None
չհածեին	Third person Plural
թաղեն	Third person Plural
ծածկեն	Third person Plural
կընկղմեր	Third person Singular
չարգելեիք	Second person Plural
կկատարեր	Third person Singular
չչվես	Second person Singular
չտեւեիք	Second person Plural
արդարացրեց	Third person Singular
կոլորեն	Third person Plural
կբաղձաս	Second person Singular
հարգե՛ք	Second person Plural
չհերքվեցիք	Second person Plural
խոցեր	Third person Singular
չհղանար	Third person Singular
չհավատացիք	Second person Plural
զուռնաներիցս	None
ստորագրի	Third person Singular
բաժանվեցինք	First person Plural
կլոգանար	Third person Singular
միջակետ	None
կայարանը	None
սաթեր	None
չգողանայի	First person Singular
զվարճացան	Third person Plural
սովորեն	Third person Plural
չհյուծեր	Third person Singular
զարթնի՛ր	Second person Singular
չաջակցեց	Third person Singular
ծնգցրի	First person Singular
բողոքարկելու	None
կուրախացնեիք	Second person Plural
գիտակցվե՛ք	Second person Plural
ամիրսպասալարը	None
հյուսեն	Third person Plural
չարկանեցիք	Second person Plural
կպանծան	Third person Plural
վերնագրերի	None
սննդի	None
ենիչարիիդ	None
անասնաբույժ	None
կկարմրանա	Third person Singular
համարեցիք	Second person Plural
բաժանումները	None
նեյտրինոների	None
չպայմանավորեի	First person Singular
շատացանք	First person Plural
թուլանան	Third person Plural
ծոծրակին	None
զվարճանքների	None
խածանելու	None
բանի	Third person Singular
գեղջուկ	None
ձագարների	None
արաբների	None
կշռելու	None
չհեգեցիր	Second person Singular
ամպ	None
ոգեշնչեցի	First person Singular
չսփոփվեիք	Second person Plural
պարտություն	None
մատուռում	None
փորձեմ	First person Singular
հեղափոխություններին	None
ստիպեց	Third person Singular
արդյունքը	None
չբաղխեր	Third person Singular
բնակվող	None
կբուսանենք	First person Plural
հոդի	None
չապացուցենք	First person Plural
չխնկեցին	Third person Plural
ործկայինք	First person Plural
չփարվեր	Third person Singular
առերեսեր	Third person Singular
կտակելու	None
հաստի՛ր	Second person Singular
շնորհեցին	Third person Plural
չզխկտեցիր	Second person Singular
չապահովես	Second person Singular
հորդենք	First person Plural
ընդգծեց	Third person Singular
հայհոյի	Third person Singular
չլքեցին	Third person Plural
խցիկի	None
նոյեմբերներիս	None
կգնեին	Third person Plural
հագնվեինք	First person Plural
հիրեցիք	Second person Plural
կբաղբաջեի	First person Singular
չերկայնես	Second person Singular
կոչմանը	None
պուրակով	None
տանջի	Third person Singular
թրի	Third person Singular
չցտեցիր	Second person Singular
ամուսնալուծությունը	None
գյուղի	None
չպաշտեն	Third person Plural
ապահովեք	Second person Plural
շեղջիդ	None
վարեցիր	Second person Singular
քառակուսիների	None
չքելեինք	First person Plural
խմբագրես	Second person Singular
հիրի	Third person Singular
պարտիքներով	None
սորեցին	Third person Plural
կհպարտանան	Third person Plural
կշշնջայի	First person Singular
կպատառեինք	First person Plural
չնեղանան	Third person Plural
բաոբաբները	None
վերծանեի	First person Singular
կքչքչան	Third person Plural
չտռզեցիր	Second person Singular
չհոտոտեցիք	Second person Plural
չկշռադատեիր	Second person Singular
մոռանան	Third person Plural
հերքեցին	Third person Plural
նքողեք	Second person Plural
ողորմե՛ք	Second person Plural
արտասովոր	None
չհորանջեցի	First person Singular
սրամտեին	Third person Plural
արտաքսեցի	First person Singular
սրճամաններովս	None
արձագանքեցին	Third person Plural
ատյանների	None
աքսորեցիր	Second person Singular
կնեխենք	First person Plural
վանկի	Third person Singular
զետեղեք	Second person Plural
չթրմեցիր	Second person Singular
կմաքրի	Third person Singular
սպիտակամորթները	None
գոլանային	Third person Plural
բացառությունները	None
կպահպանեինք	First person Plural
խածանեց	Third person Singular
ընդերքից	None
մալեր	Third person Singular
կոլորեի	First person Singular
կորոճաք	Second person Plural
իշխանություններից	None
չխածեի	First person Singular
սմարթֆոնը	None
կհասկանաք	Second person Plural
կկարեինք	First person Plural
իռացիոնալ	None
գլտոր	None
կտառադարձեի	First person Singular
տանջեցինք	First person Plural
խառնուրդից	None
կազմակերպության	None
բեկտեիր	Second person Singular
կհրկիզեն	Third person Plural
կխոպոպացվեիք	Second person Plural
պղծեիք	Second person Plural
չխեթացին	Third person Plural
մրցեմ	First person Singular
գրառի	Third person Singular
կծափահարվեին	Third person Plural
հնանայի	First person Singular
զեռամ	First person Singular
կփութացներ	Third person Singular
մոնոմերների	None
խոչընդոտներից	None
մրսեն	Third person Plural
կհուսալքես	Second person Singular
ուրացող	None
շողա	Third person Singular
կավերը	None
կհամեին	Third person Plural
վրդովի՛ր	Second person Singular
կեռաս	Second person Singular
վարաներ	Third person Singular
բուծեիր	Second person Singular
կընտրվենք	First person Plural
չկարեկցեց	Third person Singular
չծլեին	Third person Plural
չձաղկենք	First person Plural
արուներից	None
ծփեցի	First person Singular
քամեն	Third person Plural
կատենք	First person Plural
կխօսայիք	Second person Plural
հրապատերում	None
խնամեն	Third person Plural
զորահավաքը	None
սոուսի	None
հարբեր	Third person Singular
ընդոստեիք	Second person Plural
հառի՛ր	Second person Singular
մրմնջայինք	First person Plural
ժողովուրդները	None
քարտերից	None
չհարեիք	Second person Plural
չսանրվեց	Third person Singular
չկարողացավ	Third person Singular
ճշգրտեցին	Third person Plural
կտկռեր	Third person Singular
ծաղրեցիր	Second person Singular
փլվեցին	Third person Plural
ուղուց	None
չկանխամտածվեցիր	Second person Singular
ոխերիմ	None
չկցեք	Second person Plural
արթնացավ	Third person Singular
նավահանգիստներից	None
անձնագրերը	None
սպանեցին	Third person Plural
չխիթայի	First person Singular
պաշտեցիք	Second person Plural
չմեծանար	Third person Singular
ձայնարկություններ	None
մղձկա՛	Second person Singular
կշարժվես	Second person Singular
թլվատեր	Third person Singular
լիանար	Third person Singular
չխանձեցի	First person Singular
քավեցիք	Second person Plural
ախտորոշեմ	First person Singular
հասկանա	Third person Singular
վայելեցին	Third person Plural
կտղեցիր	Second person Singular
կհարբենայիր	Second person Singular
մարթի	Third person Singular
չխիթացիր	Second person Singular
կհասկանա	Third person Singular
մականունից	None
կպառկեր	Third person Singular
բասկետբոլ	None
կբացատրեինք	First person Plural
մատուռով	None
խոռոչին	None
կարհամարհեի	First person Singular
արմին	None
չարտագաղթեցի	First person Singular
բուսանեմ	First person Singular
մեծարեցինք	First person Plural
խանձենք	First person Plural
անդրանիկիս	None
սրտառի	Third person Singular
գոհարովդ	None
չզվարճանար	Third person Singular
գազանի	None
չխրտնի	Third person Singular
չշփեցինք	First person Plural
խաժում	None
հասցնելու	None
թանգարանների	None
քացին	None
վրդովվեց	Third person Singular
աբսորբի	Third person Singular
տեւել	None
չքարոզեին	Third person Plural
էրիկ	None
օգտագործի՛ր	Second person Singular
չզրուցեցին	Third person Plural
նավեինք	First person Plural
ցանկանան	Third person Plural
խածանեի	First person Singular
տոմար	None
կբզզան	Third person Plural
կլուծեն	Third person Plural
մագլցեցին	Third person Plural
բնութագրի՛ր	Second person Singular
խառնարանից	None
գթասիրտ	None
տուժվեմ	First person Singular
կհյուսեիք	Second person Plural
աղարտեիք	Second person Plural
կստամբակեինք	First person Plural
կբանեցնի	Third person Singular
կոճկեիք	Second person Plural
չվիճեք	Second person Plural
երկբայացե՛ք	Second person Plural
կհամառես	Second person Singular
հյուպատոսությունս	None
ծուխը	None
քրդերից	None
հուսահատ	None
թռնեին	Third person Plural
կառքերը	None
ըմպեցիք	Second person Plural
վհատեք	Second person Plural
կողր	None
ահաբեկվի՛ր	Second person Singular
կծափահարենք	First person Plural
քաբաբ	None
աղբանոցում	None
նավակը	None
չպատկերեց	Third person Singular
վարսին	None
մեկին	None
բարձրաձայնել	None
դատապարտեցի	First person Singular
զավթեց	Third person Singular
չմերկացող	None
վերընթերցեի	First person Singular
սպասասրահներդ	None
փքեք	Second person Plural
կընթանար	Third person Singular
կզավթես	Second person Singular
չնեղանայի	First person Singular
չշտկեն	Third person Plural
աղճատում	None
մոլեցինք	First person Plural
շպրտեմ	First person Singular
ագարակացրի	First person Singular
չէտեի	First person Singular
ոգեշնչեի	First person Singular
չսսկվեինք	First person Plural
նվագեցին	Third person Plural
նազեցիք	Second person Plural
մարտիկներին	None
չփայփայեինք	First person Plural
չպատկերեիք	Second person Plural
հագեն	Third person Plural
շարունակեն	Third person Plural
կզատես	Second person Singular
նախանձեիր	Second person Singular
չողբայինք	First person Plural
զվարճանալու	None
կարծեց	Third person Singular
չկտակեց	Third person Singular
չճամփեցինք	First person Plural
ընտրվեցիր	Second person Singular
քուղերը	None
չպոռոտախոսեցին	Third person Plural
հասկացար	Second person Singular
կանաչով	None
չմղձկենք	First person Plural
առկայծում	None
կխղճամ	First person Singular
չզառանցենք	First person Plural
քններ	Third person Singular
իտալացիներ	None
տեսիլքների	None
վերադառնանք	First person Plural
խոչընդոտներով	None
կգանգրանար	Third person Singular
կաբսորբենք	First person Plural
կապարներում	None
չկատարեցին	Third person Plural
կաճացներ	Third person Singular
կապացուցեն	Third person Plural
կբուսանեիր	Second person Singular
նիշերով	None
վերագրե՛ք	Second person Plural
ցտեիր	Second person Singular
պահածոյացաք	Second person Plural
հեծնենք	First person Plural
հմայում	None
ֆուտբոլասերիս	None
ագահանաց	Third person Singular
շահագործի	Third person Singular
ադրբեջաներենի	None
զրուցեք	Second person Plural
սաղացնեիր	Second person Singular
չճվատեն	Third person Plural
եփեք	Second person Plural
ալեկոծ	None
ապահովեցներ	Third person Singular
ծպտի՛ր	Second person Singular
երկով	None
կոսմոսին	None
չաղություններիս	None
չխօսէք	Second person Plural
շիթից	None
բարբառի	Third person Singular
ամայանամ	First person Singular
չզառանցեցիր	Second person Singular
չառերեսեի	First person Singular
կկռնչեմ	First person Singular
ավանին	None
քիմիայով	None
կընթանա	Third person Singular
աղբուտներում	None
կարծեք	Second person Plural
զանգեց	Third person Singular
թաքցնի	Third person Singular
չփլեինք	First person Plural
հերքած	None
թխկու	None
տենար	Third person Singular
յուղով	None
վախճանի	None
չզանգեք	Second person Plural
կհատակեիք	Second person Plural
արգելոցը	None
հիանեիր	Second person Singular
հոտոտեցի	First person Singular
ձախողակ	None
չմեղադրեր	Third person Singular
թրջած	None
չթրեցին	Third person Plural
փորձի	Third person Singular
բողոքարկեց	Third person Singular
չսանրես	Second person Singular
կատես	Second person Singular
չկրակեիք	Second person Plural
չարձագանքեցին	Third person Plural
չփողոտեմ	First person Singular
օսմանցիս	None
կսնգուրվեի	First person Singular
կարտագաղթեիք	Second person Plural
բաներ	Third person Singular
վերադառնային	Third person Plural
հեռացրին	Third person Plural
չսուզեց	Third person Singular
մաղթեցիր	Second person Singular
կպարտվես	Second person Singular
խոստումների	None
չցանկանան	Third person Plural
բդկեցիք	Second person Plural
կոչեց	Third person Singular
չլքեք	Second person Plural
կկարմրանայինք	First person Plural
դրացի	None
նետի՛ր	Second person Singular
բացառվեիր	Second person Singular
քարոզես	Second person Singular
չօժանդակեցին	Third person Plural
ռինգերի	None
կխոսայի	First person Singular
ընգար	Second person Singular
ներկայացնեին	Third person Plural
գրասենյակը	None
սփռեցիք	Second person Plural
ստեղնաշարը	None
հայուհու	None
բժիշկը	None
չսլանայիր	Second person Singular
կվանի	Third person Singular
չարգելեիր	Second person Singular
թաիով	None
կնիքները	None
արձագանքի՛ր	Second person Singular
չցանկացան	Third person Plural
ծպտեն	Third person Plural
անձերից	None
որսացի	First person Singular
ապստամբի	Third person Singular
էղնեին	Third person Plural
կացարանում	None
քունեցի	First person Singular
չդրսեւորվեք	Second person Plural
շիկացե՛ք	Second person Plural
կանչեցի	First person Singular
սադրող	None
շնորհավորանքներս	None
կհայթայթեիր	Second person Singular
չխազեր	Third person Singular
բղավեցի	First person Singular
ոգեմ	First person Singular
արշալույս	None
կկարծեիք	Second person Plural
կխոպոպվեր	Third person Singular
հագնի	Third person Singular
կանչել	None
թքեցի	First person Singular
չընտրվեց	Third person Singular
մալերի	None
մնացորդների	None
հրճվեմ	First person Singular
կրեք	Second person Plural
չամուսնացրին	Third person Plural
բնագրերումդ	None
հետեւեցինք	First person Plural
գոհանամ	First person Singular
վերադարձի՛ր	Second person Singular
այծքաղ	None
չփրթեց	Third person Singular
ազդվի	Third person Singular
խնամի՛ր	Second person Singular
տոկայի	First person Singular
չհիասթափվեք	Second person Plural
էթան	Third person Plural
կկռկռաս	Second person Singular
քունե՛ք	Second person Plural
չառերեսեր	Third person Singular
երեւան	Third person Plural
հաղթակամարի	None
էստոներենի	None
չսրճեինք	First person Plural
փողոտեցինք	First person Plural
կռնչեմ	First person Singular
կբացառեինք	First person Plural
ճայս	None
չծածկես	Second person Singular
չուրախացնես	Second person Singular
պատուհան	None
չհղեր	Third person Singular
կպապանձեցներ	Third person Singular
սանրվեմ	First person Singular
ախտորոշի	Third person Singular
հաստատեիր	Second person Singular
չհետեւի	Third person Singular
վոլֆրամը	None
սիգ	None
խելացիովդ	None
չտեղեկանային	Third person Plural
ոռի	None
կեղծես	Second person Singular
կհարեի	First person Singular
հաշվիչների	None
չհամեմ	First person Singular
խոյանամ	First person Singular
ագռավացի՛ր	Second person Singular
բակտերիայի	None
չհամաձայնեց	Third person Singular
ծանծաղիցս	None
կմեծարի	Third person Singular
շարունակում	None
ոգ	None
չչվի	Third person Singular
չհեգեի	First person Singular
չխոյացան	Third person Plural
այցելեն	Third person Plural
ձեռնաշարժության	None
կպապանձեցնեի	First person Singular
չտեղեկացնենք	First person Plural
չգլորես	Second person Singular
գուրգուրացիր	Second person Singular
կդրվատեի	First person Singular
բանում	None
հասունս	None
լծեն	Third person Plural
կանգնեց	Third person Singular
կտրոհեին	Third person Plural
չսիրվեինք	First person Plural
չաբստրահվեմ	First person Singular
չխեթկես	Second person Singular
շենքի	None
չմտադրեմ	First person Singular
վախենա	Third person Singular
ասպետ	None
համոզել	None
մերձավորները	None
կանձրեւեիր	Second person Singular
ծագումը	None
հարգեք	Second person Plural
թամաշայումդ	None
զանգեր	Third person Singular
արգելեցին	Third person Plural
չկարոտեցիք	Second person Plural
սպանենք	First person Plural
չխորխեիք	Second person Plural
կավելացնեի	First person Singular
խնձորները	None
ավելացրին	Third person Plural
կլուտային	Third person Plural
բարձրաձայնեն	Third person Plural
կփայփայեր	Third person Singular
կհելնեն	Third person Plural
սերբերենը	None
կսառեի	First person Singular
կսաղացնեք	Second person Plural
կարդարացնես	Second person Singular
կմածվեիր	Second person Singular
աստղաբույլը	None
ժամանումը	None
կործանես	Second person Singular
բուծանեք	Second person Plural
տշի	Third person Singular
լեռնագրություններովդ	None
զննեիք	Second person Plural
անձրեւի	Third person Singular
հերքես	Second person Singular
ողորկում	None
ըմպեցի	First person Singular
աշխատի՛ր	Second person Singular
գովելու	None
ստորագրեք	Second person Plural
շարունակեցին	Third person Plural
զառամի	Third person Singular
մատուցեն	Third person Plural
արարողությունում	None
կռվեցին	Third person Plural
քայլեր	Third person Singular
թիթեռնիկների	None
կվերադառնա	Third person Singular
բացառվեմ	First person Singular
գլեն	Third person Plural
չհմայեցի	First person Singular
կճամփեիք	Second person Plural
կարողանայիք	Second person Plural
հարգեցի	First person Singular
ծաղրի՛ր	Second person Singular
չստրկացնես	Second person Singular
պատվերից	None
կգլդորեինք	First person Plural
չշնչեմ	First person Singular
չորումդ	None
ջրամբարներում	None
հանրախանութ	None
մալի	Third person Singular
գլուխ	None
չբանեցրիք	Second person Plural
կարաոկե	None
բրետոներենումս	None
ուսուցանեք	Second person Plural
չարտաքսես	Second person Singular
հաճարենու	None
տանկ	None
լողանային	Third person Plural
ճկեմ	First person Singular
կարենան	Third person Plural
կճաքեիք	Second person Plural
կորի	Third person Singular
չողջագուրի	Third person Singular
կկշռադատեք	Second person Plural
չտառապեցրիք	Second person Plural
ծաղրով	None
կներքինացնենք	First person Plural
հացադուլը	None
չազդեցին	Third person Plural
վիճաբանեցիր	Second person Singular
կրեմ	First person Singular
չճախրեիք	Second person Plural
աղտովս	None
համաձայնեց	Third person Singular
արածեցրի	First person Singular
չվհատեինք	First person Plural
աշխատես	Second person Singular
երկնակամարներումս	None
լուսատտիկ	None
կբեկտեք	Second person Plural
հավասարումներում	None
չձուլեցին	Third person Plural
կոշկոճեի	First person Singular
բողոճիցս	None
չստրկացրիր	Second person Singular
բրետոներեն	None
կարմիրների	None
ջրամբարից	None
չվռնդեցիք	Second person Plural
կեռային	Third person Plural
ակնաղբյուրի	None
շնորհած	None
հեգնե՛ք	Second person Plural
խոպոպիկիդ	None
առողջարանում	None
անգերի	None
չամբարտավանացավ	Third person Singular
տրամադրեր	Third person Singular
կմատնեիք	Second person Plural
թրջեցիք	Second person Plural
ագահդ	None
չչվեցի	First person Singular
չուռչեցիք	Second person Plural
խմեմ	First person Singular
չկայանայի	First person Singular
մտաբերեցիք	Second person Plural
կասկածեցին	Third person Plural
կհատի	Third person Singular
քարշեն	Third person Plural
շամբուտիդ	None
շենքեր	None
չշարունակեցինք	First person Plural
չնիրհեցի	First person Singular
պապանձվեցիր	Second person Singular
առողջարաններում	None
չհասցրի	First person Singular
կխափաներ	Third person Singular
լացով	None
տձեւումդ	None
չոռոգեցին	Third person Plural
շտապեք	Second person Plural
կախարդվեմ	First person Singular
կամենար	Third person Singular
չսրտառեիր	Second person Singular
չքունեն	Third person Plural
պետը	None
քայլերգի	None
ընթեռնեն	Third person Plural
չսադրեմ	First person Singular
կսպասարկեք	Second person Plural
խոստանում	None
լոգարիթմներ	None
խարխալեիք	Second person Plural
չսադրի	Third person Singular
հարսնանային	Third person Plural
փնտրեն	Third person Plural
ընթացան	Third person Plural
ածխաթթու	None
կկծեիք	Second person Plural
հառնեն	Third person Plural
հաշվից	None
կշիկանա	Third person Singular
առաքյալները	None
կուժեղանամ	First person Singular
պահպաներ	Third person Singular
չճողոպրեինք	First person Plural
կանչեցին	Third person Plural
կստուգես	Second person Singular
պարգեւեցին	Third person Plural
հեղեղես	Second person Singular
զառամեց	Third person Singular
գանգրվում	None
չբխեցին	Third person Plural
կտարակուսի	Third person Singular
ուսումնասիրի	Third person Singular
գլդորեցիր	Second person Singular
շիկնի	Third person Singular
կողմնակի	None
դդումներս	None
հնդկընկույզներիդ	None
չխոպոպացվեն	Third person Plural
նիշերը	None
չբնորոշեին	Third person Plural
մղեցին	Third person Plural
կոտորակները	None
կարողանամ	First person Singular
աջակցեր	Third person Singular
հարթուկեմ	First person Singular
աղանդերներին	None
վարդապետները	None
կարմրանար	Third person Singular
պարապի	Third person Singular
մեղադրեն	Third person Plural
կառաջադիմեք	Second person Plural
չխոպոպեցրիր	Second person Singular
հրեք	Second person Plural
ֆոտոններդ	None
աղատենք	First person Plural
փլած	None
կզգածվեինք	First person Plural
տեւողություններումս	None
մեծարես	Second person Singular
խմեց	Third person Singular
ներխուժի	Third person Singular
մասնիկը	None
չհմայեցիք	Second person Plural
տնակի	None
կրաքարերից	None
թեշիկները	None
ճարտարապետությունում	None
ճարտար	None
կոսմոպոլիտություններումդ	None
միանա	Third person Singular
ընդգծեցին	Third person Plural
կուսումնասիրեմ	First person Singular
բկի	None
չօթեր	Third person Singular
չվռնդեք	Second person Plural
չառողջացնի	Third person Singular
ազդի	Third person Singular
ագարականայինք	First person Plural
խաղաթղթերի	None
հարգի՛ր	Second person Singular
կայսրությունների	None
հայեր	Third person Singular
կծնեիք	Second person Plural
չհայեցիք	Second person Plural
սորացիք	Second person Plural
չարախոսներից	None
չկոշկոճեք	Second person Plural
չսառեին	Third person Plural
չշնորհեն	Third person Plural
չշիկնեմ	First person Singular
հետազոտողի	None
չղջիկների	None
կստուգեր	Third person Singular
ճկեցիր	Second person Singular
չքցեմ	First person Singular
կուսակցությունումդ	None
չճշգրտես	Second person Singular
կախեցին	Third person Plural
չոռոգեի	First person Singular
ծնվեցի	First person Singular
գործարկեիր	Second person Singular
ճկեր	Third person Singular
սպանել	None
կաճացնեինք	First person Plural
կգանգրանաք	Second person Plural
համեմունք	None
ճանապարհորդություններ	None
գանգրացվեմ	First person Singular
կշշնջաս	Second person Singular
չուսուցանենք	First person Plural
չօգտագործեցինք	First person Plural
լուծեցի	First person Singular
վախեցավ	Third person Singular
կաչաղակները	None
բանեցնես	Second person Singular
պարտեզներով	None
լճում	None
չնվացինք	First person Plural
կհեղեք	Second person Plural
քանորդը	None
չտեսնայինք	First person Plural
չճմռթեիք	Second person Plural
չտրոհեցիք	Second person Plural
չսնգուրվեցիք	Second person Plural
հատուցեցին	Third person Plural
կվախենաք	Second person Plural
դրսեւորվեն	Third person Plural
մարշրուտս	None
վարան	None
խաշը	None
կճոռոմաբանեինք	First person Plural
կպոռոտաբանեի	First person Singular
պատկանում	None
կխարխլեիք	Second person Plural
չկարեք	Second person Plural
չհիմարացնենք	First person Plural
չգանգրվեք	Second person Plural
կսազի	Third person Singular
չխոպոպեցրիք	Second person Plural
թենիսիստուհուն	None
կմահանար	Third person Singular
կառավարություններում	None
պատմություն	None
չխածնեիք	Second person Plural
կվախենամ	First person Singular
վիրակապը	None
վուշեր	None
հալածեն	Third person Plural
փտեցիք	Second person Plural
վաճառեին	Third person Plural
օդաչուներ	None
չապահովեցնեինք	First person Plural
չեփեցիք	Second person Plural
փրփրալ	None
մաքսի	None
կարտաքսեք	Second person Plural
հովազ	None
թրջեցիր	Second person Singular
հասցեներով	None
չհանգես	Second person Singular
թելադրիչդ	None
չսանձեց	Third person Singular
շալվարի	None
կասկածվել	None
կաբստրահեիր	Second person Singular
կայարանից	None
չխոթեցին	Third person Plural
կզգածվեք	Second person Plural
ուղղափառություն	None
գողացան	Third person Plural
ֆենը	None
աղա	Third person Singular
երթանք	First person Plural
կտարբերեի	First person Singular
կքավենք	First person Plural
գրադարձենք	First person Plural
կհեգես	Second person Singular
պատրաստենք	First person Plural
քայլեին	Third person Plural
երկբարբառի	None
կթաքչեր	Third person Singular
օգոստոսից	None
նկարից	None
կկենդանանային	Third person Plural
բաղբաջեինք	First person Plural
գնեն	Third person Plural
զանգենք	First person Plural
կներխուժեիր	Second person Singular
աստվածեղեններիս	None
ներքինացնեին	Third person Plural
հայթայթեն	Third person Plural
փոխում	None
կոլորեիր	Second person Singular
տեսքովս	None
բռնաբարես	Second person Singular
երգիծե՛ք	Second person Plural
չձաղկեն	Third person Plural
խալիֆայությունում	None
անիծեցինք	First person Plural
մեկնող	None
սրճեցի	First person Singular
չպոռոչեցինք	First person Plural
նախարարների	None
լուծեց	Third person Singular
ճնշմամբ	None
սխալվեցի	First person Singular
սորեիր	Second person Singular
ծովագնացի	None
կոռոգեիր	Second person Singular
չվախեի	First person Singular
ցախից	None
արկեցին	Third person Plural
հիմունքով	None
չբողոքեցիք	Second person Plural
սրի	None
չդայլայլեին	Third person Plural
խոցեց	Third person Singular
կկլանեք	Second person Plural
վարպետներին	None
փրփրայի	First person Singular
շվեդական	None
հղեցին	Third person Plural
հասկացավ	Third person Singular
կպոռոտաբանեիք	Second person Plural
կիբեռնետիկայի	None
ստեր	Third person Singular
ֆիզիկականը	None
կցտի	Third person Singular
կիսի	Third person Singular
կշարունակի	Third person Singular
ճշգրտեն	Third person Plural
չհայհոյեմ	First person Singular
կկերակրենք	First person Plural
կկակազեմ	First person Singular
մետաղից	None
կկատակեիր	Second person Singular
վերադառնամ	First person Singular
քամովդ	None
կանխամտածեր	Third person Singular
գնի	Third person Singular
չփորձեց	Third person Singular
բանեմ	First person Singular
կոտրում	None
հալածանքին	None
գարեջրով	None
էվոլյուցիոնին	None
կնավեիր	Second person Singular
բնակվեն	Third person Plural
սառչեցիր	Second person Singular
թլվատեցինք	First person Plural
չմատչեք	Second person Plural
չօծեին	Third person Plural
սանդուղքը	None
ուղղություններին	None
կհառաչեք	Second person Plural
խարխալեի	First person Singular
կծնեին	Third person Plural
քանակները	None
չցավացիք	Second person Plural
չշփենք	First person Plural
կհարկանեն	Third person Plural
խմբագրեցին	Third person Plural
կբողոքարկենք	First person Plural
սադրենք	First person Plural
թուլացավ	Third person Singular
շղթայում	None
հայտարարեցին	Third person Plural
հրահրեիր	Second person Singular
բխեցի	First person Singular
կլուծեմ	First person Singular
կտուրներով	None
չկրակեինք	First person Plural
կկախեիք	Second person Plural
չքրթմնջացիք	Second person Plural
այգեպանի	None
տրամադրեցիք	Second person Plural
տվյալների	None
փռթկացրեց	Third person Singular
ճեմեմ	First person Singular
չզղջա	Third person Singular
չհամառեիք	Second person Plural
լեռնագնացների	None
խմբագրեց	Third person Singular
զբոսանավ	None
գրառեցին	Third person Plural
ուղարկեի	First person Singular
չարտագաղթեիր	Second person Singular
հանձնեին	Third person Plural
լուտացինք	First person Plural
կնավեն	Third person Plural
վիրակապդ	None
կփայլունանամ	First person Singular
կկարծեմ	First person Singular
շարժիչներով	None
կվարանեի	First person Singular
պարգեւած	None
չսավառնեինք	First person Plural
չկտղեինք	First person Plural
կփսխեինք	First person Plural
կոմունիստների	None
գոնադովս	None
արջերի	None
կաղանք	First person Plural
կբաղձանք	First person Plural
համեմ	First person Singular
քարոզեցի	First person Singular
չխորխեցիր	Second person Singular
չհեղեղենք	First person Plural
հալածեց	Third person Singular
կբողոքեինք	First person Plural
բողբոջի	Third person Singular
դարբնենք	First person Plural
կհավելեն	Third person Plural
մեղադրեցին	Third person Plural
շատի	None
սուզեցի	First person Singular
չգիշատեիր	Second person Singular
վարի	Third person Singular
տկռեի	First person Singular
ծնելիս	None
չընտրվի	Third person Singular
կքրթմնջայինք	First person Plural
ագուցվեցի	First person Singular
կիզի	Third person Singular
գարշեն	Third person Plural
երկարությանը	None
յոդեր	None
անկարելի	None
չշողայի	First person Singular
չմեղադրեն	Third person Plural
կսիկտիրվենք	First person Plural
թուրմ	None
ուղեկցեինք	First person Plural
ատեր	Third person Singular
գուրա	Third person Singular
չշպռտեց	Third person Singular
պալադիումը	None
պարտվեիր	Second person Singular
կփչես	Second person Singular
վիճակից	None
ծնվե՛ք	Second person Plural
հյուծեց	Third person Singular
մղձկենք	First person Plural
լոուրենսիում	None
տգետ	None
առաջադրանքում	None
չհարսնացնեք	Second person Plural
կգրադարձեն	Third person Plural
փրփրան	Third person Plural
պարապեիր	Second person Singular
կուսանեի	First person Singular
պատառեիք	Second person Plural
զննել	None
գործադուլները	None
մեծաբանեիր	Second person Singular
չշահագործեցինք	First person Plural
չխարխլեցիր	Second person Singular
օղողի	Third person Singular
մերձեցավ	Third person Singular
զավթեք	Second person Plural
զեբրերը	None
ապագաներին	None
ջինջիլովս	None
չթվարկի	Third person Singular
պատգամի	None
ճկունությամբ	None
չքչքչացիր	Second person Singular
ապահովվի	Third person Singular
ընկույզներով	None
թարգմանե՛ք	Second person Plural
լրտեսի	Third person Singular
չսփոփեր	Third person Singular
ճախրեցին	Third person Plural
չաղատեինք	First person Plural
կհիասթափեցնեին	Third person Plural
սովորեր	Third person Singular
կտոկամ	First person Singular
զամբիկներիդ	None
չտրցակեցինք	First person Plural
չճամփեցին	Third person Plural
աշխատեն	Third person Plural
մրցակից	None
կըլնեինք	First person Plural
զարմանան	Third person Plural
օմանյանների	None
մարգարինի	None
խայթում	None
էտում	None
շուկաներից	None
չմնչեի	First person Singular
էլիպսս	None
արտոնագիր	None
քյոխվայի	None
չմալեցին	Third person Plural
ներկայացրին	Third person Plural
տպեց	Third person Singular
չխօսան	Third person Plural
չշնչեցինք	First person Plural
բանա	Third person Singular
բաժանվեցին	Third person Plural
կփոխհատուցես	Second person Singular
գլուխներ	None
կգոչեին	Third person Plural
կանխենք	First person Plural
չբարեւեինք	First person Plural
չմտցրեց	Third person Singular
կհմայեիր	Second person Singular
թրի՛ր	Second person Singular
ներխուժեցիր	Second person Singular
չխափանեմ	First person Singular
կերեւա	Third person Singular
ահագնանաք	Second person Plural
խեղդեց	Third person Singular
խառնած	None
ավելացնել	None
տառապեց	Third person Singular
փոխարիներ	Third person Singular
որջ	None
կանխեն	Third person Plural
զբոսանավերում	None
հետազոտողներ	None
ահաբեկվենք	First person Plural
մերկանանք	First person Plural
հատնեին	Third person Plural
կեղեցի	First person Singular
փոխարինելու	None
կհամարեն	Third person Plural
հորիզոնումդ	None
աքսորեց	Third person Singular
կածանցեինք	First person Plural
կերակուրների	None
հարկադրեր	Third person Singular
օդակայաններովս	None
ծաղկաման	None
չտրցակեի	First person Singular
փոխարինեք	Second person Plural
կջեռուցեին	Third person Plural
չհղենա	Third person Singular
կեռասովս	None
ժամանակաշրջաններին	None
իսպաներենի	None
անորոշանան	Third person Plural
չհաստատեց	Third person Singular
կռկռացի	First person Singular
հեղաշրջումից	None
հղիանայինք	First person Plural
տորթեր	None
խոսաք	Second person Plural
չանզգայանայիր	Second person Singular
քշող	None
կկեղեիր	Second person Singular
պապանձեցնեիք	Second person Plural
բզզացե՛ք	Second person Plural
փական	None
չսպանեց	Third person Singular
մեծաբանեիք	Second person Plural
հանցագործ	None
չկասկածեց	Third person Singular
թքես	Second person Singular
չգարշեմ	First person Singular
աճի	Third person Singular
կիրառի	Third person Singular
չհարբենայինք	First person Plural
թրեր	Third person Singular
չերեւան	Third person Plural
համել	None
վալսդ	None
հնացի՛ր	Second person Singular
չհամբուրես	Second person Singular
նահանգներում	None
չթարգմանեցի	First person Singular
վճռվել	None
կհագնես	Second person Singular
չհամոզեցիր	Second person Singular
ահաբեկչին	None
սամարիում	None
կնքողեին	Third person Plural
հաստատի	Third person Singular
կանխամտածեցի	First person Singular
կմեղադրեի	First person Singular
մաստակ	None
ակութներով	None
միջատներ	None
սեքսից	None
չակերտներ	None
երկնչել	None
պագեին	Third person Plural
թաթարերեն	None
քանդի	Third person Singular
մտադրություններից	None
նախընտրեն	Third person Plural
պառկի	Third person Singular
չերդվեց	Third person Singular
ձվարաններում	None
փարթիով	None
կնիրհեք	Second person Plural
առասպելի	None
չամորձատեմ	First person Singular
կկրակեք	Second person Plural
որոճեի	First person Singular
բխեիք	Second person Plural
լամպին	None
բողոքեցինք	First person Plural
հանդեսները	None
կույտի	None
չերկայնեիք	Second person Plural
սառչող	None
տաբու	None
զուգահեռագծերը	None
կվհատեք	Second person Plural
վանկե՛ք	Second person Plural
չկռթնեին	Third person Plural
մակեդոնացու	None
չհղացավ	Third person Singular
կսադրեիր	Second person Singular
մաքրեն	Third person Plural
ֆիլմերին	None
չգուրամ	First person Singular
լրջանաք	Second person Plural
փուլերի	None
կարողանանք	First person Plural
կփայլունացներ	Third person Singular
չքայլեցիր	Second person Singular
կարողանաք	Second person Plural
փաստաթուղթը	None
ընթերցումից	None
չսփոփեցինք	First person Plural
կտարածեն	Third person Plural
ստամբակեինք	First person Plural
կէտի	Third person Singular
հաճար	None
մօտենայ	Third person Singular
ապահովացա	First person Singular
դեղատնից	None
շեշտել	None
հայդուկականումդ	None
անդամով	None
ջայնիզմում	None
կտուց	None
կսավառնեին	Third person Plural
չգելենք	First person Plural
կկեղեք	Second person Plural
կեպերեք	Second person Plural
կլկստվեիք	Second person Plural
լքնի	Third person Singular
խրթեցիք	Second person Plural
բանաստեղծները	None
կուզեին	Third person Plural
հուսահատեցնես	Second person Singular
չկտցեինք	First person Plural
կխոխոջամ	First person Singular
հեռացրի	First person Singular
հնոց	None
հարկադրեցին	Third person Plural
հեգերովդ	None
տուժեցինք	First person Plural
չանձրեւի	Third person Singular
մեղադրեց	Third person Singular
նեղանամ	First person Singular
արքունիքին	None
հղացել	None
փոխհատուցեիր	Second person Singular
շարունակեց	Third person Singular
արձագանքեն	Third person Plural
չփռթկացնեին	Third person Plural
խմածներիցդ	None
լոգանքի	None
հրամայեցին	Third person Plural
չմրսեիր	Second person Singular
կծնվեք	Second person Plural
ուսանեցիր	Second person Singular
հավատների	None
չկիզեցինք	First person Plural
չկարողանայիր	Second person Singular
փախստականներից	None
ծանուցումներ	None
չագուցահանեն	Third person Plural
չթոթովես	Second person Singular
մաքրեց	Third person Singular
քերում	None
խառնեն	Third person Plural
անձրեւեիք	Second person Plural
խոցերի	None
խոյացա	First person Singular
հոխորտանք	First person Plural
չլքեցի	First person Singular
փախցնես	Second person Singular
կսովորեիր	Second person Singular
թարգմանեցին	Third person Plural
չպատկանեի	First person Singular
տարբերե՛ք	Second person Plural
քսենոն	None
փայլունացվի՛ր	Second person Singular
բարելավեց	Third person Singular
տրոհեր	Third person Singular
կջեռուցենք	First person Plural
աճուրդներ	None
գայթակղելու	None
կկարողանան	Third person Plural
չսաղացրինք	First person Plural
հարությունից	None
պատառեցին	Third person Plural
վաղորդյան	None
կբացառեիք	Second person Plural
տեսախցիկով	None
չմոգոնեիր	Second person Singular
նախանձեց	Third person Singular
մկաններով	None
կաղավաղեինք	First person Plural
չմղձկեին	Third person Plural
կուզեն	Third person Plural
բլրին	None
ընթացել	None
երթար	Third person Singular
կխռթայիք	Second person Plural
վարչապետների	None
չսարսափեիր	Second person Singular
չանկանեի	First person Singular
կթրծեին	Third person Plural
վիճաբանեցինք	First person Plural
սնգուրեցին	Third person Plural
կմահանա	Third person Singular
քավե՛ք	Second person Plural
բավարարեցիր	Second person Singular
ճաշակից	None
կխառնեք	Second person Plural
ներկայացնեն	Third person Plural
ալյանսը	None
կապահովեցնեիք	Second person Plural
ոսկոր	None
կշարունակեմ	First person Singular
կսլանայինք	First person Plural
քշեց	Third person Singular
պաճուճաբանին	None
բոզոնը	None
կհիանի	Third person Singular
անկաշկանդ	None
աղային	Third person Plural
մուրճերով	None
ազդվեցինք	First person Plural
չմարթեին	Third person Plural
ցավայիք	Second person Plural
տաշի	None
բացատրելիս	None
ընդելուզե՛ք	Second person Plural
միկրոօրգանիզմներից	None
կփարվեմ	First person Singular
գրգռեիք	Second person Plural
կսսկվեինք	First person Plural
դրդեցին	Third person Plural
հետազոտեց	Third person Singular
համոզեր	Third person Singular
շուրթերը	None
փախուստից	None
կցտեր	Third person Singular
զատենք	First person Plural
ծլարձակես	Second person Singular
խոպոպանայի	First person Singular
սնդուկ	None
լծի	Third person Singular
մամուռներում	None
հերոսից	None
բանտարկությունների	None
սովորույթով	None
կաշխատես	Second person Singular
խթանեցին	Third person Plural
վարսակաշիլադ	None
նեխեի	First person Singular
լուծեր	Third person Singular
արտասահմանի	None
չկազմակերպեցինք	First person Plural
քավ	None
կբդկես	Second person Singular
չփրփրաց	Third person Singular
վանում	None
կարբի	Third person Singular
չգուրգուրաք	Second person Plural
ճառեր	None
խորովեմ	First person Singular
հետեւի	Third person Singular
հարկադրեցինք	First person Plural
զետեղեիք	Second person Plural
պատգամավորացուներիս	None
կպոռոտախոսեիք	Second person Plural
կիսեցին	Third person Plural
կհամբերեր	Third person Singular
խափանեցին	Third person Plural
կարդուկեինք	First person Plural
օճառով	None
կուզեիք	Second person Plural
ուռչե՛ք	Second person Plural
չշփոթեի	First person Singular
սովորի	Third person Singular
հեշտոցում	None
փորսուղին	None
չշարունակեմ	First person Singular
չկալես	Second person Singular
մեծաբանեին	Third person Plural
թվարկել	None
չչորանար	Third person Singular
ալեկոծենք	First person Plural
կթեմ	First person Singular
կլանեինք	First person Plural
կընթեռնեք	Second person Plural
հավաքույթովդ	None
պագի	Third person Singular
չնվաղեիք	Second person Plural
կհերքվենք	First person Plural
շաչեցի	First person Singular
դառն	None
ֆոյեներ	None
հրապուրեցիք	Second person Plural
խթանած	None
ագրեգատավորի	Third person Singular
կազմին	None
նիրհեք	Second person Plural
խիզախը	None
չպղծեց	Third person Singular
սազը	None
բանեցին	Third person Plural
չճողոպրեցիք	Second person Plural
չսորաց	Third person Singular
չհետազոտեինք	First person Plural
չփորի	Third person Singular
կմրցեինք	First person Plural
ապահովացնեին	Third person Plural
նիստեր	None
հրթիռ	None
չարյունահոսեր	Third person Singular
մոռանանք	First person Plural
առաջադրանքներիդ	None
կկասկածեր	Third person Singular
կցավեն	Third person Plural
գգվեցին	Third person Plural
մատներ	Third person Singular
զանգահարեն	Third person Plural
տեսնամ	First person Singular
քաղաքացիությունում	None
կնպաստեր	Third person Singular
կգովեի	First person Singular
հատակի	Third person Singular
մտմտայի	First person Singular
վագրակատուն	None
կկիրառեմ	First person Singular
մղձկայինք	First person Plural
թոքը	None
ապուրով	None
ճամփեց	Third person Singular
կատաղեց	Third person Singular
բաժանվեն	Third person Plural
կապստամբեմ	First person Singular
ահաբեկչությանը	None
կպատրաստեն	Third person Plural
կճաշեն	Third person Plural
չսաղացրիք	Second person Plural
կկռթնեիր	Second person Singular
համեր	Third person Singular
չփոխհատուցեց	Third person Singular
կհափափեր	Third person Singular
առապարի	None
չագուցավորեցինք	First person Plural
կվրդովեիք	Second person Plural
պոռոչեցինք	First person Plural
կդողայի	First person Singular
չհասկացա	First person Singular
համակարգեր	Third person Singular
սահմանեցին	Third person Plural
ճաշեցին	Third person Plural
խաղողներիս	None
սուպերմարկետ	None
ծլարձակեցիք	Second person Plural
ծնգցրե՛ք	Second person Plural
կներքինանան	Third person Plural
չշփեինք	First person Plural
կշռի՛ր	Second person Singular
չառողջացնեիք	Second person Plural
սոցիալիզմի	None
չմիզեր	Third person Singular
մոտեցնեք	Second person Plural
գրանցման	None
թանձր	None
լայնը	None
վարած	None
օդանավի	None
փամփուշտների	None
բախումները	None
մղես	Second person Singular
պարտավորություններից	None
մտցրին	Third person Plural
խելագար	None
մեծացավ	Third person Singular
լրջացար	Second person Singular
կամուսնացնես	Second person Singular
ծնգցնեիք	Second person Plural
փոխարինող	None
ստեմ	First person Singular
փոխառության	None
զարմացա	First person Singular
չճողոպրեցիր	Second person Singular
սաղս	None
հայտարարությանդ	None
հրավերի	None
չորոճացի	First person Singular
գոյանալ	None
լրջանա	Third person Singular
ծիլերի	None
կլրտեսեի	First person Singular
չխազեի	First person Singular
չորս	None
կգնահատեմ	First person Singular
չհակազդեինք	First person Plural
կփախնեմ	First person Singular
տենչա	Third person Singular
ենթամնան	None
դատարկեք	Second person Plural
կառավարություններին	None
բարբանջենք	First person Plural
չգանգրացվեցինք	First person Plural
չզվարճացրիր	Second person Singular
ապենինյաններովս	None
գողանա	Third person Singular
զվարճացավ	Third person Singular
փչանայի	First person Singular
կերգիծեիր	Second person Singular
լքեիք	Second person Plural
քննեք	Second person Plural
տեղեկությունների	None
չթլփատեր	Third person Singular
չհալեցիր	Second person Singular
կենդանաբանները	None
կհենեն	Third person Plural
չբնութագրեինք	First person Plural
բացատրեց	Third person Singular
շպրտեց	Third person Singular
չմեղկացան	Third person Plural
ստրկացրիք	Second person Plural
կփայլատակենք	First person Plural
կփլվեիք	Second person Plural
ենթարկեց	Third person Singular
ավելացրեց	Third person Singular
հակազդեինք	First person Plural
կկթենք	First person Plural
մեծանան	Third person Plural
գնդակահարությունից	None
կատիոնումս	None
ուսումնասիրենք	First person Plural
կանչեն	Third person Plural
կպոռոչեմ	First person Singular
կհամակարգեիք	Second person Plural
կկարծենք	First person Plural
կկռվեր	Third person Singular
ուղեկցեց	Third person Singular
չզրնգաս	Second person Singular
հյուսեր	Third person Singular
ողնաշարից	None
գոլանանք	First person Plural
կորեցիք	Second person Plural
կվարեր	Third person Singular
չզեղես	Second person Singular
խրտնեմ	First person Singular
հռչակավոր	None
պարաշյուտներ	None
վանեք	Second person Plural
չտռեմ	First person Singular
գնահատեք	Second person Plural
չխռթայիր	Second person Singular
մաքրել	None
թվարկեի	First person Singular
կսպանեք	Second person Plural
չտեղեկացնեի	First person Singular
չթուլանամ	First person Singular
խմբագրեք	Second person Plural
հարսնացուն	None
չսարսափի	Third person Singular
կարիքներին	None
դրսեւորվեի	First person Singular
մաքրեցին	Third person Plural
կկորի	Third person Singular
ջրաղացներումս	None
քունի	Third person Singular
չագռավանա	Third person Singular
չքանդեինք	First person Plural
չհեռացնեք	Second person Plural
չծնգցրիր	Second person Singular
գրաբարով	None
չճշգրտի	Third person Singular
կշողա	Third person Singular
թորշոմեին	Third person Plural
կքարշեին	Third person Plural
տարմահավերիցս	None
ուժեղացի՛ր	Second person Singular
կանգնեցի	First person Singular
չվանեիք	Second person Plural
չընդոստնեմ	First person Singular
հերքվի	Third person Singular
քվարց	None
մարզիկը	None
կկրծեիր	Second person Singular
աջակցեինք	First person Plural
չկողոպտեի	First person Singular
չսազայի	First person Singular
փորձեցին	Third person Plural
չհավատամ	First person Singular
կուզես	Second person Singular
մաքրենք	First person Plural
կկայանա	Third person Singular
կաճեի	First person Singular
նետեր	Third person Singular
քանդեն	Third person Plural
աղոթեի	First person Singular
բացականչեց	Third person Singular
գանգրագեղներին	None
կգիտակցեիր	Second person Singular
խոպոպացվեց	Third person Singular
պատրաստեց	Third person Singular
գործարաններից	None
հազարամյակները	None
կիսեք	Second person Plural
չհամոզեին	Third person Plural
հավատաց	Third person Singular
կհուզեին	Third person Plural
չնիրհեի	First person Singular
կվերադառնար	Third person Singular
կարած	None
կբանեցնեն	Third person Plural
զոհասեղանի	None
կճուճներ	None
չքծնեցիք	Second person Plural
ամուսնացնում	None
խոցոտում	None
հագնեիք	Second person Plural
խածեցին	Third person Plural
չբարեւած	None
կթաղեք	Second person Plural
աստղաբանների	None
չհասկանայի	First person Singular
չհատուցեցինք	First person Plural
ցանկությամբ	None
այլեւայլ	None
աջակցեցին	Third person Plural
ճաղաշարերից	None
ագարականացի	First person Singular
սխրանքից	None
չսնգուրեցի	First person Singular
մտի	None
կցուցանեի	First person Singular
քոչեր	Third person Singular
չհեղեին	Third person Plural
մրգերը	None
ծառայեր	Third person Singular
չփչեք	Second person Plural
հեղուսեցին	Third person Plural
չհամենայիք	Second person Plural
գոճուդ	None
գոռաց	Third person Singular
խմեր	Third person Singular
արկանեիք	Second person Plural
հանգամանքները	None
չահաբեկվեցին	Third person Plural
տեսություն	None
թաղեր	Third person Singular
ահաբեկիչը	None
կքերծեի	First person Singular
չխածանեք	Second person Plural
չտպեինք	First person Plural
չամբարտավանեցին	Third person Plural
այցելեցին	Third person Plural
խառնարաններս	None
քաքեին	Third person Plural
ամպի	None
արգանակի	None
կլուտա	Third person Singular
առաքինությունումդ	None
կբեկաներ	Third person Singular
ձգտի	Third person Singular
կարամելի	None
խնդրանքս	None
չզգածվեր	Third person Singular
կշիկնեմ	First person Singular
հաստատություններին	None
ռոման	None
չմարթեց	Third person Singular
օմանյաններովս	None
գներ	Third person Singular
ըմպելու	None
չգոհանային	Third person Plural
չզգեցանք	First person Plural
խոցոտի	Third person Singular
չզղջաց	Third person Singular
ամբարիշտ	None
փլես	Second person Singular
մուժի	None
հրապուրեց	Third person Singular
կոլորես	Second person Singular
ահազանգես	Second person Singular
գործվածքով	None
չվիճեիք	Second person Plural
գերշուկայիդ	None
կերկկտտացնեինք	First person Plural
պարսպին	None
չսառեի	First person Singular
որովայնի	None
պլուզը	None
չգոյացաք	Second person Plural
չխիթաց	Third person Singular
հատկացնեմ	First person Singular
հարցմունք	None
կնքեցին	Third person Plural
կողոպտի՛ր	Second person Singular
թեն	None
կօծեք	Second person Plural
կեփեմ	First person Singular
վայելեմ	First person Singular
լուցեն	Third person Plural
գրանցումների	None
կհնանանք	First person Plural
չշահագործեմ	First person Singular
նեխեք	Second person Plural
չամբարտավանեցինք	First person Plural
թռնեինք	First person Plural
չհիրի	Third person Singular
չշիկնեինք	First person Plural
չքցես	Second person Singular
արգահատի՛ր	Second person Singular
տուժեցին	Third person Plural
ոխացաք	Second person Plural
նորեկի	None
սումոյում	None
կվաճառի	Third person Singular
չշնորհեի	First person Singular
կտարածեր	Third person Singular
պետություններումս	None
աքսորավայրին	None
մալայերենը	None
զրնգացիք	Second person Plural
սովորեցի	First person Singular
չաջակցես	Second person Singular
կտակեիք	Second person Plural
արտադրությունների	None
չնախանձի	Third person Singular
կառկայծեիք	Second person Plural
չզեղի	Third person Singular
կպարապեր	Third person Singular
սառնարանով	None
ծիծաղային	Third person Plural
ցողունը	None
բղավե՛ք	Second person Plural
կվերծանեմ	First person Singular
գիտելիքների	None
հասցեի	None
հագեինք	First person Plural
փամփուշտդ	None
քավեցին	Third person Plural
չվրդովվեք	Second person Plural
չահաբեկի	Third person Singular
կատարեն	Third person Plural
կստիպեր	Third person Singular
չխոպոպեցիր	Second person Singular
ահազանգի	Third person Singular
տուփերը	None
բաղխեիք	Second person Plural
կսավառնի	Third person Singular
չճախրեցի	First person Singular
բողոքեց	Third person Singular
բդկեն	Third person Plural
չարհամարհի	Third person Singular
հաստատեմ	First person Singular
խարխլեք	Second person Plural
աղատի	Third person Singular
կմտադրի	Third person Singular
այրվեիր	Second person Singular
խուց	None
պաճուճաբանես	Second person Singular
հիդրոլիզներումդ	None
հոլանի	Third person Singular
հեղեղների	None
չկաղկանձեցինք	First person Plural
չկշռեիր	Second person Singular
չշիջենք	First person Plural
խուճուճ	None
տարբերի	Third person Singular
չհղեք	Second person Plural
գոյացա	First person Singular
կահաբեկեիք	Second person Plural
աճեցրին	Third person Plural
գուշակ	None
հարբի՛ր	Second person Singular
չհանգեն	Third person Plural
այցելեց	Third person Singular
ունկնդիրներ	None
վարձ	None
ծնեցիր	Second person Singular
չբացականչես	Second person Singular
կբրթեի	First person Singular
որովայնում	None
նվար	Third person Singular
չկքեի	First person Singular
կիրառվելու	None
կզգենանք	First person Plural
չմնչենք	First person Plural
չբողոքեր	Third person Singular
ապացուցեց	Third person Singular
ղեկիս	None
նեգրի	None
կուզեմ	First person Singular
կհրկիզեի	First person Singular
չհոտեր	Third person Singular
կաշառե՛ք	Second person Plural
շաչեցիք	Second person Plural
ապստամբեցինք	First person Plural
զարմիկս	None
չջղայնացրին	Third person Plural
կպայմանավորի	Third person Singular
վճռականներումս	None
զետեղեցի	First person Singular
շնորհի	Third person Singular
քունեք	Second person Plural
չմեկնեմ	First person Singular
կհենեի	First person Singular
դատապարտեն	Third person Plural
սանրվեցինք	First person Plural
կքշեիք	Second person Plural
սանձահարի՛ր	Second person Singular
կկանգնի	Third person Singular
ագուցանեիր	Second person Singular
չուղեկցեցին	Third person Plural
չճանապարհորդեցիք	Second person Plural
չտնօրինեցի	First person Singular
կվանեի	First person Singular
կլկստվեք	Second person Plural
չվերագրեց	Third person Singular
կզավթեք	Second person Plural
բիսլամայիս	None
քննարկեցին	Third person Plural
չկործեր	Third person Singular
կկտակեմ	First person Singular
մոծակներին	None
այծքաղների	None
չվռնդեցինք	First person Plural
լափե՛ք	Second person Plural
կալանքներս	None
չգայթակղեցի	First person Singular
չվխտա	Third person Singular
չծլեցիք	Second person Plural
հասցրեց	Third person Singular
վիթը	None
սպանի	Third person Singular
ահազանգեին	Third person Plural
քչքչացի	First person Singular
առյուծներովդ	None
բքի	None
հասկացանք	First person Plural
կոչեր	Third person Singular
ճվատեինք	First person Plural
որմերին	None
չբողբոջի	Third person Singular
սիրած	None
տնօրինի	Third person Singular
չածի	Third person Singular
քշե՛ք	Second person Plural
ավելացնի	Third person Singular
կարծեցի	First person Singular
վճարեց	Third person Singular
որբանար	Third person Singular
պահպանեց	Third person Singular
չշիկնես	Second person Singular
աստղադիտարանի	None
փլատակների	None
չխեթացիք	Second person Plural
ստուգվել	None
աղիքներից	None
սորի՛ր	Second person Singular
հերքվենք	First person Plural
կուսումնասիրենք	First person Plural
հեռացրեց	Third person Singular
չխածեր	Third person Singular
չաճապարեր	Third person Singular
հատի	Third person Singular
կխմբագրեն	Third person Plural
գյուտերի	None
կկատակես	Second person Singular
հնարամիտներովդ	None
չկանխամտածի	Third person Singular
կպոռոտախոսեմ	First person Singular
չմոլեցի	First person Singular
չկարեինք	First person Plural
չքծնեց	Third person Singular
կահույրներդ	None
չբողոքեին	Third person Plural
օրակարգին	None
չբաղբանջեր	Third person Singular
կոշկակար	None
ֆոտոնը	None
կկթես	Second person Singular
կծնգցնես	Second person Singular
չգոչենք	First person Plural
կաշխատեմ	First person Singular
քերեք	Second person Plural
կալի	Third person Singular
կշիջի	Third person Singular
լքնեին	Third person Plural
չքունեմ	First person Singular
կորնչեմ	First person Singular
գործարքին	None
աղատեիք	Second person Plural
չարբեցանք	First person Plural
գյուտարարները	None
չբրթեցինք	First person Plural
կլուծեի	First person Singular
կհագնվեիր	Second person Singular
չկլանես	Second person Singular
չմաքրեիր	Second person Singular
կատարի	Third person Singular
բնակվեց	Third person Singular
կարձագանքեինք	First person Plural
ներգաղթեցին	Third person Plural
չբեկտեն	Third person Plural
արածեցրիր	Second person Singular
չհոլաթեւեն	Third person Plural
մակբայների	None
կացիններով	None
երթաս	Second person Singular
հեքիաթ	None
կլքնեին	Third person Plural
չագուցահանեիր	Second person Singular
ներբեռնե՛ք	Second person Plural
ապահովվեին	Third person Plural
գրասենյակներից	None
կբրթեր	Third person Singular
վանի	Third person Singular
առերեսվեցինք	First person Plural
հնչույթի	None
չզարթնեին	Third person Plural
տարբերեցիր	Second person Singular
խօսէին	Third person Plural
բացատրեցի	First person Singular
չհմայեիր	Second person Singular
արհամարհեիք	Second person Plural
պղծեցիք	Second person Plural
կարողանայի	First person Singular
կոճապղպեղի	None
քննեցին	Third person Plural
դրսեւորվեր	Third person Singular
կճոռոմախոսեիք	Second person Plural
գովեն	Third person Plural
կհատակեն	Third person Plural
ամեր	None
կսգա	Third person Singular
հեգնեին	Third person Plural
չխթեիր	Second person Singular
չորացնեիր	Second person Singular
անզգայացնես	Second person Singular
բահով	None
հագար	Second person Singular
սպանեն	Third person Plural
կկթոտենք	First person Plural
հիմունքներիդ	None
հորդի՛ր	Second person Singular
ուլունքները	None
մնացորդը	None
չարտագաղթի	Third person Singular
կհայտնեի	First person Singular
կրես	Second person Singular
կխնկեր	Third person Singular
գեղեցկությունից	None
կխոպոպեցնեիք	Second person Plural
չբաղբանջեցիք	Second person Plural
կհամենա	Third person Singular
ադրբեջանցին	None
սովորականներով	None
չշփոթեցնեք	Second person Plural
շուկայից	None
ուսանեցին	Third person Plural
կգնչեմ	First person Singular
բարբառեցին	Third person Plural
հոտեին	Third person Plural
պահլավերենի	None
չզխկտեցինք	First person Plural
հզոր	None
հարկանի	Third person Singular
կատաղեիք	Second person Plural
կաբստրահեն	Third person Plural
հանրակացարանները	None
խոպոպեինք	First person Plural
չհրեին	Third person Plural
ճաղերով	None
չհեղուսեցին	Third person Plural
չտեսնա	Third person Singular
բացականչի	Third person Singular
գրիպի	None
կկշռեիր	Second person Singular
խթեի	First person Singular
կանզգայացվի	Third person Singular
հարթուկե՛ք	Second person Plural
պղծեիր	Second person Singular
կդիեն	Third person Plural
մորուք	None
շնչեինք	First person Plural
սադրեցիք	Second person Plural
պարապես	Second person Singular
չկախեիք	Second person Plural
կձգտի	Third person Singular
թափվեցի	First person Singular
սերբերիցս	None
կպարգեւեր	Third person Singular
լեզվակը	None
չառոգանեցի	First person Singular
կարողանաս	Second person Singular
ֆեոդալիզմիցս	None
ործկանք	First person Plural
չմատուցեն	Third person Plural
կսփոփեի	First person Singular
քուղը	None
հանվի	Third person Singular
կհղիանան	Third person Plural
կհամառեի	First person Singular
կծծեինք	First person Plural
կոկտեյլ	None
կոչենք	First person Plural
ուղիներին	None
շտկի՛ր	Second person Singular
գրող	None
կքննեիր	Second person Singular
բացվածքների	None
կհամենանք	First person Plural
մեծաբանեք	Second person Plural
ծիծաղաշարժ	None
լողանաք	Second person Plural
մոլեխաղին	None
համերգասրահ	None
հուզես	Second person Singular
չցավեին	Third person Plural
արտաքսեցին	Third person Plural
զարմացնել	None
կներկայացնենք	First person Plural
կքեն	Third person Plural
կպահածոյացնեք	Second person Plural
չշփեն	Third person Plural
կքոչեն	Third person Plural
հյուսեիք	Second person Plural
հայտնած	None
կպարապի	Third person Singular
ֆիլմերում	None
բնակվենք	First person Plural
ուժեղի	None
քարոզ	None
մարգարեությունները	None
հողդողդեն	Third person Plural
շիվերը	None
չխթեն	Third person Plural
կալեն	Third person Plural
ռադիոն	None
չհագեի	First person Singular
վխտացիր	Second person Singular
չազդեցինք	First person Plural
գանգրվեցիր	Second person Singular
կծածկենք	First person Plural
ականին	None
կհետազոտեին	Third person Plural
մօտենայիք	Second person Plural
չափանիշով	None
չգոլանամ	First person Singular
կխրախուսի	Third person Singular
ածե՛ք	Second person Plural
կբրթեին	Third person Plural
ձվատարում	None
բարբաջես	Second person Singular
կընդարմանաս	Second person Singular
չհուսալքեմ	First person Singular
ծղոտ	None
չխրթեք	Second person Plural
տեղեկացնեք	Second person Plural
համարեցին	Third person Plural
ժանրեր	None
թարթի՛ր	Second person Singular
բանավեճի	None
կհամբուրվեմ	First person Singular
բորբոքեն	Third person Plural
չխնկեր	Third person Singular
չնվագեք	Second person Plural
քորի	Third person Singular
կհանգեք	Second person Plural
գիտելիքներից	None
տանջե՛ք	Second person Plural
չհամբուրվեին	Third person Plural
ճկունությունը	None
չբարեւեին	Third person Plural
ծն	None
կահագնանայինք	First person Plural
կգլորեինք	First person Plural
ծնվելու	None
կջեռուցեիք	Second person Plural
ստոծանու	None
չճվատեք	Second person Plural
դարանակալեի	First person Singular
չպոռոչեց	Third person Singular
կերտեի	First person Singular
հատնի	Third person Singular
չբռնաբարեցի	First person Singular
տեւեց	Third person Singular
չխռթացնեք	Second person Plural
կողոպտեց	Third person Singular
չշառաչենք	First person Plural
պարտվեցին	Third person Plural
բարեւեցին	Third person Plural
ընկճես	Second person Singular
տեսնաս	Second person Singular
շարժվենք	First person Plural
տրամագիծ	None
ձուլարանների	None
տուկանի	None
փայլունացրինք	First person Plural
բաժանումից	None
կործի	Third person Singular
վերադառնան	Third person Plural
տեղեկատուները	None
բուրաստաններումդ	None
ատեն	Third person Plural
չհայթայթեց	Third person Singular
քավենք	First person Plural
զարմիկից	None
կստուգեին	Third person Plural
չկայացանք	First person Plural
կկիսեին	Third person Plural
խարխլեցին	Third person Plural
փլվեց	Third person Singular
կխեթկի	Third person Singular
պատկերասրահներում	None
ձորերով	None
կօժանդակեր	Third person Singular
բացառեցի	First person Singular
չփրթեք	Second person Plural
աղվանների	None
չարածես	Second person Singular
չսայթաքեցիք	Second person Plural
ոլորի՛ր	Second person Singular
ալի	None
վիզա	None
լուտացիք	Second person Plural
չորոճայիք	Second person Plural
կուսուցանես	Second person Singular
չերթաք	Second person Plural
դիի	Third person Singular
չսավառնենք	First person Plural
անկախությունը	None
կսրճես	Second person Singular
կսարսափեն	Third person Plural
արգահատեն	Third person Plural
կքերծեիք	Second person Plural
կաթոլիկներ	None
խորովեց	Third person Singular
երջանկություններդ	None
երթամ	First person Singular
անշարժներս	None
ոռոգի՛ր	Second person Singular
վախենամ	First person Singular
գանգրոցդ	None
ծնգցնեն	Third person Plural
չագուցավորեին	Third person Plural
առզելով	None
զորքին	None
չծլեցին	Third person Plural
մանդարին	None
որոճացին	Third person Plural
չթրմենք	First person Plural
արածեցներ	Third person Singular
կներկայացնեք	Second person Plural
մաթեմատիկոսի	None
չակնածենք	First person Plural
կիզեր	Third person Singular
չքննարկեց	Third person Singular
չվայելեցիք	Second person Plural
կմտաբերեր	Third person Singular
չծառայեիք	Second person Plural
պահպանեին	Third person Plural
կպահածոյացնեինք	First person Plural
չհրահրեր	Third person Singular
մատուցեին	Third person Plural
ուղղությունում	None
չաղացի՛ր	Second person Singular
կլքնենք	First person Plural
աղանդավորների	None
ներգաղթեց	Third person Singular
չուռենք	First person Plural
հասկանար	Third person Singular
ուրարտական	None
տարվի	Third person Singular
ալոճենի	None
կաշխատեին	Third person Plural
չխոթեցի	First person Singular
կհամառեինք	First person Plural
տնակում	None
վհատեցներ	Third person Singular
այրվեց	Third person Singular
առատներիցս	None
ջինիս	None
երգիծել	None
ծուլացար	Second person Singular
էթայիր	Second person Singular
չշրջվեն	Third person Plural
չոռոգեինք	First person Plural
չերկկտտացնեին	Third person Plural
հնանայիր	Second person Singular
պաշարի	None
չփայլունացներ	Third person Singular
չոգեց	Third person Singular
չբարբանջենք	First person Plural
կացարաններ	None
կռվեիք	Second person Plural
կստիպեիր	Second person Singular
չխոպոպացվեցինք	First person Plural
ողջույններովս	None
չընտրվեք	Second person Plural
կենցաղներին	None
չհամառեի	First person Singular
պատրաստեր	Third person Singular
կոճկեցինք	First person Plural
մսեղներովդ	None
կփայլունացվես	Second person Singular
հնագետների	None
չծնեցի	First person Singular
բանեցներ	Third person Singular
կընտրվի	Third person Singular
դարավանդներ	None
պահապանի	None
բաժանումը	None
չգլեր	Third person Singular
գնահատենք	First person Plural
սկանդիում	None
չկտակի	Third person Singular
ախտաբան	None
չսաղացանք	First person Plural
բնութագրեր	Third person Singular
ամայացար	Second person Singular
կատարեիր	Second person Singular
ստուգեն	Third person Plural
չգործարկես	Second person Singular
տոներ	None
հիասթափվեցինք	First person Plural
ավագներիցս	None
կարեկցող	None
պարտքերը	None
վիճաբանելու	None
փոխանակեցին	Third person Plural
չբացատրեք	Second person Plural
սիրուհիների	None
հորդորեց	Third person Singular
չստիպեիր	Second person Singular
գուրացինք	First person Plural
կկեի	First person Singular
կսխալվեին	Third person Plural
սարսափի	Third person Singular
չվրդովեցի	First person Singular
շագանակագույնով	None
իտալացիներովդ	None
չցնծայիր	Second person Singular
գադոլինիումներիցս	None
չզարմացնես	Second person Singular
կայսրությամբ	None
տարածեց	Third person Singular
պոռոտախոսենք	First person Plural
ցախովդ	None
խրախուսեց	Third person Singular
չդարբնեցիր	Second person Singular
խեթա	Third person Singular
փողրակներով	None
ըղձանք	First person Plural
չհաճախեցնի	Third person Singular
կառավարեր	Third person Singular
մացառուտներում	None
հելներ	Third person Singular
աբստրահեցինք	First person Plural
չգոռաց	Third person Singular
չքելեի	First person Singular
կխմի	Third person Singular
թոքաբորբից	None
կերակուրներումդ	None
կգոհացնեին	Third person Plural
չկարենայի	First person Singular
կազազեի	First person Singular
կհյուծեի	First person Singular
կխռմփացներ	Third person Singular
լուծենք	First person Plural
ահագնացա	First person Singular
կմագլցեին	Third person Plural
տոկայինք	First person Plural
չկթոտեցի	First person Singular
խթանեց	Third person Singular
կիրառես	Second person Singular
աշակերտներով	None
կհարի	Third person Singular
չկորեին	Third person Plural
բուծեցիր	Second person Singular
ահաբեկող	None
տռեցիր	Second person Singular
հարնչի՛ր	Second person Singular
պարտավորությունների	None
թարգմանեց	Third person Singular
հեղինակությունը	None
կերտեց	Third person Singular
գողտրին	None
կթարգմանենք	First person Plural
բնորոշեի	First person Singular
բաժանվի	Third person Singular
ճանապարհորդեցին	Third person Plural
չտռզեի	First person Singular
չմատչեի	First person Singular
հաստատած	None
խորովել	None
հերքեց	Third person Singular
երեխա	None
զխկտե՛ք	Second person Plural
թաքցնելու	None
մրցի	Third person Singular
քարոզեիք	Second person Plural
հարկանեմ	First person Singular
չլծեիր	Second person Singular
կծփեն	Third person Plural
կղմինդրի	None
կգոռանք	First person Plural
թրծեցինք	First person Plural
կերեւաք	Second person Plural
տորթերը	None
կուռչի	Third person Singular
չվճարեմ	First person Singular
խելոքիդ	None
քաջալերանք	None
տուժվեցիր	Second person Singular
ինտերնետում	None
չբխեցի	First person Singular
հանվես	Second person Singular
չօթեցինք	First person Plural
առողջացնենք	First person Plural
մալթայերենը	None
չինարի	None
ամբարտավանես	Second person Singular
սլացավ	Third person Singular
չհարեցիք	Second person Plural
ճմռթեցին	Third person Plural
կշտկեմ	First person Singular
վերծանեցիք	Second person Plural
չկթոտեցինք	First person Plural
հայտնեիք	Second person Plural
չսփռեիր	Second person Singular
չվանկարկեցին	Third person Plural
կկակազեր	Third person Singular
ապահովեցրեց	Third person Singular
չվանկեին	Third person Plural
ճառերը	None
տռի	Third person Singular
չհյուսեցիր	Second person Singular
զարթնեն	Third person Plural
չոխանայինք	First person Plural
ագրեգատավորեց	Third person Singular
կկենդանանայիք	Second person Plural
ղարաբաղյաններ	None
աղիքները	None
քերի	Third person Singular
մտցներ	Third person Singular
կզտես	Second person Singular
կուղարկի	Third person Singular
սայլը	None
ավելացրի	First person Singular
հուսալքեցի	First person Singular
դարպասապահների	None
չծիծաղայի	First person Singular
մխիթարին	None
կմագլցի	Third person Singular
սիգացիր	Second person Singular
հանգամանքներով	None
չանզգայացվեցինք	First person Plural
կհեղեի	First person Singular
փորոտիքը	None
ցանկություններով	None
տուփերում	None
կաբսորբեք	Second person Plural
ցտեցիր	Second person Singular
նիրհեց	Third person Singular
չստիպի	Third person Singular
կբուծանեն	Third person Plural
շարքայինները	None
արու	None
չտեսնամ	First person Singular
ագրեգատավորես	Second person Singular
չդրվատեցին	Third person Plural
չվրդովվեց	Third person Singular
չհամաձայնեք	Second person Plural
ընձուղտների	None
հեղուսեիք	Second person Plural
կաշխատի	Third person Singular
չկտղեի	First person Singular
կահաբեկվեք	Second person Plural
ուսումնասիրեք	Second person Plural
պնակներ	None
խրոխտա՛	Second person Singular
չքելեիր	Second person Singular
համարեն	Third person Plural
վերագրեցիր	Second person Singular
չվախենայիր	Second person Singular
արտագաղթեց	Third person Singular
չաղանային	Third person Plural
խեթացիք	Second person Plural
գրանիտները	None
չընդելուզենք	First person Plural
գեղեցիկի	None
չխրոխտային	Third person Plural
չգողանաս	Second person Singular
միացնենք	First person Plural
չհղեն	Third person Plural
կհենեիր	Second person Singular
կերկնչեմ	First person Singular
ազդվել	None
օպերաներում	None
աշխատակազմի	None
չկառավարեցինք	First person Plural
խոստացի՛ր	Second person Singular
կփոխարինի	Third person Singular
մահացար	Second person Singular
չուղարկեցի	First person Singular
նավեցիք	Second person Plural
կցեց	Third person Singular
չբավարարեցին	Third person Plural
խնծիղին	None
չարտագաղթեցինք	First person Plural
պայթի	Third person Singular
մղձավանջների	None
շփոթեցրի	First person Singular
կճկեք	Second person Plural
տեւեցի	First person Singular
չպագա	First person Singular
միություններից	None
կխոցեին	Third person Plural
չկարեկցեն	Third person Plural
աշխատենք	First person Plural
չտուժեց	Third person Singular
կնոջ	None
կեպերեիր	Second person Singular
չկամենար	Third person Singular
ընձուղտս	None
կոճկեի	First person Singular
չկանխամտածեմ	First person Singular
պայմանավորեմ	First person Singular
բարելավեցին	Third person Plural
կայֆումդ	None
չոլորակես	Second person Singular
չնվան	Third person Plural
բժշկություն	None
կունկնդրեր	Third person Singular
ամերիկացին	None
լոբին	None
չփարթամանան	Third person Plural
բացատրութիւններ	None
հոլովումը	None
հարբեիք	Second person Plural
այտուցի	None
խոթիցդ	None
հասցներ	Third person Singular
կեղե՛ք	Second person Plural
քնկոտ	None
չլրթացան	Third person Plural
ժանրերովդ	None
քամեր	Third person Singular
կքաղցի	Third person Singular
ճանապարհորդ	None
չճկեք	Second person Plural
ձողիկներ	None
հրահրեց	Third person Singular
մոնիտորը	None
մահանան	Third person Plural
այցելի	Third person Singular
չաղերսենք	First person Plural
կկնքեր	Third person Singular
ակոսներդ	None
կմոլեգնեմ	First person Singular
խնչեցին	Third person Plural
ոստիկանությանը	None
չկշռեր	Third person Singular
չճեմեցի	First person Singular
ապացուցեցին	Third person Plural
արկեր	Third person Singular
կտռեմ	First person Singular
մտմտաս	Second person Singular
կփոխհատուցեի	First person Singular
նախահայրերը	None
ավիաընկերություններ	None
կայանա	Third person Singular
հումանիզմով	None
չարհամարհեցի	First person Singular
չաքսորվեցիք	Second person Plural
չլկստվի	Third person Singular
չուսուցանեցիր	Second person Singular
սինդհի	None
հրճվեին	Third person Plural
կայացան	Third person Plural
վիրուս	None
չփութացրին	Third person Plural
սառեց	Third person Singular
մաթեմատիկոսներից	None
աղաղակի	Third person Singular
մատուռ	None
նահանգապետերի	None
կողոպտեն	Third person Plural
կհատակենք	First person Plural
սազայի	First person Singular
յանիչարների	None
չբողոքեինք	First person Plural
չհեռեիք	Second person Plural
չհուռթանանք	First person Plural
կգոլանամ	First person Singular
նպաստի	Third person Singular
կազդի	Third person Singular
քցեք	Second person Plural
աղաչանքիդ	None
կհորանջեիք	Second person Plural
կայծակը	None
կհեղեղեր	Third person Singular
վրձին	None
բավարարող	None
հեղուսեի	First person Singular
նախկինի	None
օբյեկտը	None
չպաճուճաբանես	Second person Singular
կողորմեմ	First person Singular
չմնչեն	Third person Plural
ապահովեր	Third person Singular
գնեց	Third person Singular
կանգնեն	Third person Plural
տերտերին	None
երկարությունները	None
չահազանգեին	Third person Plural
տեղեկացնի	Third person Singular
գալակտիկայիցդ	None
ագուցանեք	Second person Plural
կլքի	Third person Singular
կալիումով	None
հիասթափվեինք	First person Plural
զգուշանայի	First person Singular
կսուզեինք	First person Plural
փռշտում	None
հիմնում	None
սապոններդ	None
չափեց	Third person Singular
չլուծես	Second person Singular
հոգեբանի	None
տեղեկացրի	First person Singular
չդրդեցիք	Second person Plural
ապահովի	Third person Singular
երկրաբանության	None
բարելավենք	First person Plural
չապշեց	Third person Singular
ծնվեց	Third person Singular
վանկարկեց	Third person Singular
փողրակով	None
արշավանքներում	None
քիլ	None
չբորբոքեն	Third person Plural
չունկնդրեր	Third person Singular
չվաճառես	Second person Singular
կխրոխտայինք	First person Plural
չփոխարինեիր	Second person Singular
չարածեցրիք	Second person Plural
ապաշխարեցիր	Second person Singular
չզավթեցինք	First person Plural
քահանաներին	None
հրդեհից	None
չմեղադրեցին	Third person Plural
մեղանչեցինք	First person Plural
ծիծեռնակ	None
առնը	None
չհելա	First person Singular
պոռոտախոսեցիք	Second person Plural
կհորդորեին	Third person Plural
կխարխլեք	Second person Plural
կախարդներ	None
տկռեին	Third person Plural
կգոյանայի	First person Singular
ոսկորներում	None
չզխկտեցի	First person Singular
լաբիրինթոս	None
մեղմեխների	None
ագահես	Second person Singular
սաղավարտումս	None
միանայի	First person Singular
հագնվի՛ր	Second person Singular
համբուրվի	Third person Singular
թզուկների	None
կծծեք	Second person Plural
չքայլեիք	Second person Plural
փսխեք	Second person Plural
կփոխարինեի	First person Singular
արժեքին	None
հուսահատություն	None
համաձայնեք	Second person Plural
չվիճաբանեիր	Second person Singular
չհեգեց	Third person Singular
չմատնեցիք	Second person Plural
բանավոր	None
չխմբագրենք	First person Plural
նախազգուշացումները	None
չխոպոպվեիր	Second person Singular
կհասցնի	Third person Singular
ավելացնես	Second person Singular
փայտիկ	None
հանդուգն	None
չպատկերեցիր	Second person Singular
խավիար	None
արդարացնի	Third person Singular
փայլունացվե՛ք	Second person Plural
չկիրառվեցի	First person Singular
չապահովեին	Third person Plural
խրտնեք	Second person Plural
գելեի	First person Singular
կտնօրինես	Second person Singular
կկակազեն	Third person Plural
վիճեցին	Third person Plural
սարավանդը	None
վեճդ	None
ցավար	Third person Singular
բուծի՛ր	Second person Singular
ամրոց	None
չողբայի	First person Singular
կծլեք	Second person Plural
կբդկեին	Third person Plural
չկանչենք	First person Plural
հրեց	Third person Singular
փոխարինեն	Third person Plural
հայերենով	None
հուսահատվեմ	First person Singular
իմպերիալիզմ	None
ճահիճը	None
գերմաներենում	None
ավելացնեն	Third person Plural
բարբառես	Second person Singular
էղնեիք	Second person Plural
նախանձեցին	Third person Plural
փութացնեին	Third person Plural
կառերեսեինք	First person Plural
չանզգայանա	Third person Singular
կհեծեծեիք	Second person Plural
կօգտագործեն	Third person Plural
ստրկացնեմ	First person Singular
հիմարացնեիր	Second person Singular
հղի	Third person Singular
չանորոշանայինք	First person Plural
կկտցեմ	First person Singular
չկերակրեինք	First person Plural
չկանխագրի	Third person Singular
չկռթնեմ	First person Singular
հեռացնի	Third person Singular
պարմեզան	None
ծնողներս	None
հարբուխի	None
սորեց	Third person Singular
հածեն	Third person Plural
բարբառները	None
կախարդվեն	Third person Plural
կանաչավուն	None
խածատեին	Third person Plural
բաստուրմա	None
կերակրելիս	None
հղեցան	Third person Plural
կթրջի	Third person Singular
աքսորի՛ր	Second person Singular
կներկայացներ	Third person Singular
կսնգուրվես	Second person Singular
կսփոփեիք	Second person Plural
կորնչես	Second person Singular
տառապեցրի	First person Singular
կիրառեն	Third person Plural
կկանխագրեմ	First person Singular
կցտեմ	First person Singular
մխիթարը	None
չձուլեիր	Second person Singular
ուսանեց	Third person Singular
կհպատակվեիր	Second person Singular
կմտմտամ	First person Singular
մտցնեինք	First person Plural
պագա	First person Singular
խորհրդանշեն	Third person Plural
նախընտրի՛ր	Second person Singular
արգելեք	Second person Plural
վարակ	None
կավանդես	Second person Singular
արածեց	Third person Singular
լյարդիդ	None
աբսորբեին	Third person Plural
ճանապարհորդի	Third person Singular
մեկներ	Third person Singular
կչարանա	Third person Singular
ջղայնացնեիք	Second person Plural
ձուլեցին	Third person Plural
կկազմակերպեի	First person Singular
չածանցեցիք	Second person Plural
կոշկոճի	Third person Singular
չթրեն	Third person Plural
չամուսնացրիր	Second person Singular
դարչինի	None
չմալեցի	First person Singular
կառավարեցիք	Second person Plural
բռնաբարի	Third person Singular
չարբեն	Third person Plural
ժամում	None
շիթի	None
կգիշատեն	Third person Plural
չկանխամտածվեցի	First person Singular
կգրգռի	Third person Singular
ֆուտբոլասերների	None
կհոտեին	Third person Plural
կհորդորեն	Third person Plural
վիրաբուժություն	None
ձաղկեցի	First person Singular
չմրսեինք	First person Plural
հայտնեինք	First person Plural
աճեցնեն	Third person Plural
տենչացիր	Second person Singular
խոստանաք	Second person Plural
չխմեր	Third person Singular
ռեստորանից	None
կանչի	Third person Singular
խոչընդոտը	None
վարեցին	Third person Plural
չծիծաղանք	First person Plural
լրտեսես	Second person Singular
կանաչապատում	None
ծաղրեին	Third person Plural
վճարեն	Third person Plural
չփախա	First person Singular
չբանեք	Second person Plural
ահաբեկիչների	None
չսանրեց	Third person Singular
անզգայությունիցդ	None
չհաճեցինք	First person Plural
անզգայանայիք	Second person Plural
ուռթեն	Third person Plural
ատեմ	First person Singular
կբաժանվենք	First person Plural
կտնօրինեի	First person Singular
բացառիկությունը	None
կտրցակեին	Third person Plural
մատուցեց	Third person Singular
կարողանան	Third person Plural
ծնվեցին	Third person Plural
նեղանաք	Second person Plural
չպայմանավորված	None
կամենա	Third person Singular
կահազանգեիք	Second person Plural
կագրեգատավորեր	Third person Singular
ռոմանը	None
կջեռուցեն	Third person Plural
երկերովս	None
արթնացա	First person Singular
քննարկեք	Second person Plural
չթանայիք	Second person Plural
կհագնեի	First person Singular
ապացուցի	Third person Singular
կռվեն	Third person Plural
խոճկորների	None
չքայլեիր	Second person Singular
ազատանուդ	None
մահանայիր	Second person Singular
կկտակեք	Second person Plural
չթոթովեցինք	First person Plural
կվայելեինք	First person Plural
կպահածոյացնի	Third person Singular
ողողվել	None
ուզեցա	First person Singular
համաձայնեցին	Third person Plural
կատեգորիային	None
պատվիրակությունը	None
ֆաշիզմի	None
կէտեր	Third person Singular
չհոխորտայի	First person Singular
արկով	None
ունկնդրեց	Third person Singular
կճեմեք	Second person Plural
ժամկետ	None
չհարեցին	Third person Plural
չտարակուսի	Third person Singular
չնեխեցին	Third person Plural
աղանդից	None
թաքցրել	None
ուսումնասիրեցին	Third person Plural
հմայեք	Second person Plural
հնացաք	Second person Plural
փակ	None
վռնդի	Third person Singular
կասկածեց	Third person Singular
կհեծնեք	Second person Plural
վճռեն	Third person Plural
չլուցեք	Second person Plural
հերքվեցինք	First person Plural
հայտարարությունում	None
թարխանաներով	None
չհափափեք	Second person Plural
ապագաներով	None
կրակեց	Third person Singular
արբանյակից	None
թովեցի	First person Singular
էլեմենտներով	None
կանզգայացվեմ	First person Singular
կաբսորբեի	First person Singular
կկռթնեմ	First person Singular
հանվեն	Third person Plural
լողանար	Third person Singular
բանաստեղծս	None
կիզիչներս	None
գնդակահարությունների	None
սրճի	Third person Singular
չնեխեիք	Second person Plural
մարդաբանները	None
կազդվեն	Third person Plural
չկորնչենք	First person Plural
մարթեն	Third person Plural
ճամփորդի	Third person Singular
չափսերին	None
չէղնես	Second person Singular
չսրտաշարժի	Third person Singular
մրսես	Second person Singular
օսեթիդ	None
նեյտրոնի	None
կբտեմ	First person Singular
բարելավեցի	First person Singular
չընկղմեին	Third person Plural
օգտագործեն	Third person Plural
հոգար	Third person Singular
օգտագործի	Third person Singular
չփոխհատուցեք	Second person Plural
վհատներով	None
կփարթամանային	Third person Plural
բացականչեինք	First person Plural
կզառամանայիք	Second person Plural
կցավեինք	First person Plural
լավաներ	None
աճեցիք	Second person Plural
կքննարկենք	First person Plural
ագահանացե՛ք	Second person Plural
կենացներ	None
ջերմաստիճանների	None
հողդողդեցինք	First person Plural
ալեկոծեցի	First person Singular
մտավորականության	None
մարտիրոսներդ	None
հարգի	Third person Singular
ավտոմեքենաներին	None
հանդիսականներին	None
սերմնաբջիջներ	None
կնքենք	First person Plural
շենքերում	None
հյուսիսին	None
չամբարտավանի	Third person Singular
կնքեց	Third person Singular
արձագանքի	Third person Singular
չկառչեն	Third person Plural
ագարականամ	First person Singular
շարժիչներից	None
չհավատացինք	First person Plural
կառուցվածքները	None
կանգնենք	First person Plural
շտկեմ	First person Singular
ձգտեն	Third person Plural
չպաճուճաբանեինք	First person Plural
դանիերեն	None
կհյուսեմ	First person Singular
փնջերում	None
հրեցիք	Second person Plural
վառվեց	Third person Singular
անգղը	None
չշիջուցանեցիք	Second person Plural
օգտագործենք	First person Plural
կկամենաք	Second person Plural
գեղարդով	None
կթրմեր	Third person Singular
թագերովս	None
չգրադարձենք	First person Plural
ախտորոշեցիք	Second person Plural
կհոսեի	First person Singular
կխռթացնեինք	First person Plural
կռվեիր	Second person Singular
ուզեինք	First person Plural
վարպետներ	None
քանդեցին	Third person Plural
ծխախոտի	None
թռնեմ	First person Singular
կստրկացնեիք	Second person Plural
կմեկնես	Second person Singular
մղող	None
չխրտնեին	Third person Plural
չզեղեցինք	First person Plural
հուսահատեցնեք	Second person Plural
չստիպես	Second person Singular
ունկնդրենք	First person Plural
չհոգայիք	Second person Plural
մտրակների	None
պատմվածքի	None
սուզվել	None
հայտնեիր	Second person Singular
կառչեիր	Second person Singular
սպիտակուցով	None
բնութագրի	Third person Singular
չտարվեք	Second person Plural
կփորձի	Third person Singular
երգչուհիներից	None
կդատապարտի	Third person Singular
ծույլերի	None
կհայտարարի	Third person Singular
պապայան	None
կհափափեիք	Second person Plural
չխիթաս	Second person Singular
խաղամոլի	None
երեկվա	None
դատապարտեց	Third person Singular
սրիչ	None
պայմանավորի՛ր	Second person Singular
շփոթեցի	First person Singular
հարսնացրին	Third person Plural
չաղա	Third person Singular
կարապները	None
չխածատեն	Third person Plural
կհազար	Third person Singular
հանրապետություններից	None
ցեղասպանություններ	None
կխեթամ	First person Singular
քննությունից	None
ոսպապուրս	None
չտրցակեինք	First person Plural
կագուցանենք	First person Plural
վախեցիր	Second person Singular
վանկեր	Third person Singular
հիմնավորեց	Third person Singular
չտեւեց	Third person Singular
կոչի	Third person Singular
չզննեիք	Second person Plural
չոլորակեց	Third person Singular
չճոռոմախոսեցինք	First person Plural
մրջնակերներիցդ	None
համացանցից	None
վախեք	Second person Plural
ծածկույթի	None
ֆուտբոլիստը	None
դրվատի՛ր	Second person Singular
հարգեցին	Third person Plural
տախտակամածով	None
ծառայեն	Third person Plural
կփարթամանայիք	Second person Plural
նիստը	None
մագմայումս	None
կսազայի	First person Singular
ճաշեն	Third person Plural
նվաղեց	Third person Singular
վռնդեցին	Third person Plural
չգոհանայինք	First person Plural
քննեիր	Second person Singular
կգիտակցվեիք	Second person Plural
սասինկայով	None
քարայրից	None
չնազեինք	First person Plural
նավաստին	None
ռեակցիայով	None
ծինը	None
լքեի	First person Singular
շարունակեիք	Second person Plural
չմատուցի	Third person Singular
խոպոպեցնեք	Second person Plural
ուղարկի՛ր	Second person Singular
մորուքի	None
կխռթային	Third person Plural
էլեկտրականությունից	None
Զատկին	None
չսիրվեի	First person Singular
չկաշառի	Third person Singular
տակառ	None
թաթերը	None
չխազեցի	First person Singular
համարեց	Third person Singular
էպոսից	None
չստորագրեմ	First person Singular
գնեցին	Third person Plural
հրապուրեին	Third person Plural
աճապարեցիք	Second person Plural
աճեք	Second person Plural
մեղքերին	None
չհերքի	Third person Singular
որսորդներ	None
չտարամիտեց	Third person Singular
փախցնեինք	First person Plural
համակարգեց	Third person Singular
չհամակարգեինք	First person Plural
չկանգնեմ	First person Singular
խորխեն	Third person Plural
առերեսվեին	Third person Plural
խօսէիր	Second person Singular
չհայթայթեն	Third person Plural
կուղեկցի	Third person Singular
գերդաստաններիդ	None
խածեք	Second person Plural
մետաղներով	None
չկարեցավ	Third person Singular
չվանեցին	Third person Plural
կբարբանջեն	Third person Plural
արդյունքով	None
լեյտենանտները	None
մասուր	None
հրեն	Third person Plural
կպայմանավորեք	Second person Plural
ստորագրեց	Third person Singular
չբացառեցին	Third person Plural
չկարոտեի	First person Singular
մոռացավ	Third person Singular
վասալի	None
չշիկնեիք	Second person Plural
կդարանակալենք	First person Plural
կքչքչամ	First person Singular
կջանար	Third person Singular
չսայթաքեցինք	First person Plural
չքաղցեմ	First person Singular
թույները	None
հեր	None
զննեին	Third person Plural
հաստատեր	Third person Singular
կաղնիները	None
մաճիցդ	None
կապանքները	None
մոռացան	Third person Plural
կկարօտի	Third person Singular
կանգնե՛ք	Second person Plural
խղճացե՛ք	Second person Plural
շատացան	Third person Plural
զորավարներին	None
արկեցի	First person Singular
մոտեցնենք	First person Plural
վանկեին	Third person Plural
կզարմանային	Third person Plural
մերկության	None
թրեք	Second person Plural
մայի	Third person Singular
չափեմ	First person Singular
չմոտեցրինք	First person Plural
ասպատակ	None
որբացած	None
չշնչեին	Third person Plural
ընթանան	Third person Plural
չբդկեցին	Third person Plural
կարեցա	First person Singular
գերմանական	None
որոմումս	None
չկառավարեր	Third person Singular
կգուրգուրար	Third person Singular
սպի	None
կատարեցին	Third person Plural
ալոճենիներիդ	None
մերի	None
ուզես	Second person Singular
չվերադառնանք	First person Plural
ցավացե՛ք	Second person Plural
կէղնեի	First person Singular
ջահել	None
չարտաքսեք	Second person Plural
չմոռանա	Third person Singular
պոռոչեինք	First person Plural
մետաղալարով	None
չգիտակցված	None
կծղրտայիք	Second person Plural
ուղարկեցի	First person Singular
միրգ	None
ապահովվեցի	First person Singular
պայմանավորեց	Third person Singular
տերմիններով	None
մեկնաբանություններով	None
չծնեինք	First person Plural
հորքուրը	None
կքաքեմ	First person Singular
հոսի	Third person Singular
չփոխանակեցի	First person Singular
կուզենար	Third person Singular
կթվարկեր	Third person Singular
չխածնեցին	Third person Plural
չզառանցեմ	First person Singular
բնավորությանը	None
չչարանայի	First person Singular
երդիկներովս	None
մոլեխաղերի	None
գոյացել	None
գայթակղեց	Third person Singular
ապահովեինք	First person Plural
ստորգետնյա	None
զգածվեն	Third person Plural
հեծելազորից	None
հետազոտողները	None
հալածեցի	First person Singular
ջղայնանայինք	First person Plural
հրեան	None
փայփայեցիր	Second person Singular
արփին	None
հայտարարեն	Third person Plural
քոչվորների	None
զետեղեց	Third person Singular
չառոգանեցիր	Second person Singular
չխիթար	Third person Singular
հասկանան	Third person Plural
չափեինք	First person Plural
առաջադիմումը	None
չգանգրացան	Third person Plural
մամուռները	None
կատարեք	Second person Plural
աշխույժ	None
դարանակալեինք	First person Plural
ծնեիր	Second person Singular
մուրա	Third person Singular
պատառեք	Second person Plural
միացավ	Third person Singular
չմոլեգնեին	Third person Plural
չաճեցնեք	Second person Plural
որբանայիք	Second person Plural
չներքինացրեց	Third person Singular
կկաղկանձեին	Third person Plural
սիրեկանի	None
կբավարարեիր	Second person Singular
չբխեինք	First person Plural
շաչենք	First person Plural
չուվաշերեն	None
չկռվեի	First person Singular
պայմանավորեցին	Third person Plural
կներբեռնեմ	First person Singular
լիգայից	None
չցանկացավ	Third person Singular
աջակցի	Third person Singular
չուզեցին	Third person Plural
այցելելիս	None
ուռթացաք	Second person Plural
պարանը	None
հղիություն	None
կսպրդեի	First person Singular
պատվիրակությունները	None
չպատկանեին	Third person Plural
ամիրաներ	None
հեծելազորը	None
անցքի	None
դատողությունը	None
չխոխոջան	Third person Plural
տոհմով	None
չսնգուրվենք	First person Plural
այցելեցիր	Second person Singular
թաքցնել	None
չճմռթեցի	First person Singular
բաջաղեցինք	First person Plural
կմեղադրեն	Third person Plural
հիմունքներ	None
կպատառենք	First person Plural
գրգռեի	First person Singular
կկշռեն	Third person Plural
կկանգնես	Second person Singular
քննարկենք	First person Plural
զարմացրեց	Third person Singular
խորհրդին	None
կնվաղեիր	Second person Singular
սիբիրախտերիցդ	None
չկանխագրես	Second person Singular
խաչմերուկ	None
կլափեին	Third person Plural
հորթը	None
չսադրեցիք	Second person Plural
չհասկանան	Third person Plural
մլակներ	None
չհղեց	Third person Singular
չարորեք	Second person Plural
կռվել	None
սպասարկելու	None
չահագնանաք	Second person Plural
կզենեինք	First person Plural
բարելավեմ	First person Singular
չագարակացնեին	Third person Plural
շռեցի	First person Singular
սանսկրիտի	None
կենցաղից	None
բիբդ	None
չհոսեք	Second person Plural
հոխորտա	Third person Singular
կկախեք	Second person Plural
ինքնահավանեք	Second person Plural
գլեց	Third person Singular
հակասեմականության	None
ավտոմեքենայի	None
զետեղեմ	First person Singular
առանցքները	None
բդկես	Second person Singular
կորնչեինք	First person Plural
երե	None
ճկեն	Third person Plural
հարաբերություն	None
կզարմանար	Third person Singular
խրձերով	None
չշատացանք	First person Plural
կջղայնանար	Third person Singular
դատարկենք	First person Plural
կսորայի	First person Singular
ուզեմ	First person Singular
հաղարջ	None
իմպերիալիզմը	None
չծնգցրեց	Third person Singular
կխռթացներ	Third person Singular
կորնչի	Third person Singular
ավագի	None
հղեն	Third person Plural
չմոռանան	Third person Plural
նպաստով	None
չփոխանակեր	Third person Singular
սրտաշարժենք	First person Plural
կմոտեցնեին	Third person Plural
չզգեցան	Third person Plural
ցուցանակին	None
մեծանայիք	Second person Plural
խորովեցինք	First person Plural
ուսումնասիրեին	Third person Plural
ստրկացնեք	Second person Plural
չայցելենք	First person Plural
զրույց	None
կաղապարը	None
սպանություն	None
թրծեր	Third person Singular
թրմեինք	First person Plural
աշունը	None
չսազեցինք	First person Plural
ճաղից	None
սանրեր	Third person Singular
կթլփատենք	First person Plural
պահպանեք	Second person Plural
կուրի	None
պառկեց	Third person Singular
օժանդակեցիք	Second person Plural
քյաբաբներ	None
նազեցին	Third person Plural
կարմանար	Third person Singular
չքչքչաս	Second person Singular
մոտից	None
չկենդանանանք	First person Plural
վանեցի	First person Singular
չհենեիր	Second person Singular
ճաքեիք	Second person Plural
բանավեճ	None
ագռավանաս	Second person Singular
հանձնեցին	Third person Plural
կաներկյուղանան	Third person Plural
քրտնում	None
մեյդանի	None
ընդգծեցինք	First person Plural
աշխատեցին	Third person Plural
աղոթեցիր	Second person Singular
չքամեն	Third person Plural
չքչքչային	Third person Plural
չկիրառեիք	Second person Plural
շնաձկների	None
չհածեիր	Second person Singular
նախընտրեցին	Third person Plural
սարսափենք	First person Plural
կբարեւեք	Second person Plural
չաղարտեր	Third person Singular
ներբեռնեինք	First person Plural
պատառես	Second person Singular
կհակազդես	Second person Singular
մահացան	Third person Plural
կրեին	Third person Plural
բանբերների	None
կհառեի	First person Singular
կհետազոտես	Second person Singular
չկարողանա	Third person Singular
ճանդարիդ	None
բույրով	None
չմեկնեն	Third person Plural
կլիանան	Third person Plural
կշիջուցանենք	First person Plural
ապաշխարեցին	Third person Plural
հանգեցիք	Second person Plural
շարժվեր	Third person Singular
չվրդովեցին	Third person Plural
արտերի	None
չխթանեմ	First person Singular
ալյումինով	None
անձրեւեց	Third person Singular
արբեն	Third person Plural
կհամաձայնեիք	Second person Plural
չխածատեր	Third person Singular
չապահովվեինք	First person Plural
լքներ	Third person Singular
չագարականար	Third person Singular
ծլարձակեր	Third person Singular
ուղեկցող	None
կթրջեինք	First person Plural
կբացառեմ	First person Singular
կփրփրայինք	First person Plural
բիլով	None
չձաղկեց	Third person Singular
կհայտնեմ	First person Singular
սրտառեցի	First person Singular
խարխալեցին	Third person Plural
վեճեր	None
կորոճեմ	First person Singular
կքննարկեինք	First person Plural
տուբերկուլոզը	None
չբուսնեցի	First person Singular
հրեշի	None
խոստացնել	None
աջակցեին	Third person Plural
չտառապի	Third person Singular
կմալեք	Second person Plural
դատարկեիք	Second person Plural
կկշռեմ	First person Singular
զանգակը	None
մօտենալու	None
կրճատում	None
հանգստանան	Third person Plural
խօսի	Third person Singular
լկստվեն	Third person Plural
էջումդ	None
կաղապար	None
ձուլեցի	First person Singular
հարեմ	First person Singular
չքոչեցին	Third person Plural
չոգես	Second person Singular
չկաշկանդեն	Third person Plural
չզարմացաք	Second person Plural
հայող	None
չկարմրանաս	Second person Singular
չղջիկ	None
բեկանեիք	Second person Plural
լինդ	None
ազդեցությունները	None
չծծեցինք	First person Plural
կչաղանա	Third person Singular
ագուցվեք	Second person Plural
ջրհոր	None
չափածոս	None
էտի	Third person Singular
չմատուցեց	Third person Singular
կհոգա	Third person Singular
գոչեց	Third person Singular
բաջաղեիր	Second person Singular
նախասրահ	None
հագավ	Third person Singular
կհատկացնեն	Third person Plural
գիտակցեինք	First person Plural
չջղայնացրեց	Third person Singular
հենի	Third person Singular
չբզզար	Third person Singular
հատու	None
ռուսական	None
զառամանա	Third person Singular
աքսորեցին	Third person Plural
հիասթափեցրիր	Second person Singular
ցանկանար	Third person Singular
էվոլյուցիոններովդ	None
երիկամներ	None
քունեին	Third person Plural
բորբոքեցին	Third person Plural
առաջարկությունը	None
կառավարությանը	None
չհուսալքեինք	First person Plural
կհամարի	Third person Singular
զարմացան	Third person Plural
խառնարաններով	None
վերջինիդ	None
քննարկեն	Third person Plural
աշխատակազմը	None
չկաղկանձի	Third person Singular
կարծի՛ր	Second person Singular
թողություն	None
փարթամացա	First person Singular
կմիանամ	First person Singular
սորենք	First person Plural
չապահովացներ	Third person Singular
չփրփրացիք	Second person Plural
քննելու	None
հպատակվել	None
խառնեցի	First person Singular
հատով	None
հրեշտակի	None
արտասվեմ	First person Singular
տշեց	Third person Singular
չօրհնեցիք	Second person Plural
չոլորակեիք	Second person Plural
չդատապարտեր	Third person Singular
չհուռթացավ	Third person Singular
նախկինը	None
կալանք	First person Plural
կդիեին	Third person Plural
գմբեթների	None
ճամփորդների	None
արձագանքես	Second person Singular
չմածվեցիր	Second person Singular
խոյացար	Second person Singular
անզգայացուցիչիդ	None
սփոփվեցի	First person Singular
բանեցնեիր	Second person Singular
վերագրվել	None
տատրակի	None
ներդրումը	None
նյարդերդ	None
կսփռեիք	Second person Plural
կկնքի	Third person Singular
կզարմացնի	Third person Singular
ավտոտնակում	None
վայելես	Second person Singular
բաղխեիր	Second person Singular
կապահովվի	Third person Singular
աքսորում	None
մոլեգնի՛ր	Second person Singular
բավարարում	None
ջանան	Third person Plural
ձեռիցս	None
ձվաձեւ	None
խօսէր	Third person Singular
կհղենա	Third person Singular
չբանա	Third person Singular
պոմպով	None
չճոռոմախոսեիր	Second person Singular
հուսահատեցնեիր	Second person Singular
օգտագործեց	Third person Singular
հայտեր	None
չակնածեիք	Second person Plural
հավաքածուներին	None
չարածեցրին	Third person Plural
բխի	Third person Singular
սրեր	None
կրեիր	Second person Singular
կապացուցվեն	Third person Plural
բարբարոս	None
մուրայի	First person Singular
չկողոպտեն	Third person Plural
շիկանար	Third person Singular
չծուլանաք	Second person Plural
հարսնանայինք	First person Plural
ցանկանամ	First person Singular
զորապետ	None
խոցեի	First person Singular
չհայտնեց	Third person Singular
քննությանը	None
ամայացավ	Third person Singular
արժեքիցդ	None
ազգականի	None
աշորան	None
չբողոքես	Second person Singular
քննարկեցի	First person Singular
ծպտեք	Second person Plural
օգտագործեք	Second person Plural
կվճարես	Second person Singular
հայթայթեցինք	First person Plural
ստամբակող	None
վարչապետացուն	None
ձիթայուղից	None
չարհամարհեիք	Second person Plural
չախտորոշեցիք	Second person Plural
կփորձեք	Second person Plural
չազդեց	Third person Singular
չվերուվարեցինք	First person Plural
լողանան	Third person Plural
խթան	None
չողջագուրեցիք	Second person Plural
չկարօտի	Third person Singular
հյուծեր	Third person Singular
կկարոտեիր	Second person Singular
զառամացի՛ր	Second person Singular
ցուցաներ	Third person Singular
երգահանը	None
շարժվեց	Third person Singular
կհասցնեն	Third person Plural
ստուգի	Third person Singular
չսիրուէր	Third person Singular
կայարաններից	None
կսիգաք	Second person Plural
չխորովեիր	Second person Singular
հատակեիր	Second person Singular
տրամաբանություններումդ	None
կցանկանաք	Second person Plural
չայցելեցիք	Second person Plural
խանդեցի	First person Singular
հումորներ	None
չանկանես	Second person Singular
ոլորակեր	Third person Singular
մնացորդից	None
կբխի	Third person Singular
չագուցանեցինք	First person Plural
չկործեմ	First person Singular
չհոլանեցինք	First person Plural
չխռթացրինք	First person Plural
կճամփորդեք	Second person Plural
հուսահատվում	None
ողջույնի	None
դիի՛ր	Second person Singular
նետեցիր	Second person Singular
Ամանորը	None
ավանակի	None
կմղի	Third person Singular
քսակի	None
բանվորի	None
չխեթկեցիք	Second person Plural
շարունակի	Third person Singular
հսկաներից	None
մոլեկուլի	None
ուռչում	None
ձգեր	None
բողոք	None
չծափահարվեցին	Third person Plural
կթարթեիր	Second person Singular
կռնչեք	Second person Plural
էրեներ	None
հատվել	None
կշարժվենք	First person Plural
զույգի	None
չպատրաստեի	First person Singular
չճկեիք	Second person Plural
լիբրացիա	None
պարտվեց	Third person Singular
ծիրանի	None
փորձես	Second person Singular
կիրճով	None
արդարացնեք	Second person Plural
ստորինում	None
չսանձեի	First person Singular
սփոփեն	Third person Plural
պրակները	None
բացատրեն	Third person Plural
կնավես	Second person Singular
խրթեր	Third person Singular
կպաղատեի	First person Singular
բաղխեցիր	Second person Singular
չակնածեին	Third person Plural
մտաբերեինք	First person Plural
մրսի	Third person Singular
ղայիշներից	None
բարելավելու	None
չվախեն	Third person Plural
անմոռուկ	None
կմրսեր	Third person Singular
պարողները	None
չմոլեգնեցի	First person Singular
չկառավարի	Third person Singular
բանայի	First person Singular
կըլնեն	Third person Plural
տռեիք	Second person Plural
ցեց	None
խոխոջար	Third person Singular
կսովորի	Third person Singular
աստվածաբանության	None
չվանկած	None
ապրիլը	None
կմղձկաք	Second person Plural
մանրադիտակների	None
բացառել	None
ծովագնացների	None
չհագնես	Second person Singular
փայլունությանս	None
պալասատովիումս	None
արեւադարձերին	None
ծիծաղանք	First person Plural
չնպաստենք	First person Plural
արտաքսեց	Third person Singular
կսանձեինք	First person Plural
լուտամ	First person Singular
կլկստվեն	Third person Plural
չվերագրեմ	First person Singular
ապստամբեց	Third person Singular
մայեն	Third person Plural
թագումս	None
սերկեւիլենիդ	None
օծեց	Third person Singular
բնագրում	None
մերկացել	None
կոչին	None
չխեթկեիր	Second person Singular
զարթնեին	Third person Plural
կզարմանաք	Second person Plural
չպատառեց	Third person Singular
սագերի	None
հավաքույթին	None
կխուզեի	First person Singular
կհերքեիք	Second person Plural
չսիրուեցիր	Second person Singular
ակռաներիցս	None
չառերեսեք	Second person Plural
ստալինիզմի	None
թրեյլեր	None
կքեցի	First person Singular
հազարամյակով	None
չփրփրեցի	First person Singular
հիվանդությունները	None
շվեյցարիս	None
չագուցվեցիք	Second person Plural
ործկար	Third person Singular
չտրցակեն	Third person Plural
նվացի	First person Singular
լծել	None
քերականագետներ	None
կամեցավ	Third person Singular
գործընկերներին	None
թագվոր	None
չհիանեի	First person Singular
հայրանուն	None
կսանձահարեր	Third person Singular
կտենար	Third person Singular
պայմանավորվենք	First person Plural
պարապեցիր	Second person Singular
ժողովրդի	None
լիացավ	Third person Singular
հարդում	None
նպաստեր	Third person Singular
կկամենայի	First person Singular
չհիասթափեցնեիք	Second person Plural
գալյեգոյից	None
կողորմեիր	Second person Singular
ցեղի	None
կերցներ	Third person Singular
բավարարեիր	Second person Singular
համաձայնեին	Third person Plural
վկայությունդ	None
շարժվի	Third person Singular
հրահրվել	None
չաղոթեցինք	First person Plural
գործազրկությունումդ	None
կպագեի	First person Singular
հաստատեցի	First person Singular
համիդ	None
չպապանձվեիք	Second person Plural
կթրմեք	Second person Plural
սխալներին	None
ոռնաց	Third person Singular
կքորի	Third person Singular
կմերձենաք	Second person Plural
կիսեց	Third person Singular
սպանեց	Third person Singular
կհոտեի	First person Singular
խոցեցին	Third person Plural
վախեցան	Third person Plural
մասնիկների	None
ճախրեին	Third person Plural
մենինգիտներդ	None
թատրոն	None
լոգացար	Second person Singular
կմոգոներ	Third person Singular
փախցնեիք	Second person Plural
չհատկացրինք	First person Plural
կզվարճանաք	Second person Plural
ճուճուլից	None
տնայինից	None
թաշկինակը	None
չսպրդեց	Third person Singular
տեւումդ	None
պատկանեցի	First person Singular
օրհնեցիք	Second person Plural
պաշտեցին	Third person Plural
բարեւեք	Second person Plural
չհասկացավ	Third person Singular
չաղատեցիք	Second person Plural
չհարկանի	Third person Singular
ազազի	Third person Singular
օգոստոսների	None
ապրիլյանը	None
հոբելյաններին	None
չգեղգեղեմ	First person Singular
գորշավուն	None
կդողային	Third person Plural
կթովեր	Third person Singular
վերքերով	None
ործկայի	First person Singular
նախահոր	None
կշշնջային	Third person Plural
կմղձկեին	Third person Plural
ընկճող	None
կալնեմ	First person Singular
չվեք	Second person Plural
հոգնածություն	None
հավաքածուների	None
չխօսես	Second person Singular
չհաճախեցին	Third person Plural
բզզան	Third person Plural
բեկորներից	None
ուժեղացան	Third person Plural
չփայփայեցիք	Second person Plural
քաղաքի	None
կհեռացնի	Third person Singular
չնվաս	Second person Singular
չշատանայիր	Second person Singular
վասալներ	None
կեղծեմ	First person Singular
չհարկանեք	Second person Plural
կերակրի	Third person Singular
վրացիներով	None
կփսխեր	Third person Singular
կդրսեւորվեմ	First person Singular
կկերտեիք	Second person Plural
գոգեն	Third person Plural
չվհատեցնեինք	First person Plural
չանհանգստացաք	Second person Plural
զեղեր	Third person Singular
դոլարներից	None
հարնչենք	First person Plural
խանութներ	None
հրամայեցի	First person Singular
համի	Third person Singular
կբացառվեինք	First person Plural
տենա	Third person Singular
չբուսանի	Third person Singular
կհարսնացնեք	Second person Plural
չխթեցին	Third person Plural
մսիս	None
կհարբեինք	First person Plural
պղինձ	None
չշողաց	Third person Singular
ամբարտավանեն	Third person Plural
մեկնեինք	First person Plural
մանգաղը	None
չընդարմացար	Second person Singular
սիբորգիում	None
կվհատեինք	First person Plural
մեծարեց	Third person Singular
գոյականները	None
չշատանար	Third person Singular
հայրերին	None
գեղգեղի	Third person Singular
կոչով	None
ձգտեր	Third person Singular
վաճառեց	Third person Singular
բաժեր	None
կապահովանայիք	Second person Plural
կփոխանակեին	Third person Plural
երդվեց	Third person Singular
սնգուրվեիք	Second person Plural
կխնկես	Second person Singular
ճանճ	None
ուրանում	None
հայտարարած	None
տրամագծով	None
չորդ	None
խոչընդոտեցին	Third person Plural
վարորդի	None
կնախընտրեի	First person Singular
չխոխոջեին	Third person Plural
տրամագծին	None
հայթայթել	None
չուզեցիր	Second person Singular
խնկի	Third person Singular
չկերակրի	Third person Singular
չգոլանան	Third person Plural
կիրառեց	Third person Singular
շնաձկներ	None
ընթեռնե՛ք	Second person Plural
փորձեց	Third person Singular
ծծակներովս	None
նպաստեցիր	Second person Singular
կհիմնավորեն	Third person Plural
թամադաներիցս	None
բառարաններից	None
ոգի	Third person Singular
կտառապեիր	Second person Singular
չբողբոջեն	Third person Plural
կքայլեմ	First person Singular
չերկկտտացնեինք	First person Plural
փախավ	Third person Singular
ներողություն	None
ալկոհոլայիններին	None
կկարեկցի	Third person Singular
տնակ	None
իշխանափոխության	None
արթնանալիս	None
հեռացնենք	First person Plural
մետաղներին	None
լազերայինին	None
ատի՛ր	Second person Singular
կկատարեիր	Second person Singular
բացառվեն	Third person Plural
չշփեիք	Second person Plural
ակումբներին	None
չարգելեք	Second person Plural
չկարողանար	Third person Singular
տեւեն	Third person Plural
կբաղձայինք	First person Plural
կայացած	None
չդարսի	Third person Singular
հաճախեցրին	Third person Plural
հերքվեին	Third person Plural
տառադարձես	Second person Singular
ճախրեն	Third person Plural
ծերուկ	None
կզգուշանաս	Second person Singular
վանես	Second person Singular
ծնի	Third person Singular
տարաների	None
հրահրես	Second person Singular
ծնելու	None
կճողոպրի	Third person Singular
ելուզակների	None
մոլորվեն	Third person Plural
զղջացիք	Second person Plural
կկռանայի	First person Singular
կկատարի	Third person Singular
քարափ	None
ճմռթ	None
չխայթեն	Third person Plural
հիմնավորեցին	Third person Plural
խոպոպանաք	Second person Plural
բռնաբարի՛ր	Second person Singular
նետեց	Third person Singular
ճշգրտեմ	First person Singular
արթնացնել	None
բոյ	None
հորանջեիք	Second person Plural
չթովենք	First person Plural
գնչեցինք	First person Plural
ապացուցենք	First person Plural
կբղավեն	Third person Plural
փռթկացնեք	Second person Plural
կկոշկոճեի	First person Singular
օսերեններովս	None
մոխրոտ	None
ոլորքներից	None
խնամեիք	Second person Plural
բավարար	None
լրտեսեք	Second person Plural
արագիլների	None
կէթայիր	Second person Singular
կտրոհեիր	Second person Singular
չմղեմ	First person Singular
կմտցնեի	First person Singular
ոռնալ	None
վարչապետներ	None
թալիում	None
կխնամի	Third person Singular
կացարանից	None
գաղտնաբառը	None
կկազմակերպեիք	Second person Plural
քառյակ	None
երկայնքը	None
հնդկացորեն	None
ատեցինք	First person Plural
կանխամտածվեցին	Third person Plural
չխրթես	Second person Singular
պաշտեր	Third person Singular
սրտառեի	First person Singular
չհյուսես	Second person Singular
մրցես	Second person Singular
վճռի	Third person Singular
կեղծանեիր	Second person Singular
չխոպոպվես	Second person Singular
կթքենք	First person Plural
ավելացնենք	First person Plural
հաղորդումից	None
կծաղրեն	Third person Plural
չծծեն	Third person Plural
չամուսնացնի	Third person Singular
ճմռթենք	First person Plural
չչարանանք	First person Plural
կչվեր	Third person Singular
ատես	Second person Singular
կկեղեքենք	First person Plural
փարվեց	Third person Singular
ծուլացե՛ք	Second person Plural
կապշենք	First person Plural
չխոթեց	Third person Singular
առագաստներով	None
ափսեների	None
սովորեց	Third person Singular
զննեմ	First person Singular
չմեծանա	Third person Singular
հետազոտի՛ր	Second person Singular
տրամադրեն	Third person Plural
կրակեմ	First person Singular
կաղապարով	None
գիհու	None
կկանգնեք	Second person Plural
չդատապարտեք	Second person Plural
բացատրենք	First person Plural
չուզենայինք	First person Plural
ուզեցանք	First person Plural
պակաս	None
չկախեցինք	First person Plural
չքերեցիր	Second person Singular
չքորեցինք	First person Plural
չհարգեիր	Second person Singular
կոշկոճեին	Third person Plural
պանծաս	Second person Singular
հպարտանաս	Second person Singular
չլուտացիք	Second person Plural
համաձայնես	Second person Singular
չտառադարձեիք	Second person Plural
պագնենք	First person Plural
իլում	None
քարոզարշավը	None
ուսումնասիրած	None
խազեն	Third person Plural
էմիգրանտները	None
չթվարկեին	Third person Plural
մեծանային	Third person Plural
չհոշոտեին	Third person Plural
կկթոտեր	Third person Singular
ճամփեր	Third person Singular
կհոխորտաս	Second person Singular
քավեիր	Second person Singular
օգտագործեին	Third person Plural
հարթուկեին	Third person Plural
կհիմնավորեիր	Second person Singular
կվերընթերցեիք	Second person Plural
ուռթեիր	Second person Singular
զսպանակի	None
շեշտի	Third person Singular
օճառը	None
պատկերի	Third person Singular
կքավեիք	Second person Plural
կկես	Second person Singular
ավետարանի	None
ոսկեհուռովս	None
փոխարինում	None
լամայի	None
ցուցակներ	None
չգգվեց	Third person Singular
գիսաստղերի	None
կործկայինք	First person Plural
չվերուվարենք	First person Plural
երդվեցին	Third person Plural
ուղարկեցին	Third person Plural
չփախցրինք	First person Plural
կրծքով	None
հածեին	Third person Plural
կարդուկեին	Third person Plural
չբզզայիր	Second person Singular
չփութացրի	First person Singular
արմավենիների	None
կոճապղպեղներովս	None
չկծեմ	First person Singular
բասկերենի	None
արդ	None
կկարեկցեինք	First person Plural
չընդգծեցին	Third person Plural
մսեղեն	None
հիանեի	First person Singular
կեչուպիդ	None
կկթոտես	Second person Singular
չկճենք	First person Plural
չբաջաղեին	Third person Plural
լենինիզմ	None
կռվի	Third person Singular
գորշուկի	None
չգուրգուրայիք	Second person Plural
չաշխատեց	Third person Singular
կաթնուկ	None
կմեղանչեին	Third person Plural
նետի	Third person Singular
չարերի	None
հոշոտեցիր	Second person Singular
մատնեց	Third person Singular
պագ	None
անձրեւեցին	Third person Plural
վռնդելու	None
արտագաղթեցինք	First person Plural
կխոչընդոտեմ	First person Singular
ծեփի	Third person Singular
չապշեն	Third person Plural
աղատեն	Third person Plural
կարձագանքեն	Third person Plural
կգանգրացվեիր	Second person Singular
կզրուցեիք	Second person Plural
քառակուսիներումս	None
գնենք	First person Plural
կդիեիր	Second person Singular
աղատեր	Third person Singular
բաղբաջեիր	Second person Singular
տարբերվել	None
կտրամադրեր	Third person Singular
բարձրաձայնեց	Third person Singular
կողոպտելու	None
հղանաք	Second person Plural
կաթնասունի	None
եղերական	None
խույրի	None
կչվեմ	First person Singular
մեկնեց	Third person Singular
չբեկանեիք	Second person Plural
չգնեինք	First person Plural
պողոտայում	None
թթվով	None
սրբուհու	None
մերկացավ	Third person Singular
բառարանների	None
չնվաղես	Second person Singular
չստուգես	Second person Singular
կընտրվեն	Third person Plural
մետրեր	None
չգովեցին	Third person Plural
անզգայացնեինք	First person Plural
կշփոթեցներ	Third person Singular
գարշապարի	None
փոխարինեց	Third person Singular
մրմնջանք	First person Plural
սազովս	None
կէղներ	Third person Singular
բոպիկ	None
խոպոպվես	Second person Singular
կբուծեն	Third person Plural
ազդեմ	First person Singular
փորեինք	First person Plural
չմտցրի	First person Singular
կմատչեի	First person Singular
ապացուցվես	Second person Singular
գոգեի	First person Singular
ջին	None
ընդգծեն	Third person Plural
արթնացող	None
գրազ	None
չվհատեցրի	First person Singular
չուզեցավ	Third person Singular
որսաց	Third person Singular
հատա	First person Singular
չսանրվեցիք	Second person Plural
չքամեմ	First person Singular
կսազաս	Second person Singular
չորսար	Third person Singular
կբնակվեն	Third person Plural
ջեռուցեցիք	Second person Plural
կքաքեիր	Second person Singular
խնչեին	Third person Plural
կգլեն	Third person Plural
կփչի	Third person Singular
չաքսորվեցի	First person Singular
չներկայացրեց	Third person Singular
կճամփեի	First person Singular
Ծաղկազարդ	None
շնչեցինք	First person Plural
սնգուրվեցիր	Second person Singular
կկարողանամ	First person Singular
գուրամ	First person Singular
երազի՛ր	Second person Singular
չհյուծեց	Third person Singular
լոգանքների	None
գիտակցեց	Third person Singular
խալեր	None
արվեստագետներին	None
վերադարձան	Third person Plural
չսանձեցինք	First person Plural
դաշտան	None
կթռնի	Third person Singular
չառոգաներ	Third person Singular
չգուրայիք	Second person Plural
գրչատուփով	None
կհարբեք	Second person Plural
էտեցի	First person Singular
թարխանային	None
մառանի	None
սարսափեի	First person Singular
չկարողացա	First person Singular
ոգեշնչեք	Second person Plural
չհագնեմ	First person Singular
անմոռուկներումս	None
արհեստավորի	None
չափեցին	Third person Plural
կքենք	First person Plural
վճարեցին	Third person Plural
չշշնջա	Third person Singular
կուղխ	None
էվոլյուցիոններովս	None
խրոխտություններ	None
հնարքից	None
արբանյակ	None
գյուղացիներ	None
հավաքարարովդ	None
անկանեք	Second person Plural
չկռնչեցի	First person Singular
խարխլես	Second person Singular
հասկ	None
կսազան	Third person Plural
շաչյուններովդ	None
կհոգան	Third person Plural
հոսեին	Third person Plural
կհրահրես	Second person Singular
չհատեք	Second person Plural
ստվարաթիվներումդ	None
քարոզի	Third person Singular
կդարսեր	Third person Singular
երկայնաբազուկը	None
չհմայես	Second person Singular
հավելի	Third person Singular
կհոլաթեւեիր	Second person Singular
կսորան	Third person Plural
չաճեի	First person Singular
հոգնածությունից	None
չխրախուսի	Third person Singular
կգգվեիր	Second person Singular
թռան	Third person Plural
չշիկանամ	First person Singular
կբղավենք	First person Plural
բրթեցիր	Second person Singular
ճանապարհներին	None
չատեմ	First person Singular
չհիասթափեցնեինք	First person Plural
շարժվեցին	Third person Plural
չծնեցիր	Second person Singular
ստամբակի	Third person Singular
ապրուստի	None
կեռանք	First person Plural
խմբագրի	Third person Singular
չկոչեիք	Second person Plural
չհեղեցին	Third person Plural
ուռեր	Third person Singular
չփարթամանաս	Second person Singular
ավելացնեմ	First person Singular
առոգանությունը	None
կլափեի	First person Singular
կծփեին	Third person Plural
