ukorijenjene	Participle
kontaktirali	Participle
ponovio	Participle
obaveštavaju	Verb
spominju	Verb
potpredsjednike	Noun
razglasio	Participle
kriterijem	Noun
prorađivane	Participle
raskinut	Participle
refrena	Noun
dostavljale	Participle
rezistencijom	Noun
toksikologiju	Noun
zauzimaj	Verb
zbrajaju	Verb
grušajmo	Verb
športom	Noun
prijavljuje	Verb
sabrali	Participle
prognate	Verb
himeru	Noun
zakazan	Participle
razasuh	Verb
ograničilo	Participle
ubrizgavao	Participle
čarobnjáci	Noun
krivicom	Noun
izrečeni	Participle
povređen	Participle
uljepšavaste	Verb
ćelo	Noun
granit	Noun
чмарни	Adjective
komoru	Noun
hagiografiju	Noun
darovano	Participle
magnetíta	Noun
spalili	Participle
udrugu	Noun
sviramo	Verb
maorskom	Adjective
razarača	Noun
krajišku	Adjective
porušene	Participle
pokušao	Participle
kodeksa	Noun
stubove	Noun
delovi	Noun
česmom	Noun
manevrom	Noun
pokrštavao	Participle
liječnike	Noun
ekonomijom	Noun
непознат	Adjective
isterani	Participle
zagreje	Verb
pritisnemo	Verb
obijaste	Verb
većinskom	Adjective
obožavan	Participle
utrkuje	Verb
rožnjaci	Noun
kukove	Noun
izbio	Participle
otiska	Noun
kanovi	Noun
ljepotu	Noun
krilcem	Noun
mirovnom	Adjective
malteškom	Adjective
klavirom	Noun
žȅzālā	Noun
čovjekomrzac	Noun
ikavizmi	Noun
čuvare	Noun
gonoreje	Noun
zasađene	Participle
njujorškom	Adjective
kuhaju	Verb
popravljene	Participle
komorom	Noun
koegzistenciju	Noun
nosačem	Noun
detektirao	Participle
pučkom	Adjective
pošumljivane	Participle
saborskom	Adjective
kajkavštine	Noun
kapitalizma	Noun
anđelkom	Noun
источни	Adjective
dopuštale	Participle
pozove	Verb
gigantom	Noun
promiču	Verb
iznjedrili	Participle
odjeci	Noun
најубитачнији	Adjective
obuzimale	Participle
potražio	Participle
šaputah	Verb
orao	Participle
prikazao	Participle
cvjetaju	Verb
kujo	Noun
agregatnom	Adjective
povećan	Participle
bilježničku	Adjective
spremom	Noun
svakodnevicu	Noun
kapiju	Noun
grofa	Noun
središe	Verb
skupljeni	Participle
bluz	Noun
poslano	Participle
rezultiralo	Participle
aluminija	Noun
rezime	Noun
blagostanja	Noun
priđeš	Verb
lihvom	Noun
nemali	Participle
oleat	Noun
ispao	Participle
utjecaje	Noun
podvig	Noun
posetitele	Noun
žalilac	Noun
vrbu	Noun
izgledom	Noun
podvalu	Noun
иновативан	Adjective
naglasilo	Participle
krajnost	Noun
sefova	Noun
pletenicu	Noun
nivoe	Noun
ćirilice	Noun
podijelilo	Participle
preseljavali	Participle
lolo	Noun
slomom	Noun
njuškom	Noun
kozak	Noun
razvezale	Participle
plebejci	Noun
preoteli	Participle
povukle	Participle
ispravili	Participle
oterao	Participle
tvorio	Participle
teozofija	Noun
primoran	Participle
kreveče	Noun
sadržavalo	Participle
lasere	Noun
savjetovali	Participle
nazadovao	Participle
najbezobzirniju	Adjective
prolistali	Participle
svežanj	Noun
divljinom	Noun
ustrojavam	Verb
biljnu	Adjective
prostorijom	Noun
stisnut	Participle
potvrdio	Participle
priznale	Participle
takte	Noun
potpisao	Participle
uvriježio	Participle
navaljivali	Participle
ovlašteni	Participle
uočili	Participle
zatajio	Participle
sjećali	Participle
hladnoratovskom	Adjective
tangentu	Noun
vrpolje	Verb
pokrenimo	Verb
strvinare	Noun
пуст	Adjective
obilazio	Participle
metropolu	Noun
oprostio	Participle
održavano	Participle
memorijom	Noun
autoputa	Noun
krčkom	Adjective
pribijan	Participle
bokca	Noun
odazvalo	Participle
potrošene	Participle
raspale	Participle
osteopatijo	Noun
zasedanjem	Noun
snopove	Noun
ublažio	Participle
isekle	Participle
rtovi	Noun
pokršteno	Participle
gozbu	Noun
dotrčava	Verb
sađen	Participle
curicu	Noun
ugine	Verb
dospije	Verb
deljeni	Participle
izumreste	Verb
shvaćene	Participle
мочварни	Adjective
suparnikom	Noun
visovi	Noun
razmotrili	Participle
aksioma	Noun
nedostaci	Noun
strpljenjem	Noun
acetona	Noun
iritiraju	Verb
graničarom	Noun
anestetike	Noun
proizvođače	Noun
odabrali	Participle
oporavljali	Participle
sastajalo	Participle
učinilo	Participle
preraspodelom	Noun
sedlare	Noun
kozom	Noun
porušio	Participle
инфериоран	Adjective
dječaštvom	Noun
napinjem	Verb
словачки	Adjective
indoeuropskom	Adjective
alveolo	Noun
lȅdolōmče	Noun
nasukani	Participle
adaptirao	Participle
bakroreze	Noun
poslao	Participle
gledamo	Verb
zadaje	Verb
лажни	Adjective
prilagođavali	Participle
laska	Verb
konturu	Noun
poboljšali	Participle
pripiše	Verb
sociološku	Adjective
oterasmo	Verb
impotencijom	Noun
okovani	Participle
nadom	Noun
snabdete	Verb
tiskane	Participle
proveru	Noun
zaustavio	Participle
razoreni	Participle
làžī	Noun
otječu	Verb
prizoveš	Verb
krnjeni	Participle
ovlašćuješ	Verb
lombardiraj	Participle
paci	Noun
brđane	Noun
povrijeđeno	Participle
obojice	Noun
omladina	Noun
abdiciraste	Verb
sijenom	Noun
sira	Noun
derasmo	Verb
ulizani	Participle
pretpostavljao	Participle
odsijecasmo	Verb
sabirali	Participle
raspalo	Participle
doplove	Verb
iskopano	Participle
brinjaste	Verb
preostaju	Verb
povjesničar	Noun
nejasnòća	Noun
najavili	Participle
ocjenjivali	Participle
lijesa	Noun
орнитолошки	Adjective
prsnom	Adjective
mikroorganizam	Noun
kipove	Noun
izobličen	Participle
prisjetili	Participle
istupaju	Verb
pomešali	Participle
poretkom	Noun
raseliše	Verb
protiče	Verb
leman	Participle
osvajačem	Noun
vekove	Noun
kajah	Verb
obuzdali	Participle
dinsta	Verb
lobanjom	Noun
predodžbu	Noun
tračkom	Adjective
preporučeno	Participle
učinjeno	Participle
akru	Noun
građen	Participle
buk	Noun
ponudile	Participle
демократски	Adjective
pisali	Participle
dodate	Verb
primljeni	Participle
kovačnicom	Noun
глибави	Adjective
први	Adjective
pivare	Noun
približio	Participle
prožesmo	Verb
razmenio	Participle
antimona	Noun
skrenut	Participle
maramicu	Noun
uređaje	Noun
hašiša	Noun
učinke	Noun
krhotinom	Noun
vapnom	Noun
povredili	Participle
odbija	Verb
bigamija	Noun
dopunjen	Participle
detalje	Noun
romantičare	Noun
napadajte	Verb
dodajem	Verb
stečevinom	Noun
preračunato	Participle
ponizio	Participle
strankinjom	Noun
saradnjom	Noun
revizijom	Noun
cvjetnom	Adjective
razmišljali	Participle
sijediju	Adjective
kreveljim	Verb
trupova	Noun
istinu	Noun
prikupljeni	Participle
šestérci	Noun
alku	Noun
utemeljene	Participle
lȋstākā	Noun
stana	Noun
policijo	Noun
braćom	Noun
usvojili	Participle
vlaka	Noun
mesečnu	Adjective
poniženi	Participle
mjestom	Noun
izostane	Verb
bolničku	Adjective
odudaram	Verb
dvanaestoricu	Noun
značajkom	Noun
manekenkom	Noun
imaginacijom	Noun
izazvali	Participle
misijom	Noun
bacale	Participle
združuje	Verb
атлантски	Adjective
iskopava	Verb
decimetara	Noun
ostani	Verb
potpisivao	Participle
pruća	Noun
opasane	Participle
rivala	Noun
ledino	Noun
gnevom	Noun
prenošeni	Participle
listićem	Noun
rakija	Noun
proslavljeni	Participle
metan	Noun
zbroje	Verb
velikodušnost	Noun
zapisuješ	Verb
dočekali	Participle
obustavljeni	Participle
zavarali	Participle
cepaju	Verb
pevač	Noun
podjarmljivale	Participle
smjenjivalo	Participle
odbacivali	Participle
preplivavahu	Verb
puža	Noun
uticalo	Participle
zobah	Verb
izazvano	Participle
riješeni	Participle
rimom	Noun
turist	Noun
gledaoče	Noun
parolu	Noun
špekom	Noun
oltarom	Noun
zabrinuste	Verb
savjetnike	Noun
zgrejavaste	Verb
koritom	Noun
izoštravali	Participle
sjevernjake	Noun
cvatova	Noun
potopljene	Participle
anđeosku	Adjective
proglašen	Participle
otpušten	Participle
egzila	Noun
đak	Noun
ispražnjeni	Participle
pritisnuli	Participle
pričekaju	Verb
tjerani	Participle
tražile	Participle
izveštava	Verb
prisjeća	Verb
renesansnom	Adjective
avarskom	Adjective
ugovorom	Noun
podsećah	Verb
odvažnost	Noun
miliciju	Noun
razboleh	Verb
nagrizeš	Verb
elektromagneta	Noun
rub	Noun
prologom	Noun
držalo	Participle
povezao	Participle
kvačicom	Noun
odnosilo	Participle
uvojak	Noun
nizinsku	Adjective
ugrejano	Participle
privlače	Verb
hranile	Participle
meštanine	Noun
poslužen	Participle
komodom	Noun
barutom	Noun
vegetaciju	Noun
izostaneš	Verb
stizali	Participle
ubrizgavaju	Verb
odmicane	Participle
islandskom	Adjective
вичнији	Adjective
isporučuj	Verb
osmoricu	Noun
sindrom	Noun
biljem	Noun
mirovali	Participle
bilten	Noun
osla	Noun
metvicu	Noun
dozvolile	Participle
križnu	Adjective
but	Noun
pređoše	Verb
antonim	Noun
informirao	Participle
dodali	Participle
brzinu	Noun
prevodili	Participle
hvaljeno	Participle
napadaje	Noun
kosmonaut	Noun
tikvom	Noun
екстерни	Adjective
kajkavština	Noun
začinio	Participle
izliječio	Participle
mučenik	Noun
presecate	Verb
dojmom	Noun
šljakom	Noun
koro	Noun
glasove	Noun
stražar	Noun
brojevi	Noun
prosperirali	Participle
jedrenjake	Noun
zlikovac	Noun
smatraš	Verb
šavovi	Noun
agronomije	Noun
izručio	Participle
dječju	Adjective
isticah	Verb
fotosintezu	Noun
požarom	Noun
uništio	Participle
obije	Verb
tamilsku	Adjective
podeliše	Verb
pripeklo	Participle
nastavke	Noun
informirali	Participle
prisegneš	Verb
igračicu	Noun
cvao	Participle
rezove	Noun
stenico	Noun
dosađuju	Verb
preteču	Noun
biračkom	Adjective
obavljate	Verb
prijevoza	Noun
odabrao	Participle
posečem	Verb
spoj	Noun
nadvisujete	Verb
cakljah	Verb
dušu	Verb
prisilom	Noun
natecanjem	Noun
osvojili	Participle
ugiba	Verb
simbolizirali	Participle
probuđene	Participle
pohote	Noun
prijasmo	Verb
opomenuše	Verb
cepidlačaste	Verb
bubnjare	Noun
bubrege	Noun
proširuje	Verb
baliju	Noun
ulazile	Participle
bengalskom	Adjective
spominje	Verb
patuljke	Noun
kalendarom	Noun
klijent	Noun
slance	Noun
pošumljeni	Participle
zaštićene	Participle
znakovi	Noun
bicikl	Noun
kovačnicu	Noun
odnio	Participle
onesposobismo	Verb
primećuju	Verb
egzistencijalist	Noun
postavku	Noun
jagmu	Noun
zadužene	Participle
prepoznajemo	Verb
retor	Noun
avanturističkijom	Adjective
materija	Noun
kukce	Noun
iskorijenjeno	Participle
dokument	Noun
zaglavljeni	Participle
iluminaciju	Noun
tresli	Participle
pripadale	Participle
kruhovac	Noun
udvostručene	Participle
pretrpeo	Participle
dima	Noun
metodologijom	Noun
netočnijom	Adjective
rastanci	Noun
onečišćene	Participle
raspustili	Participle
usredotočeno	Participle
nosoroge	Noun
drukčiju	Adjective
nastavljali	Participle
hrđale	Participle
egzistencija	Noun
atrakcijom	Noun
birokraciju	Noun
socijalističku	Adjective
govoriš	Verb
čelika	Noun
otpuštene	Participle
kamiondžija	Noun
ranjavan	Participle
ovenčano	Participle
negaciju	Noun
promenjene	Participle
pustinjačkom	Adjective
vapiš	Verb
metalurgije	Noun
razlažu	Verb
dvogledom	Noun
opisivani	Participle
osjetio	Participle
izražavaju	Verb
ukrašava	Verb
unutarnjom	Adjective
osiguravaju	Verb
kolodvorom	Noun
anestetici	Noun
napitak	Noun
kolosijek	Noun
crtom	Noun
kote	Verb
blokove	Noun
temeljnu	Adjective
uvene	Verb
galon	Noun
stremenom	Noun
razgolićivali	Participle
kȇčkā	Noun
čitano	Participle
ulomke	Noun
statiku	Noun
poželeli	Participle
snabdeše	Verb
izračunaju	Verb
paradiraju	Verb
ovisile	Participle
kalemio	Participle
sahranjene	Participle
najbrdovitiju	Adjective
deblju	Adjective
upotrebljavano	Participle
odvukoh	Verb
konjanike	Noun
obitavah	Verb
silili	Participle
sintezu	Noun
iscrpljivali	Participle
delile	Participle
poludeli	Participle
saboruj	Verb
izrađeni	Participle
bibliotekom	Noun
natjeralo	Participle
munjom	Noun
glumac	Noun
ugrijavaj	Verb
propovijedali	Participle
virusom	Noun
monetarizam	Noun
hvalio	Participle
udalje	Verb
birale	Participle
pretiskom	Noun
prinčeve	Noun
razbacano	Participle
tikvu	Noun
putujem	Verb
mostova	Noun
грузијски	Adjective
menedžer	Noun
mediteransku	Adjective
skraćen	Participle
probavilo	Participle
iscuriš	Verb
parišku	Adjective
кошмарни	Adjective
iscrpemo	Verb
izvješćuju	Verb
suzbija	Verb
placento	Noun
slȃnācā	Noun
hladnijom	Adjective
razuvjerilo	Participle
molitvom	Noun
razvijale	Participle
utopiju	Noun
zamisao	Noun
lakonsku	Adjective
džipom	Noun
priveden	Participle
plastikom	Noun
otkrile	Participle
baterijom	Noun
đavla	Noun
doselilo	Participle
cepidlačah	Verb
praga	Noun
objelodanjen	Participle
zamrzavaju	Verb
uvezan	Participle
objedine	Verb
isprane	Participle
uvaljivao	Participle
nadimci	Noun
alkoholom	Noun
procijenjeno	Participle
glumile	Participle
truje	Verb
umivajmo	Verb
ograniče	Verb
sačuvan	Participle
pokrene	Verb
potplaćivahu	Verb
posjedovao	Participle
razljutio	Participle
morfizma	Noun
meteora	Noun
ostane	Verb
polože	Verb
šunja	Verb
aukciju	Noun
kaj	Verb
skupih	Verb
istrebe	Verb
razodijevan	Participle
zacementirao	Participle
kritičarku	Noun
tipkovnicom	Noun
astrofizike	Noun
nauku	Noun
napredaka	Noun
dospeo	Participle
vitezova	Noun
izvještavaju	Verb
ulovljen	Participle
nelagodu	Noun
utajujte	Verb
bačvu	Noun
најсензуалнији	Adjective
obavještavam	Verb
francusku	Adjective
mesnatijom	Adjective
hrđah	Verb
sutjeskom	Noun
krajniče	Noun
zapisali	Participle
ustanovljuje	Verb
blejao	Participle
prognali	Participle
kanto	Noun
kanalskom	Adjective
probdesmo	Verb
škriljac	Noun
onečišćujte	Verb
samlevene	Participle
tajfuna	Noun
kanjonom	Noun
obasute	Participle
raspetljaj	Verb
najezdom	Noun
avangardnu	Adjective
otorinolaringologija	Noun
odbranjen	Participle
prožima	Verb
preterale	Participle
izbrisao	Participle
avionom	Noun
predložile	Participle
obrisali	Participle
molbu	Noun
dospeju	Verb
prioritetom	Noun
тананији	Adjective
maglino	Noun
paprenijom	Adjective
iznijeli	Participle
ciljao	Participle
patrijarhe	Noun
garantovao	Participle
bijes	Noun
menjate	Verb
izazivale	Participle
okruge	Noun
rasijecani	Participle
strogošću	Noun
dostavljene	Participle
refleksa	Noun
obilježilo	Participle
kelner	Noun
uveriste	Verb
placentu	Noun
zelenilom	Noun
harfa	Noun
isporučeni	Participle
uznemirilo	Participle
supstitucijom	Noun
ponedjeljka	Noun
filtriraju	Verb
rekorderom	Noun
karcinom	Noun
najbogatiju	Adjective
pripovjèdāč	Noun
povećalom	Noun
energetika	Noun
zlikovaca	Noun
kistom	Noun
bikova	Noun
carinskom	Adjective
duda	Noun
најизбезумљенији	Adjective
kasale	Participle
povećavaju	Verb
srbijansku	Adjective
odluko	Noun
teko	Noun
prihvaćale	Participle
tkali	Participle
minirali	Participle
klimom	Noun
bičevali	Participle
upitali	Participle
paviljona	Noun
namijenjen	Participle
obožavam	Verb
механички	Adjective
likvidacijom	Noun
sluškinjom	Noun
ručnici	Noun
procenom	Noun
mogućnošću	Noun
ohlade	Verb
stiču	Verb
nego	Noun
deveticu	Noun
izrezano	Participle
onomastika	Noun
protječe	Verb
vređa	Verb
obelodanjeno	Participle
pozvalo	Participle
fitilja	Noun
botanike	Noun
banju	Noun
prodalo	Participle
стабилни	Adjective
kapljicu	Noun
uzoravale	Participle
predočava	Verb
isključeno	Participle
slap	Noun
blagonaklonost	Noun
lješnjak	Noun
izruče	Verb
opremljen	Participle
vjenčao	Participle
vodíča	Noun
šljivici	Noun
srednjovekovnom	Adjective
žaluju	Verb
izjavljeno	Participle
prekršeno	Participle
prȉjateljā	Noun
inženjerskom	Adjective
tuša	Noun
pretjerali	Participle
kapitulacijom	Noun
otme	Verb
aludirao	Participle
navodilo	Participle
krasilo	Participle
pripisivale	Participle
oslonaca	Noun
opredijelilo	Participle
proširile	Participle
mlinovi	Noun
zahtevah	Verb
kroma	Noun
batinom	Noun
prtljagom	Noun
konfuziju	Noun
filozof	Noun
tužioce	Noun
veslaju	Verb
um	Noun
rùkāvācā	Noun
kunom	Noun
vratove	Noun
dlanovi	Noun
zagrljajem	Noun
ubrzanjem	Noun
rekurziju	Noun
čamcem	Noun
razdvajaj	Verb
orman	Noun
primijenjene	Participle
dobio	Participle
konfederacijom	Noun
ispunjavali	Participle
anketu	Noun
transportiraju	Verb
preraspodijelim	Verb
sklopiše	Verb
postavljale	Participle
izvuklo	Participle
fortifikaciju	Noun
muškarce	Noun
verizam	Noun
usmjerile	Participle
vrućinom	Noun
proglašavao	Participle
junakinju	Noun
živahnost	Noun
strategiju	Noun
renoviraju	Verb
ovčarstva	Noun
oličavaste	Verb
rječitiju	Adjective
rešetkom	Noun
šeće	Verb
dnevnom	Adjective
pokvasiš	Verb
odlučivalo	Participle
festival	Noun
licemjerja	Noun
potkovaše	Verb
podržavaju	Verb
golubicu	Noun
kroatistiku	Noun
церемонијални	Adjective
giba	Noun
carinarnicu	Noun
saginje	Verb
naslednike	Noun
utvrđen	Participle
strelicom	Noun
bijekciju	Noun
dogmatskom	Adjective
dimenziju	Noun
pišče	Noun
posvetu	Noun
podstanare	Noun
uklonjene	Participle
viljuško	Noun
mijenjate	Verb
baca	Verb
branioce	Noun
povezale	Participle
ljepilom	Noun
istjeralo	Participle
ograđuje	Verb
dostavljaju	Verb
oterani	Participle
podčinio	Participle
sputavaju	Verb
isticao	Participle
zamrzava	Verb
probio	Participle
obasjavaju	Verb
kraljicu	Noun
zidare	Noun
setom	Noun
hegemonijom	Noun
službenike	Noun
okovao	Participle
održavale	Participle
турски	Adjective
naginji	Verb
predstavnike	Noun
razdvojene	Participle
uklonili	Participle
sakrivaš	Verb
sakramenta	Noun
pristranost	Noun
visove	Noun
besmrtnicu	Noun
raseljavate	Verb
rizom	Noun
zavoleo	Participle
potpisan	Participle
jezu	Noun
ispušete	Verb
personifikacijom	Noun
miješali	Participle
zakonodavnom	Adjective
uobrazio	Participle
sazivamo	Verb
organiziraju	Verb
upotrebu	Noun
reknu	Verb
raseljeni	Participle
raspravom	Noun
tamburom	Noun
ustrojeni	Participle
ambivalentnost	Noun
potkopan	Participle
oslobodilaca	Noun
skreće	Verb
savjetnikom	Noun
dočekivali	Participle
rješavalo	Participle
naloge	Noun
dubino	Noun
kornera	Noun
lovca	Noun
pretvorene	Participle
zaprosio	Participle
zaboravljao	Participle
alfabetom	Noun
omogućujte	Verb
osuđenici	Noun
preseke	Noun
visinskom	Adjective
sprata	Noun
preneli	Participle
čvorom	Noun
župan	Noun
janjičare	Noun
dokumentacijom	Noun
naučilo	Participle
nivoa	Noun
cjepka	Verb
šprica	Noun
inverziju	Noun
pridobiva	Verb
konventa	Noun
pretučen	Participle
odgovarao	Participle
бјешњи	Adjective
prislonjen	Participle
grmljavine	Noun
žbunova	Noun
zatraženo	Participle
obranio	Participle
zadaću	Noun
pretvaralo	Participle
pokorile	Participle
agnostike	Noun
korio	Participle
doselili	Participle
sestričnom	Noun
apstrakciju	Noun
urađene	Participle
темпераментни	Adjective
tražilom	Noun
togu	Noun
događaje	Noun
upijene	Participle
odlikovalo	Participle
zaštitnom	Adjective
napadnuto	Participle
lubanju	Noun
pobeđene	Participle
hramom	Noun
čelnici	Noun
inča	Noun
lim	Noun
rukometašem	Noun
trako	Noun
očistio	Participle
formulirali	Participle
eure	Noun
kaolinit	Noun
obrće	Verb
osećalo	Participle
avitaminozu	Noun
ustrojavaju	Verb
siromašniju	Adjective
džihadom	Noun
administratorom	Noun
stepenico	Noun
regijom	Noun
uočavaju	Verb
poslužuje	Verb
popraćivahu	Verb
obistinilo	Participle
separatizam	Noun
zabrinutost	Noun
anticipacijo	Noun
njivu	Noun
koristim	Verb
sjedio	Participle
oče	Noun
namenjen	Participle
olakšaste	Verb
granjavaju	Verb
нијеми	Adjective
hrvahu	Verb
šaraf	Noun
dodani	Participle
masturbiramo	Verb
pišemo	Verb
spjevate	Verb
maglinom	Noun
slutio	Participle
ovjereno	Participle
obustavljam	Verb
osećate	Verb
članove	Noun
baruta	Noun
naoružavaju	Verb
okolišao	Participle
prodire	Verb
prepiše	Verb
sljubili	Participle
magistri	Noun
zavodiš	Verb
određivalo	Participle
deceniju	Noun
policajci	Noun
svemirsku	Adjective
fisijo	Noun
aktivirale	Participle
primijenjeno	Participle
opredijele	Verb
izbjeglicu	Noun
usađen	Participle
dragulje	Noun
pastu	Noun
praoca	Noun
stanova	Noun
Berbere	Noun
bubrahu	Verb
senatom	Noun
prodavali	Participle
висок	Adjective
ušlo	Participle
đavlom	Noun
bodovasmo	Verb
algoritam	Noun
đainizma	Noun
buknuo	Participle
мистериозан	Adjective
načinile	Participle
odudarali	Participle
mljevene	Participle
diskriminacijom	Noun
pobudu	Noun
otjerano	Participle
немачки	Adjective
boli	Participle
biheviorističkom	Adjective
galebicom	Noun
jaguar	Noun
nedoumica	Noun
zamjenicu	Noun
obilježavali	Participle
gasa	Noun
zahtijevam	Verb
medijatorom	Noun
filologijom	Noun
gospoda	Noun
analnom	Adjective
pomilovali	Participle
ugledali	Participle
zaklonjene	Participle
uvažavali	Participle
pokrivače	Noun
izbatinani	Participle
svetskom	Adjective
plaćaju	Verb
prijavljene	Participle
vrtiće	Noun
posetio	Participle
krčme	Verb
sjevernoameričku	Adjective
prisustvovahu	Verb
preotmu	Verb
četvorica	Noun
voz	Noun
kapacitete	Noun
pojednostavljen	Participle
skinite	Verb
bijedu	Noun
sjenom	Noun
epidemijom	Noun
neguje	Verb
majicu	Noun
prímedba	Noun
šiljak	Noun
dobijte	Verb
simpatijom	Noun
nadvladate	Verb
документарни	Adjective
sinka	Noun
dikcijom	Noun
utvrdio	Participle
energetike	Noun
повољан	Adjective
kȋčmā	Noun
buja	Verb
šapuće	Verb
tužiteljstva	Noun
doživljavamo	Verb
апатетичнији	Adjective
ispisivan	Participle
zatvarani	Participle
tugovale	Participle
vrapčić	Noun
zapaljeni	Participle
samoglasnikom	Noun
otimale	Participle
elektrifikacije	Noun
svidjelo	Participle
ukorijenjen	Participle
raseljeno	Participle
luftirao	Participle
izmjerene	Participle
soknom	Noun
postavio	Participle
žuriš	Verb
barataju	Verb
lingvistike	Noun
obrađivano	Participle
postanem	Verb
uhvatio	Participle
barakom	Noun
iselile	Participle
избрисив	Adjective
vale	Noun
vršeni	Participle
erupciju	Noun
tipografija	Noun
placeva	Noun
poimasmo	Verb
odlaziš	Verb
zagrljaje	Noun
slavim	Verb
mahalu	Noun
interval	Noun
mapu	Noun
opovrgavao	Participle
opijumom	Noun
vrčeve	Noun
otvorili	Participle
navodili	Participle
muftiju	Noun
porodicu	Noun
rupicom	Noun
protjeran	Participle
javljaju	Verb
koloseke	Noun
nestaju	Verb
imigracijom	Noun
mitraljez	Noun
amaterskom	Adjective
upropašten	Participle
palim	Verb
zenitom	Noun
kukova	Noun
zahtjevom	Noun
zvoca	Verb
nadahnut	Participle
zemljoradnjom	Noun
primorano	Participle
gospođicom	Noun
osoblja	Noun
preotima	Verb
prevladalo	Participle
крушни	Adjective
vođeno	Participle
sačekivane	Participle
šačicom	Noun
sicilijanskom	Adjective
krepan	Participle
poljubio	Participle
izbacio	Participle
obućar	Noun
kultovi	Noun
jahtom	Noun
inicijativom	Noun
sudstvom	Noun
sliku	Noun
svrhovitost	Noun
dokazali	Participle
podoficire	Noun
piša	Verb
odsekom	Noun
najdrastičniju	Adjective
kratere	Noun
florom	Noun
увредљивији	Adjective
namjeravam	Verb
interakciju	Noun
vikendico	Noun
kasabom	Noun
deklaracijom	Noun
nadzornikom	Noun
boščom	Noun
obradu	Noun
dodeljen	Participle
izrađivane	Participle
individualističkom	Adjective
nauma	Noun
najbezveznijom	Adjective
pokoravao	Participle
saharsku	Adjective
usavršavali	Participle
ostavljali	Participle
recept	Noun
likvidirao	Participle
pevao	Participle
odletio	Participle
lisicu	Noun
izlomljene	Participle
cepkali	Participle
prevashodnijom	Adjective
krivulju	Noun
dočekuje	Verb
krisom	Noun
intimnost	Noun
omladince	Noun
mire	Verb
adekvatnost	Noun
katedrom	Noun
apsorbiralo	Participle
probudio	Participle
одређени	Adjective
zbunio	Participle
čekaš	Verb
tragedijom	Noun
štetu	Noun
kvara	Noun
švapsku	Adjective
zaljubljen	Participle
vrapci	Noun
mušterijo	Noun
kozmopolitìzam	Noun
zagrijavamo	Verb
importiram	Verb
prijavim	Verb
najoporijom	Adjective
progutasmo	Verb
pjevalo	Participle
svetiònīk	Noun
slavonskom	Adjective
nadograđivao	Participle
trezvenost	Noun
bogataše	Noun
pobednik	Noun
bičevi	Noun
životopisom	Noun
seto	Noun
razumeju	Verb
istočnu	Adjective
prelomiste	Verb
krin	Noun
daljnju	Adjective
izbljuvaše	Verb
zbroj	Noun
sedale	Participle
dopisao	Participle
mije	Verb
vrtoglavicu	Noun
zadatke	Noun
prenošen	Participle
filom	Noun
trsja	Noun
natjeramo	Verb
čvorovi	Noun
ljušturom	Noun
uvriježilo	Participle
koturaju	Verb
холандски	Adjective
limfu	Noun
nadlijetalo	Participle
tumačen	Participle
pravoslavaca	Noun
predvodnikom	Noun
najumniju	Adjective
obratilo	Participle
šampanjca	Noun
garažu	Noun
podržavam	Verb
vekom	Noun
meksičku	Adjective
iglom	Noun
etimologiju	Noun
mešavinu	Noun
ljupkost	Noun
trgnemo	Verb
članstvom	Noun
izaslanici	Noun
kriju	Verb
ščepavaste	Verb
frazeologijom	Noun
svetinu	Noun
rajeva	Noun
ilovače	Noun
zapazili	Participle
janjičar	Noun
posetiš	Verb
stisnuti	Participle
regulaciju	Noun
ljiljanom	Noun
užetom	Noun
traktatom	Noun
iscetke	Noun
unio	Participle
paralaksu	Noun
napadalo	Participle
doštampane	Participle
snopom	Noun
ometu	Verb
crnogoričnom	Adjective
sjeveroistočnu	Adjective
prigovorili	Participle
repetitor	Noun
iracionalizam	Noun
svećnjače	Noun
crtaju	Verb
tisuću	Noun
iznio	Participle
velikan	Noun
udaljavajmo	Verb
poslušajte	Verb
propovedao	Participle
predmetak	Noun
humanizmom	Noun
ismijavani	Participle
zloupotrijebljeni	Participle
odlomiše	Verb
afirmirali	Participle
opredeljen	Participle
načelnike	Noun
svodnikom	Noun
filmova	Noun
dubinom	Noun
dekret	Noun
zemljoradnja	Noun
захвалнији	Adjective
psovanjem	Noun
divljina	Noun
autobusom	Noun
мултилатералан	Adjective
vježbu	Noun
izbavljam	Verb
financiralo	Participle
iračku	Adjective
savile	Participle
premotane	Participle
sȅmenīk	Noun
leđnom	Adjective
zaštitnicu	Noun
opseno	Noun
udovicom	Noun
odbacivao	Participle
razbolijeva	Verb
bolnicu	Noun
biva	Verb
plèće	Noun
nastanak	Noun
potkrijepljene	Participle
direktorom	Noun
obnavljao	Participle
klize	Verb
zgodu	Noun
ispija	Verb
retoričkom	Adjective
skȅla	Noun
poetike	Noun
pedagoškom	Adjective
poludeo	Participle
utečen	Participle
trpjele	Participle
dimnjake	Noun
zasadili	Participle
roditeljskom	Adjective
ozljeđivah	Verb
razbacivao	Participle
nagađalo	Participle
predane	Participle
mast	Noun
meteorologiju	Noun
jesensku	Adjective
zagrljeni	Participle
okrug	Noun
lavino	Noun
poteru	Noun
kontrakciju	Noun
čehoslovačku	Adjective
propane	Noun
utoljivaste	Verb
zadovoljio	Participle
nemoralom	Noun
misiju	Noun
razrađeno	Participle
lasicu	Noun
imperatorom	Noun
pretvorbu	Noun
arsenalom	Noun
pokopane	Participle
maksimumom	Noun
osvećeni	Participle
gaženo	Participle
podgrijem	Verb
pamukom	Noun
zaključujem	Verb
zaradom	Noun
drača	Noun
testova	Noun
posećeno	Participle
opterećen	Participle
pregrijavamo	Verb
frigam	Verb
najljepšu	Adjective
napisano	Participle
nestalo	Participle
reprezentativka	Noun
stropove	Noun
zapitali	Participle
odstupilo	Participle
primiče	Verb
odmara	Verb
figurom	Noun
hladniju	Adjective
bjesnila	Noun
krak	Noun
imovinu	Noun
okrenuli	Participle
zamišljen	Participle
prváka	Noun
zine	Verb
obavezale	Participle
osigurao	Participle
zapovednike	Noun
prisjetio	Participle
otjerali	Participle
ortodoksiju	Noun
konstrukciju	Noun
prodao	Participle
svrȃkā	Noun
pokazano	Participle
književnike	Noun
obrtnici	Noun
bistom	Noun
oskudicom	Noun
kupce	Noun
fiškal	Noun
zadovoljavalo	Participle
pravosudnu	Adjective
tešnju	Adjective
umirem	Verb
pudlicu	Noun
vodičem	Noun
specijalizaciju	Noun
krčažićem	Noun
promenjeno	Participle
plug	Noun
sarkofage	Noun
nogometašem	Noun
odazvaste	Verb
кронични	Adjective
odmicalo	Participle
shvatilo	Participle
nagovijestismo	Verb
nadjačani	Participle
pešake	Noun
negovali	Participle
smaknut	Participle
djelokruga	Noun
pridružio	Participle
izbodeni	Participle
sramoćaste	Verb
satelit	Noun
pravosuđa	Noun
naušnicom	Noun
uzburkavahu	Verb
kondenzaciju	Noun
kultnu	Adjective
lažljivci	Noun
analizator	Noun
камбоџански	Adjective
бесконачни	Adjective
poreže	Verb
natopljeno	Participle
vrpca	Noun
ubicu	Noun
pojačavane	Participle
sramio	Participle
policiju	Noun
orane	Participle
udelom	Noun
prolazio	Participle
grobova	Noun
krugom	Noun
vlastelinskom	Adjective
oganj	Noun
budili	Participle
spojeve	Noun
anarhiste	Noun
sačuvale	Participle
pòpravak	Noun
rutinu	Noun
stupljene	Participle
posjetilaca	Noun
rulju	Noun
vázu	Noun
krivuljao	Participle
albinizmom	Noun
slitinu	Noun
sniženi	Participle
projekt	Noun
uzrokujete	Verb
rugao	Participle
apostrofirate	Verb
mini	Verb
непримјетљиви	Adjective
proglašene	Participle
vedrinom	Noun
navratiše	Verb
posedovale	Participle
provalile	Participle
geslom	Noun
nevjerničkom	Adjective
biografsku	Adjective
eksploziv	Noun
nepostojeću	Adjective
termometara	Noun
prisiljavani	Participle
obrtničkom	Adjective
izbiju	Verb
ljubavnu	Adjective
uzimale	Participle
imitiraju	Verb
sijedjeli	Participle
slomilo	Participle
stopiste	Verb
satrapom	Noun
razdereš	Verb
dobročinitelj	Noun
emancipaciju	Noun
robinjom	Noun
paljbom	Noun
lijevane	Participle
perom	Noun
dopisivao	Participle
одлучујући	Adjective
riješilo	Participle
pobunio	Participle
provjeren	Participle
pragovi	Noun
nastojao	Participle
amazonskom	Adjective
usavršavamo	Verb
naslikan	Participle
porodičnu	Adjective
razbije	Verb
testirao	Participle
rubina	Noun
polugom	Noun
improvizator	Noun
držao	Participle
napomenuto	Participle
obrazovnu	Adjective
alatom	Noun
prete	Verb
izbegnut	Participle
egzodusom	Noun
sestrinskom	Adjective
виши	Adjective
emisiju	Noun
decu	Noun
suočeno	Participle
ispitane	Participle
trgovao	Participle
djedom	Noun
mikroorganizama	Noun
amalgama	Noun
kositrom	Noun
poneo	Participle
hedonistom	Noun
povezane	Participle
koncepcijom	Noun
krivotvorio	Participle
krampašem	Noun
smještao	Participle
izbjegavali	Participle
kucao	Participle
žanrova	Noun
obrađujemo	Verb
sklonjen	Participle
spaljeno	Participle
potopili	Participle
ludilom	Noun
obrađen	Participle
nikal	Noun
sinoníma	Noun
opciju	Noun
zabilježio	Participle
iskašljavali	Participle
djevicu	Noun
ambigvitéta	Noun
nadvladava	Verb
zatomljivah	Verb
sezonskom	Adjective
tjelovježbu	Noun
silogizam	Noun
izjavljuje	Verb
udišu	Verb
ukrcali	Participle
štuju	Verb
antičesticu	Noun
zonom	Noun
ugovorili	Participle
računao	Participle
ekspanzijom	Noun
otapa	Verb
poznao	Participle
zadrugu	Noun
poleće	Verb
upalio	Participle
reko	Noun
živost	Noun
krumpira	Noun
stilskom	Adjective
osovinom	Noun
opterećuje	Verb
poprskane	Participle
postojale	Participle
ajatolahom	Noun
batliju	Noun
snajperist	Noun
sjetvu	Noun
ubijaju	Verb
kȁlūpā	Noun
kafu	Noun
dionicu	Noun
serumom	Noun
izbrisane	Participle
upoznati	Participle
доследни	Adjective
izražavalo	Participle
ispekle	Participle
cvali	Participle
bijegom	Noun
zabranjeni	Participle
upaljača	Noun
ispunjavalo	Participle
kultova	Noun
nakanio	Participle
šavova	Noun
istraživačkom	Adjective
česma	Noun
romanopísci	Noun
sokakom	Noun
morali	Participle
akustičku	Adjective
poslužiteljem	Noun
ispričane	Participle
promjenu	Noun
zaleđujmo	Verb
kratkodnevicu	Noun
umetnik	Noun
sticalo	Participle
narodnu	Adjective
kulom	Noun
društvom	Noun
dramom	Noun
avanturom	Noun
pokrajinskom	Adjective
mrtvaci	Noun
uzdišu	Verb
јавни	Adjective
rečicu	Noun
jednodelnom	Adjective
romantizmom	Noun
vozile	Participle
grđeni	Participle
izotopijom	Noun
pomešan	Participle
mučitelj	Noun
gigant	Noun
pregovara	Verb
zajedništva	Noun
ožiljak	Noun
opstanak	Noun
spremio	Participle
trza	Verb
kotrljaju	Verb
odlučuju	Verb
liječnikom	Noun
delovao	Participle
krijumčar	Noun
krklja	Verb
logaritamskom	Adjective
raspodjelu	Noun
sašiven	Participle
trbušnu	Adjective
smaknuto	Participle
detetom	Noun
odjebi	Verb
slomili	Participle
poklone	Verb
zapisujemo	Verb
ubio	Participle
góvno	Noun
kutiju	Noun
geografiju	Noun
amplifikacijo	Noun
prijemom	Noun
pomoćnikom	Noun
prepucij	Noun
opredeljuju	Verb
izviđaš	Verb
iščupan	Participle
uzmiče	Verb
belaje	Noun
razvijali	Participle
iznosom	Noun
zatalasate	Verb
dobiva	Verb
akronimom	Noun
razblaženo	Participle
pribijen	Participle
prekore	Noun
rastvarane	Participle
немогућ	Adjective
elementa	Noun
izložili	Participle
disocijacijom	Noun
podučava	Verb
sastavlja	Verb
uspijevao	Participle
odugovlačio	Participle
ukinuto	Participle
čoporom	Noun
kikotalo	Participle
odredio	Participle
amalgam	Noun
osokoliš	Verb
autentičnošću	Noun
asketizam	Noun
rasporedom	Noun
optuženici	Noun
spašava	Verb
nakupismo	Verb
niču	Verb
oštetile	Participle
pripremaju	Verb
poviše	Verb
алармантан	Adjective
raselili	Participle
blagajnu	Noun
jurišali	Participle
najsenovitiju	Adjective
stigle	Participle
proprao	Participle
romanskom	Adjective
izbadamo	Verb
најбједнији	Adjective
borbenost	Noun
inteligenciju	Noun
kapuljačom	Noun
дворски	Adjective
skarabej	Noun
elektrolizom	Noun
pumpom	Noun
nizozemskom	Adjective
sumom	Noun
najtrivijalniju	Adjective
belega	Noun
pijeskom	Noun
zauzimale	Participle
začarao	Participle
pucnjava	Noun
iscjeđivale	Participle
bočnom	Adjective
esperanta	Noun
obdarujem	Verb
zadavili	Participle
udom	Noun
zlostavljaju	Verb
učiniš	Verb
tezo	Noun
baratajte	Verb
savjetovao	Participle
juriše	Noun
јутарњи	Adjective
prebacim	Verb
hijacint	Noun
upozoravali	Participle
odvjetnicu	Noun
nesli	Participle
дрвенаст	Adjective
naoružam	Verb
крволочан	Adjective
starinu	Noun
hipokrizije	Noun
revolucionarom	Noun
prekretnicom	Noun
prekidač	Noun
odvojen	Participle
poduzima	Verb
oporavljeni	Participle
isušeni	Participle
vragove	Noun
advokat	Noun
bunare	Noun
telefonije	Noun
zamotuljkom	Noun
palestinskom	Adjective
štićasmo	Verb
kosinu	Noun
općinskom	Adjective
klasa	Noun
zasađeni	Participle
iskazivale	Participle
најувјерљивији	Adjective
prazninom	Noun
maršem	Noun
povele	Participle
idilu	Noun
godišnjicu	Noun
primećeni	Participle
rustikalnijom	Adjective
glumcem	Noun
кишнији	Adjective
uspostavljao	Participle
oponaša	Verb
onesposobljen	Participle
ističem	Verb
tamu	Noun
pripovjedače	Noun
sipao	Participle
cijenili	Participle
izumeo	Participle
ugrađen	Participle
stabilizaciju	Noun
dodavano	Participle
klora	Noun
otapalo	Participle
irskom	Adjective
uvreženo	Participle
pripovedale	Participle
balerinu	Noun
okleva	Verb
razjedinio	Participle
prijateljicom	Noun
pridržava	Verb
odgovorili	Participle
vezuju	Verb
prenosnici	Noun
kristalizirane	Participle
uništavajte	Verb
podmitio	Participle
uviđali	Participle
ljetinu	Noun
varijaciju	Noun
divove	Noun
Čehe	Noun
zatečeno	Participle
dopiru	Verb
uzrujani	Participle
asocijacijom	Noun
probijale	Participle
racionalističku	Adjective
tezgom	Noun
krivili	Participle
konobu	Noun
zabada	Verb
tapiseriju	Noun
tjerali	Participle
aplicirao	Participle
ocenjene	Participle
belešku	Noun
cilindara	Noun
postupili	Participle
demokratijom	Noun
banjicu	Noun
opijajte	Verb
utrobu	Noun
diplomat	Noun
čitaonicu	Noun
slavljeni	Participle
ponašali	Participle
odvodile	Participle
antifašist	Noun
zloupotrebljava	Verb
marom	Noun
rutino	Noun
piskajte	Verb
ulažah	Verb
nagovorom	Noun
pripravu	Noun
većnik	Noun
kraljevstvom	Noun
proreklo	Participle
oboreno	Participle
atrofiju	Noun
istražitelje	Noun
grča	Noun
odavalo	Participle
trn	Noun
skupštinu	Noun
koreografom	Noun
rukometa	Noun
sipo	Noun
demokracijom	Noun
feudalizma	Noun
zavodnicu	Noun
doseljavale	Participle
dopremani	Participle
verodostojnost	Noun
repertoara	Noun
otklonilo	Participle
motiku	Noun
pridobiti	Participle
razmotaj	Verb
tonovi	Noun
razmišljamo	Verb
zastupnicom	Noun
udruživali	Participle
dižu	Verb
imitirali	Participle
glumce	Noun
šoka	Noun
građasmo	Verb
apsorbirali	Participle
simbol	Noun
maslačak	Noun
osiromašili	Participle
dokazivao	Participle
biskup	Noun
uvidjelo	Participle
разностранични	Adjective
piskaj	Verb
legalizaciju	Noun
trbuhom	Noun
proučene	Participle
kolendom	Noun
kovitlane	Participle
iritaciju	Noun
izobličavano	Participle
najparadoksalniju	Adjective
zbiva	Verb
tjeralo	Participle
razvijene	Participle
dogmu	Noun
banketa	Noun
rđahu	Verb
speleòlozi	Noun
zglobovi	Noun
krivičnom	Adjective
uvećane	Participle
tiso	Noun
kaljeni	Participle
maljem	Noun
gutanjem	Noun
čučavci	Noun
sasijecane	Participle
prodavao	Participle
чисти	Adjective
незамењиви	Adjective
doprineo	Participle
haraju	Verb
proizvodile	Participle
zarađivao	Participle
dosjetka	Noun
abecedara	Noun
mušketir	Noun
počine	Verb
zemljištem	Noun
kolaž	Noun
osjetile	Participle
niječimo	Verb
štitilo	Participle
opredeljeni	Participle
najneskromnijom	Adjective
zaglavljivasmo	Verb
sljedbenikom	Noun
iznimkom	Noun
zakopavalo	Participle
kvantitetom	Noun
pljuskove	Noun
komesare	Noun
manuskripta	Noun
solar	Noun
stagnirali	Participle
glagoljale	Participle
renovirao	Participle
najuspešniju	Adjective
križan	Participle
besmislicu	Noun
porodičnom	Adjective
rasedom	Noun
baklju	Noun
raspetljavamo	Verb
primenu	Noun
tražim	Verb
uplašili	Participle
izuvale	Participle
popravili	Participle
progrizaju	Verb
naslednik	Noun
pitan	Participle
ovlašten	Participle
licemerjem	Noun
bocom	Noun
prijavljen	Participle
skotova	Noun
podoficir	Noun
ponašao	Participle
počinjene	Participle
krivica	Noun
ispiru	Verb
ukrcaš	Verb
razoružan	Participle
otkazano	Participle
uspavane	Participle
defova	Noun
riznicom	Noun
prikaži	Verb
osuđivani	Participle
cvjetaste	Verb
lijes	Noun
premašilo	Participle
rituala	Noun
izgrađen	Participle
namjeravalo	Participle
keramičkom	Adjective
razljutiš	Verb
mahalom	Noun
izborio	Participle
nabire	Verb
kuvan	Participle
obrne	Verb
egzosferom	Noun
zalede	Verb
ismejavahu	Verb
utanačen	Participle
slobodniju	Adjective
samicu	Noun
prekretao	Participle
isplaćeni	Participle
batinaš	Verb
vestom	Noun
arhitekticom	Noun
tonsku	Adjective
dijakritičkom	Adjective
vraćao	Participle
meškolje	Verb
nordijsku	Adjective
presenetiše	Verb
livadu	Noun
razbilo	Participle
zavisnost	Noun
grobnicom	Noun
premašen	Participle
svezalo	Participle
objelodanilo	Participle
snajpere	Noun
ljušturu	Noun
natkrililo	Participle
binarnu	Adjective
placa	Noun
popova	Noun
razumeli	Participle
izgoresmo	Verb
obvezom	Noun
praznovjerjem	Noun
izgnanike	Noun
nizali	Participle
gardom	Noun
izrekom	Noun
muzikologije	Noun
zaglavljivani	Participle
ogledavali	Participle
ucenjuje	Verb
odlomkom	Noun
pružale	Participle
primiše	Verb
promiče	Verb
sirutko	Noun
najekonomičnijom	Adjective
sastajao	Participle
školovanjem	Noun
maramu	Noun
čileanskom	Adjective
zaključen	Participle
pupka	Noun
cerova	Noun
prevladale	Participle
prozvali	Participle
zaključivah	Verb
локални	Adjective
ubacivao	Participle
zemljoposjednici	Noun
spiritizam	Noun
viđaju	Verb
prekopale	Participle
singl	Noun
preostali	Participle
cionizam	Noun
opozicijom	Noun
preživljavali	Participle
obriju	Verb
sarkazmom	Noun
svjetlom	Noun
islamiziralo	Participle
tržišnom	Adjective
čistio	Participle
narukvicu	Noun
usporavale	Participle
tuniku	Noun
opreko	Noun
ostavljaju	Verb
uključili	Participle
staklom	Noun
trkače	Noun
rastanka	Noun
gorsku	Adjective
homozigoti	Noun
izostave	Verb
ugrađeni	Participle
pačić	Noun
utapa	Verb
daltonìzma	Noun
raspršili	Participle
postavljane	Participle
napunjene	Participle
peščanika	Noun
komandom	Noun
probije	Verb
prašinom	Noun
pecam	Verb
lijevu	Adjective
modifikacijom	Noun
penetrira	Verb
građani	Noun
dogovoreno	Participle
komunizmom	Noun
onečišćivao	Participle
sjemenom	Noun
pošalju	Verb
automobilskom	Adjective
prošlogodišnju	Adjective
dostigao	Participle
cede	Verb
potakli	Participle
naslanja	Verb
božićnom	Adjective
pomaknut	Participle
svinjare	Noun
iscrpljuju	Verb
obija	Verb
prekini	Verb
utorkom	Noun
odvođene	Participle
najsvestraniju	Adjective
totalitet	Noun
krnjak	Noun
etiopskom	Adjective
doseljenike	Noun
побожнији	Adjective
dirajte	Verb
binarnom	Adjective
ispražnjavao	Participle
opsegom	Noun
pobudile	Participle
razradom	Noun
ohrabrivalo	Participle
ugao	Noun
naredbom	Noun
ugledaju	Verb
iselilo	Participle
kapitala	Noun
kršćane	Noun
planiram	Verb
rešetaste	Verb
korilo	Participle
aklimatizacionu	Adjective
štaba	Noun
raspušteno	Participle
naslućuju	Verb
najavljivani	Participle
eseje	Noun
zavjetom	Noun
sastavke	Noun
pobio	Participle
svetkovinu	Noun
usmjerilo	Participle
izazvalo	Participle
oksid	Noun
negoduje	Verb
izdato	Participle
proceno	Noun
provjeru	Noun
reinkarnaciju	Noun
udomljuje	Verb
sabere	Verb
odaberite	Verb
smicale	Participle
kurili	Participle
žare	Noun
kompresijom	Noun
porušile	Participle
detonacijom	Noun
zaostanem	Verb
razljućeni	Participle
parobrodom	Noun
traktata	Noun
mekoću	Noun
balistiku	Noun
razbacivali	Participle
boru	Noun
izdvojilo	Participle
nadjačao	Participle
otkriva	Verb
ȕvo	Noun
razmjenjivao	Participle
rezultirao	Participle
pluskvamperfektom	Noun
obilaze	Verb
supstrat	Noun
učinim	Verb
sumnjivci	Noun
kurzivom	Noun
razgovaraju	Verb
bezumniju	Adjective
osedlavano	Participle
ortopedije	Noun
saznale	Participle
peku	Noun
potoke	Noun
pojavile	Participle
ishodom	Noun
активни	Adjective
kljuna	Noun
dostavili	Participle
udarilo	Participle
federaciju	Noun
korenom	Noun
svetitelje	Noun
naučeno	Participle
uzdom	Noun
veseljem	Noun
ličnost	Noun
trijumvirat	Noun
plima	Noun
pljuvahu	Verb
ionosferu	Noun
ormana	Noun
trgova	Noun
prigušivač	Noun
širmove	Noun
kofer	Noun
utopili	Participle
imenovalo	Participle
osnivače	Noun
pozivalo	Participle
uočeni	Participle
štićenikom	Noun
плећати	Adjective
objektivnost	Noun
rukovodstvom	Noun
senata	Noun
најбрижљивији	Adjective
dadoše	Verb
sviraj	Verb
osvežava	Verb
vračan	Participle
brazdom	Noun
ukaži	Verb
bombardera	Noun
dizalicom	Noun
učvrstilo	Participle
odlučujuću	Adjective
isječene	Participle
poslane	Participle
dobijete	Verb
bodrili	Participle
rukavce	Noun
pripojilo	Participle
povratim	Verb
sinapsi	Noun
trežnjeno	Participle
selim	Verb
tuguj	Verb
zapadnjačku	Adjective
raspolagalo	Participle
kartografijom	Noun
pronicaste	Verb
pridruženi	Participle
početka	Noun
aritmiju	Noun
razagnate	Verb
pročitavaste	Verb
daidžinica	Noun
maloletnicom	Noun
pojelo	Participle
krznar	Noun
pogledamo	Verb
zamenjuje	Verb
čašu	Noun
zaredam	Verb
zamrzavano	Participle
obvezali	Participle
navođeni	Participle
pàhulja	Noun
policijsku	Adjective
eliksira	Noun
otkrivaju	Verb
uljepšavani	Participle
štrihericu	Noun
hipotenuzu	Noun
čvarci	Noun
onesposobljava	Verb
pregrije	Verb
pomoćnicu	Noun
polizao	Participle
najslabiju	Adjective
islamom	Noun
ženevskom	Adjective
crijepom	Noun
monogamija	Noun
proučen	Participle
etapom	Noun
povezivao	Participle
zgusne	Verb
klonove	Noun
financirali	Participle
bivaju	Verb
udarale	Participle
ubijali	Participle
kromanjonci	Noun
казалишни	Adjective
završen	Participle
oduzelo	Participle
penje	Verb
poslednjom	Adjective
približavamo	Verb
platilo	Participle
prožet	Participle
predomišljao	Participle
кућни	Adjective
šancem	Noun
osvajaju	Verb
pesnike	Noun
tečnošću	Noun
opozove	Verb
ustanu	Verb
okruženo	Participle
dočekivani	Participle
entuzijazama	Noun
prtljažnik	Noun
biljku	Noun
upoznaje	Verb
otimano	Participle
izdavane	Participle
пословни	Adjective
baljezgaš	Verb
polubrat	Noun
bȍēme	Noun
zauzdaš	Verb
prepirka	Noun
prerezan	Participle
razdirano	Participle
pripalo	Participle
stanare	Noun
sajmove	Noun
teutonskom	Adjective
rigiditéta	Noun
lakat	Noun
raščlanjeni	Participle
кинески	Adjective
potkopavaj	Verb
taban	Noun
крвнички	Adjective
prestrašen	Participle
sedištem	Noun
grmova	Noun
odradili	Participle
protjerivani	Participle
ropstvom	Noun
zavodio	Participle
oponiram	Verb
svedoče	Verb
kapetanom	Noun
presretne	Verb
sašio	Participle
obiđoh	Verb
sačekajte	Verb
stagnacijo	Noun
zvučnikom	Noun
načet	Participle
zagorčava	Verb
botaniku	Noun
sakrivali	Participle
ujaci	Noun
ženkom	Noun
najpopularnijom	Adjective
sednicom	Noun
predomislili	Participle
ugušili	Participle
profesiju	Noun
tumačile	Participle
intenzivniju	Adjective
doživeli	Participle
zadržavaju	Verb
staricom	Noun
divljom	Adjective
hipotekom	Noun
izgovorene	Participle
pukovnijom	Noun
poduzimaju	Verb
crtu	Noun
isporučene	Participle
intenzitet	Noun
ìskūstāvā	Noun
ulagujte	Verb
finoću	Noun
ujakom	Noun
češljugar	Noun
pripremom	Noun
devojčicom	Noun
odsekle	Participle
izute	Participle
ekonomskom	Adjective
razmaknuti	Participle
vješate	Verb
križarsku	Adjective
singlova	Noun
izjasnio	Participle
rječnik	Noun
automobilsku	Adjective
osušeni	Participle
takmičarsku	Adjective
utorak	Noun
probali	Participle
realističku	Adjective
kukovi	Noun
zamijenjeni	Participle
zlonamjernijom	Adjective
mužjaci	Noun
smejao	Participle
raskoliste	Verb
procurio	Participle
zaključkom	Noun
koškah	Verb
osipom	Noun
promašio	Participle
iskonskom	Adjective
slamčicu	Noun
zdraviju	Adjective
ćeretaš	Verb
jezivijom	Adjective
uviđamo	Verb
nagradiš	Verb
entomologija	Noun
popisani	Participle
gurnuh	Verb
samoubojstvom	Noun
obuhvaćalo	Participle
inspirirali	Participle
novčanu	Adjective
opredeljivano	Participle
kapsulu	Noun
sjedinio	Participle
skrpih	Verb
potkivasmo	Verb
izrezali	Participle
naslonjene	Participle
seosku	Adjective
postizale	Participle
posvećene	Participle
upotrebljeni	Participle
razotkriva	Verb
odvajao	Participle
odeljene	Participle
huđu	Adjective
okončan	Participle
задњи	Adjective
postojeću	Adjective
utege	Noun
skandiraju	Verb
probijeni	Participle
ponovljeno	Participle
škotskom	Adjective
garantirao	Participle
dalju	Adjective
istovarivasmo	Verb
mučeništvom	Noun
egipatsku	Adjective
nizale	Participle
ventilacijom	Noun
oporavljao	Participle
prénosnīk	Noun
vodozemac	Noun
potvrđuju	Verb
odvajali	Participle
merdevina	Noun
obrazlagao	Participle
otuđen	Participle
ganja	Verb
ostavljate	Verb
pedagog	Noun
vrtio	Participle
ostavu	Noun
usule	Participle
ohrabrio	Participle
odmorom	Noun
ćirilicu	Noun
oporezivali	Participle
presekao	Participle
nudizam	Noun
letino	Noun
agitaciju	Noun
plažom	Noun
pijavicu	Noun
straha	Noun
zapisivani	Participle
škopio	Participle
konkurenciju	Noun
snimljen	Participle
rugali	Participle
čistili	Participle
provokaciju	Noun
otputuju	Verb
sjedinili	Participle
uznemireni	Participle
kanala	Noun
istraživali	Participle
tektonike	Noun
nadzirali	Participle
smetane	Participle
dadiljom	Noun
državom	Noun
sjevernokorejsku	Adjective
pojedinca	Noun
energetikom	Noun
zastale	Participle
ćozu	Noun
crnokošuljaše	Noun
svrbeža	Noun
čajem	Noun
sahranjuju	Verb
raspolovismo	Verb
palma	Noun
astrofizikom	Noun
prerušio	Participle
razmnožismo	Verb
objavljivano	Participle
snimile	Participle
posvećujem	Verb
dohvatio	Participle
potpišu	Verb
intuicijom	Noun
šamanizam	Noun
osumnjičene	Participle
inkorporaciju	Noun
prebijani	Participle
razmnože	Verb
izbegava	Verb
rečenicom	Noun
dostavnu	Adjective
rođaci	Noun
sazreli	Participle
viziju	Noun
kràsūljākā	Noun
uvučemo	Verb
blefove	Noun
mužjake	Noun
snabdevani	Participle
trotoara	Noun
prilagođen	Participle
konstruiraju	Verb
alfabeta	Noun
šokova	Noun
žabare	Noun
uklanjale	Participle
naoružavale	Participle
prcan	Participle
primjenjivani	Participle
niči	Verb
šinu	Noun
pigmenta	Noun
bratić	Noun
kudim	Verb
omekšavali	Participle
prebacuju	Verb
heterozigoti	Noun
osvojilo	Participle
parkom	Noun
raskidahu	Verb
kapicu	Noun
nogometaše	Noun
djelokrugom	Noun
objašnjenjem	Noun
кошаркашки	Adjective
adventist	Noun
potrebu	Noun
fiziologiju	Noun
ščepavaj	Verb
pójmōvā	Noun
koncesijom	Noun
zbornici	Noun
pokrili	Participle
leksikologija	Noun
kasam	Verb
maslinike	Noun
opću	Adjective
dojavljuje	Verb
prikazuju	Verb
sumaglicu	Noun
uvježbavali	Participle
azimutom	Noun
zamenicom	Noun
prokopajmo	Verb
smrada	Noun
lȍpta	Noun
vodstva	Noun
šećerom	Noun
vozačem	Noun
informativniju	Adjective
razglobljeno	Participle
гладнији	Adjective
šlema	Noun
silaze	Verb
zasenjen	Participle
nobelovaca	Noun
ukrasnu	Adjective
ispravljen	Participle
uzmiču	Verb
zbivalo	Participle
odaberete	Verb
usavršavan	Participle
kopao	Participle
spajaju	Verb
užitka	Noun
gospu	Noun
autonomijom	Noun
improvizacijom	Noun
bujaju	Verb
sukobljavaju	Verb
malinu	Noun
ploču	Noun
pomešam	Verb
ministarstava	Noun
baziralo	Participle
vladare	Noun
krošnjo	Noun
cementirao	Participle
obuhvaćao	Participle
akumulirali	Participle
bečkom	Adjective
rečitost	Noun
skladane	Participle
koračaj	Verb
izbjegavajte	Verb
proverene	Participle
spasiocem	Noun
zrelijom	Adjective
mletačku	Adjective
западни	Adjective
dovršetak	Noun
kradljivci	Noun
uništilo	Participle
ograđivali	Participle
branilo	Participle
udahnuti	Participle
označavalo	Participle
gatova	Noun
paleontologiju	Noun
najgoru	Adjective
deljen	Participle
visio	Participle
prevrnimo	Verb
uzimaju	Verb
glavoboljom	Noun
stizalo	Participle
ometen	Participle
uočene	Participle
nervoznijom	Adjective
primijenjen	Participle
invencije	Noun
podešavaju	Verb
usvojio	Participle
zabunkèrīranōst	Noun
briselskom	Adjective
otvorim	Verb
falsifikat	Noun
strahove	Noun
popraćen	Participle
poricahu	Verb
eparhijskom	Adjective
overavale	Participle
dodirni	Verb
рани	Adjective
blagoslovljeno	Participle
štokavskom	Adjective
opnom	Noun
progutali	Participle
lingvistika	Noun
antologiju	Noun
baziramo	Verb
pravljene	Participle
krunidbom	Noun
penom	Noun
profesionalce	Noun
malj	Noun
gazio	Participle
psihom	Noun
incidenta	Noun
odjaše	Verb
zatočili	Participle
potiljak	Noun
broša	Noun
usvojile	Participle
higijenu	Noun
planirali	Participle
obećavali	Participle
secirate	Verb
umoren	Participle
mađioničare	Noun
izveštavali	Participle
pripremane	Participle
centralizacijom	Noun
barokom	Noun
razilazili	Participle
amatersku	Adjective
strategijom	Noun
gostom	Noun
zavlačim	Verb
izgarao	Participle
otuđene	Participle
domovinom	Noun
prevodilaca	Noun
stvaranjem	Noun
odbranilo	Participle
odjek	Noun
otuđenost	Noun
valom	Noun
dozvoljava	Verb
okultizama	Noun
трансцендентан	Adjective
profesionalci	Noun
прогресиван	Adjective
uljepšavamo	Verb
nepoverenja	Noun
prikupljane	Participle
dobiše	Verb
dospelo	Participle
dohotke	Noun
razuveravale	Participle
dadaizam	Noun
шупљикавији	Adjective
nastajte	Verb
odmjeravaš	Verb
smrtnik	Noun
pivskom	Adjective
cenim	Verb
hrast	Noun
ловачки	Adjective
rešava	Verb
patricijem	Noun
vjernike	Noun
ispuste	Verb
esejom	Noun
šljunkom	Noun
udaljavaju	Verb
pravili	Participle
nadograđeno	Participle
časovi	Noun
posustaje	Verb
prisiljeni	Participle
ponudio	Participle
lȗtnjo	Noun
dajem	Verb
maloprodaje	Noun
odricao	Participle
slika	Verb
plašili	Participle
zauzelo	Participle
strizah	Verb
pojačavahu	Verb
useljeniče	Noun
gramofonsku	Adjective
kamenuju	Verb
srpanjskom	Adjective
cijepaju	Verb
pratio	Participle
bjegunce	Noun
dugom	Noun
uzimalo	Participle
uvažio	Participle
miješalicom	Noun
promatrani	Participle
ideju	Noun
razbojničku	Adjective
uvježbava	Verb
doprinosim	Verb
sraz	Noun
brijestova	Noun
tromost	Noun
zaceljujte	Verb
prȍšče	Noun
obitavaju	Verb
automat	Noun
isečene	Participle
blagovao	Participle
moderniju	Adjective
ponavljale	Participle
genije	Noun
štetio	Participle
trebao	Participle
uzgajane	Participle
sukobljeni	Participle
iscijedih	Verb
invenciju	Noun
slatinu	Noun
navodnom	Adjective
staništem	Noun
prepolovio	Participle
njegovao	Participle
opterećene	Participle
sintaksu	Noun
најмешовитији	Adjective
napadale	Participle
zabrinulo	Participle
upoznajemo	Verb
pričinjavah	Verb
knjižnu	Adjective
kritizerstvom	Noun
razmnažajte	Verb
opisali	Participle
ponižavano	Participle
artritisa	Noun
dobici	Noun
izvršava	Verb
lutalicu	Noun
popunjeni	Participle
zalaže	Verb
zadah	Noun
dostignu	Verb
rernu	Noun
obuzimali	Participle
poručeno	Participle
kleknut	Participle
nagovestio	Participle
anarhističku	Adjective
zvȗci	Noun
mumijom	Noun
bavarsku	Adjective
umjeli	Participle
zaboravili	Participle
veljaču	Noun
podsećali	Participle
topologijom	Noun
ostao	Participle
pijetlove	Noun
romanizacijom	Noun
kurs	Noun
planinsku	Adjective
hartiju	Noun
urezao	Participle
aromu	Noun
posvetom	Noun
udruživah	Verb
transakciju	Noun
komentirali	Participle
predbacismo	Verb
rodio	Participle
gledaš	Verb
šištale	Participle
stavilo	Participle
pljuštamo	Verb
nizao	Participle
propalo	Participle
glasilo	Participle
harane	Participle
pojačani	Participle
адијабатски	Adjective
hedonizam	Noun
канцероген	Adjective
izumeli	Participle
izručen	Participle
sastojah	Verb
romana	Noun
ero	Noun
poboljšavamo	Verb
bèsposličārka	Noun
izmiču	Verb
terorom	Noun
tamničar	Noun
flauto	Noun
fudbala	Noun
odvojeni	Participle
kajkavaca	Noun
uraganom	Noun
maternju	Adjective
pruga	Noun
smetali	Participle
anektirali	Participle
nasmeje	Verb
dignute	Participle
kovao	Participle
rekonstrukcijo	Noun
prkosili	Participle
izlagao	Participle
opozvah	Verb
obožavatelje	Noun
savjetnik	Noun
izlagale	Participle
klošára	Noun
tradicijom	Noun
kolaža	Noun
slavljaste	Verb
ustanovih	Verb
vizijom	Noun
fasadu	Noun
vešalo	Participle
mlazove	Noun
briši	Verb
linja	Verb
uvredio	Participle
raspravljale	Participle
palminom	Adjective
sniježilo	Participle
nastupili	Participle
spiritualnost	Noun
sliče	Verb
nacionalističku	Adjective
erekcijo	Noun
segmentom	Noun
dosjetljivijom	Adjective
osiromašeno	Participle
obesio	Participle
kvarove	Noun
izjašnjavaju	Verb
kubanskom	Adjective
indukciju	Noun
mladošću	Noun
kocku	Noun
doživljavali	Participle
pobegnu	Verb
aminokiselinom	Noun
promrsih	Verb
snižava	Verb
pratnjom	Noun
zaveže	Verb
čobani	Noun
руднички	Adjective
horsa	Noun
naočitijom	Adjective
iskorišteni	Participle
pesnicom	Noun
porasta	Noun
izvučem	Verb
jednoglasnost	Noun
utapao	Participle
autorizirao	Participle
користан	Adjective
sunđere	Noun
udrugom	Noun
најнапорнији	Adjective
rupicu	Noun
изабран	Adjective
spasiteljem	Noun
jampsku	Adjective
prepisivao	Participle
dizajnom	Noun
podrignuli	Participle
spužvu	Noun
odgođeno	Participle
unosilo	Participle
zobano	Participle
salinizacijo	Noun
smijao	Participle
odaberu	Verb
prestravljuje	Verb
otpušteni	Participle
ovlašteno	Participle
pročitale	Participle
lajem	Verb
varijacijom	Noun
glasnogovornici	Noun
sustigne	Verb
košarku	Noun
miješano	Participle
raskinuti	Participle
rušilo	Participle
dogode	Verb
obronci	Noun
postignu	Verb
slepoočnom	Adjective
džemperom	Noun
gangster	Noun
obvezao	Participle
zatajene	Participle
sjedaju	Verb
havajskom	Adjective
huliganskom	Adjective
prima	Verb
razaznaš	Verb
snijeg	Noun
vjenčanjem	Noun
smatrate	Verb
preselio	Participle
kompresor	Noun
porobljeno	Participle
svrstalo	Participle
regulu	Noun
ubrzali	Participle
odijeljeni	Participle
ugrizeni	Participle
metionin	Noun
učestalošću	Noun
vers	Noun
letinu	Noun
pretvorilo	Participle
sviđale	Participle
таљив	Adjective
gledaj	Verb
azotom	Noun
oporbu	Noun
prijenosnici	Noun
favoritom	Noun
italijanskom	Adjective
brukaju	Verb
klokan	Noun
motah	Verb
krokodilom	Noun
pregrađuje	Verb
bran	Participle
upućuje	Verb
špiglom	Noun
muslìmānka	Noun
standardizacijom	Noun
preporučilo	Participle
suspenzijom	Noun
davalo	Participle
označile	Participle
avatarom	Noun
kentaur	Noun
kakaovac	Noun
konkretnijom	Adjective
zvuče	Noun
dogovorile	Participle
kraše	Noun
kvinteta	Noun
ključevi	Noun
iskona	Noun
gitarskom	Adjective
zaradu	Noun
verovao	Participle
pobeđujte	Verb
publiciramo	Verb
moram	Verb
ukopano	Participle
koljenom	Noun
čekam	Verb
trilogiju	Noun
grešnike	Noun
zenom	Noun
preporučeni	Participle
posredovali	Participle
matricom	Noun
puze	Verb
otomansku	Adjective
pripadnošću	Noun
abdesta	Noun
diplomom	Noun
ukažu	Verb
modaliteta	Noun
žigom	Noun
plaću	Noun
lukavci	Noun
apsorbiraju	Verb
zarobljenikom	Noun
razvijeni	Participle
brodogradnje	Noun
nagoveštavale	Participle
lipanj	Noun
bunarom	Noun
ističemo	Verb
skucao	Participle
šankom	Noun
pere	Verb
izgredom	Noun
tješim	Verb
sanskrta	Noun
pružaju	Verb
šapo	Noun
adolescencija	Noun
slojem	Noun
amaterizama	Noun
mortom	Noun
matematiku	Noun
sekcijom	Noun
sveštenik	Noun
pravljeni	Participle
izgovorili	Participle
glupljom	Adjective
pripisale	Participle
pronikne	Verb
razarač	Noun
pratilo	Participle
odsječeni	Participle
mješavinu	Noun
supova	Noun
postova	Noun
limitom	Noun
mirovinu	Noun
kotač	Noun
dodjeljivao	Participle
izgledale	Participle
osakaćivalo	Participle
smer	Noun
izrezuju	Verb
individuu	Noun
karaktere	Noun
ostanu	Verb
kilu	Noun
hodnike	Noun
iskopavali	Participle
pedagogija	Noun
počinjale	Participle
usuđujem	Verb
setili	Participle
poslovali	Participle
rasrđuješ	Verb
indonezijsku	Adjective
osnivačkom	Adjective
svirkom	Noun
psihijatrija	Noun
primedbu	Noun
savlađivan	Participle
izdatke	Noun
povratio	Participle
srebra	Noun
otklonjene	Participle
bjeloruskom	Adjective
najzadovoljnijom	Adjective
badnjak	Noun
istražiteljem	Noun
počinjali	Participle
danskom	Adjective
rehabilitirao	Participle
hteli	Participle
pobedio	Participle
statikom	Noun
gangsterskom	Adjective
amputacijom	Noun
pijanstvom	Noun
čekamo	Verb
popunjavajte	Verb
morževe	Noun
mirah	Verb
paranojom	Noun
obustavilo	Participle
nemaš	Verb
ijekavicom	Noun
ekavicom	Noun
večernju	Adjective
zgušnjavaste	Verb
orasi	Noun
suvenir	Noun
značajnost	Noun
policijom	Noun
isticali	Participle
pokrajinu	Noun
čara	Verb
plòha	Noun
raskinule	Participle
otkopani	Participle
oporezivao	Participle
šnalo	Noun
pobeđuju	Verb
ukidah	Verb
medicinsku	Adjective
kopriva	Noun
napijaju	Verb
uđoše	Verb
политички	Adjective
nasrnuo	Participle
nuđen	Participle
balerinom	Noun
svidjeli	Participle
zbivah	Verb
rotkva	Noun
bukvom	Noun
većinom	Noun
pileta	Noun
baršúna	Noun
ugasio	Participle
dokazao	Participle
prilagodio	Participle
pripitome	Verb
glase	Verb
izbegneš	Verb
olakšavalo	Participle
čeličnom	Adjective
vijte	Verb
podudaralo	Participle
voditeljem	Noun
najžilavijom	Adjective
jazavce	Noun
sjedale	Participle
psihoanaliza	Noun
kontaminacijom	Noun
žanju	Verb
zapostavili	Participle
ornitologiju	Noun
kruhoborstvom	Noun
небулозан	Adjective
povrate	Verb
podsete	Verb
kamuflažu	Noun
поједини	Adjective
nadoknadismo	Verb
prepoznati	Participle
пунолетни	Adjective
potočnom	Adjective
sjevernom	Adjective
guskom	Noun
saveznicom	Noun
bistrinu	Noun
akupunkture	Noun
trajali	Participle
palmom	Noun
srećo	Noun
pljačkom	Noun
proslavljeno	Participle
crevnom	Adjective
traj	Verb
presreći	Verb
ganuti	Participle
pigmentom	Noun
okeanom	Noun
slatkoće	Noun
najpovoljniju	Adjective
blokiralo	Participle
ubrzavano	Participle
veterinu	Noun
stanicom	Noun
svedočili	Participle
delano	Participle
plebejca	Noun
imperfekt	Noun
utemeljio	Participle
smjerom	Noun
gaknemo	Verb
понован	Adjective
sinonima	Noun
realiziraju	Verb
izopačuju	Verb
uhapšene	Participle
hidrata	Noun
nosim	Verb
građeno	Participle
telefonirao	Participle
baba	Noun
pretvarale	Participle
promatralo	Participle
ležerniju	Adjective
razgovorom	Noun
zastaje	Verb
nasilnike	Noun
fakta	Noun
prestaneš	Verb
mero	Noun
oličenjem	Noun
umetnuti	Participle
ostvareni	Participle
pokretalo	Participle
stankom	Noun
uspostave	Verb
najubojitiju	Adjective
motrili	Participle
elektranom	Noun
fatalizam	Noun
pričvršćene	Participle
suncem	Noun
zadubao	Participle
sjedinjeni	Participle
garnituru	Noun
maher	Noun
obalom	Noun
žbunovi	Noun
iskrom	Noun
uklete	Participle
koristio	Participle
trenutkom	Noun
pribrajaju	Verb
prebacio	Participle
impresivniju	Adjective
izbacivane	Participle
oteraju	Verb
odeveni	Participle
izlučio	Participle
suce	Noun
blenuše	Verb
naricali	Participle
usporavao	Participle
opao	Participle
pretio	Participle
kozlaca	Noun
oglasom	Noun
kokainom	Noun
izmjerili	Participle
otvarajmo	Verb
odjeke	Noun
krstova	Noun
rubinom	Noun
impliciralo	Participle
spojio	Participle
turpijamo	Verb
povij	Verb
spaljivanjem	Noun
koncentrata	Noun
gnjijaste	Verb
forma	Noun
utopljeno	Participle
teritorije	Noun
galona	Noun
upozorio	Participle
zatražio	Participle
šešir	Noun
regulativu	Noun
preselile	Participle
robotika	Noun
prevožene	Participle
zaželelo	Participle
psihičkom	Adjective
otpuštao	Participle
trojka	Noun
trpelo	Participle
неспутани	Adjective
greje	Verb
agitirale	Participle
gađao	Participle
šrafcigere	Noun
rogača	Noun
zagrađuj	Verb
izazovom	Noun
instruktor	Noun
ponudili	Participle
propadalo	Participle
pouzdanjem	Noun
trupa	Noun
lijȇsākā	Noun
promjenjuješ	Verb
panslavizmom	Noun
lopov	Noun
sklapani	Participle
smenjen	Participle
sijamsku	Adjective
pokrivali	Participle
larpurlartizam	Noun
vesalc	Noun
protjeravao	Participle
nuklearnom	Adjective
звучни	Adjective
čvore	Noun
unose	Verb
ukazali	Participle
spartansku	Adjective
seksualizama	Noun
ožiljaka	Noun
proznom	Adjective
pripadaju	Verb
zaleđivalo	Participle
uplašeno	Participle
muzeje	Noun
besavjesniju	Adjective
dohvatili	Participle
ustupljeno	Participle
firmo	Noun
cesarom	Noun
brakove	Noun
kapke	Noun
klinca	Noun
opstao	Participle
kulta	Noun
sudelovasmo	Verb
osvećivao	Participle
opisao	Participle
susretnu	Verb
komad	Noun
travo	Noun
jadransku	Adjective
klijentom	Noun
plesa	Noun
marcipána	Noun
čagalj	Noun
neznabožaca	Noun
ceremonijom	Noun
podvostručio	Participle
udomio	Participle
glavnicu	Noun
mnijenjem	Noun
otopio	Participle
gusar	Noun
acetilen	Noun
otpuštaju	Verb
grafom	Noun
seljeno	Participle
impulzívnōst	Noun
popràvljāč	Noun
anticiklono	Noun
traženi	Participle
popravljan	Participle
korpusom	Noun
gruzijskom	Adjective
pomagače	Noun
ironiju	Noun
trnove	Noun
štampaju	Verb
sudile	Participle
estetskom	Adjective
raspravljali	Participle
sastojao	Participle
opredjeljivalo	Participle
izgovorio	Participle
pčèlinjāci	Noun
krticu	Noun
autorizacija	Noun
dȇte	Noun
domaćinom	Noun
probilo	Participle
pitate	Verb
brkovi	Noun
tvrdoćom	Noun
najavljene	Participle
istopljeni	Participle
opčinjeno	Participle
zaključaka	Noun
prodamo	Verb
klizače	Noun
jezičnu	Adjective
sprijatelje	Verb
učešćem	Noun
glazbenijom	Adjective
turbinom	Noun
virolože	Noun
sajma	Noun
mazalo	Participle
skupili	Participle
napunili	Participle
uporabilo	Participle
rješavao	Participle
pravca	Noun
vandalizam	Noun
fusnotu	Noun
trȗpālā	Noun
њемачки	Adjective
ponižava	Verb
révnōst	Noun
pisak	Noun
okružile	Participle
snađu	Verb
okreću	Verb
slovenačku	Adjective
održavane	Participle
odvile	Participle
pomiješamo	Verb
traže	Verb
bojnikom	Noun
mirovao	Participle
ometano	Participle
urednike	Noun
obustavlja	Verb
oplode	Verb
uhoda	Noun
nastavljačem	Noun
урођен	Adjective
godišnju	Adjective
apsolutizam	Noun
nadjačali	Participle
osuđivano	Participle
otimalo	Participle
prođoh	Verb
zasađen	Participle
raspodeljen	Participle
notaciju	Noun
fluorescenciju	Noun
pribijahu	Verb
ritmom	Noun
rokćete	Verb
prašinu	Noun
obelisci	Noun
zadivljeni	Participle
najtrapavijom	Adjective
mjehove	Noun
motorom	Noun
ludujemo	Verb
politeizme	Noun
prašumo	Noun
intelektom	Noun
negodujte	Verb
dostigle	Participle
pluralizmom	Noun
leksičku	Adjective
zarađuju	Verb
zakopajte	Verb
popravljao	Participle
intervjue	Noun
sađeno	Participle
prestraše	Verb
račiće	Noun
jurišale	Participle
plaženo	Participle
odmarao	Participle
prevoje	Noun
lóvca	Noun
čitalaca	Noun
popunjavale	Participle
ukrašene	Participle
српски	Adjective
maštao	Participle
ostajem	Verb
maglicu	Noun
pobjegli	Participle
poštovali	Participle
naknađivano	Participle
polusestrom	Noun
simbolizirao	Participle
bude	Verb
isječen	Participle
bujnost	Noun
ukrašavani	Participle
telekomunikacijsku	Adjective
vegetarijansku	Adjective
takmičili	Participle
svezane	Participle
spektra	Noun
lepezu	Noun
britansku	Adjective
klanjao	Participle
krinom	Noun
odvjetnikom	Noun
izvadio	Participle
dvotočaka	Noun
inspekciju	Noun
iznajmiste	Verb
cedrove	Noun
portugalsku	Adjective
ispravom	Noun
безнадан	Adjective
svećenik	Noun
odbijte	Verb
dozvoljavali	Participle
izlagan	Participle
umirovljeni	Participle
belinu	Noun
легислативни	Adjective
lenio	Participle
mitologiju	Noun
memoriju	Noun
izostavim	Verb
zakonike	Noun
kòšulja	Noun
kriptologija	Noun
veroispoved	Noun
beogradskom	Adjective
ivu	Noun
primijeniše	Verb
kvalitetom	Noun
plàvōjka	Noun
skijašku	Adjective
automatsku	Adjective
smjȅna	Noun
истрошени	Adjective
grudnjak	Noun
рутински	Adjective
izađoh	Verb
tèmplār	Noun
bacao	Participle
raspoložiše	Verb
sendviče	Noun
adoptirali	Participle
slutile	Participle
tibetansku	Adjective
utonuli	Participle
погубнији	Adjective
dinamíta	Noun
trijemova	Noun
sonatino	Noun
morfemo	Noun
čelnike	Noun
razuveravam	Verb
huliganstava	Noun
podeljene	Participle
tumačeni	Participle
prijemčiviju	Adjective
izgovoren	Participle
beležio	Participle
očuvan	Participle
bevando	Noun
monsuna	Noun
lȁgodnōst	Noun
zabranjene	Participle
vjekovi	Noun
leksema	Noun
elektrolize	Noun
vejano	Participle
nemarom	Noun
gonio	Participle
pop	Noun
depoa	Noun
sluškinju	Noun
košuljicu	Noun
plovidbom	Noun
ohlađen	Participle
blagostanjem	Noun
klecan	Participle
antikomunističkom	Adjective
usredotočeni	Participle
participirao	Participle
milicijom	Noun
hipotenuzom	Noun
korporaciju	Noun
brujah	Verb
informaciju	Noun
špijunom	Noun
nesamostalnijom	Adjective
prosvjeduju	Verb
sujevernijom	Adjective
grejao	Participle
ovnove	Noun
najstarijom	Adjective
zemljoposednike	Noun
efikasnijom	Adjective
orkestracije	Noun
paleontologijom	Noun
svlačah	Verb
tupoglavce	Noun
uspijevali	Participle
robotikom	Noun
birani	Participle
zapisani	Participle
turkijskom	Adjective
udruživalo	Participle
ženom	Noun
prćastijom	Adjective
tehniku	Noun
suzbismo	Verb
urezivali	Participle
najčišću	Adjective
masovniju	Adjective
sok	Noun
oduzimalo	Participle
odlikovali	Participle
obraćao	Participle
izbacivan	Participle
zarazu	Noun
obistinim	Verb
preživelo	Participle
trola	Noun
dijetom	Noun
amana	Noun
osvetilo	Participle
pramena	Noun
studirao	Participle
obeščastiš	Verb
napunilo	Participle
podvalim	Verb
izolaciju	Noun
izgrađivan	Participle
kočijašem	Noun
prigovara	Verb
trokutom	Noun
pristiglo	Participle
gornju	Adjective
cinizam	Noun
kolektivom	Noun
uključujete	Verb
fotona	Noun
bazom	Noun
osunčano	Participle
prikupljeno	Participle
pádeža	Noun
papira	Noun
prikazani	Participle
ustrojavane	Participle
skida	Verb
potoče	Noun
nadahnuli	Participle
zaokružuje	Verb
epruvetu	Noun
budnicom	Noun
odštetu	Noun
kožnu	Adjective
dolikuješ	Verb
uništavan	Participle
jemensku	Adjective
izdržavao	Participle
posredovao	Participle
poprimaju	Verb
protivnikom	Noun
ustaj	Verb
slijedili	Participle
svilom	Noun
obasjava	Verb
izjavljuješ	Verb
rukopisnom	Adjective
Prus	Noun
bradom	Noun
entomologije	Noun
podizali	Participle
preraspodijeliš	Verb
kompleta	Noun
izlaske	Noun
stanicu	Noun
novotarijom	Noun
topom	Noun
zečeva	Noun
potvrdile	Participle
konvenciju	Noun
obiđeš	Verb
izdavan	Participle
razotkrio	Participle
kašljah	Verb
kadim	Verb
presjeke	Noun
prezalogajim	Verb
dvobojem	Noun
odriču	Verb
nabrajaju	Verb
usavršene	Participle
oplovili	Participle
анакроничнији	Adjective
ambasadorom	Noun
kartografiju	Noun
antraksa	Noun
primenjujemo	Verb
satelita	Noun
izgubile	Participle
žudjeli	Participle
tovar	Noun
trapavaca	Noun
feminističkom	Adjective
racionalizam	Noun
imenovale	Participle
abonmanom	Noun
šaman	Noun
šukao	Participle
hajko	Noun
uzimahu	Verb
tribunala	Noun
badnja	Noun
odustao	Participle
zahvaća	Verb
saharoze	Noun
roditeljem	Noun
titulu	Noun
бенгалски	Adjective
veslaj	Verb
samozaštite	Noun
modernizma	Noun
raspisao	Participle
odjekivale	Participle
monsun	Noun
prođeš	Verb
lȍnčīnā	Noun
razmake	Noun
sojeve	Noun
usredotočen	Participle
cjepidlačile	Participle
čizmu	Noun
anomalijom	Noun
singlove	Noun
napustili	Participle
škrtce	Noun
mafiju	Noun
spašeni	Participle
načelom	Noun
šapnuo	Participle
proverom	Noun
gužvu	Noun
iskrcavaju	Verb
obavještájci	Noun
cipelu	Noun
najslavniju	Adjective
zapažene	Participle
plebejce	Noun
bakteriologije	Noun
drhtasmo	Verb
znamenku	Noun
bolesničkom	Adjective
prihvaćali	Participle
ledenjaci	Noun
nabore	Noun
isprani	Participle
voljom	Noun
sanskrt	Noun
raširujete	Verb
fanatik	Noun
pùšāč	Noun
dilemu	Noun
poslužitelj	Noun
podgrađen	Participle
zarađivali	Participle
istrijebio	Participle
podelile	Participle
smernicu	Noun
evanđeoskom	Adjective
pigment	Noun
utvrđivali	Participle
izostaje	Verb
potopljeni	Participle
zalutali	Participle
spremili	Participle
privjesci	Noun
mišljenjem	Noun
okupilo	Participle
polijeću	Verb
sanja	Verb
alegoriju	Noun
kluba	Noun
sultanata	Noun
svršavajte	Verb
braću	Noun
dizan	Participle
supstituciju	Noun
izvješćuje	Verb
narišu	Verb
pridržavalo	Participle
atlantskom	Adjective
nastavljajte	Verb
brevijára	Noun
ilustracijom	Noun
slatino	Noun
trijema	Noun
rđom	Noun
popisane	Participle
stvarane	Participle
zastupnicu	Noun
pitomci	Noun
ministara	Noun
menja	Verb
šalabahtere	Noun
vijetnamskom	Adjective
reklamom	Noun
liveni	Participle
analogijom	Noun
krumpirom	Noun
azil	Noun
prikupljene	Participle
umetnuto	Participle
oktobarsku	Adjective
bȁčāvā	Noun
iznosili	Participle
razrušeno	Participle
maštaj	Verb
miješao	Participle
statutom	Noun
kvadrata	Noun
markom	Noun
optuživale	Participle
panamskom	Adjective
okuplja	Verb
progutao	Participle
kovali	Participle
razmenjivali	Participle
lȅšnjāk	Noun
zapisivali	Participle
raznom	Adjective
razbacani	Participle
došljakinjo	Noun
sećam	Verb
zalutajmo	Verb
vrijeđali	Participle
muka	Noun
penzijom	Noun
policajcem	Noun
crvenilo	Participle
izobrazbe	Noun
snimao	Participle
potresom	Noun
hortikulturom	Noun
skrivale	Participle
obećanjem	Noun
ude	Noun
tiču	Verb
hipofizu	Noun
koordinaciju	Noun
školovali	Participle
ptičjom	Adjective
ostavismo	Verb
pomešao	Participle
najamnu	Adjective
mrakom	Noun
starinom	Noun
legenda	Noun
spuštene	Participle
dominiraju	Verb
raznosio	Participle
vjerovalo	Participle
fobiju	Noun
osećamo	Verb
radiš	Verb
jahano	Participle
udružiše	Verb
začetnike	Noun
posjekao	Participle
pokriva	Verb
odmazdom	Noun
kućicu	Noun
majčinom	Adjective
nogo	Noun
grljeni	Participle
sovjetskom	Adjective
džamiju	Noun
pridonosili	Participle
astronomom	Noun
oponašaju	Verb
grješnik	Noun
pripovjedile	Participle
udaljavali	Participle
tjelesnu	Adjective
ugovoreno	Participle
šminkom	Noun
vrtlarevom	Adjective
pronalazaka	Noun
promaknemo	Verb
uspostavljene	Participle
orkestracijom	Noun
izmereno	Participle
primjećujem	Verb
odmjerenost	Noun
susretne	Verb
kvalitetu	Noun
podudarali	Participle
izobličim	Verb
podmićuje	Verb
skladatelje	Noun
procijenjen	Participle
mongolsku	Adjective
historijom	Noun
trem	Noun
iskaljivaste	Verb
predviđalo	Participle
ponižavaju	Verb
prevrne	Verb
šumah	Verb
izdržavale	Participle
virova	Noun
susreće	Verb
smetnjom	Noun
pogrbljivah	Verb
најпријазнији	Adjective
pomelo	Participle
izbodemo	Verb
ciljaste	Verb
feljton	Noun
cifrom	Noun
dide	Noun
tvrtko	Noun
spasile	Participle
primijene	Verb
plitkost	Noun
intervalom	Noun
najusamljeniju	Adjective
nagradio	Participle
šokirao	Participle
funkcionirale	Participle
smatrale	Participle
najsavitljivijom	Adjective
glasaju	Verb
procijenilo	Participle
uspostavljeno	Participle
vara	Verb
pobunile	Participle
salome	Verb
muzom	Noun
partiju	Noun
identifikaciju	Noun
siročeta	Noun
antropolozi	Noun
daha	Noun
susretale	Participle
hrbat	Noun
proterujte	Verb
podstriženo	Participle
platformom	Noun
ekscentrik	Noun
crkavale	Participle
skuplja	Verb
ceduljom	Noun
dramu	Noun
štabovi	Noun
ovcom	Noun
zastrašuju	Verb
глибовит	Adjective
čajeva	Noun
dvanaestorica	Noun
svinjskom	Adjective
prevaljen	Participle
najranijom	Adjective
gomilu	Noun
spašeno	Participle
vjetrenjaču	Noun
svojte	Noun
iskače	Verb
pristojnost	Noun
rekle	Participle
istrijebljeni	Participle
pristankom	Noun
devijacijom	Noun
uklinjao	Participle
obeshrabren	Participle
astronomije	Noun
sakrament	Noun
masiva	Noun
ubicom	Noun
šarom	Noun
oduševljenja	Noun
kȍra	Noun
lirskom	Adjective
nadjačavaju	Verb
zagađivali	Participle
održano	Participle
vlaga	Noun
rasteraš	Verb
zenicu	Noun
gladijator	Noun
budžete	Noun
valutom	Noun
izvidnici	Noun
boluje	Verb
žargona	Noun
nastavio	Participle
ugađamo	Verb
smanjivan	Participle
suštinu	Noun
uputio	Participle
zlostavljani	Participle
izaberete	Verb
devalvacijom	Noun
zatekne	Verb
tanburom	Noun
otkazuje	Verb
nasukan	Participle
grivu	Noun
belanjke	Noun
piščevom	Adjective
pacifizmom	Noun
ukidajmo	Verb
kremenom	Noun
uzmu	Verb
postignuto	Participle
pripitomljuju	Verb
vladarom	Noun
kerova	Noun
дечји	Adjective
ciljeve	Noun
meh	Noun
ručnik	Noun
romansku	Adjective
lemo	Noun
kemija	Noun
globusom	Noun
celibat	Noun
ružo	Noun
preplaćivane	Participle
nedoumicu	Noun
skakavac	Noun
usponom	Noun
dodavalo	Participle
pokretao	Participle
lov	Noun
snima	Verb
dijagnostika	Noun
zaklonjeno	Participle
sme	Verb
abdikaciju	Noun
ručali	Participle
sprovođeni	Participle
razočarane	Participle
urotio	Participle
promicane	Participle
vlasnik	Noun
pitoresknijom	Adjective
krećemo	Verb
zvezdu	Noun
veru	Verb
postupilo	Participle
meleke	Noun
oticalo	Participle
stavak	Noun
čeznuo	Participle
furnir	Noun
ovladavaju	Verb
makadamskom	Adjective
propadali	Participle
lokacijom	Noun
šokiralo	Participle
tobdžijo	Noun
kvekerom	Noun
odbijaju	Verb
animiraju	Verb
pronađen	Participle
rimokatolike	Noun
probavljaju	Verb
dogovorilo	Participle
krnjače	Noun
pljèsnivōst	Noun
rezultat	Noun
idiotizam	Noun
omelo	Participle
skamenjivali	Participle
mahne	Verb
hibernacije	Noun
preo	Participle
ček	Noun
izgradile	Participle
pričvrste	Verb
februarsku	Adjective
autizmom	Noun
izrazilo	Participle
ovisilo	Participle
smrskane	Participle
žure	Verb
kolekciju	Noun
istoka	Noun
jovu	Noun
podučavaju	Verb
guljahu	Verb
morale	Participle
izbrisali	Participle
nagodbom	Noun
dikobraz	Noun
demokratskom	Adjective
osokoljeni	Participle
edukaciju	Noun
naudih	Verb
ponuđeno	Participle
novozelandskom	Adjective
izazvao	Participle
napušteni	Participle
oženili	Participle
besparica	Noun
učenikom	Noun
prodavane	Participle
shvate	Verb
flotom	Noun
usmereno	Participle
posjeduje	Verb
popratio	Participle
splitskom	Adjective
dođu	Verb
venčam	Verb
petka	Noun
raspršene	Participle
izdvajaju	Verb
gramatikom	Noun
sazvali	Participle
trebale	Participle
uznemiravalo	Participle
pozvane	Participle
parkovi	Noun
zgurili	Participle
gunđah	Verb
дубоки	Adjective
selektor	Noun
prednošću	Noun
gandža	Noun
raščlanjene	Participle
željelo	Participle
analizirale	Participle
utvrđivani	Participle
carevinom	Noun
mlohaviju	Adjective
probaju	Verb
pamfleta	Noun
nara	Noun
јединствен	Adjective
oboje	Verb
otklonjeni	Participle
dovodilo	Participle
kočnicu	Noun
kalup	Noun
papir	Noun
osminu	Noun
pokrijemo	Verb
udarile	Participle
lovačku	Adjective
opsjedano	Participle
lansirao	Participle
sportove	Noun
odjeljaka	Noun
postom	Noun
nazdravlja	Verb
ljudožderstva	Noun
uro	Noun
dodavali	Participle
ismejava	Verb
štavljahu	Verb
primijećeni	Participle
prevrnulo	Participle
dvojicom	Noun
potapa	Verb
tragičnost	Noun
huljaste	Verb
namenili	Participle
pljuvali	Participle
želelo	Participle
postojim	Verb
transfera	Noun
upisani	Participle
kvadratnu	Adjective
zlostavljam	Verb
jahtu	Noun
најдалекосежнији	Adjective
prerušeni	Participle
kazivali	Participle
vozaste	Verb
aseptičku	Adjective
nađemo	Verb
promatrao	Participle
botaničkom	Adjective
konkordatom	Noun
vojvotkinjom	Noun
zadržano	Participle
koristili	Participle
frazu	Noun
sagradio	Participle
slušali	Participle
uvučen	Participle
dvoje	Verb
uveličavamo	Verb
drskost	Noun
uništavano	Participle
struju	Noun
čokoladom	Noun
sačekane	Participle
latiničnu	Adjective
izbjegoše	Verb
počinio	Participle
potvrdilo	Participle
standardom	Noun
gledatelje	Noun
joge	Noun
manjkom	Noun
kolenda	Noun
prodavaoci	Noun
zahvaljuju	Verb
entuzijazma	Noun
naoružava	Verb
probijaju	Verb
ulaže	Verb
dopali	Participle
iguman	Noun
mutaciju	Noun
štakor	Noun
letjelicom	Noun
reflektore	Noun
tvrdiš	Verb
električnom	Adjective
soneta	Noun
stavljam	Verb
opseda	Verb
zakonskom	Adjective
pokrenut	Participle
ekološku	Adjective
slivom	Noun
tenkove	Noun
prokopali	Participle
istražiše	Verb
avijatičare	Noun
priklanja	Verb
zajmom	Noun
detektivom	Noun
najmlađom	Adjective
starjele	Participle
sađeni	Participle
trsa	Noun
šestinu	Noun
usidrili	Participle
vele	Noun
bloga	Noun
tehničkom	Adjective
vodo	Noun
pepsínā	Noun
propisom	Noun
obožavaju	Verb
odalo	Participle
републички	Adjective
primerkom	Noun
ostavilo	Participle
carinu	Noun
regulativom	Noun
dodiruje	Verb
stradava	Verb
parfem	Noun
uzbudiš	Verb
upriliče	Verb
utoke	Noun
mahnite	Verb
leopard	Noun
upisali	Participle
pridremam	Verb
početaka	Noun
donosili	Participle
završavao	Participle
uputstvom	Noun
silovitiju	Adjective
elektrotehnika	Noun
šiljkom	Noun
prevale	Verb
navlaže	Verb
razilaze	Verb
potvrdili	Participle
kašlješ	Verb
seriju	Noun
aglomeraciju	Noun
carevinu	Noun
tampona	Noun
špȉlja	Noun
rešavajmo	Verb
nadoknadom	Noun
iluzionizam	Noun
košticu	Noun
pacijente	Noun
kanarínac	Noun
цењени	Adjective
pośećene	Participle
razblažuje	Verb
štiglić	Noun
stočarstvom	Noun
pokazao	Participle
hardverom	Noun
kmetove	Noun
baroknom	Adjective
pokazivaste	Verb
izvučeni	Participle
zaviđa	Verb
povjetarca	Noun
bocu	Noun
kotačem	Noun
meteorološkom	Adjective
kozmopolíta	Noun
stavljan	Participle
gotičku	Adjective
sabijeni	Participle
tvoraca	Noun
odnosili	Participle
isušeno	Participle
zaudaralo	Participle
slezinu	Noun
plutokracijo	Noun
gađan	Participle
plota	Noun
centralizaciju	Noun
zàbrinūtōst	Noun
ambasadu	Noun
osnivajte	Verb
prosvjedujem	Verb
kazuju	Verb
starajmo	Verb
dirne	Verb
autoricu	Noun
ratnom	Adjective
najme	Noun
rudarskom	Adjective
hiperonima	Noun
pošalje	Verb
formiralo	Participle
trgovinsku	Adjective
pasjalukom	Noun
увјерљив	Adjective
prožeto	Participle
oceanom	Noun
zasadio	Participle
mjesečinom	Noun
spremahu	Verb
rezbarene	Participle
opsjedan	Participle
zahtijevajmo	Verb
подробан	Adjective
jabučicu	Noun
nošen	Participle
svrhòvitōst	Noun
krivotvoreni	Participle
odbijaš	Verb
rastužilo	Participle
osjećamo	Verb
jasenom	Noun
nakaleme	Verb
umetnuli	Participle
financirane	Participle
nameravahu	Verb
mudom	Noun
jednadžbom	Noun
kosturnicu	Noun
pripravio	Participle
tukli	Participle
ljube	Verb
žvakao	Participle
glasaj	Verb
nesvestica	Noun
registraciju	Noun
nagrizam	Verb
zavladavam	Verb
punktuacijo	Noun
patrona	Noun
srhe	Noun
primamljuju	Verb
zastorom	Noun
azerskom	Adjective
kritizirale	Participle
pedagošku	Adjective
tipologija	Noun
sebičnost	Noun
fiziologijom	Noun
uključen	Participle
usporen	Participle
transmisiju	Noun
granitom	Noun
uvijete	Verb
diktator	Noun
scenu	Noun
budist	Noun
okolišalo	Participle
skočio	Participle
pridržao	Participle
rastali	Participle
otkrijem	Verb
nastavljene	Participle
obnovljeno	Participle
predvođen	Participle
nadziru	Verb
naslijeđen	Participle
infleksijom	Noun
vodomar	Noun
zaključuje	Verb
posuđivani	Participle
otišao	Participle
simfonijom	Noun
bočnu	Adjective
gašeno	Participle
praska	Verb
suglasnik	Noun
melankòliče	Noun
sedativa	Noun
ostavljaš	Verb
crnačku	Adjective
vazduha	Noun
krolavano	Participle
sibìlant	Noun
stečaja	Noun
slovenačkom	Adjective
slušamo	Verb
konfederacijo	Noun
katodnu	Adjective
izračene	Participle
iscjeđivane	Participle
odmicao	Participle
napreduju	Verb
armaturu	Noun
žderite	Verb
prosudbu	Noun
perem	Verb
osuđivao	Participle
nižeš	Verb
cestovnom	Adjective
istrebili	Participle
mrzio	Participle
glođi	Verb
činilo	Participle
pritisaka	Noun
kavkaskom	Adjective
arhitektom	Noun
prezirao	Participle
hapšeni	Participle
opija	Verb
trabunjah	Verb
samlesmo	Verb
специфичан	Adjective
odgođeni	Participle
versajskom	Adjective
zauzme	Verb
trȃnšā	Noun
skučen	Participle
krivuljaju	Verb
katetom	Noun
nesu	Verb
puteljak	Noun
predgovore	Noun
razmišljam	Verb
odlaskom	Noun
bučili	Participle
kidaj	Verb
plantažu	Noun
buhu	Noun
obogaćeno	Participle
zenu	Noun
vunu	Noun
uredničkom	Adjective
Zemljo	Noun
uvreženi	Participle
priklanjao	Participle
zemljom	Noun
posjećivao	Participle
grobom	Noun
stvarali	Participle
gripom	Noun
nadmašivao	Participle
dočarava	Verb
административан	Adjective
poštovahu	Verb
safirnom	Adjective
omladinci	Noun
podsećaju	Verb
суседни	Adjective
jačao	Participle
ispitivače	Noun
šah	Noun
opljačkali	Participle
najeo	Participle
starenjem	Noun
naučili	Participle
grmljavino	Noun
strijelom	Noun
uznemiravah	Verb
knjižicom	Noun
jabučicom	Noun
doživljavah	Verb
obuhvaća	Verb
fijolu	Noun
upališe	Verb
rezan	Participle
miruje	Verb
populist	Noun
uživale	Participle
šahovskom	Adjective
krvare	Verb
gramofon	Noun
sumu	Noun
grijane	Participle
sprejevi	Noun
nastaniše	Verb
skrše	Verb
sjekirom	Noun
kahla	Noun
karticom	Noun
izvozilo	Participle
izobličismo	Verb
otpočivajmo	Verb
taoizma	Noun
privlačio	Participle
objavljivane	Participle
štrik	Noun
suzuje	Verb
dažbinu	Noun
groznicom	Noun
opstoj	Verb
razaraju	Verb
slikanjem	Noun
oskudicu	Noun
usmeravao	Participle
pijanist	Noun
gornjom	Adjective
percepcijom	Noun
imunost	Noun
prereže	Verb
sračunavate	Verb
namleveni	Participle
otvaraju	Verb
radnicu	Noun
ortopedija	Noun
boljom	Adjective
oklijeva	Verb
stjecao	Participle
oslanjah	Verb
popraćeni	Participle
gomilao	Participle
spriječile	Participle
postignute	Participle
portugalskom	Adjective
propadaju	Verb
obmanuo	Participle
тврди	Adjective
slačicu	Noun
iskaže	Verb
glacijacijom	Noun
specificiraju	Verb
pornografskom	Adjective
ječma	Noun
zastrašivali	Participle
razjarene	Participle
dijabetesom	Noun
antiimperijalizam	Noun
pritisne	Verb
razdobljem	Noun
plesačem	Noun
obavljaj	Verb
zidano	Participle
dokažu	Verb
kartáša	Noun
izravnao	Participle
pripovijeda	Verb
vidik	Noun
uništava	Verb
diskusiju	Noun
црквени	Adjective
uzvikuju	Verb
nedostatke	Noun
oštricu	Noun
mokraćom	Noun
rotore	Noun
zgrijavane	Participle
toplinom	Noun
konsonanta	Noun
organizirao	Participle
cvjetnu	Adjective
ugrozilo	Participle
uhvatilo	Participle
муљав	Adjective
vulkanizma	Noun
zadnjom	Adjective
dućan	Noun
dotiskaše	Verb
rasuti	Participle
štabova	Noun
pesmom	Noun
pobudilo	Participle
sanacijom	Noun
vjerojatnost	Noun
zloupotrebili	Participle
posrednike	Noun
doživljava	Verb
jogom	Noun
pismom	Noun
preraspodjelu	Noun
vređah	Verb
procenili	Participle
žgaravica	Noun
primijećen	Participle
mlitavost	Noun
potrčali	Participle
nameru	Noun
poduzmu	Verb
književnikom	Noun
непријазан	Adjective
pustinjak	Noun
nesrećom	Noun
izvršiste	Verb
štampali	Participle
redukcijom	Noun
zastali	Participle
hvatani	Participle
ljubimca	Noun
lastavicu	Noun
dude	Noun
izvornu	Adjective
opisalo	Participle
usporile	Participle
prepeličar	Noun
конститутивни	Adjective
rigidnijom	Adjective
uglova	Noun
australskom	Adjective
spojilo	Participle
etimološkom	Adjective
kancelarijom	Noun
izneli	Participle
zapadaju	Verb
privoljeh	Verb
izjasniše	Verb
folklorom	Noun
vrisnite	Verb
zagrizoše	Verb
optužilo	Participle
diskvalifikacijom	Noun
deluju	Verb
osvajanjem	Noun
технички	Adjective
mrsa	Noun
deizmom	Noun
dodjeljivani	Participle
sustavom	Noun
metaforu	Noun
optike	Noun
osuđivan	Participle
iscrpljivano	Participle
crta	Verb
isplaćivan	Participle
proračunaše	Verb
dvojnici	Noun
obuće	Noun
traju	Verb
šiptar	Noun
pakla	Noun
ulaskom	Noun
ustao	Participle
zatalasano	Participle
nadopunio	Participle
isteravao	Participle
termopilsku	Adjective
vej	Verb
prepirali	Participle
žezlom	Noun
nedjelju	Noun
kartografskom	Adjective
klipa	Noun
dovode	Verb
primerak	Noun
poplavljeni	Participle
slede	Noun
totalitarizam	Noun
razdijelili	Participle
raspoznavani	Participle
opiralo	Participle
progovarao	Participle
neotesanko	Noun
govorile	Participle
okrene	Verb
dolazim	Verb
bajkom	Noun
kockar	Noun
dedukciju	Noun
preuzele	Participle
emigraciju	Noun
ostanak	Noun
avanturu	Noun
dobivali	Participle
srednjovjekovnom	Adjective
bjelkinju	Noun
studijem	Noun
državljanstvom	Noun
napadnut	Participle
akadsku	Adjective
samovolje	Noun
javio	Participle
mrmljajte	Verb
ugrađivao	Participle
adenskom	Adjective
čvorove	Noun
zanosom	Noun
teoretiziraj	Participle
sirotinju	Noun
detlić	Noun
hadža	Noun
vodonoša	Noun
prijateljsku	Adjective
bresta	Noun
papo	Noun
tvrđavom	Noun
resore	Noun
mamica	Noun
plesačicu	Noun
pobjeđujte	Verb
dobacuje	Verb
dodavani	Participle
raseljavajte	Verb
tužiteljem	Noun
pokradu	Verb
detaljem	Noun
slikate	Verb
opekom	Noun
financirani	Participle
pridonijelo	Participle
opišemo	Verb
književnom	Adjective
zračenjem	Noun
ugušene	Participle
zoveš	Verb
razvodio	Participle
suhoće	Noun
flegmatičnijom	Adjective
gospodaricu	Noun
metemo	Verb
mučile	Participle
svotu	Noun
brežuljka	Noun
zavišasmo	Verb
letonskom	Adjective
maštom	Noun
krahovi	Noun
glodalo	Participle
skidahu	Verb
veče	Noun
pećinu	Noun
diftonge	Noun
obrezujte	Verb
obrisane	Participle
aktivirao	Participle
travom	Noun
priznalo	Participle
rastavom	Noun
doradio	Participle
anodom	Noun
kontinuitet	Noun
kromanjonca	Noun
vošteni	Participle
dijagonalom	Noun
ventilom	Noun
dozivljem	Verb
jetrom	Noun
pozovi	Verb
karticu	Noun
vrhove	Noun
ništavnijom	Adjective
удати	Adjective
naginjali	Participle
endogamija	Noun
nabavljen	Participle
razgonilo	Participle
samozadovoljavajmo	Verb
bele	Verb
svezujmo	Verb
misionarom	Noun
fontanu	Noun
okupljao	Participle
iranskom	Adjective
biciklizam	Noun
sjedištem	Noun
кључни	Adjective
dolažaste	Verb
hispanistike	Noun
budizmom	Noun
arhaizmi	Noun
usporili	Participle
tunel	Noun
šepah	Verb
jametinom	Noun
uvrijediše	Verb
zimuju	Verb
neboderom	Noun
rtanj	Noun
претходни	Adjective
grano	Noun
azijsku	Adjective
naselile	Participle
kristologijsku	Adjective
ogrejaste	Verb
zamjerio	Participle
imperijalnom	Adjective
raspoložen	Participle
poduzeto	Participle
igračkom	Noun
pretučeno	Participle
utvrđivahu	Verb
ustanovilo	Participle
izgubili	Participle
razlučuje	Verb
izdanjem	Noun
istrago	Noun
apostolom	Noun
ukoren	Participle
hiljadu	Noun
zavređujete	Verb
raskućismo	Verb
monstrum	Noun
lelekasmo	Verb
brzopisa	Noun
dostignut	Participle
hrđali	Participle
zapadnu	Adjective
podučavali	Participle
odviti	Participle
dešavalo	Participle
suprotstavlja	Verb
žestinu	Noun
uvažava	Verb
postfeminìzam	Noun
makova	Noun
lešnjake	Noun
podjelom	Noun
smokvik	Noun
drhte	Verb
težištem	Noun
zaređivalo	Participle
pobornik	Noun
pljuju	Verb
dobitnike	Noun
potpisani	Participle
laskaj	Verb
pitajte	Verb
podnosili	Participle
obilježavan	Participle
podijelili	Participle
aspektom	Noun
afričku	Adjective
podržane	Participle
salonom	Noun
osiguramo	Verb
podbada	Verb
korake	Noun
bacaju	Verb
diplomacijom	Noun
predsjednikom	Noun
zahtijevaju	Verb
prosjakom	Noun
zeničnu	Adjective
verovale	Participle
pojačao	Participle
dotrčavaste	Verb
pomorac	Noun
vazalom	Noun
dijaloge	Noun
kolibu	Noun
vađeni	Participle
literaturu	Noun
preriju	Noun
lonca	Noun
dogovarali	Participle
pticom	Noun
eulogiju	Noun
krčmljasmo	Verb
propuštani	Participle
канцерознији	Adjective
ubožnicu	Noun
slanci	Noun
podjarmljivasmo	Verb
semantika	Noun
đakonat	Noun
rukavicom	Noun
opstrukciju	Noun
adu	Noun
potomke	Noun
ocijenjene	Participle
posvetili	Participle
zatraže	Verb
običavali	Participle
bedu	Noun
masakr	Noun
ubacivani	Participle
срећни	Adjective
tjera	Verb
uvećavano	Participle
meteoritom	Noun
uznemiravale	Participle
podsetnik	Noun
zlostavljane	Participle
plime	Noun
medijskom	Adjective
materijal	Noun
logaritama	Noun
blatom	Noun
sekirom	Noun
pakira	Verb
iscjeđujte	Verb
kemije	Noun
principa	Noun
kulminacijom	Noun
istrebljuj	Verb
naoružavani	Participle
butike	Noun
deluje	Verb
telegrafiju	Noun
odrasle	Participle
posedujemo	Verb
oktobara	Noun
pravopisom	Noun
usredotočiše	Verb
diži	Verb
najavljivano	Participle
žbuke	Noun
obujmljuje	Verb
zaboravljaju	Verb
pretvorbom	Noun
iznjedrio	Participle
papirnom	Adjective
zanemareni	Participle
tezom	Noun
rutinskom	Adjective
menzese	Noun
uveravaste	Verb
smanjile	Participle
kvotu	Noun
osakatismo	Verb
carskom	Adjective
opaskom	Noun
tarimo	Verb
režisere	Noun
sinovca	Noun
britanskom	Adjective
preraslo	Participle
autoportretom	Noun
trupce	Noun
obronke	Noun
razmnažali	Participle
transformiraju	Verb
plina	Noun
razvrstavamo	Verb
izjurio	Participle
smjestile	Participle
odzivam	Verb
izlikom	Noun
spominjano	Participle
oslobode	Verb
buzdovan	Noun
čeznu	Verb
točkove	Noun
luftiraj	Verb
обавезни	Adjective
iznudili	Participle
iscrpljen	Participle
ometao	Participle
smišljeni	Participle
konceptom	Noun
provaljeno	Participle
provodilo	Participle
seansu	Noun
štedio	Participle
odrekle	Participle
stigosmo	Verb
upadoh	Verb
normu	Noun
blef	Noun
nakupljene	Participle
prepričavaste	Verb
eru	Noun
skalpove	Noun
turcizmi	Noun
razapne	Verb
estonskom	Adjective
podesio	Participle
kriznom	Adjective
hȃjkī	Noun
obranjen	Participle
indijskom	Adjective
uvažiš	Verb
satrapsku	Adjective
primijenjeni	Participle
dàska	Noun
nasamario	Participle
izgradnju	Noun
zatomljuje	Verb
prikupljate	Verb
zgrušaj	Verb
sitnicu	Noun
dade	Verb
obrukaj	Verb
poručuje	Verb
postavljali	Participle
protekao	Participle
napomenimo	Verb
razvrstani	Participle
rubriku	Noun
rečene	Participle
magnezije	Noun
cedrova	Noun
pritisnute	Participle
petljo	Noun
marševe	Noun
suzbijeni	Participle
oštećene	Participle
utjecao	Participle
rezoluciju	Noun
oprošteno	Participle
nailažahu	Verb
zeto	Noun
nagodim	Verb
suverenitetom	Noun
limovi	Noun
ukrašeno	Participle
fijaskom	Noun
opomenom	Noun
trijumfom	Noun
tucan	Participle
zasjenile	Participle
takt	Noun
riječnom	Adjective
članom	Noun
unakazujete	Verb
javljam	Verb
pristajalo	Participle
upadosmo	Verb
četvorku	Noun
uspjehom	Noun
zaređuju	Verb
motrio	Participle
svrstane	Participle
пуни	Adjective
ugriza	Verb
gone	Verb
podučih	Verb
propijete	Verb
istrebljujmo	Verb
izrađivani	Participle
batinali	Participle
drenovi	Noun
dužnik	Noun
nedelju	Noun
strelaca	Noun
premaše	Verb
ostavljaj	Verb
бестијалнији	Adjective
primali	Participle
hipik	Noun
urezan	Participle
smjestio	Participle
umivahu	Verb
obuzelo	Participle
leksikografija	Noun
medicinskom	Adjective
obeležjem	Noun
crijep	Noun
hvaljeni	Participle
komiteta	Noun
viškom	Noun
smještate	Verb
prestali	Participle
prekrile	Participle
iskorìstivōst	Noun
utanačujemo	Verb
ublažuje	Verb
barjakom	Noun
menopauze	Noun
доступан	Adjective
poleću	Verb
napuštane	Participle
stavljamo	Verb
kraticu	Noun
motivom	Noun
predvidjesmo	Verb
bližu	Adjective
segni	Verb
nacizma	Noun
tekstilom	Noun
survaju	Verb
kumarin	Noun
osporio	Participle
šestinom	Noun
omekšiváča	Noun
specijalitet	Noun
sociologijom	Noun
barákā	Noun
izražen	Participle
pridruže	Verb
zabije	Verb
najživotnijom	Adjective
prostitutku	Noun
ložom	Noun
kirurškom	Adjective
bubnjalo	Participle
izračunao	Participle
ražestio	Participle
očuvaš	Verb
zaslužen	Participle
prijemnike	Noun
latinsku	Adjective
stanujem	Verb
predao	Participle
udvostručilo	Participle
preotme	Verb
povezivane	Participle
cimetom	Noun
pomaknuto	Participle
uzimam	Verb
slada	Noun
nasamarivasmo	Verb
lijem	Verb
kriminalcem	Noun
skladom	Noun
kongres	Noun
vjȅtrom	Noun
završnom	Adjective
làvina	Noun
sektore	Noun
odlutasmo	Verb
ispunjene	Participle
katodnom	Adjective
lugovi	Noun
srušeno	Participle
kafanu	Noun
nijansom	Noun
epiteta	Noun
ideološku	Adjective
iskrcava	Verb
filogeniju	Noun
mušku	Adjective
spašavao	Participle
пунокрван	Adjective
uspostavilo	Participle
deponije	Noun
kvantnu	Adjective
saveznom	Adjective
bošču	Noun
rječnici	Noun
općinsku	Adjective
glazbenike	Noun
sipu	Noun
kravatom	Noun
obasipljemo	Verb
umirovljen	Participle
očekujemo	Verb
prestrašene	Participle
zamerio	Participle
brahu	Verb
koncertom	Noun
praznikom	Noun
prijemnik	Noun
śedim	Verb
zabranjuju	Verb
pòznanīče	Noun
doplovio	Participle
očekivao	Participle
dostignuti	Participle
nastradali	Participle
rabile	Participle
skrbništvom	Noun
optužio	Participle
vojskovođom	Noun
razgrizahu	Verb
poboljšavalo	Participle
obradovali	Participle
porasti	Verb
isušiše	Verb
spašene	Participle
posuđivano	Participle
prosce	Noun
zapustio	Participle
specijalizirao	Participle
pripisivalo	Participle
hokejom	Noun
pantljikom	Noun
sune	Verb
galaksiju	Noun
dovodim	Verb
nastavili	Participle
utvrđivalo	Participle
neurologija	Noun
lȋsācā	Noun
mlevene	Participle
bezbojnost	Noun
konstruktor	Noun
vitezove	Noun
opušta	Verb
ìmūnōst	Noun
pridonijele	Participle
pobijate	Verb
ручни	Adjective
potpisane	Participle
dolikovao	Participle
prenosnike	Noun
istjerale	Participle
molitvu	Noun
успешан	Adjective
spuštali	Participle
eholalija	Noun
šibicu	Noun
tehnološkom	Adjective
bubnjem	Noun
rusinskom	Adjective
aplikacijom	Noun
menjalo	Participle
segmenta	Noun
pupovi	Noun
panjeva	Noun
omotom	Noun
unele	Participle
spretnost	Noun
razbegle	Participle
cenzuru	Noun
hvatao	Participle
deru	Verb
izvukao	Participle
naručeno	Participle
ističu	Verb
izašli	Participle
kosturnicom	Noun
prestrašio	Participle
fosfornu	Adjective
oslonci	Noun
набожнији	Adjective
kvadratnom	Adjective
razoružale	Participle
treniran	Participle
lutalica	Noun
кожни	Adjective
žljebova	Noun
krša	Noun
katoličanstva	Noun
poremetio	Participle
nevestu	Noun
magiju	Noun
popravio	Participle
Berber	Noun
pregrij	Verb
zaglavljen	Participle
dvoličnost	Noun
fiskalnu	Adjective
sudelovali	Participle
soka	Noun
izgovorom	Noun
veslače	Noun
privučen	Participle
čekalo	Participle
folije	Noun
moskovskom	Adjective
слободоумни	Adjective
balkona	Noun
susretao	Participle
zadovoljavao	Participle
betona	Noun
familiju	Noun
zapitao	Participle
prokleto	Participle
nuđeno	Participle
ideologijom	Noun
završavalo	Participle
stražo	Noun
membranu	Noun
suradnjo	Noun
odmamljivali	Participle
rotacijom	Noun
istovetnost	Noun
priopćavane	Participle
antenom	Noun
zaselci	Noun
krajišnike	Noun
дужни	Adjective
zauzimali	Participle
bojeve	Noun
astrologiju	Noun
posekao	Participle
objašnjava	Verb
tenkist	Noun
šešire	Noun
gorčasmo	Verb
navraćao	Participle
šokom	Noun
iskorišten	Participle
sprovedeno	Participle
predano	Participle
dojavljujete	Verb
наметљив	Adjective
obilježiste	Verb
učlanjeno	Participle
prikazuje	Verb
nijekao	Participle
zaustavljani	Participle
narom	Noun
nekrstom	Noun
prožete	Participle
zadržavale	Participle
padovi	Noun
ligaturu	Noun
pročitajte	Verb
rastopljeni	Participle
kapiramo	Verb
narudžbu	Noun
razvij	Verb
grozde	Noun
zvuci	Noun
krpa	Verb
šlajmom	Noun
mošta	Noun
useljavaju	Verb
sredinu	Noun
dovodile	Participle
hrčaka	Noun
sastavljače	Noun
najkoščatijom	Adjective
bivstvovaste	Verb
konzule	Noun
stupile	Participle
original	Noun
nabije	Verb
secesijom	Noun
priopćile	Participle
džamijom	Noun
lȉčnōst	Noun
upadajmo	Verb
bȉsta	Noun
reciklira	Verb
primenjivane	Participle
četa	Noun
proučili	Participle
dodijeljeno	Participle
štovale	Participle
prilaska	Noun
sadašnju	Adjective
priliku	Noun
napraviš	Verb
poziralo	Participle
dirneš	Verb
krizom	Noun
kradem	Verb
fisiju	Noun
travestiju	Noun
kovčega	Noun
supo	Noun
grba	Noun
тржишни	Adjective
narod	Noun
popom	Noun
očajem	Noun
služeno	Participle
izvodio	Participle
obdaren	Participle
anulirani	Participle
banove	Noun
hvatali	Participle
kritiziran	Participle
mulci	Noun
zabranjivali	Participle
snizuju	Verb
koferom	Noun
zadaci	Noun
bolovao	Participle
odabirao	Participle
pamćahu	Verb
taktom	Noun
krmčađu	Noun
svȑsishodnōst	Noun
dojavljene	Participle
brinuo	Participle
psalama	Noun
prisegni	Verb
kruh	Noun
važio	Participle
intèrvāl	Noun
pobunjene	Participle
uvukao	Participle
plimom	Noun
breskva	Noun
zamijenjeno	Participle
zdravstvenu	Adjective
cenzor	Noun
kraniološku	Adjective
kupovali	Participle
pretplaćujemo	Verb
upravljali	Participle
uspe	Verb
noževa	Noun
izjednačuju	Verb
postupaka	Noun
ren	Noun
prekinite	Verb
dogodilo	Participle
spomenuo	Participle
pilom	Noun
nastavom	Noun
kanua	Noun
ađustiraj	Participle
otrovani	Participle
dušman	Noun
podnosim	Verb
nadao	Participle
devcem	Noun
jȕnāče	Noun
uklonjeno	Participle
ambijentom	Noun
grozdovi	Noun
struk	Noun
epilog	Noun
zasjedanjem	Noun
helebarda	Noun
svetkuješ	Verb
debilnijom	Adjective
ljevicom	Noun
noževi	Noun
prepuštaju	Verb
bezjak	Noun
uklinje	Verb
okoliše	Noun
farmu	Noun
pozorištem	Noun
брзи	Adjective
ogovarale	Participle
proslavilo	Participle
usporavalo	Participle
reku	Noun
podudarilo	Participle
celinu	Noun
kapsulom	Noun
pogibajte	Verb
shvaćaju	Verb
istinom	Noun
paleozoika	Noun
proradio	Participle
presečeni	Participle
kravála	Noun
apetita	Noun
instinkta	Noun
sotonizirate	Verb
bizantskom	Adjective
protektoratom	Noun
osvanuo	Participle
antropologiju	Noun
izbušen	Participle
bunda	Noun
obvezale	Participle
umećem	Verb
astrobiologije	Noun
isticale	Participle
miga	Noun
njušku	Noun
prestupljeni	Participle
glasovali	Participle
penise	Noun
pržah	Verb
ronioce	Noun
kozmonaut	Noun
raspustile	Participle
gradile	Participle
kreativnošću	Noun
težu	Noun
fiziologom	Noun
dojmova	Noun
suknjom	Noun
laj	Verb
molim	Verb
napisane	Participle
nemalo	Participle
osmijehom	Noun
potpredsjednicom	Noun
zapisivao	Participle
izgovarano	Participle
bjȅčva	Noun
povećali	Participle
rijekom	Noun
zakonik	Noun
racionalističkom	Adjective
reorganizaciju	Noun
ostanem	Verb
grejem	Verb
sprečavale	Participle
božićnu	Adjective
uspavljivane	Participle
opat	Noun
slušalo	Participle
soknu	Noun
reviziju	Noun
seriozniju	Adjective
potpisujte	Verb
kurio	Participle
tepihe	Noun
hvata	Verb
ovlašćuj	Verb
šnofale	Participle
proizvedosmo	Verb
cveća	Noun
zr̀natōst	Noun
prepričan	Participle
nápitak	Noun
silom	Noun
brkan	Participle
baletom	Noun
sklopom	Noun
priborom	Noun
stavova	Noun
ispere	Verb
teorijom	Noun
zaostalo	Participle
ciklo	Noun
aktivaciju	Noun
prilagođeni	Participle
aràbesāka	Noun
patka	Noun
rojevi	Noun
prisustvovalo	Participle
trigonometriju	Noun
pljačkan	Participle
najkrvaviju	Adjective
žurnalistike	Noun
budžak	Noun
presoljavajmo	Verb
stvaramo	Verb
stariju	Adjective
upravnom	Adjective
magnetit	Noun
spisa	Noun
udarca	Noun
snabdevao	Participle
kneževinom	Noun
uklanjao	Participle
izvještavah	Verb
stario	Participle
viceve	Noun
kračun	Noun
ustvrdili	Participle
proterano	Participle
uvećavaju	Verb
zagrijane	Participle
buntovnikom	Noun
podestom	Noun
harpunom	Noun
benzenom	Noun
leksikograf	Noun
odmorio	Participle
basom	Noun
neovisnost	Noun
izlečene	Participle
razložilo	Participle
odzvanjaju	Verb
lozu	Noun
teizma	Noun
teletina	Noun
mlažnjače	Noun
tobolac	Noun
prigrizemo	Verb
održavalo	Participle
blažen	Participle
pobegoše	Verb
najznačajnijom	Adjective
probavom	Noun
isekao	Participle
leta	Noun
spremu	Noun
siljene	Participle
smrdjele	Participle
uporabljen	Participle
socijalizam	Noun
uklonio	Participle
lemasmo	Verb
plavojkom	Noun
harlekine	Noun
teksturu	Noun
vareno	Participle
brukani	Participle
kupuse	Noun
utjecali	Participle
trabunjale	Participle
prisegom	Noun
ispravile	Participle
pancire	Noun
akta	Noun
krfskom	Adjective
rušioče	Noun
okončali	Participle
астрономски	Adjective
strašiš	Verb
proizvedu	Verb
iskusniju	Adjective
pojele	Participle
nadam	Verb
biraju	Verb
ukidane	Participle
raspršuje	Verb
usavršeno	Participle
zamjenu	Noun
kreativniju	Adjective
primenjivano	Participle
smještale	Participle
obećan	Participle
ùžītākā	Noun
okupljale	Participle
najlabaviju	Adjective
pendrekom	Noun
vario	Participle
usmerili	Participle
pomilovani	Participle
nastavljamo	Verb
numeričkom	Adjective
navodnu	Adjective
pravoslavac	Noun
akrostihom	Noun
klisurom	Noun
mašinom	Noun
lokaciju	Noun
uveravaju	Verb
osnivaju	Verb
okrivio	Participle
savetuje	Verb
smokvika	Noun
dalo	Participle
glasili	Participle
sežu	Verb
postigne	Verb
rimokatoličku	Adjective
zečeve	Noun
apsidu	Noun
omekšao	Participle
nabaciše	Verb
susretom	Noun
kompletom	Noun
bajka	Noun
sporazumevaste	Verb
ponestaje	Verb
akumulirao	Participle
akumulacijom	Noun
dodijelili	Participle
odmaraju	Verb
krsnom	Adjective
jagnjetino	Noun
deblom	Noun
površinu	Noun
zbližili	Participle
obmanuli	Participle
vraćale	Participle
šlagere	Noun
vrzmah	Verb
obavještajca	Noun
zasenismo	Verb
rasijeci	Verb
severoistočnom	Adjective
košarače	Noun
izgara	Verb
tona	Noun
kvasac	Noun
mnogomuštvom	Noun
okončaju	Verb
objašnjen	Participle
list	Noun
lenilo	Participle
svirajte	Verb
provalom	Noun
mostovi	Noun
старији	Adjective
grafa	Noun
izdajom	Noun
principom	Noun
dijabetičar	Noun
veterinarstvom	Noun
nametnuti	Participle
buknuše	Verb
obavijaju	Verb
osokoliše	Verb
posećivaste	Verb
gubljen	Participle
poslove	Noun
špiljo	Noun
bombarder	Noun
noževe	Noun
ophodnju	Noun
sputaju	Verb
kazivao	Participle
zapisivan	Participle
bajaju	Verb
nȁdničārkā	Noun
izloženo	Participle
uglom	Noun
opanci	Noun
izbacujem	Verb
iskusile	Participle
hranom	Noun
zaceliš	Verb
kremljòlozi	Noun
suđeno	Participle
bitkom	Noun
držan	Participle
zalije	Verb
kljunovi	Noun
pripravnici	Noun
krivòkletnīče	Noun
tvorile	Participle
otkrilo	Participle
najskupoceniju	Adjective
krijepljasmo	Verb
trsio	Participle
beleg	Noun
doseljavali	Participle
odaberemo	Verb
nastajalo	Participle
hrama	Noun
stradalo	Participle
klaonicu	Noun
zagase	Verb
lepršaj	Verb
zobali	Participle
sedmoricom	Noun
kolonijalizam	Noun
trapez	Noun
nasamarili	Participle
presreće	Verb
liniju	Noun
paor	Noun
dočasnik	Noun
nominirali	Participle
zatrujete	Verb
iskušaš	Verb
obilježavahu	Verb
posjedovali	Participle
uskraćen	Participle
isporučuje	Verb
siječnja	Noun
ismijane	Participle
riješene	Participle
ručnika	Noun
podvige	Noun
simboliziraju	Verb
najsuvremenijom	Adjective
slali	Participle
spriječeno	Participle
pluta	Verb
ustvrdio	Participle
pogodnost	Noun
brojani	Participle
suspenziju	Noun
učih	Verb
ubacili	Participle
kritičkom	Adjective
zadirkuju	Verb
šetao	Participle
siromasi	Noun
egoizmom	Noun
razdeo	Noun
kaznom	Noun
trupac	Noun
pretukosmo	Verb
pišite	Verb
srpanjsku	Adjective
lider	Noun
središnjom	Adjective
gorčaj	Verb
stječe	Verb
jesenskom	Adjective
pokazateljem	Noun
isušivane	Participle
cijepa	Verb
australsku	Adjective
najnovijom	Adjective
тврдокорни	Adjective
poništavale	Participle
severnoafričkom	Adjective
ponavljane	Participle
pomešate	Verb
skakačem	Noun
pronašao	Participle
patrijaršijom	Noun
idejnom	Adjective
učvrste	Verb
klupkom	Noun
nastanjen	Participle
италијански	Adjective
poletjeli	Participle
scenografom	Noun
pokriju	Verb
cinkom	Noun
jedrenjem	Noun
svodnici	Noun
најсамокритичнији	Adjective
perajom	Noun
баскијски	Adjective
prognozirali	Participle
pođu	Verb
kriminaliziraju	Verb
sazvano	Participle
efendiju	Noun
pokušali	Participle
minuli	Participle
vlažim	Verb
strujom	Noun
mušteriju	Noun
hebrejsku	Adjective
tajce	Noun
vatrom	Noun
sputavalo	Participle
vegetacijskom	Adjective
posadili	Participle
dopao	Participle
pobeđen	Participle
zadarsku	Adjective
gledali	Participle
umaknule	Participle
suglasnike	Noun
sačekasmo	Verb
šipka	Noun
usadio	Participle
komentatorom	Noun
kradljivca	Noun
jurišaju	Verb
složio	Participle
међународни	Adjective
presreću	Verb
najbližom	Adjective
govedina	Noun
hȏdom	Noun
неостварен	Adjective
zavolio	Participle
polomili	Participle
zaredili	Participle
profesorom	Noun
balasta	Noun
čakavci	Noun
iscrpoh	Verb
kalemom	Noun
maslinu	Noun
gatovi	Noun
glagolsku	Adjective
zamenjene	Participle
točaka	Noun
dugovao	Participle
salaš	Noun
sasecali	Participle
prepuštali	Participle
učili	Participle
promjerom	Noun
ostvarivali	Participle
prerađuje	Verb
zborove	Noun
iskopan	Participle
čestitaju	Verb
obranom	Noun
iskrcali	Participle
predočeno	Participle
bataci	Noun
placentom	Noun
hortikultura	Noun
gušeni	Participle
oživeo	Participle
prst	Noun
šampanjcem	Noun
tulumarilo	Participle
kritizirane	Participle
darvinist	Noun
strahuju	Verb
slojeve	Noun
skrbništva	Noun
pamćenjem	Noun
izvijestiš	Verb
izrezbarene	Participle
srdžbu	Noun
albanizacijo	Noun
potkivajmo	Verb
crnčiš	Verb
finalnom	Adjective
umerenost	Noun
propovijedani	Participle
pobijen	Participle
udarao	Participle
paradu	Noun
niza	Noun
snošaj	Noun
priznavale	Participle
pridruživale	Participle
istragom	Noun
sahranjen	Participle
republikanizma	Noun
proizvođeni	Participle
saopćujmo	Verb
žleba	Noun
zglobnom	Adjective
poreknu	Verb
hortikulturu	Noun
ukrasio	Participle
letaka	Noun
fetišizma	Noun
sudaca	Noun
gate	Noun
dočekivalo	Participle
tirana	Noun
kartograf	Noun
biznismenom	Noun
prekine	Verb
zemljoradnju	Noun
varani	Participle
hr̀pa	Noun
strožu	Adjective
preuzimaj	Verb
uvučeni	Participle
otkrio	Participle
galiju	Noun
tjeraš	Verb
ratujem	Verb
košaraštvom	Noun
uzmite	Verb
trgnuti	Participle
glas	Noun
ogradio	Participle
karakterom	Noun
najbržu	Adjective
велики	Adjective
izbija	Verb
lažovi	Noun
preračunavani	Participle
zakunu	Verb
svareni	Participle
rastvaraš	Verb
januarom	Noun
koštao	Participle
bijeg	Noun
tuširalo	Participle
seksa	Noun
klinac	Noun
povereno	Participle
biologe	Noun
ansambla	Noun
pravdani	Participle
štokavštine	Noun
učinaka	Noun
usmeravamo	Verb
sunčao	Participle
preporučivali	Participle
privatnom	Adjective
svitkovaca	Noun
ratnu	Adjective
rezahu	Verb
tec	Noun
trese	Verb
prevoze	Verb
policájca	Noun
pauke	Noun
mimare	Noun
pad	Noun
okončano	Participle
prašak	Noun
strugotinu	Noun
pucnjavu	Noun
slobodom	Noun
zvijezdu	Noun
pučani	Noun
neprepoznatljivost	Noun
bubnja	Verb
значајан	Adjective
lajka	Noun
naglašene	Participle
semiotika	Noun
trajnost	Noun
uzvisio	Participle
renoviraš	Verb
lončariju	Noun
hartijom	Noun
pogledane	Participle
mauzolejom	Noun
zasluživasmo	Verb
zlostavljano	Participle
truda	Noun
tajnicu	Noun
odzivom	Noun
zgrtah	Verb
slepca	Noun
razasut	Participle
štafelaj	Noun
povećavane	Participle
izbadam	Verb
obrtano	Participle
plasmana	Noun
savanu	Noun
taktičku	Adjective
dvora	Noun
koncepta	Noun
vinogradom	Noun
strahova	Noun
iskorištene	Participle
kosir	Noun
ozon	Noun
prikrivaju	Verb
označavaš	Verb
božura	Noun
srću	Verb
zabodite	Verb
vitraje	Noun
zanima	Verb
prijestolonasljednikom	Noun
istrošio	Participle
krase	Verb
ždrebamo	Verb
nesi	Verb
opanak	Noun
cvijećem	Noun
flerta	Noun
prevaljuju	Verb
štovao	Participle
tkaninom	Noun
brkova	Noun
živcem	Noun
zlatare	Noun
prigušujete	Verb
polubogova	Noun
zašiljiš	Verb
pripovetku	Noun
oštrinu	Noun
sìrevi	Noun
uživao	Participle
robuje	Verb
skinemo	Verb
prestonicu	Noun
paperjem	Noun
hiperoníma	Noun
poprimili	Participle
zanimanjem	Noun
frče	Verb
zevnuste	Verb
oduševljenjem	Noun
isečen	Participle
viđani	Participle
predavale	Participle
incidentom	Noun
trećinom	Noun
odgrizane	Participle
ribljom	Adjective
bockano	Participle
snegovi	Noun
porekne	Verb
odvajani	Participle
zastavniče	Noun
krunidbu	Noun
postojanjem	Noun
ravnotežom	Noun
erudicije	Noun
nameće	Verb
božikovina	Noun
proglašavali	Participle
најуочљивији	Adjective
začuđen	Participle
najstrožu	Adjective
naguravaš	Verb
bilježili	Participle
spalio	Participle
raspršeno	Participle
pokoreno	Participle
doprinosili	Participle
transformirao	Participle
paljahu	Verb
kuno	Noun
narednom	Adjective
isele	Verb
kopiju	Noun
krugovalnu	Adjective
pokrivao	Participle
jadikuje	Verb
poseduju	Verb
sašiše	Verb
непробојнији	Adjective
iskazali	Participle
krȅmšnītā	Noun
obio	Participle
posao	Noun
ventilirahu	Verb
dresirale	Participle
sabrale	Participle
dijafragmu	Noun
opozvani	Participle
dopisani	Participle
kist	Noun
učvršćivao	Participle
tjelešcem	Noun
vjenčali	Participle
svjetionik	Noun
kajkavci	Noun
bluze	Noun
prikrada	Verb
obitavalo	Participle
raseljavajmo	Verb
правни	Adjective
narkotike	Noun
zaokruže	Verb
optuživani	Participle
psihologiju	Noun
boravak	Noun
štovalo	Participle
aktuelnijom	Adjective
kalvinizam	Noun
nesrećo	Noun
začinjah	Verb
vježbom	Noun
talismana	Noun
iskušava	Verb
usložnjavate	Verb
obrađivale	Participle
tumačeno	Participle
izrazom	Noun
trudova	Noun
пристрани	Adjective
zbližavate	Verb
ostavljao	Participle
legendom	Noun
tvrdile	Participle
sagledavaju	Verb
forínta	Noun
složenijom	Adjective
izdavale	Participle
pridružene	Participle
skucavamo	Verb
naučene	Participle
predator	Noun
zatvara	Verb
odlučivao	Participle
psić	Noun
nekolicina	Noun
najzreliju	Adjective
astrološkom	Adjective
rabotale	Participle
gledatelj	Noun
zbora	Noun
pomešaju	Verb
okolinom	Noun
proterivahu	Verb
uzlijeće	Verb
iskazane	Participle
nosate	Verb
kipa	Noun
drvnu	Adjective
kovertu	Noun
probavnom	Adjective
bubamarom	Noun
promenio	Participle
sagnem	Verb
kršio	Participle
opsjednuti	Participle
odbacilo	Participle
presvučeno	Participle
zabavljali	Participle
ukidao	Participle
privilegijo	Noun
tadašnjom	Adjective
ustanovu	Noun
nosilaca	Noun
lopatom	Noun
vodikom	Noun
transportere	Noun
sultanatom	Noun
zvuk	Noun
sirovijom	Adjective
deficitom	Noun
liberalom	Noun
dodiruju	Verb
ispuhaše	Verb
slušalicu	Noun
saznao	Participle
promašujete	Verb
potjernicu	Noun
nedostajale	Participle
praznio	Participle
utakmicom	Noun
obuhvate	Verb
savinute	Participle
bubani	Participle
ateistom	Noun
sugrađane	Noun
sećali	Participle
transportera	Noun
pokrštavaju	Verb
izvođeno	Participle
ukazalo	Participle
davan	Participle
đakom	Noun
klizali	Participle
baltičkom	Adjective
popisivao	Participle
juhu	Noun
sektu	Noun
poravnah	Verb
navodile	Participle
dječjom	Adjective
razapeli	Participle
uzeše	Verb
књижевни	Adjective
nadiman	Participle
vrhovnom	Adjective
pokopao	Participle
kišnica	Noun
colove	Noun
naglašavamo	Verb
naterivan	Participle
burmom	Noun
ospica	Noun
jačanjem	Noun
lingvist	Noun
dopišem	Verb
sandalovino	Noun
doseljavaju	Verb
otkopali	Participle
udahnem	Verb
glavicu	Noun
ljutilo	Participle
osnivali	Participle
natjerava	Verb
konformìzam	Noun
seku	Verb
pornografsku	Adjective
uticali	Participle
čišću	Adjective
jurisdikcijo	Noun
ismeje	Verb
kecelju	Noun
usvojeno	Participle
filantropijo	Noun
osumnjičio	Participle
crtežom	Noun
dominaciju	Noun
psihijatriju	Noun
apstinencija	Noun
nadenuli	Participle
педагошки	Adjective
ispražnjeno	Participle
prospekt	Noun
istukoše	Verb
profesionalizmom	Noun
privjeskom	Noun
hormonom	Noun
karikom	Noun
atičkom	Adjective
autorizaciju	Noun
zadrugarstva	Noun
potočnu	Adjective
han	Noun
neprekidnost	Noun
raširile	Participle
austrijskom	Adjective
rekonstruirao	Participle
predomislih	Verb
brinule	Participle
razišle	Participle
vožnjom	Noun
dobitnikom	Noun
uštedu	Noun
podrazumevane	Participle
antipoda	Noun
sindikat	Noun
stadionom	Noun
antičkom	Adjective
upućivalo	Participle
blizance	Noun
zabavljen	Participle
zadaćom	Noun
znamenkom	Noun
inaugurirao	Participle
неуспешни	Adjective
podrijetlom	Noun
kavanu	Noun
poljubim	Verb
pevajte	Verb
otpisani	Participle
lijenost	Noun
glumilo	Participle
lagunu	Noun
blokom	Noun
odlukom	Noun
guštamo	Verb
mestovino	Noun
rezali	Participle
avionskom	Adjective
položen	Participle
obitavaj	Verb
usavršavale	Participle
formaciju	Noun
sedefnu	Adjective
opirasmo	Verb
parlamenta	Noun
tucano	Participle
labilnijom	Adjective
ostatka	Noun
haba	Verb
tepamo	Verb
utiče	Verb
žbuka	Verb
civilom	Noun
naišli	Participle
osiromašivano	Participle
etiologijom	Noun
tròglasnīci	Noun
spoznao	Participle
računamo	Verb
pristaje	Verb
izbjeglo	Participle
sodom	Noun
sirenu	Noun
kompanijo	Noun
dozovi	Verb
dezertere	Noun
razaslani	Participle
okićen	Participle
poboljšanjem	Noun
trenda	Noun
iskušalo	Participle
spomenimo	Verb
proteran	Participle
sekundom	Noun
prepale	Participle
ustupak	Noun
papa	Noun
izdržale	Participle
helikopterom	Noun
najubogiju	Adjective
zahtijevano	Participle
manekenka	Noun
almanasi	Noun
okončalo	Participle
uvidelo	Participle
odjevene	Participle
primjećujemo	Verb
šijo	Noun
suzdržava	Verb
doznavalo	Participle
nametalo	Participle
pobegao	Participle
lugom	Noun
nivoom	Noun
talio	Participle
naježismo	Verb
divili	Participle
vampirsku	Adjective
mesečnom	Adjective
odbojkaškom	Adjective
presečem	Verb
logičare	Noun
niklo	Participle
pločicu	Noun
nadahnule	Participle
prut	Noun
bukvu	Noun
smežurajmo	Verb
nađite	Verb
odlučen	Participle
testiralo	Participle
spekulira	Verb
spolovilom	Noun
preselili	Participle
jasniju	Adjective
premašile	Participle
pozdravile	Participle
osvježavaju	Verb
urotnike	Noun
uzrokom	Noun
dokazujemo	Verb
krotile	Participle
kip	Noun
nikotinsku	Adjective
humanističkom	Adjective
otiču	Verb
pokoren	Participle
mehaničar	Noun
povećaju	Verb
pohodom	Noun
gubljasmo	Verb
prijavu	Noun
vadio	Participle
logore	Noun
pomicale	Participle
iselili	Participle
dijalektologijom	Noun
potrčiš	Verb
nabavljalo	Participle
brojku	Noun
železničku	Adjective
šank	Noun
usidrene	Participle
брзоплетији	Adjective
graditeljskom	Adjective
kelvin	Noun
fluor	Noun
budio	Participle
pljeskali	Participle
obožavalaca	Noun
napalo	Participle
pacifičkom	Adjective
pokoravaju	Verb
odrekoste	Verb
izbijeni	Participle
aklimatizirate	Verb
gib	Noun
prkosa	Noun
mara	Noun
osvojio	Participle
čȉstka	Noun
uginule	Participle
типични	Adjective
motociklom	Noun
zgradu	Noun
snimak	Noun
izdvojene	Participle
otplovio	Participle
motku	Noun
bandu	Noun
sokova	Noun
kristaliziraju	Verb
utonuo	Participle
sukobljavajte	Verb
mèštānka	Noun
pojačava	Verb
participaciju	Noun
državnom	Adjective
putuje	Verb
jeftinijom	Adjective
približe	Verb
pobudili	Participle
ranjavaju	Verb
pucnjavom	Noun
sklopio	Participle
ismijavam	Verb
tržištem	Noun
klimaksa	Noun
metabolizmom	Noun
percepciju	Noun
zapregu	Noun
pobunjenike	Noun
неособан	Adjective
knjižničar	Noun
genocidom	Noun
okite	Verb
odsustava	Noun
jednorog	Noun
štapom	Noun
prestravljen	Participle
operem	Verb
daljinsku	Adjective
izrezuje	Verb
tegljač	Noun
naručili	Participle
zahtevahu	Verb
štape	Noun
dostupnost	Noun
izvade	Verb
bajt	Noun
smjerovi	Noun
stida	Noun
зрцалан	Adjective
prostirao	Participle
čipku	Noun
teretom	Noun
popravljane	Participle
suvremenikom	Noun
želele	Participle
sudio	Participle
pregrađene	Participle
džamija	Noun
zaratili	Participle
osnovo	Noun
smogovi	Noun
ćirilica	Noun
višeznačnost	Noun
splitsku	Adjective
heraldika	Noun
optimizma	Noun
jubileja	Noun
belorusku	Adjective
lupa	Verb
patološkom	Adjective
zatvaraju	Verb
svetioničare	Noun
lordovi	Noun
načinjeno	Participle
lečio	Participle
ćiriličnom	Adjective
krina	Noun
nabadan	Participle
stavko	Noun
osvetio	Participle
dresove	Noun
reprezentacijom	Noun
rezultatom	Noun
natjecanjem	Noun
determinacija	Noun
naobrazbu	Noun
nicali	Participle
došlo	Participle
razvijalo	Participle
ćupriju	Noun
teoretizirao	Participle
provaliju	Noun
rastojanjem	Noun
popiju	Verb
akustikom	Noun
parado	Noun
afarskom	Adjective
stršljen	Noun
nadživljavalo	Participle
humka	Noun
preostao	Participle
destrukcijom	Noun
lùtrija	Noun
kupolom	Noun
podgrijavale	Participle
teletine	Noun
stanovao	Participle
dvoranu	Noun
hemijsku	Adjective
risove	Noun
istraženi	Participle
demonom	Noun
razbiju	Verb
omotača	Noun
tvrdnjom	Noun
pripremljeni	Participle
mrviš	Verb
ispostavlja	Verb
pretpostavku	Noun
plijenor	Noun
livadsku	Adjective
gušenjem	Noun
srpom	Noun
raskrižjem	Noun
harate	Verb
kalka	Noun
hranilo	Participle
našle	Participle
sirutka	Noun
zapadnjaci	Noun
tranzicijo	Noun
borom	Noun
behara	Noun
povezivano	Participle
atributa	Noun
првокласани	Adjective
državljanin	Noun
čorbu	Noun
opstankom	Noun
osuđivane	Participle
nasmijano	Participle
vrednoće	Noun
promislili	Participle
opstalo	Participle
potkupljivao	Participle
erudiciju	Noun
vampirskom	Adjective
pobratim	Noun
preletio	Participle
generacijo	Noun
računom	Noun
sinod	Noun
enklavu	Noun
uvideo	Participle
naoružanja	Noun
prokune	Verb
planirate	Verb
aranžmana	Noun
krivudao	Participle
ohrabrili	Participle
velegrade	Noun
smeše	Verb
teca	Noun
razotkrili	Participle
spremalo	Participle
ravninom	Noun
povjerenstvom	Noun
mjehurom	Noun
oduzete	Participle
ostalu	Adjective
predočeni	Participle
raspravu	Noun
zidnom	Adjective
kondiciju	Noun
ekumenizam	Noun
samostanom	Noun
prenoće	Verb
tratinu	Noun
separaciju	Noun
prebačen	Participle
pregovarače	Noun
kitolovce	Noun
razjedinim	Verb
priklanjaju	Verb
eutanazijom	Noun
predlagane	Participle
pretvarani	Participle
turizmom	Noun
nemate	Verb
mještani	Noun
prespavah	Verb
kažnjavahu	Verb
trgovalo	Participle
tutorom	Noun
урбани	Adjective
pridonijeli	Participle
hidroksidom	Noun
obuzdavan	Participle
vezivale	Participle
hegemoniju	Noun
raseljen	Participle
rodova	Noun
krompira	Noun
hipotezom	Noun
šnajder	Noun
metodist	Noun
kmetstva	Noun
balavile	Participle
podelilo	Participle
izrastaju	Verb
najnečasniju	Adjective
intelektùālkā	Noun
tjesnacem	Noun
izostavljen	Participle
analoškom	Adjective
jambram	Verb
trikovi	Noun
средишњи	Adjective
učenjake	Noun
izradilo	Participle
nasljeđuju	Verb
utoljujemo	Verb
metom	Noun
кристаличан	Adjective
zakonodavstava	Noun
pukni	Verb
smenu	Noun
kolonizacijom	Noun
tigrom	Noun
tečajeve	Noun
preslicom	Noun
podičim	Verb
ispada	Verb
ratovale	Participle
određujemo	Verb
kondukcije	Noun
gravitacijskom	Adjective
želuca	Noun
nazivnik	Noun
filozofiju	Noun
obdukciju	Noun
muzejsku	Adjective
posuđuju	Verb
ukorjenjivan	Participle
zahtijevao	Participle
pričom	Noun
ujedinile	Participle
snijega	Noun
povredu	Noun
osnovalo	Participle
pešadijom	Noun
obuzdaše	Verb
maše	Verb
povežete	Verb
pronalaske	Noun
dolazili	Participle
tajnicom	Noun
prutove	Noun
higijene	Noun
rasìzam	Noun
imobilizaciju	Noun
proučavani	Participle
kanabisa	Noun
njuška	Noun
sužava	Verb
poreznik	Noun
nametnuto	Participle
nadvisio	Participle
nasleđen	Participle
londonsku	Adjective
sektáša	Noun
lonce	Noun
procenu	Noun
zrcalom	Noun
konopom	Noun
plašt	Noun
rizike	Noun
otmičar	Noun
opovrgavali	Participle
većinsku	Adjective
jastrebove	Noun
obodi	Verb
svemirom	Noun
nevolju	Noun
samokritiko	Noun
javlja	Verb
atentata	Noun
spajamo	Verb
turističkom	Adjective
zalaske	Noun
rabljene	Participle
zasedu	Noun
dvanaesnik	Noun
pišete	Verb
pogine	Verb
колоквијални	Adjective
ispitali	Participle
obiđu	Verb
плачљиви	Adjective
dobacivan	Participle
psihijatrije	Noun
ucjenjivani	Participle
pjesmo	Noun
gravitira	Verb
prenijeli	Participle
analiziraj	Participle
poetikom	Noun
klimatologija	Noun
gleda	Verb
poraslo	Participle
preni	Verb
snimam	Verb
fragmentom	Noun
krivotvorasmo	Verb
odstranjuju	Verb
glasnoće	Noun
imperator	Noun
šeširom	Noun
slame	Noun
umišljao	Participle
crticu	Noun
računare	Noun
kratkovidnost	Noun
nigerijskom	Adjective
opozvali	Participle
prevarom	Noun
prekaliste	Verb
izrastemo	Verb
cvatemo	Verb
iznajmljivali	Participle
dostavljeni	Participle
izgorjele	Participle
dignu	Verb
златни	Adjective
prodate	Verb
pobednikom	Noun
katrana	Noun
bračeve	Noun
upisivan	Participle
idolopoklonstvom	Noun
izjavio	Participle
zagriju	Verb
najkomunikativniju	Adjective
neùmerenōst	Noun
selekcijom	Noun
usredotočio	Participle
obrijmo	Verb
namamio	Participle
raspolagao	Participle
smještani	Participle
izložile	Participle
implikaciju	Noun
probuđeno	Participle
kacigom	Noun
dojam	Noun
poznanikom	Noun
onkologije	Noun
predstavljen	Participle
baljezgasmo	Verb
transcendentálnōst	Noun
zaklanjaju	Verb
algebro	Noun
mitološkom	Adjective
poricao	Participle
inicijatorom	Noun
odgrižu	Verb
dostojanstava	Noun
usadili	Participle
menstruaciju	Noun
obaspite	Verb
arhipelaga	Noun
osigurani	Participle
zadržalo	Participle
prepuštao	Participle
privučene	Participle
doselile	Participle
snalažljivost	Noun
skrivaju	Verb
povezivalo	Participle
poremetili	Participle
brk	Noun
označavaju	Verb
prelaske	Noun
vulkana	Noun
tražen	Participle
koljem	Verb
zamenjivahu	Verb
pomòranādžā	Noun
iskrcavale	Participle
rovove	Noun
brijega	Noun
šeću	Verb
ratifikacijo	Noun
pokrstio	Participle
stilistike	Noun
očišćeno	Participle
podsjetilo	Participle
sagrađeni	Participle
osuše	Verb
negirate	Verb
zašao	Participle
bivol	Noun
pričali	Participle
prijeđu	Verb
vraćene	Participle
rojeva	Noun
studence	Noun
napuštaju	Verb
pokrivača	Noun
koncert	Noun
akademiju	Noun
otpraviše	Verb
zabranjuje	Verb
iseljavali	Participle
lika	Noun
maestre	Noun
električnu	Adjective
zaustavilo	Participle
dobiven	Participle
sudsku	Adjective
razlikom	Noun
hinduizam	Noun
zlòdusi	Noun
bljeskam	Verb
popuštao	Participle
oporavljajmo	Verb
prebacivao	Participle
zapaženo	Participle
komisiju	Noun
oslobođen	Participle
intenziteta	Noun
beletristika	Noun
podudara	Verb
konvoj	Noun
raduj	Verb
широк	Adjective
napadali	Participle
odbijen	Participle
izdajnik	Noun
okončane	Participle
kondicional	Noun
praznik	Noun
vosak	Noun
prespavaju	Verb
svjetliju	Adjective
gricnete	Verb
zidani	Participle
sarađujem	Verb
kute	Noun
razvrstao	Participle
romsku	Adjective
doprineli	Participle
patrijaršiju	Noun
izmamljivao	Participle
preživljavao	Participle
helikoptere	Noun
mitskom	Adjective
prožmem	Verb
globo	Noun
zapadnjake	Noun
ogrlicom	Noun
božjom	Adjective
