acabant	None
vorejaren	Plural
desenvoluparen	Plural
succeint	None
afegida	Singular
finies	Singular
comentes	Singular
industrialitzats	Plural
pescant	None
ballaren	Plural
justificant	None
estudiant	None
jaquir	None
guardonen	Plural
interpretades	Plural
encaixessis	Singular
proporcionant	None
revoltant	None
sotmetran	Plural
explicaràs	Singular
jubilada	Singular
mesclant	None
aconsello	Singular
infectarien	Plural
triant	None
estaquen	Plural
somrient	None
dissuadissis	Singular
aportant	None
elegien	Plural
dormiré	Singular
calmats	Plural
llegir	None
introduïen	Plural
disposats	Plural
familiaritzar	None
canviar	None
mullar	None
solidificà	Singular
llegat	Singular
colonitzat	Singular
concorregut	Singular
pelat	Singular
pegada	Singular
submergits	Plural
servint	None
modificant	None
recolliran	Plural
planxant	None
tallarien	Plural
aprofitarem	Plural
pretenent	None
consideraríem	Plural
vendre	None
recupero	Singular
reflexionat	Singular
mullant	None
arrestessin	Plural
respecto	Singular
conduïts	Plural
animades	Plural
cloent	None
refinar	None
embenar	None
emetré	Singular
fonguessin	Plural
frenaven	Plural
publiques	Singular
calcificareu	Plural
atacades	Plural
estigmatitzar	None
dibuixant	None
boxar	None
harmonitzarien	Plural
movent	None
eixírem	Plural
aconsellaven	Plural
respirà	Singular
recorrerem	Plural
circular	None
expandeixen	Plural
llatinitzar	None
acusessin	Plural
jaquint	None
profetitzant	None
submergides	Plural
rebutgen	Plural
abandonàrem	Plural
habilitaven	Plural
assabentaren	Plural
incorporarien	Plural
assimilar	None
contraatacar	None
publiquessin	Plural
observéssiu	Plural
etiquetar	None
intervindrien	Plural
lligaren	Plural
acordà	Singular
pasteuritzant	None
oblidada	Singular
especificaran	Plural
participats	Plural
sobrevolà	Singular
escollirà	Singular
alienàveu	Plural
traspassessin	Plural
resoldrem	Plural
representar	None
respirares	Singular
transgredit	Singular
trobaré	Singular
elevant	None
descoratjats	Plural
distanciats	Plural
acollien	Plural
regressen	Plural
enaiguant	None
alteres	Singular
deshumanitzada	Singular
embolicats	Plural
sobreviurà	Singular
renovaven	Plural
vedant	None
suggereixen	Plural
domant	None
ensorrar	None
domen	Plural
digerits	Plural
apoderar	None
afegint	None
promourien	Plural
dispersarien	Plural
desaparèixer	None
pregant	None
estiràveu	Plural
lloant	None
pintar	None
manis	Singular
encunyar	None
estabilitzant	None
evaporada	Singular
desaprovada	Singular
dificultéssim	Plural
organitzant	None
cobrades	Plural
circumnavegant	None
islamitzat	Singular
heretant	None
ateníem	Plural
lligarà	Singular
quantificant	None
redimeixen	Plural
obrint	None
velaritzar	None
dessin	Plural
vorejar	None
activo	Singular
desembocarien	Plural
capfiquis	Singular
dissuadir	None
protegirà	Singular
progressà	Singular
ballant	None
parlades	Plural
dormir	None
trigant	None
restringiren	Plural
demolint	None
vetà	Singular
conceberen	Plural
mudada	Singular
segregaries	Singular
imposat	Singular
viure	None
abdicàrem	Plural
instauréssiu	Plural
qüestionada	Singular
aprecià	Singular
suplint	None
assegurà	Singular
pararà	Singular
dures	Singular
obliqüéssim	Plural
compararen	Plural
estudiarem	Plural
estimulat	Singular
indico	Singular
subministrar	None
estimessin	Plural
sucant	None
vinculat	Singular
prohibirà	Singular
discutint	None
fotosintetitzaries	Singular
portats	Plural
apliquéssim	Plural
vocalitzar	None
satisfer	None
cuejant	None
afectaren	Plural
revenjà	Singular
destil·lar	None
prepararan	Plural
llepaven	Plural
servíreu	Plural
improvisar	None
escandalitzada	Singular
cometran	Plural
segregaven	Plural
establint	None
recompondràs	Singular
raspallada	Singular
ampliarem	Plural
celebrant	None
dormint	None
duplicà	Singular
encaixar	None
beneficiant	None
motoritzats	Plural
protagonitzar	None
repetiries	Singular
filtrats	Plural
evitaran	Plural
cobrint	None
imposarà	Singular
emigrarien	Plural
barbaríeu	Plural
promogut	Singular
estudiada	Singular
descloure	None
rejovenit	Singular
divorcià	Singular
afavorir	None
evaporar	None
apreciaran	Plural
refregar	None
recolzen	Plural
argüíreu	Plural
traslladar	None
bastint	None
seguirà	Singular
manifestada	Singular
reorganitzant	None
coronades	Plural
ennuegar	None
exterminen	Plural
cornant	None
ensordirien	Plural
rosegar	None
estaré	Singular
trobats	Plural
relacionaven	Plural
enfocaven	Plural
nado	Singular
agraïren	Plural
encaixant	None
incorporares	Singular
rebotre	None
tacada	Singular
col·locat	Singular
varies	Singular
complint	None
reiteren	Plural
recompondre	None
idolatraríem	Plural
rosegant	None
rentar	None
reiterant	None
resolguessin	Plural
tractaven	Plural
encallar	None
constituïen	Plural
dat	Singular
oferirà	Singular
arrenquen	Plural
eduquen	Plural
tractats	Plural
resar	None
improvisen	Plural
responen	Plural
evacuà	Singular
finir	None
pasteuritzis	Singular
inflar	None
endeutàvem	Plural
esnifant	None
envies	Singular
adoptat	Singular
assassinar	None
desplaçada	Singular
canvies	Singular
nacionalitzen	Plural
rentada	Singular
infonent	None
nomenar	None
passar	None
baixats	Plural
estigueren	Plural
associarà	Singular
edificarà	Singular
individualitzar	None
xarrupant	None
propagarem	Plural
vorejant	None
executaren	Plural
pereixen	Plural
embolicada	Singular
resistida	Singular
percebut	Singular
patint	None
participis	Singular
tremolaré	Singular
simulaven	Plural
afectant	None
desprendre	None
indicant	None
rebo	Singular
deturà	Singular
cerques	Singular
mirant	None
obliguen	Plural
rauríem	Plural
evocar	None
solucionada	Singular
dinamitzat	Singular
protestaves	Singular
efectuant	None
integro	Singular
agregats	Plural
demostrant	None
saludo	Singular
gaudiran	Plural
dejunar	None
finançar	None
reverberant	None
vehiculareu	Plural
dominaven	Plural
nadar	None
eixits	Plural
liberalitzes	Singular
mesurant	None
atenuant	None
martiritzar	None
observarà	Singular
reconeixerien	Plural
depenguessin	Plural
acidificar	None
sabíeu	Plural
forjant	None
dragares	Singular
progressaven	Plural
sagnant	None
desodoro	Singular
créixer	None
eructada	Singular
despatxant	None
terminà	Singular
estiuant	None
aturaven	Plural
marques	Singular
reverencien	Plural
compensaven	Plural
estovades	Plural
xarrupàrem	Plural
categoritzades	Plural
rodats	Plural
cerno	Singular
catapultar	None
estudiarien	Plural
buscà	Singular
torçant	None
perfumar	None
nomenada	Singular
boxéssim	Plural
reforçada	Singular
digerir	None
sobrevolis	Singular
sorprenguessin	Plural
fraternitzar	None
reverint	None
lligant	None
néixer	None
immortalitzat	Singular
internacionalitzéssim	Plural
solucionats	Plural
publicat	Singular
gratí	Singular
anuncià	Singular
incorporaven	Plural
brodant	None
aixecàveu	Plural
guardonats	Plural
dutxar	None
transcriguessis	Singular
dissenyant	None
vociferant	None
perdonada	Singular
aconsegueixo	Singular
anhelada	Singular
idolatrant	None
fragmentant	None
comencis	Singular
pots	Singular
embolicant	None
llegiran	Plural
eixugat	Singular
reguen	Plural
xiuxiuejaren	Plural
completo	Singular
calguin	Plural
conjugarà	Singular
incorporar	None
acordareu	Plural
notaran	Plural
apareguessin	Plural
sobreescalfat	Singular
detectaran	Plural
activaran	Plural
anomenarien	Plural
resistirà	Singular
fundar	None
sumada	Singular
multiplicada	Singular
m'entretingui	Singular
sumaren	Plural
refrigeren	Plural
tantalitzant	None
derruïda	Singular
follar	None
gustar	None
sofrint	None
subministraven	Plural
jurant	None
verbalitzar	None
monopolitzant	None
produït	Singular
retornessin	Plural
esmenen	Plural
segrestar	None
atribuïssin	Plural
empitjorat	Singular
afegies	Singular
extrapolar	None
belen	Plural
parlaríem	Plural
forçats	Plural
trairà	Singular
condemnades	Plural
subratllada	Singular
obeíeu	Plural
imposessin	Plural
sembles	Singular
anhelades	Plural
atempten	Plural
rellegireu	Plural
sobreviuré	Singular
assetjaren	Plural
retirat	Singular
reescalfant	None
escanejar	None
encantat	Singular
perds	Singular
abaixo	Singular
esmento	Singular
cessant	None
tocaré	Singular
viatjar	None
suïcidà	Singular
traient	None
caps	Singular
soldes	Singular
continuaven	Plural
racionalitzaven	Plural
tustant	None
reapareixerà	Singular
ratificat	Singular
iniciar	None
renunciéssiu	Plural
occidentalitzat	Singular
gustant	None
compongué	Singular
nacionalitzat	Singular
lamentada	Singular
pertanyeran	Plural
guies	Singular
cerndre	None
inhumat	Singular
estrenant	None
sabí	Singular
assecant	None
elegir	None
creuant	None
jubilarà	Singular
cargolades	Plural
dirien	Plural
beatificà	Singular
manades	Plural
estiguessin	Plural
obert	Singular
perdien	Plural
entenguessin	Plural
uniformitzar	None
suplires	Singular
racionalitzis	Singular
generessin	Plural
faltéssim	Plural
distengueres	Singular
desencadenant	None
distrauran	Plural
abaixar	None
belant	None
remuntaren	Plural
vorejat	Singular
impulsant	None
clamà	Singular
fraternitzant	None
absorbir	None
orbitar	None
privaven	Plural
condicionant	None
derivaven	Plural
rodà	Singular
citarem	Plural
devorareu	Plural
coneixíem	Plural
mercantilitzàrem	Plural
assistida	Singular
llevar	None
formar	None
regalats	Plural
absorbirà	Singular
nominar	None
menysprear	None
ensopireu	Plural
cuirasses	Singular
travessar	None
anomenareu	Plural
construïda	Singular
calien	Plural
procedirà	Singular
esclaten	Plural
sobrevisqué	Singular
traumatitzaríem	Plural
agraeixo	Singular
cercaren	Plural
foradada	Singular
visqueren	Plural
desenterro	Singular
atribuïda	Singular
afebleixis	Singular
rescatant	None
desapareixem	Plural
pecaven	Plural
impedit	Singular
condicionessin	Plural
conceptualitzen	Plural
ornamentades	Plural
simulada	Singular
tallarem	Plural
comparant	None
enfonsaren	Plural
asseurà	Singular
habilitaríeu	Plural
fluctuar	None
cessaven	Plural
infectar	None
torrar	None
aprendrem	Plural
cagaré	Singular
educat	Singular
pení	Singular
escrigueren	Plural
modernitzar	None
mastegats	Plural
habitant	None
agradaven	Plural
exclamada	Singular
governaven	Plural
recolzaren	Plural
profetitzat	Singular
tingudes	Plural
aportí	Singular
compareixíeu	Plural
acollíssim	Plural
presentarà	Singular
ancorada	Singular
instaurant	None
falsificar	None
vull	Singular
sumant	None
dejunant	None
legislats	Plural
comptabilitzar	None
dèieu	Plural
agrairà	Singular
lluitaran	Plural
preferint	None
evoluciones	Singular
perfeccionat	Singular
sobreviure	None
pescat	Singular
conjugues	Singular
plantejàrem	Plural
absorbeixen	Plural
deprimint	None
debilitant	None
adjuréssiu	Plural
parlada	Singular
influïdes	Plural
respectar	None
enterbolides	Plural
il·lustraren	Plural
conduïres	Singular
rebaixant	None
cobreixen	Plural
emascular	None
investigaven	Plural
refutar	None
assegurarien	Plural
dibuixar	None
jutjà	Singular
conreat	Singular
llicenciàreu	Plural
demostrats	Plural
alimentat	Singular
hospitalitzant	None
disculpar	None
realitzaven	Plural
afavorits	Plural
aromàreu	Plural
revelats	Plural
assetjares	Singular
tancaré	Singular
ornamentaré	Singular
naufragaven	Plural
esforçar	None
construirem	Plural
sagnats	Plural
falsificat	Singular
pol·linitzat	Singular
perfumo	Singular
reorganitzarà	Singular
arrendar	None
derivaren	Plural
ingressaven	Plural
demostrarà	Singular
roncant	None
triarà	Singular
rescatessin	Plural
endevino	Singular
adjurà	Singular
ventilats	Plural
voltessin	Plural
batejada	Singular
confiar	None
rendirà	Singular
escullo	Singular
divulgant	None
finalitzats	Plural
afalagar	None
reverenciaren	Plural
punxà	Singular
guaitar	None
enxampats	Plural
guiat	Singular
alenar	None
rebel·laríem	Plural
encapçalant	None
inspirar	None
procedint	None
planxat	Singular
contaminar	None
humanitzar	None
massacrà	Singular
enyorat	Singular
explorant	None
dirigiran	Plural
ajudes	Singular
asseguràrem	Plural
guarida	Singular
sumen	Plural
tibis	Singular
alfabetitzada	Singular
enderrocaràs	Singular
seleccionar	None
alletant	None
optant	None
agitar	None
millorarem	Plural
teixir	None
retindrem	Plural
costes	Singular
designaren	Plural
menar	None
allunyà	Singular
brodades	Plural
tossint	None
bullint	None
corregides	Plural
emboliquessin	Plural
encadenats	Plural
triomfarà	Singular
demostrar	None
reaccionarien	Plural
duraren	Plural
indicaren	Plural
disseminat	Singular
atribuïen	Plural
guardada	Singular
destorbaràs	Singular
escaparien	Plural
regnant	None
perir	None
derroten	Plural
pixis	Singular
consideris	Singular
romandreu	Plural
depenien	Plural
vol	Singular
comptant	None
caçada	Singular
comportant	None
costàreu	Plural
exterminar	None
militaritzar	None
volàreu	Plural
reprengueren	Plural
prestades	Plural
rebaixada	Singular
emfatitzar	None
persuadiren	Plural
florirà	Singular
callaríeu	Plural
conduirà	Singular
optaven	Plural
interpretat	Singular
inscriurà	Singular
sotmetrà	Singular
daves	Singular
revoltàveu	Plural
lubricà	Singular
demolir	None
jutjaren	Plural
estiuejades	Plural
homenatjaren	Plural
empitjorada	Singular
sumarien	Plural
procedeixo	Singular
toldríeu	Plural
pesat	Singular
inserits	Plural
respectats	Plural
refugiaven	Plural
esmorzessin	Plural
narro	Singular
eguinàveu	Plural
curses	Singular
cobro	Singular
subhastat	Singular
barrejaran	Plural
pararan	Plural
ensorraren	Plural
embolicar	None
xiulareu	Plural
lluitant	None
classificades	Plural
rescatada	Singular
confonent	None
intersectar	None
establirà	Singular
occidentalitzaré	Singular
escriure	None
trobaràs	Singular
graduant	None
anomenen	Plural
comprarà	Singular
parida	Singular
excel·lir	None
plorada	Singular
prometre	None
pasteuritzaven	Plural
amplià	Singular
retessin	Plural
treballaré	Singular
menysvalorant	None
colonitzats	Plural
escamparen	Plural
experimentaven	Plural
rendides	Plural
afusellaren	Plural
volent	None
armant	None
alleugerà	Singular
estarien	Plural
menades	Plural
assecaren	Plural
abatent	None
atrevíssim	Plural
replicats	Plural
gratàreu	Plural
capitularan	Plural
marxat	Singular
dissoldrà	Singular
descansat	Singular
adaptant	None
produir	None
manumetent	None
succeiran	Plural
presentant	None
impulsà	Singular
plantarà	Singular
entreno	Singular
alimentarà	Singular
encapçalades	Plural
subornats	Plural
vincularà	Singular
cantant	None
llançats	Plural
esforçant	None
trinxant	None
batre	None
normalitzades	Plural
congelat	Singular
tancada	Singular
expliquessin	Plural
definiren	Plural
divorciaries	Singular
seure	None
fomentareu	Plural
hagudes	Plural
proporcionessin	Plural
enderrocàreu	Plural
impossibilitaren	Plural
augmentar	None
subestimà	Singular
servides	Plural
beatificar	None
comparèixer	None
acceleraren	Plural
aterrades	Plural
colpejaren	Plural
transformat	Singular
romanent	None
vetis	Singular
efectuà	Singular
hibernessin	Plural
oblidades	Plural
legalitzo	Singular
entretenint-se	None
conclogué	Singular
acrediten	Plural
graduat	Singular
esmenats	Plural
corresponíem	Plural
deprimírem	Plural
poguéssim	Plural
recollint	None
escopir	None
sancionat	Singular
vigoritzar	None
dramatitzat	Singular
especificar	None
robis	Singular
unir	None
fertilitzant	None
vèncer	None
insereixen	Plural
manats	Plural
recordaven	Plural
acampà	Singular
buscar	None
pogueren	Plural
colàrem	Plural
conduint	None
subestimessin	Plural
mostrarem	Plural
agregant	None
sobrevolessis	Singular
exposant	None
sintetitzant	None
mugint	None
fenent	None
brotaré	Singular
crucificant	None
infeccionar	None
decebuts	Plural
resistien	Plural
vaporitzar	None
aturaren	Plural
participant	None
discutírem	Plural
designant	None
consolidar	None
fomentats	Plural
fumàrem	Plural
prendre	None
coronis	Singular
concentren	Plural
conreant	None
desafiarà	Singular
convocar	None
descrius	Singular
subministrats	Plural
contradiguis	Singular
aliats	Plural
reflectint	None
proposis	Singular
beneficiaran	Plural
encórrer	None
imposaren	Plural
confiaries	Singular
escaramussaven	Plural
concentrant	None
reclames	Singular
terroritzat	Singular
aturaran	Plural
acompanyaven	Plural
estressar	None
convocada	Singular
esternudant	None
catalitzada	Singular
nominalitzar	None
admirat	Singular
fortifiquéssiu	Plural
crescut	Singular
cantes	Singular
trac	Singular
barallaren	Plural
cuidant	None
detectar	None
sortir	None
activada	Singular
haure	None
empapussant	None
comportaran	Plural
llençant	None
augmentaran	Plural
trigo	Singular
estirant	None
encantades	Plural
reprendran	Plural
executant	None
aprofità	Singular
perillar	None
molestaré	Singular
obrir	None
infiltrar	None
vinculant	None
amar	None
personificant	None
contribuïssin	Plural
obligarà	Singular
influint	None
correspost	Singular
oraré	Singular
aixecat	Singular
liderant	None
tapat	Singular
esgarriats	Plural
plantejat	Singular
beneeixen	Plural
hesitar	None
queien	Plural
entregarà	Singular
segregada	Singular
informada	Singular
renovada	Singular
adoraren	Plural
solidifiquen	Plural
visitarà	Singular
esterilitzaràs	Singular
localitzant	None
participarem	Plural
durà	Singular
alçà	Singular
sobreestimant	None
servissin	Plural
desodoritzat	Singular
creuada	Singular
sancionant	None
guerrejat	Singular
converséssiu	Plural
acabà	Singular
badallant	None
funden	Plural
permetis	Singular
generalitzant	None
enllaçà	Singular
reviscolant	None
finint	None
convidessin	Plural
refugiar	None
halessis	Singular
dissenyà	Singular
mancarem	Plural
catalanitzant	None
inventada	Singular
cercar	None
ancorats	Plural
encaixà	Singular
deposada	Singular
exasperàreu	Plural
ignores	Singular
rebentant	None
assetjat	Singular
mato	Singular
corregeixen	Plural
destorbar	None
t'entretenies	Singular
cauteritzar	None
diguéssim	Plural
desodorar	None
llançarà	Singular
garantint	None
atenuen	Plural
traslladen	Plural
engolíem	Plural
construir	None
empenyerà	Singular
discutida	Singular
calcificats	Plural
caçats	Plural
recomponguérem	Plural
pol·linitzada	Singular
edificats	Plural
punit	Singular
restringir	None
racionalitzada	Singular
robar	None
tiro	Singular
considerat	Singular
tricotant	None
començats	Plural
dorms	Singular
corroborar	None
liberalitzar	None
retent	None
comportat	Singular
menjàvem	Plural
escorregueres	Singular
surts	Singular
basaren	Plural
interpretis	Singular
tapessin	Plural
resistissin	Plural
consolidat	Singular
determinaran	Plural
afegissin	Plural
trobàveu	Plural
cooperaven	Plural
espanyolitzar	None
lexicalitzarà	Singular
gratis	Singular
remar	None
pecar	None
rascar	None
inscriuen	Plural
duplicant	None
arribada	Singular
importats	Plural
detenint	None
avançar	None
convertir	None
allarguessis	Singular
abolir	None
substituïren	Plural
elegint	None
vengueren	Plural
ajudant	None
arreglo	Singular
tatuada	Singular
sopar	None
judaïtzant	None
dinamitzant	None
xatejar	None
arreglaran	Plural
t'asseus	Singular
treballades	Plural
superant	None
assumits	Plural
alliberes	Singular
afavoriran	Plural
cercaven	Plural
designats	Plural
eludiré	Singular
llançant	None
arribar	None
disposada	Singular
diagnosticà	Singular
generant	None
digitalitzades	Plural
barbo	Singular
entregaríem	Plural
restringeixis	Singular
tapaven	Plural
ensopíem	Plural
capolant	None
resultessin	Plural
servits	Plural
subornant	None
enganxessin	Plural
contagiats	Plural
consagrant	None
enfonsaves	Singular
insultant	None
colpejà	Singular
encarregaven	Plural
jugaran	Plural
titllà	Singular
comuniquessin	Plural
governo	Singular
reemplaces	Singular
habilitant	None
veuen	Plural
enllestint	None
residit	Singular
abeurar	None
apel·lades	Plural
codificaren	Plural
fitxes	Singular
comentaren	Plural
inspirarien	Plural
aplaudeixo	Singular
manllevats	Plural
triomfar	None
teso	Singular
denunciïs	Singular
capolessin	Plural
repeteixo	Singular
habità	Singular
evocaràs	Singular
capolat	Singular
acompanyaran	Plural
baixant	None
digué	Singular
desenvolupar	None
emplenaven	Plural
cabessin	Plural
dissolt	Singular
evitaríem	Plural
casco	Singular
avorreixen	Plural
ensenyant	None
reconstruïen	Plural
esquitxada	Singular
absorbides	Plural
sentiràs	Singular
sortiran	Plural
purificar	None
homenatjant	None
suposat	Singular
patir	None
aixeco	Singular
impulsarien	Plural
finida	Singular
convencíeu	Plural
sabotejaven	Plural
estalviant	None
aplaudides	Plural
invitaven	Plural
avantatjar	None
trigar	None
assolares	Singular
acceleres	Singular
compensada	Singular
reaccionareu	Plural
terroritzar	None
il·lustrà	Singular
mataré	Singular
fotografiat	Singular
dejunats	Plural
desbloquejarà	Singular
centrat	Singular
odio	Singular
labialitzada	Singular
continuant	None
restringíeu	Plural
detectada	Singular
teixida	Singular
alterarà	Singular
fundades	Plural
aïllant	None
compensant	None
facilitaren	Plural
sobrevolar	None
dissols	Singular
metastatitzar	None
vetades	Plural
fornint	None
estandarditzada	Singular
suspengué	Singular
sacrificant	None
escandalitzaràs	Singular
lletregessis	Singular
mogué	Singular
nodríeu	Plural
començaren	Plural
compondran	Plural
llegeixen	Plural
denunciaren	Plural
conjugant	None
atacada	Singular
transmetessin	Plural
reviscolessin	Plural
localitzats	Plural
corroir	None
endeutats	Plural
preguntant	None
pareixent	None
esdevenen	Plural
disposarà	Singular
felicitant	None
finançarà	Singular
aplicar	None
militaritzant	None
concediran	Plural
reconstruïes	Singular
posseíeu	Plural
interpretar	None
estudiïs	Singular
espiessin	Plural
vetllant	None
matades	Plural
explico	Singular
envoltat	Singular
causat	Singular
comanden	Plural
simplifiquen	Plural
soterrant	None
suggerint	None
aporten	Plural
bufen	Plural
desbloquejada	Singular
esgarriant	None
enllaçarem	Plural
obtindreu	Plural
embolicaven	Plural
permetent	None
revoltaven	Plural
gravats	Plural
profunditzant	None
comentaves	Singular
fonguérem	Plural
fendre	None
accedireu	Plural
diversificant	None
obtens	Singular
podarien	Plural
viuen	Plural
descoratjant	None
multiplicarem	Plural
reaccionen	Plural
sentiré	Singular
exploraven	Plural
fusionarà	Singular
consistir	None
acariciant	None
ensenyàvem	Plural
encoratjada	Singular
ignorant	None
atacar	None
aturar	None
involucrar	None
sabessin	Plural
alimentar	None
fortificant	None
provat	Singular
vehiculant	None
podran	Plural
sondejaries	Singular
limitat	Singular
olorant	None
disputarà	Singular
suïcidat	Singular
contagiat	Singular
suprimint	None
cascada	Singular
defensada	Singular
maleïssin	Plural
derruiríeu	Plural
zigzaguegessin	Plural
aprenc	Singular
falsejada	Singular
confeccioní	Singular
occiren	Plural
reduint	None
extingint	None
derrotat	Singular
purificat	Singular
acórrer	None
escoltà	Singular
salvar	None
combinà	Singular
rentats	Plural
modernitzaries	Singular
noure	None
parodiaries	Singular
preocupar	None
ennuegant	None
eixirà	Singular
témer	None
renovar	None
corro	Singular
fumant	None
aprovaren	Plural
percebudes	Plural
ubicant	None
seduïdes	Plural
expulsaven	Plural
evolucionant	None
defineixen	Plural
manipularen	Plural
revelat	Singular
riméssiu	Plural
gelo	Singular
rebuda	Singular
rotat	Singular
reconquerida	Singular
socarràrem	Plural
simulats	Plural
inclinar	None
multipliquen	Plural
nominalitzaren	Plural
manant	None
emmascaressis	Singular
gaudirien	Plural
civilitzar	None
captures	Singular
envoltaren	Plural
inicialitzen	Plural
obliqües	Singular
aplico	Singular
bombardejarien	Plural
informarà	Singular
explotant	None
treballaran	Plural
militaritzades	Plural
moralitzen	Plural
acaronàreu	Plural
pegareu	Plural
retirar	None
controlant	None
acollits	Plural
autoritzar	None
acullen	Plural
retornà	Singular
aconsellà	Singular
neutralitzat	Singular
amat	Singular
descompondran	Plural
transgredeixen	Plural
relacionat	Singular
generat	Singular
assassinaven	Plural
provocareu	Plural
conjuntant	None
respectada	Singular
comparàrem	Plural
assabentà	Singular
deure	None
rotes	Singular
repartits	Plural
importen	Plural
comprant	None
dormen	Plural
confeccionàveu	Plural
xafardejant	None
tesàrem	Plural
superarem	Plural
esmentant	None
desenvolupo	Singular
centralitzades	Plural
espantessin	Plural
dirimeixen	Plural
bramen	Plural
comprada	Singular
guiar	None
intentades	Plural
boteres	Singular
reverberar	None
colonitzaran	Plural
podrem	Plural
habitar	None
enderrocat	Singular
sabotejat	Singular
agradar	None
filtrant	None
revenjarien	Plural
nuant	None
diferenciats	Plural
terminada	Singular
sondejar	None
contribuït	Singular
dibuixats	Plural
pleguen	Plural
estabilitzada	Singular
colonitzar	None
mort	Singular
coagulat	Singular
batejàreu	Plural
oscil·laven	Plural
ponies	Singular
moralitzéssim	Plural
jubilat	Singular
contraposo	Singular
curar	None
mesclen	Plural
asseuen	Plural
dogmatitzar	None
recordaràs	Singular
divinitzant	None
enfonsarà	Singular
cuidada	Singular
promouràs	Singular
congelo	Singular
gratada	Singular
obtenen	Plural
castrat	Singular
martiritzats	Plural
congelats	Plural
separaven	Plural
s'entretenen	Plural
assimilant	None
comenten	Plural
desbordar	None
ensenyar	None
explotarà	Singular
adonaràs	Singular
circumcidant	None
manllevar	None
divorciarà	Singular
assecà	Singular
posposar	None
xiulats	Plural
represos	Plural
respectaren	Plural
cauteritzant	None
oïda	Singular
consultades	Plural
planificat	Singular
bevent	None
dissociant	None
difamaran	Plural
improvisant	None
examinaran	Plural
dictessin	Plural
integrant	None
reeixida	Singular
mourien	Plural
descompondre	None
esmicolaríeu	Plural
confirmàvem	Plural
renunciant	None
decebent	None
italianitzar	None
odiada	Singular
enviaven	Plural
apreciar	None
importà	Singular
indignar	None
manifestis	Singular
previst	Singular
exhumats	Plural
competida	Singular
xiulades	Plural
dictaven	Plural
xoquen	Plural
delint	None
enxampada	Singular
optarien	Plural
apareixem	Plural
desitjà	Singular
grapejant	None
jutjant	None
lamenten	Plural
cregut	Singular
anunciades	Plural
confons	Singular
arrissis	Singular
arriscà	Singular
ennuvolades	Plural
conjuguen	Plural
advertides	Plural
desautoritzà	Singular
canvià	Singular
escaramussaries	Singular
malparlant	None
absorbits	Plural
amansir	None
martiritzant	None
aidant	None
ventilaran	Plural
acollida	Singular
assabentares	Singular
exercits	Plural
senyaléssim	Plural
rient	None
arrapàvem	Plural
completessin	Plural
canviada	Singular
tardis	Singular
beneficiaven	Plural
obeïen	Plural
havent	None
il·lustren	Plural
culminéssim	Plural
aprofitant	None
recordà	Singular
sintetitzats	Plural
envaint	None
trenquis	Singular
aprendreu	Plural
importades	Plural
instauraré	Singular
visità	Singular
punir	None
contractar	None
impedint	None
dormit	Singular
distingiran	Plural
agrupaven	Plural
habilitada	Singular
cobrada	Singular
tractaren	Plural
marxarien	Plural
debutar	None
refusar	None
carregat	Singular
agità	Singular
anglicitzada	Singular
intentis	Singular
reconquerit	Singular
adoptaven	Plural
estripant	None
modificaren	Plural
improvisareu	Plural
tallant	None
descosint	None
improvisà	Singular
americanitzar	None
combatent	None
beatifiquessis	Singular
vomitant	None
pregat	Singular
cuinaven	Plural
arrissats	Plural
pal·liat	Singular
reforçat	Singular
exilien	Plural
remeiar	None
entengueu	Plural
traumatitzaríeu	Plural
proporcionar	None
justificarà	Singular
inspeccionàrem	Plural
modelaren	Plural
situaran	Plural
sofríssim	Plural
prosperessin	Plural
difamaves	Singular
guanyes	Singular
separares	Singular
reiterà	Singular
orientalitzaren	Plural
obtinguessin	Plural
aprecio	Singular
inclouré	Singular
cerquessin	Plural
alcis	Singular
allotjar	None
retornades	Plural
categoritzen	Plural
signen	Plural
moldre	None
envejant	None
danyant	None
saps	Singular
embarrancats	Plural
taquen	Plural
gemegar	None
heretaran	Plural
massacrant	None
designada	Singular
entendrien	Plural
acariciar	None
prenen	Plural
registres	Singular
apel·laran	Plural
xiuxiuejà	Singular
registrarà	Singular
traspassades	Plural
vorejaven	Plural
esmenat	Singular
tardar	None
motivarà	Singular
fundaven	Plural
dispersades	Plural
reclamà	Singular
mesclar	None
suposaren	Plural
falto	Singular
calmen	Plural
expresses	Singular
immunitzant	None
complirà	Singular
subratllà	Singular
dissolent	None
editaries	Singular
perdonareu	Plural
proclamar	None
recordarien	Plural
emetent	None
precisarien	Plural
nevant	None
lideren	Plural
cooperant	None
pegarem	Plural
reformarà	Singular
reverenciar	None
acusaren	Plural
fredejant	None
localitzades	Plural
mullen	Plural
hagueu	Plural
signaran	Plural
donant	None
renunciades	Plural
après	Singular
cuinant	None
aconsegueixes	Singular
cedits	Plural
desplaçant	None
preservada	Singular
vigilaré	Singular
portarien	Plural
esqueixar	None
arrissat	Singular
reclamar	None
besaran	Plural
modificarien	Plural
odiàreu	Plural
modelaven	Plural
continuen	Plural
traspassar	None
alliberen	Plural
causis	Singular
introduint	None
construirà	Singular
ensenyades	Plural
etiquetes	Singular
organitzarem	Plural
iniciant	None
centrareu	Plural
defenestressis	Singular
faltant	None
simularé	Singular
pronunciar	None
forades	Singular
redactat	Singular
coles	Singular
forces	Singular
toldre	None
mutades	Plural
bombardejaren	Plural
llogant	None
calmessin	Plural
mostren	Plural
obliquats	Plural
empitjorats	Plural
immobilitzar	None
vacil·lar	None
encarregaràs	Singular
assumíeu	Plural
enganxant	None
esdevindrien	Plural
experimentaríeu	Plural
partirà	Singular
troben	Plural
reconciliaràs	Singular
reaparèixer	None
domtar	None
rosegats	Plural
subratllades	Plural
sumà	Singular
renillaràs	Singular
divulgaren	Plural
mancarien	Plural
pactats	Plural
reescalfes	Singular
dubto	Singular
tardes	Singular
salant	None
emmagatzemà	Singular
naufraguessis	Singular
dominessin	Plural
preserven	Plural
rebaixéssim	Plural
nuàreu	Plural
cedint	None
emmascarades	Plural
comparat	Singular
diferencien	Plural
desistissis	Singular
gesticularíem	Plural
tesis	Singular
suant	None
derivà	Singular
saquejà	Singular
cicatritzaríeu	Plural
enterbolint	None
tractis	Singular
gelí	Singular
exercies	Singular
jeuen	Plural
fotis	Singular
lexicalitzant	None
petonejant	None
volto	Singular
assumida	Singular
parodiar	None
mostraran	Plural
descansant	None
riuran	Plural
defendríem	Plural
imposarien	Plural
omplissin	Plural
investigada	Singular
sostenien	Plural
captivéssiu	Plural
brindant	None
aplicant	None
abrandant	None
requerit	Singular
consistirien	Plural
caracteritzant	None
marcarien	Plural
assolissin	Plural
apreciaven	Plural
abrigant	None
despatxat	Singular
cosint	None
estereotipades	Plural
estimada	Singular
transformant	None
vetant	None
culminà	Singular
entreteníeu	Plural
empraren	Plural
articulada	Singular
tronant	None
rebentar	None
portà	Singular
polaritzada	Singular
eructar	None
oscil·laré	Singular
fondre	None
salis	Singular
protegirien	Plural
desfan	Plural
pescar	None
tapar	None
estiraven	Plural
travessà	Singular
arrestat	Singular
variada	Singular
frenessin	Plural
desmoralitzat	Singular
controlar	None
massejant	None
senyalaven	Plural
sabràs	Singular
diguis	Singular
rellegit	Singular
classifiquessin	Plural
tingueren	Plural
cristal·litzant	None
distenent	None
protagonitzant	None
esqueixí	Singular
cerneres	Singular
pactà	Singular
elaborarà	Singular
hipnotitzant	None
recomptar	None
oposant	None
estereotipat	Singular
disputant	None
tremolant	None
occidentalitzant	None
exterminat	Singular
peles	Singular
rebí	Singular
consultà	Singular
intensificar	None
elevarien	Plural
transportessin	Plural
fomentant	None
perdonant	None
atrevits	Plural
menes	Singular
detectats	Plural
resideixen	Plural
oren	Plural
atrauen	Plural
espaventar	None
tossir	None
suportats	Plural
aixecà	Singular
provaran	Plural
extingirà	Singular
comandar	None
investigarien	Plural
ignoren	Plural
expandirem	Plural
funcionar	None
besat	Singular
eixiran	Plural
contribueixo	Singular
reemplaçant	None
adoro	Singular
drago	Singular
intervindrà	Singular
conduirien	Plural
jaqueixis	Singular
acreditades	Plural
obtenir	None
soterraren	Plural
enfrontar	None
endut	Singular
lladrant	None
estossegar	None
enganxada	Singular
fugiríeu	Plural
representí	Singular
arrestant	None
deurà	Singular
grates	Singular
blindada	Singular
orar	None
mortificant	None
popularitzant	None
citant	None
inhibien	Plural
deprimit	Singular
aturant	None
rebutjar	None
dormien	Plural
superaran	Plural
pujades	Plural
arrapada	Singular
optaries	Singular
vigilar	None
calen	Plural
divulgaven	Plural
lateralitzar	None
arreglats	Plural
rebutjàveu	Plural
vocalitzaven	Plural
curarà	Singular
exhalen	Plural
entrenar	None
amenaçades	Plural
mortifiques	Singular
bordares	Singular
discriminàrem	Plural
afavoríssim	Plural
estenent	None
correré	Singular
seuré	Singular
falsificats	Plural
prenien	Plural
cancel·laríem	Plural
deïficant	None
originaves	Singular
anunciarien	Plural
independitzar	None
sobrevisquessin	Plural
refregats	Plural
carregues	Singular
tolc	Singular
arraulir	None
dividir	None
conqueriren	Plural
adobada	Singular
rellegir	None
apercebessis	Singular
substituït	Singular
sepultàvem	Plural
narraríem	Plural
xiularà	Singular
convèncer	None
refreguéssim	Plural
seguides	Plural
preveien	Plural
aprovant	None
inspeccionant	None
evolucionar	None
perdent	None
verificar	None
poblat	Singular
cuinar	None
immigrades	Plural
emanciparies	Singular
exerciran	Plural
mancada	Singular
diversificat	Singular
islamitzada	Singular
afirmar	None
escanejant	None
mous	Singular
decidiren	Plural
adreçat	Singular
descobreixen	Plural
caminarem	Plural
automatitzada	Singular
sodomitzar	None
raonar	None
distingides	Plural
inhibir	None
llicenciar	None
vetllada	Singular
sacsejà	Singular
castrant	None
enfrontant	None
arrosseguen	Plural
aproximant	None
mantens	Singular
prohibeixis	Singular
pintà	Singular
recolzéssim	Plural
denominats	Plural
colar	None
rebaixades	Plural
experimentar	None
cometent	None
reconstrueixen	Plural
encunyaran	Plural
trinxada	Singular
examinats	Plural
privà	Singular
dedico	Singular
intervenir	None
arrencant	None
expel·lit	Singular
afirmaren	Plural
paralitzar	None
tancant	None
atenuàrem	Plural
taques	Singular
prohibint	None
subministressin	Plural
regalant	None
reflectissin	Plural
observar	None
empapussar	None
alternàrem	Plural
hospitalitzà	Singular
captivant	None
estereotipant	None
redactaren	Plural
dinamitzar	None
informar	None
evolucionaven	Plural
contradir	None
ficarà	Singular
ratificar	None
islamitzar	None
fracasso	Singular
prefereixo	Singular
calgui	Singular
juguí	Singular
il·legalitzant	None
poguessin	Plural
estenguessin	Plural
insistir	None
rebel·len	Plural
arriscar	None
ajornada	Singular
fumades	Plural
desplaçat	Singular
mullis	Singular
aguar	None
vendré	Singular
tocaven	Plural
decretaren	Plural
recordis	Singular
enfondrien	Plural
registrades	Plural
robant	None
matessis	Singular
alimentaren	Plural
suprimides	Plural
empresonaríem	Plural
entengueren	Plural
retallat	Singular
interrompent	None
atrevida	Singular
culminar	None
analitzarem	Plural
dissenyarà	Singular
amputats	Plural
treballaven	Plural
salà	Singular
sumo	Singular
registrat	Singular
afirmat	Singular
fomentades	Plural
envaïssin	Plural
agraíeu	Plural
duplicades	Plural
comprenem	Plural
inserint	None
aterrada	Singular
investiguessin	Plural
rotant	None
suïcidats	Plural
ratificant	None
interromprà	Singular
arribarien	Plural
perpetrades	Plural
alienant	None
romperes	Singular
beatificant	None
narrada	Singular
sancionen	Plural
encalçat	Singular
dominarà	Singular
renovarà	Singular
massegéssiu	Plural
provar	None
confirmàrem	Plural
resant	None
desbloquejades	Plural
cuirassades	Plural
qüestiono	Singular
continuà	Singular
aprestats	Plural
descendint	None
temérem	Plural
divorciades	Plural
travessada	Singular
digitalitzar	None
afusellant	None
situà	Singular
aprendran	Plural
efectuats	Plural
replicada	Singular
jubilar	None
alleugeraves	Singular
descobrien	Plural
anhelen	Plural
presidida	Singular
decidiran	Plural
tenien	Plural
apel·lar	None
exerceixen	Plural
metastatitzant	None
assolà	Singular
tremolo	Singular
xiuxiuejant	None
practicarà	Singular
ejacularien	Plural
cauen	Plural
enutjareu	Plural
aïllats	Plural
americanitzant	None
interpretant	None
somiaran	Plural
vorejats	Plural
converteixen	Plural
llicencies	Singular
xipollejar	None
inaugurades	Plural
cuidades	Plural
empatis	Singular
acompanyéssiu	Plural
conjunto	Singular
determinant	None
vexats	Plural
desafio	Singular
comprovaven	Plural
assemblant	None
forçaren	Plural
reelegit	Singular
relatades	Plural
representades	Plural
concediríem	Plural
emmascarar	None
liderarà	Singular
pobles	Singular
compilant	None
anglicitzant	None
agrades	Singular
escapades	Plural
inserir	None
incrementarien	Plural
depengueren	Plural
mesurares	Singular
intueixen	Plural
exercint	None
conclòs	Singular
orinar	None
deduir	None
aproximats	Plural
localitzaven	Plural
atorgats	Plural
denunciessin	Plural
guiarien	Plural
familiaritzant	None
col·leccionessis	Singular
col·leccionant	None
monopolitzéssim	Plural
tindries	Singular
vencerà	Singular
blindades	Plural
castrada	Singular
acidificàveu	Plural
afavorien	Plural
traslladant	None
aglomeren	Plural
perfeccionant	None
veuràs	Singular
regnarà	Singular
acompanyes	Singular
dramatitzar	None
perdessin	Plural
mobilitzí	Singular
enganxes	Singular
bastides	Plural
agregar	None
professionalitzats	Plural
ubicaran	Plural
fornejaves	Singular
contribuir	None
propagaren	Plural
perfumades	Plural
garanteixes	Singular
garanties	Singular
escampat	Singular
interessàrem	Plural
refugiats	Plural
estacar	None
ensordeixen	Plural
fugir	None
materialitzaríeu	Plural
existint	None
escric	Singular
sentir	None
empresonar	None
transformarà	Singular
articulen	Plural
rebutjarà	Singular
rebé	Singular
fotogravant	None
pegant	None
baixà	Singular
preveuríem	Plural
confirmada	Singular
bulliries	Singular
excediren	Plural
compensen	Plural
exagerares	Singular
emmascarats	Plural
indignats	Plural
canviaríeu	Plural
professionalitzaríeu	Plural
desbordo	Singular
destinaran	Plural
acudir	None
titubejant	None
adoptats	Plural
redimint	None
escandalitzar	None
difamant	None
consideraran	Plural
intentat	Singular
refugiant	None
robaren	Plural
destinada	Singular
exorcitzant	None
transferien	Plural
avorrint	None
torçaran	Plural
vencereu	Plural
governats	Plural
assemblar	None
enduent-se	None
viurà	Singular
tustàrem	Plural
alimentant	None
cagant	None
potabilitzades	Plural
disparat	Singular
caminat	Singular
contradit	Singular
està	Singular
frenada	Singular
difonent	None
hospitalitzades	Plural
busquessin	Plural
impossibilitaríem	Plural
segregar	None
parodien	Plural
atemptat	Singular
existir	None
divertint	None
vetlles	Singular
personificar	None
definíssiu	Plural
incrementats	Plural
cantessin	Plural
poblar	None
infongué	Singular
degradada	Singular
terminats	Plural
pagada	Singular
injectàvem	Plural
agrupats	Plural
diagnosticaren	Plural
vulcanitzant	None
colonitzessin	Plural
destruirien	Plural
designades	Plural
exagerar	None
envaïdes	Plural
esclafat	Singular
parties	Singular
cursarà	Singular
embolicades	Plural
signada	Singular
registrar	None
justificat	Singular
desobeint	None
fitxàvem	Plural
nomenessin	Plural
menant	None
vulcanitzat	Singular
lligat	Singular
tatuat	Singular
organitzarien	Plural
portarà	Singular
passejar	None
contradeien	Plural
descomponent	None
barbes	Singular
condicionat	Singular
racionalitzant	None
garantir	None
destacats	Plural
delit	Singular
intersectant	None
constituirien	Plural
esquitxen	Plural
ensenyaré	Singular
rabejar	None
ataques	Singular
anticipen	Plural
perfumant	None
organitzades	Plural
bullis	Singular
estiuegen	Plural
llençà	Singular
fluctuaven	Plural
veieren	Plural
mercantilitzessin	Plural
divinitzats	Plural
foníeu	Plural
desapareixerà	Singular
descompons	Singular
alarmades	Plural
fumar	None
digeriré	Singular
afegirien	Plural
coronàveu	Plural
organitzen	Plural
cicatritzar	None
estalviar	None
prevenir	None
guarníreu	Plural
partien	Plural
relacionats	Plural
perpetrada	Singular
renillo	Singular
interpretaríem	Plural
conquistes	Singular
exhumades	Plural
intimidar	None
designar	None
penen	Plural
mesuraren	Plural
eructà	Singular
dependre	None
designà	Singular
enyoràveu	Plural
atenuat	Singular
travesso	Singular
reberen	Plural
traumatitzats	Plural
mobilitzen	Plural
deixar	None
engoleixen	Plural
demanant	None
empènyer	None
diferencies	Singular
partida	Singular
naufragats	Plural
paralitzats	Plural
vénen	Plural
abatuda	Singular
insultar	None
ionitzat	Singular
perpetuaven	Plural
esbrinant	None
renunciat	Singular
dirigeixen	Plural
continuarà	Singular
compareguis	Singular
enviant	None
imposats	Plural
debutà	Singular
partiran	Plural
enfonsaven	Plural
registraren	Plural
menjant	None
justifiquen	Plural
zigzaguejant	None
occint	None
legalitzant	None
seduiran	Plural
conreà	Singular
relaxaves	Singular
seduïda	Singular
harmonitzant	None
crearan	Plural
ometent	None
durades	Plural
confirmarien	Plural
individualitzaren	Plural
aprendrà	Singular
resultaven	Plural
influïda	Singular
voldrà	Singular
exposarien	Plural
cultivades	Plural
abaten	Plural
agitàreu	Plural
influïts	Plural
ores	Singular
entusiasmats	Plural
alçats	Plural
reiniciada	Singular
especificat	Singular
associat	Singular
discriminades	Plural
lliurar	None
coexistint	None
repetint	None
encenen	Plural
cancel·lar	None
basant	None
forçaran	Plural
buscàveu	Plural
bramant	None
lubricat	Singular
destacaren	Plural
presentaries	Singular
considero	Singular
trencarà	Singular
remat	Singular
aplicaven	Plural
imantar	None
escornant	None
ordenaven	Plural
besant	None
voldrien	Plural
jauen	Plural
obligades	Plural
originaven	Plural
xatejant	None
separats	Plural
endeutar	None
ajornant	None
lliguessin	Plural
amagàreu	Plural
fotografiarà	Singular
fitxares	Singular
apoderen	Plural
concentraven	Plural
refugiessin	Plural
zigzaguejar	None
destruirà	Singular
tatuar	None
convencerà	Singular
concórrer	None
rebel·lar	None
intersectàreu	Plural
heretades	Plural
debilitar	None
creuarien	Plural
beneint	None
encapçalarien	Plural
despertar	None
reiterar	None
excretant	None
diversificada	Singular
immolant	None
encendran	Plural
incorporaren	Plural
enllaçaven	Plural
rebutjarien	Plural
abaixades	Plural
entressin	Plural
calcificàvem	Plural
relacionareu	Plural
forniré	Singular
imaginar	None
sentida	Singular
domar	None
erigint	None
acusaran	Plural
concorrent	None
petonejar	None
brodaven	Plural
deixessin	Plural
nodrides	Plural
estimulada	Singular
embriagar	None
expandides	Plural
subjuguessis	Singular
adornà	Singular
torrades	Plural
visitarien	Plural
gelarien	Plural
recuperats	Plural
adjurant	None
notar	None
estovant	None
abreujats	Plural
citar	None
delir	None
beneir	None
lliures	Singular
desodoritzant	None
manumetre	None
disposarem	Plural
advertir	None
regno	Singular
robes	Singular
jubilant	None
cabrien	Plural
alienes	Singular
halant	None
rento	Singular
protestat	Singular
jurar	None
onejant	None
ampliar	None
mancades	Plural
acabessin	Plural
modificaran	Plural
atacant	None
absorbissin	Plural
teoritzat	Singular
ulular	None
influïssin	Plural
batallant	None
podent	None
enfadà	Singular
bordats	Plural
motivada	Singular
atraient	None
depenen	Plural
revoltades	Plural
mancat	Singular
analitzant	None
aprenien	Plural
doldre	None
violo	Singular
congelaven	Plural
comentar	None
conquerides	Plural
parlant	None
estalviat	Singular
esgarriar	None
estrenades	Plural
alenada	Singular
discutíem	Plural
esclafant	None
urbanitzant	None
atorgaven	Plural
afartaràs	Singular
carbonitzar	None
modificats	Plural
defendre	None
beneficiar	None
ensenyo	Singular
bufant	None
abrigar	None
vetar	None
silenciar	None
subornar	None
entretenint	None
obtinc	Singular
prosperà	Singular
perillat	Singular
fotografiant	None
multiplicarien	Plural
aconseguiràs	Singular
desmagnetitzar	None
escriurien	Plural
originant	None
comparar	None
preservat	Singular
preguntar	None
consolidaran	Plural
enviaríeu	Plural
culminat	Singular
rodo	Singular
exhibiran	Plural
abandonarà	Singular
condicionades	Plural
edificada	Singular
proporcionarien	Plural
enfocaré	Singular
intimidessis	Singular
gaudir	None
fragmentar	None
obtindré	Singular
atenguessin	Plural
catalanitzada	Singular
durar	None
amagada	Singular
enterro	Singular
caus	Singular
comentant	None
nadis	Singular
detenir	None
escapà	Singular
esglaiada	Singular
podrien	Plural
subjugaren	Plural
penalitzà	Singular
perseveris	Singular
individualitzen	Plural
comandant	None
contemplaran	Plural
enxampant	None
dotorejant	None
firmaves	Singular
enregistrà	Singular
refutats	Plural
entregar	None
ordenes	Singular
reflexiones	Singular
interrompé	Singular
inscrivien	Plural
reconquerir	None
dessalinitzéssim	Plural
parodiant	None
relacionar	None
plorar	None
guardonàreu	Plural
alarmat	Singular
doblarà	Singular
evocades	Plural
creuaran	Plural
espaventí	Singular
representaren	Plural
calculaven	Plural
sorgida	Singular
segrestàreu	Plural
buidats	Plural
adornéssim	Plural
col·laborant	None
necessitaren	Plural
interessà	Singular
cessar	None
saltats	Plural
derruïts	Plural
trigarem	Plural
dissocies	Singular
actuà	Singular
resaràs	Singular
qüestionant	None
conquerint	None
signà	Singular
poblàreu	Plural
dominaren	Plural
conservaren	Plural
plorant	None
caminà	Singular
abatudes	Plural
petonejarem	Plural
forçar	None
debilitéssim	Plural
rondinant	None
encoratjar	None
decapitaries	Singular
abaté	Singular
arrestats	Plural
executaven	Plural
mesclareu	Plural
occidentalitzades	Plural
malvendre	None
polaritzessin	Plural
prioritzat	Singular
allisaren	Plural
comprovaren	Plural
arriscada	Singular
enfonsant	None
teoritzà	Singular
riurem	Plural
fregir	None
privatitzats	Plural
promous	Singular
heure	None
eclipsis	Singular
apoderarà	Singular
protegint	None
jutjat	Singular
frenats	Plural
accedeixo	Singular
vigilaren	Plural
avantatjaven	Plural
dubtaven	Plural
escapes	Singular
aplaudida	Singular
definien	Plural
costant	None
sobrevolaries	Singular
registressis	Singular
calia	Singular
forjaríem	Plural
cuinàveu	Plural
partirem	Plural
vetllar	None
descriure	None
debutat	Singular
encantant	None
provades	Plural
regnat	Singular
veien	Plural
carregant	None
pensessin	Plural
plegats	Plural
sorgits	Plural
rimes	Singular
reprenen	Plural
trigat	Singular
immigrant	None
oblidarem	Plural
estaran	Plural
recollien	Plural
restaurarà	Singular
obeirien	Plural
encaixares	Singular
habitarà	Singular
reemplacen	Plural
insultéssim	Plural
fusionar	None
vociferis	Singular
reben	Plural
protegissin	Plural
supliren	Plural
estrenarà	Singular
acidificàreu	Plural
dilaten	Plural
ornamentar	None
governades	Plural
privatitzàrem	Plural
rascaven	Plural
gaudeixis	Singular
dato	Singular
circumnavegaríem	Plural
imprimint	None
interrompien	Plural
respiren	Plural
enllaces	Singular
enregistrada	Singular
molestant	None
escornàrem	Plural
jurades	Plural
dinamitzades	Plural
encaixaves	Singular
tardaren	Plural
presidir	None
contractàvem	Plural
rebaixar	None
barrejant	None
teixíssim	Plural
perpetuat	Singular
fraternitzí	Singular
creuades	Plural
renunciïs	Singular
assolar	None
injecten	Plural
tenen	Plural
sopant	None
elaborats	Plural
tallades	Plural
convocà	Singular
digereixen	Plural
degué	Singular
enduu-te	Singular
emasculant	None
truquen	Plural
demanis	Singular
brindà	Singular
comproví	Singular
doblades	Plural
revelada	Singular
apareixerien	Plural
coronessin	Plural
purificarem	Plural
fiquessin	Plural
caçares	Singular
provocar	None
variades	Plural
usar	None
desat	Singular
emigrada	Singular
seleccionen	Plural
evolucionarà	Singular
perillo	Singular
ubico	Singular
envellides	Plural
divorciarien	Plural
amenaçats	Plural
consolidats	Plural
gratant	None
rotis	Singular
dirigint	None
untats	Plural
vocalitzaren	Plural
desafiats	Plural
ajudà	Singular
revenien	Plural
consagrar	None
triar	None
nominalitzessis	Singular
entrevistessin	Plural
instal·lar	None
mengen	Plural
robí	Singular
abeurant	None
arrossegaren	Plural
rebran	Plural
nodrirà	Singular
observo	Singular
ajornen	Plural
tardarem	Plural
pretenem	Plural
ampliades	Plural
reemplaçada	Singular
atomitzat	Singular
pudo	Singular
alienaren	Plural
consolidaren	Plural
pacto	Singular
simulades	Plural
rebutjaries	Singular
volguts	Plural
impedissin	Plural
conjugaven	Plural
domo	Singular
animalitzessin	Plural
esbrinat	Singular
regnaren	Plural
aïno	Singular
emboliquen	Plural
dessalarem	Plural
vexí	Singular
estandarditzats	Plural
accelerant	None
sotmetí	Singular
amputaríem	Plural
determinar	None
aprovada	Singular
subratllen	Plural
especialitzessin	Plural
estrenà	Singular
assolirien	Plural
reorganitzessin	Plural
reeixint	None
excel·liren	Plural
distendre	None
interrompudes	Plural
absorbit	Singular
gemegaves	Singular
bevien	Plural
apreciada	Singular
confonen	Plural
planejada	Singular
suposar	None
mereixo	Singular
plegaries	Singular
estalviessis	Singular
alliberats	Plural
segueixen	Plural
tesada	Singular
cooperarà	Singular
acostessin	Plural
saltar	None
disseminant	None
limitaré	Singular
activen	Plural
balanço	Singular
traspassant	None
aïllaren	Plural
empaquetada	Singular
milloraré	Singular
anomenessin	Plural
suquegéssiu	Plural
reorganitzades	Plural
reverireu	Plural
efectuessin	Plural
paralitzàrem	Plural
enganxàrem	Plural
transliterades	Plural
entenguis	Singular
modelant	None
perpetraren	Plural
embarranquen	Plural
catapultant	None
modifiques	Singular
emprant	None
pegares	Singular
eludint	None
degradaven	Plural
aguaiten	Plural
escurant	None
desfet	Singular
queixar	None
assaborida	Singular
consistint	None
millorarien	Plural
irritada	Singular
enutjats	Plural
jugar	None
escalfí	Singular
volgué	Singular
reprenent	None
silenciéssim	Plural
agitant	None
afalaguéssim	Plural
estabilitzar	None
contravenir	None
ancoraven	Plural
badallar	None
regressà	Singular
funcionaren	Plural
afirmà	Singular
agonitzaries	Singular
suspengueren	Plural
duplicats	Plural
activaven	Plural
penalitzares	Singular
empatat	Singular
invitades	Plural
falsejar	None
financessin	Plural
preservar	None
buscat	Singular
contagiar	None
votats	Plural
ignorà	Singular
integren	Plural
il·luminí	Singular
afectà	Singular
cobraves	Singular
individualitzéssiu	Plural
traduirem	Plural
datant	None
enfondre	None
sancionada	Singular
faltaren	Plural
queixaren	Plural
codificarà	Singular
adobes	Singular
eclipsar	None
bastíssim	Plural
escollirien	Plural
alegrarà	Singular
ingressades	Plural
has	Singular
treballar	None
construíem	Plural
tement	None
reclamo	Singular
tindríem	Plural
reten	Plural
comunicades	Plural
exposar	None
alliberarà	Singular
encunyada	Singular
creurem	Plural
sorgir	None
acostumar	None
conduïdes	Plural
revingueu	Plural
transportar	None
rodaran	Plural
estalviaríem	Plural
exasperar	None
acordessis	Singular
obeïts	Plural
bordes	Singular
trobaran	Plural
diferenciarà	Singular
guanyar	None
seguir	None
comunicar	None
relatar	None
atenien	Plural
mastegant	None
desautoritzades	Plural
liberalitzant	None
educar	None
nominant	None
ionitzar	None
pagarien	Plural
prospero	Singular
rodes	Singular
adoren	Plural
portaven	Plural
materialitzats	Plural
coordinen	Plural
visc	Singular
entens	Singular
faltà	Singular
encoratjat	Singular
adones	Singular
orientalitzar	None
alfabetitzant	None
trivialitzar	None
esquitxar	None
preservant	None
assoliran	Plural
acolliren	Plural
deïficàvem	Plural
consultaré	Singular
truco	Singular
faciliten	Plural
explicar	None
lideraren	Plural
gravessin	Plural
investigàveu	Plural
emplenant	None
adopto	Singular
netejant	None
patiren	Plural
escalant	None
anhelar	None
augmentarà	Singular
exterminaren	Plural
enganxo	Singular
morirà	Singular
procedit	Singular
hospitalitzar	None
amenaçada	Singular
modernitzats	Plural
entretenir-se	None
immortalitzaríeu	Plural
sintetitzen	Plural
blindis	Singular
deturar	None
animats	Plural
reconstruït	Singular
cedit	Singular
provenien	Plural
aparegueren	Plural
sexes	Singular
comprovant	None
netejada	Singular
empalar	None
amputar	None
anhelaríem	Plural
senties	Singular
regressant	None
conquerir	None
vacil·lant	None
informessin	Plural
refredar	None
envoltant	None
mesuraran	Plural
compondrien	Plural
trobis	Singular
cediràs	Singular
capficàveu	Plural
tirar	None
repartirà	Singular
pagaren	Plural
etiquetant	None
sostingudes	Plural
reverenciada	Singular
ingressaran	Plural
assassinaren	Plural
desenvolupes	Singular
fotografiar	None
tradueixo	Singular
costar	None
naturalitzada	Singular
restaurat	Singular
pintades	Plural
discriminen	Plural
acusar	None
paraven	Plural
pessigar	None
inhibides	Plural
assolarien	Plural
atomitzant	None
tallis	Singular
merescut	Singular
saltes	Singular
impedeixen	Plural
situades	Plural
servir	None
naufraguis	Singular
votis	Singular
obtingueren	Plural
injectar	None
entenen	Plural
assetjar	None
pudir	None
evolucionarien	Plural
menysvalorar	None
soterraríem	Plural
retallar	None
discutiren	Plural
contemplant	None
acollint	None
submergeixen	Plural
pararen	Plural
amansits	Plural
polaritzades	Plural
assetjant	None
trobessin	Plural
observat	Singular
remolc	Singular
legalitzar	None
sagnaren	Plural
examinarà	Singular
eliminar	None
activades	Plural
verbalitzant	None
adquirint	None
oposarà	Singular
emmascarant	None
desplacen	Plural
sacsejaves	Singular
basis	Singular
recorden	Plural
constituir	None
simplificar	None
identificades	Plural
ejacular	None
creuessin	Plural
reaccionant	None
eclipsat	Singular
resultarà	Singular
sobrevolarà	Singular
opto	Singular
adreçant	None
resultar	None
desmagnetitzant	None
preferir	None
llençàrem	Plural
insisteixen	Plural
seguiràs	Singular
estalvien	Plural
independitzàveu	Plural
subestimada	Singular
esmentat	Singular
distribuir	None
rotarem	Plural
suportes	Singular
ferir	None
consultarà	Singular
fertilitzat	Singular
assaborint	None
derruir	None
entusiasmada	Singular
davallar	None
extreuen	Plural
orbites	Singular
elegissin	Plural
estacant	None
permetre	None
decidir	None
atenuares	Singular
relaxat	Singular
destinà	Singular
emmagatzemades	Plural
insistiren	Plural
llatinitzades	Plural
allisant	None
afartant	None
remaràs	Singular
signessin	Plural
frenàreu	Plural
homenatjats	Plural
apologitzar	None
tapà	Singular
amen	Plural
rentes	Singular
regalo	Singular
mantingueu	Plural
esclatant	None
derivaríeu	Plural
obtenien	Plural
menyspreaven	Plural
guien	Plural
coincidissis	Singular
embrutar	None
modelà	Singular
atreviren	Plural
compten	Plural
obririen	Plural
concedides	Plural
estimis	Singular
broten	Plural
calculo	Singular
aguaitaven	Plural
lluitarà	Singular
recollides	Plural
destituir	None
segat	Singular
precisà	Singular
militaritzada	Singular
limitessin	Plural
sospiten	Plural
satisfent	None
segresten	Plural
reflectides	Plural
cometeren	Plural
fotogravat	Singular
esclatà	Singular
neutralitzà	Singular
tems	Singular
admetre	None
inhalant	None
esterilitzant	None
cultivant	None
deposant	None
garantides	Plural
brotar	None
solucionis	Singular
pal·liar	None
foten	Plural
alternaren	Plural
mobilitzarem	Plural
impetrar	None
solidificant	None
dispersà	Singular
escapant	None
daurats	Plural
lideraven	Plural
dedueixes	Singular
avantatjant	None
profunditzar	None
creà	Singular
inspeccionar	None
plantejant	None
editaran	Plural
gires	Singular
suposaran	Plural
avances	Singular
generes	Singular
restant	None
suspendre	None
reverir	None
assimilis	Singular
labiovelaritzant	None
modifiquis	Singular
conreada	Singular
mereixerien	Plural
desvetllat	Singular
destrossada	Singular
consideraven	Plural
baixarà	Singular
diagnosticant	None
desconeixien	Plural
rebel·là	Singular
passejant	None
portat	Singular
laborat	Singular
enutjant	None
anomenes	Singular
civilitzen	Plural
trinxar	None
exercida	Singular
violant	None
tolerant	None
explores	Singular
incrementessin	Plural
privatitzéssim	Plural
organitzat	Singular
eludiren	Plural
involucrades	Plural
reverenciat	Singular
estiguis	Singular
juris	Singular
representarà	Singular
demanades	Plural
tradueixis	Singular
materialitzà	Singular
globalitzada	Singular
relaxar	None
basàvem	Plural
senyalant	None
mostraren	Plural
examinà	Singular
optaren	Plural
debutant	None
dient-se	None
deien	Plural
comptaren	Plural
destriéssim	Plural
galvanitzant	None
motives	Singular
tallaran	Plural
recuperat	Singular
construïdes	Plural
prestessin	Plural
capturar	None
marcaven	Plural
deprimida	Singular
dissoldre	None
inclogueu	Plural
allotjats	Plural
amo	Singular
escrius	Singular
departit	Singular
eructàveu	Plural
distingiren	Plural
queixessin	Plural
traslladessin	Plural
termino	Singular
sentint	None
editarà	Singular
pol·linitzen	Plural
matarà	Singular
empro	Singular
maleïts	Plural
marxaven	Plural
succeïts	Plural
ensorrà	Singular
contemplaren	Plural
pensàreu	Plural
constituïssin	Plural
alenarem	Plural
desvetllar	None
tustareu	Plural
acabaven	Plural
acompanyant	None
sacsegen	Plural
olorà	Singular
dubtà	Singular
negocio	Singular
enllaço	Singular
zigzaguejaríem	Plural
sorprès	Singular
lladrades	Plural
suïcides	Singular
popularitzades	Plural
transportarien	Plural
mostrant	None
miolar	None
identificada	Singular
suen	Plural
eclipsen	Plural
representaven	Plural
raent	None
baixo	Singular
expandirà	Singular
subjugaràs	Singular
entusiasmar	None
revistes	Singular
fitxant	None
admiraré	Singular
desenvolupares	Singular
creuà	Singular
economitzaren	Plural
impossibilitares	Singular
critiques	Singular
mancà	Singular
articulades	Plural
contraposada	Singular
elevar	None
asseguressin	Plural
distancien	Plural
destituint	None
suar	None
alteressin	Plural
tindríeu	Plural
significaríeu	Plural
mastegar	None
conjugar	None
persistint	None
complien	Plural
laïcitzessis	Singular
informaven	Plural
evocat	Singular
celebres	Singular
ferien	Plural
mantingudes	Plural
desembocar	None
gelada	Singular
violessin	Plural
activar	None
untat	Singular
publicant	None
xafarotegessis	Singular
emplenada	Singular
afusellades	Plural
adormir	None
devorant	None
recomençà	Singular
transportat	Singular
imaginaven	Plural
empataven	Plural
reveries	Singular
seien	Plural
coincidida	Singular
confiant	None
apel·lant	None
ratificà	Singular
nacionalitzà	Singular
afegíeu	Plural
vigilat	Singular
buscaran	Plural
segrestaren	Plural
racionalitzar	None
bastir	None
bullida	Singular
escórrer	None
indignant	None
sap	Singular
immolarà	Singular
sonada	Singular
cridaven	Plural
molestades	Plural
indignes	Singular
ossificant	None
catalanitzar	None
dividint	None
boxarà	Singular
filtressin	Plural
evacuaren	Plural
divorciar	None
calcularien	Plural
ubicar	None
assistint	None
conceptualitzat	Singular
animo	Singular
arxivat	Singular
prestarien	Plural
intitulant	None
cregueu	Plural
provocaves	Singular
forçà	Singular
suporto	Singular
dragant	None
protestessin	Plural
volguéssim	Plural
combatessin	Plural
diagnosticats	Plural
distret	Singular
solidificar	None
completaven	Plural
interessades	Plural
divinitzàreu	Plural
batí	Singular
cometrà	Singular
ataquí	Singular
revelar	None
immolaven	Plural
divulgar	None
tenint	None
citessin	Plural
destripar	None
segrestada	Singular
beneficiats	Plural
presidits	Plural
empaquetar	None
esmentà	Singular
combaten	Plural
polaritzar	None
integrarà	Singular
uniformat	Singular
aturà	Singular
apreciant	None
callades	Plural
corrent	None
transformarien	Plural
exilií	Singular
rearrencant	None
classifiquen	Plural
anglicitzareu	Plural
inspirada	Singular
arrapar	None
volaries	Singular
individualitzant	None
velaritzant	None
lamentaren	Plural
sabotejades	Plural
fundo	Singular
allotgessin	Plural
manlleven	Plural
demostrarem	Plural
replicant	None
provada	Singular
enderrocaren	Plural
danyà	Singular
enviat	Singular
etiqueten	Plural
engolir	None
concedeixo	Singular
simpatitzats	Plural
promès	Singular
urgint	None
participen	Plural
halo	Singular
llançar	None
refusant	None
recompto	Singular
constituïdes	Plural
coronant	None
colonitzant	None
mogueren	Plural
estiuejant	None
sintetitzaven	Plural
detindríem	Plural
efectuarà	Singular
conreats	Plural
podríem	Plural
perdonen	Plural
retre	None
consten	Plural
trucar	None
florint	None
oferiré	Singular
expandien	Plural
inspeccionada	Singular
cridar	None
darem	Plural
firmant	None
aturaríem	Plural
començat	Singular
planxar	None
intentaven	Plural
marcant	None
crearien	Plural
atrevir	None
representant	None
deïficat	Singular
cultivar	None
trillà	Singular
pons	Singular
afalagant	None
atrapaven	Plural
industrialitzat	Singular
gustàreu	Plural
assecaven	Plural
explotar	None
provinguis	Singular
devent	None
espiats	Plural
creure	None
galvanitzaríeu	Plural
llençaren	Plural
enllestida	Singular
digitalitzant	None
dessalinitzar	None
propagà	Singular
remí	Singular
ensorrades	Plural
fomentéssiu	Plural
prohibissin	Plural
interpretà	Singular
oposats	Plural
demanarà	Singular
ascendissin	Plural
adoptaran	Plural
enfonsessin	Plural
ornamentareu	Plural
reconèixer	None
afeblirien	Plural
comprenent	None
posposant	None
ossificaré	Singular
sabrem	Plural
afirmes	Singular
beatificaries	Singular
dedicaven	Plural
solucionaren	Plural
produíssim	Plural
esclafaren	Plural
destinant	None
reformant	None
tatuant	None
eixugar	None
infectat	Singular
modifico	Singular
italianitzant	None
col·leccionen	Plural
disparar	None
terroritzant	None
prengueren	Plural
categoritzar	None
recomptaríeu	Plural
gelades	Plural
segrestats	Plural
laboressin	Plural
belar	None
sexar	None
enterrà	Singular
semblat	Singular
ajornar	None
enganyaren	Plural
acamparíem	Plural
comparades	Plural
concorren	Plural
demanaran	Plural
debuto	Singular
traumatitzada	Singular
portant	None
bufaven	Plural
arrendada	Singular
assegurades	Plural
explicaran	Plural
pasturar	None
inicialitzar	None
destil·laven	Plural
dialogades	Plural
dibuixades	Plural
assistirien	Plural
denunciaríeu	Plural
pretendre	None
esbrinàrem	Plural
refrescar	None
ometre	None
allunyarà	Singular
expressaven	Plural
disputar	None
desbordats	Plural
comptar	None
centralitzat	Singular
mobilitzaren	Plural
prohibida	Singular
peso	Singular
elaborar	None
presideixen	Plural
tantalitzarem	Plural
dibuixen	Plural
aturis	Singular
beatificat	Singular
modelar	None
enganyada	Singular
culminaren	Plural
transmetent	None
alterà	Singular
treballessin	Plural
marcarem	Plural
optessin	Plural
juressin	Plural
condemnat	Singular
cremes	Singular
fongueren	Plural
dramatitzats	Plural
intervingué	Singular
martiritzaríeu	Plural
compraren	Plural
podrà	Singular
encapçalar	None
animalitzar	None
peguen	Plural
edificades	Plural
simbolitzen	Plural
absorbien	Plural
recordar	None
universalitzant	None
recuperar	None
limitada	Singular
cornar	None
sepultades	Plural
instal·laven	Plural
beurà	Singular
fertilitzats	Plural
traslladaran	Plural
arrapat	Singular
oblidats	Plural
defensades	Plural
manllevares	Singular
rejovenint	None
escolliries	Singular
arriscant	None
alarmats	Plural
eclipsades	Plural
magnetitzades	Plural
hesitàveu	Plural
sorgiran	Plural
penjaren	Plural
segellaríeu	Plural
reflexionaran	Plural
organitzis	Singular
retiro	Singular
doblats	Plural
competirien	Plural
actuaren	Plural
imprimissin	Plural
amansiries	Singular
nuat	Singular
pasteuritzar	None
inutilitzant	None
desféu	Singular
cuines	Singular
endevinar	None
multiplicares	Singular
comandats	Plural
marejant	None
remenats	Plural
situarien	Plural
modulant	None
fonc	Singular
constrènyer	None
encoratjo	Singular
generats	Plural
ficar	None
tesant	None
transcrivint	None
anunciar	None
procedirem	Plural
assumiren	Plural
identificaré	Singular
ossificada	Singular
engolida	Singular
baixades	Plural
alegrar	None
educades	Plural
comportaren	Plural
penalitzar	None
procedir	None
defenc	Singular
demolida	Singular
barbant	None
zigzaguegí	Singular
dictant	None
voregéssiu	Plural
assolats	Plural
temis	Singular
vexar	None
bordaríeu	Plural
encadenàrem	Plural
inicies	Singular
significaràs	Singular
travessen	Plural
acudint	None
incrementaré	Singular
avantatges	Singular
negat	Singular
consolidaven	Plural
ubicats	Plural
dissuadirem	Plural
aproximades	Plural
provocarà	Singular
ofendre	None
felicitat	Singular
narraven	Plural
enfadar	None
corregiran	Plural
inventar	None
radicalitzen	Plural
combinat	Singular
plegades	Plural
declaren	Plural
deduït	Singular
ragué	Singular
arrossegada	Singular
posposats	Plural
repartirien	Plural
descobriren	Plural
oferint	None
adoressin	Plural
enxampar	None
oposaven	Plural
colpejar	None
rentaven	Plural
incrementar	None
cal	Singular
lamentarà	Singular
ubicat	Singular
imitada	Singular
gratularen	Plural
manteníem	Plural
entusiasmaven	Plural
inutilitzàrem	Plural
amago	Singular
requereixen	Plural
mitigar	None
entusiasmen	Plural
denuncien	Plural
excitar	None
normalitzaries	Singular
pudirien	Plural
infeccionéssiu	Plural
controlà	Singular
domes	Singular
manipulat	Singular
enganyant	None
fuges	Singular
sentien	Plural
marquéssim	Plural
acreditares	Singular
oraven	Plural
alçaren	Plural
trono	Singular
escoltàveu	Plural
pasturen	Plural
atreure	None
esqueixat	Singular
trenats	Plural
cooperar	None
baixat	Singular
clogueres	Singular
batejar	None
afegissis	Singular
manipulant	None
automatitzant	None
faltarien	Plural
convidaren	Plural
assumeixen	Plural
nuar	None
admirant	None
parlaven	Plural
empaquetant	None
caminar	None
subestimen	Plural
constituïts	Plural
articularà	Singular
plovies	Singular
esterilitzada	Singular
jugat	Singular
perpetrant	None
admeten	Plural
sacies	Singular
traduirà	Singular
desapareixent	None
carreguessin	Plural
traïts	Plural
brillaren	Plural
reconciliada	Singular
animant	None
usarem	Plural
rejovenires	Singular
dirimint	None
infondríem	Plural
degradaran	Plural
confeccionant	None
intimidà	Singular
sotmetre	None
acostar	None
suposades	Plural
transferint	None
salvats	Plural
reconquerint	None
recolzàvem	Plural
aliar	None
aproximessin	Plural
resolgué	Singular
completar	None
xiulant	None
immobilitzis	Singular
allotjades	Plural
travessades	Plural
neutralitzades	Plural
arrodonida	Singular
estressant	None
concloure	None
asseure-se	None
habitessin	Plural
digerides	Plural
entenent	None
observades	Plural
sol·licità	Singular
beuen	Plural
tancarà	Singular
reformades	Plural
debutarà	Singular
molestar	None
causada	Singular
saquejant	None
reiniciar	None
encarreguessin	Plural
forçaven	Plural
erigiren	Plural
llatinitzada	Singular
danyar	None
imità	Singular
menysvalorat	Singular
gambant	None
abraçades	Plural
nacionalitzàveu	Plural
immortalitzant	None
classificarien	Plural
vius	Singular
transliterar	None
admirats	Plural
expandir	None
embenant	None
menyspreada	Singular
capitulis	Singular
subhastar	None
apercebent	None
provindran	Plural
endeutaven	Plural
recorro	Singular
acorralar	None
encoratjaven	Plural
dedicaren	Plural
rauquis	Singular
espolsant	None
economitzaries	Singular
soldà	Singular
orarien	Plural
tirotejada	Singular
doctoraríeu	Plural
expulsarien	Plural
dedicada	Singular
canviaré	Singular
modernitzada	Singular
fertilitzar	None
persuadits	Plural
crucificar	None
confiades	Plural
suposen	Plural
atrofiant	None
retiren	Plural
descendit	Singular
espantant	None
suggerir	None
celebraren	Plural
agradant	None
interpretada	Singular
passegen	Plural
despendre	None
evacuaven	Plural
pescaven	Plural
actues	Singular
renunciaren	Plural
cuinada	Singular
rebutjaven	Plural
alçant	None
liderades	Plural
procediran	Plural
cursen	Plural
ferint	None
acceptaren	Plural
compilí	Singular
acudiren	Plural
corones	Singular
queixo	Singular
adjurarà	Singular
entrenats	Plural
titubis	Singular
descobrir	None
naturalitzar	None
restarien	Plural
treballes	Singular
trigà	Singular
nodrien	Plural
cuejar	None
cedida	Singular
resolem	Plural
fotografiaven	Plural
obligarien	Plural
pogut	Singular
exposaran	Plural
codificar	None
afirmessin	Plural
desodoritzar	None
incrementaven	Plural
habitat	Singular
alegrat	Singular
provocant	None
tolent	None
retallaven	Plural
proposaren	Plural
declarada	Singular
insistiríeu	Plural
encarregarien	Plural
impulsades	Plural
caldrien	Plural
succeïda	Singular
funcionen	Plural
llençar	None
onejaren	Plural
imitant	None
derrotar	None
assolirà	Singular
lligaven	Plural
generalitzar	None
treballen	Plural
pegaven	Plural
determinats	Plural
reclamarà	Singular
produïda	Singular
interessat	Singular
aidarà	Singular
sintonitzats	Plural
fotografiats	Plural
depenem	Plural
acordada	Singular
lubriquéssiu	Plural
parodiada	Singular
intersectareu	Plural
obligat	Singular
comptessin	Plural
dissenyar	None
contaminant	None
envoltà	Singular
abominar	None
escalfar	None
exhibiren	Plural
posseir	None
ressortien	Plural
deposessin	Plural
venut	Singular
adornen	Plural
polits	Plural
reconeixeran	Plural
adverteixo	Singular
orant	None
besaré	Singular
teoritzàvem	Plural
il·luminar	None
amant	None
empresonats	Plural
cruixit	Singular
senyalada	Singular
demostraran	Plural
traure	None
entreguessin	Plural
dictarà	Singular
localitzar	None
revoltar	None
confongueren	Plural
filtraven	Plural
incloem	Plural
criden	Plural
enfocar	None
fabricant	None
repartien	Plural
eixida	Singular
abandones	Singular
desistint	None
eliminant	None
cosit	Singular
atrapada	Singular
anomenaven	Plural
metastatitzis	Singular
clamaren	Plural
ser	None
demanes	Singular
ordenat	Singular
respondrà	Singular
distingint	None
caminen	Plural
denunciar	None
desistit	Singular
usarà	Singular
incorporéssim	Plural
obeït	Singular
cantades	Plural
desapareguessin	Plural
pretenc	Singular
guarneixen	Plural
signats	Plural
sorgint	None
fico	Singular
xopat	Singular
expandiran	Plural
refrigerant	None
concebent	None
coincidissin	Plural
modernitzant	None
encarregar	None
obtindrien	Plural
desprenent	None
brillarà	Singular
enfonent	None
succeirien	Plural
acudirien	Plural
encreuaven	Plural
rebaixaren	Plural
pasturaven	Plural
empraran	Plural
descriurem	Plural
harmonitzar	None
conjuntes	Singular
professionalitzar	None
lluitada	Singular
escorrent	None
belis	Singular
graves	Singular
agruparien	Plural
excedien	Plural
inclinaren	Plural
memoritzant	None
atemptes	Singular
acredità	Singular
empenyeren	Plural
presento	Singular
escapar	None
regalat	Singular
barbar	None
protegides	Plural
regalarà	Singular
allargats	Plural
gravarien	Plural
converteixes	Singular
clourà	Singular
eructes	Singular
relates	Singular
categoritzarà	Singular
afeblint	None
arrissar	None
escampà	Singular
residir	None
fabriquessis	Singular
assolint	None
disseminarem	Plural
treballant	None
excel·leixen	Plural
reunirien	Plural
córrer	None
concloïen	Plural
exercir	None
empalats	Plural
convoquen	Plural
esclafades	Plural
ignoro	Singular
pal·liaran	Plural
desbloquejant	None
puniríeu	Plural
somien	Plural
rimada	Singular
sintonitzant	None
triades	Plural
desitjant	None
calmar	None
velaritzada	Singular
jugarà	Singular
rimar	None
mercantilitzant	None
publicà	Singular
anomenant	None
atrofiada	Singular
contenint	None
estàveu	Plural
atenuada	Singular
desobeït	Singular
conjugat	Singular
riure	None
cargolant	None
noent	None
imantant	None
dificultar	None
calculats	Plural
repetit	Singular
aprestant	None
parlàvem	Plural
suïcidant	None
visitada	Singular
emigraren	Plural
subjugada	Singular
derrotats	Plural
puges	Singular
alternarà	Singular
necessitaré	Singular
enviar	None
solucionar	None
manifesten	Plural
evitaré	Singular
mossegaven	Plural
descobreixes	Singular
enterbolírem	Plural
adornessin	Plural
evolucionares	Singular
somriurà	Singular
nuo	Singular
investigant	None
assenyalarem	Plural
afegits	Plural
respondré	Singular
cometre	None
assolada	Singular
tricotar	None
estereotipar	None
plantades	Plural
afuselles	Singular
tinguessis	Singular
llegà	Singular
llatinitzant	None
nedant	None
aliada	Singular
transformaren	Plural
sues	Singular
brodat	Singular
encarregant	None
empaquetares	Singular
tens	Singular
torturí	Singular
ampliant	None
assassinant	None
alternant	None
preveu	Singular
obliguessin	Plural
brillant	None
inhibit	Singular
poblen	Plural
promogueren	Plural
edifiques	Singular
abandonar	None
enveges	Singular
completat	Singular
proposes	Singular
constrenyent	None
obriren	Plural
ocupar	None
atures	Singular
editant	None
cabries	Singular
condicionis	Singular
hospitalitzat	Singular
ennuvolar	None
simpatitzat	Singular
deposo	Singular
llogaren	Plural
parada	Singular
veiem	Plural
arreglaràs	Singular
desbordes	Singular
ordenar	None
publicaren	Plural
mudant	None
acusada	Singular
extreguis	Singular
violà	Singular
firmarà	Singular
empatant	None
devorat	Singular
anunciessin	Plural
anunciant	None
refuten	Plural
disminuiríem	Plural
examinar	None
revenint	None
aterraren	Plural
sumessin	Plural
boxaven	Plural
anticipant	None
mudo	Singular
acostats	Plural
fusionarien	Plural
instaurat	Singular
adobar	None
espantar	None
posseït	Singular
segreguéssim	Plural
sorprengué	Singular
quantificat	Singular
tapen	Plural
satisfareu	Plural
dissociada	Singular
fixar	None
intitular	None
crucifiquis	Singular
massacraries	Singular
da	Singular
enfrontaven	Plural
resultaran	Plural
accedeixen	Plural
pol·linitzant	None
acidificada	Singular
morir	None
capolar	None
sofrir	None
recomençares	Singular
unto	Singular
lloà	Singular
convenceren	Plural
traspassaven	Plural
giressin	Plural
monopolitzaren	Plural
sacsejar	None
precisar	None
polaritzant	None
afavorint	None
posposades	Plural
queixada	Singular
doctorà	Singular
subornaries	Singular
conduir	None
onegen	Plural
alleugerar	None
actualitzar	None
resessin	Plural
retornen	Plural
elaborant	None
educaven	Plural
unifiar	None
destrosses	Singular
importes	Singular
delíem	Plural
dupliques	Singular
catalitzarà	Singular
disputada	Singular
ensorrant	None
comptabilitzo	Singular
reviscolat	Singular
consolidant	None
sondejàreu	Plural
dragat	Singular
disculpant	None
desplaçaré	Singular
escolten	Plural
ronronejant	None
dispersarà	Singular
expressessin	Plural
buscats	Plural
penjades	Plural
esdevenir	None
pertanyo	Singular
desmoralitzar	None
torçarà	Singular
titllar	None
protagonitzaven	Plural
compraran	Plural
balançant	None
practicaren	Plural
dormida	Singular
plaus	Singular
confirmaven	Plural
lloat	Singular
davallades	Plural
labiovelaritzareu	Plural
corroborant	None
conegut	Singular
laïcitzar	None
democratitzessis	Singular
menjaren	Plural
abaixà	Singular
pudirem	Plural
condicionar	None
expulsats	Plural
pretenen	Plural
llegues	Singular
canten	Plural
involucris	Singular
agrupar	None
influirien	Plural
diferenciaven	Plural
folles	Singular
abaixant	None
existiran	Plural
canviéssim	Plural
calculant	None
equivocar	None
abraçarà	Singular
robàrem	Plural
efectuaves	Singular
col·locar	None
imiten	Plural
escollien	Plural
immolar	None
evitada	Singular
espiada	Singular
combaté	Singular
condicionaren	Plural
emprar	None
entro	Singular
afeblits	Plural
explotades	Plural
escoltessin	Plural
bordant	None
harmonitzat	Singular
corresponen	Plural
contamines	Singular
trobaven	Plural
revelarà	Singular
subestimats	Plural
reelegint	None
saludar	None
pareixereu	Plural
elevada	Singular
forgis	Singular
acordat	Singular
creiem	Plural
criticant	None
revelessis	Singular
componc	Singular
distribuïts	Plural
emplenades	Plural
matà	Singular
distanciada	Singular
sostinguda	Singular
entreguen	Plural
impetressis	Singular
calent	None
escorren	Plural
bec	Singular
articulant	None
massacressin	Plural
informaran	Plural
deïficaré	Singular
comprar	None
planejà	Singular
semblant	None
florir	None
organitzessin	Plural
ficats	Plural
arrencada	Singular
dotorejà	Singular
recorreràs	Singular
persuadint	None
regressaren	Plural
reclamaré	Singular
saludaven	Plural
rescatar	None
prioritzar	None
funcionaran	Plural
maleir	None
trobarem	Plural
instal·lat	Singular
afebleixen	Plural
dilatat	Singular
immobilitzada	Singular
expulsar	None
preparaven	Plural
calcular	None
pinto	Singular
aturí	Singular
mugit	Singular
exhalar	None
collíssiu	Plural
sincronitzar	None
bombardegen	Plural
imposàrem	Plural
cansant	None
acabar	None
exigiran	Plural
labiovelaritzar	None
agonitzar	None
defenestrar	None
guardàveu	Plural
calcificar	None
divinitzaríem	Plural
exasperada	Singular
nuen	Plural
boicotejar	None
aconsegueixen	Plural
encoratgen	Plural
accediríem	Plural
inscriure	None
dissolgueren	Plural
originats	Plural
vocalitzaríeu	Plural
toleraran	Plural
firmar	None
signant	None
forçarà	Singular
penjaran	Plural
provindrà	Singular
subratllis	Singular
nomenen	Plural
empresonaren	Plural
esternudar	None
intimiden	Plural
admirarà	Singular
perfumada	Singular
decretant	None
usant	None
apoderats	Plural
desenvolupen	Plural
exhumar	None
transmeteren	Plural
masticat	Singular
carregaran	Plural
encalçant	None
caiguis	Singular
generà	Singular
vendrien	Plural
pintessin	Plural
distanciant	None
motivats	Plural
comprenguessin	Plural
vedar	None
relatat	Singular
presidit	Singular
retornada	Singular
generarà	Singular
substituirà	Singular
grapejar	None
ompliran	Plural
cultivats	Plural
especificada	Singular
avançats	Plural
suquen	Plural
edificar	None
etiquetessin	Plural
alarmaren	Plural
abatis	Singular
aparegué	Singular
robats	Plural
reflexionaren	Plural
emigressin	Plural
odien	Plural
deshumanitzant	None
detingudes	Plural
conquisten	Plural
obligar	None
recomençaries	Singular
encaixada	Singular
desodorant	None
reconstruïren	Plural
vinculats	Plural
requerides	Plural
violar	None
tacar	None
amaguen	Plural
iniciaran	Plural
parlarem	Plural
submergir	None
punxes	Singular
vedades	Plural
escornar	None
governen	Plural
progressar	None
revelaven	Plural
dialogaren	Plural
saltà	Singular
garantida	Singular
modelat	Singular
cancel·làveu	Plural
pensat	Singular
escaramussis	Singular
collint	None
dogmatitzaríem	Plural
citarà	Singular
catalitzen	Plural
agitéssim	Plural
mantinc	Singular
propaguen	Plural
propagada	Singular
extrapolant	None
accedien	Plural
casant	None
amplio	Singular
batien	Plural
envaïen	Plural
pagues	Singular
imantada	Singular
datada	Singular
dansar	None
estar	None
envellits	Plural
corregueren	Plural
soldant	None
parlat	Singular
ajudarem	Plural
conclourien	Plural
segellen	Plural
reemplaçar	None
destorben	Plural
subministrarà	Singular
satisféreu	Plural
entusiasmo	Singular
decretarien	Plural
dictar	None
presentada	Singular
cobrà	Singular
oprimint	None
arrisquen	Plural
transportàrem	Plural
reprendre	None
enderrocaven	Plural
redactà	Singular
pactant	None
temuts	Plural
embarrancant	None
derruïdes	Plural
ruixar	None
enllaçant	None
vences	Singular
dissociar	None
brinden	Plural
simbolitzar	None
rebis	Singular
atacà	Singular
afartar	None
mitigant	None
rebrà	Singular
coagular	None
identificats	Plural
motoritzar	None
buscarà	Singular
estalviarem	Plural
vine	Singular
proposaran	Plural
ensenyaran	Plural
esbrinar	None
degraden	Plural
enregistrant	None
exposes	Singular
protegir	None
realitzant	None
aglutinaran	Plural
xiulat	Singular
difamàrem	Plural
subjectivar	None
fracassar	None
arriscaven	Plural
aglutinades	Plural
condemnessin	Plural
constàrem	Plural
acaronant	None
requeriran	Plural
patiràs	Singular
cabien	Plural
llatinitzat	Singular
ensopit	Singular
capficat	Singular
associats	Plural
parodiaven	Plural
imprimir	None
enlluernar	None
comportà	Singular
maleint	None
suplicaven	Plural
analitzarà	Singular
remolent	None
escollides	Plural
beure	None
demanaré	Singular
canviarà	Singular
dutxant	None
discutirà	Singular
serviríem	Plural
arrossegaven	Plural
perdràs	Singular
moure	None
automatitzar	None
dificultada	Singular
prefereixen	Plural
fornida	Singular
tractaré	Singular
desats	Plural
prefereixes	Singular
purificaven	Plural
derivessin	Plural
immigressin	Plural
casar	None
estimen	Plural
evolucionaran	Plural
separada	Singular
detinguessin	Plural
insisteixo	Singular
memoritzessin	Plural
cedissin	Plural
arrestar	None
fabricaren	Plural
tòrcer	None
planificaven	Plural
absolgué	Singular
dedicant	None
atenyen	Plural
posseïren	Plural
assetgessin	Plural
fitxen	Plural
destaco	Singular
sumí	Singular
cancel·lessin	Plural
rendint	None
conec	Singular
trilles	Singular
reduïssin	Plural
mesuren	Plural
extreure	None
transformaries	Singular
desembocarà	Singular
vençuts	Plural
sospito	Singular
poguessis	Singular
costà	Singular
encantar	None
seguit	Singular
corroborada	Singular
serveixo	Singular
significar	None
exercirien	Plural
utilitzaríem	Plural
ridiculitzar	None
ignorades	Plural
resen	Plural
fumat	Singular
adaptar	None
infondre	None
conspirarien	Plural
comprendrien	Plural
desmilitaritzant	None
avançant	None
obtingut	Singular
abandonades	Plural
eclipsant	None
cabut	Singular
planejant	None
saltant	None
harmonitzen	Plural
traus	Singular
corroït	Singular
eixiren	Plural
rascades	Plural
xocà	Singular
parat	Singular
assimilessin	Plural
usaren	Plural
impulsaran	Plural
rompre	None
refugiéssiu	Plural
netejàrem	Plural
apoderàveu	Plural
involucrà	Singular
negar	None
categoritzant	None
xucles	Singular
vigilarà	Singular
conegueu	Plural
liderada	Singular
classificaran	Plural
deïficar	None
convertits	Plural
caldrà	Singular
pensàvem	Plural
suïciden	Plural
faltaven	Plural
faltaran	Plural
valer	None
encreuessin	Plural
tallaven	Plural
honrar	None
atrac	Singular
derrotessin	Plural
copiant	None
esclatat	Singular
romandrien	Plural
recorregueren	Plural
arrossegar	None
esmentades	Plural
lluitàvem	Plural
deixareu	Plural
exhibit	Singular
enfadarem	Plural
manaven	Plural
rodada	Singular
afalagat	Singular
pretès	Singular
inseriríem	Plural
considerant	None
discriminar	None
retallades	Plural
torçà	Singular
combatre	None
guardar	None
corroborat	Singular
abandonaven	Plural
reapareixent	None
fornegen	Plural
ornamentant	None
arrapant	None
reorganitzar	None
acorralarien	Plural
respondre	None
transfongué	Singular
autoritzarà	Singular
aprofitar	None
socarrat	Singular
blindats	Plural
evocarem	Plural
combines	Singular
tocarien	Plural
esgatinyant	None
propagaven	Plural
manifestarà	Singular
nodriren	Plural
gustaran	Plural
perpetuaran	Plural
excedir	None
gemegant	None
dibuixaven	Plural
martiritzada	Singular
marxàrem	Plural
associaren	Plural
anomenats	Plural
forçant	None
ajudo	Singular
indignat	Singular
diversificar	None
editen	Plural
monopolitzà	Singular
motivàreu	Plural
penjada	Singular
disminuïda	Singular
torturant	None
endevinarien	Plural
independitzant	None
dissuadint	None
treballareu	Plural
basessin	Plural
reeixien	Plural
reforçarà	Singular
estudiar	None
amaren	Plural
usats	Plural
allotgen	Plural
refreden	Plural
desobeïen	Plural
diversificats	Plural
sospitats	Plural
congelades	Plural
sintonitzen	Plural
narrà	Singular
llicenciant	None
justificarien	Plural
alternar	None
adornar	None
evaporant	None
uniformitzada	Singular
perfeccionada	Singular
firmats	Plural
donessin	Plural
emplenats	Plural
trobaries	Singular
obligant	None
pronunciant	None
decretada	Singular
condicionarien	Plural
planificant	None
escriguessin	Plural
defensant	None
desaparegueren	Plural
rebotent	None
pactar	None
cornis	Singular
sumar	None
comentà	Singular
explorà	Singular
sobremenjar	None
entrevistaren	Plural
preparar	None
proposaven	Plural
rodarà	Singular
enviaré	Singular
rememoràveu	Plural
durant	None
cabríeu	Plural
disputades	Plural
evolucionessin	Plural
aïllaran	Plural
aixecant	None
fomentat	Singular
dolies	Singular
ofegar	None
vetllat	Singular
rescatats	Plural
fusionant	None
descoratjar	None
habitades	Plural
esgatinyàrem	Plural
combinarà	Singular
aconseguint	None
queixaries	Singular
tesar	None
coincideixo	Singular
adoptant	None
profetitzada	Singular
apareixent	None
buidaren	Plural
alarmada	Singular
indicarem	Plural
embarrancada	Singular
pujats	Plural
recuperant	None
emprà	Singular
refredades	Plural
acreditaven	Plural
experimentats	Plural
expel·lint	None
exclamarien	Plural
contaminen	Plural
dejunat	Singular
amansirà	Singular
decretis	Singular
desmoralitzaríem	Plural
protesto	Singular
pintaren	Plural
corregint	None
diferenciades	Plural
retallada	Singular
agrairé	Singular
acaricies	Singular
resulten	Plural
salvo	Singular
mosseguis	Singular
enganxaríem	Plural
conservar	None
capficant	None
relaxaríem	Plural
barallar	None
defensat	Singular
mescles	Singular
unflar	None
escuro	Singular
colat	Singular
embolicarien	Plural
pentinen	Plural
idolatrats	Plural
acceptaré	Singular
guardats	Plural
atrapant	None
rememorarien	Plural
circumnaveguessin	Plural
exhibint	None
fundes	Singular
degueren	Plural
trobar	None
massacrades	Plural
reapareixen	Plural
delíssiu	Plural
arrossegarà	Singular
socarrar	None
retornaran	Plural
degradar	None
fornejat	Singular
acceptar	None
retornar	None
desautoritzant	None
hipnotitzat	Singular
arxivats	Plural
respirar	None
pertànyer	None
travessaríeu	Plural
arrodonit	Singular
senyalen	Plural
lateralitzàreu	Plural
oposaran	Plural
xafarotejà	Singular
encarregaré	Singular
merèixer	None
tancaven	Plural
odiat	Singular
enlluernant	None
contribuirà	Singular
profunditzaran	Plural
cantarà	Singular
pertanys	Singular
posseïts	Plural
traumatitzat	Singular
trenant	None
corprenent	None
entrant	None
presten	Plural
envejaven	Plural
insistirà	Singular
redactarà	Singular
rascàvem	Plural
enfocades	Plural
desplaçar	None
destruïen	Plural
evitarien	Plural
convidar	None
alegraven	Plural
elegies	Singular
desafiant	None
evacuessin	Plural
escoltats	Plural
seguireu	Plural
recomençar	None
folrat	Singular
cedir	None
assetjo	Singular
antecedir	None
transformaven	Plural
acostat	Singular
privats	Plural
destruïren	Plural
infonguéssiu	Plural
sondejant	None
denuncies	Singular
xocaren	Plural
especifiquen	Plural
esclafar	None
enfadant	None
follis	Singular
esbotifarrar	None
estimades	Plural
aturarien	Plural
assimilaríeu	Plural
copiats	Plural
llogares	Singular
immortalitzí	Singular
avantatgéssiu	Plural
salto	Singular
confeccionaren	Plural
alienat	Singular
danyàreu	Plural
torturada	Singular
enterraríem	Plural
semblar	None
afegeixo	Singular
preveient	None
sostindrien	Plural
dimitir	None
furant	None
alçar	None
diagnosticada	Singular
graduen	Plural
conèixer	None
especificaren	Plural
centressis	Singular
reprenc	Singular
contemplar	None
aconseguiran	Plural
preservaren	Plural
ordenà	Singular
adoraven	Plural
sabrien	Plural
aproví	Singular
edità	Singular
acampats	Plural
evaporats	Plural
recollir	None
pruir	None
practiquen	Plural
jac	Singular
etiquetat	Singular
rotar	None
dispersant	None
allargà	Singular
estriparàs	Singular
descloíeu	Plural
treballat	Singular
caigué	Singular
reorganitzaven	Plural
retiris	Singular
organitzéssim	Plural
aprenent	None
admeté	Singular
acabarà	Singular
reapareixies	Singular
compareguessin	Plural
estripar	None
advertint	None
estossegaven	Plural
alleugerides	Plural
generalitzat	Singular
inserien	Plural
confeccionarà	Singular
augmentant	None
dimeritzes	Singular
doctores	Singular
guerrejàreu	Plural
organitzarà	Singular
xuclàrem	Plural
consultaren	Plural
desfer	None
enutjar	None
indicarien	Plural
simplificarà	Singular
animarien	Plural
creant	None
invento	Singular
caracteritzat	Singular
accedirà	Singular
eclipses	Singular
envellint	None
evocaven	Plural
guardonada	Singular
ofegant	None
servirien	Plural
amenaçarien	Plural
exposat	Singular
orinàreu	Plural
urbanitzaren	Plural
renovant	None
elaborà	Singular
pecats	Plural
redimir	None
utilitzaves	Singular
sumaran	Plural
mesclaven	Plural
oposessis	Singular
xafardejar	None
circulant	None
creixent	None
canviats	Plural
heretar	None
encreuar	None
utilitzessin	Plural
esterilitzar	None
nacionalitzant	None
marxà	Singular
acorralàrem	Plural
caminant	None
hibernaren	Plural
accelerar	None
associar	None
martiritzat	Singular
expandida	Singular
retirats	Plural
satisfarien	Plural
interpretessin	Plural
estalviarà	Singular
acceptarà	Singular
segellarà	Singular
conjuntats	Plural
encendre	None
neden	Plural
relaxant	None
industrialitzes	Singular
rescatàrem	Plural
motivo	Singular
soterrarà	Singular
reduïdes	Plural
radicalitzà	Singular
reduíssiu	Plural
acariciaves	Singular
cridant	None
importar	None
roten	Plural
anhelat	Singular
disperso	Singular
reeixíssim	Plural
tibar	None
parlaves	Singular
barrejaven	Plural
trillessis	Singular
desenvolupant	None
amputàvem	Plural
universalitzarem	Plural
tractant	None
girar	None
admirareu	Plural
familiaritzessin	Plural
rego	Singular
esdevenien	Plural
pudint	None
desembocat	Singular
guerrejaries	Singular
modules	Singular
discutiran	Plural
privant	None
enfonsar	None
estrenar	None
professionalitzant	None
cregué	Singular
ajudaren	Plural
cultiví	Singular
desafiar	None
adjurar	None
desmilitaritzar	None
mitigaríeu	Plural
hipnotitzar	None
orientalitzis	Singular
agraïts	Plural
departir	None
limiten	Plural
dites	Plural
bullits	Plural
tastessis	Singular
dedicar	None
codificat	Singular
reinicialitzat	Singular
redimits	Plural
repartiren	Plural
evaporarien	Plural
inventant	None
coincidirà	Singular
potabilitzant	None
bategessin	Plural
incorporant	None
analitzaren	Plural
afusellar	None
requerint	None
exposaven	Plural
embenats	Plural
emprarem	Plural
excedint	None
trencaran	Plural
industrialitzant	None
apunyalant	None
duplicar	None
esgarrapades	Plural
comentades	Plural
il·luminades	Plural
començaran	Plural
saludant	None
afeblit	Singular
permeteren	Plural
aguaitàveu	Plural
floriran	Plural
escampant	None
soldis	Singular
desaprovar	None
alliberades	Plural
vigilades	Plural
batallar	None
estimularen	Plural
autoritzaves	Singular
treure	None
insistides	Plural
planejar	None
simpatitzaven	Plural
transmès	Singular
allargant	None
exigint	None
modificar	None
congelada	Singular
comparegueren	Plural
nacionalitzar	None
triaran	Plural
contravenint	None
aplaudeixen	Plural
boten	Plural
posseiran	Plural
revinguis	Singular
mudat	Singular
armis	Singular
complaïen	Plural
podat	Singular
sostinguérem	Plural
enlluernaríeu	Plural
mostres	Singular
respirat	Singular
afegir	None
rearrenquis	Singular
consultar	None
iniciarà	Singular
absorbint	None
correspons	Singular
erigit	Singular
acceptant	None
menyspreen	Plural
contraatacant	None
desbloquejats	Plural
dissoldran	Plural
rompent	None
regar	None
correrà	Singular
estalvià	Singular
fotografien	Plural
intuiran	Plural
desfent	None
aproximar	None
existíreu	Plural
revingut	Singular
malparlaràs	Singular
tingué	Singular
necessitats	Plural
editat	Singular
adaptarà	Singular
paro	Singular
fotograven	Plural
simular	None
acostant	None
estudiats	Plural
suposarem	Plural
disposà	Singular
evití	Singular
pesar	None
asseure	None
homenatjarien	Plural
repeteixes	Singular
reforçaran	Plural
calcificant	None
paregut	Singular
envejada	Singular
espies	Singular
colonitzada	Singular
quantifiquen	Plural
agrupant	None
rememorar	None
raonades	Plural
funcionaven	Plural
transgredir	None
comunicaren	Plural
il·luminàvem	Plural
adaptaren	Plural
aconseguida	Singular
cures	Singular
sobreescalfes	Singular
dissenyarem	Plural
tractada	Singular
escalfareu	Plural
menjaven	Plural
acompanyà	Singular
ballà	Singular
trobessis	Singular
formen	Plural
creixerien	Plural
combinéssiu	Plural
molestà	Singular
renunciarien	Plural
deduint	None
rovellant	None
especialitzant	None
complaent	None
emascularé	Singular
recordarà	Singular
guiant	None
encorregut	Singular
rondinaríeu	Plural
empatar	None
disparant	None
manumeteres	Singular
distanciaré	Singular
preocupant	None
atribuir	None
galvanitzàreu	Plural
enganyarà	Singular
extingir	None
mecanitzar	None
alterar	None
expressades	Plural
cursà	Singular
voten	Plural
compartírem	Plural
magnetitzant	None
xocar	None
proposaré	Singular
mantinguda	Singular
esglaiat	Singular
eructant	None
entretenir	None
sincronitzen	Plural
reclamats	Plural
mortificat	Singular
estimulant	None
empressin	Plural
alegrades	Plural
netejar	None
comparo	Singular
retiraran	Plural
combatien	Plural
actuessin	Plural
vehicularien	Plural
arribaríem	Plural
animà	Singular
sintonitzar	None
deixo	Singular
comandada	Singular
assenyalades	Plural
atorgarien	Plural
deturat	Singular
lligar	None
deposà	Singular
estandarditzen	Plural
introduirien	Plural
rondino	Singular
abdicant	None
funcionant	None
m'asseuré	Singular
mocant	None
ferraven	Plural
competint	None
instaurar	None
fugiren	Plural
denominar	None
destrossar	None
catalitzat	Singular
entrevistant	None
descendir	None
debilitessin	Plural
provocats	Plural
col·laboraven	Plural
cometé	Singular
abaixaries	Singular
dispares	Singular
divulgades	Plural
coincidir	None
esmenada	Singular
moris	Singular
laïcitzant	None
suat	Singular
secretes	Singular
escrivint	None
malparlar	None
escorregut	Singular
presidirà	Singular
immortalitzar	None
classificà	Singular
influïen	Plural
intensificant	None
trobarien	Plural
descendirien	Plural
assetgen	Plural
tiben	Plural
fugirien	Plural
capficar	None
necessitaran	Plural
oprimides	Plural
confeccionaries	Singular
unint	None
escolliran	Plural
enllestir	None
divorciant	None
enyorant	None
viscut	Singular
abreugen	Plural
usessin	Plural
polida	Singular
portessin	Plural
arriscaríeu	Plural
afegiré	Singular
succeir	None
convencis	Singular
atenuades	Plural
estiuejar	None
atreveixes	Singular
alies	Singular
alienéssim	Plural
ajudades	Plural
arreglada	Singular
recollirà	Singular
decapitar	None
despreses	Plural
forges	Singular
filtrà	Singular
regalis	Singular
ancorant	None
olorar	None
dir	None
constà	Singular
parlis	Singular
experimentà	Singular
passeges	Singular
articular	None
anunciat	Singular
veure	None
empaquetat	Singular
permeto	Singular
ruixada	Singular
persistiren	Plural
ressortir	None
demolit	Singular
exhibir	None
eixugaràs	Singular
oprimida	Singular
esmorzant	None
culminéssiu	Plural
facilitada	Singular
divinitzar	None
batejaren	Plural
persuadit	Singular
nues	Singular
suprimeixen	Plural
rentant	None
alimentada	Singular
acordar	None
plegà	Singular
buscaré	Singular
relacionà	Singular
superaríem	Plural
intervindries	Singular
inscrivint	None
transfonent	None
adonaren	Plural
brotant	None
refinen	Plural
xopes	Singular
digerit	Singular
serviran	Plural
denunciaven	Plural
acamparíeu	Plural
digerint	None
zigzaguejàrem	Plural
assolir	None
destorbant	None
dibuixà	Singular
esgatinyessis	Singular
limitis	Singular
expandirien	Plural
cuiden	Plural
conrearen	Plural
especificant	None
ornamentada	Singular
digitalitzats	Plural
promoguts	Plural
propiciats	Plural
anuncio	Singular
mourà	Singular
milloraren	Plural
derruiríem	Plural
ignoràveu	Plural
remeiant	None
anomenà	Singular
celebrat	Singular
encunyats	Plural
robessin	Plural
homenatjar	None
decapitades	Plural
repartit	Singular
mossegar	None
cuirassar	None
obtinguda	Singular
necessitarem	Plural
destituïda	Singular
depenent	None
evoquen	Plural
menarà	Singular
distanciar	None
arrissada	Singular
aterrar	None
alfabetitzar	None
mecanitzat	Singular
expresséssim	Plural
assecada	Singular
reorganitzaren	Plural
rendeixen	Plural
subhastà	Singular
triomfà	Singular
reconeguessin	Plural
fotosintetitzant	None
temptaves	Singular
variant	None
explorada	Singular
dedicades	Plural
segellar	None
rejovenir	None
retenir	None
contraposà	Singular
definint	None
arrencàreu	Plural
enfocàrem	Plural
llepades	Plural
recomptaren	Plural
pessigaven	Plural
triomfessin	Plural
desenterraven	Plural
alenen	Plural
destacant	None
planejaren	Plural
sintonitzat	Singular
abandonaran	Plural
reconeixien	Plural
enfaden	Plural
marejar	None
traduint	None
impediran	Plural
subjugant	None
diries	Singular
merceritzar	None
il·luminant	None
suplir	None
informen	Plural
dividirà	Singular
mouen	Plural
obeïda	Singular
agrair	None
propaguis	Singular
popularitzaren	Plural
ubicareu	Plural
brodada	Singular
plaure	None
podades	Plural
ululant	None
caguéssim	Plural
aturarà	Singular
elaboressin	Plural
emplenar	None
simbolitzant	None
canvien	Plural
ingressaves	Singular
allunyaren	Plural
deses	Singular
generalitzaren	Plural
especificaven	Plural
confiat	Singular
sintetitzar	None
boicotejats	Plural
revelades	Plural
sorgit	Singular
donats	Plural
subjectivàreu	Plural
refrescat	Singular
diagnosticar	None
demostrat	Singular
usarien	Plural
habiten	Plural
beatificaré	Singular
florits	Plural
civilitzarien	Plural
volten	Plural
finalitzar	None
concentraran	Plural
culminant	None
desplaçarà	Singular
esmentada	Singular
ratificaven	Plural
identifiquessin	Plural
despatxaren	Plural
criticar	None
acusaven	Plural
danses	Singular
acompanyada	Singular
recorrien	Plural
ajudarà	Singular
construiran	Plural
ensenyà	Singular
fornit	Singular
tustar	None
soldaven	Plural
purificades	Plural
distribuint	None
parèixer	None
permetré	Singular
augmentares	Singular
guardonant	None
reconciliarien	Plural
apunyalar	None
capitularé	Singular
elegirà	Singular
ennuvolant	None
brindar	None
publiquen	Plural
ruixaràs	Singular
posseïda	Singular
allargaven	Plural
informant	None
destacà	Singular
revistant	None
conjugà	Singular
aconseguirien	Plural
penjaré	Singular
facilitant	None
instaurats	Plural
dificultats	Plural
fumo	Singular
indicà	Singular
pecàveu	Plural
propagant	None
banyant	None
pensen	Plural
silencià	Singular
reiniciant	None
alarmes	Singular
creo	Singular
controlaren	Plural
saciessin	Plural
recuperades	Plural
mullaven	Plural
centrar	None
corroeixes	Singular
tancar	None
atenuats	Plural
desar	None
respectaran	Plural
parlar	None
reduir	None
refinats	Plural
transmetre	None
teixit	Singular
bastit	Singular
planejat	Singular
deshumanitzéssim	Plural
penges	Singular
arribaries	Singular
utilitzes	Singular
combinant	None
enfonguéssim	Plural
deposar	None
derruint	None
circumcidà	Singular
desconeixem	Plural
dir-se	None
besar	None
plantejar	None
col·laborat	Singular
venent	None
divulgaríeu	Plural
codifiques	Singular
dormissin	Plural
decapitada	Singular
incorporen	Plural
estigmatitzant	None
preparats	Plural
componien	Plural
limitaven	Plural
cauran	Plural
allisada	Singular
expressada	Singular
plegar	None
expulsant	None
lamentant	None
enxampàrem	Plural
exigir	None
assabenten	Plural
boicotejant	None
assenyalen	Plural
assistir	None
internacionalitzant	None
transformar	None
utilitzant	None
pintaven	Plural
relacionant	None
laborant	None
atacarien	Plural
volíeu	Plural
perseveren	Plural
veient-se	None
plantejarà	Singular
desistir	None
prometo	Singular
solucionant	None
suplantada	Singular
denominades	Plural
enfadats	Plural
registrant	None
conservades	Plural
injectant	None
sobrevolen	Plural
proclamessin	Plural
motoritzarem	Plural
millorant	None
contemplessin	Plural
disputareu	Plural
fotografiaries	Singular
veig	Singular
desitjats	Plural
distribuït	Singular
desplaçaran	Plural
corroborades	Plural
assolant	None
narrant	None
empresonant	None
sentiran	Plural
conegueren	Plural
acreditar	None
mudar	None
llaves	Singular
decretar	None
oscil·lar	None
significant	None
celebraven	Plural
comentàvem	Plural
arreglant	None
obtenim	Plural
substituirien	Plural
inclourem	Plural
trobàvem	Plural
refrigerada	Singular
expressats	Plural
mortificaven	Plural
condemnant	None
afavorit	Singular
mano	Singular
cerní	Singular
catapultaran	Plural
acabis	Singular
represa	Singular
obeint	None
reconstruint	None
molestada	Singular
capturessin	Plural
suplicat	Singular
cessà	Singular
comprats	Plural
capolaven	Plural
estiguéssim	Plural
comparàvem	Plural
clamant	None
dissenyaven	Plural
llegint	None
reforçaren	Plural
inclouran	Plural
corres	Singular
eclipsarà	Singular
sabé	Singular
antecedint	None
acordaríeu	Plural
enganyar	None
buscant	None
arrossegareu	Plural
manifestaran	Plural
executaran	Plural
previnguts	Plural
sortit	Singular
excel·lint	None
corregut	Singular
pensant	None
utilitzarien	Plural
educant	None
simpatitzant	None
puc	Singular
esmentats	Plural
naufrago	Singular
adonant	None
endeutant	None
ordenant	None
fortificar	None
emprenguessis	Singular
embarrancar	None
mataven	Plural
trenada	Singular
sotmeté	Singular
animar	None
posar	None
autoritzats	Plural
anomenar	None
destaquen	Plural
enterbolir	None
segellares	Singular
monetitzant	None
coneguéssim	Plural
familiaritzat	Singular
triomfen	Plural
mates	Singular
caure	None
regressareu	Plural
orats	Plural
conté	Singular
gelant	None
conduiran	Plural
trinxessis	Singular
espiar	None
concebut	Singular
encadenat	Singular
queixes	Singular
carbonitzessis	Singular
assistirem	Plural
causarà	Singular
callar	None
categoritzessin	Plural
flaires	Singular
afegeixis	Singular
venguérem	Plural
exiliessin	Plural
girant	None
contractat	Singular
regalen	Plural
previngut	Singular
barallant	None
callo	Singular
alliberar	None
dissociarem	Plural
dirigir	None
emprarà	Singular
moralitzar	None
conceptualitzar	None
impetrant	None
llanço	Singular
guerrejar	None
sostingué	Singular
provo	Singular
apostar	None
plantejaran	Plural
romandran	Plural
conquistats	Plural
desitjaran	Plural
mostrada	Singular
silenciaré	Singular
sobrevisqueren	Plural
gravaran	Plural
dificultessin	Plural
nomenades	Plural
torcent	None
definir	None
declararien	Plural
titubant	None
suposaven	Plural
satisféssiu	Plural
privatitzar	None
orbiten	Plural
decidirà	Singular
recomptant	None
suportant	None
penetrats	Plural
segant	None
exclamar	None
copiada	Singular
fabricaven	Plural
envellida	Singular
estiuarem	Plural
usaran	Plural
governà	Singular
cloure	None
modificaven	Plural
infiltrats	Plural
bombardegessin	Plural
seient	None
suprimien	Plural
rebel·lant	None
viatjant	None
restringint	None
emmagatzemaríeu	Plural
avanço	Singular
industrialitzà	Singular
propiciarà	Singular
divorciaran	Plural
arreglaven	Plural
fixant	None
confirmar	None
dominant	None
inclinarà	Singular
dictí	Singular
conspirar	None
encoratjant	None
oprimeixen	Plural
gaudit	Singular
adopten	Plural
memoritzar	None
autoritzades	Plural
aconseguíssim	Plural
impulsat	Singular
harmonitzades	Plural
assegurant	None
raspallant	None
conegué	Singular
construït	Singular
posseirien	Plural
tolerà	Singular
jutjar	None
inclino	Singular
desplacessin	Plural
facilitar	None
exhumant	None
estrenat	Singular
romandre	None
conspirant	None
sintetitzàreu	Plural
revé	Singular
aprecien	Plural
estacat	Singular
podes	Singular
afusellats	Plural
indignàveu	Plural
raucant	None
divorciats	Plural
sotmetrien	Plural
sacsejades	Plural
buscades	Plural
destrossat	Singular
destripant	None
salvarien	Plural
posposat	Singular
materialitzaven	Plural
animis	Singular
prengueu	Plural
sagnar	None
polirien	Plural
punint	None
boté	Singular
derivar	None
comproven	Plural
empenyien	Plural
lliurant	None
registraven	Plural
rebent	None
obren	Plural
deixaven	Plural
actuant	None
trinxà	Singular
quedar	None
esgarrar	None
tallada	Singular
desenterrat	Singular
venint	None
creuarà	Singular
legalitzades	Plural
fluctuant	None
davallaríem	Plural
oprimir	None
desamortitzant	None
cancel·lada	Singular
consolidarà	Singular
guardonareu	Plural
interrompessis	Singular
autoritzaríeu	Plural
fotosintetitzar	None
descrivim	Plural
bombardejar	None
suposarien	Plural
causarien	Plural
recordéssim	Plural
influir	None
plovent	None
suspenent	None
indicaran	Plural
arxivarà	Singular
afavoriren	Plural
intuirem	Plural
forcis	Singular
engolint	None
fredejar	None
habilitarien	Plural
investigades	Plural
carbonitzada	Singular
injectat	Singular
arribant	None
ficades	Plural
injectades	Plural
reclamen	Plural
pretenguessin	Plural
trivialitzant	None
rebré	Singular
passejà	Singular
cuinaves	Singular
prioritzà	Singular
comunicant	None
servirà	Singular
penso	Singular
propagar	None
esmorzar	None
prosperaren	Plural
comportar	None
ajudar	None
intitulaves	Singular
saquejar	None
enxampen	Plural
sodomitzant	None
pensats	Plural
vehiculades	Plural
llogar	None
exigides	Plural
tracten	Plural
interrompre	None
encunyant	None
encreuada	Singular
perseverar	None
esbrinen	Plural
educà	Singular
evacuar	None
exclamaré	Singular
cuirassant	None
parissin	Plural
compensaran	Plural
comparats	Plural
forjar	None
imprimeixen	Plural
aglutinant	None
elegida	Singular
dilatant	None
encaixen	Plural
estossegarien	Plural
brillar	None
marxo	Singular
imagines	Singular
delies	Singular
intitulat	Singular
brindis	Singular
odiar	None
combatut	Singular
ajudarien	Plural
parar	None
absolent	None
preguen	Plural
repeteixen	Plural
descendida	Singular
nedar	None
industrialitzades	Plural
desaproven	Plural
retallant	None
formant	None
escollint	None
prohibits	Plural
recuperada	Singular
intersectessin	Plural
sento	Singular
cessen	Plural
aliant	None
derives	Singular
consolidessin	Plural
pagarà	Singular
vetllareu	Plural
observaran	Plural
apostes	Singular
destacada	Singular
començarien	Plural
subratllant	None
esmentar	None
abrandar	None
segrestant	None
imposar	None
sondejats	Plural
registrà	Singular
begut	Singular
restarà	Singular
aconseguir	None
deturareu	Plural
concedint	None
deposaven	Plural
rebutjaren	Plural
vincularien	Plural
rebotut	Singular
unten	Plural
marcarà	Singular
motoritzades	Plural
concentrarien	Plural
recordo	Singular
amagant	None
torrada	Singular
confio	Singular
desmagnetitzàrem	Plural
laboris	Singular
contaminis	Singular
condicionada	Singular
governar	None
sincronitzant	None
segueixo	Singular
sobrevolaré	Singular
narrar	None
ratificada	Singular
respongué	Singular
traint	None
sumes	Singular
formarà	Singular
remo	Singular
legislà	Singular
romanem	Plural
compilaven	Plural
assetjà	Singular
reflexionen	Plural
atenent	None
mercantilitzar	None
corroborats	Plural
adreçar	None
fracassant	None
cabent	None
desembarquessin	Plural
votaven	Plural
cediren	Plural
traduir	None
ajudada	Singular
ferro	Singular
dols	Singular
impedida	Singular
automatitzades	Plural
revenjant	None
inhibissin	Plural
promoure	None
entrevistada	Singular
escoltat	Singular
despatxar	None
posseint	None
ejaculant	None
estenien	Plural
expresso	Singular
ferris	Singular
admetran	Plural
intentaves	Singular
allotjaren	Plural
visquis	Singular
prestat	Singular
citaven	Plural
emanciparàs	Singular
conduïen	Plural
entretindríem	Plural
desbordant	None
improvisada	Singular
comentaran	Plural
denunciada	Singular
salar	None
costarem	Plural
reemplacessin	Plural
elegíssiu	Plural
afeblir	None
dejunes	Singular
reemplaçà	Singular
vencent	None
oir	None
prenem	Plural
complauen	Plural
arrossegaran	Plural
investigarà	Singular
vocalitzaves	Singular
atacaren	Plural
comparà	Singular
situaven	Plural
llegades	Plural
nodrir	None
acorralats	Plural
motiven	Plural
declarar	None
atrapar	None
estenem	Plural
humanitzant	None
manifestar	None
presentat	Singular
alimentarien	Plural
acampant	None
subratllar	None
restringeixen	Plural
combinessin	Plural
conclogueu	Plural
triomfant	None
acidificant	None
allunyat	Singular
inhalar	None
disminuïssin	Plural
planificades	Plural
exterminà	Singular
redactar	None
vigilant	None
descendits	Plural
arrossegant	None
centralitzar	None
adobats	Plural
infiltrat	Singular
cultivà	Singular
traspassaren	Plural
datarien	Plural
adorant	None
raure	None
capturaven	Plural
prego	Singular
destruït	Singular
fracassats	Plural
saltada	Singular
gambes	Singular
sacsejant	None
alliberareu	Plural
desitjar	None
ballar	None
dependrien	Plural
exiliant	None
atemptar	None
observant	None
enterraven	Plural
nominalitzaves	Singular
anunciaran	Plural
sagnaríem	Plural
conquistada	Singular
suggerit	Singular
uniformitzant	None
aguaità	Singular
sortiren	Plural
cruixir	None
espanten	Plural
inclinant	None
obtinguts	Plural
necessitant	None
promovent	None
notats	Plural
arribades	Plural
distribuirien	Plural
tremolades	Plural
agonitzant	None
estudio	Singular
començaries	Singular
conqueriràs	Singular
imitar	None
prohibiren	Plural
ensenyarà	Singular
publicada	Singular
sacrifiquen	Plural
dictaren	Plural
modifiquen	Plural
simplificaràs	Singular
ferit	Singular
component	None
doblada	Singular
guanyant	None
represes	Plural
perpetraves	Singular
ensenyes	Singular
fornits	Plural
fotre	None
enganxaves	Singular
pactéssim	Plural
bramaríeu	Plural
revenjar	None
assumissin	Plural
repartissin	Plural
rascada	Singular
degut	Singular
esqueixàreu	Plural
pesant	None
matant	None
reaccionar	None
sostenen	Plural
fitxar	None
flairar	None
treballaren	Plural
allunyar	None
congelant	None
xiuxiuejàveu	Plural
suprimits	Plural
lliuren	Plural
acudirà	Singular
tingut	Singular
envellir	None
submergien	Plural
carregar	None
explicaven	Plural
adornats	Plural
escaramussant	None
empalant	None
promoguda	Singular
classificar	None
espanyolitzàreu	Plural
agusàveu	Plural
agusant	None
halat	Singular
rimo	Singular
exterminades	Plural
mastegaven	Plural
apostant	None
basar	None
reconeixes	Singular
paguessin	Plural
recomençant	None
proves	Singular
coagulant	None
conclourà	Singular
practicant	None
eguinant	None
masticar	None
brodes	Singular
miolant	None
tiressin	Plural
veurà	Singular
cursat	Singular
assetjades	Plural
utilitzar	None
pujo	Singular
inhalat	Singular
reinicià	Singular
soterrats	Plural
renillen	Plural
coordinant	None
reprenien	Plural
planificà	Singular
balcanitzar	None
citat	Singular
propiciant	None
caçaven	Plural
confirmant	None
trencaven	Plural
separar	None
doctorada	Singular
incrementarà	Singular
resistiren	Plural
armat	Singular
disminuït	Singular
marxaré	Singular
endeutada	Singular
beneirà	Singular
memoritzada	Singular
difondre	None
coronaven	Plural
encadenant	None
casquéssim	Plural
identificaran	Plural
disseminar	None
imprimien	Plural
tocaran	Plural
cerndrem	Plural
comets	Singular
perpetrar	None
sorgien	Plural
dictades	Plural
embarrancat	Singular
nominalitzant	None
enterrar	None
descompondreu	Plural
acusant	None
exposen	Plural
generar	None
arribaven	Plural
comento	Singular
accedits	Plural
fortificaren	Plural
oposada	Singular
adoptessin	Plural
enganxàveu	Plural
comencen	Plural
falsejant	None
destacarien	Plural
progressant	None
inhumades	Plural
enterbolit	Singular
reforçar	None
planificar	None
senten	Plural
voltat	Singular
vivim	Plural
permeté	Singular
catalanitzarem	Plural
enllaçat	Singular
rebel·lessin	Plural
sincronitzats	Plural
oferir	None
dissenyada	Singular
suques	Singular
dirimir	None
terminis	Singular
refonen	Plural
descompondràs	Singular
bullir	None
estrenessin	Plural
orinà	Singular
retingueres	Singular
cascades	Plural
controlat	Singular
reïxen	Plural
modificat	Singular
adonen	Plural
segregà	Singular
assumit	Singular
casquen	Plural
pujant	None
amada	Singular
dispersaran	Plural
esmorzessis	Singular
substituir	None
cobrats	Plural
votarien	Plural
materialitzant	None
necessitar	None
sorprendre	None
ennuvolada	Singular
moríem	Plural
concebuda	Singular
aportades	Plural
lluitar	None
disposo	Singular
peno	Singular
patit	Singular
situar	None
entusiasmà	Singular
editar	None
sabreu	Plural
prepararien	Plural
sobreestiméssiu	Plural
defensar	None
declarant	None
contaminaven	Plural
assenyalarà	Singular
reconeixerà	Singular
vomitareu	Plural
calmades	Plural
xocant	None
miolades	Plural
dessalinitzant	None
celebrí	Singular
estandarditzant	None
metastatitzaran	Plural
rebrem	Plural
esmentarem	Plural
menyspreant	None
excitat	Singular
disposaven	Plural
pregaríeu	Plural
estaven	Plural
independitzares	Singular
intimidant	None
obeir	None
nadant	None
calmo	Singular
llicenciat	Singular
reemplaçarien	Plural
profetitzà	Singular
deguts	Plural
aprofitada	Singular
demostren	Plural
facilitaven	Plural
il·lustrant	None
perdudes	Plural
circumcidar	None
alimentaran	Plural
patien	Plural
dansada	Singular
mostrats	Plural
llegada	Singular
gaudida	Singular
desenterrar	None
mantenim	Plural
incrementant	None
col·locà	Singular
causaven	Plural
constret	Singular
esgarrada	Singular
ajornat	Singular
irritant	None
guarint	None
dragar	None
sobreestimà	Singular
trivialitzessis	Singular
escaramusses	Singular
penalitzant	None
privatitzant	None
terminades	Plural
barallada	Singular
depenc	Singular
globalitzar	None
arreglar	None
oferien	Plural
arrencaren	Plural
seduir	None
arrestàreu	Plural
calgué	Singular
afaitar	None
cremar	None
transferits	Plural
contractats	Plural
aconseguits	Plural
defensaré	Singular
defenso	Singular
acabaríem	Plural
integrar	None
coneixent	None
assumirien	Plural
reinicialitzant	None
atorgar	None
ames	Singular
aliarà	Singular
identificar	None
caçant	None
corrompudes	Plural
insistit	Singular
descloguérem	Plural
onejat	Singular
legislant	None
nego	Singular
bombejant	None
alienar	None
ferissin	Plural
compartien	Plural
rimen	Plural
entraré	Singular
ressortint	None
circumcidada	Singular
forçada	Singular
nàixer	None
protestar	None
ferida	Singular
defenguessis	Singular
quedant	None
occir	None
pasturant	None
deprimits	Plural
facilitats	Plural
donà	Singular
fitxat	Singular
untaven	Plural
prosperar	None
ignoraran	Plural
coordinats	Plural
determinada	Singular
adaptaran	Plural
xiuxiuejàrem	Plural
arrendats	Plural
continuaren	Plural
assenyalats	Plural
martiritzades	Plural
desembocà	Singular
assumint	None
lliurat	Singular
circumcidat	Singular
oblidar	None
orbitàvem	Plural
transferissin	Plural
reflectit	Singular
generis	Singular
acompanyar	None
avantatjats	Plural
nodrida	Singular
descansaren	Plural
gratar	None
allargar	None
disparo	Singular
rovellar	None
cremaren	Plural
partint	None
descrivint	None
nevat	Singular
perfeccionar	None
esnifar	None
identificant	None
intersectis	Singular
renillant	None
encalçats	Plural
llancessis	Singular
transferirien	Plural
desenvoluparien	Plural
rebutjant	None
persisteixen	Plural
dogmatitzaven	Plural
confiats	Plural
rebel·lat	Singular
origines	Singular
executarien	Plural
conservessin	Plural
islamitzant	None
revistar	None
nomenant	None
traspassà	Singular
arribí	Singular
fornir	None
mobilitzar	None
titubejar	None
gemegàvem	Plural
infonies	Singular
denominant	None
decreto	Singular
desenterrats	Plural
dolguda	Singular
tastant	None
destil·lant	None
diferenciaríem	Plural
dubtar	None
contraposar	None
provingut	Singular
multiplicades	Plural
mesclà	Singular
xocaven	Plural
trigaran	Plural
acabarem	Plural
caracteritzats	Plural
regalaven	Plural
saciïs	Singular
augmentaren	Plural
homenatjà	Singular
pagat	Singular
enfrontareu	Plural
traslladarien	Plural
jurà	Singular
xarrupar	None
fundaren	Plural
escollir	None
gambar	None
tatuats	Plural
foradar	None
aromaries	Singular
respondran	Plural
habitada	Singular
dispersessin	Plural
interpretes	Singular
denominaven	Plural
escalada	Singular
distingir	None
detinguts	Plural
publicaran	Plural
emprenent	None
veies	Singular
fugits	Plural
transliterats	Plural
enfocant	None
contractaries	Singular
extingit	Singular
especificarem	Plural
insurreccionant	None
pegar	None
elimines	Singular
dubtant	None
ploure	None
aplaudint	None
gratulant	None
aterrant	None
calculà	Singular
vetàvem	Plural
lletrejo	Singular
amenaçaven	Plural
inspeccionaren	Plural
escalades	Plural
trenat	Singular
imagino	Singular
senyalarà	Singular
conceben	Plural
convertida	Singular
preserves	Singular
diversificà	Singular
concedirien	Plural
exterminant	None
realitzarem	Plural
elegits	Plural
aconsellar	None
inutilitzen	Plural
especialitzares	Singular
degradant	None
barrejar	None
ventilada	Singular
armà	Singular
purificant	None
volats	Plural
boteren	Plural
cobrirà	Singular
intentes	Singular
soldat	Singular
impossibilitar	None
voregessis	Singular
compartissin	Plural
enfonies	Singular
copiarà	Singular
rescaten	Plural
xuclant	None
traumatitzar	None
exhalant	None
cercà	Singular
batejant	None
atendrà	Singular
mirar	None
empenyeres	Singular
dirigit	Singular
guanyaríem	Plural
ofeguessin	Plural
lexicalitzades	Plural
internacionalitzar	None
cruixies	Singular
edifiquessin	Plural
xiularen	Plural
replicat	Singular
inclinats	Plural
relacionis	Singular
capturant	None
catapultà	Singular
defensarien	Plural
poder	None
negociar	None
ratificarà	Singular
pegà	Singular
dramatitzada	Singular
seleccionat	Singular
vomitar	None
diagnostiquen	Plural
disparaven	Plural
proporciono	Singular
poblessis	Singular
corrompé	Singular
aroméssiu	Plural
corroboren	Plural
miolàveu	Plural
roncar	None
manifestades	Plural
enllestiren	Plural
proven	Plural
lubricant	None
advertida	Singular
soterren	Plural
acostarà	Singular
pasteuritzats	Plural
esclatéssim	Plural
adorat	Singular
estrenaren	Plural
doblen	Plural
teixides	Plural
atrapà	Singular
promoguessin	Plural
caient	None
extrapolen	Plural
percebre	None
introdueixen	Plural
caracteritzà	Singular
veié	Singular
produint	None
torraven	Plural
infiltrada	Singular
destruir	None
doblar	None
rodant	None
ponc	Singular
caçaren	Plural
consagro	Singular
oposar	None
consultant	None
sotmetent	None
contagiada	Singular
governessin	Plural
divorcien	Plural
parlàreu	Plural
transportant	None
forçat	Singular
inventaré	Singular
guiaven	Plural
informo	Singular
planejaríem	Plural
arxivis	Singular
sentíreu	Plural
refutaven	Plural
cedides	Plural
discriminant	None
vigoritzant	None
empitjorar	None
dividies	Singular
naufragant	None
arxiven	Plural
destacaran	Plural
plantes	Singular
retallaren	Plural
rellegint	None
evocant	None
empatades	Plural
uniformant	None
escorres	Singular
ensopir	None
estires	Singular
polaritzo	Singular
oíssiu	Plural
soterrar	None
massacrar	None
desclogueu	Plural
refutant	None
debilità	Singular
assistissin	Plural
moriràs	Singular
planificaren	Plural
aprovar	None
editaré	Singular
assolíeu	Plural
afectar	None
abominant	None
declaro	Singular
conquistà	Singular
recomponent	None
concentrar	None
introduir	None
tesà	Singular
conversàreu	Plural
manquessin	Plural
esmicolar	None
sobreestimada	Singular
pescada	Singular
pastures	Singular
excel·leixis	Singular
fragmentà	Singular
divinitzat	Singular
estimar	None
lletrejar	None
fabricarà	Singular
extrapolaré	Singular
cobries	Singular
imprimeixes	Singular
estem	Plural
blindarem	Plural
aconseguiré	Singular
acceptaran	Plural
felicitar	None
prendré	Singular
criticades	Plural
sobreestimar	None
notareu	Plural
refugiades	Plural
evacuant	None
acaronar	None
substituïda	Singular
enfocat	Singular
restringissin	Plural
amansint	None
insistint	None
saquegen	Plural
multiplicar	None
sonar	None
nogué	Singular
ajornà	Singular
emigren	Plural
naufragar	None
rellegeixo	Singular
refonent	None
actualitzí	Singular
salvessin	Plural
menjaré	Singular
experimentarà	Singular
tacat	Singular
constaran	Plural
endevinarà	Singular
gaudint	None
ensordint	None
viatges	Singular
corregissin	Plural
graduats	Plural
transportaven	Plural
sospitada	Singular
conquistant	None
prosperat	Singular
independitzà	Singular
conceptualitzada	Singular
competíssiu	Plural
onejar	None
saltarien	Plural
mantenint	None
finalitzant	None
endur-se	None
dissuadits	Plural
compleixes	Singular
prestats	Plural
destacarem	Plural
refugien	Plural
massacres	Singular
llegiries	Singular
ampliàrem	Plural
departirien	Plural
agafant	None
rondinaré	Singular
esglaiareu	Plural
maten	Plural
subestimades	Plural
garantit	Singular
decidits	Plural
vedada	Singular
cursar	None
omès	Singular
dotorejats	Plural
ronronejaries	Singular
encantarà	Singular
acabaren	Plural
vaporitzat	Singular
matessin	Plural
compondre	None
cercarà	Singular
existit	Singular
alletares	Singular
viatjarien	Plural
radicalitzat	Singular
lladrar	None
halis	Singular
ascendint	None
absoldre	None
contemplà	Singular
paint	None
gesticular	None
centralitzarà	Singular
organitzaran	Plural
plantejaren	Plural
proclamat	Singular
reaparegué	Singular
apostessin	Plural
hospitalitzats	Plural
introduiran	Plural
deduïdes	Plural
fracassada	Singular
envoltar	None
mercantilitzes	Singular
apologitzant	None
amagues	Singular
somriem	Plural
entretindríeu	Plural
orada	Singular
ionitzant	None
emigrant	None
saquegessin	Plural
esqueixades	Plural
alegren	Plural
tocareu	Plural
silenciant	None
cosits	Plural
ornamentats	Plural
banyo	Singular
finançat	Singular
suportar	None
pasturats	Plural
autoritzen	Plural
discutits	Plural
caic	Singular
destinades	Plural
cursant	None
precisant	None
tolerats	Plural
dilatareu	Plural
requerida	Singular
defineixes	Singular
conservats	Plural
aprendre	None
mostrar	None
dramatitzant	None
intervenint	None
dialogues	Singular
contraposaven	Plural
prohibit	Singular
naufragaves	Singular
acaben	Plural
beatificades	Plural
xipollejant	None
segareu	Plural
causar	None
collir	None
culminarà	Singular
protagonitzà	Singular
suïcidar	None
despatxats	Plural
lliuraren	Plural
espià	Singular
exigida	Singular
rodar	None
exploraren	Plural
suplantades	Plural
entusiasmant	None
voltant	None
discriminats	Plural
fots	Singular
traspassat	Singular
estirar	None
dubtades	Plural
idolatrar	None
articulares	Singular
preferit	Singular
deprimir	None
recolzaven	Plural
perpetuo	Singular
assaborir	None
abolida	Singular
fotent	None
concentrat	Singular
cuirassàveu	Plural
penses	Singular
xafarotejar	None
atomitzada	Singular
originéssim	Plural
explicant	None
grapejàveu	Plural
pagats	Plural
contaminaren	Plural
contractes	Singular
presidirien	Plural
lloaré	Singular
aproximaren	Plural
clamí	Singular
saquejats	Plural
evitant	None
estimo	Singular
regnà	Singular
organitzats	Plural
venir	None
bevem	Plural
decretaven	Plural
utilitzat	Singular
gelis	Singular
continuat	Singular
reformarien	Plural
adorar	None
recorregut	Singular
socarrareu	Plural
simplificant	None
caçades	Plural
trucant	None
allargat	Singular
pensar	None
ossificat	Singular
determinarien	Plural
necessitessin	Plural
llepant	None
cascant	None
raus	Singular
visitaren	Plural
agües	Singular
provis	Singular
somiéssim	Plural
inaugurar	None
seleccionades	Plural
funcionat	Singular
mancar	None
ratificarien	Plural
escaramussar	None
naufragàrem	Plural
perfeccionessin	Plural
vincular	None
envejar	None
vivíem	Plural
mancats	Plural
boto	Singular
firmaré	Singular
cobraven	Plural
daurares	Singular
allunyada	Singular
decretes	Singular
necessitaven	Plural
votar	None
dolent	None
condemnaven	Plural
retinguda	Singular
desitges	Singular
protestant	None
proporcionada	Singular
reapareixien	Plural
llavant	None
aterràrem	Plural
signar	None
eixien	Plural
esperant	None
restaurats	Plural
temut	Singular
atribuint	None
judaïtzar	None
arrencar	None
improvisessin	Plural
replicaven	Plural
pintarà	Singular
enganyen	Plural
aglutinen	Plural
entrarien	Plural
