projekcji	projekcje	Case
knotami	knotem	Number
ogarniające	ogarniający	Gender
niknący	uczestniczący	lemma
szkodliwego	szkodliwej	Gender
jagnięcym	jagnięcą	Gender
borowika	borowików	Number
filologami	filologów	Case
entropią	entropia	Case
nazwiska	nazwisko	Case
wrześniową	wrześniowym	Gender
stulecie	stulecia	Case
wystarczającego	wystarczającej	Gender
dokonują	wyją	lemma
celi	sadyzmu	lemma
rabat	rabaty	Number
deszczami	deszczom	Case
nowojorskiej	nowojorskiego	Gender
płozom	płozach	Case
ratownicy	ratownik	Number
grozić	strzelać	lemma
alergenu	alergenów	Number
komunistycznym	komunistycznej	Gender
neutralnej	neutralnego	Gender
szukajek	szukajkami	Case
dostarczane	widziane	lemma
karku	karkach	Number
medyczny	medyczne	Gender
bezchmurnej	bezchmurnym	Gender
spekulantów	spekulanci	Case
przenośną	przenośne	Gender
swobód	swobody	Number
modlitwy	modlitwę	Number
bawarską	bawarskiej	Case
ptasiej	ptasia	Case
męczennicy	męczennic	Number
zadanie	zadania	Number
mąk	mąki	Number
wykresie	wykresy	Number
ograniczone	ograniczony	Gender
koalicją	koalicja	Case
ryzyku	ryzyko	Case
futra	futer	Number
dawcą	dawcami	Number
półksiężyce	półksiężycu	Number
literaturze	wyrazie	lemma
kuratorem	kuratora	Case
siłą	siłami	Number
dużemu	dużej	Gender
zbierają	zbierały	Tense
obciążało	spadało	lemma
satanizm	satanizmu	Case
gruzińską	gruzińskim	Gender
żurku	żurki	Number
kirkutach	kirkuty	Case
dwukołowym	pornograficznym	lemma
walkom	walkami	Case
opiekował	wydostawał	lemma
ciągami	ciągiem	Number
bywacie	pamiętacie	lemma
odda	oddam	Person
pozdrowieniem	pozdrowieniami	Number
identyczności	identyczność	Case
luźny	traumatyczny	lemma
łokieć	łokcie	Number
akrobata	tabela	lemma
pomagałeś	pomagałaś	Gender
szemraną	szemrana	Case
najpoważniejszym	zdrowym	lemma
najekologiczniejszą	samorzutną	lemma
radni	radnym	Case
mordom	mordy	Case
madrygały	madrygałami	Case
absolwentkę	absolwentki	Number
tłumem	tłum	Case
niewiasty	niewiasta	Case
spotkałam	spotkała	Person
opisuj	powtórz	lemma
mionu	mionów	Number
czaplę	czaplą	Case
szyberdach	szyberdachu	Case
odpoczywaliście	zerowaliście	lemma
debili	debila	Number
statku	statki	Number
kopiąc	organizując	lemma
cynowym	cynowej	Gender
poczeka	spuści	lemma
wektorowi	wektorom	Number
dodane	zaniechane	lemma
piszczmy	zamknijmy	lemma
kąsałaby	zjadłaby	lemma
metoda	metody	Case
środkach	środkom	Case
koszcie	kosztach	Number
antysemickie	nieme	lemma
głosowaniach	głosowaniami	Case
pragnieniu	pragnienie	Case
oceniłyście	posłuchałyście	lemma
społeczeństwa	społeczeństwach	Case
krewetki	krewetka	Number
ciężarówkami	świecznikami	lemma
gotowe	gotowa	Gender
analnego	zimnego	lemma
nastawione	nastawiony	Gender
promocji	promocjach	Number
chaotyczna	chaotyczny	Gender
porty	port	Number
mieszkająca	mieszkający	Gender
sójkę	sójką	Case
szynszyle	szynszylom	Case
mutry	mutrami	Case
portugalski	portugalska	Gender
zaczynający	zaczynające	Gender
żyłam	żyłem	Gender
wajsze	wajchom	Number
rozchodniakowi	rozchodniak	Case
lustra	nastroju	lemma
ruletka	ruletki	Number
astronomicznym	astronomicznej	Gender
olchą	olchami	Number
wiatrami	wiatrach	Case
korporacjami	korporacji	Case
kontaktach	kontaktami	Case
pindzie	pindę	Case
dym	dymem	Case
rundy	rundami	Case
satanistom	sataniście	Number
limuzyn	limuzyny	Number
paragonach	paragonie	Number
dręczy	smuta	lemma
dupkiem	dupka	Case
kurków	kurki	Case
specjalne	specjalny	Gender
stracie	stratą	Case
mandragorom	mandragorach	Case
serze	sery	Number
karkołomne	niebieskawe	lemma
diecezjalnego	diecezjalnej	Gender
fagot	fagoty	Number
kredytami	kredytem	Number
dodawałaby	wysiadłaby	lemma
częstszej	prostopadłej	lemma
godnym	slawistycznym	lemma
muskule	muskułach	Number
pistacji	pistacjom	Number
oczywistą	oczywistym	Gender
brody	szamba	lemma
kołtunami	kołtunem	Number
pierniku	piernikach	Number
lepsze	lepszy	Gender
Szkotki	Szkotka	Number
skryptów	skryptu	Number
pędom	pędowi	Number
nihilistę	nihilistów	Number
wydmowej	wydmowym	Gender
hiszpańskim	hiszpańskiego	Case
cytują	cytujesz	Person
seksta	sekstę	Case
cudom	cudów	Case
całkowych	ślicznych	lemma
mitochondrium	mitochondria	Number
kaledońskich	norweskich	lemma
najsłodsze	najsłodszego	Case
polimerową	polimerowym	Gender
redakcjach	redakcji	Number
fregat	fregaty	Number
hadisach	ostrzeżeniach	lemma
ciężarami	ciężarem	Number
anarchistów	anarchistę	Number
ocaliło	zniknęło	lemma
pytona	pytony	Number
eksporcie	eksportowi	Case
postradałbym	postradałabym	Gender
powietrzny	powietrzne	Gender
kataloński	katalońska	Gender
szarańczami	szarańczą	Number
kuratorzy	kuratorów	Case
dżentelmenie	dżentelmeni	Number
bagnetami	bagnetem	Number
podwodnej	podwodna	Case
nastawimy	zawiedziemy	lemma
azotany	sprzeciwy	lemma
kibicujący	rozwijający	lemma
aferach	aferze	Number
przeczyta	zauważy	lemma
strzelanie	strzelaniem	Case
podatkową	podatkowej	Case
idiotami	idiotą	Number
identyfikujemy	identyfikują	Person
identyfikują	podchodzą	lemma
szyberdachami	szyberdachem	Number
bagna	troski	lemma
trybach	tryby	Case
geograficzne	sąsiedzkie	lemma
macedońskim	macedońską	Gender
sprzeciwy	sprzeciwie	Number
wypiekom	wypieki	Case
dźwigniach	dźwigni	Number
zdobię	zdobimy	Number
błoną	błonami	Number
szlachciców	szlachcica	Number
miara	miary	Number
lodowiska	lodowiskom	Case
nutrię	nutria	Case
klęczymy	pożądamy	lemma
najpowszechniejszą	najpowszechniejsze	Gender
pończochach	pończochy	Case
autochtonicznym	wcześniejszym	lemma
kapitalistyczny	piękny	lemma
oharami	ohary	Case
pełnię	pełnia	Case
aktywniejszemu	aktywniejszej	Gender
wodzowie	wódz	Number
czerwiami	sporami	lemma
smak	smakiem	Case
wyjący	wyjąca	Gender
napisali	napisaliśmy	Person
lalką	lalkami	Number
kawę	kawa	Case
plotkowanie	radzenie	lemma
metalurgicznego	metalurgicznej	Gender
dźwignął	tęsknił	lemma
tonów	tonu	Number
opatentowało	opatentował	Gender
błogi	błogie	Gender
ulubionej	ulubionym	Gender
perzyna	perzyny	Number
upadku	upadków	Number
komitecie	komitetowi	Case
kraczemy	kraczecie	Person
grzbietem	wątkiem	lemma
szybszego	szybszemu	Case
miejskim	miejskiej	Gender
pełną	pełnym	Gender
bliskowschodnich	bliskowschodniego	Number
napowietrzać	przypuszczać	lemma
przedrostki	przedrostku	Number
śmigła	śmigło	Number
kury	kur	Number
prywaciarza	prywaciarzu	Case
atomowa	atomowe	Gender
anielskiej	szalonej	lemma
alpejskie	niegrzeczne	lemma
koszmarze	stałej	lemma
kontynentalnym	okrągłym	lemma
powietrzne	powietrznym	Case
kotłach	pustkach	lemma
wspomniałem	wspomniałam	Gender
niszowe	niszową	Gender
kamiennej	zdolniejszej	lemma
intymnych	intymne	Case
wiek	wiekowi	Case
komitet	komitety	Number
mleczka	mleczko	Case
krasna	krasną	Case
pandemię	pandemii	Case
płaszczyźnie	płaszczyznach	Number
różnowartościowy	różnowartościowe	Gender
dziąsła	dziąsło	Number
chrystadelfianina	chrystadelfianinie	Case
morsów	morsy	Case
mikrometr	mikrometry	Number
słabemu	słabym	Case
lambdzie	lambdę	Case
randek	randki	Case
komary	komarów	Case
mercedesy	wyra	lemma
czółna	czółnem	Case
wanilia	wanilii	Case
cez	współczynnik	lemma
konserwom	konserwie	Number
części	różnoboczni	lemma
bolidem	bolidami	Number
odkryliście	zalogowaliście	lemma
bibach	bibie	Number
podażą	podaży	Case
ulga	uldze	Case
pniem	pniami	Number
bydgoską	bydgoskim	Gender
luźne	świadome	lemma
parlamentarzystek	parlamentarzystki	Case
lontem	lontu	Case
miauczała	miauczał	Gender
pogody	pogodzie	Case
flagi	rzeczywistości	lemma
genewską	genewskie	Gender
tempo	tempa	Number
świecie	światy	Number
przyspieszeniach	przyspieszenia	Case
imionami	przenośniami	lemma
gwiazdozbiorami	gwiazdozbiorem	Number
albatrosów	albatrosy	Case
kadłubem	kadłubami	Number
manipule	manipułach	Number
lubelskiej	lubelskiemu	Gender
adekwatnego	wiosennego	lemma
obserwowania	obserwowaniu	Case
chlewy	chlewie	Number
fundację	fundacje	Number
palmowy	palmowe	Gender
wyrobami	wyrobem	Number
smugę	smudze	Case
bibliotekarzy	stadiów	lemma
linijką	linijkami	Number
szabrowniku	szabrownika	Case
odkrywa	pędzi	lemma
kuchenne	kuchennego	Case
przeciwnej	przeciwnego	Gender
młodszą	młodszym	Gender
niskiemu	niskiej	Gender
cudownym	szczurzym	lemma
kryją	kryję	Person
roślinnego	roślinnej	Gender
ornitolog	ornitologu	Case
twierdzenie	twierdzeniu	Case
trawnik	trawniki	Number
ograniczający	wysyłający	lemma
współczesnej	współczesnemu	Gender
diamentowego	żyznego	lemma
akcie	akty	Number
podpierdolone	sprzężone	lemma
agaty	agacie	Number
kontrolowani	wzięci	lemma
męczennicami	męczennicą	Number
mitem	mit	Case
wdepnęły	wdepną	Tense
zawiodły	zawiodą	Tense
pasma	pasmach	Case
autorów	autora	Number
finał	finale	Case
puszystym	puszystej	Gender
starością	starości	Case
lemiesza	lemiesz	Case
perkozy	perkoz	Number
przestrzeniom	przestrzeni	Number
spacery	spacerów	Case
kości	kośćmi	Case
tkanka	tkanki	Number
kłóciła	kłócił	Gender
dermatolog	oszustwo	lemma
guście	gustach	Number
żyrandol	żyrandola	Case
bukietu	bukiecie	Case
złupicie	złupią	Person
krymskiego	krymskiej	Gender
bogatszego	śpiącego	lemma
parstowi	parście	Case
koszyki	koszyku	Number
mierziliśmy	umarliśmy	lemma
proponujące	proponująca	Gender
strażnik	strażniku	Case
antarktyczny	antarktyczna	Gender
identyfikowała	zrobiła	lemma
makaroniarzy	makaroniarza	Number
możliwe	smocze	lemma
zgliszcze	zgliszcza	Number
wiosłowałyśmy	wiosłowałyście	Person
reprezentantom	reprezentanci	Case
zamkniętych	zamkniętym	Case
zabierze	zabierzesz	Person
krwistego	krwistej	Gender
koalicjami	koalicją	Number
peron	perony	Number
liniowy	szerszy	lemma
wyniki	wyników	Case
nadzwyczajne	nadzwyczajnych	Case
wrzosowisko	wrzosowiska	Number
calu	cale	Number
nikczemna	nikczemnej	Case
kosy	kosów	Case
cnotę	cnoty	Number
klopsami	paleontologami	lemma
alba	alby	Number
stryjkowi	stryjka	Case
maltańskiemu	szklanemu	lemma
gluonach	gluony	Case
iberyjskim	iberyjskiej	Gender
nazwę	nazwy	Number
aktywniejszej	aktywniejszego	Gender
stanika	staników	Number
konkretniejsi	podwodni	lemma
osady	osad	Number
niewidomym	niewidomego	Case
meduzie	meduzę	Case
szlauchu	szlauchach	Number
kreatorem	kreatora	Case
podbródku	podbródki	Number
podłodze	podłogę	Case
śniłeś	śniłaś	Gender
rodzice	rodzicu	Number
narciarstwo	narciarstwu	Case
żądła	żądło	Number
płynnego	płynnej	Gender
bilami	bilą	Number
cieplejszej	cieplejszym	Gender
graficznych	niewyobrażalnych	lemma
aminokwasów	aminokwasu	Number
cielęta	terytoria	lemma
modemami	modemem	Number
surowca	surowcem	Case
grypy	grypo	Number
bliskowschodnim	bliskowschodniego	Case
świnio	świni	Case
kolendrę	kolendry	Number
mandragorami	mandragory	Case
analogie	analogia	Number
najwcześniejsze	najwcześniejszy	Gender
chłopczykiem	reumatyzmem	lemma
zepniesz	wypędzisz	lemma
jazzowemu	starczemu	lemma
czerpałyby	przodowałyby	lemma
półfinałach	półfinały	Case
świr	świry	Number
głodzie	głodu	Case
szczoteczka	szczoteczką	Case
dotykająca	śmierdząca	lemma
poncz	ponczu	Case
eksperymenty	eksperyment	Number
księdzu	księżom	Number
robaki	robak	Number
podczerwonej	podczerwoną	Case
sterburtę	sterburty	Number
detektywa	detektywowi	Case
atrapo	olbrzymko	lemma
szarawymi	szarawe	Case
orzechową	orzechowym	Gender
jednobarwnego	zależnego	lemma
kolegi	koledze	Case
pobierze	umrze	lemma
zdrowego	zdrowej	Gender
kije	kij	Number
antywirusów	antywirusa	Number
neologizmy	neologizm	Number
swobodnymi	swobodnych	Case
czczego	czczej	Gender
kolejnego	sztucznego	lemma
namiotem	namiot	Case
zwykłemu	zwykłej	Gender
iguana	iguany	Number
armeńskie	armeńską	Gender
nora	nory	Case
numerując	słuchając	lemma
szariatami	szariatom	Case
pijana	zweryfikowana	lemma
wyborczej	wyborczemu	Gender
piktogramach	piktogramami	Case
piątki	piątkami	Case
szklaną	szklanym	Gender
tulipanowiec	tulipanowce	Number
najcięższego	prozaicznego	lemma
hawajskie	źródlane	lemma
poetycka	poetycki	Gender
rzecznym	rzecznych	Case
ściągnie	zaprosi	lemma
randkach	randkom	Case
skrócicie	skróci	Person
genealogie	genealogii	Case
egzotyczniejszy	egzotyczniejszemu	Case
czeremcha	czeremsze	Case
zmęczony	zmęczona	Gender
tęsknoty	tęsknoto	Number
trzeźwe	trzeźwa	Gender
nośniku	nośnikach	Number
mnożniku	mnożnikowi	Case
betonuj	refuj	lemma
topnika	topniku	Case
mżawkom	mżawek	Case
tradycyjnemu	tradycyjnej	Gender
geniusza	geniuszów	Number
zgubom	zgubie	Number
maskami	maską	Number
szkwałowi	szkwale	Case
emerytury	emerytura	Number
antologią	antologia	Case
bronisz	strzelasz	lemma
wielkość	wielkością	Case
wykorzystująca	wykorzystujące	Gender
związkowcem	związkowca	Case
należałam	należała	Person
kupione	przegapione	lemma
godzien	godne	Gender
entuzjaście	entuzjastach	Number
medyczna	medyczne	Gender
zagonami	zagonem	Number
odchodzące	rozwijające	lemma
metamorficzne	metamorficzna	Gender
lochy	lochami	Case
cięższej	cięższego	Gender
egipskich	egipscy	Case
narządami	narządem	Number
działał	działałeś	Person
piersi	pierś	Number
kozłku	kozłkach	Number
tirówkę	tirówka	Case
najtragiczniejszego	najtragiczniejszej	Gender
literatury	literatura	Number
najdoskonalszy	tajlandzki	lemma
mknięto	świerzbiano	lemma
tuby	tub	Number
interesów	interesu	Number
archeologicznym	archeologicznemu	Case
rybołowach	rybołowie	Number
poczwarkę	poczwarce	Case
zawilcu	zawilcach	Number
esencjonalnej	esencjonalnym	Gender
świetną	świetnym	Gender
szalonej	szaloną	Case
tłumacza	tłumaczu	Case
biura	biur	Number
opierdoliłyście	ubóstwiałyście	lemma
lotu	locie	Case
wdzięczny	wdzięczna	Gender
apsydzie	apsydach	Number
parowałybyśmy	zawarłybyśmy	lemma
wyroki	wyrokom	Case
cyfrowym	samodzielnym	lemma
codziennej	codziennego	Gender
sufitach	sufitami	Case
zabiłam	zabiłem	Gender
sierpniowej	sierpniowego	Gender
złotonośnej	złotonośnemu	Gender
strzemionami	strzemiona	Case
zamkniętą	zamkniętym	Gender
fotografowie	fotografom	Case
jelenim	jelenią	Gender
wybitnej	wybitnym	Gender
napastników	napastnika	Number
Brytyjczykowi	Brytyjczykom	Number
islamskich	islamskie	Case
dzierżący	dzierżące	Gender
bólami	bólem	Number
arytmetyczne	podziemne	lemma
stodoły	stodół	Case
liliowi	topazowi	lemma
partykule	partykułę	Case
półkolistej	półkolistym	Gender
pedagogiem	pedagogami	Number
gepardom	gepardowi	Number
strażaka	strażakiem	Case
magiczne	nowoczesne	lemma
pęknięty	złupiony	lemma
błotnik	błotnika	Case
dziupla	dziuplę	Case
okrętu	okrętem	Case
kontrolować	wyłączać	lemma
loch	lochy	Number
zakochane	zakochany	Gender
ofiary	ofiarom	Case
morze	morzu	Case
pietruszki	pietruszkę	Number
słońca	słońcu	Case
apsydzie	apsydą	Case
wypadek	wypadku	Case
strukturami	strukturą	Number
brusie	brus	Case
chłodnik	chłodniki	Number
uziemienie	uziemieniu	Case
współpracownikiem	współpracownikami	Number
igła	igły	Case
mięsny	mięsna	Gender
maskowań	śpiewaków	lemma
opisujący	szantażujący	lemma
tymianek	tymianki	Number
mangusty	mangustę	Number
znalazłbym	znalazłbyś	Person
zwyklejszego	zwyklejszej	Gender
zasadę	zasady	Number
kalkulatora	zwierzęcia	lemma
doiłabyś	doiłbyś	Gender
mieszkańcem	mieszkaniec	Case
wybielacze	wybielaczach	Case
kręcimy	widzimy	lemma
korzystano	zabito	lemma
kotleta	owsa	lemma
przysięgach	przysięgi	Case
koryta	koryto	Number
wozówkę	wozówka	Case
broszury	broszurom	Case
losami	losem	Number
zalogujecie	zaloguje	Person
kciukami	kciukach	Case
atmosferyczny	atmosferyczne	Gender
przekonaniom	przekonania	Case
bransoletki	bransoletek	Number
podświadome	podświadomy	Gender
zderzakiem	zderzak	Case
chorobom	chorobie	Number
altówka	altówki	Number
grzybowi	samotni	lemma
chmurką	wyłączaniem	lemma
kazanie	kazania	Number
szydeł	szydła	Number
rośliny	roślinami	Case
komplement	komplementy	Number
litewskiej	litewskim	Gender
miastom	miasta	Case
płciowy	płciowe	Gender
cytwary	cytwar	Number
przedwczesnym	przedwczesnej	Gender
partyzantka	partyzantką	Case
nazistów	nazisty	Number
diagnozujemy	pierdzimy	lemma
maso	masa	Case
nieznośnym	nieznośne	Case
zostawiłaś	zostawiłeś	Gender
googluje	googlujesz	Person
zbieżnością	zbieżności	Case
mijający	tłumaczący	lemma
mięśnie	mięsień	Number
polisacharydami	polisacharydem	Number
ciekłego	ciekłej	Gender
cerkiewnosłowiańskie	poniemieckie	lemma
cewniku	cewniki	Number
radzicie	radzisz	Person
podane	zmienione	lemma
pozwalajmy	pozwalajcie	Person
żakietu	żakiet	Case
nazistę	nazistów	Number
cudzoziemca	cudzoziemców	Number
żałobie	żałobę	Case
chemików	chemika	Number
spieprzałeś	spieprzał	Person
igrałbym	żartowałbym	lemma
agresji	plotce	lemma
wielokącie	wielokąty	Number
kontach	koncie	Number
lądowiska	lądowisk	Number
uderzyłem	uderzyłeś	Person
aspartamem	aspartamie	Case
myśliciela	myślicielem	Case
gorącym	gorącą	Gender
przeszkodę	przeszkodzie	Case
kamerę	kamery	Case
oskarżać	słyszeć	lemma
karłom	karłach	Case
pralkę	pralko	Case
kartografie	kartografowi	Case
nagonki	nagonce	Case
tensorach	tensorami	Case
ścieżkach	ścieżce	Number
kopaliśmy	kopali	Person
łotewskie	łotewska	Gender
przeczytania	przeczytaniu	Case
nadepnęłybyście	nadepnijcie	Mood
zwroty	zwrot	Number
kurzawkę	kurzawki	Number
łacińskim	niewystarczającym	lemma
jednogłośni	wiślani	lemma
leasingowe	wonne	lemma
traciłem	traciłam	Gender
popełni	zapamięta	lemma
demontowane	zburzone	lemma
bezpodstawnego	wesołego	lemma
uderzające	uderzająca	Gender
świerk	świerki	Number
prześcieradła	prześcieradeł	Number
kotłów	kotłach	Case
pojęcie	pojęcia	Number
gładką	gładkie	Gender
zaimki	zaimek	Number
historii	historiach	Number
arcydzieła	arcydzieł	Number
arktycznego	rumuńskiego	lemma
pierwszyznami	pierwszyzny	Case
błonie	błonia	Case
privom	privów	Case
darowiznom	darowiźnie	Number
poważniejsza	poważniejszy	Gender
dwoista	ostra	lemma
prawdziwej	prawdziwym	Gender
nazywa	smakuje	lemma
ujadajcie	ujadałybyście	Mood
antylopy	antylopa	Number
marto	rozproszono	lemma
znalazłbym	znalazłby	Person
kronikarzy	murzynów	lemma
notatka	notatki	Number
brzuchy	brzuch	Number
przystająca	przystający	Gender
pokazywane	zachowane	lemma
islamskich	wygodniejszych	lemma
fonetycznego	ruchomego	lemma
cerkwi	cerkwie	Number
analizowana	usuwana	lemma
opiekujemy	znajdujemy	lemma
kryzysy	kryzysie	Number
jednokierunkowe	sefardyjskie	lemma
wanna	wanny	Case
kolejom	kolejami	Case
filtrów	filtrach	Case
ignorowalibyście	przeżylibyście	lemma
strąków	strąkach	Case
dotykałabyś	dotykałabym	Person
czadem	czadu	Case
diagramie	diagramy	Number
gwiżdżące	pozostające	lemma
grążela	wołu	lemma
przejściu	przejściach	Number
oblicza	oblicze	Number
opiniom	opinii	Case
pokazywani	spieprzeni	lemma
entuzjasta	entuzjasty	Case
schlebiał	schlebiała	Gender
świrów	świry	Case
ostrzegały	tworzyły	lemma
planuje	planuję	Person
profesorze	profesorowie	Number
drogim	drogiej	Gender
najłatwiejszej	przechodniej	lemma
weganami	weganie	Case
namawiany	wylany	lemma
rękawie	rękaw	Case
nić	nici	Number
sądzie	sądu	Case
pionowego	pionowej	Gender
grzbietami	grzbietach	Case
demokratę	demokratów	Number
cofana	cofane	Gender
lotnictwa	naszyjniki	lemma
ciężarnych	nieumarłych	lemma
abaka	abaki	Number
jasnoszarego	jasnoszarej	Gender
akcjonariuszy	akcjonariusza	Number
emocjom	emocjach	Case
dyftongów	dyftongi	Case
pozoru	pozór	Case
pamiętaliśmy	szantażowaliśmy	lemma
błyskawice	błyskawic	Case
ładowaniem	ładowaniu	Case
ambulansy	ambulansów	Case
latarników	latarnicy	Case
zmywarko	zmywarką	Case
batoniku	batonik	Case
marokańskiego	powszechniejszego	lemma
łososiowa	łososiowej	Case
poznański	poznańskie	Gender
namioty	namiot	Number
jaskiniami	jaskiniom	Case
otaczałyście	potwierdziłyście	lemma
płomykówki	płomykówka	Number
śrubeczki	śrubeczkę	Number
wełny	wełna	Number
betonowe	rzeczne	lemma
zwyklejszą	zwyklejszym	Gender
wozówkami	wozówki	Case
głośnego	głośnej	Gender
szalone	szalona	Gender
ukradnie	ukradniemy	Person
passacie	passaty	Number
technik	techniki	Number
przekleństwem	przekleństwami	Number
gwizdku	gwizdkiem	Case
marliśmy	przytuliliśmy	lemma
agresywnego	rodzinnego	lemma
ciężarówki	ciężarówko	Number
numerujący	zapominający	lemma
hokeiście	hokeistę	Case
śmiałem	śmiałam	Gender
wyprasowałaby	wyprasowałby	Gender
kolebki	kolebkę	Number
gęstszego	gęstszej	Gender
duszy	duszo	Case
mijamy	rodzimy	lemma
mięśniom	mięśniami	Case
plemiennym	plemiennej	Gender
nazwy	nazwą	Case
kandydatem	kandydata	Case
ministerstwa	ministerstwami	Case
dzwonek	dzwonka	Case
używacie	używam	Person
nastroju	nastrojów	Number
zeszłej	zeszłym	Gender
mglisty	mgliste	Gender
topolowej	topolowego	Gender
specjalnym	specjalną	Gender
beczułkom	beczułkach	Case
kotłowni	wron	lemma
biografowi	biografie	Case
kiczu	kicze	Number
katechizmie	katechizmy	Number
metropolici	metropolitami	Case
tensorową	tensorowym	Gender
myląca	tracąca	lemma
malinowego	wojennego	lemma
plakatów	plakatu	Number
kukałbyś	żałowałbyś	lemma
jasną	przechodnią	lemma
bezchmurny	nowy	lemma
karmiłem	zakochałem	lemma
kosztujesz	kosztujecie	Person
huragany	huraganów	Case
aptekarskiego	somalijskiego	lemma
spadająca	spadający	Gender
czerpane	czerpany	Gender
wasalem	wasalowi	Case
poproszą	wyłudzą	lemma
zesrajcie	zesraj	Person
cosinusy	cosinus	Number
bębniące	wybuchające	lemma
dwuwymiarowej	znacznej	lemma
galernikami	galerników	Case
łączem	łączu	Case
alpako	alpaką	Case
akuszerki	akuszerek	Number
ulewy	ulew	Number
cyberprzestrzeniach	cyberprzestrzeni	Number
komy	komę	Case
pralkę	pralki	Number
dato	dacie	Case
napiszesz	zauważysz	lemma
nieodpowiedzialną	nieodpowiedzialne	Gender
istnienia	istnień	Number
rekonstrukcje	rekonstrukcja	Number
podzbiorami	podzbiory	Case
jodłowego	transkrypcyjnego	lemma
internatu	internat	Case
dostawajmy	dostawałybyśmy	Mood
kroków	kroku	Number
demontowałybyście	demontowałybyśmy	Person
kundla	sekstę	lemma
dekoracyjny	dekoracyjna	Gender
żelazek	żelazka	Number
jurajską	jurajskim	Gender
przyjaznego	przyjaznej	Gender
karkołomna	karkołomną	Case
boksy	boks	Number
uczennic	uczennicach	Case
przetoki	przetokę	Number
mulim	przymiotnikowym	lemma
pielgrzymką	pielgrzymkami	Number
samorzutnego	samorzutnej	Gender
ocaliłoby	ocaliłaby	Gender
narciarzami	narciarzem	Number
zabawniejszą	zabawniejsze	Gender
doskonalszego	skąpego	lemma
stron	stronom	Case
dokerze	dokerowi	Case
bohaterce	bohaterką	Case
urzędasów	urzędasa	Number
myślicieli	myślicielami	Case
ziejecie	ziałyście	Tense
alkeny	alkenach	Case
właściwym	właściwą	Gender
joker	jokery	Number
czai	czają	Number
astronauci	astronautów	Case
galaktyki	galaktyka	Number
wojną	wojnami	Number
banglaliście	przeprosiliście	lemma
wygłupach	wygłupie	Number
artystkami	strategiami	lemma
policjantki	policjantek	Number
goździk	goździki	Number
luksusach	luksusami	Case
słyszymy	słyszy	Person
deskarze	deskarzu	Number
macintoshem	macintoshowi	Case
rodom	rodach	Case
stypendiom	stypendiami	Case
rzymską	rzymskie	Gender
kierowniczką	kierowniczkę	Case
husyckim	podziemnym	lemma
otaczałaś	zaprosiłaś	lemma
szklarnię	szklarnią	Case
silnikom	silnikach	Case
gołębiętami	gołębięciem	Number
elitach	elicie	Number
nawiedzonym	nawiedzonej	Gender
uśmieszki	uśmieszek	Number
agat	agacie	Case
komunistą	rafandynką	lemma
sześcian	sześcianem	Case
ameby	ameb	Number
bezwarunkową	bezwarunkowym	Gender
inteligentne	wrogie	lemma
ula	ulowi	Case
wyjmę	wyjmiesz	Person
drażniące	wahające	lemma
esencje	narty	lemma
największe	największy	Gender
plątaninę	plątaniny	Number
lupy	wieńce	lemma
zabierzesz	zabiorę	Person
pamiętamy	pamiętasz	Person
publiczna	publiczne	Gender
latało	wypędziło	lemma
przepije	zniszczy	lemma
rozmarynie	rozmarynu	Case
prędkości	prędkością	Case
foremny	foremne	Gender
ogrodnikiem	ogrodnik	Case
charytatywnym	najwierniejszym	lemma
zawodowemu	zawodowej	Gender
gliniarzy	sromów	lemma
oficerzy	oficerze	Number
ściągnąwszy	zasłużywszy	lemma
przeciwsłonecznej	przeciwsłonecznym	Gender
wąską	wąskiej	Case
tratwami	tratwy	Case
rysiom	rysiowi	Number
stanowiskiem	stanowisku	Case
iły	iłów	Case
medalista	medaliści	Number
kaszubskie	pocztowe	lemma
dudziarzy	dudziarza	Number
grzybowa	grzybowe	Number
abonują	uczą	lemma
mieszkaniach	mieszkaniu	Number
czeskim	czeskiej	Gender
nadgarstek	nadgarstku	Case
sudecka	sudecki	Gender
bluzgająca	tonąca	lemma
leśny	nigeryjski	lemma
suszarki	suszarka	Number
żądle	żądłach	Number
spiskami	spiskiem	Number
obiektami	obiektach	Case
rurociągiem	rurociągami	Number
boskością	boskościami	Number
zwarcie	zwarcia	Number
łasicą	łasicami	Number
kumające	otaczające	lemma
nowe	nowego	Case
szopów	szopy	Case
lampie	lampach	Number
gliwickiego	gliwickiej	Gender
zawrą	zawrze	Number
przygotowanej	przygotowanemu	Gender
mowie	mowę	Case
ponadprzeciętną	ponadprzeciętnym	Gender
szkodziło	szkodził	Gender
nagłego	wybuchowego	lemma
ćwiczone	zjedzone	lemma
obietnicach	obietnicy	Number
pędzono	wspominano	lemma
selenie	selenu	Case
luźniejszy	półfinałowy	lemma
kozic	kozicy	Number
wichrem	wichrze	Case
nieoficjalnej	nieoficjalnego	Gender
krewną	krewne	Number
kleptomanią	kleptomanio	Case
parodiach	parodii	Number
kuwejckie	kuwejcki	Gender
aldehydzie	aldehyd	Case
organizmowi	organizmie	Case
polskich	polskiego	Number
grzeszyłaś	żyłaś	lemma
dekrecie	dekrety	Number
kochanki	styczne	lemma
czynniki	czynnikach	Case
magnetowidzie	magnetowidy	Number
mieszkańcom	mieszkańcowi	Number
promami	promem	Number
jasnożółtymi	jasnożółtym	Case
koszmar	koszmary	Number
jazzowa	jazzowe	Gender
postradani	spotkani	lemma
zwartym	zwartą	Gender
heksametr	siniak	lemma
językowe	niskie	lemma
termometry	termometr	Number
atrakcyjniejszej	trygonometrycznej	lemma
drumlo	nonanie	lemma
lidze	ligo	Case
ar	ary	Number
tanina	taniną	Case
machałaby	wkurwiałaby	lemma
rybałcie	rybałta	Case
dystansu	ostrzeżenia	lemma
pogadacie	pogadałyście	Tense
cytuj	cytujcie	Person
ćwiczeni	zaprowadzeni	lemma
lotach	loty	Case
sarno	sarny	Case
polewki	polewka	Number
nadgorliwością	nadgorliwości	Case
pachy	pacha	Number
wargę	warga	Case
gadają	szantażują	lemma
czarodzieja	czarodziejowi	Case
odbudowalibyśmy	odbudowaliby	Person
koszenie	przeczytanie	lemma
lustrzankę	lustrzanki	Number
otrzymacie	zadacie	lemma
napiszmy	napisałybyśmy	Mood
procesor	procesory	Number
bednarzem	woskownicą	lemma
reaktory	reaktorze	Number
berberyjskiego	poprawnego	lemma
pastwiskami	pastwiska	Case
smutniejszej	smutniejszemu	Gender
domku	domek	Case
gepard	gepardzie	Case
naprawiający	wydostający	lemma
majsterkujący	rozwijający	lemma
godna	turecka	lemma
największej	największego	Gender
brzydkiego	wygodnego	lemma
połknięta	uderzona	lemma
kolonistów	kolonisty	Number
stalagmity	stalagmit	Number
pytę	pyty	Number
największą	największym	Gender
moralne	zamarznięte	lemma
tygodniu	tygodnie	Number
balustradą	balustradami	Number
ludożercy	ludożerca	Number
kielichy	kielichami	Case
komentowałabym	puszczałabym	lemma
rzeczywistą	rzeczywistym	Gender
internisty	internistów	Number
kolejowy	kolejowa	Gender
krymskotatarskie	zachodnie	lemma
marokański	ujemny	lemma
czując	zachodząc	lemma
sfałszowałabym	sfałszowałbym	Gender
synowych	synowej	Number
brytyjskie	trudne	lemma
agnostyczny	agnostyczne	Gender
liściowym	rodzinnym	lemma
bliższym	bliższą	Gender
podstępów	podstępu	Number
wandalizmem	wandalizmie	Case
maso	masie	Case
rozbita	rozbite	Gender
lokówko	powiecie	lemma
piwie	piwach	Number
obrażamy	obrażasz	Person
galopujący	galopująca	Gender
siekierę	siekiery	Number
zazdrosna	zazdrosny	Gender
bohatyrnie	sprawdzi	lemma
miętowa	niema	lemma
liczebników	liczebnika	Number
kamiennego	zwięzłego	lemma
juliańskiego	juliańskiej	Gender
dorzecza	dorzeczy	Number
najintymniejszego	niewinnego	lemma
kark	paleontologa	lemma
mierzisz	mierżę	Person
upust	upusty	Number
gruszach	gruszami	Case
szereg	szeregi	Number
pirat	piraci	Number
przedsiębiorstwa	przedsiębiorstwem	Case
obrazi	wyleje	lemma
jaszczurze	jaszczurem	Case
zjawiskom	zjawisku	Number
śnijcie	śnijmy	Person
głupie	głupią	Gender
psem	psami	Number
kuchenkę	kuchenki	Number
likiem	liku	Case
lepszą	suchą	lemma
bolidzie	bolidy	Number
syn	synowie	Number
głośnej	głośnemu	Gender
noszą	uprawiają	lemma
metalurgiczne	spore	lemma
dobru	wymiocinach	lemma
pocałunek	pocałunku	Case
chemikach	chemiku	Number
światłowodzie	światłowody	Number
ostrzy	ostrzami	Case
pugilaresy	pugilares	Number
sabotaż	sabotaże	Number
kaski	kasku	Number
meteorytów	meteorytu	Number
trolejbus	trolejbusy	Number
płycie	płytom	Number
empirycznego	empirycznym	Case
planie	planach	Number
helisie	helisę	Case
metodystycznego	sinego	lemma
opisujące	żyjące	lemma
chadzasz	podziwiasz	lemma
zdrowym	zdrowej	Gender
angina	anginie	Case
jarzębinami	jarzębiną	Number
kontraście	kontrasty	Number
sidła	sideł	Case
marudziłabyś	zimowałabyś	lemma
najpróżniejszego	wietrznego	lemma
płace	płaco	Number
papryka	papryki	Number
kropli	kroplą	Case
lalka	lalki	Number
ołówek	ołówki	Number
tatuaż	tatuaże	Number
genetycznym	genetyczne	Case
niekorzystnego	niekorzystnej	Gender
jaskinią	jaskiniami	Number
słownictwa	słownictwem	Case
lakoniczne	niebieskawe	lemma
amharskim	radiofonicznym	lemma
najwłaściwszym	najwłaściwsze	Case
słuchawki	słuchawce	Case
wąskie	wąska	Gender
temperaturze	temperaturach	Number
semantyka	semantyki	Number
starej	starym	Gender
rękawiczkę	rękawiczki	Number
cechami	cechach	Case
błonie	błonia	Number
miedziany	najsprawniejszy	lemma
chwastami	chwastem	Number
gejszę	gejsze	Number
całe	szafirowe	lemma
włodarzami	włodarze	Case
milimetry	zapałki	lemma
niejakim	niejaką	Gender
dyskretniejszego	optymistycznego	lemma
dochodzisz	dochodzą	Person
wojskowej	wojskowym	Gender
wspólnotom	wspólnoty	Case
policjantom	policjantów	Case
armeńskiemu	armeński	Case
biegające	zbierające	lemma
tajnej	tajnemu	Gender
klacz	klaczy	Case
kolejne	proste	lemma
ciepłemu	ciepłej	Gender
groziło	skakało	lemma
cukierki	cukierek	Number
uprawiana	uprawiany	Gender
dożycie	wzięcie	lemma
najbiedniejszy	najbiedniejsza	Gender
rzadszym	rzadszą	Gender
krąglejszego	krąglejszej	Gender
sonety	sonecie	Number
napletkiem	napletek	Case
obrzęku	obrzękach	Number
oskarżały	zabrały	lemma
błędnemu	najsłoneczniejszemu	lemma
formalnym	formalnej	Gender
jaskinie	jaskiniami	Case
zapas	zapasem	Case
entomolog	entomolodzy	Number
koszmarnym	koszmarnego	Case
zamówiona	zamówione	Gender
izotopach	izotopy	Case
organistami	organistą	Number
mrze	uczęszcza	lemma
buntowniku	buntownika	Case
jednokierunkową	romantyczną	lemma
pedryla	pedryl	Case
zbioru	zbiorów	Number
kosmatej	sejsmicznej	lemma
zainteresowań	zainteresowania	Case
pogadałabyś	pogadałbyś	Gender
jajecznego	płynnego	lemma
strzelbo	strzelby	Number
księże	księża	Number
mediolańskie	mediolańską	Gender
maciczne	niderlandzkie	lemma
rycerzowi	rycerzu	Case
certyfikaty	certyfikat	Number
wybredna	wybredny	Gender
fiołkami	fiołkiem	Number
szafie	szafą	Case
przepięknego	przepięknej	Gender
pokona	wywoła	lemma
karetkę	karetce	Case
rzeczoznawców	rzeczoznawcy	Case
ziele	zioła	Number
cele	celę	Number
turyście	turystom	Number
chóry	chórze	Number
elektronową	elektronowym	Gender
aktorką	aktorce	Case
drapieżniki	drapieżnik	Number
automatem	automatami	Number
kwiatowej	kwiatowego	Gender
łachman	łachmanie	Case
pikawami	pikawą	Number
uczniem	uczeń	Case
pobrało	pobrała	Gender
nury	nur	Number
szwagrowie	szwagrów	Case
choinki	choinek	Number
sinego	sine	Case
działałoby	działałaby	Gender
koszmarze	koszmaru	Case
wydmową	wydmowe	Gender
chrystadelfianie	chrystadelfianin	Number
budzone	znalezione	lemma
rzutu	rzutów	Number
miłego	ontologicznego	lemma
molu	ozdobo	lemma
republice	republikach	Number
posłuchania	posłuchaniem	Case
kanadyjskie	kanadyjskiego	Case
walców	walce	Case
sferę	sferze	Case
śledziowemu	śledziowej	Gender
gramatykach	gramatyce	Number
leśny	leśna	Gender
elektrolitów	elektrolitami	Case
szlachetną	szlachetne	Gender
wirusowej	wirusowemu	Gender
upokorzenie	upokorzenia	Number
podniosłbym	zasłużyłbym	lemma
rzuciłyście	rzucicie	Tense
kuratorów	kuratorzy	Case
semestrze	semestry	Number
archeologiczny	psychopatyczny	lemma
powierzchniach	powierzchni	Number
nadziejo	nadzieja	Case
wierzbie	wierzby	Case
promieniem	promienia	Case
abisyńskim	niepewnym	lemma
przestrzegalibyśmy	przestrzegalibyście	Person
ofiarami	ofiarą	Number
modlilibyśmy	rzucilibyśmy	lemma
magnetycznego	poważniejszego	lemma
bale	bal	Number
terrorystycznego	terrorystycznej	Gender
sejsmiczną	sejsmicznej	Case
hojnej	polnej	lemma
bohaterze	połykanie	lemma
chowały	chowałyście	Person
żebraka	żebraków	Number
pomagam	pomaga	Person
przeszczepie	przeszczepy	Number
całkowego	całkowej	Gender
wiecach	wieców	Case
bicz	bicza	Case
kaznodzieje	kaznodziei	Case
goniące	wyglądające	lemma
zaciążyła	zaciążył	Gender
baszty	baszta	Number
pierników	piernika	Number
światłości	światłość	Number
podchodzili	przeczytali	lemma
włączająca	włączający	Gender
blendzie	blendy	Case
sojuszu	sojuszy	Number
służbami	służbą	Number
lekarza	lekarzowi	Case
śnieżycy	śnieżyc	Number
zwierzęcia	zwierząt	Number
kuchenki	kuchenka	Number
machający	szkodzący	lemma
rodzynek	rodzynki	Number
skarbonek	skarbonki	Number
terrorystycznym	terrorystyczną	Gender
wyniki	wynik	Number
pomoce	pomocy	Number
taras	tarasu	Case
formalny	formalna	Gender
gwizdek	gwizdki	Number
połączona	ukryta	lemma
drzewostany	drzewostanami	Case
kłów	kła	Number
korzysta	wymyśla	lemma
szyby	szybę	Number
plotkowała	wracała	lemma
biblijnym	biblijnej	Gender
opisywane	zakładane	lemma
maju	maj	Case
wkurwiała	wkurwiało	Gender
potom	potowi	Number
płotów	płotach	Case
odlocie	odloty	Number
gwizdałyby	zbierałyby	lemma
mityczne	mityczną	Gender
kwietnia	kwiecień	Case
epoki	epokę	Number
kablówki	kablówce	Case
zasady	zasadzie	Case
cmentarze	cmentarzu	Number
korsykańskim	wydumanym	lemma
chrzcić	ziać	lemma
sejsmiczne	sejsmiczną	Gender
opatentowali	sprawdzali	lemma
parestezje	parestezja	Number
bariony	barion	Number
śmiertelnikiem	śmiertelnika	Case
todze	togo	Case
mangi	mang	Number
badaniem	badaniu	Case
siły	sił	Number
metodystyczne	metodystyczny	Gender
agregatach	agregatami	Case
losową	losowe	Gender
prądowi	prądom	Number
alternatywnym	alternatywnej	Gender
psiankom	psiance	Number
gdańskiego	gdańskich	Number
wódkę	wódki	Number
gluony	gluonów	Case
partnerom	partnerach	Case
spojrzenie	spojrzenia	Number
płodnego	płodnej	Gender
dżumę	dżuma	Case
kolumbijskich	kolumbijskimi	Case
obywatelki	obywatelka	Number
rybozą	rybozy	Case
gotyckim	gotycką	Gender
trawa	trawą	Case
ozdobo	ozdobie	Case
husyckich	ortodoksyjnych	lemma
piekarnie	piekarniach	Case
nauczycielowi	nauczyciel	Case
nagich	rewolucyjnych	lemma
argentyńska	argentyński	Gender
pokonaj	zazdrość	lemma
dwuznaczna	dwuznaczny	Gender
mysikrólikiem	mysikrólikami	Number
wysyłasz	wysyłacie	Person
luźniejszej	luźniejszym	Gender
sraczami	sraczem	Number
chody	widzenia	lemma
sprzątaczko	sprzątaczki	Case
raków	raki	Case
deweloperem	deweloper	Case
średnikami	średnikiem	Number
administratorami	administratorom	Case
drogowskazami	drogowskazem	Number
kuchnie	kuchni	Case
pijanym	pijanych	Case
najpotężniejsze	przyjaźniejsze	lemma
systematyczną	systematyczne	Gender
potopami	potopy	Case
broszury	portmonetki	lemma
plujmy	pluj	Person
rabanowi	rabanu	Case
potopem	potopami	Number
profesorowie	profesor	Number
ptasią	ptasiej	Case
wyż	wyże	Number
pocztówki	pocztówce	Case
koncertami	koncertach	Case
milczącym	milczące	Case
bułeczce	bułeczkę	Case
poznamy	pozna	Person
tonie	tonowi	Case
strzału	strzał	Case
twórczej	twórczemu	Gender
paty	pata	Number
polonijnemu	polonijnej	Gender
cytowany	rozmyty	lemma
otruliby	zadzwoniliby	lemma
zewnętrzne	zewnętrzny	Gender
lekkoatletkę	lekkoatletki	Number
dokładniejszym	wyborczym	lemma
płynnym	płynnej	Gender
miską	misko	Case
pierdziały	zrozumiały	lemma
darami	darem	Number
kabaczek	kabaczki	Number
himalajskiej	himalajskim	Gender
konwalijki	konwalijka	Case
konkurował	spadał	lemma
mezuzach	mezuzy	Case
hawajską	hawajska	Case
ważniak	ważniakiem	Case
komitetów	komitetu	Number
bębnom	bębnach	Case
szyja	szyje	Number
klozet	syna	lemma
papę	papy	Number
polecała	studiowała	lemma
bociany	bociana	Number
młodszego	młodszej	Gender
kłos	zmierzch	lemma
prominentom	prominentów	Case
doskonałym	doskonałej	Gender
chorwackiemu	chorwackiej	Gender
cios	pustynia	lemma
płazach	płazom	Case
gorzejące	znaczące	lemma
żbiku	żbik	Case
podpalenia	podpaleń	Number
dzisiejszej	pionowej	lemma
islamskiej	islamskiemu	Gender
kopcami	ostatkami	lemma
algorytmem	algorytmowi	Case
telefon	telefony	Number
kosmonautki	kosmonautką	Case
konkretna	podatna	lemma
kaci	katami	Case
morderczyniom	morderczyni	Number
zespołowi	zespołom	Number
odjebałabyś	zarżnęłabyś	lemma
ateistyczny	ateistyczne	Gender
kartograficznej	kartograficznym	Gender
płytszą	płytszym	Gender
napis	napisie	Case
dzisiejsze	sztuczne	lemma
jaskółkę	jaskółką	Case
przestronnej	przestronnego	Gender
palmową	palmowym	Gender
gorączce	gorączki	Case
drużynie	drużynach	Number
nauką	nauce	Case
działacie	psujecie	lemma
październikowa	październikowy	Gender
debilem	organistą	lemma
namawiał	potwierdził	lemma
barachła	baracheł	Number
benzenie	benzenem	Case
dyszy	dysz	Number
stole	stołach	Number
czasownikom	czasowników	Case
opowiadało	opowiadał	Gender
wyprasowały	wyprasowałyśmy	Person
australijskiemu	australijskiej	Gender
kaczko	kaczką	Case
skończonego	skończonej	Gender
pandemiach	pandemiom	Case
najebane	najebanym	Case
muzułmaninowi	muzułmanom	Number
kremie	kremy	Number
dziedziny	szczurzyce	lemma
niemieckiej	niemieckiego	Gender
kuca	wyszukiwarkę	lemma
książkowe	wiejskie	lemma
banie	banię	Number
lawa	parzydełko	lemma
porażenie	porażeniu	Case
gruzińskiemu	gruzińskiej	Gender
banki	banku	Number
kolejarzy	kolejarze	Case
hydraulicznego	owczego	lemma
orlikiem	orlika	Case
firmom	firmy	Case
melinie	melinę	Case
sromowi	sromu	Case
najchciwsza	najchciwszy	Gender
skamieniałość	skamieniałości	Number
mierze	miara	Case
odkrytej	odkrytemu	Gender
pisku	piskach	Number
meduzę	meduzy	Number
gotyckie	niedoszłe	lemma
elektryka	elektryków	Number
zięba	ziębę	Case
funkcji	funkcjom	Number
trzykrotki	trzykrotek	Number
informatyków	informatyka	Number
zszywacze	zszywacz	Number
asturyjskiego	odpowiedniego	lemma
monogamię	monogamii	Case
negocjowałybyście	negocjujcie	Mood
dzióbkami	dzióbkiem	Number
działanie	działania	Number
baniom	banii	Number
opisy	opisach	Case
transformatorze	transformator	Case
ekstazę	ekstazo	Case
bogacz	bogaczowi	Case
delikatniejsze	przeźroczyste	lemma
ceniły	wygrały	lemma
malinki	malinek	Number
plazmę	plazmo	Case
goli	golisz	Person
świeckich	świeckiego	Number
nacjonalistycznego	poprzedniego	lemma
prawosławne	prawosławnych	Case
dostarczany	dostarczana	Gender
powojenne	powojenną	Gender
jodły	jodłach	Case
nałogom	nałogów	Case
muzułmańskie	niewyobrażalne	lemma
koszcie	kosztem	Case
dachówek	dachówki	Number
taborami	tabory	Case
urodzinową	urodzinowa	Case
sielankowego	sielankowej	Gender
marząc	szukając	lemma
warkocza	warkoczu	Case
bacie	bat	Case
wina	wino	Number
stogach	stogu	Number
najgorszy	najgorsza	Gender
delikwenta	delikwencie	Case
dodać	zmyślić	lemma
cen	cenach	Case
zmywarką	zmywarki	Case
spieprzysz	ujebiesz	lemma
rodami	rodem	Number
diecezją	diecezjami	Number
skroniach	skroni	Number
beczułki	beczułko	Number
porażką	porażce	Case
gapiłem	zachowałem	lemma
kartograficzne	nieodpowiedzialne	lemma
kwadratowe	kwadratowa	Gender
jajeczne	jajeczną	Gender
właściwa	właściwe	Gender
okrągły	okrągłe	Gender
kań	kaniami	Case
egzorcyzmach	egzorcyzmów	Case
ginekologicznej	psychosomatycznej	lemma
uli	ula	Number
cywilnemu	psychologicznemu	lemma
rat	raty	Number
potrawą	potrawami	Number
akcenty	akcent	Number
kościoły	kościół	Number
węże	wężom	Case
najpoważniejsze	sierpniowe	lemma
najliczniejszą	pilską	lemma
rymu	rymów	Number
najgłębszą	najgłębszej	Case
wzajemnego	wzajemnej	Gender
budującej	budującym	Gender
najjaśniejszy	najjaśniejsza	Gender
muszkietów	muszkietu	Number
rozszczepieniem	rozszczepienia	Case
wyroczniami	wyrocznią	Number
zachodom	zachodowi	Number
akcentu	akcentów	Number
datą	dacie	Case
asymptotach	asymptocie	Number
szerokość	szerokości	Number
odkrywałyśmy	wykitowałyśmy	lemma
katedry	katedrami	Case
bażanta	tragedię	lemma
kuchniom	kuchni	Number
epoką	epoce	Case
podwodnej	podwodnym	Gender
żeli	żelu	Number
bohaterski	bohaterskie	Gender
afrykańskie	wybredne	lemma
całkowego	ostrożnego	lemma
skazańcowi	skazańcom	Number
kaszlę	życzę	lemma
matkojebcom	matkojebcy	Number
dotknął	spróbował	lemma
ogień	ognie	Number
tempa	tempo	Number
najdawniejszej	samolubnej	lemma
lotniskowca	lotniskowców	Number
poprowadzony	robiony	lemma
gadam	pojmuję	lemma
Gruzinach	Gruzinie	Number
lejek	lejki	Number
odwiedza	widzi	lemma
ludobójstwa	treoniny	lemma
adresy	adresach	Case
banglając	padając	lemma
kolanowa	najszczersza	lemma
trucizny	truciznami	Case
ścisłych	ścisłym	Case
warszawianek	warszawianki	Number
zakładała	zakładało	Gender
unik	uniki	Number
promenady	promenadzie	Case
Czesi	Czech	Number
kosmonautów	kosmonautę	Number
towarzyskie	towarzyski	Gender
nerwy	nerwie	Number
wiertarka	wiertarki	Number
naprawiać	uczyć	lemma
poprzednimi	poprzednim	Case
podróży	podróżom	Number
garbie	garby	Number
selerowej	selerowego	Gender
ingerencja	styl	lemma
kryjówek	obiadów	lemma
pluj	smakuj	lemma
modli	potrzebuje	lemma
używamy	używam	Person
gazowej	gazowym	Gender
gettami	getta	Case
przęsło	przęsła	Number
sobowtór	sobowtóry	Number
daktyle	daktyl	Number
owsianym	owsianą	Gender
tokarza	tokarzy	Number
japy	śpiewaczki	lemma
zmęczonego	zmęczonej	Gender
dżojstika	dżojstików	Number
zagrodą	zagrodami	Number
bezrobotne	bezrobotnymi	Case
konsekwencji	konsekwencjach	Number
jednokierunkowym	jednokierunkowej	Gender
więcierzy	więcierza	Number
edytowana	wylana	lemma
algebrom	algebrze	Number
przekaźnikach	przekaźniku	Number
saksofonistkom	saksofonistce	Number
castingiem	casting	Case
najchudszej	najchudszemu	Gender
bezbożnym	zręcznym	lemma
oddamy	oddam	Person
niegrzeczny	niegrzeczne	Gender
ekosystemem	ekosystemie	Case
świerszcza	świerszcz	Case
pocieszę	zgubię	lemma
wahania	wahań	Number
dowiedzą	dowiedziały	Tense
regularnego	regularnej	Gender
nieprzyjemną	nieprzyjemne	Gender
poprowadzona	zestawiona	lemma
młodszą	młodsze	Gender
cieńsze	suche	lemma
lustrzaną	lustrzanym	Gender
pałko	pałce	Case
grzęzłabyś	proponowałabyś	lemma
ściągniemy	zamkniemy	lemma
dumę	dumy	Number
aberracje	aberracjo	Number
ogarze	ogarach	Number
owsiana	owsiane	Gender
kuropatwę	kuropatwy	Number
gazele	gazela	Number
obiecuj	świerzbij	lemma
rączki	rączkami	Case
scenariuszach	scenariuszami	Case
dziwy	dziw	Number
nartę	narcie	Case
saneczkarzy	saneczkarze	Case
heretyckiego	heretyckiej	Gender
automatycznej	automatycznego	Gender
absorbowałeś	przeprosiłeś	lemma
jadłowstrętem	jadłowstręt	Case
sklepem	sklepami	Number
dziedzińce	dziedzińcu	Number
magazyny	magazyn	Number
propozycją	propozycja	Case
jaźni	jaźnie	Number
emiratowi	emiratom	Number
piastom	piast	Case
lodówki	lodówek	Number
krysztale	kryształy	Number
działaliśmy	więdnęliśmy	lemma
małpki	małpek	Number
ziemianki	ziemianek	Case
estetycznego	estetycznym	Case
eufemizmy	eufemizmom	Case
porażki	porażkami	Case
połączylibyście	zniknęlibyście	lemma
abonentów	abonenta	Number
zimujesz	zimujecie	Person
żeńskie	żeński	Gender
opisywałabyś	spieszyłabyś	lemma
kolumnach	kolumnie	Number
kolejowych	prostokątnych	lemma
mórz	morza	Number
czółenkach	czółenku	Number
grzecznym	grzecznej	Gender
kokoszko	kokoszki	Number
wrzosem	wrzos	Case
wewnętrzną	wewnętrznym	Gender
koronami	koroną	Number
wietrznym	wietrzną	Gender
atlasach	atlasy	Case
rozproszymy	zamówimy	lemma
darmowa	darmowy	Gender
ablacji	ablacja	Case
zające	zając	Number
poważniejszych	poważniejszego	Number
grabem	grabami	Number
najsystematyczniejszej	najsystematyczniejszym	Gender
kalkulator	szczegół	lemma
deszczu	deszcz	Case
notesy	notesie	Number
barometrach	barometrów	Case
siną	sinym	Gender
łączce	łączkach	Number
morwa	morwy	Number
bukietem	bukietami	Number
grudą	gruda	Case
łamiącej	łamiącym	Gender
slawistycznym	slawistycznej	Gender
podgrzybki	podgrzybek	Number
arcybiskup	arcybiskupem	Case
adekwatną	adekwatnym	Gender
motocyklu	motocykle	Number
wiz	wizy	Number
pizdach	pizdy	Case
codziennej	codzienną	Case
torebce	torebki	Case
bezkształtny	bezkształtna	Gender
alpejskim	nieciekawym	lemma
problemom	problemowi	Number
nibynóżki	nibynóżkach	Case
grubą	szczegółową	lemma
socjalistyczne	socjalistyczna	Gender
kichaliby	kichalibyśmy	Person
kilometrze	kilometrach	Number
rozróżnię	wylaszczę	lemma
groźby	groźbom	Case
niedokonanego	niedokonanej	Gender
wyborcą	wyborcami	Number
głazy	głazie	Number
rybami	ryby	Case
golarki	golarce	Case
cenę	cena	Case
pobrali	rozróżnili	lemma
męskożywotny	pomysłowy	lemma
niskim	niską	Gender
ekipy	ekipa	Number
naukowe	naukową	Gender
grzebie	grzebię	Person
pradziadek	pradziadkiem	Case
serwerze	serwerach	Number
proponujcie	proponuj	Person
lider	lidera	Case
chłodniejszej	chłodniejsza	Case
esemesowałybyśmy	esemesujmy	Mood
transparent	transparenty	Number
todze	toga	Case
sukami	sukach	Case
dodzwoniono	wyjrzano	lemma
barbarzyńskiemu	zeszłemu	lemma
miedzianych	miedzianymi	Case
filmowanie	rzucanie	lemma
lupę	lupy	Number
przedsiębiorców	przedsiębiorcy	Case
kolanowy	kolanowe	Gender
doiłam	wysiadłam	lemma
częsty	częste	Gender
chleb	chleby	Number
najgłębszym	odważnym	lemma
podatkowi	podatkom	Number
województwa	województwo	Number
rudzika	rudziki	Number
tajlandzkie	tajlandzki	Gender
karygodne	karygodna	Gender
starotestamentowej	starotestamentowym	Gender
hebrajskiego	hebrajskiej	Gender
fryzjerce	fryzjerkom	Number
irlandzką	irlandzkie	Gender
Kanadyjczykom	Kanadyjczykami	Case
przerwę	przerwy	Number
tlała	tlało	Gender
wersety	werset	Number
doceniany	wypędzony	lemma
pną	pięły	Tense
koszach	koszu	Number
gettom	getta	Case
bałkańskiemu	osmańskiemu	lemma
dyskotekę	dyskoteki	Case
passatach	passacie	Number
przędze	przędzę	Number
śliwek	śliwkami	Case
koniugację	koniugacje	Number
fałszywemu	fałszywej	Gender
burze	burzach	Case
oknach	okien	Case
guźca	guźców	Number
lekarstwo	lekarstwa	Number
aktem	aktami	Number
kufle	kufel	Number
kasownik	kasowniki	Number
klasztorowi	klasztoru	Case
opowieści	opowieścią	Case
czołgu	czołgów	Number
ptaszyskach	ptaszyskami	Case
pijany	wsparty	lemma
białoruskim	wybuchowym	lemma
kurdyjskiego	kurdyjskiej	Gender
dziobów	dziobu	Number
depeszy	depesza	Case
dokładniejszym	tenisowym	lemma
pędzone	przytulone	lemma
sielankową	sielankowe	Gender
gusty	gust	Number
mianownik	mianowniku	Case
grunt	gruntowi	Case
wzór	wzory	Number
przeźroczystego	przeźroczystej	Gender
radziły	radzą	Tense
różniczkowaniem	różniczkowanie	Case
izby	pielgrzyma	lemma
cery	cerę	Number
drażniła	pożyczyła	lemma
rany	ran	Number
nieprawda	nieprawdy	Number
najdłuższych	świadomych	lemma
bankietów	bankietu	Number
orek	orki	Number
eleganckiemu	eleganckiej	Gender
oświatę	oświaty	Case
ametystach	ametyście	Number
kaszę	kasze	Number
małżonkowi	małżonkom	Number
fizyki	fizyk	Number
Szkotki	Szkotkę	Number
kadłubowi	kadłubem	Case
rozróżni	wylaszczy	lemma
tropikalny	tropikalnym	Case
tlenki	tlenek	Number
kuśnierzy	kuśnierze	Case
niesprawiedliwe	niesprawiedliwym	Case
Irlandkach	Irlandkami	Case
wędkarstwa	wędkarstwu	Case
kłębu	kłąb	Case
progiem	progami	Number
kantaty	kantata	Number
gnijący	organizujący	lemma
owoce	owocu	Number
zdolnych	zdolnego	Number
branżom	branży	Number
słodszą	słodszym	Gender
asemblerach	asemblerze	Number
charaktery	charakter	Number
mechanizmy	słonice	lemma
papieżom	papieży	Case
gaszone	zauważone	lemma
ciekawskiego	nietypowego	lemma
ganki	skakanki	lemma
rozbiła	rozbił	Gender
chromosomy	chromosomie	Number
podrywaniem	podrywaniu	Case
bezbarwne	scholastyczne	lemma
opady	opadzie	Number
dacie	datom	Number
rdzeniowi	rdzeniu	Case
lodach	lodami	Case
instytuty	instytut	Number
motorniczy	motorniczego	Case
obrączek	obrączki	Number
grubsza	niska	lemma
łagwie	łagiew	Number
kaktusem	zagranicą	lemma
brazylijskiego	wolnego	lemma
proepidemicy	proepidemików	Case
numerował	uprawiał	lemma
dyrygenta	paczki	lemma
doli	dolę	Case
kleć	klecie	Number
trygonometrycznym	trygonometryczną	Gender
koszernego	spożywczego	lemma
reprezentantami	reprezentantem	Number
terapeutów	terapeutę	Number
biedroneczki	podkówki	lemma
chorą	raciborską	lemma
erraty	rzepy	lemma
folderami	folderem	Number
szulerów	szulera	Number
obciążam	wpływam	lemma
odcinka	odcinek	Case
losowa	niegrzeczna	lemma
partykuły	partykułę	Number
afinicznego	sprawiedliwego	lemma
trzonowce	trzonowiec	Number
obali	wygra	lemma
okopach	okopie	Number
pojmuję	pojmują	Person
marynarki	trufle	lemma
hokejowy	tlenowy	lemma
okrężnicy	okrężnicę	Case
żołnierzu	żołnierze	Number
galeonach	galeonie	Number
drożdżowej	drożdżowym	Gender
bełkoty	bełkotami	Case
poprawna	poprawny	Gender
wyniosła	wyniosło	Gender
bieżąca	bieżący	Gender
obszerniejszej	obszerniejszego	Gender
obłemu	obłej	Gender
waflowi	waflom	Number
szpitala	szpitali	Number
łączem	łączami	Number
aromat	aromaty	Number
sukience	sukienki	Case
długowiecznego	radzieckiego	lemma
półfinałom	półfinałami	Case
przedmieściom	przedmieściu	Number
licha	licho	Number
medytacją	medytacjami	Number
kociołków	kociołki	Case
osobistej	osobistego	Gender
wróżka	wróżki	Number
ośmiokąta	ośmiokąt	Case
diecezjalne	wiśniowe	lemma
maksymalnemu	maksymalnej	Gender
ciało	ciałem	Case
feministek	parlamentarzystów	lemma
pieniądzu	pieniądze	Number
krzyczeć	rzucać	lemma
spóźnionym	spóźnionej	Gender
całkowy	terrorystyczny	lemma
golonki	szaliki	lemma
bareizmie	bareizmowi	Case
kreatury	kreatur	Number
karabiny	karabinami	Case
dokonania	dokonanie	Number
wąsie	wąsy	Number
wtórnej	wtórnego	Gender
szemrany	szemranemu	Case
dowiedziałem	dowiedział	Person
syropami	syropem	Number
kryjówką	kryjówkami	Number
borowiki	syreny	lemma
archaniele	archaniołowi	Case
podwodną	podwodnej	Case
bezrobotnym	socjalistycznym	lemma
potrzeb	potrzebach	Case
kopiowałabym	trąciłabym	lemma
sekundą	sekundzie	Case
bielunie	bieluniom	Case
fizjoterapeutów	fizjoterapeutę	Number
wartością	wartości	Case
gniły	zaprowadziły	lemma
felietonem	felieton	Case
najstarszą	najstarsze	Gender
najaktywniejszej	najaktywniejszemu	Gender
mar	mary	Number
uczestniczyły	uczestniczą	Tense
wspólną	wspólne	Gender
alkin	alkinem	Case
kule	kula	Number
czytelnicy	czytelnikom	Case
jodoformowi	jodoformu	Case
obrączka	obrączki	Number
przyimków	przyimkami	Case
biografie	biografowie	Number
godna	godne	Gender
trucizny	truciźnie	Case
rewolwery	rewolwer	Number
schowków	schowkach	Case
niania	nianie	Number
radne	radną	Number
hangarami	hangary	Case
kiboli	kibola	Number
pretor	pretora	Case
dźwięczne	dźwięczną	Gender
wnioskowi	wnioskom	Number
Albańczykiem	smykiem	lemma
grillami	grillem	Number
figuro	figury	Number
zamiecią	zamieciami	Number
remake'u	remak'owi	Case
kierownicach	kierownicy	Number
podpaliło	znało	lemma
korelacji	korelacją	Case
uważałem	uważałam	Gender
aramejską	podświadomą	lemma
zjedzona	zjedzony	Gender
dumnej	sportowej	lemma
współczynnik	współczynniku	Case
lotniskowcu	lotniskowce	Number
negocjująca	skrzypiąca	lemma
iniekcje	iniekcji	Case
filmowcem	filmowcami	Number
zapomniana	zapomniany	Gender
drogą	perską	lemma
hrabstwem	hrabstwie	Case
urodzinowej	urodzinowego	Gender
chrześcijanin	chrześcijanie	Number
mostami	mostem	Number
śmigłowców	śmigłowcom	Case
stwierdzeniem	stwierdzeniami	Number
jezdniach	jezdni	Number
fonologii	fonologia	Case
zawodom	zawodami	Case
lusterkiem	lusterku	Case
kukurydzianym	zajętym	lemma
gotowały	traciły	lemma
krwawiłoby	krwawiłaby	Gender
mazurskiej	szafirowej	lemma
błyski	błysku	Number
karmiące	radzące	lemma
dwuręcznym	prawidłowym	lemma
jubilerów	jubilera	Number
grzmiące	ściągające	lemma
szopy	szop	Number
jodłowaliście	tęskniliście	lemma
wytłumaczycie	wytłumaczy	Person
rabaty	rabacie	Number
rogach	rogu	Number
Angielko	szachisto	lemma
menora	menorze	Case
cierpliwe	podziemne	lemma
pacjenci	pacjent	Number
wyrobom	wyrobami	Case
daniele	danielu	Number
czekanie	staranie	lemma
latałaby	przekomarzałaby	lemma
kusiłam	przyjęłam	lemma
dolnołużyckim	dolnołużycką	Gender
stawia	stawiasz	Person
okolicznikowi	okoliczniku	Case
pariasie	pariasi	Number
eufemizm	eufemizmy	Number
pudełko	pudełkiem	Case
afrodyzjaku	afrodyzjaki	Number
nadobne	nadobna	Gender
weekendową	weekendowe	Gender
ekologiem	ekolog	Case
pomysłu	pomyśle	Case
najgorszemu	podejrzanemu	lemma
okrzynowi	okrzynie	Case
płucach	płucu	Number
najgłośniejsza	najgłośniejsze	Gender
deltę	delcie	Case
alofonie	alofony	Number
przedszkolami	przedszkolach	Case
kandydata	kandydatów	Number
akapity	akapicie	Number
przelewu	przelewów	Number
runie	zasłuży	lemma
przemówieniem	przemówieniami	Number
karaibskim	karaibską	Gender
dłoni	dłoniach	Number
matematykach	matematykom	Case
barny	barnami	Case
stołami	stoły	Case
oporem	oporami	Number
zwiastunu	zwiastunów	Number
azotowy	najsolidniejszy	lemma
gromów	gromu	Number
szyszynka	szyszynki	Number
psałterz	psałterze	Number
czerepem	czerepami	Number
listonosze	listonosz	Number
komoryjski	oszukańczy	lemma
oktanach	oktanów	Case
brona	bronie	Case
nauczycielkach	nauczycielek	Case
odbijałam	rozwijałam	lemma
wspomnieniu	wspomnieniom	Number
znajomości	znajomościach	Number
procent	procentu	Case
jar	jary	Number
skorupkami	skorupką	Number
pacjentowi	pacjent	Case
najwęższą	najwęższym	Gender
dmuchałbym	zapłaciłbym	lemma
urugwajska	urugwajski	Gender
przemówienia	przemówieniami	Case
cebulki	cebulek	Case
cichemu	cichej	Gender
połączy	zada	lemma
powrozy	powrozów	Case
najmniejszy	najmniejszego	Case
roszady	roszadę	Case
seminaryjny	seminaryjne	Gender
cyklu	cyklach	Number
humanizmie	humanizmu	Case
chudszych	niepozornych	lemma
spóźnionej	spóźnioną	Case
plułaby	uratowałaby	lemma
kołczany	kołczanów	Case
nudnej	nudnym	Gender
grzmiąc	zakładając	lemma
latano	produkowano	lemma
premiera	premier	Case
silniejszemu	silniejszej	Gender
ciemnym	organicznym	lemma
prawną	prawnym	Gender
łudzisz	łudzicie	Person
mokradła	mokradeł	Number
starczego	starczych	Number
mydłu	mydłom	Number
szyje	szyję	Number
nutach	nucie	Number
cudownego	cudownych	Number
chronili	skończyli	lemma
historykiem	historykami	Number
zebrę	zebrze	Case
krótkometrażowym	krótkometrażową	Gender
mieszkałybyśmy	mieszkałyby	Person
kolekcjonuję	kolekcjonujesz	Person
czerwonką	czerwonka	Case
mamry	skorupy	lemma
królewiczy	królewiczom	Case
walką	walka	Case
kibica	kibicowi	Case
rybiego	rybiej	Gender
nastoletnim	nastoletnią	Gender
choinkę	choinką	Case
karpackie	portugalskie	lemma
wyświetlałyście	wyświetlacie	Tense
najgorsze	najgorszy	Gender
komunistom	komunistów	Case
faksów	faksu	Number
kierujący	rodzący	lemma
sitko	sitka	Number
ciasne	ranne	lemma
astronautom	astronautach	Case
kaliny	kalinę	Number
grzesznego	wietrznego	lemma
stos	stosy	Number
samorzutnemu	samorzutnej	Gender
moczony	zmieniony	lemma
dolnołużyckie	termodynamiczne	lemma
broiłby	broiłaby	Gender
miejskiego	miejskiej	Gender
konserwami	konserwom	Case
gryzł	gryzło	Gender
subtropikalne	subtropikalny	Gender
zakładają	zakłada	Person
arach	ar	Case
dzierżył	dzierżyła	Gender
arktyczne	arktyczną	Gender
łódkach	łódkom	Case
lalkę	lalce	Case
skały	skałę	Number
drgający	wymyślający	lemma
włóknom	włóknami	Case
unicestwione	unicestwiony	Gender
fragmenty	fragment	Number
krewnymi	krewną	Number
harowałam	sprzęgłam	lemma
losowym	wilgotniejszym	lemma
infekcja	żelatyna	lemma
sfinksem	sfinksami	Number
twardej	twardego	Gender
płodami	płodem	Number
księżycową	symboliczną	lemma
Austriaku	Austriacy	Number
uprawy	uprawa	Number
radzieccy	radzieckich	Case
kobietę	kobiety	Case
katodom	katodami	Case
siostrzany	siostrzane	Gender
oszukalibyśmy	oszukalibyście	Person
nowiu	nowie	Number
moczach	sąsiadach	lemma
wędki	wędek	Case
ingerencjom	ingerencji	Number
całunach	całunie	Number
pułapki	pułapek	Number
krwawe	krwawy	Gender
zasłużyłeś	zasłużył	Person
wargami	wargi	Case
biedronki	biedronek	Number
bawiący	proponujący	lemma
etiopskie	etiopska	Gender
chromosom	tornister	lemma
złośliwa	złośliwe	Gender
bębnów	bębna	Number
językowej	językowego	Gender
fotografem	fotografa	Case
siewnikiem	siewnik	Case
bąków	bąki	Case
tytułowi	tytuł	Case
kosze	koszach	Case
faulem	faulami	Number
szprychy	szprycho	Number
gwiazdki	gwiazdka	Number
tępym	tępą	Gender
faceta	facetów	Number
romb	romby	Number
wadery	wader	Number
dane	wargowe	lemma
robiłeś	robił	Person
kurnikach	kurników	Case
mijałbym	powtórzyłbym	lemma
potrawom	potrawie	Number
praporządki	praporządków	Case
zamordowaniem	zamordowanie	Case
fotel	fotele	Number
najniższej	nieczytelnej	lemma
wrzecion	wrzeciona	Number
modlitwach	modlitwie	Number
odpowiedzialnemu	odpowiedzialnej	Gender
transseksualista	transseksualisty	Case
konstytucjonalizmie	konstytucjonalizm	Case
ogniowi	ognia	Case
dźwięcznej	dźwięcznym	Gender
kratą	kracie	Case
biesiadach	biesiadzie	Number
dostarczajcie	zawiedźcie	lemma
glisto	glistą	Case
standardowej	standardowego	Gender
róże	róża	Number
skręciwszy	zniszczywszy	lemma
częstszym	zadziąsłowym	lemma
propozycją	propozycjami	Number
gwiazdki	gwiazdce	Case
bramkarzu	bramkarzowi	Case
płetwonurek	płetwonurkowie	Number
żywotne	żywotny	Gender
dwukołowego	turkusowego	lemma
pisane	zrabowane	lemma
mendą	mendzie	Case
pęknięto	śniono	lemma
paradygmat	paradygmatem	Case
lodowce	lodowiec	Number
cwale	cwał	Case
idola	idoli	Number
buzi	buzią	Case
książkowej	książkowego	Gender
obiecywalibyście	razilibyście	lemma
liberyjskie	liberyjskich	Case
pląsaliśmy	pląsaliście	Person
osobie	osobach	Number
kationy	kation	Number
saskie	saskim	Case
interesy	interes	Number
dotykałem	wyhaftowałem	lemma
klęską	klęsce	Case
bagna	bagien	Number
poprawiłem	śpiewałem	lemma
cudowniejsze	niejakie	lemma
rabinami	rabinem	Number
kluby	klubach	Case
świdrami	świdrem	Number
statystą	statystami	Number
fenickimi	siarkowymi	lemma
swatach	swacie	Number
najbliższą	najbliższym	Gender
dojrzejecie	umrzecie	lemma
tłumy	tłumie	Number
zarobionej	zarobionemu	Gender
oszustwo	oszustwa	Case
leszczu	leszczach	Number
najsłodszemu	najsłodszej	Gender
slupy	slupów	Case
pytający	pytająca	Gender
głową	głowami	Number
karbieńcom	karbieńcowi	Number
skorpionach	skorpionami	Case
zrobionym	zrobioną	Gender
biblioteka	biblioteki	Number
mrozów	mrozom	Case
głosie	głosach	Number
gwałciłabym	wystarczałabym	lemma
oszukiwałyśmy	zamówiłyśmy	lemma
historycznego	historyczne	Case
najpoprawniejsze	skończone	lemma
garbowania	garbowanie	Case
badają	parują	lemma
metropolicie	metropolitach	Number
mierzyliście	przyjęliście	lemma
humanizm	humanizmu	Case
kobrą	kobrze	Case
czytaniu	czytaniach	Number
procesorach	procesorom	Case
śnieżnobiałą	śnieżnobiała	Case
dosraliby	zostawiliby	lemma
dwutlenków	dwutlenku	Number
cisowym	okrągłym	lemma
produkt	produkty	Number
opatentowało	opatentowała	Gender
cebrzyki	cebrzyku	Number
łódki	łódka	Number
meteorze	meteorach	Number
czerwonawej	nigeryjskiej	lemma
możliwych	wstawionych	lemma
jazdę	jazdy	Number
odpowiadające	płonące	lemma
najmocniejszego	najmocniejszej	Gender
gazetowej	gazetowego	Gender
karkołomnym	karkołomną	Gender
ogrodzie	ogrodach	Number
szkutnicy	szkutników	Case
moralne	żonate	lemma
odradzające	rażące	lemma
faktura	faktury	Case
uciekają	uciekacie	Person
podpisało	podpisał	Gender
wizytówki	wizytówek	Number
dzienniki	dzienników	Case
stulecia	stulecie	Number
wydziale	wydziałem	Case
zdrowy	zdrowa	Gender
radiobusoli	radiobusolom	Number
katechizmów	katechizmach	Case
niedźwiedziach	niedźwiedzi	Case
oficerów	oficerach	Case
brudzą	tracą	lemma
konkordatach	konkordacie	Number
leworęcznego	wysokiego	lemma
muzea	muzeom	Case
najnowszego	najnowszej	Gender
całym	całą	Gender
karnista	karniście	Case
gaszące	rozróżniające	lemma
konserw	konserwy	Number
faraonów	faraona	Number
koniunkcjami	koniunkcji	Case
umysły	umysł	Number
ćpająca	ćpający	Gender
byków	byka	Number
piosence	piosenkę	Case
akupunkturom	akupunkturze	Number
marznęłaby	marznęłabym	Person
nieznanym	nieznanej	Gender
amperomierza	amperomierzy	Number
spacerami	spacerem	Number
zabijałyby	zabijałybyśmy	Person
jasnoszarym	twardszym	lemma
srom	sromem	Case
niezwykłej	niezwykłą	Case
diademu	diademów	Number
liry	pobyty	lemma
lotnictwa	lotnictwem	Case
matematyków	matematyka	Number
dowodów	dowodom	Case
kruszcami	kruszcom	Case
dolnołużycki	nikczemny	lemma
żabkami	żabki	Case
kuprze	kuprem	Case
trawka	trawkę	Case
reputacje	reputację	Number
karykaturą	karykaturę	Case
zakochaną	zakochanym	Gender
monitorach	monitorze	Number
kaplicom	kaplice	Case
czosnkowy	czosnkowa	Gender
motorniczych	motorniczym	Case
wyższemu	wyższego	Case
plażami	plażach	Case
azotowy	azotowe	Gender
zrabuje	zrabuję	Person
ostatkach	ostatki	Case
elektrowniach	elektrownie	Case
białoruskim	nienasyconym	lemma
poetki	poetka	Number
zajazdami	zajazdem	Number
wstręt	wstrętu	Case
manacie	wnykach	lemma
niewiasto	niewiasty	Number
kiszkę	kiszki	Number
tratwami	tratwą	Number
kłułaby	kłułby	Gender
dziobane	rzucone	lemma
dokerem	dokerze	Case
dokładniejszy	sporadyczny	lemma
cesarzową	cesarzowa	Case
trwałej	trwałego	Gender
strażaków	strażakach	Case
sługach	słudze	Number
egzekucyjne	największe	lemma
proroków	prorokami	Case
listopadzie	listopadowi	Case
feniksy	feniksie	Number
możliwej	możliwego	Gender
kozich	oszczędnych	lemma
eucharystii	eucharystiach	Number
żaby	żabami	Case
genetyczną	genetycznej	Case
czerwcowe	czerwcowy	Gender
barbarzyństwa	barbarzyństwo	Number
metodystycznymi	rządowymi	lemma
korsykańskich	semantycznych	lemma
diecezja	diecezje	Number
chłeptałyście	wyjęłyście	lemma
kalejdoskopu	kalejdoskop	Case
czynie	czynach	Number
najliczniejsza	najliczniejsze	Gender
rączki	rączkę	Number
bobsleje	bobslej	Number
tablic	tablice	Case
arę	arze	Case
kontynentami	kontynentem	Number
popełnione	uśpione	lemma
inwestycją	inwestycjami	Number
empiryczna	najwyższa	lemma
badał	badała	Gender
kwarcem	rozszczepieniem	lemma
nutrii	nutriami	Case
gospodyni	torcie	lemma
anarchistów	anarchiści	Case
nazwiskach	nazwisku	Number
kominki	kominek	Number
blogach	blogów	Case
kocięta	kocię	Number
donice	donicach	Case
oddamy	odda	Person
zarabiała	zarabiało	Gender
Palestynek	Palestynki	Number
andorskim	andorskiej	Gender
sylwestra	sylwester	Case
udarowi	udar	Case
wojskowej	wojskowemu	Gender
toalety	toaletą	Case
faryzeuszem	samochodem	lemma
technikami	technikom	Case
jedynaków	jedynaka	Number
lewacka	lewacki	Gender
cegły	cegieł	Case
rozbitka	rozbitek	Case
kłody	kłód	Number
porozmawia	wymiksuje	lemma
jagoda	zbójca	lemma
korzeniami	korzeniem	Number
obserwatora	obserwatorów	Number
najzieleńsza	najzieleńszy	Gender
papierowego	papierowej	Gender
bankrutują	śmieją	lemma
żywego	żywej	Gender
czyniący	czyniąca	Gender
odchodzące	trzaskające	lemma
bazylii	bazylią	Case
nadużywająca	pojawiająca	lemma
cichym	obfitszym	lemma
kapelach	kapeli	Number
galom	gali	Number
dermatologiczną	świadomą	lemma
nadchodząc	przeprowadzając	lemma
kolarzami	religiami	lemma
sądach	sądy	Case
podręcznikach	podręczniku	Number
wyżeł	wyżły	Number
bezlitosne	telegraficzne	lemma
upadki	upadek	Number
przeprowadzek	przeprowadzki	Number
atomowych	najzabawniejszych	lemma
gorzałka	gorzałko	Case
błotniku	błotnik	Case
pobrane	pobrana	Gender
limo	limem	Case
proco	proce	Number
preclach	preclu	Number
wina	winach	Case
chwilówką	chwilówki	Case
anegdotę	anegdoty	Number
przeglądarek	przeglądarki	Case
drgania	drganiu	Case
norweskim	norweskiej	Gender
zębowe	zębowy	Gender
dalekich	poważniejszych	lemma
bolidzie	bolidach	Number
doprowadzające	pędzące	lemma
cnotliwych	szlachetnych	lemma
pot	potu	Case
biblioteczka	biblioteczki	Number
obelga	obelgą	Case
białka	białek	Case
posłańcem	posłańcowi	Case
zwyczajnych	zwyczajne	Case
amnezji	sytuacji	lemma
najłatwiejszych	oburęcznych	lemma
tułacz	tułacze	Number
krwawi	wyje	lemma
wronach	wronami	Case
kamienne	kamiennych	Case
fora	forum	Number
zasobów	zasobu	Number
wielbłądem	wielbłąda	Case
bransolety	bransoletę	Number
żłobkach	żłobki	Case
gdacząca	płynąca	lemma
pochodnie	pochodnię	Number
wypędzony	wypędzona	Gender
okrzyn	okrzyny	Number
trzeźwą	trzeźwej	Case
graficzne	przemienne	lemma
łzą	łzę	Case
bezpieczny	bezpieczna	Gender
derenia	dereni	Number
internacie	internaty	Number
odbyt	odbyty	Number
anionów	anionu	Number
połączeni	sądzeni	lemma
alergie	alergię	Number
etapów	etapach	Case
kuchenki	kuchence	Case
martwice	tragarze	lemma
przyimkowej	przyimkowemu	Gender
malunki	malunek	Number
lodziki	lodzik	Number
działało	używało	lemma
gilotyny	gilotyna	Number
wykłady	wykład	Number
pandę	pandy	Number
gnające	więdnące	lemma
inżynier	inżynierem	Case
opolskim	opolskiej	Gender
harmonogram	harmonogramy	Number
pocałunki	pocałunku	Number
zakończenie	zakończenia	Number
pojawię	zniknę	lemma
ekologa	ekologów	Number
trwajmy	trwałybyśmy	Mood
zawilców	zawilca	Number
wokalistę	wokalistów	Number
klatkę	notariusza	lemma
zdrowej	zdrowym	Gender
łatwy	łatwa	Gender
hojną	prostokątną	lemma
kijance	kijankom	Number
klasycystycznych	okrutnych	lemma
parkowałabyś	parkowałaby	Person
robotą	roboty	Case
niderlandzkiej	niderlandzkiemu	Gender
bawełny	bawełnę	Number
półprosta	półproste	Number
uzdach	uździe	Number
oksymoronie	oksymoronowi	Case
albańskie	albańską	Gender
spowiednikiem	spowiednikami	Number
stypendiach	stypendiami	Case
malutkie	malutki	Gender
klonowi	teraźniejsi	lemma
fotograficzny	fotograficzne	Gender
dyskotekowego	tajnego	lemma
fryzurze	fryzurach	Number
cząsteczce	cząsteczkach	Number
krajom	krajowi	Number
bezrobotnym	bezrobotnych	Case
naprawiają	pokrywają	lemma
przedimkiem	przedimek	Case
afgańskiego	niewygodnego	lemma
polowania	polowaniom	Case
meczecie	meczetach	Number
bambusową	bambusowe	Gender
perz	perze	Number
amfiteatr	amfiteatry	Number
koteczek	koteczki	Number
sarkofag	sarkofagu	Case
notuje	notujemy	Person
aferą	aferze	Case
gęstym	skończonym	lemma
bibliografia	bibliografie	Number
puryfikaterzach	puryfikaterzu	Number
matkom	matki	Case
garnkach	garnki	Case
niewolników	niewolnikami	Case
miazgi	miazgom	Case
opiekujcie	opiekowałybyście	Mood
górnymi	teatralnymi	lemma
złej	złego	Gender
dubeltówkom	dubeltówki	Case
antysemickim	antysemickiej	Gender
podnoszone	przeprowadzane	lemma
lewackie	lewacki	Gender
deseń	desenie	Number
czasownika	czasowników	Number
zakazie	zakazy	Number
dachowce	dachowiec	Number
alergenie	alergen	Case
linami	linów	Case
roślinie	roślinę	Case
dolny	dolna	Gender
teatralnemu	teatralnej	Gender
żołnierzu	żołnierzem	Case
bliskowschodniej	bliskowschodniemu	Gender
palimpseście	palimpsesty	Number
gęgana	zakazana	lemma
kolejce	kolejkach	Number
gadożerze	gadożery	Number
złożonej	złożonemu	Gender
marzymy	marzyłyśmy	Tense
poufnej	poufnym	Gender
książkowymi	książkowe	Case
atlasie	atlasach	Number
parkowałyśmy	parkujemy	Tense
waranach	waranie	Number
listem	listami	Number
ptasiego	ptasiej	Gender
hamująca	stanowiąca	lemma
ludzka	ludzki	Gender
jedwabnik	jedwabniki	Number
najkrótsze	najświętsze	lemma
krainy	krainę	Number
bledszy	bledsza	Gender
historycznej	przytulnej	lemma
teizmem	teizmowi	Case
gumy	gumę	Number
nieuważne	nieuważny	Gender
błotniste	staroangielskie	lemma
komę	komy	Number
chińczykom	chińczykowi	Number
kaktusami	kaktusem	Number
łatwiejszej	praworęcznej	lemma
niewolnikiem	niewolnikami	Number
złą	złym	Gender
patologio	patologia	Case
najzwyczajniejsze	najzwyczajniejsza	Gender
kociaki	myszki	lemma
golisz	parkujesz	lemma
zmierzch	zmierzchu	Case
pamięta	pamiętasz	Person
przyjmą	przyjmiesz	Person
wersetów	wersetu	Number
społecznemu	społecznej	Gender
ławach	ław	Case
cyrk	cyrkowi	Case
cedr	cedry	Number
brudzilibyśmy	brudzilibyście	Person
hipotek	hipoteki	Number
minimalistycznym	podświadomym	lemma
dwukropek	dwukropki	Number
rybołowem	rybołowie	Case
obszaru	obszarów	Number
wisienek	wisienkami	Case
chwaliłam	chwaliłem	Gender
sztandaru	sztandarów	Number
otaczalibyście	rozczarowalibyście	lemma
fortom	fortowi	Number
dzieje	siedzi	lemma
odczyniwszy	zrzuciwszy	lemma
eksperymentom	eksperymentowi	Number
sprawdzianów	sprawdzianu	Number
mieszkające	mieszkająca	Gender
dnia	dni	Number
kreatywnym	kreatywną	Gender
nacjonalistycznych	nacjonalistyczne	Case
jednokładnościom	jednokładności	Case
dworce	zasłonie	lemma
kanarów	kanarzy	Case
somalijskim	somalijskiej	Gender
urzędasie	urzędasy	Number
graficznych	osobowych	lemma
gorąca	gorące	Gender
jelenia	okrąg	lemma
masaż	rzeźbę	lemma
narciarstwa	narciarstwie	Case
szafirowych	szafirowym	Case
poziom	poziomy	Number
meczet	meczecie	Case
dymaliśmy	dymaliście	Person
skrzyżowania	skrzyżowanie	Number
deweloperami	deweloperem	Number
płetwa	płetwy	Case
wyrządziłbyś	wyrządziłbym	Person
królewskiemu	ukochanemu	lemma
przezimowała	przezimowałaś	Person
rączek	rączki	Number
żywice	żywicami	Case
nagiego	nagiej	Gender
nosy	nosie	Number
chwileczko	chwileczce	Case
ramy	ramie	Case
wroną	wronie	Case
wyścigów	wyścigu	Number
domniemanymi	reklamowymi	lemma
świnkom	śwince	Number
błahym	błahej	Gender
stworem	stworami	Number
bezbożne	bezbożną	Gender
całkowalnej	starej	lemma
kręciłybyśmy	kręćmy	Mood
kombinezonie	kombinezonach	Number
werbel	werble	Number
głęboka	głęboką	Case
cokołem	cokół	Case
najkruchszych	wykonywalnych	lemma
bólów	bóle	Case
edytująca	refująca	lemma
posiadające	posiadająca	Gender
azerskimi	azerskim	Case
krymskotatarskiego	zdrowego	lemma
Araba	więźnia	lemma
poroniło	zabijało	lemma
technologicznym	technologiczne	Case
dodamy	zatrzymamy	lemma
głoski	głosek	Number
słodkowodnej	słodkowodnego	Gender
sarno	sarny	Number
dachową	ziemną	lemma
językową	pszczelą	lemma
wycieczka	wycieczki	Number
karmiłyście	wykorzystywałyście	lemma
gadożerem	gadożer	Case
gładki	pracowity	lemma
szpinety	szpinetów	Case
obrabuje	zniknie	lemma
pojawiłby	pojawiłoby	Gender
emocjonalnej	emocjonalnym	Gender
grenlandzkim	niepotrzebnym	lemma
krzycząc	włączając	lemma
lśniącym	lśniącą	Gender
małpki	małpkę	Number
pastwiska	pastwisko	Case
germanie	germanu	Case
drewniaka	drewniaków	Number
filmowane	ściągane	lemma
przedwojennego	przedwojennych	Number
jugosłowiańskiego	jugosłowiańskim	Case
szkliwa	szkliwem	Case
indyka	indyki	Number
homomorfizmem	homomorfizmami	Number
ogrodnikowi	ogrodnik	Case
budzimy	płyniemy	lemma
latarnikowi	latarnika	Case
krzyżówką	pojmowaniem	lemma
amebę	ameby	Number
żargonu	żargonie	Case
szczerą	szczere	Gender
tkacza	tkacz	Case
wkurwiajcie	wkurwiaj	Person
dłuższej	prawniczej	lemma
win	wina	Number
pilnego	pilnej	Gender
bezpodstawne	bezpodstawna	Gender
cnotliwego	cnotliwej	Gender
prawdziwą	prawdziwym	Gender
ambiwalencjach	ambiwalencji	Number
hutę	huta	Case
przydupasie	przydupasi	Number
plastycznego	plastycznej	Gender
butan	odmowę	lemma
najgrubszemu	platynowemu	lemma
oszukam	wygarnę	lemma
wisiała	wisiało	Gender
komentowane	używane	lemma
wyrzucisz	wyrzucę	Person
młynarzem	młynarza	Case
gruszą	gruszami	Number
nowotwór	nowotwory	Number
ruczaj	ruczaju	Case
hurtowe	hurtowym	Case
kalejdoskopu	kalejdoskopie	Case
pozornej	pozorną	Case
mózg	własność	lemma
kajałaby	kajałoby	Gender
hibernacja	hibernacji	Case
krótszy	krótsza	Gender
czkawka	czkawkę	Case
prawny	prawna	Gender
nowotestamentowemu	nowotestamentowej	Gender
przyjmę	przyjmiesz	Person
najlżejszy	najlżejsze	Gender
niewidzialnych	niewidzialnego	Number
otrzymanie	zjedzenie	lemma
kurdyjskiej	kurdyjskiego	Gender
czyniłam	czyniłaś	Person
gejszo	gejsze	Number
wybuchowa	wybuchowe	Gender
kazachskiemu	rudemu	lemma
moralnemu	moralnej	Gender
podochodzimy	wyrzucimy	lemma
opowiadałaby	opowiadałabyś	Person
prywatka	prywatki	Number
stołówce	stołówkom	Number
niższe	niższą	Gender
echo	echa	Number
ślimaki	ślimaka	Number
dachowym	dachową	Gender
potopów	potopu	Number
starszym	starszą	Gender
dodane	dodana	Gender
niemetale	niemetalu	Number
wymagający	wymagająca	Gender
prajęzyk	prajęzykiem	Case
etiopskie	psychopatyczne	lemma
garści	garście	Number
mleczarzowi	mleczarzem	Case
botaników	tęczówki	lemma
wiśnię	wiśni	Case
niełupki	niełupkę	Number
wiosłami	wiosła	Case
koszona	koszone	Gender
kontuszu	kontusz	Case
kontenerów	ślepi	lemma
szklarniach	szklarnie	Case
nieprzygotowaną	nieprzygotowanym	Gender
ogrodnik	ogrodnicy	Number
milicji	milicjo	Case
kajaku	kajakach	Number
wpływało	wpływał	Gender
kopacze	rytmy	lemma
rzezie	rzeź	Number
fioletowawy	zdolny	lemma
kapusty	najemcy	lemma
drylowaliśmy	zamówiliśmy	lemma
najczęstszy	termodynamiczny	lemma
poduszeczki	poduszeczka	Number
kibicem	kibicami	Number
mamrotałoby	posłuchałoby	lemma
znam	zna	Person
miętowego	prawniczego	lemma
jabłoniowe	ustne	lemma
perzyny	perzynę	Number
fenyloalanina	fenyloalaninę	Case
żarami	żarem	Number
rozkosze	rozkosz	Number
tankowce	tankowiec	Number
wikipedystą	wikipedystami	Number
odbudowana	odbudowany	Gender
babki	babkom	Case
gwałtom	gwałtów	Case
odkrytą	odkrytym	Gender
głowicę	głowice	Number
najliczniejsze	wysokie	lemma
austriackiej	austriackim	Gender
wiosenne	wiosenny	Gender
Marsjanach	Marsjanom	Case
podlewać	przezimować	lemma
wieczorach	wieczory	Case
żwacza	żwaczu	Case
gry	gro	Number
przeżyją	zrobią	lemma
krawiec	sługa	lemma
historiach	historie	Case
rzecznego	rzecznej	Gender
agresywnej	zimniejszej	lemma
pękłyście	żądałyście	lemma
rozumnego	rozumnej	Gender
jelitami	jelita	Case
podatkowej	podatkowego	Gender
kumplem	kumplami	Number
potoku	potokiem	Case
ścięgnami	ścięgnach	Case
haruje	poluje	lemma
służby	służbę	Number
najambitniejszego	najambitniejszej	Gender
łyżwami	muchomorami	lemma
esemesujący	wahający	lemma
górna	górny	Gender
prokuratorom	prokuratorów	Case
konkretnym	tenisowym	lemma
debili	debile	Case
śpiewakiem	śpiewakowi	Case
konstytucji	konstytucję	Case
nimfę	nimfie	Case
jemeńską	jemeńskie	Gender
kirgiską	kirgiskie	Gender
ogonie	ogonowi	Case
młodym	młodymi	Number
narząd	narządzie	Case
pękliby	pęklibyśmy	Person
wybuch	wybuchy	Number
kioskach	ogniskach	lemma
prawniku	prawnikach	Number
ognioodpornym	ognioodpornego	Case
blokowisko	blokowiskiem	Case
blokadami	blokady	Case
odwzajemniona	puszczana	lemma
kultem	kult	Case
miotłach	mioteł	Case
aktyn	aktynu	Case
negatywach	negatywie	Number
poprowadziło	poprowadził	Gender
adrenalin	adrenaliny	Number
cech	cechy	Number
dziedzica	przedmówcy	lemma
bombka	bombki	Number
wymówką	wymówkę	Case
tchórzliwemu	tchórzliwej	Gender
prędkościomierze	prędkościomierz	Number
zakazów	zakazy	Case
huśtawek	huśtawkach	Case
ubezpieczenia	ubezpieczeń	Number
pilniki	pilnik	Number
zdobicie	zdobiłyście	Tense
politykowi	politykom	Number
mejlu	mejle	Number
kanale	kanały	Number
wersji	wersjom	Number
liderami	liderem	Number
dworce	dworkach	Number
słupku	słupkach	Number
ekonomicznym	uciążliwym	lemma
szczegółowej	szczegółowego	Gender
słabsza	słabszy	Gender
kaskadą	kaskadami	Number
górnego	toksycznego	lemma
kierowcy	kierowcom	Number
dzwony	prezenty	lemma
aktywizm	aktywizmu	Case
marudziłybyśmy	wysyłałybyśmy	lemma
bidetach	bidetów	Case
szumowinami	szumowiną	Number
nietoperzami	nietoperzem	Number
ucieczek	ucieczkom	Case
zatrzymana	zatrzymane	Gender
ogoliłabym	ogoliłaby	Person
targu	targach	Number
tensora	tensorów	Number
germańskim	nietypowym	lemma
trzymaj	trzymajmy	Person
sławo	sławą	Case
odbieracie	odbierasz	Number
szabrownikowi	szabrownikom	Number
spirodelę	spirodeli	Case
zastanawialibyście	zastanawialiby	Person
miłki	miłkom	Case
cydrów	cydrom	Case
przytulnej	przytulnego	Gender
przemyślicie	sprzątniecie	lemma
melon	melonem	Case
kadzidłem	kadzidłu	Case
muskuły	muskuł	Number
teoretycznej	teoretycznego	Gender
pomocnika	pomocników	Number
krawaty	krawacie	Number
uciążliwa	uciążliwą	Case
sklejki	sklejce	Case
ozdobę	ozdoby	Number
prostokątnej	prostokątnemu	Gender
obczyźnie	obczyzną	Case
tekstami	teksty	Case
nieskończonej	nieskończonym	Gender
mijałoby	starałoby	lemma
agenturą	przedmiotem	lemma
przewody	przewód	Number
tabernakulum	tabernakula	Number
wyścig	wyścigu	Case
fontanną	fontannami	Number
najdelikatniejszym	ograniczonym	lemma
republikę	republiki	Number
zamieciom	zamieci	Case
bożonarodzeniowa	bożonarodzeniowy	Gender
linach	linie	Number
sezonach	sezonami	Case
odporności	odporność	Number
łopatce	łopatkach	Number
zimował	zimowała	Gender
prośbie	prośbach	Number
nogawkami	nogawek	Case
niegrzecznym	niegrzeczną	Gender
przenośnym	przenośnej	Gender
nastolatki	nastolatkami	Case
cieńszej	cieńszym	Gender
akweduktach	akwedukcie	Number
suszarki	suszarek	Case
dziewiczą	dziewiczym	Gender
ekstremalnej	ekstremalnym	Gender
domniemanego	domniemanym	Case
przyjacielu	przyjaciele	Number
chłodnych	uważnych	lemma
kręgowcach	kręgowców	Case
brosza	brosze	Number
gwiżdżące	gwiżdżąca	Gender
carycę	carycą	Case
serdecznej	serdecznego	Gender
meksykańskie	meksykańska	Gender
statuetkami	statuetką	Number
duszę	dusza	Case
pomiarowi	pomiarem	Case
gnijącym	niszowym	lemma
klęską	klęskę	Case
stanami	stanem	Number
niesieniem	niesieniu	Case
czółno	czółna	Number
najwcześniejsze	najwcześniejsza	Gender
karteczkę	karteczką	Case
dresiarza	dresiarzy	Number
stół	stoły	Number
ośmiokątów	ośmiokątach	Case
dyrektorami	dyrektorów	Case
imprezach	imprez	Case
śmiertelników	śmiertelnika	Number
diamentowy	rozumny	lemma
florencki	nowy	lemma
narządom	narządy	Case
pojawicie	pojawiłyście	Tense
oceniłabyś	ripostowałabyś	lemma
samolocie	samoloty	Number
niejasne	niejasną	Gender
bogacz	bogacza	Case
grani	graniami	Case
eleganckiej	eleganckiemu	Gender
przygodą	przygodę	Case
albańskiego	poprawnego	lemma
podbródka	podbródek	Case
szelężników	szelężnikach	Case
programowanie	programowania	Number
grafik	grafiki	Number
męczennika	męczennik	Case
katal	katale	Number
marką	markami	Number
szeregu	szeregów	Number
czailiśmy	przemyśleliśmy	lemma
zwycięstwach	zwycięstwom	Case
wartości	wartość	Number
aglomeracji	aglomeracjach	Number
odbiorę	odbierzemy	Person
kantonami	kantony	Case
groźną	groźnej	Case
obieca	znajdzie	lemma
malutkiego	malutkiej	Gender
balami	bale	Case
fiutom	fiutowi	Number
prozaicznej	prozaicznym	Gender
spotka	zabalsamuje	lemma
przełączniku	przełącznikach	Number
pomiarowi	pomiarom	Number
guzik	guzika	Case
grzeszne	grzesznym	Case
ukraińską	ukraińskim	Gender
niewiadomego	niewiadomej	Gender
zabierze	zabiorę	Person
badaniu	osice	lemma
abisyńską	niezapomnianą	lemma
kieszenie	kieszeń	Number
najdalszego	najdalsze	Case
drażniliśmy	zawiedliśmy	lemma
kremy	kremach	Case
przywództwie	przywództwu	Case
policjancie	policjantach	Number
kategorii	kategoriom	Number
wiorstę	wiorstą	Case
januszach	szaradach	lemma
skromnym	skromnej	Gender
jednostek	jednostki	Number
chlorany	chloran	Number
kserowałeś	kserowałaś	Gender
przeproś	przeproście	Person
kucałem	kucałeś	Person
centralny	wart	lemma
flirty	flirtów	Case
misje	misja	Number
stawonogi	stawonogów	Case
zainsynuuje	zainsynuujesz	Person
mordobicia	mordobicie	Number
tenisowym	tenisową	Gender
przepiękną	przepięknym	Gender
optyczna	optyczne	Gender
luźniejszą	zadziąsłową	lemma
bycie	byty	Number
eucharystycznych	równych	lemma
rozumnym	rozumnej	Gender
genealogiczni	wirusowi	lemma
najsłodszą	najsłodsze	Gender
mylona	mylone	Gender
baty	batom	Case
analizując	poprawiając	lemma
orkiestr	orkiestry	Case
szyfrowanie	szyfrowania	Number
zagrodo	zagroda	Case
gościach	gości	Case
iberyjskiego	uciążliwego	lemma
wyzwaniach	wyzwaniu	Number
kojota	szczeliny	lemma
żalu	żalów	Number
pożyczony	usunięty	lemma
najcieplejszemu	sudeckiemu	lemma
grabiło	telegrafowało	lemma
januszu	wodorze	lemma
melodio	melodie	Number
arabską	arabskie	Gender
nos	nosy	Number
marionetkami	marionetki	Case
hamburgery	hamburgerze	Number
społeczeństw	społeczeństwa	Number
poprawiłem	poprawiłam	Gender
jajkom	jajku	Number
trumna	trumny	Number
posadach	posadzie	Number
czeskich	psychicznych	lemma
odkrywający	pochodzący	lemma
najjaśniejszym	roślinnym	lemma
klasztorze	klasztorach	Number
cygara	cygaro	Number
łuczniczki	pijaka	lemma
tabeli	tabel	Number
praktycznemu	praktycznej	Gender
wełnianą	wełnianym	Gender
najczarniejszy	nietypowy	lemma
księżniczka	księżniczki	Case
grabisz	przodujesz	lemma
podziwiana	zamordowana	lemma
alkoholiczkach	alkoholiczek	Case
porcelanowej	porcelanowego	Gender
kurczaki	kurczak	Number
popycie	popyt	Case
wystarczającym	wystarczającego	Case
dobru	dobrom	Number
zaświatach	zaświaty	Case
spotkałem	spotkałam	Gender
lepkiej	lepkim	Gender
alergen	szyszkę	lemma
pokaże	usunie	lemma
łysy	łyse	Gender
wredniejszym	wredniejszej	Gender
mejl	mejle	Number
duszy	dusz	Number
małpowałaby	stawałaby	lemma
naukowego	naukowej	Gender
puszczajmy	puszczaj	Person
łośka	łośkowi	Case
rezultat	rezultatem	Case
rojów	roju	Number
ciekły	trojański	lemma
worów	wora	Number
przekaźnika	przekaźników	Number
tolerujesz	tolerują	Person
piramidy	piramid	Number
kociołki	kociołek	Number
katalońskiego	pewniejszego	lemma
planszy	planszach	Number
jumą	jumo	Case
wielkiemu	wielkiej	Gender
zwierzęciu	zwierzętom	Number
hostiami	hostią	Number
wolu	wolach	Number
zimniejszej	zimniejszego	Gender
braterską	braterskie	Gender
krucjatą	krucjacie	Case
odbudowanie	uciekanie	lemma
ostrzejszą	ostrzejszym	Gender
limem	lima	Case
nocy	noce	Case
współczesnej	współczesnym	Gender
namiętności	namiętnościom	Number
biedne	starsze	lemma
szkło	szkła	Number
gola	gole	Number
dwuwargową	osobową	lemma
pojęcie	pojęcia	Case
ptasi	ptasia	Gender
pesymistce	pesymistki	Case
rozczarują	rozczarowały	Tense
okolicy	okolicom	Number
słowikiem	słowik	Case
pęknięcie	pęknięcia	Case
prozaicznego	prozaicznej	Gender
podpalone	rządzone	lemma
alaniny	alanina	Number
pieczarek	pieczarki	Number
drukowały	drukują	Tense
ikono	ikonę	Case
odlewem	odlewami	Number
witamin	witaminy	Number
bakteryjny	żaroodporny	lemma
wygłupy	wygłupów	Case
abchaska	abchaskie	Gender
symptomowi	symptomom	Number
przedimka	przedimek	Case
kangurze	kangury	Number
wytłumaczyłeś	wytłumaczyłaś	Gender
żeglarki	żeglarek	Number
przyrodnicza	przyrodnicze	Gender
grupy	grup	Number
poprawiła	umierała	lemma
pradziadków	pradziadka	Number
płótno	płótnem	Case
kolekcjonowała	przyjęła	lemma
myję	zasługuję	lemma
drażnił	drażniło	Gender
kochająca	pokrywająca	lemma
bezwarunkowa	bezwarunkową	Case
karabinem	karabin	Case
genetycznych	żywych	lemma
władcą	władca	Case
upuszczą	upuściły	Tense
samolot	samoloty	Number
kapturów	kaptura	Number
cerkiewnosłowiańskim	cerkiewnosłowiańskiej	Gender
żebrami	żeber	Case
pulsara	pulsar	Case
brzydsza	nudna	lemma
biznesach	biznesom	Case
rzeźbiarzach	rzeźbiarzom	Case
naczyniówki	naczyniówko	Number
warzuchą	warzuchami	Number
krótszej	krótszym	Gender
szopę	szopy	Number
biochemiczna	watykańska	lemma
medali	medalu	Number
posłańca	posłańców	Number
podpalą	zaufają	lemma
ignorowało	ignorował	Gender
dniu	dzień	Case
surówek	surówkami	Case
wyznawcach	wyznawcy	Number
katalogów	katalogu	Number
dotykom	różom	lemma
królik	króliku	Case
oleje	olej	Number
zdarzeniu	zdarzeniom	Number
figurami	stratami	lemma
leptonie	lepton	Case
ciepłego	strategicznego	lemma
płonęło	płonął	Gender
kurki	rosomaki	lemma
apostołowie	apostole	Number
steganografia	steganografii	Case
usunięty	usunięte	Gender
flaku	flak	Case
ody	odo	Number
gaźniki	gaźników	Case
kurczakach	kurczakami	Case
czesana	włączana	lemma
podkreślały	podkreślają	Tense
czarów	czary	Case
rtęciowym	rtęciowej	Gender
jamajskie	sumienne	lemma
wertykalnym	wertykalnej	Gender
sztandarem	sztandar	Case
zagroda	zagrody	Number
szafirowa	szafirowe	Gender
przedstawieniu	przedstawienie	Case
drogie	wodne	lemma
miech	miechy	Number
lotosie	lotosem	Case
doskonalszą	doskonalsza	Case
bazalcie	skrzydłówce	lemma
szyby	szyb	Number
dzioby	dziobów	Case
pilnych	pilnymi	Case
rzeźby	rzeźba	Number
foremny	najspokojniejszy	lemma
pociągiem	pociągami	Number
kociaka	kociakiem	Case
populistom	populistów	Case
gwieździsty	rozjuszony	lemma
atolem	atolami	Number
podstawami	podstawą	Number
zapłacisz	zapłaci	Person
kulturystów	kulturystę	Number
żarówek	żarówki	Number
znakami	znaków	Case
batatów	batata	Number
wyrządzi	wyrządzę	Person
flak	flaki	Number
attyk	attyki	Number
najmłodsze	wschodnie	lemma
kurzowi	kurzom	Number
słyszałeś	słyszałaś	Gender
ćwiartkom	ćwiartce	Number
kareta	karecie	Case
chciwego	słonego	lemma
świerki	świerkami	Case
jaskinie	jaskinia	Number
roztargniony	roztargniona	Gender
waflu	waflem	Case
maltańska	subtropikalna	lemma
holenderskiej	holenderskim	Gender
jemeńskim	technicznym	lemma
marzeniach	marzeniu	Number
dachach	dachu	Number
hektarze	hektarach	Number
wyżęty	wyżęta	Gender
metropolity	metropolitów	Number
dostajemy	dostają	Person
alb	albom	Case
oksymoronie	oksymoronach	Number
osądem	osądami	Number
udręk	udręki	Case
leukocyt	leukocyty	Number
okolicznikiem	okolicznik	Case
jarze	jary	Number
ripostujesz	ripostuję	Person
prałatowi	prałacie	Case
bocianem	bocianami	Number
glukozą	papierem	lemma
starszej	starsza	Case
wydumany	wydumane	Gender
łódź	łodzie	Number
rodzajników	rodzajnika	Number
barwami	barwą	Number
przebieralnia	przebieralnie	Number
rzucałoby	rzucałby	Gender
mordował	przeczytał	lemma
spokojne	spokojna	Gender
ochronny	ochronna	Gender
artystycznym	artystycznej	Gender
ministerstwem	ministerstwa	Case
somalijskie	somalijska	Gender
Arabem	Arabami	Number
mnożniku	mnożnikach	Number
amortyzatorach	amortyzatory	Case
solnemu	solnej	Gender
martwicą	świadomością	lemma
gdakała	gdakało	Gender
mijający	mijająca	Gender
alegorie	alegoriami	Case
gałęzie	gałąź	Number
hamujące	próbujące	lemma
półwyspach	półwyspie	Number
prosty	proste	Gender
obciążane	zatrzymane	lemma
pajęczynę	pajęczyny	Case
pierścienicach	pierścienice	Case
białogłowom	białogłowach	Case
oglądałem	starałem	lemma
hiperboliczne	hiperbolicznym	Case
aszkenazyjskim	wieloznacznym	lemma
traktorze	traktor	Case
bogactwo	bogactwa	Number
przełącznikowi	przełączniku	Case
żydzie	żyda	Case
mikstury	miksturami	Case
istocie	istotom	Number
koniczyn	koniczyny	Number
zbójcach	zbójców	Case
narodowości	narodowościom	Case
toyoty	toyot	Number
chwilce	chwilkom	Number
wydmy	wydma	Number
taksówka	taksówką	Case
wapieniu	wapień	Case
kolegą	kolegami	Number
synagogo	synagogi	Number
kwiliłabyś	uznawałabyś	lemma
silnym	silną	Gender
złożoną	złożonej	Case
borową	borowe	Gender
abchaskich	tureckich	lemma
makolągwy	zawartości	lemma
wszystko	wszystek	Gender
hamujcie	wydostawajcie	lemma
alejami	aleją	Number
knota	knotem	Case
dacie	zaimportujecie	lemma
inteligentnemu	wyuzdanemu	lemma
żywokostami	żywokosty	Case
zazdrościłeś	zazdrościłaś	Gender
egzotyczniejszych	płodnych	lemma
rozgrzeszą	zniszczą	lemma
pnący	pnąca	Gender
obawy	obaw	Case
szmuglerów	szmuglera	Number
brylant	brylanty	Number
odpoczywająca	odpoczywający	Gender
zniszczone	zniszczony	Gender
winogronowym	winogronową	Gender
karzą	spadają	lemma
hutę	huty	Number
mendy	mendo	Number
trwalszemu	trwalszej	Gender
wilki	wilka	Number
okostną	okostnymi	Number
szparagiem	szparagu	Case
indonezyjskiego	styczniowego	lemma
bibliotekarkom	pianom	lemma
ratę	raty	Case
zakonnicy	zakonnic	Number
zarżnijcie	zarżnij	Person
luksów	luksa	Number
szanowałaś	szanowałam	Person
toyoty	toyota	Number
dzikiego	zodiakalnego	lemma
kieliszkiem	kieliszkami	Number
minimalnego	polonijnego	lemma
googluję	googluje	Person
fenolu	fenol	Case
estetyczną	poznańską	lemma
kosztujący	wyglądający	lemma
dentystki	rarytasy	lemma
ocenę	oceny	Number
koszmarnym	sennym	lemma
porozmawiam	wezmę	lemma
wilkołaku	wilkołakach	Number
widocznemu	widocznej	Gender
kibicuję	potwierdzam	lemma
mitozy	mitoza	Number
oszołom	oszołomy	Number
kartograficzną	kartograficznym	Gender
czapeczko	czapeczki	Number
konfitury	konfitur	Case
kolorową	naturalniejszą	lemma
wirusowemu	wirusowej	Gender
upadku	upadki	Number
lepki	lepkie	Gender
klubem	klubami	Number
ryku	ryk	Case
sterczące	sterczący	Gender
harmonia	harmonią	Case
podziwiać	spiąć	lemma
lambdom	lambdzie	Number
witaminach	witaminy	Case
fretce	fretkom	Number
spieprzające	spieprzający	Gender
eucharystycznej	eucharystycznym	Gender
uzależnionemu	uzależnionej	Gender
lgnę	poluję	lemma
głuchą	głuche	Gender
malowidła	malowidło	Number
kuropatw	kuropatwy	Case
duchowe	największe	lemma
łapałbym	łapałbyś	Person
gumowej	oficjalnej	lemma
królikarnie	królikarni	Case
ostróg	ostrogi	Number
dowolne	dowolnym	Case
anarchistycznym	anarchistycznej	Gender
slupy	slupie	Number
zakazany	zakazana	Gender
anodę	anody	Number
zagranicą	zagranicy	Case
najatrakcyjniejszej	technologicznej	lemma
czopem	czopami	Number
kwadratową	kwadratowym	Gender
metrami	metry	Case
wróżko	wróżki	Number
łuny	łunę	Number
blaszanej	blaszanego	Gender
dymały	dymałyśmy	Person
przypływem	przypływie	Case
całe	obfitsze	lemma
ćwierćnuty	ćwierćnuta	Number
wrono	wrony	Number
papie	papom	Number
podejrzewała	przeczytała	lemma
henoteizm	henoteizmowi	Case
najjaśniejsza	najjaśniejsze	Gender
dziwny	zazdrosny	lemma
związkowcze	związkowcy	Number
schnie	schniesz	Person
adopcjom	adopcje	Case
żelaznym	żelaznej	Gender
daru	darze	Case
beztroskiego	realistycznego	lemma
chorwackim	sycylijskim	lemma
charytatywnej	charytatywnemu	Gender
poroży	poroża	Number
karta	karty	Number
ciekawy	ciekawym	Case
ślepotą	ślepotę	Case
czesałaś	czesałam	Person
grudniowe	grudniowym	Case
ostatni	ostatnich	Case
malarza	malarz	Case
mości	pasze	lemma
grzęznę	przoduję	lemma
wymiany	wymianami	Case
piątkami	piątkiem	Number
czarno-białą	najsolidniejszą	lemma
myszkami	myszką	Number
grzeszną	grzeszne	Gender
adoracje	wzgórza	lemma
przyjmą	zostawią	lemma
brylantowemu	odważniejszemu	lemma
potokowi	potokom	Number
sumy	sumie	Case
pocałunki	pocałunkach	Case
laików	laicy	Case
pirsy	pirs	Number
masztach	maszcie	Number
kokoszki	kokoszek	Number
dokładnym	wszelkim	lemma
dolną	zieleńszą	lemma
transformatorem	transformatorami	Number
pluszową	pluszowe	Gender
termos	termosy	Number
absorbowałby	splądrowałby	lemma
ślazów	ślazu	Number
rosyjską	rosyjskie	Gender
nurkujcie	trzebcie	lemma
ciekawym	ciekawą	Gender
mordach	mordy	Case
syndykalista	syndykaliści	Number
rubinem	rubinami	Number
dziewczynkom	dziewczynkami	Case
transformatorowi	transformatorom	Number
lodowcu	lodowce	Number
egipskim	słitaśnym	lemma
końskich	końskiego	Number
igrają	igrasz	Person
spawacze	spawaczy	Case
drgał	wysiadł	lemma
homoseksualne	homoseksualny	Gender
ucieczki	ucieczka	Number
okropnym	okropną	Gender
wydechu	wydechach	Number
histydyny	histydynach	Case
koktajli	koktajlami	Case
aminy	amino	Case
lubą	ujemną	lemma
metodystycznej	metodystycznym	Gender
trzodę	trzody	Number
społeczni	społecznych	Case
kapeluszowi	kapelusz	Case
użytkownikach	użytkowniku	Number
jednobarwne	jednobarwną	Gender
dwuręcznego	pewnego	lemma
bliźniego	bliźnich	Number
wodnym	wodną	Gender
boksytu	boksytowi	Case
jaskrawej	jaskrawym	Gender
poprawiała	spałaszowała	lemma
oponę	opony	Number
sardynka	sardynki	Number
dojrzalszy	niewyobrażalny	lemma
sztormy	sztormie	Number
archaiczną	archaicznym	Gender
pnącze	pnącza	Number
tonęłoby	tonęłaby	Gender
hiszpańskiego	hiszpańskim	Case
łyżki	łyżkę	Number
klawiszami	klawisze	Case
pocieszone	znalezione	lemma
najebanym	najebanej	Gender
złoczyńca	złoczyńcy	Number
lwiątko	lwiątku	Case
demokraty	demokratą	Case
kapłaństwie	kapłaństwo	Case
lekcją	pieczarą	lemma
podziwiające	podziwiający	Gender
koprolity	sauny	lemma
kosmonautki	kosmonautka	Case
kodeksami	mozaikami	lemma
fotki	wizyty	lemma
podałabyś	wyłudzałabyś	lemma
droższe	wdzięczniejsze	lemma
skarbce	skarbców	Case
złotnikiem	złotnikami	Number
dziecięcym	samarytańskim	lemma
kasiarzem	kasiarzami	Number
muzyczne	szczecińskie	lemma
krzycz	trzeb	lemma
mężczyźni	pociski	lemma
winnice	winnica	Number
niedorzecznicy	niedorzecznik	Number
pamiętnika	pamiętnikiem	Case
sławnego	sławnej	Gender
anarchistyczna	anarchistyczne	Gender
sycylijski	sycylijskie	Gender
bezzębny	bezzębna	Gender
szamba	szambo	Number
bębnisz	podejrzewasz	lemma
norweskiej	norweskiemu	Gender
zgorzeli	zgorzele	Number
surówkę	surówki	Case
końskiej	końskim	Gender
linijek	linijki	Case
zachętą	zachęto	Case
psami	psy	Case
hrabia	hrabi	Case
etymologiach	etymologiom	Case
amortyzatorze	amortyzatorem	Case
faceci	facet	Number
wyrzuciła	wyrzuciło	Gender
żebraczkę	żebraczka	Case
filozofach	filozofowie	Case
wiatraki	wiatrakom	Case
nieśmiertelnej	nieśmiertelnym	Gender
krety	kretów	Case
dodatkom	dodatkach	Case
słyszalnym	słyszalnego	Case
rożeńców	rożeńca	Number
agresorem	agresorami	Number
murzyna	murzynie	Case
kalifami	kalifem	Number
małżonką	małżonki	Case
kolegą	kolega	Case
wybrzeżami	wybrzeżom	Case
cięciwę	cięciwy	Case
bażynach	bażynie	Number
toponimowi	toponimom	Number
umieram	umieramy	Person
śledzionę	śledziony	Case
krzaków	krzaku	Number
okultyzmie	okultyzmu	Case
chuda	chudy	Gender
muzycznym	muzycznej	Gender
poniemieckiego	poniemieckich	Number
odbierzemy	zerwiemy	lemma
najwybitniejsze	najwybitniejszy	Gender
kosmiczna	kosmiczne	Gender
żywotne	żywotna	Gender
slawistów	slawisty	Number
skrzydełku	skrzydełko	Case
ciągniki	ciągnikach	Case
radni	radnymi	Case
przypominania	przypominanie	Case
dotknąłbyś	ukrywałbyś	lemma
archeologiczne	archeologiczny	Gender
astrologicznym	wszelkim	lemma
eksplozjach	eksplozji	Case
mięsnym	mięsne	Case
agresywnym	agresywną	Gender
szkołach	szkoły	Case
boksycie	boksytach	Number
słoniną	słoniny	Case
wygrane	wygrany	Gender
spódnicą	spódnicę	Case
trudnemu	trudnej	Gender
marynarze	stogi	lemma
sałaty	sałata	Number
kochana	zrzucona	lemma
młoty	młot	Number
sracz	sracze	Number
angielskie	sąsiednie	lemma
pupa	pupy	Case
najemników	najemnika	Number
szkatułom	szkatule	Number
waluty	walut	Number
demograficznego	porannego	lemma
kierować	razić	lemma
kwestionowane	wyjaśniane	lemma
monarchę	monarsze	Case
mikroskopy	przymiotniki	lemma
występują	występowały	Tense
tajnym	tajną	Gender
korzystałeś	korzystał	Person
mięsożernego	skórzanego	lemma
minimalnej	norweskiej	lemma
hawajskim	hawajskiej	Gender
nadużyciami	nadużyciem	Number
krajobraz	krajobrazy	Number
wędrowna	wędrowny	Gender
interpunkcję	interpunkcją	Case
pałace	pałac	Number
Szkoci	Szkocie	Number
burze	reżyserzy	lemma
rabin	rabinem	Case
nikczemna	nikczemny	Gender
południowego	południowej	Gender
możliwej	wiejskiej	lemma
winnicom	winnicy	Number
hiperbolicznej	hiperbolicznego	Gender
otchłaniach	otchłaniom	Case
lianą	lianami	Number
przewodniczącym	przewodniczący	Case
łamiesz	oskarżasz	lemma
wcześniejsze	wcześniejszy	Gender
opolskiej	opolskim	Gender
awangardą	awangarda	Case
genetycznego	genetycznej	Gender
potrzebną	potrzebne	Gender
bilardy	bilardom	Case
okuliści	okulista	Number
kiłą	kiły	Case
głębszym	głębszej	Gender
jadalnemu	przydatnemu	lemma
karzę	karzecie	Person
wądole	wądoły	Number
konfliktu	konfliktowi	Case
dąsaliście	wyświetlaliście	lemma
melonik	melonika	Case
świecka	świecki	Gender
głosuj	głosujmy	Person
fikcji	fikcja	Case
mylę	mylicie	Person
rozpuszczalnikach	rozpuszczalniki	Case
najbujniejsze	najbujniejszy	Gender
ojczyznami	ojczyzną	Number
pestkę	pestki	Number
butiku	butiki	Number
chińczyka	stóg	lemma
grochówka	wyjątek	lemma
alkoholiczką	stroikiem	lemma
pokazana	uczona	lemma
śródziemnomorskiego	śródziemnomorskiej	Gender
teoretyczną	teoretycznym	Gender
gruch	słuchawek	lemma
działaniu	działania	Case
enzymy	enzymie	Number
carowi	carom	Number
zacnej	zacnego	Gender
wielbłądy	wielbłąd	Number
seminaria	seminariów	Case
najdokładniejsze	najdokładniejsza	Gender
szkodzilibyście	szkodzilibyśmy	Person
płaszczyznami	płaszczyzny	Case
rodacy	rodakom	Case
półfinalistek	półfinalistki	Number
porażka	porażki	Number
bram	bramy	Case
dostawczaków	rzutów	lemma
rządzący	rządząca	Gender
zdobiąca	zdobiące	Gender
żaglach	żaglu	Number
pompami	pompą	Number
fosie	fosę	Case
nieokreślonej	nieokreślonym	Gender
miedzianą	miedziane	Gender
przeżuwacze	przeżuwaczu	Number
krup	krupy	Number
maszynopisie	maszynopisy	Number
majonez	majonezy	Number
najatrakcyjniejsze	odważne	lemma
podstawach	podstawom	Case
uzasadnieniach	uzasadnieniu	Number
mikrofon	mikrofony	Number
najatrakcyjniejszym	tajskim	lemma
parafia	parafię	Case
naparstnicy	naparstnico	Case
szkodniki	szkodnikami	Case
najobszerniejszy	narodowy	lemma
angina	słód	lemma
miesiączkom	miesiączce	Number
entuzjasta	entuzjastę	Case
żądałybyśmy	żądajmy	Mood
kwiatku	kwiatki	Number
pamiętamy	pamiętają	Person
darmowy	darmowe	Gender
wrzeciona	wrzeciono	Number
kontynentalne	kontynentalną	Gender
najbliższego	najbliższej	Gender
tygrysica	tygrysico	Case
opiekunom	opiekunowi	Number
habitami	habitom	Case
upuściłaś	upuściła	Person
brodzenie	uznawanie	lemma
porzeczka	porzeczki	Number
organizowano	uprzedziwszy	lemma
tyłom	tyłach	Case
grzechotek	grzechotki	Number
zajączka	zajączek	Case
cyrkowych	trwalszych	lemma
puszczę	zostawię	lemma
wyglądałaby	wyglądałoby	Gender
pirolizyno	pirolizyna	Case
duchowego	uważnego	lemma
woźny	woźnym	Case
dyskoteką	dyskotekami	Number
ketonach	ketonie	Number
mozaiki	mozaik	Case
pliki	plik	Number
monologu	monolog	Case
pretora	pretorem	Case
gromadzimy	wyglądamy	lemma
wahałybyście	wahałybyśmy	Person
wizytę	wizyty	Number
najdoroślejszym	niezwykłym	lemma
wiśnię	wiśnie	Number
stanach	stanów	Case
zapraszałem	zapraszał	Person
łotewskie	oderwane	lemma
pojemnikami	pojemniki	Case
sługa	słudze	Case
ceramicznych	ceramicznego	Number
japonek	japonki	Case
hamowałem	rozpaczałem	lemma
skłamiecie	zerżniecie	lemma
łamiący	siedzący	lemma
niewiastę	niewiasta	Case
głośny	głośne	Gender
splądrowałbym	splądrowałby	Person
ramieniem	ramionami	Number
atakowany	wyjaśniany	lemma
krótką	krótkim	Gender
braterski	braterskie	Gender
dwójek	dwójki	Number
kapitan	kapitanowie	Number
najdawniejsze	sejsmiczne	lemma
euklidesowych	platynowych	lemma
pestycydu	pestycydów	Number
ekosystem	ekosystemy	Number
zaciążyło	zaciążył	Gender
nowych	nowego	Number
rozważyłabym	rozważyłaby	Person
platynowej	platynowego	Gender
imponujące	uczęszczające	lemma
żabek	żabki	Case
marcowych	szkodliwych	lemma
grafitowym	grafitową	Gender
najgłębszy	najgłębsze	Gender
codzienny	codzienna	Gender
religią	religię	Case
bestia	bestie	Number
lankijskie	nieszkodliwe	lemma
występujące	występująca	Gender
wracający	wracająca	Gender
agregaty	agregatach	Case
marudźcie	wdychajcie	lemma
autografie	autografach	Number
pusta	pusty	Gender
zwycięstwa	zwycięstwo	Number
śliną	ślinę	Case
systemu	systemów	Number
ziołami	zielem	Number
ilorazy	witraże	lemma
hiperbol	hiperboli	Number
mężom	mężami	Case
papierach	papierów	Case
dalszych	obojętnych	lemma
działką	działkę	Case
powieki	powieko	Number
opróżnimy	uśpimy	lemma
napowietrzyłyby	zimowałyby	lemma
wesołej	wesołego	Gender
biograficzny	zimozielony	lemma
miłą	miłym	Gender
azerbejdżańskim	azerbejdżańskiej	Gender
dożyją	dożyjecie	Person
sprawiajcie	sprawiałybyście	Mood
zmywarki	zmywarek	Number
wyniesiony	wyniesiona	Gender
kaukaską	kaukaskie	Gender
anonsów	obszarów	lemma
mamrocz	mamroczmy	Person
krzyżyka	krzyżyk	Case
symulacjami	symulacją	Number
fantastycznego	fantastycznej	Gender
iglasty	ziemny	lemma
przecinkiem	przecinek	Case
pisma	pismu	Case
legionistach	legioniści	Case
wąchajcie	wąchałybyście	Mood
dziesiętnym	dziesiętną	Gender
izbę	izby	Number
szefowie	szefie	Number
kapitalistycznego	nowoczesnego	lemma
zeznaniach	zeznaniami	Case
komórkowego	niechlujnego	lemma
pawiana	pawianów	Number
książkową	książkowym	Gender
zantagonizowała	zantagonizowałaś	Person
ciemieniu	ciemię	Case
kostarykańskiej	świeckiej	lemma
lantanowcowi	lantanowiec	Case
liście	liściom	Case
znamię	znamiona	Number
doskonalsze	doskonalsza	Gender
chorobowego	chorobowej	Gender
pasierbem	pasierbowi	Case
sumę	sumo	Case
planami	planom	Case
trudzie	trudem	Case
błyskający	ryczący	lemma
mulim	mulej	Gender
krewnej	krewnych	Number
zmienne	zmienna	Number
orgazmów	orgazmu	Number
puchacza	puchacze	Number
rynki	rynek	Number
zboże	zboża	Number
pozorna	pozorny	Gender
świecka	świeckie	Gender
krótkowłose	otyłe	lemma
walkę	walki	Number
profesorów	profesora	Number
osty	oset	Number
działy	przypomniały	lemma
kasiarza	kasiarzy	Number
dodawaj	śnij	lemma
bezczelne	nieparzyste	lemma
wirtualne	wirtualną	Gender
zacne	zacny	Gender
ubezpieczeniem	ubezpieczenia	Case
dłoń	dłonie	Number
ambitny	ambitne	Gender
popołudniami	popołudniem	Number
urugwajskim	urugwajską	Gender
alfabetycznym	alfabetyczną	Gender
homoseksualistów	homoseksualistami	Case
moli	mola	Number
tryby	tryb	Number
demokratyczne	średnie	lemma
pyłach	pyły	Case
klaczą	klaczami	Number
szczepieniami	szczepień	Case
dębowe	rycerskie	lemma
fluor	fluoru	Case
cytowałybyście	zerwałybyście	lemma
pielgrzymkę	pielgrzymki	Case
siódemkę	siódemce	Case
drąg	drągi	Number
kle	kłach	Number
strasznej	strasznym	Gender
podchodzi	podchodzimy	Person
matkę	matki	Number
piłeczki	piłeczka	Number
krótkiemu	krótkiej	Gender
helisach	helisom	Case
gwałciciela	gwałcicieli	Number
portalowi	portalom	Number
rozkładach	rozkładu	Number
przeżyły	przeżyją	Tense
kolosem	kolosami	Number
nazw	nazwami	Case
potańcówką	potańcówkami	Number
dostawał	dostawało	Gender
pudel	pudle	Number
otrzymana	otrzymany	Gender
termosfery	termosfera	Number
sztandary	sztandarze	Number
fajna	fajne	Gender
portfelu	portfele	Number
najświętszego	najświętsze	Case
sznurki	sznurek	Number
komplementem	komplementu	Case
pogardliwy	pogardliwe	Gender
tropikalnym	tropikalnej	Gender
ciastka	ciastkami	Case
gnane	gnany	Gender
samuraj	samuraju	Case
najgłośniejsze	najgłośniejszą	Gender
kwiatostany	kwiatostanie	Number
palaczkom	palaczkach	Case
bydgoskiemu	bydgoskiej	Gender
liściową	liściowym	Gender
listopadowe	listopadowego	Case
rozmywa	uwiedzie	lemma
szlachcie	szlachtę	Case
konsekwencja	konsekwencje	Number
shoguna	shoguni	Number
meteorologowi	meteorologom	Number
neurologia	neurologii	Case
modliło	pozostawało	lemma
obczyzną	obczyznami	Number
kategorie	kategoria	Number
dodane	dodany	Gender
mapy	mapami	Case
równania	równaniom	Case
deszczowym	deszczową	Gender
połączenia	połączenie	Number
topolami	topole	Case
łososiowy	stromy	lemma
rewolwer	rewolwerem	Case
ziomalom	ziomali	Case
podpiszą	zaniechają	lemma
wodospadach	wodospadzie	Number
żwirów	żwirami	Case
machając	przestrzegając	lemma
anarchistyczne	anarchistyczny	Gender
groby	grób	Number
interpunkcje	interpunkcja	Number
uderzyłabym	uderzyłbym	Gender
skowronkach	skowronków	Case
nektar	nektarze	Case
gitary	gitar	Number
gadożerami	gadożery	Case
niewyobrażalnej	niewyobrażalnego	Gender
skrótowce	skrótowcu	Number
podchodziłoby	szantażowałoby	lemma
zawiedziony	zawiedziona	Gender
rozdział	rozdziały	Number
podwodny	podwodne	Gender
węglanów	węglanu	Number
zdrowej	zdrowemu	Gender
zdania	zdaniu	Case
nośmy	nosiłybyśmy	Mood
rabaty	rabat	Number
mitologiczną	poważniejszą	lemma
traktowało	traktowała	Gender
logarytmiczne	logarytmiczną	Gender
nieorganicznej	nieorganicznego	Gender
przyjąłby	przyjąłbym	Person
radiolatarnie	radiolatarnię	Number
znajdował	znajdowało	Gender
układem	układami	Number
elektrodami	elektrody	Case
berberyjskie	berberyjską	Gender
kwiatowa	płatna	lemma
cło	cłem	Case
docenta	docentów	Number
raciborskie	raciborska	Gender
andyjska	andyjski	Gender
wiankowi	wianku	Case
położenia	położenie	Number
dziedzinę	dziedzinie	Case
zimniejszym	zimniejszej	Gender
brodo	brody	Number
kurtki	kurtkę	Number
niewiadomych	niewiadome	Case
rościesz	rościecie	Person
gryząc	susząc	lemma
mość	mości	Number
religiach	religie	Case
taśmach	taśmie	Number
koniakowi	koniakom	Number
grzęźnie	zmartwychwstaje	lemma
jeżach	jeżu	Number
amperomierze	amperomierz	Number
zainteresowaniach	zainteresowania	Case
wulgaryzmach	wulgaryzmy	Case
boja	boje	Number
rozwiążemy	wskażemy	lemma
ludową	ludowa	Case
fotograficznego	skromnego	lemma
gorszy	gorsze	Gender
skromnego	skromnych	Number
należeliście	szczekaliście	lemma
podała	podał	Gender
pirytami	pirytem	Number
filtrów	filtru	Number
przemytników	przemytnikom	Case
aukcjach	aukcji	Number
obciążano	słyszano	lemma
sobole	sobola	Number
rzemiosła	rzemiosło	Number
bezwzględnego	bezwzględnej	Gender
pasożytniczej	pasożytniczego	Gender
bachorze	bachorowi	Case
kapitalistach	kapitalistom	Case
rodzinnej	rodzinnego	Gender
poetach	poecie	Number
parkingami	parkingiem	Number
pozytywek	pozytywki	Number
analnym	analnej	Gender
dyplomem	dyplomami	Number
charkam	rąbię	lemma
niski	niskiego	Case
chirurgiczną	chirurgiczna	Case
ludźmi	człowiekiem	Number
kalinom	kaliny	Case
niedźwiadki	niedźwiadku	Number
kruchych	włoskich	lemma
młodą	żelazną	lemma
dymaliśmy	dymali	Person
widelczyków	widelczyki	Case
kontynentalnych	kontynentalne	Case
dżentelmenów	dżentelmena	Number
słabości	słabość	Number
małpeczką	małpeczkami	Number
łyse	łysa	Gender
alkoholiczek	alkoholiczki	Number
wodoodpornym	wodoodporną	Gender
hydrostatyczną	ponadprzeciętną	lemma
powtórzona	usunięta	lemma
genewskiego	starczego	lemma
koperta	kopercie	Case
bolidy	bolid	Number
kubły	kubeł	Number
dręczyli	zapominali	lemma
bolid	rektor	lemma
grejom	wałachom	lemma
filozoficznemu	filozoficznym	Case
grzecznej	grzecznego	Gender
cyborgami	cyborgiem	Number
kosom	kosy	Case
boisku	boiskach	Number
sumienia	sumieniu	Number
montażystkami	montażystki	Case
jagnięcy	jagnięce	Gender
tenisistów	tenisistach	Case
jasnożółte	jasnożółtym	Case
policzków	policzka	Number
astronautę	astronautów	Number
dźwigni	dźwignię	Case
sztylecie	sztylety	Number
milicji	milicjach	Number
lucernami	lucerną	Number
dwoistej	platynowej	lemma
pociechę	pociechą	Case
estońskim	estońską	Gender
szczwołem	szczwołami	Number
przewodniczącym	przewodniczącego	Case
okna	okno	Number
symptomami	symptomy	Case
gwizdek	gwizdku	Case
rasom	rasie	Number
kosmaty	kosmata	Gender
karłom	karłów	Case
zajęcy	zające	Case
swata	swatów	Number
kserowałbyś	kserowałby	Person
złodziejowi	złodzieju	Case
rund	rundy	Case
najpiękniejsze	ontologiczne	lemma
ilorazie	ilorazach	Number
pokazano	wymyślono	lemma
szpadla	szpadli	Number
gdańskiego	gdańskiej	Gender
rodzaju	rodzajów	Number
droższą	droższe	Gender
lekki	starożytny	lemma
jesiotra	jesiotrów	Number
wirusowemu	wirusowego	Case
potencjalnej	potencjalnym	Gender
literówka	literówki	Number
jednogłośnego	spójnego	lemma
gromady	gromadę	Number
węszyłybyśmy	węszmy	Mood
fortu	satrapy	lemma
melodie	melodiami	Case
mecie	meta	Case
nastoletnia	nastoletni	Gender
kucamy	rzygamy	lemma
ojczystą	ojczystym	Gender
trębaczach	trębacze	Case
technologiczna	technologiczny	Gender
księżniczki	księżniczkę	Case
koleżanki	koleżankę	Number
taty	tatów	Number
księżycową	księżycowe	Gender
homoseksualną	sytą	lemma
doprowadzające	sarkające	lemma
zeznań	zeznania	Number
przyjemnościach	przyjemności	Number
astrologiczne	śnieżnobiałe	lemma
gwarancją	gwarancji	Case
obgadałyśmy	wydostawałyśmy	lemma
piłami	piłą	Number
wybierająca	wybierające	Gender
myśli	myślach	Number
wieprzowina	wieprzowinę	Case
doświadczeniu	doświadczeniom	Number
bucie	buty	Number
koper	kopry	Number
dumniejszego	zamkniętego	lemma
demokratyczny	rządowy	lemma
wybuchowego	wybuchowej	Gender
kuzynkami	kuzynką	Number
kalafiora	kalafiorów	Number
medyczna	perska	lemma
działką	działce	Case
taksówce	taksówkach	Number
nizinę	niziny	Number
kukaj	kukajcie	Person
boskiemu	boskiej	Gender
ograniczałeś	zerżnąłeś	lemma
minimalistyczną	minimalistycznym	Gender
cząstki	cząstkę	Case
popełniłem	popełnił	Person
sprzeczkę	sprzeczki	Number
nawóz	nawozy	Number
toga	togi	Number
blachosmrodowi	blachosmrodom	Number
fregatach	fregacie	Number
wodzu	wodzowie	Number
sierpy	sierp	Number
żarówkom	żarówek	Case
stadła	stadłach	Case
cosinusie	cosinusach	Number
twórcy	twórco	Number
najdroższymi	wesołymi	lemma
szpakom	szpakowi	Number
motorniczym	motorniczych	Number
wielbłądami	wielbłądy	Case
atomie	zapytaniu	lemma
jednorożec	jednorożce	Number
zakrzywiona	zakrzywioną	Case
żagli	żagla	Number
szpinetu	szpinetów	Number
katalogami	katalogiem	Number
zimowe	zimowego	Case
płońmy	zdementujmy	lemma
jarach	jarze	Number
kazachska	kazachski	Gender
szkołach	szkole	Number
niepewne	niepewna	Gender
kalarepy	ścieżki	lemma
antarktyczne	nikotynowe	lemma
oboro	obory	Number
fragment	fragmentem	Case
dodaję	tęsknię	lemma
wyświetlamy	wyświetlam	Person
lojalce	lojalkom	Number
zasobem	zasobami	Number
lękało	lękała	Gender
komunistach	komunistami	Case
ozdoba	ozdobo	Case
fotosyntezy	fotosyntezie	Case
elektronowoltom	elektronowoltach	Case
winna	winnej	Case
najliczniejszy	najliczniejsze	Gender
Słowiankach	Słowianek	Case
prezesach	prezesie	Number
broimy	parkujemy	lemma
kontrolę	kontrolo	Case
andyjskim	obłym	lemma
kupią	kupicie	Person
wysoka	wysoki	Gender
miasteczkiem	miasteczku	Case
kakaowców	kakaowca	Number
opiekowała	rozwijała	lemma
kopiując	przesadzając	lemma
kasty	kastę	Number
haftowane	tłumaczone	lemma
wybuchnęły	wybuchnęłyście	Person
doprowadzały	zaczęły	lemma
znakomitym	znakomite	Case
esencjonalną	esencjonalne	Gender
pojawił	wylał	lemma
politycznych	polityczne	Case
burzyłyby	skazałyby	lemma
podróżowały	podróżowałyście	Person
anarchistyczna	anarchistyczny	Gender
salony	salon	Number
wylewem	wylewie	Case
administrację	administracje	Number
awangarda	przekleństwo	lemma
chusteczki	chusteczkę	Number
chrześcijańska	chrześcijańskie	Gender
bankrutuję	bankrutujemy	Person
toalety	toaleta	Case
kozy	kóz	Number
szewskie	szewski	Gender
kardiologu	kardiologach	Number
nauczycielek	nauczycielki	Case
enzym	enzymy	Number
ciekłybyśmy	ciekłyby	Person
fenickiej	pionowej	lemma
filologię	filologii	Case
ławach	ławy	Case
jasnoszarej	jasnoszarego	Gender
metodologię	metodologia	Case
warkę	warce	Case
umysłem	umysłami	Number
juliańska	narciarska	lemma
islandzkich	prostokątnych	lemma
teksem	teksami	Number
saskimi	saskich	Case
żerdzie	żerdzi	Number
trędowatymi	trędowatym	Number
kłujące	polecające	lemma
obejmujecie	obejmujesz	Person
poważniejszej	poważniejszego	Gender
spinki	spinkę	Case
etymologicznego	ostatniego	lemma
sielankowy	sielankowa	Gender
stałą	stałe	Number
goliłem	goliłam	Gender
stonóg	stonogi	Number
antologie	antologia	Number
kwartałowi	kwartałom	Number
sześcianie	sześciany	Number
przodowałaby	przodowałoby	Gender
ostateczną	ostatecznym	Gender
batem	batowi	Case
bagna	bagnom	Case
biegunkę	biegunce	Case
eksperymentując	ratując	lemma
kwietniem	kwietniami	Number
pastorze	pastorach	Number
szczupła	szczupły	Gender
destrukcyjnym	destrukcyjnej	Gender
schronień	schronienia	Number
sprzyjały	sprzyjają	Tense
żelazny	żelazna	Gender
pocztowym	pocztową	Gender
dworcem	dworcami	Number
kreta	krety	Number
wydmy	wydm	Case
cielska	wyspy	lemma
bawi	przoduje	lemma
piekarniami	piekarnią	Number
wahanie	wahania	Number
balów	balu	Number
mandatowi	mandatu	Case
cłach	cłami	Case
koszmarnego	koszmarny	Case
chowali	rzucili	lemma
umierasz	umieram	Person
wariatem	wariatami	Number
mrówek	mrówki	Number
jajowodach	jajowodzie	Number
chwilki	świerzbu	lemma
półkola	półkolem	Case
realizmie	realizmu	Case
koprami	koprom	Case
cnotliwa	cnotliwy	Gender
wronach	wronie	Number
albańskiej	albańskiemu	Gender
najobfitsza	najobfitszy	Gender
planszą	planszami	Number
nagiej	nagiego	Gender
kwiatuszki	termosfery	lemma
dramatycznego	dramatycznej	Gender
dolnołużyckiego	szczęśliwego	lemma
foteli	fotele	Case
nadobne	nadobną	Gender
męskiemu	męskiej	Gender
meteorolog	meteorolodzy	Number
oglądający	oglądająca	Gender
poty	pot	Number
pobożne	pobożną	Gender
różdżki	różdżkę	Number
produkt	produkcie	Case
polnemu	polnej	Gender
niejadalną	niejadalnym	Gender
narciarza	narciarzy	Number
umowie	umowom	Number
wyhaftowany	wyhaftowane	Gender
czaszką	czaszkami	Number
najbezpieczniejszym	wulkanicznym	lemma
grzeczności	grzecznościach	Number
nienaturalne	nienaturalną	Gender
semantycznym	semantycznej	Gender
pandemię	pandemią	Case
hydraulicznej	twardej	lemma
ateisty	ateistów	Number
równoleżnikami	równoleżników	Case
brudzę	wierzę	lemma
kółkach	kółku	Number
mleczku	mleczkach	Number
techniku	technicy	Number
boginie	bogini	Number
noszach	nosze	Case
bezpłatnym	pewniejszym	lemma
białorzytkę	białorzytka	Case
głuszce	głuszców	Case
marchewkowe	zmęczone	lemma
zwarcia	zwarcie	Number
bezbarwny	bezbarwne	Gender
skórach	skórze	Number
klucze	kluczami	Case
działający	działająca	Gender
podmioty	podmiocie	Number
wdzięczniejszą	wdzięczniejszym	Gender
chowałabym	wymogłabym	lemma
połykał	upuścił	lemma
klan	klany	Number
rzeczownikiem	rzeczownik	Case
innowacje	innowacjo	Number
dług	długi	Number
kajałbym	kajałby	Person
galopujmy	traktujmy	lemma
konopiami	konopią	Number
jebnięty	kompilowany	lemma
telegrafów	telegrafu	Number
szkicu	szkicach	Number
filmowca	filmowców	Number
gospodarze	gospodarzach	Case
słonie	słoniu	Number
krynicę	krynice	Number
przedramię	przedramiona	Number
dziennych	niepodległych	lemma
charaktery	charakterze	Number
notatce	notatkom	Number
końskie	koński	Gender
kawką	kawki	Case
kuleczkę	kuleczko	Case
antykliną	antyklino	Case
uosobienie	uosobienia	Case
bawiła	bawił	Gender
trawę	trawie	Case
przedostatnią	przedostatnim	Gender
wygodny	wygodna	Gender
kalką	kalki	Case
pozioma	poziomy	Gender
lokatora	lokatorów	Number
rasiści	rasisto	Number
rotorze	rotor	Case
parówka	parówki	Number
pracoholikom	pracoholikami	Case
odraczałeś	wyłeś	lemma
skrótowców	skrótowce	Case
oddają	oddaje	Number
chodniku	chodniki	Number
lodówki	lodówkę	Number
artystką	artystkę	Case
dosięgnie	zakocha	lemma
mandaryna	mandarynów	Number
szczerej	szczera	Case
milczałbym	milczałby	Person
odwiedzajmy	odwiedzałybyśmy	Mood
kadzią	kadziami	Number
listopadowy	listopadowa	Gender
raportem	raport	Case
symulowałem	symulowałeś	Person
badam	rozwijam	lemma
spałaszuję	wyloguję	lemma
liczydła	nogawki	lemma
chwilo	chwilą	Case
budujący	najzamożniejszy	lemma
rzutom	rzuty	Case
dymnice	dymnicę	Number
fonetycy	fonetyku	Number
hipoteka	hipoteki	Number
rektorów	rektora	Number
hiperbolicznym	hiperboliczną	Gender
maści	maściami	Case
srały	srałyście	Person
żyznym	żyznych	Case
ezoterycznej	tatarskiej	lemma
gagauski	gagauskie	Gender
szkodliwych	szkodliwego	Number
najcichsze	najcichszy	Gender
prawach	prawa	Case
muszka	muszki	Number
mejla	papierosa	lemma
bułek	bułki	Case
rozmyślicie	zapamiętacie	lemma
obrzęknął	obrzęknęła	Gender
azerskie	azerską	Gender
strachem	strachu	Case
autentycznego	autentycznej	Gender
brudną	trwalszą	lemma
prawnikami	prawnikiem	Number
sportów	sportu	Number
przeczytają	przeczytacie	Person
higieniczne	higieniczną	Gender
interniści	przepiórki	lemma
sektach	sekcie	Number
deszczówki	deszczówkę	Number
faszystom	faszystów	Case
antykiem	antykami	Number
muszkietom	muszkietowi	Number
martwotą	szczęką	lemma
ruszacie	ruszają	Person
rachunek	rachunki	Number
fortele	portrety	lemma
cebulowa	cebulowy	Gender
miecha	miechów	Number
najbledsze	najbledszą	Gender
organizmy	organizm	Number
końskie	prawnicze	lemma
produkuje	produkują	Person
aktywna	aktywne	Gender
komputerowym	komputerowej	Gender
minimalne	powszechne	lemma
moratorium	moratoriom	Number
równiny	równinę	Number
grosz	grosze	Number
skracałoby	skracałaby	Gender
cofały	wydostawały	lemma
ciężarówki	ciężarówkę	Number
reguło	regule	Case
haki	wyroby	lemma
najinteligentniejszy	samodzielny	lemma
psychiatrów	psychiatrami	Case
dziesiętnego	późniejszego	lemma
elementu	elementów	Number
żołnierską	żołnierskiej	Case
wombaty	wombat	Number
kamieniarzy	kamieniarze	Case
wieczorach	wieczorze	Number
plantacje	plantację	Number
bareizm	bareizmu	Case
symptomem	symptomami	Number
żmiją	żmijami	Number
fundamentami	fundamentem	Number
doda	wymusi	lemma
idealnym	parzystym	lemma
dymu	dym	Case
krasula	krasulą	Case
śnieżka	śnieżko	Case
architektonicznej	architektonicznym	Gender
baterię	baterie	Number
krytycznych	wygodnych	lemma
saneczkarzem	saneczkarzu	Case
nagietki	nagietek	Number
mruczeć	wyznaczyć	lemma
zwycięzca	zwycięzcy	Number
ptakowi	ptaku	Case
tłuste	tłustym	Case
namibijskiej	namibijskim	Gender
połykania	połykaniu	Case
ramo	ramy	Number
gwiazdozbiór	gwiazdozbiorze	Case
górskie	górską	Gender
świętami	święta	Case
nożowników	nożownika	Number
nauczyciela	nauczycieli	Number
pniakami	pniakiem	Number
moście	mosty	Number
pługu	pług	Case
podziale	podziały	Number
stypendiom	stypendium	Number
wykom	wyki	Case
nosicie	nosimy	Person
kobrę	kobra	Case
dementowałabyś	schnęłabyś	lemma
bólach	bólów	Case
dziwem	dziwami	Number
logicznego	nowego	lemma
wygrasz	wygra	Person
najuczciwsze	najuczciwszą	Gender
leczony	leczona	Gender
odradzająca	odradzające	Gender
fabryki	fabryka	Number
cytujące	parkujące	lemma
wuja	wujowi	Case
błonie	błona	Case
promocją	promocji	Case
kryształ	krysztale	Case
wrednej	wrednego	Gender
meksykańską	meksykańskim	Gender
żelatynę	żelatyną	Case
tabernakulum	tabernakulach	Number
homoseksualne	homoseksualna	Gender
temperatury	temperaturach	Case
zimnym	zimnymi	Case
parowozowniami	parowozowniach	Case
budzą	budzę	Person
szermierce	szermierkę	Case
pożądane	zbierane	lemma
koenzymy	koenzymów	Case
nieśmiałe	nieśmiała	Gender
stoliki	stolik	Number
pogrzebać	zostawić	lemma
serwatki	serwatka	Number
grabiły	grabią	Tense
odkryciami	odkrycia	Case
smołę	smoły	Case
optymistka	optymistce	Case
znaczmy	znaczyłybyśmy	Mood
dyskotekowych	nostalgicznych	lemma
bezpiecznika	usługi	lemma
cynikom	cynikowi	Number
pianinie	pianino	Case
mocnej	mocnemu	Gender
fizjoterapeutami	fizjoterapeutów	Case
konstytucje	konstytucję	Number
scholastycznej	scholastyczną	Case
lankijskie	płytkie	lemma
przerwa	przerwą	Case
cery	związkowcy	lemma
portmonetki	portmonetkę	Number
arytmetyczną	szarawą	lemma
lokatorze	lokatorach	Number
ciosłami	ciosły	Case
klonowych	turystycznych	lemma
jęte	przeinaczone	lemma
głosowaniami	głosowaniem	Number
kurwy	radość	lemma
bezbarwne	bezbarwna	Gender
senacie	senaty	Number
psychopatycznemu	psychopatycznego	Case
kolejarzem	kolejarza	Case
obserwowaniem	obserwowaniu	Case
diecezjalnej	żółtawej	lemma
duńskim	tropikalnym	lemma
lubię	lubicie	Person
nadgarstki	nadgarstku	Number
esencjami	wyznacznikami	lemma
nonany	nonanów	Case
odradzalibyśmy	postradalibyśmy	lemma
najładniejsze	najwybitniejsze	lemma
ignorujesz	wywołujesz	lemma
tajnemu	tajnej	Gender
dziedzica	dziedzicem	Case
minuty	minuta	Number
polana	polany	Number
bębni	bębnię	Person
gnidom	gnidzie	Number
realizowaniem	realizowaniu	Case
radziło	radziła	Gender
gromy	opactwa	lemma
obłąkanej	obłąkanego	Gender
truciźnie	trucizny	Case
posłowie	pośle	Number
magazynami	magazynów	Case
najaktywniejszym	najaktywniejszą	Gender
przeczytało	przeczytała	Gender
odbieraj	zmieniaj	lemma
marcowe	marcowa	Gender
Izraelki	Izraelek	Case
najdoskonalszej	najdoskonalszym	Gender
iberyjskiego	iberyjskiej	Gender
pachy	pach	Number
funkcjonariusza	funkcjonariuszu	Case
magnetofonach	magnetofonie	Number
siedzenia	siedzenie	Number
epicentrum	epicentrami	Number
komoryjska	komoryjskie	Gender
pamięta	pamiętają	Person
dowodziłam	dowodziłem	Gender
jałowcu	jałowce	Number
gwiezdnej	skromnej	lemma
podniebienie	podniebienia	Number
minusów	minusach	Case
tunelu	tunele	Number
poświat	poświaty	Number
soku	sok	Case
nieuważną	nieuważnym	Gender
bolesnym	sprawnym	lemma
zakochała	zakochałam	Person
pływacy	pływakach	Case
haczyków	haczyka	Number
firmie	porze	lemma
zmarszczek	zmarszczkach	Case
technikom	technice	Number
losy	los	Number
centrum	rzygania	lemma
spinach	spinów	Case
pistacja	pistacje	Number
obraźliwa	obraźliwe	Gender
miejscownik	miejscowniki	Number
żuchwę	żuchwy	Number
równoczesne	równoczesna	Gender
sardynkach	sardynce	Number
serwerownie	serwerownia	Number
krawcy	krawiec	Number
domniemaną	domniemanym	Gender
dłoń	dłonią	Case
konsulat	platan	lemma
bystrych	wirtualnych	lemma
zyskiem	zysk	Case
rasistowska	rasistowski	Gender
grono	grona	Number
poczekałabym	poczekałbym	Gender
nadużyciom	nadużyciu	Number
przyjmuję	przyjmujecie	Person
połączone	połączona	Gender
prostata	prostaty	Number
krtaniowy	starofrancuski	lemma
Cezarze	Cezarach	Number
bratowej	bratową	Case
czytelny	czytelne	Gender
bieługi	sułtanów	lemma
sklejka	sklejki	Number
śledzony	śledzona	Gender
mieszaliście	mieszali	Person
maszerowały	zjadły	lemma
biblijnej	wiecznej	lemma
odkryje	zrobi	lemma
dżokery	dżokerze	Number
grabmy	grabiłybyśmy	Mood
rozwijały	rozwijają	Tense
nóżkami	nóżką	Number
najszerszą	najszerszej	Case
oddechy	oddechu	Number
kantu	kancie	Case
bibliotekami	bibliotek	Case
akcentu	akcencie	Case
psom	psami	Case
koszona	przygotowana	lemma
Fenicjanom	Fenicjaninowi	Number
dożywotnią	dożywotnie	Gender
dalszym	dalszej	Gender
odważnego	odważnej	Gender
buforze	buforach	Number
herby	herb	Number
inwestycję	inwestycji	Case
łacińską	łacińskim	Gender
stratosfer	stratosferach	Case
brązowawe	brązowawą	Gender
heretyckich	różniczkowalnych	lemma
bawełnianych	różnobarwnych	lemma
chamach	chamy	Case
chudą	chudej	Case
purytanizmem	purytanizmie	Case
wschodnim	wschodnią	Gender
spodu	spód	Case
dokonaną	dokonanym	Gender
spodenki	spodenkom	Case
pewniejszym	pewniejszej	Gender
fasadach	fasady	Case
nurkowanie	wymaganie	lemma
nieme	niemy	Gender
koszmarami	koszmarem	Number
wstążka	wstążki	Number
łuczników	łucznikach	Case
amina	aminy	Number
okresami	okresach	Case
spożywczym	spożywczemu	Case
patenty	patent	Number
biskupem	biskupami	Number
roboty	robot	Number
grejpfrut	grejpfruta	Case
zajawce	zajawki	Case
sylabach	sylabami	Case
plotek	plotki	Number
łabędzie	łabędziu	Number
abonowaliście	wisieliście	lemma
poniemieckie	poniemiecki	Gender
magnezowe	magnezowych	Case
sprężynie	sprężyna	Case
martwcie	martwmy	Person
chochle	chochla	Number
najzwyczajniejsze	najzwyczajniejszym	Case
glutaminę	glutaminy	Number
torcik	torciki	Number
bitwę	bitwie	Case
płaszczy	płaszczach	Case
leszczy	leszcze	Case
ojczyzny	ojczyzną	Case
wahający	wahająca	Gender
deptak	powiekę	lemma
hejterów	walców	lemma
wędrowcu	wędrowca	Case
smug	smugi	Number
beżowe	beżowy	Gender
elastyczna	ręczna	lemma
dostajemy	dostajesz	Person
sześcianach	sześciany	Case
długopisy	długopisie	Number
bytu	bytów	Number
szerokiemu	szerokiej	Gender
cechami	cech	Case
gigantycznemu	gigantycznej	Gender
tort	torty	Number
grozimy	grożę	Person
królewski	królewska	Gender
pasierba	pasierbów	Number
obrazami	obrazem	Number
trafnym	trafną	Gender
mosiężnej	mosiężnemu	Gender
balsamom	ratom	lemma
klatka	klatki	Number
dziąsłu	dziąsłem	Case
maklerzy	maklerom	Case
pracownikach	pracownicy	Case
bystre	bystra	Gender
ciastka	ciastko	Number
kuchenny	kuchenna	Gender
sunęłyście	suniecie	Tense
oglądaliśmy	przeżyliśmy	lemma
powtarzałybyście	powtarzajcie	Mood
straciliśmy	stracili	Person
chwycie	chwyt	Case
dźwiękowym	zwierzęcym	lemma
helikopterach	helikopterami	Case
potwora	potwory	Number
dźwignięte	dźwignięty	Gender
legiony	legionie	Number
przystanek	przystanki	Number
rzeżączką	rzeżączkę	Case
cichszego	nepalskiego	lemma
specjalny	specjalne	Gender
dożyła	rzygała	lemma
brodatej	naturalnej	lemma
torbaczami	torbaczem	Number
ambasado	ambasadzie	Case
fura	fury	Number
wykrzyknika	wykrzykników	Number
gluony	gluonami	Case
myłoby	zabiłoby	lemma
srałeś	srał	Person
nadzorowani	unicestwieni	lemma
butikach	butiku	Number
moczowe	moczowym	Case
miłej	ostatecznej	lemma
znaczenie	znaczenia	Number
językoznawcy	językoznawcą	Case
napowietrzyłybyście	pożyczyłybyście	lemma
zwrotnicy	zwrotnicach	Number
smoczej	smoczym	Gender
łyżwach	łyżwy	Case
przyjemnego	przyjemnej	Gender
odbiorniku	odbiornikach	Number
krymskiemu	krymskiej	Gender
dłuższego	dłuższej	Gender
zgrzebło	zgrzebła	Number
wysyłałybyśmy	wysyłajmy	Mood
procami	procą	Number
boje	bój	Number
łódzkie	łódzki	Gender
łosiowi	łosiom	Number
dramatyczne	dramatyczna	Gender
trwalszych	trwalsze	Case
młodym	młodych	Number
szalałbym	szalałabym	Gender
macedońskimi	wrogimi	lemma
dębie	dąb	Case
diecezję	diecezje	Number
soczewki	soczewka	Number
macewy	powroty	lemma
bajki	bajko	Number
monoteistyczne	pełniejsze	lemma
skąpca	skąpiec	Case
śpiewamy	śpiewa	Person
komentowane	przypomniane	lemma
sokowirówce	sokowirówkach	Number
rozmyślałybyście	rozmyślajcie	Mood
kochaj	kochajcie	Person
apoteozy	apoteozę	Number
ewentualne	sefardyjskie	lemma
lampo	lampy	Number
ciekawszą	ciekawszym	Gender
gorsza	gorszy	Gender
liczbę	naród	lemma
stycznia	styczeń	Case
lęków	lękom	Case
analogowe	analogową	Gender
opróżniliście	szukaliście	lemma
szczytom	szczytowi	Number
liceami	liceum	Number
braterską	braterskim	Gender
drażniły	drażnią	Tense
poprzedniego	poprzednim	Case
kołu	kołom	Number
gębo	gęby	Number
trawniku	trawnikach	Number
napady	napad	Number
logicznych	namibijskich	lemma
graniczne	wtórne	lemma
przędziwo	przędziwa	Number
mieszamy	stajemy	lemma
transformatorami	transformatorach	Case
lubego	lubej	Gender
któremukolwiek	którymkolwiek	Case
blokadę	blokadzie	Case
zeszytach	zeszycie	Number
pożaru	pożarów	Number
kolcach	kolcami	Case
niemetalom	niemetalami	Case
termodynamicznym	termodynamiczną	Gender
neutralnemu	neutralnej	Gender
samolotem	samolotami	Number
inteligentnym	najsilniejszym	lemma
obalane	stawiane	lemma
podpierdoliła	skłamała	lemma
kolejarza	kolejarzu	Case
flecie	flety	Number
uzasadnienie	uzasadnienia	Number
osiowe	osiowa	Gender
naprawiałeś	naprawiał	Person
artystów	artyści	Case
gołej	gołym	Gender
igieł	igłami	Case
świątyniom	świątyniach	Case
lingwiści	statuy	lemma
finalista	świeca	lemma
spaniem	spanie	Case
meksykańskiej	zwięzłej	lemma
strzałom	strzałach	Case
barwnych	barwnego	Number
szczepienie	szczepieniem	Case
programiście	programistom	Number
zapalenie	zapalenia	Number
bud	budach	Case
najdoskonalszy	północny	lemma
arkadzie	arkady	Case
pępowiną	pępowiny	Case
działaczkach	działaczki	Case
najciekawszego	najciekawszej	Gender
awarie	awarię	Number
łaknący	umawiający	lemma
nadziei	nadziejom	Number
karach	karom	Case
odradzałeś	odradzał	Person
temperówko	temperówce	Case
uważała	uważałam	Person
jamajskim	wielkim	lemma
pobierzemy	zarżniemy	lemma
przyrodniczemu	przyrodniczej	Gender
szacunkiem	szacunkami	Number
sił	siłami	Case
suko	suki	Number
liściowy	liściowe	Gender
rycerz	rycerze	Number
dobry	dobra	Gender
ludziach	człowieku	Number
portugalskie	portugalska	Gender
opactwem	opactwu	Case
goląca	żartująca	lemma
tradycyjnego	tradycyjnej	Gender
batyskafy	batyskafie	Number
burząca	pozostająca	lemma
cukiernika	wombata	lemma
wrześni	września	Number
grzebień	grzebienie	Number
zuchwalstwo	zuchwalstwa	Number
amnezji	szczepionce	lemma
narkotycznej	narkotycznego	Gender
prawicę	prawicy	Case
ryjówki	ryjówka	Number
sur	sury	Number
pejoratywnych	pejoratywne	Case
kastracie	kastraci	Number
obszerniejszym	obszerniejszą	Gender
dementowałybyśmy	zbierałybyśmy	lemma
łomie	łomy	Number
puszyste	puszystą	Gender
wór	wory	Number
aktorami	aktorzy	Case
nazwie	nazwy	Case
procent	procentem	Case
przypuszczałby	przypuszczałoby	Gender
pedrylów	pedryle	Case
krwawnika	krwawników	Number
mistrzach	mistrzami	Case
niedostępna	niedostępne	Gender
zamówienia	zamówienie	Number
policjanta	policjantem	Case
gromadzony	rozproszony	lemma
odcinki	odcinek	Number
okrucieństwami	okrucieństw	Case
emirat	emiraty	Number
paniach	pań	Case
maltańskim	nieuważnym	lemma
nietypowych	nietypowego	Number
kielich	kielichy	Number
marychą	marycha	Case
erratę	erraty	Number
budzić	wygarnąć	lemma
ujemne	ujemną	Gender
umierasz	umieramy	Person
gospodarki	gospodarek	Number
podpasko	podpasce	Case
założyciele	założycielu	Number
czekający	ostrzegający	lemma
socjalista	socjaliście	Case
lwie	lwim	Case
rakotwórcza	rakotwórcze	Gender
kwestionujący	przypominający	lemma
żarty	żarcie	Number
metropolicie	wózkowi	lemma
beatyfikacje	beatyfikacjom	Case
ciężarach	ciężarze	Number
przeprowadzkę	przeprowadzki	Number
dreszczu	dreszczy	Number
pumeksach	pumeksie	Number
darmowej	pierworodnej	lemma
wirusów	wirusa	Number
czeremchy	czeremchę	Number
eksklaw	eksklawy	Number
zbirami	zbiry	Case
iglasty	iglasta	Gender
cieplejszych	przestronnych	lemma
adiutanta	urlopu	lemma
dżunglę	dżungle	Number
mieszały	przeżyły	lemma
marcowe	marcowy	Gender
atomowej	atomowym	Gender
rylce	rylec	Number
wązki	wązka	Gender
glacjalną	glacjalnym	Gender
bulwkach	bulwce	Number
aktywniejszym	praworęcznym	lemma
lnianego	lnianej	Gender
karambolu	poprawiania	lemma
diamentowego	szafirowego	lemma
jonosferze	jonosfery	Case
eksperymentalnemu	eksperymentalnej	Gender
kult	kultem	Case
tlenowej	tlenowemu	Gender
epilogu	studniówki	lemma
materiale	materiały	Number
aresztu	aresztem	Case
kowali	kowala	Number
cofany	wygrany	lemma
kuroniówkach	kuroniówek	Case
gajach	gaju	Number
ciekliście	ciekli	Person
flocie	flotach	Number
ciemnoczerwoną	pośrednią	lemma
fety	fet	Number
niewidomej	niewidomych	Number
kombajny	kombajnie	Number
przekroje	przekroju	Number
czarowników	czarownika	Number
wyrokami	wyroków	Case
osią	osi	Case
klimacie	klimatach	Number
średnicą	średnicy	Case
montażu	montaż	Case
czarodziei	czarodzieja	Number
dziękują	dziękuje	Number
zblazowanych	zblazowanym	Case
kółkiem	kółko	Case
najpoważniejszej	najpoważniejszym	Gender
dzwonem	dzwonie	Case
kołpak	kołpakiem	Case
ezoterycznym	podejrzanym	lemma
numerują	numeruję	Person
liściaste	liściasta	Gender
adrenalinami	adrenalin	Case
zachowała	zachowało	Gender
botanicznego	zastrzeżonego	lemma
nalewałabym	nalewałbym	Gender
mucha	musze	Case
decyzja	decyzje	Number
osi	osiom	Number
proste	prostym	Case
sufitami	sufitem	Number
autobiografią	autobiografii	Case
rozwiązań	rozwiązaniach	Case
korkociągi	korkociąg	Number
bawić	zimować	lemma
bakach	baku	Number
akapitach	akapity	Case
dyskusji	dyskusjo	Case
kartkówką	kartkówkami	Number
marach	marze	Number
Południowoafrykańczykiem	Południowoafrykańczykami	Number
łowcom	łowców	Case
rzemieślnicy	rzemieślnik	Number
otaczałeś	siadałeś	lemma
szybowcami	szybowcem	Number
interpunkcyjnej	interpunkcyjnemu	Gender
lipowym	zabawnym	lemma
prostokąt	prostokąta	Case
niebiańską	niebiańskiej	Case
sąsiedztwem	sąsiedztwu	Case
bandytów	bandytom	Case
informacji	informacjom	Number
gaśnicy	gaśnicą	Case
bajce	bajką	Case
zoologicznej	zoologicznego	Gender
gaśnica	gaśnice	Number
żwirach	żwirze	Number
nietypowej	nietypowego	Gender
greckie	podłe	lemma
burzono	stracono	lemma
strój	stroje	Number
krwistego	krwistych	Number
komentowalibyśmy	zaiwanilibyśmy	lemma
krucjaty	zawody	lemma
dostępne	dostępna	Gender
psychosomatycznym	psychosomatycznej	Gender
arktycznymi	arktycznym	Case
ignorujący	rażący	lemma
wierzchem	wierzchu	Case
parasola	parasol	Case
częstszym	różnowartościowym	lemma
fotografach	fotografowie	Case
żółtawym	żółtawą	Gender
kierujemy	tłumaczymy	lemma
niszcząca	niszczący	Gender
hydrauliczne	nostalgiczne	lemma
leczący	uważający	lemma
głównej	głównym	Gender
godnej	puszystej	lemma
drobiazgowej	drobiazgowym	Gender
trygonometrycznej	trygonometrycznego	Gender
abchaskim	spożywczym	lemma
porozmawiawszy	złamawszy	lemma
anielska	najwdzięczniejsza	lemma
liniowa	liniowe	Gender
estońskie	estońską	Gender
basiorami	pumeksami	lemma
obrzędzie	obrzędach	Number
ciemnego	ciemnej	Gender
pragnieniem	pragnienie	Case
azerbejdżańskiego	azerbejdżańskim	Case
niemowlęta	niemowlę	Number
stałej	stałym	Number
dokładniejszą	zrozumiałą	lemma
kierowcami	kierowcą	Number
uważnym	uważną	Gender
niebezpiecznym	niebezpieczną	Gender
drzemała	zapierdalała	lemma
grudniowa	grudniowy	Gender
żydówkę	żydówką	Case
zamknięta	zamknięte	Gender
karaluch	karaluchy	Number
rozważyłybyśmy	rozważyłyby	Person
skróty	skrót	Number
nagłe	nagły	Gender
dedykowali	przelecieli	lemma
wiktorię	wiktorie	Number
makaków	zniszczeń	lemma
tensory	tensorów	Case
otwór	otwory	Number
ciepłą	parzystą	lemma
ignorowała	ignorował	Gender
konformizmem	konformizmu	Case
najbystrzejsza	najbystrzejsze	Gender
łaknąłbyś	wylogowałbyś	lemma
ekosystem	ekosystemie	Case
gekona	gekonów	Number
nowoczesnym	nowoczesnej	Gender
bułgarskiego	zabawnego	lemma
fenickim	fenicką	Gender
aglomeracji	aglomeracjach	Case
drżenie	wygranie	lemma
twarde	twardy	Gender
czajki	czajko	Case
zajętej	zajętemu	Gender
lwim	lwią	Gender
anachroniczna	anachroniczny	Gender
lataj	uznawaj	lemma
prawa	prawą	Case
pieniądzowi	pieniądzom	Number
modemy	modemach	Case
bażanty	bażancie	Number
tony	tona	Case
halibuty	halibucie	Number
wilkołakami	wilkołakiem	Number
rdzeni	rdzenie	Case
lekarze	lekarzach	Case
chłodniejsze	chłodniejszą	Gender
wstęgami	wstęgi	Case
wojskem	wojskami	Number
wskazałybyście	wskażcie	Mood
analfabeta	analfabeci	Number
dziewice	dziewica	Number
aspekty	aspektom	Case
foremne	strome	lemma
przygotowanych	przygotowane	Case
pralinach	pralinom	Case
okropną	okropnym	Gender
maciejki	maciejko	Number
otaczałby	śniadałby	lemma
oszukaj	przygotuj	lemma
ukryłem	ukrył	Person
miedzianych	obfitych	lemma
asyryjskiej	asyryjską	Case
siewnikowi	siewnikom	Number
równoległą	równoległym	Gender
wiecznej	wiecznego	Gender
demonstrantem	demonstrancie	Case
halerze	szarości	lemma
prawnikiem	prawnikowi	Case
przyrodniczej	przyrodniczym	Gender
bazylice	bazyliką	Case
dręczony	składany	lemma
rozróżnią	wymogą	lemma
alpejskim	alpejską	Gender
najświętszy	najświętsza	Gender
chorągwią	wdzięcznością	lemma
przyjaciółki	przyjaciółkę	Number
ćwierćnuty	ćwierćnucie	Case
krzyżem	krzyżami	Number
nadzorca	nadzorcy	Case
zantagonizowała	zantagonizowało	Gender
prawosławnej	prawosławnemu	Gender
napiszą	trącą	lemma
podpisze	uratuje	lemma
miła	tchórzliwa	lemma
koczowniczy	koczownicza	Gender
migdałowca	migdałowców	Number
wieloznacznej	wieloznacznym	Gender
czynniku	czynnika	Case
korzystnym	niepozornym	lemma
ciche	podczerwone	lemma
związków	związku	Number
słonecznym	słoneczną	Gender
bezlitosną	bezlitosne	Gender
częstszym	częstszą	Gender
luźnym	luźne	Case
ekstremalnych	sporych	lemma
jednorazową	jednorazowe	Gender
krasnalach	krasnale	Case
enklawom	enklawie	Number
katedry	władze	lemma
torpedę	torpedzie	Case
ocalili	zastanawiali	lemma
dysydentem	dysydenta	Case
ciemne	zręczne	lemma
kalif	kalifowie	Number
odrzuciłyśmy	odrzucimy	Tense
gęsi	gęś	Case
okresowego	okresowej	Gender
światła	światło	Number
eksperyment	eksperymentowi	Case
schowała	schowałaś	Person
lubią	suszą	lemma
poliglotę	poliglotów	Number
rady	radę	Number
poprawiało	przypuszczało	lemma
enklawom	enklawami	Case
pamiętnik	pamiętnikiem	Case
baśniami	baśnią	Number
togi	toga	Case
eutanazjach	eutanazji	Number
dzików	dzika	Number
wielkopolskim	wielkopolską	Gender
bytowymi	stromymi	lemma
gaworzyłby	gaworzyłbym	Person
równaniu	równaniom	Number
klątwie	klątwą	Case
bawełniane	bawełniana	Gender
czeluści	pszczoło	lemma
radiologu	radiologiem	Case
śniegiem	śniegami	Number
skrzyń	skrzyniami	Case
podkreślamy	podkreślam	Number
knocie	knotach	Number
fosie	rejestrze	lemma
zboża	zboże	Number
przeżyłem	przeżył	Person
puszki	puszkę	Number
jeremiad	jeremiadom	Case
pożarty	szanowany	lemma
odpływ	odpływie	Case
aktywista	aktywiści	Number
radiowym	radiową	Gender
wyhaftowana	wyhaftowane	Gender
prywaciarzami	prywaciarzem	Number
czulszy	czulsze	Gender
listwami	listwą	Number
powojennej	powojennym	Gender
lansując	zastanawiając	lemma
dawniejszym	dawniejszej	Gender
ściągach	ściądze	Number
denerwowałbyś	wydostawałbyś	lemma
powstanie	powstania	Number
kaligraficzną	najstarszą	lemma
międzynarodowa	tajniejsza	lemma
obserwatorzy	obserwator	Number
osiach	osie	Case
cierpliwego	przedmiesiączkowego	lemma
dosłownej	tymczasowej	lemma
jog	jogi	Case
muchomora	muchomory	Number
akuszerek	akuszerkach	Case
poniemieckiego	poniemieckim	Case
telefonicznej	telefonicznym	Gender
arsenianom	arseniany	Case
podkreślam	podkreślają	Person
opisywał	tłumaczył	lemma
żyroskopami	żyroskopem	Number
muzułmanów	muzułmanina	Number
modrzew	półksiężyc	lemma
proszek	proszku	Case
publicznego	publicznej	Gender
absorbowana	rozbita	lemma
rękaw	rękawa	Case
korporacje	korporacjom	Case
kucałybyście	kucajcie	Mood
mrówkojada	mrówkojady	Number
śpieszyliście	śpieszyliśmy	Person
botaniczną	botaniczne	Gender
promieniem	promieniu	Case
frezarek	frezarki	Number
maszyna	maszyny	Number
zagrożeniu	zagrożeniem	Case
wdową	wdowie	Case
maści	przemówienia	lemma
wrażeniami	wrażeniem	Number
indoeuropejskiej	ubogiej	lemma
najdroższe	trwałe	lemma
rodzajowi	rodzajem	Case
ołtarzowi	ołtarzu	Case
błonie	błony	Case
śmieciarka	śmieciarki	Number
olejmy	olałybyśmy	Mood
maskonury	maskonur	Number
najnowszej	najtragiczniejszej	lemma
górnołużyckiego	górnołużyckiej	Gender
kryptografię	kryptografii	Case
hamował	spieszył	lemma
kajali	kajaliśmy	Person
tygrysów	tygrysy	Case
ciastko	ciastka	Number
melin	meliny	Number
litr	litry	Number
zadalibyście	zadaliby	Person
sprawiasz	sprawia	Person
zapamiętałaby	zapamiętałabyś	Person
graniczna	graniczne	Gender
saskiego	saskich	Number
odpowiadające	odpowiadająca	Gender
lapońskim	lapońskiej	Gender
cerkiewnosłowiańskie	ukochane	lemma
celnikami	celników	Case
wspominałam	wspominała	Person
szpilki	szpilek	Number
korytarz	korytarzem	Case
cyrkowego	przydatnego	lemma
gęsty	gęsta	Gender
kanonierki	kanonierkę	Number
naczynia	naczynie	Number
najczerwieńszą	śnieżnobiałą	lemma
delikatniejszą	delikatniejszym	Gender
pocisku	pociski	Number
gadem	tablicą	lemma
kibic	odlot	lemma
asteroidy	asteroida	Case
gwarancję	gwarancje	Number
potwierdzałabyś	potwierdzałaby	Person
przemyt	przemytu	Case
edytowałyśmy	robiłyśmy	lemma
obłędy	obłęd	Number
mocnym	mocnej	Gender
jadalnym	szczegółowym	lemma
jądrowym	jądrowej	Gender
miętowym	niedźwiedzim	lemma
koperty	kopercie	Case
żyły	żyłę	Number
nagą	nagim	Gender
urugwajskiemu	urugwajskiej	Gender
dekret	dekrety	Number
obiektami	obiekty	Case
tlenkiem	tlenkami	Number
doli	dolach	Number
proroka	prorokiem	Case
opuszczające	opuszczający	Gender
śniadałabym	śniadałbym	Gender
plotką	plotkami	Number
końska	końskie	Gender
cudzej	cudzego	Gender
rombościanom	rombościanami	Case
kici	kiciu	Case
przemysłowa	przemysłowy	Gender
dąb	dębem	Case
wyświetlacie	wyświetlam	Person
rozczarowania	rozczarowaniach	Case
wydziały	wydziałami	Case
dąb	wieko	lemma
aktualna	aktualny	Gender
stadionu	stadionów	Number
wezyra	wezyrów	Number
narodowościami	narodowości	Case
cesarze	cesarz	Number
katedrach	katedrom	Case
rozważyłybyśmy	rozważmy	Mood
niezrozumiałego	niezrozumiałej	Gender
radiologami	radiologach	Case
dewoci	tęczówki	lemma
najdalszą	własną	lemma
czasówce	czasówkach	Number
morderstw	mów	lemma
księżycowe	niejawne	lemma
dzwony	dzwonie	Number
cokół	cokoły	Number
skakanki	skakanka	Number
tłumaczyłeś	tłumaczył	Person
zweryfikowany	zweryfikowane	Gender
parafianina	parafian	Number
potomka	potomków	Number
sąsiadowi	sąsiadem	Case
diecezjalną	diecezjalnym	Gender
najkruchszą	najkruchszym	Gender
bytowego	pięknego	lemma
najwyraźniejsza	najwyraźniejsze	Gender
metom	met	Case
pustyniom	pustyń	Case
wichurach	wichur	Case
lewy	lewę	Number
najbladszym	najwęższym	lemma
pozory	pozór	Number
humorystycznego	najświętszego	lemma
wezmą	weźmiecie	Person
milczał	włączał	lemma
różniczkowania	różniczkowanie	Number
technologicznej	technologiczną	Case
kierowalibyście	ratowalibyście	lemma
graczom	graczowi	Number
puściłyśmy	puścimy	Tense
aberracje	aberracji	Case
czają	parskają	lemma
pamiątka	pamiątką	Case
rejestracje	rejestrację	Number
Hiszpanie	Hiszpan	Case
sypał	sypałeś	Person
sromie	sromu	Case
burnusach	burnusie	Number
lutem	lutu	Case
kogut	koguty	Number
ilości	ilościach	Number
gołąbku	gołąbkowi	Case
but	buty	Number
modłach	sosach	lemma
szczułybyście	szczułybyśmy	Person
optyków	optyka	Number
myśliwi	myśliwych	Case
pantografy	pantografom	Case
gumowej	gumowym	Gender
ostrze	ostrzu	Case
sromem	sromami	Number
pękli	zaprowadzili	lemma
chmurze	chmurach	Number
czerwień	czerwienie	Number
licem	licu	Case
żydach	żydom	Case
randce	randkach	Number
łóżka	nornice	lemma
jeździł	znosił	lemma
cesarzowych	cesarzowej	Number
dowodząc	rozmawiając	lemma
dynamit	wodze	lemma
linieją	podróżują	lemma
podtytuł	podtytuły	Number
autochtonicznym	autochtoniczną	Gender
osądów	osądach	Case
teraźniejszej	teraźniejszego	Gender
ideolog	ideolodzy	Number
przypuściłeś	przypuścił	Person
martwej	martwym	Gender
wiatrem	wiatrami	Number
kopalnia	kopalnie	Number
ziębę	zięby	Number
towarem	towaru	Case
grzecznym	numerycznym	lemma
lalkach	lalce	Number
powtórzy	zwymyśla	lemma
porozmawiacie	porozmawiałyście	Tense
świetlówek	świetlówkach	Case
jama	jamy	Number
profesjach	profesjami	Case
dwórki	dwórka	Number
łyżkami	łyżką	Number
samarytańską	samarytańskim	Gender
krzewem	krzewie	Case
pomysłowa	pomysłowe	Gender
trwałemu	trwałej	Gender
ustawie	ustawą	Case
dziewek	dziewki	Number
jasnożółtym	zakochanym	lemma
biblijnego	narciarskiego	lemma
ceni	pali	lemma
mięśnie	mięśniu	Number
pokazów	pokazy	Case
swobodnej	swobodnemu	Gender
garby	garbów	Case
bankowi	bankom	Number
pasaty	pasatów	Case
prawdopodobną	prawdopodobnym	Gender
wschodziłabym	wschodziłbym	Gender
wspólną	wspólnym	Gender
piaście	piastom	Number
bezpłatną	bezpłatnym	Gender
wizerunkom	wizerunkowi	Number
lewym	nieuczciwym	lemma
wiśniową	wiśniowym	Gender
kroi	kroję	Person
żałosne	żałosny	Gender
niedźwiedziu	niedźwiedziach	Number
ginekologicznej	ginekologicznego	Gender
chrystadelfianinie	chrystadelfianinem	Case
odkrywając	wybierając	lemma
sierpniowe	sierpniowa	Gender
daszek	daszkiem	Case
foremnego	optycznego	lemma
opisywała	straciła	lemma
symulacja	symulacje	Number
dziennego	romantycznego	lemma
lżejszym	ochronnym	lemma
ocenialiśmy	upuściliśmy	lemma
szklarnie	szklarnię	Number
wędrownym	wędrownymi	Case
przesłuchaniom	przesłuchaniach	Case
pokonajcie	pokonałybyście	Mood
toalet	toaletach	Case
karane	zniszczone	lemma
szablą	szablami	Number
turystyka	turystyko	Case
udek	udka	Number
diagnozowany	diagnozowana	Gender
objętościach	objętości	Number
zegarkami	zegarki	Case
law	lawy	Number
zakładał	zakładałem	Person
wycieczki	wycieczką	Case
węglan	węglany	Number
trzykrotka	trzykrotki	Number
zatoki	zatokami	Case
oręże	oręż	Number
akosmizmem	akosmizmu	Case
domami	domom	Case
dodawaniu	dodawanie	Case
prasie	prasa	Case
najmniejszą	najmniejszej	Case
ryki	ryku	Number
kupisz	zalogujesz	lemma
sąsiadom	sąsiadowi	Number
aktualnych	zimnych	lemma
cudowne	cudowną	Gender
siusiakiem	siusiak	Case
odpowiadające	składające	lemma
kominiarki	kominiarkach	Case
znajdowały	znajdują	Tense
weekendowej	weekendowym	Gender
filmowanie	filmowaniu	Case
gapmy	zrabujmy	lemma
piżamach	piżamie	Number
grafitowym	grafitowy	Case
żydowskiej	żydowskiego	Gender
kwint	kwinty	Number
przypowieści	przypowieściach	Number
leziecie	pożyczacie	lemma
leszcze	leszcza	Number
fula	fuli	Number
organizacjami	organizacjom	Case
kruszcach	kruszce	Case
odwrotności	odwrotnościom	Number
najśliczniejszy	najśliczniejsza	Gender
dokonywało	ratowało	lemma
sety	set	Number
szczerą	szczerym	Gender
gruszyczki	gruszyczkach	Case
skały	skała	Number
argentyńska	argentyńskie	Gender
lądowanie	lądowania	Number
człowieczeństwa	człowieczeństwo	Number
bochna	bochnie	Case
ustępstwo	ustępstwa	Number
odpowiednim	odpowiednią	Gender
denerwowaliby	zaprowadziliby	lemma
tłumaczę	tłumaczą	Person
słabą	słabym	Gender
ostrej	ostremu	Gender
piszczeć	zbyć	lemma
skokom	skokowi	Number
huty	hut	Number
smyka	smyków	Number
zakończeń	zakończenia	Number
aluminiowe	aluminiowy	Gender
sąsiednie	sąsiedni	Gender
łagodnej	ontologicznej	lemma
zwyczajnym	zwyczajnej	Gender
bankrutowałaś	bankrutowała	Person
szmaragdów	szmaragdach	Case
przewagi	przewadze	Case
dumam	pierdzę	lemma
zmęczonym	zmęczoną	Gender
domach	domu	Number
prostopadłościanu	prostopadłościanów	Number
nieparzystą	nieparzystym	Gender
listopady	listopadom	Case
dachowej	prawosławnej	lemma
zimujący	zimująca	Gender
żurze	żurowi	Case
wystarczającą	wystarczającej	Case
łamał	ufał	lemma
moczę	wybucham	lemma
kwarków	kwarki	Case
liszaja	standardu	lemma
dermatologicznej	dermatologicznego	Gender
irlandzki	irlandzka	Gender
suszarki	suszarek	Number
transkrypcyjnego	transkrypcyjnej	Gender
stworami	stworach	Case
doktorach	doktorze	Number
niewystarczającym	niewystarczającą	Gender
dwujęzycznego	wspólnego	lemma
gęgajcie	gęgałybyście	Mood
żołnierskiego	żołnierskim	Case
cep	cepy	Number
węże	wąż	Number
przyczynom	przyczynie	Number
biodrem	biodrze	Case
stany	stanie	Number
zabijesz	zabijemy	Person
kamerzystą	kamerzystami	Number
puszek	puszki	Number
noszono	rzucono	lemma
dziecinnych	okropniejszych	lemma
minimalistycznych	wargowych	lemma
baki	bakom	Case
bazarach	bazary	Case
maszyn	maszyny	Number
dodzwonić	rozróżniać	lemma
płomień	płomienie	Number
budami	budą	Number
mieszkalibyśmy	przepilibyśmy	lemma
pyt	pytom	Case
flecistę	flecistów	Number
gęstszą	gęstsze	Gender
forinty	wyznania	lemma
wulkaniczna	wulkaniczne	Gender
pośmiertna	pośmiertny	Gender
parowałeś	składałeś	lemma
stożki	stożku	Number
nurkujący	wyjaśniający	lemma
milicjant	milicjanta	Case
krasnym	tajnym	lemma
deski	deskę	Number
śledziowa	śledziową	Case
przyjęłybyśmy	przyjmijmy	Mood
nieczytelne	nieczytelną	Gender
borowemu	nienaturalnemu	lemma
elektrolicie	elektrolitach	Number
majonezy	majonezach	Case
otrzymają	zerżną	lemma
gałązkami	gałązką	Number
nukleonów	nukleony	Case
mięczaka	mięczaków	Number
ikebany	ikebanie	Case
francuskie	francuska	Gender
analizowane	smażone	lemma
przewodzie	przewody	Number
eksperymentów	eksperymentach	Case
pazurach	pazurami	Case
pojedynkowi	pojedynkom	Number
cieplejszej	zagranicznej	lemma
podrywałbym	tlałbym	lemma
gasiło	wywoływało	lemma
jonizowałabym	przeżułabym	lemma
innowacji	innowacjami	Case
chacie	prześcieradle	lemma
baryłka	baryłki	Number
bezpiecznika	bezpieczników	Number
pachnącego	pachnącej	Gender
gołębiętom	gołębięta	Case
destylacja	destylacji	Case
przyczynami	przyczyny	Case
ciasnej	ciasnego	Gender
poronieniem	poronieniami	Number
gazetę	gazeta	Case
praktykach	praktyce	Number
lekka	lekki	Gender
wierzb	wierzby	Number
ocalcie	ocaliłybyście	Mood
basiory	basior	Number
plemionami	plemieniem	Number
szalonego	szalonych	Number
najemnicy	najemników	Case
parzydełkach	parzydełkami	Case
mądrymi	towarzyskimi	lemma
czerpałyście	czerpały	Person
języczku	języczki	Number
amfiteatrach	amfiteatrze	Number
cierpliwy	rakotwórczy	lemma
wysokimi	wysokie	Case
szantażem	szantaż	Case
szklarnia	szklarnie	Number
żabę	żabą	Case
pułkami	pułków	Case
cząsteczki	cząsteczkę	Number
racjonalizm	racjonalizmu	Case
autorze	autorzy	Number
bledszy	bledsze	Gender
abstynentom	abstynenci	Case
aorty	aort	Number
przekomarzał	przekomarzało	Gender
garażami	garażem	Number
książkę	książki	Number
pokazywało	pokazywała	Gender
robiłeś	robiłem	Person
komentują	psują	lemma
wiza	wizy	Case
złodziejowi	złodziejom	Number
jog	jogi	Number
germański	siarkowy	lemma
paszkocie	paszkotach	Number
tundrom	tundrze	Number
karykaturze	karykaturach	Number
kremowi	kremom	Number
chudym	chudą	Gender
lucern	lucerny	Number
masaże	masaż	Number
złożeń	złożenia	Number
nijakie	nijaki	Gender
pręta	prętów	Number
kieliszki	kieliszek	Number
donicy	donicach	Number
starców	starcy	Case
kolumbariach	kolumbariami	Case
lazłyby	zniszczyłyby	lemma
depresje	najemnicy	lemma
frezerami	frezerów	Case
batonu	batonów	Number
łyżew	łyżwy	Number
kartezjańskiej	kartezjańskiego	Gender
uczony	uczone	Gender
skarbnicy	skarbnicę	Case
Czechowi	topnikowi	lemma
gajowego	gajowym	Case
zwrotkami	zwrotek	Case
biedroneczce	biedroneczkom	Number
kacapy	kacapie	Number
grypę	grypy	Number
łamiące	łamiąca	Gender
nękasz	pamiętasz	lemma
epizody	epizod	Number
oglądalibyśmy	ruchalibyśmy	lemma
grań	superkomputer	lemma
tratwę	tratwy	Case
ptakiem	ptaku	Case
trędowaci	trędowaty	Number
córeczki	córeczka	Number
broniona	zabrana	lemma
podpisałem	zaprowadziłem	lemma
infiksem	infiksami	Number
gamoniach	gamoniami	Case
uczyłam	uczyłaś	Person
stali	stalą	Case
grzędy	grzędę	Number
pątnicy	pątniku	Number
oszczędnego	oszczędnej	Gender
masce	maskach	Number
azerskich	obłąkanych	lemma
siusiakom	siusiaki	Case
nieobecnego	nieobecnej	Gender
kurtko	kurtką	Case
urlopu	urlopów	Number
jadano	przestrzegano	lemma
dźwigajcie	dźwigałybyście	Mood
matura	matury	Number
morświn	morświny	Number
notatko	notatki	Number
płyń	wyznacz	lemma
jadowitej	wiśniowej	lemma
dachu	dachy	Number
biegając	twierdząc	lemma
cięższego	wstawionego	lemma
ważnej	ważnemu	Gender
immunitetów	immunitety	Case
krajana	krajanów	Number
krakowskiego	sudeckiego	lemma
kołysce	kołysko	Case
księgową	księgowo	Case
mostkiem	mostkami	Number
hojny	hojna	Gender
sceptyka	sceptyk	Case
hodowcy	hodowcom	Number
ziela	ziół	Number
wymówki	wymówka	Number
najkoszmarniejszą	najkoszmarniejsze	Gender
konferencjach	konferencjom	Case
kwietniowe	kwietniowym	Case
ekstrakt	ekstrakty	Number
przedostatniego	przedostatniej	Gender
żyrandole	żyrandoli	Case
genie	geny	Number
arki	arkach	Case
podpiszmy	podpisałybyśmy	Mood
karcianej	wilczej	lemma
dzienników	dzienniki	Case
octanach	octany	Case
myśliwca	myśliwców	Number
najdawniejszej	ochronnej	lemma
rabarbarem	rabarbar	Case
dwuwymiarowe	przyjemniejsze	lemma
libację	libacjo	Case
agrafkę	agrafko	Case
Niemki	Niemka	Number
spróbowany	spróbowane	Gender
dyktaturę	dyktaturą	Case
ratuszem	ratuszami	Number
możliwościom	możliwości	Case
spółgłoskach	spółgłoski	Case
mieszkano	rąbano	lemma
cyrkiel	suknię	lemma
paradoksowi	paradoksu	Case
mercedesy	mercedesa	Number
czytała	czytało	Gender
karygodnych	najświetniejszych	lemma
roślinożerców	roślinożercy	Case
ludom	ludowi	Number
dźwięczna	piękniejsza	lemma
psychologiczną	psychologicznym	Gender
zebrała	zebrałam	Person
wieka	wieko	Number
poprawia	poprawiam	Person
cieką	przestrzegają	lemma
lizaki	lizak	Number
czytające	czytająca	Gender
symulacji	symulacjach	Number
gruszko	gruszka	Case
promu	promie	Case
logopedyczna	wiekuista	lemma
utworze	utwór	Case
seniorze	seniora	Case
metą	metę	Case
dotknięcie	przesadzanie	lemma
luźniejszą	luźniejsze	Gender
opata	opatów	Number
uboższe	uboższa	Gender
szpaków	szpaka	Number
ślub	śluby	Number
notariuszowi	notariuszem	Case
przeszkodą	przeszkodami	Number
paronimów	paronimy	Case
przeciwciała	przeciwciało	Number
podniesiona	podniesione	Gender
milimetrach	milimetry	Case
paszą	paszy	Case
podpalenia	podpalenie	Number
podziwiał	zostawił	lemma
relikwiarzach	relikwiarzu	Number
sprzęgłami	sprzęgłem	Number
ortograficznym	ortograficzną	Gender
robaku	robakach	Number
bateriom	baterie	Case
chromosom	chromosomy	Number
tancerkami	tancerki	Case
fonony	fononie	Number
ładnym	najwcześniejszym	lemma
kaszlący	kaszlące	Gender
wdychajcie	wdychaj	Person
debatą	debatami	Number
publicznej	publicznego	Gender
płynom	płynowi	Number
pocztą	pocztę	Case
koję	składam	lemma
skrzydłach	skrzydłami	Case
bojałaby	bojałabyś	Person
namibijskim	namibijskiej	Gender
czytam	posiadam	lemma
furtkami	furtką	Number
mumia	mumie	Number
jasnozielonym	jasnozieloną	Gender
marmolada	marmoladą	Case
gładkim	żyznym	lemma
kobiet	kobiety	Number
składniki	składnikami	Case
zaskrońca	zaskrońce	Number
buchałabyś	ziałabyś	lemma
beko	bekę	Case
małych	prawnoautorskich	lemma
myliliby	rozmyślaliby	lemma
Austriaka	Austriaków	Number
parapety	parapecie	Number
dodawaniu	dodawaniem	Case
uderzany	uderzana	Gender
katarskiej	katarskiego	Gender
mokradła	mokradłami	Case
częstej	zeszłej	lemma
bohaterzy	bohaterze	Number
krajobrazem	krajobrazie	Case
krowy	roszady	lemma
olszą	olszami	Number
elementarne	serdeczne	lemma
odpoczęlibyście	spuszczalibyście	lemma
prezydentowi	prezydentom	Number
plastyczną	plastyczne	Gender
profesję	profesja	Case
autografów	autografu	Number
procentowi	procentom	Number
meble	mebel	Number
ojczyzny	ojczyznę	Number
rodowi	rodem	Case
pigułkę	pigułki	Number
majonezy	średnice	lemma
figura	figurę	Case
zmian	zmiany	Number
zniszczenia	zniszczenie	Number
mewy	mewę	Number
łyku	łykom	Number
labilne	znośne	lemma
pokazywane	wyjaśniane	lemma
ognisko	ognisku	Case
chwalona	znaleziona	lemma
wikipedystów	wikipedysty	Number
charaktery	połowy	lemma
nieprzewidywalną	nieprzewidywalne	Gender
atole	atolami	Case
granicznej	granicznym	Gender
malachicie	malachitem	Case
cechy	cech	Case
raf	rafom	Case
prezerwatywy	prezerwatyw	Case
samoukowi	samoukom	Number
widma	widmo	Number
rzeźbach	rzeźbie	Number
flecistów	flecisty	Number
waliny	walina	Number
rzeźbiarzom	rzeźbiarzami	Case
most	nawóz	lemma
chrzciły	ściągały	lemma
jogurty	jogurcie	Number
poczekalniami	poczekalnią	Number
etymologicznym	etymologicznej	Gender
szydła	szydło	Case
ograniczające	podchodzące	lemma
wstęgi	wstęga	Number
holenderski	holenderskim	Case
lokalach	lokale	Case
ziemniaku	ziemniaki	Number
abonowana	wdychana	lemma
groźnymi	szesnastobitowymi	lemma
licu	lico	Case
podnoszeni	skończeni	lemma
komora	komorze	Case
dodawane	znoszone	lemma
elektronu	elektronów	Number
cienie	cieniu	Number
kubańskim	kubańskiej	Gender
scen	sceny	Number
horoskopu	horoskop	Case
modlitwy	modlitwie	Case
anachroniczne	anachroniczny	Gender
apetycie	apetyty	Number
rubinową	rubinowe	Gender
wulkany	wulkan	Number
falanga	falangi	Number
przyjazna	przyjazną	Case
wybrany	wybrane	Gender
reputacji	reputacje	Case
urzędnikach	urzędnicy	Case
oglądajcie	oglądaj	Person
ód	odom	Case
górnicy	górniku	Number
ludowe	ludowa	Gender
bluszczu	bluszcz	Case
infekcjom	infekcji	Number
zawodowej	zawodowego	Gender
stratę	straty	Number
profil	profile	Number
szczelin	szczeliny	Number
bujniejszym	bujniejsze	Case
stropie	strop	Case
maczugami	maczugą	Number
butami	butach	Case
szewskiej	szewskiego	Gender
organizacjami	organizacją	Number
przyimkiem	przyimku	Case
łużyckiej	łużyckiego	Gender
normy	norm	Number
energie	energię	Number
cudniejszemu	słyszalnemu	lemma
ciekawych	ciekawym	Case
komitety	komitecie	Number
eksplozji	eksplozjom	Number
mierzony	skazany	lemma
zachodniej	zachodnim	Gender
złotówka	złotówki	Number
grafitowe	wcześniejsze	lemma
monsunach	zwach	lemma
sadźce	sadźcach	Case
bufonowi	bufonom	Number
otworzy	wydupczy	lemma
oddziałami	oddziałem	Number
elastycznemu	elastycznej	Gender
krótsze	krótsza	Gender
funkcjonariuszu	skarbie	lemma
arię	ario	Case
liniowej	prestiżowej	lemma
kosiło	rozmyśliło	lemma
astrofizykiem	astrofizyku	Case
herbaciarnia	herbaciarnię	Case
ośle	ośla	Gender
realistach	realiście	Number
wydaniach	wydaniu	Number
pluć	zmieniać	lemma
cewek	cewki	Case
hydrantu	hydrant	Case
archeologom	archeologowi	Number
gówniarzy	place	lemma
kufli	kufla	Number
odradzasz	płyniesz	lemma
oddałybyśmy	rządziłybyśmy	lemma
przeszkadzalibyśmy	przeszkadzaliby	Person
całowały	zalogowały	lemma
łotewskimi	łotewskim	Case
szachistach	szachiście	Number
chronologii	widoków	lemma
bezkształtną	bezkształtnej	Case
chlorany	chloranów	Case
mion	miony	Number
siatką	siatka	Case
misjonarzowi	misjonarzom	Number
książeczki	książeczce	Case
nosorożec	nosorożce	Number
depilatorowi	depilatorom	Number
jerzyki	rydle	lemma
długowłosym	przygotowanym	lemma
ósemkowe	ósemkowa	Gender
ostrogach	ostrodze	Number
wewnętrzne	wewnętrznego	Case
kuzynce	kuzynki	Case
wycieraczką	wycieraczkami	Number
pierwszej	pierwszym	Gender
smutne	smutnego	Case
elastycznego	najstarszego	lemma
kradną	wymiotują	lemma
dyszy	dyszą	Case
mezonów	mezonami	Case
piętro	piętrem	Case
dalszy	dalsze	Gender
policzkiem	policzkami	Number
krzepkiego	największego	lemma
odpoczynkowi	odpoczynkom	Number
baterie	pałki	lemma
musztardę	musztardy	Number
winorośl	winorośle	Number
instytuty	instytutom	Case
wiśni	wiśniom	Number
ile	iłach	Number
złupiona	złupiony	Gender
sportowcy	sportowiec	Number
miewał	przypuścił	lemma
przewodniczącymi	przewodniczącym	Number
krośnie	krosno	Case
budynkach	budynkom	Case
wrończyku	wrończykach	Number
szalonego	szalonej	Gender
eksportowane	złupione	lemma
komentowano	wyniesiono	lemma
ciemiernikiem	ciemiernikami	Number
wirusowych	wirusowe	Case
drogową	zmęczoną	lemma
parapety	parapetach	Case
komedie	komedio	Number
gminy	gmin	Number
arcybiskupie	okrucieństwo	lemma
blachach	blasze	Number
rylec	rylce	Number
koszulach	koszul	Case
dwuwymiarowym	dwuwymiarową	Gender
melinie	meliny	Case
kadłuba	kadłubów	Number
dalekim	daleką	Gender
telewizyjnemu	telewizyjnym	Case
najłatwiejszej	najłatwiejszego	Gender
torebką	torebkami	Number
lakoniczne	lakoniczną	Gender
kajaki	kajaku	Number
drożdżowej	nieśmiertelnej	lemma
kategorie	kategoriach	Case
ogarniam	ogarniają	Person
jebadło	jebadła	Number
spódnicach	spódnicami	Case
kierowałyście	sfałszowałyście	lemma
ludowym	ludowej	Gender
akuszerki	akuszerka	Number
tajską	tajskie	Gender
błotom	błotu	Number
temblak	temblaki	Number
siatki	siatko	Number
dojące	rozwijające	lemma
abonowałbym	wyłudzałbym	lemma
zamordowanie	zamordowaniu	Case
górniku	górnikowi	Case
płatnego	płatnej	Gender
hektarom	hektarami	Case
ziewałybyście	ziewajcie	Mood
magicznym	magicznej	Gender
szyszka	szyszką	Case
chlebom	uczennicom	lemma
dosłownym	narkotycznym	lemma
poróżnią	wyprasują	lemma
powtórzymy	zmienimy	lemma
kodeksy	siarczany	lemma
świstunów	świstuny	Case
pająk	pająki	Number
krzemowym	krzemowej	Gender
narzekać	wysyłać	lemma
wacho	wasze	Case
hipopotamy	wózki	lemma
samcu	samcem	Case
czekoladki	czekoladek	Number
móżdżkiem	móżdżkami	Number
eposu	schizofrenii	lemma
sterczymy	sterczyłyśmy	Tense
azerbejdżańskie	tłuste	lemma
liściowym	sejsmicznym	lemma
zaśmieconych	zaśmieceni	Case
dotknięte	zakładane	lemma
porcelaną	porcelana	Case
afiks	uczeń	lemma
pszczółki	pszczółka	Number
dziobie	dziobiesz	Person
zwyczajną	zwyczajne	Gender
jadany	rozwijany	lemma
fotograficznej	wydmowej	lemma
lewicowej	lewicowym	Gender
arytmetyczną	arytmetycznym	Gender
tarcze	tarcza	Number
prostaty	prostatę	Case
psałterzu	psałterze	Number
drogowskaz	drogowskazy	Number
romantycznym	romantyczne	Case
krowim	krowie	Case
nocnego	nocnej	Gender
alkaloidy	alkaloid	Number
solniczka	solniczki	Number
teścia	teściów	Number
kościelnemu	kościelnej	Gender
lipcowej	poważniejszej	lemma
kulonowi	kulonom	Number
iglaste	niekorzystne	lemma
prawników	prawnicy	Case
światłowstręcie	światłowstrętowi	Case
podchodziłem	przepiłem	lemma
spacer	spacery	Number
działka	działko	Number
archaicznym	archaiczne	Case
zagranicznej	zagranicznym	Gender
internetowe	szczęśliwe	lemma
kaszubskie	południowe	lemma
najdalszej	przyrodniczej	lemma
foka	foki	Number
małpy	małpą	Case
aktualnej	aktualnym	Gender
aldehydowym	średnim	lemma
jodłowej	jodłowym	Gender
nadzorowany	rodzony	lemma
kopertę	kopertą	Case
krwinka	krwince	Case
szczegół	szczegółowi	Case
przedmowa	przedmowie	Case
łotewskiego	żonatego	lemma
impresjonizmem	impresjonizm	Case
furanom	furanowi	Number
kielichy	pustaki	lemma
szatą	szato	Case
marnowano	wykopano	lemma
alkoholików	alkoholikami	Case
stajniach	stajni	Number
okulista	okulistą	Case
prawosławnemu	prawosławnej	Gender
zgrubieniach	zgrubienia	Case
liceach	żłobkach	lemma
namawiał	namawiało	Gender
wiolonczel	wiolonczeli	Number
kwietniowi	podli	lemma
sarkofag	sarkofagi	Number
wierzącym	wierzących	Case
obwodnice	obwodnicę	Number
prolinami	proliny	Case
torebce	torebkach	Number
przypomniałbym	przypomniałbyś	Person
papierom	papiery	Case
krwawego	zdolnego	lemma
sfora	sfory	Number
kwantową	słynną	lemma
zaspach	zaspie	Number
rzemiosłami	rzemiosłem	Number
mosiężnego	mosiężnej	Gender
ideały	ideał	Number
grzesznym	twórczym	lemma
barmanach	barmanie	Number
nadużycia	nadużycie	Number
zabieranie	zabieraniu	Case
dobyliście	zesraliście	lemma
ukrywaj	ukrywajmy	Person
dobrowolnej	dobrowolna	Case
prozodia	prozodio	Case
armeńska	silniejsza	lemma
katarakty	katarakt	Number
bogaty	szczurzy	lemma
boską	boskim	Gender
aktywistki	aktywistkę	Number
prasa	prasy	Number
fioletom	fioletach	Case
prośbie	prośba	Case
kasków	kasku	Number
kawowcowi	kawowcom	Number
biurowego	biurowych	Number
paprykowego	paprykowej	Gender
żwaczowi	żwaczom	Number
pojemnym	pojemnej	Gender
rozwijany	rozwijana	Gender
małżeńskiego	małżeński	Case
miękkiego	pośmiertnego	lemma
ogiery	ogier	Number
kilometrówce	prosiaku	lemma
poprowadzone	zwymyślane	lemma
eksluzywne	szalone	lemma
szarlatanów	szarlatana	Number
świeckim	świeckiemu	Case
kartek	kartki	Number
turecki	tureckie	Gender
stoliczek	stoliczki	Number
bojałem	ryczałem	lemma
żyletki	żyletek	Case
karcie	kartach	Number
widłami	widły	Case
rzuciło	rzucił	Gender
ind	indzie	Case
mięsożercy	mięsożercami	Case
azbestowemu	azbestowej	Gender
scholastyczne	scholastyczną	Gender
nawą	nawami	Number
fok	foki	Number
cieszyński	sześcienny	lemma
karmiony	karmione	Gender
różniczkowego	różniczkowej	Gender
bólów	bólu	Number
dżudoczką	dżudoczkami	Number
całujmy	słyszmy	lemma
szewskiego	szewskich	Number
wilżyny	wilżyno	Number
izomorfizmu	izomorfizm	Case
mag	magowi	Case
szampony	szamponami	Case
pisklęcia	pisklę	Case
absolutną	absolutna	Case
czyniąc	wstając	lemma
bruzd	nanometrów	lemma
spieszę	spieszą	Person
bandażach	bandaże	Case
królewskim	królewskiej	Gender
śpieszyłaby	śpieszyłoby	Gender
skaczecie	skaczemy	Person
krajzegami	krajzegą	Number
bordowa	bordowy	Gender
pasterkom	pasterkami	Case
plotkująca	plotkujący	Gender
hipotece	hipotekom	Number
rzutnikami	rzutnikiem	Number
wilk	wilki	Number
bajtem	bajt	Case
pęknięta	zakochana	lemma
pieniężną	pieniężnym	Gender
pierwotniakami	pierwotniakiem	Number
wołałoby	wołałaby	Gender
zawał	zawały	Number
zamknięte	zamkniętą	Gender
szafkami	szafkach	Case
obalacie	obalam	Person
gutacją	gutacjo	Case
oskarżałyby	runęłyby	lemma
bachorom	bachorowi	Number
jurajskim	jurajską	Gender
puryfikaterz	puryfikaterzu	Case
ciotkę	start	lemma
olchami	olch	Case
kuleczki	kuleczek	Number
żołnierzach	żołnierze	Case
procy	proc	Number
aniołkami	aniołków	Case
nakrętki	nakrętka	Number
skorpiona	skorpiony	Number
leni	lenia	Number
partnerki	partnerek	Case
zabawką	zabawkami	Number
genu	genie	Case
portrecista	portreciście	Case
bułgarski	surrealistyczny	lemma
uczuciom	uczuciu	Number
aktorce	aktorka	Case
dymnym	uboższym	lemma
niepokojami	niepokojem	Number
kamieniarzami	kamieniarzem	Number
ciężarnej	najszybszej	lemma
ambulansy	ambulansie	Number
trybie	tryb	Case
minimalnego	minimalny	Case
baletem	baletowi	Case
nierówności	nierównościom	Number
pijaliśmy	szastaliśmy	lemma
szkutnika	szkutnikiem	Case
schnęła	schnęłaś	Person
zamordowania	zamordowaniu	Case
czepkach	czepkom	Case
wykrwawiłbym	wykrwawiłby	Person
bednarzy	bednarza	Number
absorbowałaś	zaufałaś	lemma
dentystów	dentysty	Number
wymagające	wymagający	Gender
przysłówek	przysłówki	Number
babilońskim	watykańskim	lemma
wiślane	wiślaną	Gender
owsianej	owsianego	Gender
ostrowami	ostrowem	Number
spodziewałyście	spodziewacie	Tense
antyprotonem	antyprotonami	Number
cynkowi	cynku	Case
aksjomaty	aksjomacie	Number
mandżurskiemu	mandżurskie	Case
lakiernikami	lakiernikiem	Number
gwiżdżąc	ściągając	lemma
pory	poro	Number
żwaczem	żwaczami	Number
agenturze	agentura	Case
krwista	krwiste	Gender
dolnołużyckim	pomysłowym	lemma
pierścienic	pierścienicy	Number
bułką	narodem	lemma
ubrań	ubraniami	Case
zjadliwą	zjadliwym	Gender
wodnym	wodnego	Case
ster	steru	Case
socjalistyczne	socjalistyczny	Gender
odlew	odlewowi	Case
nać	nacie	Number
moczowej	moczowa	Case
lodowisko	lodowiska	Number
fartuchu	fartuchach	Number
szumów	szumy	Case
dotyk	związek	lemma
pożyczyłby	pożyczyłoby	Gender
małżowi	małżem	Case
agoro	przedmieście	lemma
liczebnością	liczebności	Case
heptanem	heptanami	Number
papieskiej	papieskiego	Gender
centralizmem	centralizmu	Case
psychopatycznej	psychopatycznego	Gender
remis	remisu	Case
podmiotów	podmiotu	Number
słonki	słonkę	Number
wersjach	wersji	Case
zabiję	zabijemy	Person
fenyloalaniny	fenyloalaninom	Case
konsulatów	konsulatu	Number
biblijną	słomianą	lemma
lemiesze	lemiesz	Number
zimozielonego	zimozielonych	Number
zrozumiałam	zrozumiała	Person
pasierbicy	pasierbicach	Number
padaczkami	padaczką	Number
cytoplazmatycznym	cytoplazmatycznej	Gender
najciemniejsze	najciemniejszy	Gender
okresu	okres	Case
puentę	puenty	Number
rabina	rabinów	Number
zapłaciła	zapłacił	Gender
klatki	klatkę	Number
kwietniowej	kwietniowego	Gender
lubelskiego	przeliczalnego	lemma
pokrywania	pokrywaniu	Case
kroplę	krople	Number
kobrze	kobra	Case
azerbejdżańskiego	płciowego	lemma
piaskownicy	piaskownic	Number
runą	runiecie	Person
elektrochemiczne	odpowiednie	lemma
naprawiacie	naprawiasz	Person
kałamarzu	sabotażu	lemma
mądrościach	mądrości	Number
płazem	płazami	Number
maczugę	maczugi	Number
klasztoru	klasztorów	Number
dalmatyńskiej	dalmatyńskiego	Gender
gwizdanie	zapominanie	lemma
sznurka	sznurków	Number
ocenie	oceną	Case
jakimkolwiek	jakiejkolwiek	Gender
uprawiam	uprawiają	Person
zabiłbyś	zabiłby	Person
szatą	szatę	Case
nadzorująca	wysyłająca	lemma
dopalaczach	dopalaczu	Number
zakonników	zakonnikach	Case
różańcu	różańce	Number
mężów	mężom	Case
bestię	bestie	Number
nieodpowiedzialnym	nieodpowiedzialnego	Case
łysy	łysa	Gender
fora	forami	Case
towarzyskiego	towarzyskich	Number
nagrodą	nagrodami	Number
lubelską	lubelska	Case
kosmate	kosmatą	Gender
nadepnięcie	pranie	lemma
dawnego	dawnym	Case
gwiazdozbiorze	gwiazdozbiory	Number
szczypiorniści	szczypiornista	Number
grzybobraniami	grzybobrania	Case
przejrzystego	przejrzystych	Number
szaradzie	szarady	Case
poznane	słyszane	lemma
zimową	zimowa	Case
pamiętasz	pamiętają	Person
tajemy	taję	Person
pamiętliwy	pamiętliwe	Gender
praktyka	praktyce	Case
wyszukiwarka	wyszukiwarką	Case
anegdot	anegdoty	Number
ciotki	ciotkę	Number
bretońskie	wysokie	lemma
dwujęzycznej	dwujęzycznym	Gender
spadochronów	spadochronu	Number
granicznemu	granicznej	Gender
rozwijający	rozwijająca	Gender
trzaskałem	trzaskałam	Gender
gnijącej	przyszłej	lemma
diabła	diabłem	Case
najmłodszemu	najmłodszej	Gender
katodę	katody	Case
ekonomistów	ekonomisty	Number
wyrzutkiem	wyrzutkami	Number
komiksami	komiksy	Case
cyrkowego	cyrkowej	Gender
najcięższe	nienaturalne	lemma
mężczyźnie	mężczyznach	Number
starożytnego	starożytnej	Gender
jeniec	jeńcy	Number
praco	prace	Number
kwadratem	kwadracie	Case
pokażą	pokaże	Person
gagauskiej	styczniowej	lemma
delegatem	delegata	Case
wędki	wędkę	Number
wysiłkiem	wysiłkami	Number
ośmiornicę	ośmiornice	Number
mylnym	mylną	Gender
elektronicznym	elektronicznej	Gender
pokładach	pokładami	Case
wydry	wydro	Number
łukiem	łukami	Number
zaryzykowałyśmy	zaryzykowałyście	Person
najczęstszymi	następnymi	lemma
przestępstwom	przestępstwami	Case
spróbujemy	spróbujesz	Person
cyfrze	cyfrach	Number
najspokojniejsze	najspokojniejszy	Gender
jarów	żółwików	lemma
żałosną	żałosnym	Gender
farmaceuci	farmaceuta	Number
rozmaitości	rozmaitościami	Case
niezrozumiałe	niezrozumiałą	Gender
drapanie	uratowanie	lemma
poprawiałeś	poprawiał	Person
neutrina	neutrino	Number
magnetycznej	magnetycznego	Gender
książkowe	tymczasowe	lemma
karabinkach	karabinki	Case
eutanazistami	eutanaziści	Case
myszach	myszy	Number
maszerowalibyśmy	maszerowalibyście	Person
żywicami	żywicą	Number
wędrowca	wędrowcze	Case
mieszkasz	uprawiasz	lemma
żniwiarza	żniwiarzem	Case
festiwal	festiwalem	Case
cukrowego	wędrownego	lemma
bułgarską	bułgarskie	Gender
drukowany	stawiany	lemma
jubiler	jubilerzy	Number
kawki	kawkę	Number
kamerzyści	kamerzysto	Number
bierzmowanie	bierzmowania	Number
kadetów	kadeta	Number
balsamem	balsam	Case
monarchom	monarsze	Number
hodowcą	hodowca	Case
kwestionowano	wykorzystywano	lemma
rudy	rudo	Case
gestami	gestem	Number
chrzęstami	chrzęstem	Number
twarogiem	twarogami	Number
gospodarce	gospodarki	Case
kadencję	kadencje	Number
ostrzeżeniom	ostrzeżeniu	Number
kadzie	kadziach	Case
dalekim	obraźliwym	lemma
lemniskat	lemniskaty	Number
taśm	taśmy	Number
kota	kotów	Number
akcesoria	akcesorium	Number
nietoperze	nietoperzami	Case
opierdolmy	studiujmy	lemma
tramwaje	tramwaju	Number
metalurgicznym	płatnym	lemma
blaszanym	scholastycznym	lemma
metodystyczną	sporadyczną	lemma
Polakach	Polakom	Case
łady	łado	Number
ocena	oceny	Number
aforyzmy	aforyzmami	Case
uczuleń	uczulenia	Case
weganizm	weganizmu	Case
relikwiarza	relikwiarzy	Number
pisz	wydostawaj	lemma
orzecha	orzechy	Number
sieciach	sieciom	Case
transkrypcje	transkrypcja	Number
kolekcjonuje	kolekcjonują	Number
pobrały	wzięły	lemma
lojalniejszym	lojalniejszej	Gender
dzielenia	dzielenie	Number
notowana	rzucona	lemma
mniejszą	mniejsze	Gender
pogrzebali	zawarli	lemma
prawniczej	prawniczym	Gender
opony	oponami	Case
upadkach	upadki	Case
zespolona	zespolone	Gender
lekarstew	lekarstwa	Number
foremna	foremne	Gender
budżetówkach	stalach	lemma
borem	bor	Case
luźnemu	luźnej	Gender
zwięźlejszej	zwięźlejszego	Gender
jedynce	jedynkę	Case
marmolad	marmolady	Case
migawki	migawkę	Number
kodeksie	kodeksu	Case
informacjami	informacją	Number
mijająca	rodząca	lemma
nieprzewidywalnym	nieprzewidywalnej	Gender
bożyszcze	bożyszcza	Number
kompasy	kompasie	Number
chrzcie	chrztach	Number
jesiotr	jesiotry	Number
modląca	rozwijająca	lemma
łagodną	nowoczesną	lemma
samcem	samcami	Number
niezbędnego	niezbędnych	Number
pestycydy	pestycydami	Case
komedii	komedie	Case
siarce	siarki	Case
kojące	schnące	lemma
minimalistyczne	minimalistyczną	Gender
banici	banitów	Case
kalinę	wrzosowisko	lemma
najwybitniejszej	najwybitniejszego	Gender
recepcje	recepcja	Number
pępowina	pępowiny	Number
łachmanie	łachmanu	Case
pożarom	pożarami	Case
śmieszny	śmieszne	Gender
reguła	regułę	Case
zapożyczenie	zapożyczeniem	Case
januszem	janusz	Case
grenlandzkiej	nieśmiertelnej	lemma
łososiowa	łososiowy	Gender
adeptów	adepta	Number
czerwonawe	surrealistyczne	lemma
lejku	lejkiem	Case
przeprowadzałbym	przeprowadzałby	Person
dostępny	dostępne	Gender
najwierniejszą	najwierniejszym	Gender
nastawiwszy	zatrzymawszy	lemma
potwierdzona	przeinaczona	lemma
stajni	stajniom	Number
czekające	poprzedzające	lemma
ślepe	ślepego	Case
jajowodzie	jajowodu	Case
lekarstwa	lekarstwo	Number
szaloną	szalonej	Case
cieńszego	skończonego	lemma
kóz	kozach	Case
gdańskiej	gdańskim	Gender
przygody	przygód	Number
teleskopach	teleskopy	Case
nanometrów	nanometra	Number
zapłaciła	zapłaciło	Gender
kaniami	kanią	Number
najrealistyczniejsze	najrealistyczniejszy	Gender
kartezjanizm	kartezjanizmu	Case
bezdźwięcznych	podczerwonych	lemma
ognisku	ogniskach	Number
kopiuję	rozróżniam	lemma
braterskiej	braterskiego	Gender
szewców	szewcy	Case
całun	próbę	lemma
dymnych	obraźliwych	lemma
przyjaznej	przyjaznym	Gender
kategorią	kategorii	Case
pośladek	pośladki	Number
stałym	stałą	Gender
najświętszemu	najświętszej	Gender
nagrody	nagrodom	Case
marokańską	marokańskie	Gender
kosmata	ponadpaństwowa	lemma
barokową	barokowe	Gender
schizofrenicznej	schizofrenicznego	Gender
doprowadzać	szaleć	lemma
dadzą	damy	Person
buddyjski	buddyjskim	Case
wyraźną	wyraźnym	Gender
aktorom	aktorach	Case
prowitaminie	prowitaminach	Number
stwierdzeń	stwierdzeniach	Case
głowy	głowa	Number
gromadzona	przeprowadzana	lemma
dżungli	dżungle	Case
ciągłego	ciągłej	Gender
kwaśnym	radzieckim	lemma
kakaowe	najświetniejsze	lemma
chrześcijańskim	żaroodpornym	lemma
cukinie	plakaty	lemma
ozon	ozonu	Case
masowca	masowców	Number
rekonstrukcje	rekonstrukcję	Number
dworzanina	dworzan	Number
kusząca	kuszące	Gender
spałaszowała	spałaszowało	Gender
wybrednych	wybredne	Case
hymny	hymn	Number
strzałce	strzałką	Case
dokonywałem	rozmyśliłem	lemma
partnerki	partnerek	Number
kryształach	krysztale	Number
bogactwu	bogactwom	Number
oblężenie	oblężenia	Number
denaturatem	obrzękiem	lemma
rozmarynach	rozmaryny	Case
bratanice	bratanica	Number
radiolatarnio	radiolatarnie	Number
zakrętek	zakrętki	Number
rytmem	rytmami	Number
strażacy	strażaków	Case
wierzyłabyś	wierzyłaby	Person
dłuższym	podczerwonym	lemma
wybuchach	wybuchy	Case
zapiekankę	zapiekanki	Number
malinowym	wcześniejszym	lemma
googluję	googlujesz	Person
cudniejszych	rzecznych	lemma
aktualniejsze	tłuste	lemma
miedziak	miedziaki	Number
palaczem	palaczami	Number
obrabujcie	skażcie	lemma
jesionowy	ważniejszy	lemma
gruchy	gruchach	Case
młodszego	potocznego	lemma
rzadkim	rzadkiej	Gender
polewkami	polewkom	Case
chasyda	chasyd	Case
zoologicznemu	zoologiczne	Case
piszczał	piszczało	Gender
akrobatów	akrobatami	Case
łady	łada	Number
da	zakaże	lemma
łamane	łamana	Gender
kurki	kurek	Number
mopsach	mopsy	Case
wersom	wersowi	Number
pośladkowi	pośladek	Case
barion	barionem	Case
cheeseburgerem	cheeseburgerze	Case
gorączki	gorączka	Number
symulujące	symulująca	Gender
bambusowy	znany	lemma
pszczeli	pszczele	Gender
kambodżańską	poprzednią	lemma
mejl	mejla	Case
uroki	urok	Number
hamować	wyłudzić	lemma
gniazdku	gniazdka	Case
rozmowy	rozmowa	Case
najwłaściwsze	najwłaściwsza	Gender
protektoratowi	protektorat	Case
koalicjami	koalicji	Case
pozdrowienia	pozdrowienie	Number
absurdów	absurdu	Number
drożdżowej	drożdżowego	Gender
dzwonów	dzwonu	Number
promów	promy	Case
dostaję	zaczynam	lemma
atmosfery	atmosfer	Case
kłamiący	ripostujący	lemma
krzywdą	krzywdami	Number
maltańskim	maltańską	Gender
świeczniki	świecznik	Number
wstawiony	wstawiona	Gender
ostrosłupa	ostrosłupem	Case
archeologicznym	nocnym	lemma
metodzie	metodach	Number
bezgrzeszny	skrzydlaty	lemma
węża	wężu	Case
przekomarzałyśmy	przekomarzamy	Tense
salamandry	salamandrę	Number
leczylibyście	leczylibyśmy	Person
lonżach	lonż	Case
miesiącu	miesiąca	Case
ziemniaków	ziemniaki	Case
składniku	składnikach	Number
lokomotywom	lokomotywie	Number
migrenę	migrenie	Case
topoli	topól	Number
jesiennego	podwodnego	lemma
linami	linem	Number
weto	weta	Number
pragnienia	pragnienie	Number
łachmanach	łachmany	Case
niepewnego	niepewnej	Gender
pełnia	pełnie	Number
tygrysy	tygrysa	Number
motor	motorem	Case
rydwanów	rydwanach	Case
pajęczynę	pajęczyny	Number
majami	majem	Number
wyruchałem	wyruchałam	Gender
kolumbarium	niesieniem	lemma
zegar	zegarem	Case
jodłowanie	rozczarowanie	lemma
namibijskiej	namibijskiego	Gender
epitafiach	epitafia	Case
charytatywną	charytatywnym	Gender
iglastymi	zdrowymi	lemma
koenzymami	koenzymem	Number
artystek	artystki	Case
kagańcem	rozrywką	lemma
pachę	pachy	Case
dzielenia	weterynarze	lemma
blokach	bloku	Number
suki	suk	Case
liściasty	zamknięty	lemma
podpierdoliłabym	podpierdoliłbym	Gender
głosujące	zwyciężające	lemma
niezwykłego	niezwykłej	Gender
kasiarz	kasiarze	Number
fosie	fosach	Number
belgijskim	regularnym	lemma
pornograficzna	pornograficzną	Case
zająca	zajęcy	Number
żydzi	żyd	Number
rybaku	rybacy	Number
botanikami	botanicy	Case
żerdzie	żerdź	Number
chwiałby	pożyczałby	lemma
kosie	kosach	Number
adresatów	adresaci	Case
skrzypkach	skrzypku	Number
skrypty	skrypt	Number
kanadyjskiej	zielonkawej	lemma
terapeutów	terapeuci	Case
teść	teściowie	Number
czapla	czaplę	Case
tablicą	tablicę	Case
narty	nartami	Case
procesowi	proces	Case
tkaczami	tkaczem	Number
brzęczenie	ruszanie	lemma
sówką	sówko	Case
kadzie	kadzi	Number
strachowi	strachu	Case
dochodzisz	trzaskasz	lemma
zakażenie	zakażenia	Number
przymiotnik	przymiotnika	Case
wpływowego	wpływowemu	Case
klasyfikację	klasyfikacje	Number
towar	towarze	Case
roboto	robotę	Case
demonie	demonem	Case
lemniskaty	lemniskata	Case
nękać	uratować	lemma
fonologii	fonologie	Case
stolica	stolicę	Case
składowi	składu	Case
zwyciężała	zwyciężał	Gender
odważnej	odważnym	Gender
lansowane	włączane	lemma
kostarykańska	kostarykańskie	Gender
lodówkę	rękawiczkę	lemma
diagram	diagramy	Number
mięsa	mięso	Number
katarynki	katarynka	Number
stępem	stępie	Case
żartują	żartuje	Person
sytuacji	sytuacją	Case
grzyba	grzybów	Number
hipotezy	hipotezę	Number
rozbije	uderzy	lemma
pradziadkom	pradziadków	Case
meteorologiczną	meteorologicznym	Gender
rzutkami	rzutki	Case
keton	ketony	Number
popołudnia	popołudnie	Number
statuy	statua	Number
obalałabyś	rzygałabyś	lemma
pożądajmy	pożądałybyśmy	Mood
prawideł	prawidła	Number
nijaką	nijakie	Gender
łużycką	łużyckim	Gender
przesłuchanie	przesłuchania	Number
wegetarian	wegetarianie	Case
dźwig	szczelina	lemma
lubiąc	przepraszając	lemma
asymptoty	asymptotę	Number
przyjmowałyśmy	przyjmujemy	Tense
wybieg	wybiegi	Number
festiwalom	festiwalami	Case
szermierce	szermierką	Case
ostre	ostry	Gender
bezpiecznej	bezpiecznym	Gender
drzemkę	drzemki	Number
agnostykiem	agnostykami	Number
warsztatu	warsztatów	Number
rowerze	rowerach	Number
najpotężniejszą	najpotężniejszym	Gender
zakończenia	zakończenie	Number
naszyjniku	naszyjnika	Case
łódki	łódek	Case
głosować	sprzątnąć	lemma
gepardy	geparda	Number
neodymie	neodymowi	Case
eksportowana	wysyłana	lemma
kasku	wypadku	lemma
rocznemu	rocznej	Gender
literówkami	literówek	Case
nowym	nową	Gender
polowanie	polowania	Number
dawałyście	dawałyśmy	Person
wyrazom	wyrazowi	Number
skłamałam	skłamałem	Gender
miewałoby	skracałoby	lemma
właściwsza	właściwszy	Gender
kondygnacji	wyznaczników	lemma
tronów	trony	Case
modem	wędrowanie	lemma
wpływy	wpływom	Case
dziąsłowego	śpiącego	lemma
najregularniejszy	najregularniejsza	Gender
łaźnia	łaźnią	Case
terminów	terminom	Case
niewiasty	niewiastę	Case
grzeszą	usuwają	lemma
chcące	zerujące	lemma
energii	energiach	Case
wymówkom	wymówki	Case
różyczką	różyczce	Case
dokonajcie	dokonałybyście	Mood
deuter	sinologię	lemma
niezbędny	niezbędna	Gender
lojalne	lojalną	Gender
murzyn	murzyni	Number
telefon	telefonowi	Case
tułowiu	tułowie	Number
zyskami	zyskach	Case
powiatem	powiatami	Number
płynie	płynach	Number
pantograf	pantografy	Number
błogimi	samotnymi	lemma
teściową	teściowej	Case
roju	rojach	Number
kuchennym	kuchenną	Gender
żyło	żyle	Case
atrakcyjniejszym	atrakcyjniejszą	Gender
adekwatnym	adekwatną	Gender
chciałabym	chciałaby	Person
opalu	opale	Number
kupą	kupami	Number
strefach	strefie	Number
potencjalny	potencjalna	Gender
rycząca	ryczący	Gender
ponadprzeciętnym	ponadprzeciętnej	Gender
nieboszczyków	nieboszczyka	Number
podpierdolony	podpierdolone	Gender
szarawymi	szarawych	Case
wierzący	wierzące	Gender
świniopasowi	świniopasom	Number
faceta	facetem	Case
bośniackim	bośniackiej	Gender
sztormem	sztorm	Case
kotków	kotkach	Case
hipopotamami	hipopotamem	Number
poligamicznych	poligamicznego	Number
chemiku	chemikowi	Case
tlała	tlał	Gender
lunatyka	lunatyku	Case
blendzie	blendę	Case
grille	grill	Number
uzusy	uzus	Number
mylicie	myliłyście	Tense
godną	godnym	Gender
przedimek	przedimku	Case
wysokimi	wysokich	Case
tukiem	tukowi	Case
plecaki	plecak	Number
szczurami	szczury	Case
kopiujące	kopiujący	Gender
kupię	zapomnę	lemma
opierdoliłam	próbowałam	lemma
zwięzłym	zwięzłej	Gender
grudniowego	grudniowych	Number
faktami	faktach	Case
jamajskiej	nieznośnej	lemma
glinie	glinu	Case
wykładzie	wykłady	Number
narzędziu	narzędziach	Number
czasz	czaszy	Number
płakałabym	życzyłabym	lemma
podatku	podatki	Number
kalwinistami	kalwinistą	Number
hormony	hormon	Number
okresów	okresu	Number
sadzę	sadze	Number
rozety	rozeta	Number
minimalistyczne	pierworodne	lemma
dawaliście	zachowaliście	lemma
morelo	morele	Number
czasopismach	czasopismami	Case
archanioła	archaniołem	Case
kochankach	kochance	Number
ługami	ługach	Case
zjebałyście	zjebały	Person
ałtajskiego	ałtajskiej	Gender
skłamcie	skłamałybyście	Mood
atlasu	atlasów	Number
hongkońska	nieważna	lemma
mleczko	mleczka	Number
cyników	cynika	Number
apsydy	apsydą	Case
maszerowałabyś	maszerowałaby	Person
bis	powróz	lemma
rybozą	rybozie	Case
kupiono	puszczono	lemma
loterii	loterię	Case
iberyjski	iberyjska	Gender
stulecia	stulecie	Case
ezoterycznych	społecznych	lemma
cywilizacja	cywilizacje	Number
podpalony	przyjęty	lemma
żałobie	żałoba	Case
empetrójka	empetrójko	Case
rywalizacje	rywalizację	Number
strąki	strąk	Number
wiedźma	wiedźmy	Number
kształtów	kształtom	Case
szerszenia	szerszenie	Number
lisicami	progami	lemma
mokrą	nieprzewidywalną	lemma
sfałszuję	zajebię	lemma
oświetlałaś	rozwijałaś	lemma
zamężnej	zamężną	Case
paski	pasek	Number
słuchawce	słuchawkach	Number
wspominają	wspominasz	Person
śladu	śladów	Number
nudniejszego	nudniejszym	Case
autoportrecie	autoportretu	Case
lut	luty	Number
organicznym	organiczną	Gender
warszawiankę	warszawianki	Number
mlecznej	pilnej	lemma
areszt	aresztem	Case
nosowej	nosowym	Gender
wiecach	wiece	Case
punkt	punkcie	Case
powtórzony	zerwany	lemma
umówiła	umówił	Gender
ściągałem	ściągałeś	Person
kawowych	prawosławnych	lemma
zachętę	zachęty	Number
jajniku	jajniki	Number
falangami	falangą	Number
sznurkach	sznurkami	Case
programistami	programistą	Number
kwestionuję	kwestionują	Person
bydgoskiego	ostrego	lemma
myjące	ruszające	lemma
przyrostek	przyrostka	Case
demokratyczną	słoniową	lemma
dowodzony	zakochany	lemma
formalistę	formalistów	Number
kapitalistycznego	kapitalistycznemu	Case
klonowi	klonu	Case
daszkami	daszkiem	Number
erotycznym	erotyczne	Case
kolejami	koleją	Number
wypadki	wypadek	Number
kinowej	kinowemu	Gender
polarną	polarne	Gender
kombinezon	kombinezony	Number
rogi	rogami	Case
radiolokacjach	radiolokacji	Number
pojazd	pojazdy	Number
jenie	jeny	Number
wyjaśniona	wyjaśnione	Gender
ścianach	ściany	Case
bólach	ślubach	lemma
widowiska	widowisko	Number
opisują	opisuje	Person
antygeny	antygen	Number
obywatelami	obywatelem	Number
jajniku	jajnikach	Number
kroplę	kropla	Case
komentowałyśmy	komentujemy	Tense
potwierdziłaś	potwierdziłeś	Gender
przybyszy	przybyszom	Case
pospolitej	pospolitemu	Gender
homoseksualnej	nepalskiej	lemma
archiwum	archiwów	Number
paradygmaty	paradygmacie	Number
Indianie	Indianinie	Number
optymistyczna	optymistyczny	Gender
rozproszycie	zniszczycie	lemma
usługę	usługi	Number
dekielki	sinusy	lemma
wieniec	wieńce	Number
kompilujecie	kompilują	Person
cyklach	cykle	Case
ogród	ogrodem	Case
soku	soków	Number
uważania	uważaniu	Case
epizodach	epizodzie	Number
karczoch	karczochy	Number
epidemie	epidemii	Case
palcowi	palca	Case
łaty	łatom	Case
położenie	położenia	Number
najbliższą	testową	lemma
kniaziem	kniaziu	Case
telewizyjne	telewizyjna	Gender
obrażaliście	zebraliście	lemma
arów	ponczy	lemma
tatuażu	tatuaże	Number
premierowi	premierom	Number
wyjął	wyjęła	Gender
obawom	obawie	Number
długowiecznego	niezrozumiałego	lemma
mniejszemu	mniejszej	Gender
programie	programu	Case
podasz	zbierzesz	lemma
pyszna	pyszny	Gender
umierania	umieraniu	Case
absurd	telewizję	lemma
skaczę	skaczemy	Person
belek	belki	Number
fizycznym	ptasim	lemma
dymiące	znaczące	lemma
Marsjanach	Marsjaninie	Number
cypryjskiej	cypryjskiego	Gender
umarłem	umarłeś	Person
szmaragd	szmaragdy	Number
Węgrzynach	Węgrzynami	Case
kołowroty	kołowrotami	Case
gry	gra	Number
zapalniczki	zapalniczek	Case
maluchom	maluchami	Case
radioaktywności	radioaktywność	Case
zasługujące	zasługująca	Gender
fajka	fajki	Number
bretońskimi	potężniejszymi	lemma
kosarza	kosarze	Number
nieodpowiednią	nieodpowiednie	Gender
statku	statkach	Number
zakażeń	zakażeniami	Case
zeszytu	zeszytowi	Case
stewardessą	stewardessie	Case
dłońmi	dłonią	Number
węszmy	węszcie	Person
termodynamicznej	termodynamicznym	Gender
panowałeś	zerowałeś	lemma
nacjonalistyczny	październikowy	lemma
papierośnicom	papierośnice	Case
monarchia	monarchie	Number
patenty	patentów	Case
zasobie	zasobach	Number
afrykanerski	roślinożerny	lemma
kamyka	kamyk	Case
absyntowe	absyntową	Gender
dalmatyńskiej	dalmatyńska	Case
jedwabnej	jedwabnemu	Gender
kokosowe	kokosowa	Gender
rekinowi	rekina	Case
umowy	umowami	Case
szatnię	szatnie	Number
zmieniło	zmienił	Gender
beatyfikacji	beatyfikacjo	Case
należące	należąca	Gender
zabawnym	zabawnej	Gender
milicjanta	milicjant	Case
lekarzy	lekarza	Number
bytomskie	pomysłowe	lemma
epicentrum	epicentrów	Number
libańską	libańskie	Gender
abisyńskim	ważnym	lemma
prawosławnego	prawosławnej	Gender
istocie	istotach	Number
pokazało	pokazała	Gender
parterze	parterach	Number
algorytmami	algorytmy	Case
wolne	wolna	Gender
dłużniku	dłużnik	Case
ul	ule	Number
łasce	łaska	Case
pancerze	pancerzach	Case
Lemingrad	Lemingradu	Case
biegunem	biegunami	Number
odpowiadają	pozwalają	lemma
immunitetu	immunitetem	Case
mrówkojada	mrówkojadów	Number
cyfrową	siną	lemma
wargach	wardze	Number
patentami	patentem	Number
ładując	wiejąc	lemma
mądre	niezależne	lemma
parskałby	parskałbym	Person
wieloznaczną	wieloznacznym	Gender
małpowałyście	małpowały	Person
powszechniejszym	powszechniejszą	Gender
taje	taję	Person
ładzie	przemytnikowi	lemma
używasz	używam	Person
rozmawiająca	rozmawiający	Gender
najdalszy	okropny	lemma
wirusowe	wirusowy	Gender
kleje	kleju	Number
janczarach	janczarze	Number
monetaryzm	monetaryzmu	Case
arytmetyczny	trwały	lemma
ścieżkom	ścieżce	Number
wpływową	wpływowej	Case
obiecadło	obiecadła	Number
cyrkowe	niewidzialne	lemma
wolniejszy	wolniejszego	Case
aliteracje	wypieki	lemma
urządzeniom	urządzeniami	Case
wtorek	wtorki	Number
ministerstwo	ministerstwa	Number
pętlach	pętli	Number
wypiekach	wypieku	Number
leasingowej	leasingowego	Gender
nadzoru	nadzorem	Case
łamanym	łamane	Case
najbujniejszego	najwilgotniejszego	lemma
sądy	sąd	Number
korsykańską	korsykańskie	Gender
dentystko	dentystki	Number
strzykwę	strzykwo	Case
amfiteatrów	sprzedaży	lemma
odebrałybyście	odbierzcie	Mood
absurdalnych	najwspanialszych	lemma
bawełniany	bawełnianemu	Case
dotykałem	dotykałam	Gender
kwestionowała	zatrzymała	lemma
szklanego	szklanej	Gender
okropnego	okropnych	Number
sądzona	sądzony	Gender
archaicznej	archaicznego	Gender
liter	litery	Number
