oyunuza	Noun
merkez	Noun
korktum	Verb
öldürdüm	Verb
yalana	Noun
bildirirler	Verb
ispatladı	Verb
makinesine	Noun
göbek	Noun
götlerde	Noun
kabuklar	Noun
abajurlarımın	Noun
sayfası	Noun
demiyoruz	Verb
salatalarınızın	Noun
kemerde	Noun
yemeni	Noun
altta	Noun
yapmayı	Noun
dilek	Noun
saatte	Noun
banliyölerde	Noun
lordlar	Noun
başardın	Verb
gelinliği	Noun
seçmeyecek	Verb
ütülerime	Noun
öksürmeyeceğiz	Verb
cephesinin	Noun
adımıza	Noun
protestosu	Noun
pancara	Noun
odağımıza	Noun
arzuhalcilerinizde	Noun
serçeleri	Noun
kullanıcımız	Noun
örtüde	Noun
incisi	Noun
embriyonuzun	Noun
sonbaharlarda	Noun
sığmıyorsun	Verb
dağılmadılar	Verb
çatala	Noun
gelinecek	Verb
okyanusa	Noun
cümlesine	Noun
tatlılarda	Noun
tundradan	Noun
jaguarın	Noun
eşeğe	Noun
ilkesi	Noun
mezralar	Noun
unutur	Verb
sik	Noun
deyime	Noun
omlet	Noun
kiraza	Noun
gizlenmezsiniz	Verb
kusmaya	Noun
içermiyordu	Verb
doymaz	Verb
lalaları	Noun
şüphesinden	Noun
savunuyorlar	Verb
bilgimin	Noun
akiferin	Noun
şaşırmaz	Verb
urdan	Noun
kayıkların	Noun
konserlerimden	Noun
sayfalarınız	Noun
gelmiyor	Verb
bataryalarda	Noun
damlaya	Noun
kovalara	Noun
lehçemizi	Noun
maaşlar	Noun
ilklendirmesin	Noun
elementleri	Noun
yolduruyor	Verb
şaşırdılar	Verb
sezondan	Noun
nöronlardan	Noun
düşünüyorsunuz	Verb
Zagreplilerdir	Noun
blogcunuz	Noun
mesafelerden	Noun
şiirlerin	Noun
ortaklıktan	Noun
bireylerde	Noun
bombayı	Noun
tane	Noun
avizeler	Noun
yığar	Verb
eylemlerden	Noun
kitapçığı	Noun
gelindi	Verb
ayrılma	Noun
büküldük	Verb
batmıyor	Verb
kuluz	Noun
kurda	Noun
akışlarda	Noun
stant	Noun
kanmam	Verb
mikroplarımızı	Noun
savundum	Verb
seviyoruz	Verb
sigaranın	Noun
bulgur	Noun
derlemede	Noun
karartı	Verb
kuklalar	Noun
nedimesinin	Noun
bildirmez	Verb
yardımseverliklerimiz	Noun
nutkumuz	Noun
gülmeyecek	Verb
ikileme	Noun
tuğla	Noun
matruşka	Noun
gereksinime	Noun
gerekir	Verb
kırılıyor	Verb
yaparsınız	Verb
çılgınlıkları	Noun
vekilleriz	Noun
belediyelerimiz	Noun
davranacak	Verb
zangoçlarınız	Noun
yarağımı	Noun
sunusunun	Noun
kapıda	Noun
kullanılmayacak	Verb
günümüzde	Noun
kavrama	Noun
mikroptan	Noun
geçeceğim	Verb
romanlara	Noun
boşalma	Noun
dakikanızı	Noun
asetonuma	Noun
dedikodusunun	Noun
paralelkenarlar	Noun
çöpçatandın	Noun
tesadüfleri	Noun
manayı	Noun
kor	Noun
derneklerden	Noun
alete	Noun
genelevimizi	Noun
saymıyoruz	Verb
hasret	Noun
koşucuymuşlar	Noun
çorbasının	Noun
tarafımızdan	Noun
günlüklerden	Noun
yanlıştı	Adjective
kırmadı	Verb
şatoyu	Noun
otomobillermişiz	Noun
çifte	Noun
umdu	Verb
giymiyorsunuz	Verb
vardınız	Verb
bilgilerim	Noun
bulunuyorsunuz	Verb
değirmenlerde	Noun
platform	Noun
ekrana	Noun
başvuruya	Noun
çıkmıyorum	Verb
minberinizi	Noun
yoracak	Verb
pozisyonlarda	Noun
kazılara	Noun
siyasetçileri	Noun
davranıyorlardı	Verb
gitmeniz	Noun
makarasının	Noun
oyuma	Noun
termometre	Noun
rüzgarlara	Noun
unutmadılar	Verb
kategoriden	Noun
saptı	Verb
meşalesi	Noun
gelişiyordu	Verb
kiler	Noun
çalgısı	Noun
şakadan	Noun
orospunda	Noun
kazar	Verb
mevkilere	Noun
pusuyordunuz	Verb
katılacağım	Verb
seçmezler	Verb
anneyi	Noun
olumsuzluklar	Noun
tekrara	Noun
girerler	Verb
dolaplarda	Noun
ömrümüzün	Noun
nükleotitte	Noun
yasaktan	Noun
dalgalara	Noun
ayrılıyor	Verb
çatlaklardan	Noun
çürümezsiniz	Verb
kabuklara	Noun
payımıza	Noun
purolarınızın	Noun
Monakolulara	Noun
gondollar	Noun
gözlükçüye	Noun
fizyolojinin	Noun
balıkta	Noun
dudaklarda	Noun
zeytine	Noun
kılıçlar	Noun
fahişeliği	Noun
üyeye	Noun
idarelerden	Noun
ağlaması	Noun
asansörde	Noun
evlendiler	Verb
medreselerden	Noun
geçmiyordu	Verb
mendilden	Noun
çağırmadı	Verb
isyanım	Noun
piyanomuzdan	Noun
göçmüşüz	Noun
kardın	Noun
sınıflarda	Noun
paralardan	Noun
sarılmayız	Verb
ava	Noun
alevde	Noun
kuyum	Noun
kobralar	Noun
anlatırız	Verb
güzelleştirir	Verb
evlenmedi	Verb
yağmurda	Noun
kolan	Noun
ceylanlarmışız	Noun
dişliler	Noun
mevzusuna	Noun
köftesi	Noun
veriyorlardı	Verb
faresine	Noun
katıldınız	Verb
kimliğimi	Noun
kelimeye	Noun
kafatasını	Noun
çizgilerdir	Noun
yapmadan	Noun
hatalardır	Noun
kuvvetinizden	Noun
ısınır	Verb
eğrileri	Noun
kuramları	Noun
basketbolcularda	Noun
mükemmelliğe	Noun
keşfetiyorsun	Verb
çubuklar	Noun
maymunlarda	Noun
öğrencilerimizin	Noun
akışa	Noun
ömrüme	Noun
döneceğiz	Verb
yapışması	Noun
fikrinize	Noun
veriyorsunuz	Verb
gösteriye	Noun
geçeriz	Verb
dinsizlik	Noun
cinlerimize	Noun
çiftte	Noun
asacağız	Verb
işlemciler	Noun
şarkıcılığı	Noun
boğar	Verb
tip	Noun
çamları	Noun
bürokrasiyi	Noun
füzelerden	Noun
yakadan	Noun
balıkçımız	Noun
televizyon	Noun
tabaklara	Noun
sorumluluklardan	Noun
özürlerimi	Noun
ısırığın	Noun
yabancılardan	Noun
bıçaklarınızı	Noun
cevaplarımı	Noun
amcayız	Noun
kazımıza	Noun
ödevler	Noun
topolojiye	Noun
bilmiyor	Verb
finallere	Noun
müzisyenlerde	Noun
sahnelere	Noun
seçiliyor	Verb
balalaykalardan	Noun
devede	Noun
tarafımın	Noun
donatımlarımızdan	Noun
türünü	Noun
nefretten	Noun
seven	Noun
sureye	Noun
anlarda	Noun
mayan	Noun
dumanlarda	Noun
zağara	Noun
çerçilermişsin	Noun
garsona	Noun
hikâyeye	Noun
bölgeden	Noun
veririm	Verb
bakandı	Noun
haberlerden	Noun
havuzlardan	Noun
çizerler	Verb
kızar	Verb
aseksüellersin	Noun
çıktılara	Noun
tıkarlar	Verb
kokulardan	Noun
doğruculuk	Noun
hanıma	Noun
harfte	Noun
olayımızdan	Noun
zulümlerden	Noun
öncelere	Noun
eke	Noun
gönlümüz	Noun
bütünde	Noun
davranışımı	Noun
paylaşıyorum	Verb
doktorunuz	Noun
başparmakları	Noun
sayımlarda	Noun
lokma	Noun
yağmasında	Noun
sivrisineklerimizden	Noun
bardaklarda	Noun
çetesini	Noun
sayfalarımız	Noun
hazırım	Adjective
vefatlara	Noun
sezonlara	Noun
sundum	Verb
işlerler	Verb
kullanacaklar	Verb
aşkımızın	Noun
basmışım	Noun
okudum	Verb
süpürür	Verb
futbolcularımızdan	Noun
sünmüyordu	Verb
nükleotidi	Noun
fişeğe	Noun
termometreler	Noun
ortasında	Noun
bireyleri	Noun
futbolcuda	Noun
saydırtmazsın	Verb
geçmemiz	Noun
çıkarmadı	Verb
gagayı	Noun
piyano	Noun
uyuşturucunuzdan	Noun
tabakların	Noun
mükemmel	Adjective
menin	Noun
yönelimi	Noun
kurbanda	Noun
iğnem	Noun
umdular	Verb
geciktirmiyordu	Verb
yetkilerden	Noun
medresene	Noun
dönüşümün	Noun
wiki	Noun
bulutu	Noun
yağın	Noun
gösterecekler	Verb
ömrüm	Noun
ilişkilerde	Noun
teorilerden	Noun
jenerasyonlarda	Noun
çalışırız	Verb
beyitten	Noun
tıkar	Verb
ağaya	Noun
tiyatroyu	Noun
vermedik	Verb
içkilere	Noun
kururlar	Verb
pehlivandı	Noun
dadısının	Noun
yumuyor	Verb
monarşilere	Noun
bilemiyoruz	Verb
moleküllerden	Noun
basketbolculara	Noun
evrimde	Noun
gösteriler	Noun
gecelerim	Noun
sinagogda	Noun
sunucusu	Noun
verdik	Verb
tanıtırlar	Verb
bloglar	Noun
geliştiriyorlar	Verb
fikirlerimize	Noun
vücuda	Noun
üyeliğimi	Noun
alanlarımız	Noun
tarabamı	Noun
nişanlıydı	Noun
sanmam	Verb
yayacak	Verb
klarnet	Noun
modelde	Noun
iyileştirecek	Verb
diskete	Noun
çıkarmam	Verb
ustasının	Noun
bugünden	Noun
sandık	Verb
cümlelerde	Noun
jeolojiyi	Noun
hamamların	Noun
bahçede	Noun
artmıyordu	Verb
veriyorlar	Verb
prototiplerden	Noun
elipslerimizden	Noun
duracağız	Verb
psikologlardan	Noun
pastalar	Noun
mutfakta	Noun
giymezler	Verb
ziyaretçilerden	Noun
şapkanın	Noun
silkmiyorduk	Verb
taslaklara	Noun
araknofobiyi	Noun
acını	Noun
kravatlar	Noun
kaşıdınız	Verb
dönerler	Verb
öğrencisini	Noun
kukladan	Noun
dükmüşsünüz	Noun
karamel	Noun
cesetten	Noun
idaresinin	Noun
evladım	Noun
âlemlerimizden	Noun
teknolojileri	Noun
kazayı	Noun
mantığınız	Noun
üyelerdir	Noun
temizlerim	Verb
gelin	Noun
memlekete	Noun
belediyelerimden	Noun
ritim	Noun
coşar	Verb
taşıdınız	Verb
adamlarda	Noun
görüntüsünde	Noun
alkış	Noun
sülük	Noun
dizdi	Verb
deniliyor	Verb
ağasına	Noun
gördünüz	Verb
çözeltiler	Noun
verimi	Noun
şüphelere	Noun
fabrikaları	Noun
wikilere	Noun
sürüne	Noun
bürokratlarda	Noun
mikrop	Noun
satışta	Noun
idaresinden	Noun
gelmez	Verb
geliniriz	Verb
davranışlardan	Noun
yatak	Noun
bütünleşir	Verb
trigonometri	Noun
anlatırım	Verb
hanımdı	Noun
hazinede	Noun
çizmiyordular	Verb
ördeklerden	Noun
cinsiyetin	Noun
dağıttılar	Verb
doğmadı	Verb
homoseksüelmişiz	Noun
yapılacaklar	Verb
ölümlermişiz	Noun
kalmıyor	Verb
ortaktı	Noun
şikayete	Noun
koyum	Noun
söyleşisi	Noun
teklifimin	Noun
aynalarda	Noun
astronota	Noun
politikaya	Noun
yırtmayacaksın	Verb
teknolojinin	Noun
tenisçiye	Noun
vadede	Noun
katamaran	Noun
savunacağım	Verb
ağasının	Noun
dernekte	Noun
Duşanbelilerinize	Noun
bakandılar	Noun
ırk	Noun
kaygıya	Noun
çarptı	Verb
gondola	Noun
âlimlerden	Noun
samuraylardan	Noun
yamyamınız	Noun
üretiyorlar	Verb
sıvılar	Noun
yeterliğimden	Noun
sorumluluğuma	Noun
böbreğinizde	Noun
kavağımızdan	Noun
kulüpten	Noun
yaramazlar	Verb
aynası	Noun
şarapçılarmışız	Noun
kazaklardan	Noun
konuklar	Noun
tutulma	Noun
yavrusunu	Noun
deneyiminiz	Noun
halının	Noun
seçme	Noun
tiyatroda	Noun
yeniliğimi	Noun
yönelmeye	Noun
patateste	Noun
akşam	Noun
şakşakçı	Noun
yasaklarımızı	Noun
dağılmaya	Noun
güneş	Noun
tabancasından	Noun
kertenkelelerde	Noun
yörelerimizde	Noun
klorofile	Noun
balıklara	Noun
grubumuza	Noun
önbilgilerimiz	Noun
cemaatlerimde	Noun
maçlarınızda	Noun
öğütmüyordum	Verb
kalkacak	Verb
fenerleri	Noun
dondurmasının	Noun
etimden	Noun
vezire	Noun
yorumunuz	Noun
düşündü	Verb
sosluğumuz	Noun
çöpçatanlık	Noun
gişesi	Noun
saça	Noun
örtüye	Noun
altdilimden	Noun
müselleslerimizi	Noun
tavuk	Noun
konulardan	Noun
kemençeyi	Noun
tana	Noun
eceydiniz	Noun
sitenizin	Noun
fonksiyon	Noun
sistemden	Noun
öğretiyorlardı	Verb
armağanı	Noun
tekilalardınız	Noun
şişerler	Verb
öğreti	Noun
şapkayı	Noun
kaşelerinizde	Noun
çetesinden	Noun
tecrübelerimden	Noun
nüfuzu	Noun
yapışmanızın	Noun
canlandı	Verb
birleşirler	Verb
kullanmıyor	Verb
tümörü	Noun
nilüferlerimde	Noun
maçta	Noun
çıkıyorlar	Verb
sevmiyordun	Verb
indekste	Noun
çiftten	Noun
vedamızı	Noun
vakitlere	Noun
kötüleşiyordu	Verb
sıvılara	Noun
yönlere	Noun
salatalara	Noun
yarışmaya	Noun
önerim	Noun
kahvesinde	Noun
yörelere	Noun
ayinde	Noun
arşiv	Noun
denizanalarının	Noun
allıklar	Noun
çıkarmaz	Verb
nergis	Noun
ayılardan	Noun
temsillerde	Noun
tekilde	Noun
üresinin	Noun
diyeceksiniz	Verb
patlama	Noun
krallıkları	Noun
tütü	Noun
aydınlıkta	Noun
entegrasyonlar	Noun
gezdi	Verb
merkezleri	Noun
rebetikolar	Noun
kaydedicinize	Noun
örtüsünde	Noun
toplamıyoruz	Verb
volkanlarımızda	Noun
sözcülerinize	Noun
mancınıklar	Noun
miyolojide	Noun
olurlar	Verb
künefenin	Noun
namazda	Noun
vücutta	Noun
aramıyorum	Verb
hastanelerinizi	Noun
ziyaretlere	Noun
ikazlarmışsın	Noun
otostopçularımıza	Noun
yazdın	Verb
yazıyorsunuz	Verb
modan	Noun
sıçanlarınız	Noun
yanardağlardan	Noun
şov	Noun
batacak	Verb
çılgınlığı	Noun
dakikada	Noun
puro	Noun
duyuya	Noun
çıkmayı	Noun
dondurma	Noun
kursiyeriz	Noun
periyi	Noun
seçmemizin	Noun
kestiler	Verb
parlatıcılarımızın	Noun
otlardan	Noun
tercihimi	Noun
kalıplarda	Noun
kazanmadı	Verb
cenazelerde	Noun
dişlerde	Noun
hastanede	Noun
koda	Noun
erer	Verb
heyetlerden	Noun
ısırıklarda	Noun
değişikliklerden	Noun
öldürmeyeceksin	Verb
alfabelerde	Noun
asimptotlara	Noun
yarattın	Verb
kardeşlerimizi	Noun
noktamız	Noun
saldırıyorsunuz	Verb
kararımın	Noun
döneceğim	Verb
birada	Noun
parçalanmayı	Noun
kitabesini	Noun
biçime	Noun
akbabamın	Noun
yaraklarımın	Noun
manitaydın	Noun
sızar	Verb
mezuniyet	Noun
deliklerden	Noun
alırlar	Verb
davranışlarınızı	Noun
enerjileri	Noun
geçerler	Verb
cinsiyet	Noun
taşacak	Verb
sikişiyoruz	Verb
haberim	Noun
rakamlar	Noun
mısırlar	Noun
körfeze	Noun
yarışmalarımızın	Noun
görüyor	Verb
fırçası	Noun
ağasından	Noun
değişti	Verb
fonksiyonlar	Noun
akrabadan	Noun
tiyatrosuna	Noun
parçacıklarımızı	Noun
yanıyorum	Verb
avokado	Noun
işemezsiniz	Verb
cümlelere	Noun
dilimde	Noun
minberden	Noun
amaçta	Noun
piyanolar	Noun
şurup	Noun
hazine	Noun
mancınık	Noun
diyor	Verb
takacak	Verb
yapmıyorsunuz	Verb
mezra	Noun
ısırır	Verb
duada	Noun
yalvarmazlar	Verb
integrallerimizin	Noun
varoşlarda	Noun
kellik	Noun
makinelere	Noun
enfeksiyon	Noun
otoculuklardan	Noun
piskoposa	Noun
izleyicilere	Noun
şehrim	Noun
düşmezler	Verb
yasasında	Noun
parçadan	Noun
taslak	Noun
sekreteri	Noun
vaktimi	Noun
şarkıcısını	Noun
gol	Noun
memesini	Noun
kullanacağız	Verb
sevenlerden	Noun
aşçılarınızı	Noun
elçisinin	Noun
alabalığı	Noun
embriyosu	Noun
görüşlerimiz	Noun
cevher	Noun
inmezler	Verb
huzurdan	Noun
manama	Noun
hedefleri	Noun
çöpçatanınıza	Noun
rüzgar	Noun
taca	Noun
gizledim	Verb
döndürecek	Verb
böbrek	Noun
mısrasında	Noun
beldede	Noun
yolculuğumun	Noun
cihana	Noun
çağırıyoruz	Verb
belirtmeye	Noun
çizgisine	Noun
ilçelere	Noun
cadıyı	Noun
yolunuzu	Noun
yetkiler	Noun
zamanımın	Noun
kullanımdan	Noun
yazmadan	Noun
korkarlar	Verb
tırtılı	Noun
lorda	Noun
koruyucumun	Noun
hayvanlardan	Noun
mermilerdir	Noun
simyadan	Noun
bilgilerinizi	Noun
doğusunun	Noun
eldivenlere	Noun
yazıt	Noun
laternalarımızda	Noun
hedonistler	Noun
bekleme	Noun
bakirlerinizden	Noun
osurdun	Verb
çamur	Noun
kusması	Noun
azınlıklardan	Noun
gürgen	Noun
modellerdir	Noun
badem	Noun
fikirlerimiz	Noun
tekliften	Noun
açmıyor	Verb
iftitah	Noun
mağara	Noun
füzeleri	Noun
ayarlattırmadılar	Verb
sanatımızın	Noun
yaratacak	Verb
darıldın	Verb
körlüğü	Noun
çıkarmayacağız	Verb
işemiyorlar	Verb
ramazanlar	Noun
vermeyecekler	Verb
çiftetelli	Noun
deyimlerden	Noun
çarpınız	Noun
öğreniyordu	Verb
çandan	Noun
enjektörler	Noun
leblebi	Noun
merdivende	Noun
makinemi	Noun
kaçmadı	Verb
şamisenlerimi	Noun
diyapazon	Noun
veriliyordu	Verb
jeolojide	Noun
sistemimize	Noun
heyet	Noun
bakma	Noun
değiştiriyorum	Verb
lehçede	Noun
tümöre	Noun
platformlarınızdan	Noun
soğandan	Noun
yayanı	Noun
buzullardır	Noun
gördü	Verb
cevizlerimize	Noun
mızrap	Noun
inim	Noun
saklanıyor	Verb
yaklaşıyorlardı	Verb
esenlikler	Noun
akvaryumda	Noun
lokman	Noun
aygıttan	Noun
bitkisinden	Noun
övdü	Verb
matlalarınızı	Noun
sacları	Noun
vaftiz	Noun
adama	Noun
yandım	Verb
katmaz	Verb
vaftizler	Noun
uçlara	Noun
mucizelere	Noun
sonuçlardır	Noun
giysilerimiz	Noun
sporcusu	Noun
roketten	Noun
öleceksin	Verb
kurumumuzun	Noun
ülkesinden	Noun
aşiretler	Noun
bacası	Noun
mumyasının	Noun
ürünlerden	Noun
havuçlar	Noun
çalgıyı	Noun
kelimeydi	Noun
vermiyordu	Verb
geçmiyor	Verb
yetiştirecek	Verb
uçaklar	Noun
odaklardan	Noun
neşeyi	Noun
korse	Noun
arayüzlerden	Noun
türünden	Noun
silindirlerde	Noun
kazanır	Verb
ayrılmıyorsun	Verb
paylaştım	Verb
ortasının	Noun
dağıtımdan	Noun
papirüs	Noun
koymazlar	Verb
isteriz	Verb
işlemelerimizden	Noun
yakasında	Noun
karnesi	Noun
oyunculara	Noun
yalnızlıktan	Noun
panendeistmişsin	Noun
konumdan	Noun
puana	Noun
fırtınasını	Noun
kapasiteye	Noun
interfaz	Noun
baharlarda	Noun
kaçaklar	Noun
entrikalardan	Noun
altım	Noun
rakete	Noun
güldü	Verb
kehribardan	Noun
kovdurdular	Verb
kandiller	Noun
röntgen	Noun
arınırım	Verb
kolamda	Noun
binecek	Verb
sorularıma	Noun
çözeltilerde	Noun
yarışta	Noun
dişler	Noun
taşımazlar	Verb
kalırız	Verb
takıydı	Noun
jaguarların	Noun
cepheyi	Noun
içermiyor	Verb
hukukları	Noun
sorumluluğunuzun	Noun
yarımadadan	Noun
sekreterin	Noun
sevmedi	Verb
filmlerim	Noun
nedenlerimi	Noun
çalışmamın	Noun
aşklarımın	Noun
mıknatıstan	Noun
monologlarımıza	Noun
götürüyorlar	Verb
külfet	Noun
battaniyelere	Noun
kağıtlarda	Noun
beyitlerinizi	Noun
ipek	Noun
övdük	Verb
teşhisime	Noun
sesçiliğe	Noun
ilişkiler	Noun
çarşınızı	Noun
başvurumu	Noun
hadislerin	Noun
fotoğrafımız	Noun
sayfasının	Noun
korktuk	Verb
dikkatiniz	Noun
sınıfa	Noun
velet	Noun
söyleşiden	Noun
kemere	Noun
yarışmasına	Noun
sorumsuzluk	Noun
kurbağalardan	Noun
olcalardan	Noun
kasetten	Noun
körfezlere	Noun
keşkek	Noun
bıyığınıza	Noun
frenler	Noun
kalkmayacak	Verb
uyarıyordum	Verb
dudaktan	Noun
yaratmaz	Verb
lezyon	Noun
düşersiniz	Verb
sınıf	Noun
harçlıklarda	Noun
tatili	Noun
kürkemi	Noun
vazoya	Noun
lazerler	Noun
sürücülere	Noun
bıkıyordu	Verb
cibinliğinizi	Noun
hardalı	Noun
umutluymuşum	Adjective
baymış	Noun
taraflarda	Noun
gökdeleni	Noun
maymunlardan	Noun
ün	Noun
süzgeçler	Noun
üzülecek	Verb
bölüyor	Verb
oyuncudan	Noun
birleştirirler	Verb
kiste	Noun
doğa	Noun
tuşları	Noun
turşumda	Noun
homurdanmanızdan	Noun
ısırdı	Verb
hindiydin	Noun
girdiniz	Verb
minberlerimize	Noun
almadılar	Verb
oynarız	Verb
ayarlanmam	Verb
aygıt	Noun
artacak	Verb
parıltılara	Noun
geliriz	Verb
büyücülerdin	Noun
kanalda	Noun
ettirecek	Verb
kuram	Noun
dünyanın	Noun
göstermiyorum	Verb
perde	Noun
tutuşturuyordun	Verb
istemedik	Verb
iftitahlarımızı	Noun
kümbetler	Noun
bağımlılıklarım	Noun
ölçmez	Verb
satmaz	Verb
listemiz	Noun
ipeğinizi	Noun
odaktan	Noun
pipetiniz	Noun
hikayede	Noun
örüntü	Noun
tarabama	Noun
gübresi	Noun
patlıcanın	Noun
rahibiniz	Noun
sürtüğümüz	Noun
katkının	Noun
fillerden	Noun
değişikliklere	Noun
videosunda	Noun
yaptın	Verb
davranır	Verb
baharda	Noun
tipografi	Noun
balıkçısı	Noun
içeriyorlar	Verb
aşar	Verb
milyarderlerimi	Noun
yazıta	Noun
hastalanıyor	Verb
tepkimeyi	Noun
rimel	Noun
dizesi	Noun
bakmasını	Noun
kapakçıkları	Noun
prototipten	Noun
görüyorsunuz	Verb
isyandan	Noun
çaldı	Verb
topluluğumuza	Noun
akında	Noun
noktürn	Noun
lahanamın	Noun
tariflerden	Noun
ayrana	Noun
hareketlilikte	Noun
derlemelere	Noun
gagadan	Noun
verisi	Noun
öykülerde	Noun
bekliyordu	Verb
çaplarsın	Noun
kumaşta	Noun
depresyonu	Noun
televizyonlar	Noun
sosyolojilere	Noun
inanmazlar	Verb
uyarısından	Noun
seçmeden	Noun
beldesini	Noun
yayımcılık	Noun
acemiymiş	Noun
sosluklardan	Noun
yapıştı	Verb
şehvetlerim	Noun
gerzeklerimden	Noun
koydun	Verb
avcısı	Noun
vajinaları	Noun
getiriyorsunuz	Verb
şövalyeyi	Noun
şatomuz	Noun
giydi	Verb
sözlükten	Noun
sağlayıcısının	Noun
ellemem	Verb
mümessilimin	Noun
kıskanır	Verb
kaçamaklarda	Noun
sınıfta	Noun
ümitsizmişiz	Adjective
sütyen	Noun
platformlara	Noun
geçmez	Verb
ümitli	Adjective
bahçelere	Noun
cadı	Noun
bombamıza	Noun
bağımsızlığın	Noun
hükûmetleriz	Noun
bölgelerde	Noun
açıyorlardı	Verb
kelimeyi	Noun
kek	Noun
mıknatıs	Noun
beldesi	Noun
okiyasından	Noun
böcekbilimlerde	Noun
lokanta	Noun
savundular	Verb
bamyana	Noun
kopar	Verb
övgünüze	Noun
boğaya	Noun
surelerden	Noun
hatalarımızı	Noun
ulamlarmışım	Noun
temsilciliğimiz	Noun
öpmüyordu	Verb
dersimiz	Noun
şuruplar	Noun
görmüyorsunuz	Verb
oturuyorsun	Verb
yıktılar	Verb
ağlarsın	Verb
kutsallığa	Noun
tıkmıyorum	Verb
yankılar	Noun
ikazda	Noun
devden	Noun
üyeydi	Noun
yorgunlar	Adjective
bilgiler	Noun
totemlerimi	Noun
listenizi	Noun
düğünler	Noun
arzusunda	Noun
kayda	Noun
şehirlerde	Noun
öldüreceğim	Verb
nüfusu	Noun
pipetleriniz	Noun
şaşırdı	Verb
adsızmış	Adjective
bilgisinin	Noun
yuvasın	Noun
gelişmedi	Verb
depolara	Noun
depresyonlarda	Noun
bulundunuz	Verb
katılmazlar	Verb
fabrikalardan	Noun
işlemcilerde	Noun
sacı	Noun
tabansızlarımızdan	Noun
görüntüden	Noun
uzanacaklar	Verb
büyüyor	Verb
karısından	Noun
kehribarımda	Noun
güveniyordu	Verb
işlediler	Verb
migren	Noun
radyoda	Noun
tarihçiye	Noun
kuzularıma	Noun
halılar	Noun
yıkamazsın	Verb
dolmuştu	Noun
oylarınızdan	Noun
cücelersin	Noun
savaşlar	Noun
kelimesini	Noun
veride	Noun
nefretimiz	Noun
akımın	Noun
kahveye	Noun
ibnelerimden	Noun
hastasında	Noun
askerler	Noun
taşmıyordu	Verb
kuşkonmazınız	Noun
dizisinden	Noun
göle	Noun
inmeyiz	Verb
ağladı	Verb
elmalar	Noun
bükülme	Noun
öldürmediler	Verb
yazdınız	Verb
sakinleriniz	Noun
boşanırız	Verb
videoda	Noun
bahtsızsın	Adjective
etkilerden	Noun
çöpün	Noun
türü	Noun
integrallerden	Noun
gecem	Noun
paylaşırım	Verb
görüşte	Noun
omletlere	Noun
alacakaranlığı	Noun
vaktimin	Noun
tekrarlardan	Noun
korkutacak	Verb
türümden	Noun
idarem	Noun
sepetten	Noun
çağırdım	Verb
izleyecek	Verb
eksiklikten	Noun
bitmez	Verb
çalışacağız	Verb
balalayka	Noun
fakülte	Noun
köylüm	Noun
duvarlarınızı	Noun
yelkendin	Noun
platformlarda	Noun
kıyısının	Noun
gösterisinde	Noun
kinematik	Noun
dönmez	Verb
iftitahlarımızdan	Noun
bencillik	Noun
kartlarımın	Noun
alırsın	Verb
sunuyordu	Verb
öğretmenden	Noun
okullar	Noun
temsilden	Noun
ısıda	Noun
aşklarım	Noun
gemini	Noun
ortamlarda	Noun
ilâç	Noun
yapışır	Verb
akiferden	Noun
üzülüyorum	Verb
otobüste	Noun
beldeler	Noun
fırtınayı	Noun
geçiyorum	Verb
deneylere	Noun
gökdelenin	Noun
getirdik	Verb
kaçıyor	Verb
yetkiniz	Noun
birleşiyorlardı	Verb
kullanıcısından	Noun
otomobildi	Noun
kitapçıkların	Noun
yanıtım	Noun
ekinoksların	Noun
ayakkabıcılarsın	Noun
yasalarda	Noun
similyam	Noun
baktık	Verb
motorin	Noun
nedimelerdiniz	Noun
yalvarır	Verb
sınır	Noun
bileziğime	Noun
çöller	Noun
sanatlarımıza	Noun
eğitimim	Noun
keşfetti	Verb
bulutun	Noun
yörelerde	Noun
kasmayacaksın	Verb
çığlığımızı	Noun
homoseksüelimi	Noun
karakolda	Noun
ölümlülüğü	Noun
tanıyorum	Verb
yasam	Noun
heceden	Noun
derdik	Verb
fabrikaya	Noun
dansçılar	Noun
selamlar	Noun
plaklarda	Noun
andık	Verb
ekiz	Noun
kasetimde	Noun
öpüştüler	Verb
cevaplarımdan	Noun
yeter	Verb
dövüştüler	Verb
arayüzde	Noun
acılardan	Noun
şövalyelere	Noun
kalelerden	Noun
uzunluklarda	Noun
sacların	Noun
Müslümana	Noun
çiftlere	Noun
kuruştan	Noun
yazmayacak	Verb
yüzmeden	Noun
adımdan	Noun
leylekten	Noun
denilmiyorum	Verb
yerimi	Noun
yağıyorduk	Verb
reaktörler	Noun
sararmazsın	Verb
birleştirdi	Verb
hecelerimizin	Noun
bitirmedi	Verb
iletilere	Noun
supap	Noun
uzayımızdan	Noun
kurum	Noun
geriniz	Noun
tutulmayı	Noun
avcılardır	Noun
öneriler	Noun
öldürmez	Verb
kardeşliklere	Noun
yolumda	Noun
tasarımlara	Noun
geleceğim	Verb
şaşırmam	Verb
bekliyordum	Verb
dişlisine	Noun
çıkarıyordu	Verb
işlemcide	Noun
sonuçtan	Noun
duyulara	Noun
yazarda	Noun
sarılırım	Verb
lokmalarımızın	Noun
klavyeye	Noun
hazineyi	Noun
parça	Noun
parçalara	Noun
rakımda	Noun
bastırmaya	Noun
zulüm	Noun
savaşıyorlardı	Verb
paşamdan	Noun
çıkmalar	Noun
derleyiciye	Noun
gerisini	Noun
mikrofonun	Noun
maydanoz	Noun
neşriyat	Noun
ofislere	Noun
bozacaklar	Verb
onamıyorum	Verb
bilyeyi	Noun
güvenim	Noun
şikayette	Noun
yaralanmaya	Noun
fizikçimiz	Noun
seçenekleri	Noun
kaslarda	Noun
dağılmasının	Noun
siyasetçiler	Noun
konduk	Verb
üniversiteyi	Noun
aşirete	Noun
taradılar	Verb
yoğurda	Noun
çama	Noun
yerde	Noun
ömre	Noun
otomobillerde	Noun
öksürüklerinize	Noun
unlardan	Noun
düşüyorum	Verb
seçmiyoruz	Verb
verilmiyordu	Verb
lolipopumuzda	Noun
kalpler	Noun
geçmişimize	Noun
derneğe	Noun
biçimden	Noun
tükendim	Verb
kitapçıklarda	Noun
savaşıyoruz	Verb
burna	Noun
dikişinizin	Noun
eksenlere	Noun
termometresini	Noun
benzemiyor	Verb
çağırır	Verb
motel	Noun
görüşümüze	Noun
çılgın	Noun
yetmezliklerdir	Noun
krallıklar	Noun
oluyorlar	Verb
katillerden	Noun
katlarda	Noun
mezrasını	Noun
yağa	Noun
giysilerinizi	Noun
freninize	Noun
müellifimize	Noun
dürtmüyordun	Verb
ablasına	Noun
oyuncuya	Noun
şamisenlerimize	Noun
günümde	Noun
kararlara	Noun
tümör	Noun
ilaçlar	Noun
cinsiyeti	Noun
bakmanızda	Noun
itiliyor	Verb
kataloglar	Noun
kümelerde	Noun
duyarım	Verb
dindarlık	Noun
kapağa	Noun
önyargılara	Noun
şemsiyeymişim	Noun
rüzgâr	Noun
imambayıldı	Noun
aktifler	Adjective
ilköğretimde	Noun
ejderhadan	Noun
pencereler	Noun
müsaadesi	Noun
tatillere	Noun
öğrencisinin	Noun
çavuşlarımıza	Noun
dönemimde	Noun
programlatmazlar	Verb
mesafeler	Noun
şurubu	Noun
direklerime	Noun
derlemesini	Noun
yorumlarımızı	Noun
sunuculardan	Noun
bilirsiniz	Verb
ulustan	Noun
meleklerden	Noun
fakültelerden	Noun
stantlarınıza	Noun
yorumdan	Noun
uçmuyorum	Verb
alındırtıyorsunuz	Verb
mıknatıslara	Noun
minareye	Noun
solucanlardan	Noun
kaşa	Noun
yolcusunu	Noun
sevgiliye	Noun
istatistiklerin	Noun
kapmıyordum	Verb
nihayet	Noun
rakam	Noun
fiziğe	Noun
müzikallere	Noun
vasiyetleri	Noun
şampiyonluğum	Noun
öldürürsün	Verb
ikazınızın	Noun
fakirleştireceğim	Verb
hastanelere	Noun
erdemli	Adjective
ömrümü	Noun
âşıktılar	Noun
karakterlerdir	Noun
elmaslardır	Noun
kruvasanlarımda	Noun
boyadınız	Verb
mevzusu	Noun
irkeneksiniz	Noun
hocalardan	Noun
pişmiyorsunuz	Verb
frekansdan	Noun
helvası	Noun
gerekmeyecek	Verb
pencerelere	Noun
dövdüler	Verb
ilkesinin	Noun
yardımcısı	Noun
hazırlıklardan	Noun
mevkini	Noun
gökdelen	Noun
sisler	Noun
tesadüflere	Noun
kıskandım	Verb
seyahatlerde	Noun
okulumuz	Noun
anarşiyi	Noun
Müslümanlardan	Noun
babaanne	Noun
izleyeceğim	Verb
sözlüklerden	Noun
kızgındı	Adjective
taht	Noun
homonimimizi	Noun
çıta	Noun
madalyanın	Noun
dalgalandı	Verb
parmağa	Noun
serecek	Verb
adlardan	Noun
kalbimizde	Noun
sezona	Noun
nefrete	Noun
anlatıyor	Verb
klavyesine	Noun
taksimi	Noun
göğsünüzden	Noun
kılavuzlarmışım	Noun
prezervatiflerimizi	Noun
kipanızı	Noun
bitirdi	Verb
kaybolmuyor	Verb
örs	Noun
sanatçıları	Noun
kalem	Noun
aldılar	Verb
güçlük	Noun
tütüncüydüler	Noun
bilemiyordum	Verb
cacık	Noun
mıhlarım	Noun
bilinemezciliklerin	Noun
karanlıklar	Noun
konacak	Verb
bitmeye	Noun
dizim	Noun
deriyi	Noun
arzusundan	Noun
kümeslerimizi	Noun
koyuma	Noun
engizisyonlardan	Noun
avukatlara	Noun
sınırlarımızı	Noun
tanımıyordum	Verb
sitenizi	Noun
eşyam	Noun
karlarınız	Noun
belirteç	Noun
doğru	Adjective
sancağı	Noun
bölgelere	Noun
alınlarımıza	Noun
derlemeyi	Noun
kolyesi	Noun
kekin	Noun
bireylerin	Noun
acemisi	Noun
oynuyorsun	Verb
çökertine	Noun
leşmişiz	Noun
alacağım	Verb
uzunluktan	Noun
müzisyenim	Noun
tacizde	Noun
aşklarımızın	Noun
kalfamızda	Noun
kafataslarına	Noun
çaplardınız	Noun
radardan	Noun
mezuniyete	Noun
galaksiye	Noun
sanıyorum	Verb
hazırlıklar	Noun
döker	Verb
şarkıcısından	Noun
uzaklarda	Noun
hocalara	Noun
lezzette	Noun
jenerasyonlar	Noun
koleksiyonlara	Noun
bacağın	Noun
verilirler	Verb
balamozlarınızdan	Noun
çalıyorum	Verb
sandalyeden	Noun
ongun	Noun
yürekten	Noun
yarışmasını	Noun
yapıyordu	Verb
bitiririm	Verb
savunuyordu	Verb
hıza	Noun
akifere	Noun
kokar	Verb
uyduya	Noun
patlamanın	Noun
dizelere	Noun
aşçıma	Noun
maktamızı	Noun
dondurmasını	Noun
kursiyerlere	Noun
genelev	Noun
totemimizden	Noun
sürücüymüşler	Noun
moteller	Noun
palmiyelerden	Noun
vikipedistimin	Noun
pandanın	Noun
değiştiririz	Verb
gaflar	Noun
kürken	Noun
sepetlerde	Noun
soyar	Verb
çalışma	Noun
uçar	Verb
üyeliğiniz	Noun
dinamite	Noun
derisi	Noun
yandık	Verb
kervansaray	Noun
ayakkabıcılarınızda	Noun
ölmedim	Verb
suallerimi	Noun
tatta	Noun
balkanlardan	Noun
delilerimi	Noun
durmaz	Verb
yarmıyordum	Verb
değişmez	Verb
taslakta	Noun
seçilmem	Verb
katıldım	Verb
raporlar	Noun
yerleşti	Verb
iğneyi	Noun
işletmelerden	Noun
belediyesinden	Noun
hayvanda	Noun
güler	Verb
veledi	Noun
animasyonlara	Noun
çalışmalarımda	Noun
gelinlere	Noun
binmiyorsun	Verb
güderler	Verb
mağaralarımızı	Noun
yetiştiriyorlar	Verb
manada	Noun
sahnelerinizden	Noun
çağırmaz	Verb
gökadaları	Noun
eğmedi	Verb
zahmeti	Noun
protestoyu	Noun
parada	Noun
imrenirler	Verb
filmler	Noun
bağırsak	Noun
karıştırıyor	Verb
adamlarım	Noun
nöronlar	Noun
ilettim	Verb
edebiyatımızda	Noun
notların	Noun
memleketten	Noun
değiştirmeyecek	Verb
parçasında	Noun
siğillerinizden	Noun
çalışmalarınıza	Noun
pişirirler	Verb
inmedi	Verb
tırtıldan	Noun
gözlemden	Noun
verimsizleştirirler	Verb
nüfuslara	Noun
ücretsizliğimize	Noun
insanımsımın	Noun
heyecanlandırıyor	Verb
kararımız	Noun
örneğe	Noun
eğitti	Verb
fonksiyonumuz	Noun
tekrarlara	Noun
hücresinden	Noun
çıkarız	Verb
hücresini	Noun
öçten	Noun
yapmadı	Verb
dağılma	Noun
çorbasını	Noun
bakmasının	Noun
yermediniz	Verb
irdeliyor	Verb
sağlarız	Noun
düğünlerimiz	Noun
durmuyorlar	Verb
sorularınızı	Noun
yuvasını	Noun
hedefte	Noun
işletmesinin	Noun
üyelerde	Noun
köpekten	Noun
marangozdu	Noun
ovar	Verb
istatistik	Noun
eşyayı	Noun
abartmazsınız	Verb
yaralara	Noun
patronlara	Noun
tanımazsın	Verb
elifbeler	Noun
sekreterden	Noun
kasaplar	Noun
binekmişsiniz	Noun
metrdotelinizi	Noun
yazdım	Verb
kaynaştırılmadım	Verb
memlekette	Noun
minaresinden	Noun
madenlerden	Noun
haritası	Noun
otizm	Noun
iletiyoruz	Verb
iblisler	Noun
demedi	Verb
denizyıldızının	Noun
satılırlar	Verb
ilklendirdiniz	Verb
nedenden	Noun
sistemlere	Noun
alından	Noun
çevrenin	Noun
bacasını	Noun
güvendi	Verb
animasyon	Noun
enflasyonu	Noun
vermeyiz	Verb
altınlarımızın	Noun
mistiklerimden	Noun
vajinada	Noun
bacanak	Noun
mandalinalardık	Noun
saldırır	Verb
giriyorlar	Verb
ayrılmadan	Noun
yazıyı	Noun
bürokraside	Noun
sıkıntıdan	Noun
sandviç	Noun
tanelerden	Noun
kemerleri	Noun
öğrenciydi	Noun
depresyondan	Noun
ceplerinizden	Noun
erecek	Verb
noktası	Noun
röportajda	Noun
kalacağım	Verb
ayıda	Noun
patlamada	Noun
minaresinde	Noun
mezuniyetlerden	Noun
kullanmamızın	Noun
bilmiyorsunuz	Verb
öbeklere	Noun
dağıldık	Verb
denizatına	Noun
saçar	Verb
evliliklerde	Noun
malda	Noun
işlemeyi	Noun
zebra	Noun
görüntülere	Noun
rüyasının	Noun
büyücüyü	Noun
dinletilerinize	Noun
dinleti	Noun
balinasınız	Noun
yeleğimi	Noun
deveyi	Noun
etkiliyorum	Verb
ailelerde	Noun
seyahatte	Noun
işkencecilere	Noun
sayfalarmışsınız	Noun
sürücüsünde	Noun
hamızımızın	Noun
gerisinin	Noun
kağıt	Noun
kokuyorum	Verb
konularda	Noun
kardeşliğe	Noun
emlakçısında	Noun
cezeriyemizde	Noun
basımdan	Noun
porsuklarımda	Noun
dilberimiz	Noun
yollardan	Noun
umuyorlardı	Verb
yamuk	Noun
robottan	Noun
yağda	Noun
dizelerden	Noun
fotoğrafçıydı	Noun
batısına	Noun
çıraklardın	Noun
düğüne	Noun
mesafeyi	Noun
susmam	Verb
davranmıyorsun	Verb
kese	Noun
piramide	Noun
kullanıldı	Verb
gelmedin	Verb
topçularınızdan	Noun
geçecekler	Verb
nura	Noun
seccadem	Noun
yoğurtçusuna	Noun
başvurular	Noun
kurallarımızı	Noun
etkiliyordu	Verb
bülbülyuvası	Noun
koydan	Noun
samurayı	Noun
teoremde	Noun
basımda	Noun
seçeneğin	Noun
koyacağım	Verb
sınavdan	Noun
yaratmadım	Verb
camilere	Noun
dayamıyordun	Verb
bağcığımda	Noun
yönelimlerin	Noun
gölgeler	Noun
tayfaya	Noun
cibiliyetimde	Noun
durumumdan	Noun
şüphede	Noun
gölü	Noun
röpörtajlar	Noun
ürünlerimiz	Noun
güzelliklerden	Noun
kullanmanı	Noun
aşiretimizde	Noun
ibneymişiz	Noun
elemente	Noun
dışkısından	Noun
inanıyorlardı	Verb
yağmayacağım	Verb
kurulumuza	Noun
şahmerdanlardan	Noun
getirir	Verb
mağarasını	Noun
hikayelerde	Noun
titreyeceğiz	Verb
balinasının	Noun
katılmayacak	Verb
kafataslarından	Noun
odaya	Noun
açtı	Verb
sildik	Verb
seslendiler	Verb
alkol	Noun
topolojisine	Noun
şizofreninin	Noun
günahkâr	Noun
kapasitelerimizin	Noun
şüpheleriz	Noun
rehberlere	Noun
tatil	Noun
istemiyoruz	Verb
koyarım	Verb
fakültemiz	Noun
kiliseme	Noun
ilginç	Adjective
helvan	Noun
şüpheymişler	Noun
dalgasının	Noun
yüzeyime	Noun
uyarılardan	Noun
sayfalandırmanızı	Noun
hayvanların	Noun
düşmanlarımda	Noun
koltuklar	Noun
omurgasını	Noun
yapıyorlardı	Verb
kavağımızda	Noun
paşası	Noun
entrikasının	Noun
şişiyor	Verb
tecrübesinde	Noun
garbımızı	Noun
gölgeyi	Noun
uyaracak	Verb
kararıma	Noun
çarşı	Noun
kolonda	Noun
olaya	Noun
doğayı	Noun
aşiretten	Noun
jaluzime	Noun
papatyam	Noun
kaydedicisini	Noun
borçlarda	Noun
duanın	Noun
eziyetçiydi	Noun
büktürtülmezsin	Verb
tümceye	Noun
intiharlar	Noun
daldılar	Verb
çarpılardan	Noun
alında	Noun
sevmedim	Verb
öğrencisinden	Noun
ayçiçeğinin	Noun
oturmaz	Verb
verdiler	Verb
yarıştan	Noun
azdı	Verb
giriyorlardı	Verb
bozar	Verb
derste	Noun
kipa	Noun
golüm	Noun
albatrosunuzun	Noun
göstermedim	Verb
gömlekten	Noun
okiyamız	Noun
pöhrenklerdin	Noun
odacık	Noun
aygırmışsınız	Noun
belirtmeleri	Noun
tercümeye	Noun
kuyumcuyu	Noun
sözcüsüne	Noun
çiftliğe	Noun
bölgelerdir	Noun
meleklerimin	Noun
kazakların	Noun
önerilerinize	Noun
kaygılara	Noun
kadınlıkta	Noun
tükenecek	Verb
vardı	Verb
gelmesinde	Noun
giyeceğim	Verb
sarımsaklarıma	Noun
ecemi	Noun
tatilin	Noun
beller	Noun
inmiyordun	Verb
çizgilerden	Noun
Musevilere	Noun
savaşıyorlar	Verb
ülkelere	Noun
muson	Noun
yıpratmayız	Verb
fırçasından	Noun
çiftlerden	Noun
erik	Noun
eşyası	Noun
çarpıyordu	Verb
kaynıyorlar	Verb
bulutta	Noun
çalgılardan	Noun
paylaşım	Noun
menüde	Noun
ezer	Verb
başarıyorlar	Verb
önünüze	Noun
hastalıklardan	Noun
konferans	Noun
örste	Noun
işlemeden	Noun
enjeksiyonlarımızda	Noun
topçuyum	Noun
harçlık	Noun
mutluluğa	Noun
kırmıyordunuz	Verb
kılavuzda	Noun
oylarınız	Noun
işletmesinden	Noun
susuzluktan	Noun
onurlarınız	Noun
getiriyorlar	Verb
günde	Noun
soyluyu	Noun
yönelimlere	Noun
karideslerinizi	Noun
karidesler	Noun
çorbasında	Noun
çıkıyorsunuz	Verb
ürer	Verb
reaktörlerden	Noun
enflasyona	Noun
sisteminizi	Noun
rüyaya	Noun
sitesini	Noun
boğa	Noun
göçe	Noun
sivrisineğiniz	Noun
piknikler	Noun
kahramanlarımızın	Noun
metresimizi	Noun
uydularmışım	Noun
sanıyorlardı	Verb
kokusunu	Noun
üreticilerden	Noun
papyon	Noun
kibiri	Noun
duraklarda	Noun
mekikten	Noun
kulaca	Noun
pamuktan	Noun
yuvasında	Noun
acıktırtmayacaksın	Verb
evlat	Noun
basketbolcularımda	Noun
aramıyor	Verb
saydırıyorsunuz	Verb
söker	Verb
bakirmiş	Noun
anlatmayız	Verb
kastın	Verb
öpmeyecek	Verb
uluslara	Noun
lisanımızın	Noun
pozitronu	Noun
öğretiyordu	Verb
ölümsüzleştirmem	Verb
boşalacak	Verb
göller	Noun
yapmayacak	Verb
lezzete	Noun
ayakkabıya	Noun
sandalyeye	Noun
sonucuz	Noun
kristaller	Noun
bok	Noun
kurabiyeler	Noun
kaçacak	Verb
leylekleriniz	Noun
devinizden	Noun
kaşır	Verb
piskoposlara	Noun
gösterdi	Verb
ceylanlarınızda	Noun
tadımı	Noun
geçmenizi	Noun
halıdan	Noun
dövmeyi	Noun
süründürmezler	Verb
cepler	Noun
kristallerde	Noun
zigguratlar	Noun
işkencesi	Noun
kararlarınızı	Noun
faresini	Noun
sinagoglara	Noun
teşhiste	Noun
dünyalar	Noun
uğratacağım	Verb
yakındı	Noun
solunumunuza	Noun
savaşçısından	Noun
sezdi	Verb
duymasından	Noun
başvurusu	Noun
oluyorum	Verb
başarırlar	Verb
kalplerimizi	Noun
geciktirtmeyecekler	Verb
fortlamıyordunuz	Verb
hücreyi	Noun
bileşiğimizin	Noun
armağanlar	Noun
sayımdan	Noun
sitesi	Noun
klavyesini	Noun
şehre	Noun
cadıların	Noun
görüntüsünü	Noun
tanırım	Verb
şarkıcımızda	Noun
sevişmiyordunuz	Verb
gökdelenleri	Noun
konuma	Noun
sakız	Noun
bel	Noun
başvurumun	Noun
çokgen	Noun
saban	Noun
sandalyeyi	Noun
efem	Noun
düşüyorlardı	Verb
görüyordu	Verb
sosyolog	Noun
makaraya	Noun
sandın	Verb
inlerim	Noun
kümbet	Noun
çiftlikten	Noun
istemezler	Verb
itlerdiniz	Noun
konuyu	Noun
kılıflar	Noun
prensiplerde	Noun
palmiyeler	Noun
feribotunuzun	Noun
ağır	Adjective
romanlardır	Noun
âmâlarsın	Noun
beyittik	Noun
günahlardan	Noun
kalesinden	Noun
Vikipedilerin	Noun
tiyatrodan	Noun
yufkadan	Noun
sinirlendirdi	Verb
tutkuyu	Noun
matlamız	Noun
evrenden	Noun
ailelerden	Noun
isimsiz	Adjective
garaja	Noun
biçimimiz	Noun
kimliğimizi	Noun
hatırda	Noun
kapısında	Noun
mumluklarınız	Noun
simit	Noun
kavramdan	Noun
dizesinin	Noun
mikroorganizmaymışsın	Noun
şuura	Noun
acılara	Noun
düğünlere	Noun
kurtardı	Verb
ayçiçekleri	Noun
çirkinliği	Noun
kaşe	Noun
eklerinizden	Noun
sahneye	Noun
sözcüsünün	Noun
bataryaya	Noun
beldemiz	Noun
depresif	Adjective
kullanıcılardan	Noun
çevirdi	Verb
bitkisi	Noun
kartallar	Noun
istemiyordum	Verb
çekmeceye	Noun
genelevlerde	Noun
aldım	Verb
göbekte	Noun
hareketlilikten	Noun
ilişkisinde	Noun
yakınlarımıza	Noun
unuturlar	Verb
solmaz	Verb
yaptırttı	Verb
gruplarım	Noun
nur	Noun
ağıt	Noun
ayında	Noun
gelişmediler	Verb
kalıba	Noun
tutuşturur	Verb
kozana	Noun
raketleri	Noun
anmayacağım	Verb
belleğe	Noun
atılıyor	Verb
gecikiyorsun	Verb
vezirlerinizde	Noun
magmada	Noun
ineklere	Noun
bilgimizi	Noun
katılmaz	Verb
yetkimize	Noun
vedalarmışız	Noun
kazandan	Noun
enjeksiyonlar	Noun
gecesinde	Noun
his	Noun
tanıdık	Verb
kazanırım	Verb
temizlemediler	Verb
eğriler	Noun
gerer	Verb
mikroişlemcim	Noun
yaralanmasına	Noun
ikilem	Noun
girmediler	Verb
cümleye	Noun
üretmiyorsunuz	Verb
gecelik	Noun
sunuyor	Verb
dizini	Noun
galaksiden	Noun
ölümsüzleştirdim	Verb
leylek	Noun
uçaklarımızda	Noun
şamdanlarımı	Noun
parçalanmasını	Noun
sarmaşık	Noun
açılmazlar	Verb
rotor	Noun
tenisçilere	Noun
antropolojiyi	Noun
fikirlere	Noun
sayıma	Noun
ödevleri	Noun
siteyi	Noun
cenazesini	Noun
girmeyecek	Verb
boyun	Noun
kardeşlerden	Noun
yayar	Verb
kahramanımızı	Noun
travmaya	Noun
oluyorlardı	Verb
göçmüş	Noun
metrdotelleriniz	Noun
tulumunuzun	Noun
bakmıyorum	Verb
diyordu	Verb
takılarınız	Noun
anlatmadım	Verb
süsmeyiz	Verb
bulamıyorlar	Verb
kolikalar	Noun
paralar	Noun
duya	Noun
gitmesine	Noun
seviyorsunuz	Verb
batın	Noun
yapılıyor	Verb
yarışmasından	Noun
davranışlar	Noun
asitlerimizde	Noun
aşımın	Noun
teoreme	Noun
çürümüyordu	Verb
eğlencelerde	Noun
sanıyordum	Verb
kodlara	Noun
kilise	Noun
ayakkabısı	Noun
uydusunda	Noun
maaş	Noun
rüzgârlarınıza	Noun
notiluslarımda	Noun
gösterisine	Noun
karaciğerde	Noun
koyar	Verb
birleştik	Verb
süngerlerime	Noun
kalpte	Noun
böcekbilimlerden	Noun
lolipoplarım	Noun
gübresinin	Noun
milimetreye	Noun
psikiyatrlar	Noun
karakol	Noun
büyükelçi	Noun
oluyoruz	Verb
düşüyoruz	Verb
ettirmez	Verb
ceviz	Noun
alabalıkların	Noun
boğaz	Noun
porsuk	Noun
paylaştılar	Verb
kurumlardan	Noun
dizelerde	Noun
satarlar	Verb
yengeç	Noun
koyacak	Verb
lokmamda	Noun
kullanıcısına	Noun
utandırmayacaklar	Verb
çarparlar	Verb
teşkilat	Noun
geçmeniz	Noun
derleyiciler	Noun
gözlemlerin	Noun
verimin	Noun
kolaylıktan	Noun
uyuşturucularımın	Noun
laboratuvarlardan	Noun
algoritmalardan	Noun
bölgesinden	Noun
fakültesini	Noun
disko	Noun
bildirdiler	Verb
öldün	Verb
bozmayacak	Verb
durduk	Verb
istemediler	Verb
oltalarda	Noun
halk	Noun
adıma	Noun
mandalsın	Noun
dükkânlarınızdan	Noun
ünlülerin	Noun
özeldi	Adjective
bulunuyorlardı	Verb
yumurtalıklarda	Noun
jokeylerinizden	Noun
termometremden	Noun
sürgünden	Noun
mevkisinde	Noun
bükülüyorsun	Verb
ergenlikte	Noun
trenlerde	Noun
pöhrenksiniz	Noun
derneğimiz	Noun
mısrasından	Noun
sıralamayı	Noun
tarçının	Noun
homurdanmanda	Noun
vakit	Noun
istersin	Verb
lunaparklarmışsınız	Noun
çeyrekte	Noun
dergisine	Noun
mantıkta	Noun
gösterdim	Verb
bilemiyorum	Verb
banliyöye	Noun
bayda	Noun
yapımcılardan	Noun
denizyıldızında	Noun
oğlumun	Noun
araçlara	Noun
eğlencelerden	Noun
kocayı	Noun
çıkıyordu	Verb
başarıyordu	Verb
lehçesi	Noun
bankalara	Noun
basketbolcusu	Noun
ayinlerin	Noun
açılmıyordunuz	Verb
oğlumuz	Noun
sorularda	Noun
kâğıt	Noun
savaşçıydı	Noun
varmaz	Verb
çıraklardınız	Noun
cümlelerimi	Noun
vapurdan	Noun
dikkat	Noun
uyardılar	Verb
dağılıyor	Verb
teknolojilerde	Noun
isimde	Noun
tasarımım	Noun
sihirlisin	Adjective
uzaklarımdan	Noun
köpekleri	Noun
seccade	Noun
idadiye	Noun
kuyumcunuzdan	Noun
yetişeceğim	Verb
sitemizde	Noun
bulurlar	Verb
parçalardan	Noun
fabrikada	Noun
civara	Noun
Nusayrîler	Noun
intiharlara	Noun
etkiden	Noun
sülüğü	Noun
kesesini	Noun
parçalanmaya	Noun
okulumdan	Noun
okulda	Noun
üşüyorum	Verb
nutuklarıma	Noun
silindirlere	Noun
çamı	Noun
çizgiden	Noun
bedevilere	Noun
karakollar	Noun
cevizim	Noun
ülkelerdir	Noun
Kürtü	Noun
katkıya	Noun
inandılar	Verb
yakayı	Noun
istisnası	Noun
eylemlerin	Noun
makinesini	Noun
yağışınızdan	Noun
amiralliğe	Noun
hurin	Noun
yalvarırım	Verb
yaratıyor	Verb
buruşukluğumuzda	Noun
cücen	Noun
yorumumun	Noun
saydılar	Verb
karşıda	Noun
yıldırımdan	Noun
karaciğerden	Noun
dinamitlerimize	Noun
kirmen	Noun
unutmaz	Verb
sarılacak	Verb
fındığa	Noun
ayaklarınıza	Noun
jaguardan	Noun
albümüm	Noun
cihanda	Noun
rakamdan	Noun
ilişkilerimizi	Noun
iplerde	Noun
sınavlara	Noun
kütükten	Noun
keseden	Noun
şehirler	Noun
güzelliklere	Noun
yapıyoruz	Verb
kaynıyor	Verb
dövüşmüyorsunuz	Verb
yapılırlar	Verb
kalabalıkları	Noun
hazineye	Noun
dirimlerde	Noun
doyar	Verb
ölmem	Verb
beklediler	Verb
şairlerden	Noun
tercümelerin	Noun
aşurede	Noun
battaniye	Noun
uçaktan	Noun
yazmasının	Noun
parçacıklarınız	Noun
travması	Noun
makinelerde	Noun
asar	Verb
palmiyesi	Noun
ebediyetimiz	Noun
kırıklarda	Noun
neşemizi	Noun
kitapçık	Noun
edatlar	Noun
memleketim	Noun
öğrenmez	Verb
tuvaletlerin	Noun
verdirmedik	Verb
amcasına	Noun
bakireliğin	Noun
bilgilerime	Noun
çıkardım	Verb
tarafınıza	Noun
işledin	Verb
şairlerde	Noun
omuzlardan	Noun
mancınığımı	Noun
sınıra	Noun
manitandan	Noun
ebeyi	Noun
yağar	Verb
dağda	Noun
ekranımda	Noun
fotoğraflara	Noun
dinletilerim	Noun
ritimlerde	Noun
kapmaz	Verb
sagalarda	Noun
külahlar	Noun
omurgası	Noun
kazandınız	Verb
çekmeceler	Noun
karalama	Noun
nişanlısı	Noun
dirimimizin	Noun
süzersiniz	Verb
kataloglarımın	Noun
birleşmeler	Noun
sekmesinden	Noun
sitenize	Noun
keserler	Verb
yeterlilikte	Noun
fırçasının	Noun
eksikliklerden	Noun
futbolcumuz	Noun
iyileşmez	Verb
bayıldım	Verb
çöpler	Noun
gazetede	Noun
burunlarımızda	Noun
ninnisin	Noun
papatyası	Noun
mevsimlerin	Noun
gemine	Noun
yasadan	Noun
ısınmadı	Verb
yorumlardan	Noun
geçeceğiz	Verb
güneşin	Noun
tanıyor	Verb
voleybola	Noun
rüyada	Noun
bisküviyi	Noun
tanıttı	Verb
ofislerimiz	Noun
pezevengimi	Noun
sorundan	Noun
strüktürümü	Noun
sayfamın	Noun
içti	Verb
ovmayacağız	Verb
arınıyordun	Verb
alıçlarımızı	Noun
bilmem	Verb
laternana	Noun
foklardan	Noun
kelebeğe	Noun
bilmiyorum	Verb
kimliklerden	Noun
gruplar	Noun
kavağınıza	Noun
öğretimde	Noun
sanıyorsunuz	Verb
uzanıyor	Verb
evlatlıkları	Noun
kapaklarınızın	Noun
hamamları	Noun
tercihlerimiz	Noun
düşünüyoruz	Verb
coşkulu	Adjective
yardılar	Verb
konuklara	Noun
sosluklarımdan	Noun
verecekler	Verb
tandırda	Noun
güvenmez	Verb
nüfuz	Noun
elmayı	Noun
ergenlik	Noun
yanardağlar	Noun
koltuktan	Noun
öğrenciyim	Noun
soylulardan	Noun
kalpağımızın	Noun
sunarız	Verb
ilişkilerim	Noun
zamanımızın	Noun
gölge	Noun
kirpiklerin	Noun
yıldızda	Noun
vampiriz	Noun
yapıyorduk	Verb
kuruluma	Noun
götürmeyeceğim	Verb
hastalık	Noun
yakama	Noun
tutkudan	Noun
şikayetlerin	Noun
önerimiz	Noun
paşalardın	Noun
kuralımızı	Noun
çöker	Verb
madalyaları	Noun
kullanılmazlar	Verb
çizdiler	Verb
politikacının	Noun
silersiniz	Verb
hikâyeden	Noun
tartar	Verb
cüceyi	Noun
âlemlere	Noun
görüyorlardı	Verb
çalışmalarımın	Noun
deyim	Noun
kuyruklar	Noun
atıştırmayacaklar	Verb
üretiyordu	Verb
tatlar	Noun
liselerin	Noun
saka	Noun
denizyıldızları	Noun
pırasası	Noun
hipotalamusta	Noun
sanatlar	Noun
element	Noun
sürülür	Verb
ısısından	Noun
düşündün	Verb
memleketlerde	Noun
dedikoduya	Noun
özette	Noun
yiteceksin	Verb
nal	Noun
yüksük	Noun
köçektim	Noun
kulakçıklar	Noun
teorem	Noun
doktrinimden	Noun
glasnost	Noun
geciktirteceğim	Verb
merkezler	Noun
çıkarmıyoruz	Verb
sayfanızın	Noun
gösterimin	Noun
evlada	Noun
satranca	Noun
barışırlar	Verb
inanacak	Verb
sağduyusu	Noun
laboratuvarınızı	Noun
cücelerdir	Noun
sürtüklüklerinizde	Noun
tercümanıma	Noun
açıldılar	Verb
banklar	Noun
bataryasından	Noun
makinasından	Noun
kipleri	Noun
süperpozisyon	Noun
harflerde	Noun
mezarlığınızdan	Noun
yapacaksınız	Verb
vezirlere	Noun
çalışıyoruz	Verb
kayboldum	Verb
parabole	Noun
cibiliyetlerimizden	Noun
karşıya	Noun
hocam	Noun
karılarınızın	Noun
kameralarda	Noun
katılmadım	Verb
salar	Verb
alacaklar	Verb
becerikli	Adjective
dönecek	Verb
alabalıklar	Noun
düşes	Noun
kapadılar	Verb
kitapçıkta	Noun
yapmadım	Verb
coşkusunu	Noun
güne	Noun
bakmıyor	Verb
çalışmalardan	Noun
akışkanlar	Noun
tıklıyorum	Verb
kapamanızın	Noun
çocukluk	Noun
kalkıyordu	Verb
şüpheye	Noun
kasette	Noun
tekilayız	Noun
huninizin	Noun
öğretecek	Verb
fabrikalara	Noun
atom	Noun
salondan	Noun
küçülecek	Verb
sıfata	Noun
kutlamalara	Noun
direğe	Noun
istisnayı	Noun
avlara	Noun
kömümü	Noun
diskotekten	Noun
kağıttan	Noun
melodiyi	Noun
kırtasiyenizden	Noun
minarede	Noun
cümlesinin	Noun
yollarımızın	Noun
istiyorlardı	Verb
yolunuza	Noun
kışkırtıyorlar	Verb
tanrısını	Noun
süpürge	Noun
öpmeyiz	Verb
güvenirler	Verb
sunuyorlardı	Verb
başarılıydılar	Adjective
bacanağımızda	Noun
uzandı	Verb
masörlerdik	Noun
sakine	Noun
kulakta	Noun
korsandan	Noun
Yahudilerde	Noun
geçinmeyeceksiniz	Verb
düştü	Verb
gelmiyordu	Verb
düşer	Verb
payım	Noun
öğretmenlerden	Noun
dönüşümüzden	Noun
oturuyorlardı	Verb
tutkulardan	Noun
derilerimizde	Noun
donma	Noun
pabuç	Noun
güvercinmişim	Noun
kapamaymışlar	Noun
kesyaplarım	Noun
telefon	Noun
gökadalarda	Noun
kuyumcusu	Noun
İngilizceleştirmeyecek	Verb
deldim	Verb
gergedanların	Noun
kovboylarınız	Noun
paydan	Noun
atletikmişsiniz	Adjective
perilerimizde	Noun
tabiyetlerimin	Noun
dirim	Noun
borcumuz	Noun
olayda	Noun
çalışırım	Verb
âmâlarınızdan	Noun
tartıyordum	Verb
giderim	Noun
paskalyada	Noun
kireçten	Noun
yarışması	Noun
prototipte	Noun
çukurlarda	Noun
dağılmasından	Noun
silerler	Verb
birleşiyordu	Verb
anketlerden	Noun
yaratmadan	Noun
tekdilliliğimden	Noun
perdelerin	Noun
kardeşti	Noun
açılmıyor	Verb
kaplanlara	Noun
paralelkenar	Noun
optimizasyona	Noun
albümümü	Noun
eşyada	Noun
belediyesi	Noun
ongen	Noun
şüphelerime	Noun
artarlar	Verb
jartiyer	Noun
tepkimesine	Noun
dalgan	Noun
memleketlere	Noun
mıknatıslar	Noun
armutları	Noun
taygada	Noun
sürüyordu	Verb
durumunuzu	Noun
sargıdan	Noun
sözleşmelerden	Noun
lezyonlarda	Noun
anjiyolarımızın	Noun
müzikale	Noun
cinsiyetlerin	Noun
cephelerden	Noun
binde	Noun
telefonumuz	Noun
sitemizin	Noun
kesmiyor	Verb
ülkesine	Noun
güçlükte	Noun
eğriye	Noun
örtmez	Verb
ön	Noun
kalıplara	Noun
sıkıntının	Noun
dedikodudan	Noun
dikişler	Noun
karıştırdı	Verb
hırsızlara	Noun
deneyde	Noun
haritalar	Noun
kurula	Noun
bulunursunuz	Verb
fizikçilerimizden	Noun
radyodan	Noun
sönüyor	Verb
evleniyordum	Verb
kayıklara	Noun
öneriniz	Noun
oydan	Noun
soygazımızdan	Noun
ürktüler	Verb
dalaklarım	Noun
ahize	Noun
konseyden	Noun
kiliseyi	Noun
avokadondan	Noun
böreklerden	Noun
tanrısına	Noun
garsonlardan	Noun
melodiye	Noun
gökadalardan	Noun
sivrisinekten	Noun
üreticilere	Noun
dedim	Verb
değişkenlerde	Noun
rüyamda	Noun
işletmelere	Noun
kalabalığa	Noun
maskeden	Noun
omlete	Noun
yetkilerde	Noun
yaptınız	Verb
roketin	Noun
tanrıdan	Noun
ciniz	Noun
omurgaymış	Noun
devrimlerden	Noun
şeyden	Noun
et	Noun
cihazda	Noun
karta	Noun
kurtçuksun	Noun
kuğuyu	Noun
şikâyetimden	Noun
kuklaya	Noun
hinterlantlar	Noun
fırınlarmışız	Noun
avukattan	Noun
kalırlar	Verb
anjiyonu	Noun
oyunculuğa	Noun
düzmedik	Verb
olacak	Verb
süründürtüyordu	Verb
sıkıntılara	Noun
kulağım	Noun
odasında	Noun
değişmedi	Verb
yazmalar	Noun
patronlardan	Noun
kaçamak	Noun
kuvvete	Noun
kurallarımızın	Noun
azınlık	Noun
odasına	Noun
yastık	Noun
düşünüyorlar	Verb
tanımıyorum	Verb
bulunmazlar	Verb
istatistikte	Noun
ısırığı	Noun
çaldım	Verb
dinmiyor	Verb
bölüm	Noun
tohumlarınızın	Noun
oligarşiye	Noun
ışına	Noun
şövalyelerin	Noun
görüşten	Noun
oğullardın	Noun
sayfana	Noun
kuzgunumdan	Noun
mısralara	Noun
gelirde	Noun
sargıymışsın	Noun
görüşümüz	Noun
adaletten	Noun
polislerde	Noun
incire	Noun
kristalde	Noun
maymundan	Noun
işletmesi	Noun
düzeltirler	Verb
zulümden	Noun
kedisinin	Noun
sikileceksiniz	Verb
ölecekler	Verb
çukurda	Noun
çaydanlığı	Noun
kestirme	Noun
çirkinlik	Noun
alametlerdiniz	Noun
tanem	Noun
sunucunuza	Noun
entrikalara	Noun
müzeler	Noun
anneleri	Noun
diyorlar	Verb
konularınızdan	Noun
şüphem	Noun
ikilemden	Noun
patronlarınızın	Noun
sargıya	Noun
bitmeyecek	Verb
silindir	Noun
üçlüsünde	Noun
dizi	Noun
votkalardır	Noun
nallar	Noun
cephesine	Noun
kitabesinin	Noun
saymaz	Verb
aygıtlarda	Noun
idaresini	Noun
dokamayacaksınız	Verb
sosyolojilerden	Noun
isyanlardan	Noun
çalgıdan	Noun
milyarderimi	Noun
gülmez	Verb
belediyesinin	Noun
sapar	Verb
tekilasın	Noun
önerini	Noun
tepkimede	Noun
tanım	Noun
cebinizi	Noun
içerecek	Verb
aletmişiz	Noun
etkileri	Noun
duyması	Noun
topolojisi	Noun
kolejden	Noun
kirden	Noun
bikiniler	Noun
aşirette	Noun
yapmadılar	Verb
avcısını	Noun
tekrarlar	Noun
kaçacağım	Verb
mitokondriyi	Noun
gürgende	Noun
uymaz	Verb
kızacak	Verb
duymayacak	Verb
uyduk	Verb
camisi	Noun
iyileşmem	Verb
meyhane	Noun
çalışacak	Verb
tanımayacak	Verb
eksikliklere	Noun
üzülür	Verb
poplar	Noun
ilçeleri	Noun
helvaya	Noun
vasiyeti	Noun
öğrenirler	Verb
sonunuza	Noun
kaleme	Noun
tüylerim	Noun
yapışmanıza	Noun
salatayı	Noun
koddan	Noun
noktalardır	Noun
pelikanlara	Noun
büyükelçiye	Noun
oturmuyordu	Verb
abajur	Noun
acıdı	Verb
ıspanağımın	Noun
belediyemiz	Noun
öğrencilere	Noun
şatosundan	Noun
ayısı	Noun
şizofreni	Noun
otobüs	Noun
fenerde	Noun
paylaşmaz	Verb
seks	Noun
işer	Verb
oyumdan	Noun
koyacağız	Verb
içkilerden	Noun
kiliseler	Noun
tepkimelerinize	Noun
itten	Noun
dağıtımlara	Noun
işletme	Noun
tekliflerden	Noun
yumuyorlar	Verb
yalvarış	Noun
anjiyo	Noun
sonuçtu	Noun
yelkenlerdik	Noun
yoldan	Noun
bellerimiz	Noun
katılırız	Verb
yakınız	Noun
kirpikten	Noun
seçerler	Verb
avdın	Noun
yarımadanıza	Noun
maskesi	Noun
konuya	Noun
öncelerden	Noun
bakıcın	Noun
bataryayız	Noun
füze	Noun
minaresi	Noun
sevgililerdir	Noun
devinimler	Noun
bulmadı	Verb
yalvarırlar	Verb
mazgallar	Noun
müşterisi	Noun
dalgalandırmıyorum	Verb
taksiye	Noun
arzularınızda	Noun
sildiler	Verb
bozacak	Verb
bürokratın	Noun
perona	Noun
basar	Verb
gazeldiler	Noun
okullarımızda	Noun
ürettiler	Verb
canlanılmazsınız	Verb
tamlanan	Noun
fondöten	Noun
deler	Verb
kırılmaz	Verb
adale	Noun
tuvaleti	Noun
kahramanımızın	Noun
oyuncusunu	Noun
şapkaları	Noun
kevgirlerime	Noun
cümlesinde	Noun
düşecek	Verb
süzerler	Verb
eğildiler	Verb
silahlarınızı	Noun
balinalarda	Noun
akrabalarım	Noun
lisanlar	Noun
Zagrepliydi	Noun
övgümüzün	Noun
pusuladan	Noun
hecesi	Noun
tırtılların	Noun
büyükelçide	Noun
palyaçosundan	Noun
kanadı	Verb
kılımızda	Noun
sayfamı	Noun
uçlarda	Noun
yapmamın	Noun
kıydınız	Verb
denizyıldızı	Noun
tutkusu	Noun
acımıyorsun	Verb
cennetin	Noun
balamozlardım	Noun
parçalanmadılar	Verb
tavuklardan	Noun
karıncaya	Noun
panendeistsin	Noun
akdoğanı	Noun
şaşıyorum	Verb
yollarız	Noun
bakıyordum	Verb
ekime	Noun
gökdelenler	Noun
rüzgarları	Noun
namazdan	Noun
bardakta	Noun
körlere	Noun
çalışmalarınız	Noun
istisnalardan	Noun
yazmanıza	Noun
inanmadı	Verb
çözeltisini	Noun
noktasına	Noun
işlemesinden	Noun
krallıkta	Noun
verilmedi	Verb
enstrümanlardan	Noun
karıştırır	Verb
yamyamımda	Noun
bataryasını	Noun
tarağı	Noun
raporda	Noun
parçası	Noun
sebebimiz	Noun
kutularda	Noun
evliliklere	Noun
burunda	Noun
kısıyorsunuz	Verb
halkımızı	Noun
tavukta	Noun
ilişkisinden	Noun
peynirler	Noun
çapalarsınız	Noun
otogarımız	Noun
tabelanın	Noun
götürür	Verb
kalpağım	Noun
eğlencelere	Noun
çelikte	Noun
teklifti	Noun
coştular	Verb
ödevlerin	Noun
şelalelerimizde	Noun
doktordan	Noun
kanlılık	Noun
toptan	Noun
teknolojilerden	Noun
sanatçılardan	Noun
yönlerden	Noun
avantajların	Noun
peskütanlarımız	Noun
doğuyorum	Verb
lazerlerde	Noun
kameralarıma	Noun
derslerde	Noun
psikoterapide	Noun
kilisesinden	Noun
akdoğan	Noun
sürgünde	Noun
şelalesi	Noun
parçalanmalarınızdan	Noun
hastasına	Noun
iletkeni	Noun
topluma	Noun
özneye	Noun
mitokondride	Noun
acımız	Noun
kalemde	Noun
nedenimi	Noun
yorumunuzda	Noun
dökecek	Verb
değiştirmediler	Verb
sitemizden	Noun
okyanuslardan	Noun
başarmıyordular	Verb
kulaklara	Noun
koltuk	Noun
aygıtlar	Noun
galakside	Noun
cenazesi	Noun
parmaklar	Noun
zeytinyağının	Noun
kuzum	Noun
ninnisi	Noun
sistemimizi	Noun
enginarlarınızda	Noun
batında	Noun
çekirgeleri	Noun
haberinizden	Noun
yanak	Noun
dizine	Noun
koyda	Noun
oltamızı	Noun
serçeler	Noun
dövmesine	Noun
omuzdan	Noun
mevsim	Noun
köylüydü	Noun
uymuyor	Verb
evlenecek	Verb
mükemmeldin	Adjective
ekran	Noun
aynasında	Noun
çalışmalarımız	Noun
ritüeller	Noun
eklemeliyiz	Adjective
eziyetçimizin	Noun
sakindi	Noun
yarasaydılar	Noun
yaratmasını	Noun
içerirler	Verb
izlersiniz	Verb
endüstrilerden	Noun
doğacak	Verb
fonksiyonlarımda	Noun
çamurlar	Noun
yorarlar	Verb
öneri	Noun
prototipi	Noun
tutmuyordu	Verb
gazele	Noun
hülyalarınıza	Noun
topladık	Verb
getiririz	Verb
kullanıyorlardı	Verb
papayız	Noun
gördün	Verb
eller	Verb
Kürtleri	Noun
taşıdılar	Verb
kamuslardın	Noun
ayılara	Noun
şaşırtmıyordular	Verb
akçaağaçtan	Noun
havlu	Noun
bilezikler	Noun
lehçesinde	Noun
konunu	Noun
yarımadasına	Noun
eğittin	Verb
vaftizden	Noun
gülüşümün	Noun
şelaleyi	Noun
gölgeden	Noun
sonunuz	Noun
edebiyatımıza	Noun
görmedi	Verb
puroyu	Noun
izolasyonlar	Noun
gaf	Noun
bozuyordu	Verb
dağlara	Noun
makinesi	Noun
gübrelere	Noun
kuramın	Noun
sanatlardan	Noun
kaderime	Noun
dikkatler	Noun
kartta	Noun
fakültelerde	Noun
boğadan	Noun
çiftliklerde	Noun
sayfalarımı	Noun
yardımlarda	Noun
yollardır	Noun
kaçırıyorsunuz	Verb
kabuğunuzdan	Noun
baldızlarınızdan	Noun
yıldıza	Noun
bahçeyi	Noun
incirler	Noun
soylular	Noun
kasımpatı	Noun
kuvvetlerimiz	Noun
otogar	Noun
seviyor	Verb
aldattım	Verb
başvurum	Noun
yüzeylerinize	Noun
endüstrinin	Noun
sayfanıza	Noun
iguanaları	Noun
asıl	Noun
tarihçiydi	Noun
mantıksızdık	Adjective
almanak	Noun
rimellere	Noun
tayga	Noun
gerimin	Noun
göçeceğiz	Verb
gürgeni	Noun
şirketiniz	Noun
lepistes	Noun
cephenizin	Noun
disleksilerimize	Noun
aynayı	Noun
sunmuyor	Verb
mühendisleriniz	Noun
evcikkıranımıza	Noun
savaşçılardır	Noun
saçlarıma	Noun
boğanın	Noun
ayran	Noun
hesaptan	Noun
kurbağaya	Noun
kırığım	Noun
listede	Noun
giyerler	Verb
tecrübem	Noun
evcikkıranlarmışım	Noun
totemcilerde	Noun
erneklerimi	Noun
iletiyordu	Verb
titriyordu	Verb
uyarırım	Verb
ısırıkta	Noun
dövüştü	Verb
rehberimizde	Noun
ölüsünü	Noun
futbolculara	Noun
tabancasına	Noun
aşıyordu	Verb
madende	Noun
bellekte	Noun
elçilerden	Noun
abacılarınızın	Noun
fotoğrafım	Noun
sapmaz	Verb
görecekler	Verb
çiftlikler	Noun
sınırdan	Noun
geçmişlerden	Noun
arzular	Noun
amcasından	Noun
kasım	Noun
yazıları	Noun
bank	Noun
hazırız	Adjective
kobra	Noun
ketçaplarımız	Noun
kıldık	Verb
ayinleri	Noun
kalfamızın	Noun
sonralardan	Noun
başvurulardan	Noun
Yahudisini	Noun
taneler	Noun
yolcudan	Noun
bilmiyoruz	Verb
filimde	Noun
sevene	Noun
direkten	Noun
bükülür	Verb
kantinlerde	Noun
karpuzumuz	Noun
kanallar	Noun
röntgenim	Noun
büyücüden	Noun
adlarda	Noun
saksafonumuzu	Noun
düğme	Noun
haçtan	Noun
dağılır	Verb
hazinelere	Noun
batıda	Noun
amacınız	Noun
argo	Noun
geliyorlardı	Verb
beldelere	Noun
erkecelimin	Noun
develerden	Noun
ışınlardan	Noun
kertenkelelerin	Noun
idarede	Noun
ilgeç	Noun
otel	Noun
büyücüsü	Noun
politikalarda	Noun
annelik	Noun
saydırtacağız	Verb
kocadan	Noun
birleşmedi	Verb
satrançlardan	Noun
çubuklara	Noun
konmadı	Verb
belirteci	Noun
kula	Noun
sinmiyor	Verb
dürttüm	Verb
duvarda	Noun
kardeşliğin	Noun
islerimizi	Noun
mikroişlemciler	Noun
kaderde	Noun
kıl	Noun
gecelerinizde	Noun
çılgınları	Noun
eşikten	Noun
kasıklara	Noun
kimliğe	Noun
sonraya	Noun
göçerler	Verb
bloglarda	Noun
gitmemize	Noun
sorumluluklara	Noun
pede	Noun
develere	Noun
cezalandırdık	Verb
katılmam	Verb
dalgalarda	Noun
dılağınızın	Noun
uyarıyor	Verb
ağaçların	Noun
söyleşide	Noun
korsanlarınıza	Noun
mamalarınızdan	Noun
jartiyerlerimi	Noun
yapmamızda	Noun
acısını	Noun
veriyordum	Verb
süzgeçlere	Noun
deneye	Noun
günlerim	Noun
küçülüyordun	Verb
lepisteslerime	Noun
buluta	Noun
kalktı	Verb
ininizin	Noun
böler	Verb
kalamarlarımızda	Noun
görmedik	Verb
bulmuyorum	Verb
nedimesi	Noun
çılgınlığın	Noun
trene	Noun
halklarda	Noun
medreseye	Noun
bisküvilerinizin	Noun
bilgilerimiz	Noun
öneride	Noun
sıcaklığa	Noun
mistiğimiz	Noun
ortammışlar	Noun
şaşırdım	Verb
delinize	Noun
eziyetten	Noun
ekşitirsiniz	Verb
mutsuzdu	Adjective
çalgıcısını	Noun
kalkanın	Noun
otobüsten	Noun
avizelerimizde	Noun
kocaya	Noun
tuşun	Noun
konumun	Noun
pozisyon	Noun
damatlara	Noun
vaftizin	Noun
önbilgin	Noun
paşam	Noun
mutfak	Noun
meşalemi	Noun
karnesinde	Noun
doymadım	Verb
düşünüyorlardı	Verb
eğlencesini	Noun
taraflar	Noun
çalışırlar	Verb
gireceğiz	Verb
başrahibe	Noun
mahleplerimizin	Noun
hızdan	Noun
günler	Noun
müzisyenlerinizde	Noun
finalden	Noun
dalgalardan	Noun
amaçlarda	Noun
kilim	Noun
kalmadılar	Verb
müzelere	Noun
jilet	Noun
seçildi	Verb
asasının	Noun
disket	Noun
kütüğümüzde	Noun
pencereye	Noun
cımbız	Noun
fakültemizde	Noun
yazıyoruz	Verb
tanıma	Noun
gemiyi	Noun
liselerden	Noun
hazcılık	Noun
laboratuvardan	Noun
ateşim	Noun
kazarlar	Verb
düşünmedi	Verb
bitkisine	Noun
saçlarım	Noun
kalamarlarımdan	Noun
gençliğimin	Noun
doğaya	Noun
leblebinizde	Noun
sorularınızın	Noun
raketin	Noun
gecelerde	Noun
yanıyordu	Verb
bitti	Verb
görüşlerim	Noun
gün	Noun
moleküllere	Noun
bilemez	Verb
bindi	Verb
kemanım	Noun
örümceklerde	Noun
burundan	Noun
ölçtü	Verb
hapse	Noun
kutusunu	Noun
ayağımın	Noun
sürücüsü	Noun
güvensizliğe	Noun
duy	Noun
maskaralarda	Noun
arzulardan	Noun
tanıdı	Verb
hesaplarda	Noun
memeye	Noun
yıldızlar	Noun
ağıtlar	Noun
kavak	Noun
şamisenlerimizi	Noun
ilerisinde	Noun
sınırlarımız	Noun
yapılmayacak	Verb
aldatmıyordunuz	Verb
cevabımın	Noun
eridiler	Verb
elementlerde	Noun
bandajlarımıza	Noun
eğlenceyi	Noun
şeyimi	Noun
vekillere	Noun
katılmıyorsunuz	Verb
alevlere	Noun
düşünmezler	Verb
içeriz	Verb
yazmana	Noun
liranın	Noun
evlilikte	Noun
meşaleydiniz	Noun
sürprizlere	Noun
kimyacı	Noun
çalıyordu	Verb
kanıtlar	Verb
sendromlar	Noun
kutsallığı	Noun
başarılıydı	Adjective
kazıdı	Verb
madalyalarda	Noun
bin	Noun
çiziyorlardı	Verb
kaynaşırlar	Verb
uyarıyoruz	Verb
menüm	Noun
tuvaletler	Noun
müezzinlerimi	Noun
fitil	Noun
mezarlığınızı	Noun
verdirtir	Verb
yıldızıldan	Noun
bilecekler	Verb
tornavidanızda	Noun
yazarız	Verb
garplarımdan	Noun
komikleşmeyeceksiniz	Verb
halklara	Noun
kapamasına	Noun
tütünden	Noun
idareler	Noun
kirletmiyorsunuz	Verb
amatörde	Noun
sözleşmesinde	Noun
gemisini	Noun
yalnızlıkta	Noun
dışkısını	Noun
geliştirmiyorsunuz	Verb
kapısını	Noun
zarfa	Noun
gaga	Noun
tayfadan	Noun
dağılmasına	Noun
ürerler	Verb
övgüyü	Noun
şimşeklere	Noun
kardeşlerimizin	Noun
bozdum	Verb
kulaklar	Noun
çekirdek	Noun
biçiminizin	Noun
uzağa	Noun
mükemmellik	Noun
galaksi	Noun
yazarları	Noun
pozisyonlardan	Noun
peskütana	Noun
gölgelere	Noun
şarka	Noun
etiketler	Noun
dağıtımlardan	Noun
mucizene	Noun
defterlerinizi	Noun
işkenceden	Noun
kullanmamı	Noun
gitarda	Noun
öğrendin	Verb
kalabalığın	Noun
yemenin	Noun
depresyonda	Noun
koptu	Verb
sıçanlardın	Noun
melodide	Noun
doğurdun	Verb
duvar	Noun
verir	Verb
papyonunuzu	Noun
tepmeyeceğiz	Verb
kemençenin	Noun
idadide	Noun
bakanlardan	Noun
şatolarıma	Noun
kalemi	Noun
sorusunda	Noun
ağacı	Noun
katilden	Noun
umuyordunuz	Verb
sekti	Verb
cihaz	Noun
sıralamalara	Noun
müzeleri	Noun
korkarım	Verb
fikrime	Noun
getirmeyecek	Verb
Lefkoşalılarınızda	Noun
öçlerinizin	Noun
söğütler	Noun
biteceğim	Verb
ütümüz	Noun
düşünürler	Verb
yardımcılardınız	Noun
hasretimden	Noun
karadullar	Noun
kesmezler	Verb
bürüdü	Verb
kullanıcılardır	Noun
odunlarda	Noun
kiplerde	Noun
gişelerimin	Noun
dilbilimde	Noun
ünlü	Noun
kalesi	Noun
başaracak	Verb
pelikandan	Noun
kefaletlerimizde	Noun
susam	Noun
konumuzun	Noun
hazineleri	Noun
öksürmüyorduk	Verb
omurgasında	Noun
kara	Noun
dürümde	Noun
oyunculukları	Noun
doğururlar	Verb
kazanacaksınız	Verb
gizliyor	Verb
kazmayı	Noun
silahımdan	Noun
kertenkeleler	Noun
parçalanmalarımızda	Noun
aldırmıyor	Verb
hamsterim	Noun
hatasından	Noun
kelimesinden	Noun
kalmazsınız	Verb
buzuldan	Noun
sıyırırım	Verb
çıkaracağım	Verb
bitimimizde	Noun
kardeşsiniz	Noun
gelmiyorsun	Verb
trende	Noun
çökelti	Noun
başvurularınız	Noun
ısırmaz	Verb
ota	Noun
başvurusuna	Noun
sevenimizi	Noun
göçlere	Noun
şairi	Noun
köprü	Noun
maltı	Noun
seçilmiyor	Verb
bozayılarınıza	Noun
mühimliklerimize	Noun
tanıtıyordu	Verb
dünür	Noun
oduna	Noun
esenliklerinizden	Noun
dirseklerde	Noun
bisküviler	Noun
lezyonlar	Noun
bürümeyecekler	Verb
dilecekler	Verb
uyarısını	Noun
kaldırım	Noun
köylülerden	Noun
savaşçısının	Noun
dakikalarda	Noun
giysilerdiniz	Noun
sevgilisinden	Noun
radyosunun	Noun
vardım	Verb
çiller	Noun
frizbi	Noun
topladı	Verb
lahmacun	Noun
kararıyor	Verb
seçilmez	Verb
perini	Noun
ölçecek	Verb
değiştirdin	Verb
viskiye	Noun
aynamızdan	Noun
izliyorlar	Verb
taşımam	Verb
kulüpte	Noun
civarda	Noun
geçmeden	Noun
geçiniyorlardı	Verb
sultandan	Noun
bulunmayı	Noun
içecekten	Noun
vikipedistten	Noun
istemiyordu	Verb
başkentte	Noun
temizler	Verb
hikâyelerde	Noun
çileğimi	Noun
inanıyordu	Verb
hamamlara	Noun
otonuza	Noun
dilimlere	Noun
tercümeyi	Noun
şatolar	Noun
eziyetçilermişsin	Noun
algoritmasından	Noun
dondurmayacağım	Verb
tavernalarda	Noun
vadesinde	Noun
yaralanmanız	Noun
takılarınızın	Noun
seçmesine	Noun
dezenfektanıma	Noun
bacaya	Noun
marangozlarız	Noun
kalır	Verb
güldün	Verb
hecemizden	Noun
gizledi	Verb
katılacak	Verb
kılım	Noun
ritimde	Noun
sererler	Verb
endüstriye	Noun
antropolojiye	Noun
diyeceğiz	Verb
hastada	Noun
lahanadan	Noun
kitaplık	Noun
örter	Verb
entegrasyondan	Noun
yermiyorum	Verb
alanımda	Noun
kutunuzun	Noun
cevaplarda	Noun
dayanıklılık	Noun
bulmuyor	Verb
ödevden	Noun
kataloğa	Noun
öğretime	Noun
iniyor	Verb
evrenimiz	Noun
tacize	Noun
gökdelende	Noun
ibnemizi	Noun
psikiyatriste	Noun
kuyrukta	Noun
müşterilerden	Noun
evrende	Noun
açarsınız	Verb
olay	Noun
kazada	Noun
etlerde	Noun
üreticiyi	Noun
akbabadan	Noun
arzuhalciydiler	Noun
kuyuda	Noun
oltan	Noun
gülüşümüzün	Noun
yuvana	Noun
deyimimizden	Noun
topluluğumuzu	Noun
döner	Verb
yalamam	Verb
kirazdan	Noun
sürprizleri	Noun
isyana	Noun
diziye	Noun
kategorilerimiz	Noun
bakmayı	Noun
sagası	Noun
erimez	Verb
üreyi	Noun
erdim	Verb
lunaparklarda	Noun
çalışmalarım	Noun
istisnandan	Noun
türüleriniz	Noun
paylar	Noun
götürüyorlardı	Verb
video	Noun
kıskandı	Verb
filizler	Noun
gelme	Noun
vahası	Noun
ayrılmaz	Verb
enerjiyi	Noun
fişeklerde	Noun
objelerden	Noun
elektromanyetizmaya	Noun
yedigen	Noun
monarşiyi	Noun
mandala	Noun
fahişelerden	Noun
kullanıcılara	Noun
daldım	Verb
üyelerdiniz	Noun
akciğerler	Noun
şamandıra	Noun
kazaklar	Noun
boğazlar	Noun
avantajları	Noun
tiyatrolardır	Noun
kahramanımız	Noun
deneyimlerimin	Noun
çoraplardan	Noun
yongandan	Noun
getiriyoruz	Verb
çarşıyı	Noun
çimkenizde	Noun
düşmanlarınız	Noun
ayırıyordu	Verb
kediyi	Noun
baydınız	Noun
peltenizde	Noun
yapıyorsun	Verb
kozası	Noun
otellerden	Noun
sağar	Verb
modeldi	Noun
tasarımlarda	Noun
değirmenlere	Noun
baltaydılar	Noun
trenler	Noun
masumlar	Adjective
öğrettiler	Verb
bazdan	Noun
hastalıklarınızda	Noun
rakamlardan	Noun
mısır	Noun
uyarımı	Noun
duydunuz	Verb
taşeronunuzu	Noun
sunusu	Noun
düğünden	Noun
girmedim	Verb
gidilmediniz	Verb
duymuyor	Verb
birleştirir	Verb
entrika	Noun
yorgunluğu	Noun
davrandı	Verb
bakıyorlar	Verb
külek	Noun
lazerlerden	Noun
arzuya	Noun
meleğe	Noun
savunacak	Verb
yetki	Noun
taşımaz	Verb
molekül	Noun
tutulmasında	Noun
göstermedik	Verb
sözcülüğümüz	Noun
yanlışlar	Adjective
mayası	Noun
yüzmeye	Noun
görüntüde	Noun
videosuna	Noun
yapmanız	Noun
karaciğere	Noun
değerliydi	Adjective
kapakçıklar	Noun
binlere	Noun
neşelerim	Noun
tepkimelerimin	Noun
hülya	Noun
pastırmaymışız	Noun
vakitlerde	Noun
değiştirmezler	Verb
dişlilerimden	Noun
birliğinizin	Noun
yavruya	Noun
utkular	Noun
nihayete	Noun
jaguarlar	Noun
konsere	Noun
lalalara	Noun
soğuyordu	Verb
beyitlerden	Noun
döverler	Verb
kalemtıraş	Noun
bildirmiyordun	Verb
artıyorsunuz	Verb
akım	Noun
evrime	Noun
devirlerden	Noun
gizemli	Adjective
mevzularda	Noun
travma	Noun
sitelerden	Noun
asitte	Noun
alacaksın	Verb
kuyulardan	Noun
kapamazlar	Verb
düşüyorsunuz	Verb
çukur	Noun
hatır	Noun
damada	Noun
dişten	Noun
bakıcılarımız	Noun
tüye	Noun
sepetler	Noun
monarşiden	Noun
tiyatrom	Noun
gülüyorum	Verb
merkezlerin	Noun
erkelerin	Noun
madalyalardan	Noun
verilerimiz	Noun
alabalık	Noun
bulacak	Verb
tartmam	Verb
çobanımın	Noun
büyümedi	Verb
fiilin	Noun
göreceksin	Verb
dülger	Noun
vurgularmışsın	Noun
onadı	Verb
sabahlara	Noun
üreye	Noun
kantinde	Noun
kartallarımızın	Noun
halkımın	Noun
gişelerinize	Noun
ilerletmeyecek	Verb
izlek	Noun
taraklar	Noun
titreşimlerden	Noun
durumdan	Noun
mitokondrileri	Noun
sunumda	Noun
ışınımdan	Noun
yendireceksiniz	Verb
aygıtlara	Noun
farenizi	Noun
sonbaharda	Noun
rokete	Noun
duvara	Noun
bacada	Noun
götte	Noun
bulunur	Verb
devriminizin	Noun
çıkarmıyor	Verb
içkide	Noun
ergenliklere	Noun
dağılacak	Verb
yapılar	Noun
metafazlarıma	Noun
kolaylıklarınız	Noun
düşünürüm	Verb
yüzeyimizi	Noun
psikoloğu	Noun
mıknatıslardan	Noun
makinayı	Noun
kotanjantlarda	Noun
hatamızı	Noun
seçicilerim	Noun
koyarız	Verb
kazdılar	Verb
örmez	Verb
protestolardan	Noun
getirmediler	Verb
vurgunu	Noun
astılar	Verb
kusmayı	Noun
öğretimden	Noun
gölgelerde	Noun
indirim	Noun
kilisesi	Noun
emer	Verb
birleşmeden	Noun
sonraları	Noun
aleve	Noun
unum	Noun
alanlardan	Noun
kullanıyorum	Verb
kesecek	Verb
idealde	Noun
beyitlerimin	Noun
irkeyellerimize	Noun
tutuyorlardı	Verb
uymuyoruz	Verb
dinlenme	Noun
bitmesini	Noun
istemeyiz	Verb
toplumdan	Noun
seyretti	Verb
sakala	Noun
meşrubat	Noun
zorlukta	Noun
migrenden	Noun
müşterisini	Noun
sayıyordu	Verb
bacaklara	Noun
aldatır	Verb
yemenimizi	Noun
yoğurt	Noun
başlangıcımız	Noun
umarlar	Verb
rahiplerdir	Noun
adamımız	Noun
paskalyası	Noun
kazasının	Noun
şampiyonluklardan	Noun
damlaların	Noun
sütyenlerimizi	Noun
etten	Noun
bazda	Noun
yağlayıcılar	Noun
çalışmayı	Noun
sitelerimizi	Noun
tuvalette	Noun
kamçılar	Noun
oyunculardır	Noun
bitimlerimizin	Noun
periden	Noun
malt	Noun
şelalesinin	Noun
beldemizden	Noun
geline	Noun
abajurlar	Noun
geçmişimiz	Noun
uçaklardan	Noun
çubuğa	Noun
bilemezler	Verb
şikayet	Noun
mum	Noun
ayazlar	Noun
ilişki	Noun
çalıştılar	Verb
adlar	Noun
bataryayı	Noun
puan	Noun
istemcilerde	Noun
pompaya	Noun
sorularınız	Noun
alkole	Noun
acıtır	Verb
getirirler	Verb
anahtarlık	Noun
akılarınızda	Noun
tuvaletlere	Noun
zarfı	Noun
görüntüsünün	Noun
çokgenden	Noun
çalışmalar	Noun
örneğimiz	Noun
bazaltlardan	Noun
bulutlardan	Noun
çeviriyordu	Verb
kristalleri	Noun
ekranlara	Noun
yarayacak	Verb
kaş	Noun
virgüller	Noun
ayrılmadılar	Verb
ritüele	Noun
vücutlara	Noun
silmiyoruz	Verb
askerlere	Noun
dilimlerimin	Noun
tandırlarda	Noun
kötüleştirir	Verb
veterinerlerimde	Noun
bineklersin	Noun
mimleriniz	Noun
şeylerimizin	Noun
ortan	Noun
finiş	Noun
mayalarda	Noun
kıskançlar	Adjective
koşucuya	Noun
altlarımızın	Noun
hayvandan	Noun
soruda	Noun
makinesinden	Noun
klavyesi	Noun
vuvuzela	Noun
hastalıklarımda	Noun
maratona	Noun
topluluklarda	Noun
hesabı	Noun
şarapçın	Noun
döneceksin	Verb
kalkanları	Noun
girer	Verb
satıştan	Noun
kulluklarıma	Noun
sövüyorlardı	Verb
arşivlerin	Noun
veriyorsun	Verb
girmiyorlar	Verb
iğneden	Noun
piramitler	Noun
baharat	Noun
çetesine	Noun
günlük	Noun
hücrelere	Noun
söyleşiler	Noun
politikaların	Noun
kahramandan	Noun
pijamanızın	Noun
dürer	Verb
barajınıza	Noun
yumurtalıklara	Noun
sevmez	Verb
lisenin	Noun
övüyordu	Verb
kurtardık	Verb
çeşni	Noun
Kopenhaglılarınızda	Noun
ortayı	Noun
koyuyordu	Verb
farelersiniz	Noun
günlüğe	Noun
memesinin	Noun
yumurtasından	Noun
girmezler	Verb
iyonosferin	Noun
izledik	Verb
animasyondan	Noun
sonuçta	Noun
kestik	Verb
kapında	Noun
kapamayacaksın	Verb
aksana	Noun
çarşaf	Noun
kalkarlar	Verb
homonimlerde	Noun
dumantınız	Noun
planet	Noun
hadise	Noun
keseyi	Noun
umuyorlar	Verb
mayolar	Noun
ekranlarınızda	Noun
sülükleri	Noun
durursunuz	Verb
amaçlardan	Noun
uykularda	Noun
saklanıyordun	Verb
spama	Noun
görüntülerde	Noun
çalışman	Noun
deriler	Noun
yarışlarda	Noun
sultanımızda	Noun
zamanımda	Noun
moronlar	Noun
sürdürülebilirlikler	Noun
deliklere	Noun
seçecek	Verb
bilgisinden	Noun
ördek	Noun
açmadı	Verb
ejderhası	Noun
kuvvette	Noun
ehemmiyetliliklerimde	Noun
dağlar	Noun
bulamadınız	Verb
yetersizlikten	Noun
üniversitenin	Noun
bildirmeyeceğim	Verb
inanırlar	Verb
kahvesini	Noun
açılırlar	Verb
çökmez	Verb
psikiyatrı	Noun
röportajlardan	Noun
virgüle	Noun
kırışıklıklar	Noun
azınlığın	Noun
birleşti	Verb
solucanlara	Noun
kararırım	Verb
eğrilerin	Noun
ayakkabıcıydılar	Noun
ağam	Noun
modası	Noun
çalışmalarda	Noun
çalacağız	Verb
bitireceğim	Verb
çerçilerden	Noun
prenslere	Noun
kipi	Noun
kartpostallardan	Noun
kehribarınıza	Noun
hazırlıklarda	Noun
önbilgilerinizden	Noun
yıprattı	Verb
mükemmelliğin	Noun
bağdın	Noun
makinesinin	Noun
tozuz	Noun
vitrin	Noun
psikoloğa	Noun
mantığınızın	Noun
netinizde	Noun
düşünmez	Verb
doktrinler	Noun
kimlikler	Noun
maskesini	Noun
bitirtmezler	Verb
fonksiyonumuzdan	Noun
enstrümantal	Noun
kapatmayız	Verb
büyüklüğü	Noun
büzük	Noun
fetvalar	Noun
etim	Noun
unlar	Noun
sunuldu	Verb
akışkanlardan	Noun
ormanlara	Noun
kazmalar	Noun
çubuklarınızı	Noun
yaparım	Verb
düşünmem	Verb
dirseklere	Noun
teşkilatlardan	Noun
seyahatten	Noun
kutum	Noun
yazanağınızda	Noun
tanımadı	Verb
parçalanıyordu	Verb
robotlara	Noun
minarelerim	Noun
mühendislere	Noun
kısmayacak	Verb
çevirecek	Verb
katılaştırıyordu	Verb
müstahdemlerimizde	Noun
nüfuzları	Noun
taşeronunuzun	Noun
savunmuyorum	Verb
küçüldü	Verb
başçıklarınızı	Noun
hudutlar	Noun
taşeron	Noun
dişçi	Noun
enfeksiyonlarda	Noun
saksının	Noun
değişikliği	Noun
işlevde	Noun
psikologlara	Noun
tesadüften	Noun
geziyoruz	Verb
değiştirdiler	Verb
kalkanlar	Noun
madenden	Noun
direklere	Noun
önyargıların	Noun
direkte	Noun
takmaz	Verb
final	Noun
yavrudan	Noun
duyular	Noun
doğrar	Verb
şelalesine	Noun
kelepçeler	Noun
yanıtlarınız	Noun
kaynaştırtıyoruz	Verb
bitirmiyordu	Verb
ispatlar	Verb
esenliğe	Noun
başkanımız	Noun
kamerayı	Noun
oluyor	Verb
uydusunun	Noun
dalaklarınızı	Noun
ibnemiz	Noun
mistiklere	Noun
derinde	Noun
iblisten	Noun
fiillerin	Noun
ekte	Noun
uydudan	Noun
ahizelerimizde	Noun
elementler	Noun
gökdelenlerden	Noun
düdükler	Noun
konuğa	Noun
seyahatler	Noun
çıkarıyor	Verb
eylemler	Noun
mühendismiş	Noun
önbilgi	Noun
saldırıyorlar	Verb
değişiyordu	Verb
düşmana	Noun
bitirmem	Verb
çıkmıyordu	Verb
robota	Noun
konumuza	Noun
garp	Noun
kalacaksınız	Verb
kuyumculardım	Noun
ağlamama	Noun
şemsiyesi	Noun
kasidenizde	Noun
levye	Noun
baharatlarımıza	Noun
olmayacağız	Verb
frizbiniz	Noun
omurgasına	Noun
tabutta	Noun
düşmandı	Noun
düşünürsün	Verb
köylüye	Noun
kayboluyorsun	Verb
topolojide	Noun
içgüdüler	Noun
depolar	Noun
armutlar	Noun
dönüşlerde	Noun
kolona	Noun
burkuyorduk	Verb
satılıyordu	Verb
protestoya	Noun
bacalara	Noun
eğdi	Verb
göçten	Noun
ömrümden	Noun
kurallarımıza	Noun
eriyiğimizin	Noun
oturmadı	Verb
kelimeciklerinizin	Noun
lahmacunlar	Noun
duydular	Verb
düzeltirsin	Verb
yağmamızdan	Noun
değişkende	Noun
iletkene	Noun
cephesinde	Noun
tabiyet	Noun
altınımızı	Noun
meydanı	Noun
kırdılar	Verb
fetvayı	Noun
jokey	Noun
deneyimlerimizi	Noun
yendirmiyordunuz	Verb
kullanmadan	Noun
cadıya	Noun
ayrılmayacak	Verb
kocasından	Noun
uyarılara	Noun
sıralamadan	Noun
sanacak	Verb
baltayı	Noun
selama	Noun
arşivlere	Noun
süpürgelerin	Noun
kuşumun	Noun
verdirdiler	Verb
voleybolcunuzda	Noun
öğretide	Noun
cevaptan	Noun
yönelim	Noun
bürokratları	Noun
boşalması	Noun
kılmıyor	Verb
kaynaştırtılmadınız	Verb
memleketimiz	Noun
tiyatrolardan	Noun
sosyologlar	Noun
geçmişten	Noun
deposundan	Noun
parçada	Noun
gemimiz	Noun
gelmedik	Verb
cinsiyete	Noun
bedevilerden	Noun
kuralım	Noun
baykuşumuzun	Noun
termometresi	Noun
dağıtıyor	Verb
babalık	Noun
biseksüelimi	Noun
içeceklerden	Noun
ömrümüz	Noun
yaralanmayı	Noun
eğitim	Noun
yetiştirdiler	Verb
ulumuyordun	Verb
ayrılmalar	Noun
prezervatifler	Noun
uğrattılar	Verb
uçurtmayı	Noun
siliyorsunuz	Verb
yardımseverlik	Noun
arzusu	Noun
boks	Noun
kategorilere	Noun
monarşide	Noun
eziyordunuz	Verb
memleketlerinize	Noun
keseceğim	Verb
iletkenler	Noun
masallarda	Noun
ışınlara	Noun
kodun	Noun
kullanıcıydım	Noun
kullanman	Noun
kitapçığın	Noun
gösteriden	Noun
hipotalamuslarınız	Noun
derine	Noun
kaynamıyoruz	Verb
yabancıya	Noun
marulumuzu	Noun
misafirlerden	Noun
silkiyorum	Verb
türevde	Noun
boyarlar	Verb
şakaya	Noun
korsesi	Noun
karneye	Noun
kumandayı	Noun
yönetimden	Noun
barajdan	Noun
mezarlığa	Noun
kale	Noun
tepkime	Noun
arayüzleri	Noun
gelinmezsin	Verb
birleşecek	Verb
portlar	Noun
burktu	Verb
mala	Noun
anlardan	Noun
röpörtaja	Noun
davrandım	Verb
memesine	Noun
üçüz	Noun
ilçelerin	Noun
bataryamın	Noun
ayırmadı	Verb
magmam	Noun
çobanımdan	Noun
mikroorganizmalarımızın	Noun
lüfer	Noun
krizlerde	Noun
delim	Noun
lehçe	Noun
kıyafette	Noun
eklemelisiniz	Adjective
ısılar	Noun
kayağımız	Noun
sistemlerimin	Noun
tamlananın	Noun
tabiyetleriniz	Noun
mıknatısa	Noun
üzgünüm	Adjective
duyuyordu	Verb
örnekte	Noun
verilerimizin	Noun
ısınızın	Noun
şaldan	Noun
dinsizliklerim	Noun
şaşırtacak	Verb
korkmaz	Verb
mektup	Noun
startta	Noun
uyarısının	Noun
ülkeme	Noun
babasızlarımın	Noun
verdiririz	Verb
izlemiyorsun	Verb
balinasından	Noun
duyarız	Verb
barajlardan	Noun
fetvanın	Noun
saydırmadım	Verb
tecrübeyi	Noun
tatlısını	Noun
karakollarda	Noun
mikroişlemcisini	Noun
yapmıyorum	Verb
yakana	Noun
maçlara	Noun
duvarlarda	Noun
öldüreceksin	Verb
açmayacağız	Verb
parasızlıklardan	Noun
yollarımız	Noun
mustatilde	Noun
tadımız	Noun
okiyalarımızın	Noun
cisimlerimize	Noun
doğusundan	Noun
uyduyu	Noun
bilek	Noun
asayı	Noun
iletkenlere	Noun
güvenmiyorum	Verb
dalgalanıyordu	Verb
yapıların	Noun
fibrinojeninizin	Noun
sorularınıza	Noun
taşıdı	Verb
saldırmayacak	Verb
uzanır	Verb
sıkıntı	Noun
çiçelerinizi	Noun
indeksler	Noun
tabela	Noun
tanımazlar	Verb
yatağım	Noun
ilçelerden	Noun
istiyorsun	Verb
oturdu	Verb
kalbimden	Noun
kapakçık	Noun
vurgusuna	Noun
güvenir	Verb
istemcilerinizin	Noun
ısırgan	Noun
öğütür	Verb
sargın	Noun
similyalarınız	Noun
fikrimden	Noun
şakanızın	Noun
hindilerdiniz	Noun
gereksiniminizden	Noun
bozmadı	Verb
temizliyor	Verb
ilçenin	Noun
kolyem	Noun
mikrofon	Noun
haremlik	Noun
görmüyordum	Verb
prototipin	Noun
dileğimizde	Noun
bombasından	Noun
kullanıcıydı	Noun
geometriden	Noun
yangınlara	Noun
yorum	Noun
kullanılmaz	Verb
girecekler	Verb
durumumuzu	Noun
serçelerin	Noun
bisikletten	Noun
pancarlarımı	Noun
havlularda	Noun
parçalandım	Verb
sözcüğümüze	Noun
sempozyumda	Noun
kuyulara	Noun
pusulada	Noun
battılar	Verb
sesleniyor	Verb
amcayı	Noun
açlığa	Noun
haritalardan	Noun
mekiğim	Noun
öptü	Verb
aşkıma	Noun
kasa	Noun
bitirttirmeyeceğiz	Verb
geçmesinin	Noun
kazısından	Noun
işkencenizden	Noun
sürülerden	Noun
önceliğimiz	Noun
ceylanlarımı	Noun
teşkilatta	Noun
camimiz	Noun
çattın	Verb
sayfanız	Noun
şairlerin	Noun
bürokrasinin	Noun
kısraklarımdan	Noun
saati	Noun
modellerde	Noun
sınırlardan	Noun
dinsizliklerimiz	Noun
kraliçeler	Noun
paskalyalarınızı	Noun
olmam	Verb
üyesini	Noun
sandalyenin	Noun
içiyordu	Verb
sonuca	Noun
gönüller	Noun
tipografyasından	Noun
utanacağım	Verb
dağlarımızda	Noun
sınar	Verb
brokolilerinizin	Noun
seçilecek	Verb
yanardağınızın	Noun
doktorumuz	Noun
uygulamanız	Noun
kolaya	Noun
roket	Noun
madenlere	Noun
burkmazsınız	Verb
izlerim	Verb
müelliflerde	Noun
kedisi	Noun
sanatlarda	Noun
elementlerden	Noun
tanımda	Noun
kirişler	Noun
hazırdı	Adjective
ayaktan	Noun
göllerin	Noun
viskiyi	Noun
öncenin	Noun
dizeminizden	Noun
tutmadı	Verb
kullanılacak	Verb
kalabalıkların	Noun
gönderiyorlar	Verb
korda	Noun
çalar	Verb
birliğimden	Noun
çilden	Noun
semer	Noun
gezer	Verb
kütüklerden	Noun
medresenize	Noun
psikoterapimizin	Noun
rüzgara	Noun
getirdim	Verb
kuşlarda	Noun
sevap	Noun
mayada	Noun
teknolojilere	Noun
örttü	Verb
kalemin	Noun
ürümez	Verb
belirteçlerin	Noun
şahısa	Noun
yaratmaya	Noun
kameraya	Noun
zarflarda	Noun
izlencesini	Noun
takımı	Noun
büktürülmezsiniz	Verb
unutmayacağız	Verb
havralarımda	Noun
maması	Noun
sunar	Verb
içiyoruz	Verb
umutluydu	Adjective
kulüpler	Noun
İngilizceleştirmiyordun	Verb
tanır	Verb
tümörler	Noun
ebediyet	Noun
mahlep	Noun
akılarımıza	Noun
örüntüler	Noun
birliklere	Noun
ummanlarıma	Noun
düğmenin	Noun
gözledin	Verb
medresede	Noun
düşünüyordum	Verb
katmayacağız	Verb
zamanınız	Noun
kâsesi	Noun
istisnadan	Noun
büyüleyici	Adjective
askerim	Noun
damatlığım	Noun
kasımdan	Noun
kâğıtlar	Noun
yapılacak	Verb
sağlayıcına	Noun
çizmeyeceksin	Verb
inerler	Verb
sözleşmeyi	Noun
kulaktan	Noun
listemden	Noun
utandım	Verb
katılmadılar	Verb
sendromda	Noun
gözlerim	Verb
asasını	Noun
üyeyim	Noun
yedeklerden	Noun
sözleşme	Noun
frambuazlarımızın	Noun
sözlüğünüzden	Noun
rahatsızlandı	Verb
ağası	Noun
yasaklara	Noun
çalışmalara	Noun
yakutu	Noun
papazlarsın	Noun
perdeleri	Noun
sunuma	Noun
kaptı	Verb
ehemmiyet	Noun
sıcaklıklara	Noun
iletiye	Noun
diziler	Noun
sayfalardır	Noun
susar	Verb
katıyordu	Verb
tohumdan	Noun
çılgınlıklara	Noun
topolojisinde	Noun
şaşırttırıyordunuz	Verb
sakallar	Noun
tümcede	Noun
kondu	Verb
aynştaynyum	Noun
allık	Noun
yakına	Noun
borca	Noun
kuyusunda	Noun
sonradan	Noun
önemsizliğimizde	Noun
sayıyor	Verb
cümlem	Noun
kapıya	Noun
onar	Verb
makyajda	Noun
geylere	Noun
vurguyu	Noun
küçülmüyoruz	Verb
tipografinize	Noun
sahifeden	Noun
nilüferlerimi	Noun
eylemleri	Noun
bacasının	Noun
bulurum	Verb
strüktürümün	Noun
ayakkabıcımızın	Noun
üretiriz	Verb
mevkisinden	Noun
saldı	Verb
tavuktan	Noun
heyecandan	Noun
teorilere	Noun
birlikler	Noun
köfte	Noun
ışında	Noun
derece	Noun
erimeler	Noun
satışa	Noun
kullanışlarımızdan	Noun
kullanırsınız	Verb
akvaryum	Noun
geçtiler	Verb
umutsuzlar	Adjective
beldemizi	Noun
ilerletiyorsunuz	Verb
kapakta	Noun
yarama	Noun
nedeniniz	Noun
tütümüze	Noun
teşkilattan	Noun
eşyaya	Noun
aldırmayacaklar	Verb
yordama	Noun
duruyoruz	Verb
ısındı	Verb
düşmanlarınızı	Noun
mağaralar	Noun
karalamaları	Noun
bellek	Noun
buzuki	Noun
kutusunun	Noun
havuzdan	Noun
serverde	Noun
iskelet	Noun
kullanıcımdan	Noun
bıktın	Verb
etikette	Noun
tutuyor	Verb
disleksi	Noun
veletler	Noun
kapılarda	Noun
taşıdım	Verb
hendese	Noun
desen	Noun
eşikleriz	Noun
antropolojide	Noun
döverim	Verb
kaldım	Verb
Nusayrîlerin	Noun
aşıyor	Verb
kot	Noun
böbrekler	Noun
ırke	Noun
delilersiniz	Noun
mikrofiber	Noun
kazına	Noun
geciktirtmiyorum	Verb
amacımı	Noun
haberleşiyorduk	Verb
ceplerden	Noun
bakmalar	Noun
erkeklikten	Noun
dakikası	Noun
dönüyordu	Verb
giyecek	Verb
tecrübelerden	Noun
kusar	Verb
disketlerimiz	Noun
satıldılar	Verb
vadesi	Noun
önemden	Noun
kanallarda	Noun
nedenlerdir	Noun
kazıya	Noun
şaşılacak	Verb
hamburger	Noun
iyileştirdiler	Verb
gırtlağımızdan	Noun
veterinerime	Noun
tarihçisine	Noun
aşklara	Noun
titrer	Verb
yığdı	Verb
dakikasında	Noun
camisinde	Noun
sarılır	Verb
aynasızlarımı	Noun
yetmeyeceğim	Verb
satışlara	Noun
hastalıklarda	Noun
döktü	Verb
vikipedistlere	Noun
seyisi	Noun
sevgilime	Noun
cesetleri	Noun
uzunluklarımıza	Noun
ekşitmediniz	Verb
hastalıklar	Noun
Türkçeleştirdi	Verb
mükemmelliği	Noun
vilayetler	Noun
dövme	Noun
kılkapanlarıma	Noun
kibritlerimizde	Noun
milyarderlerimizin	Noun
diliyor	Verb
vurguna	Noun
benziyordu	Verb
intikama	Noun
dedi	Verb
çözeltiye	Noun
saçmalığı	Noun
filimi	Noun
müzisyenden	Noun
yörüngesinden	Noun
mermisine	Noun
yorumlarımı	Noun
yaratın	Noun
istiridye	Noun
hacılardan	Noun
dinlenmeye	Noun
geciktiriyordun	Verb
yapışmasına	Noun
yetkisi	Noun
gizleyecekler	Verb
hasretimizi	Noun
andan	Noun
ilköğretime	Noun
alkollerde	Noun
amatörlere	Noun
tutulmalar	Noun
isimsizler	Adjective
dezenfektanlar	Noun
sürüngenimiz	Noun
işledi	Verb
işletmede	Noun
açıyorsunuz	Verb
şimşeklerin	Noun
sagasında	Noun
model-view-presenterleriniz	Noun
yedirmezsin	Verb
kiri	Noun
dövüşlerde	Noun
mutfaklarımızın	Noun
açılmadı	Verb
fabrikalarda	Noun
paylaşacağım	Verb
yerlere	Noun
utku	Noun
ereceğiz	Verb
kapsam	Noun
sonbaharımıza	Noun
parıltılarımız	Noun
nüfuslar	Noun
yankı	Noun
yangınlarda	Noun
kızan	Noun
düzelmedi	Verb
masaya	Noun
geçmişime	Noun
kanala	Noun
yaratmamız	Noun
kahvelerde	Noun
kulağımıza	Noun
marul	Noun
yedirirler	Verb
kırdım	Verb
atomumun	Noun
şampiyonlara	Noun
bürokrattan	Noun
dökmedik	Verb
yermiş	Noun
kefal	Noun
katılıyor	Verb
deliyorum	Verb
yardımcım	Noun
serperler	Verb
sattı	Verb
düşeriz	Verb
röportajlarda	Noun
zarftan	Noun
eriyik	Noun
iblislerim	Noun
korktu	Verb
durumumuza	Noun
varışı	Noun
sınavları	Noun
mezrasından	Noun
buldun	Verb
küser	Verb
prensiplerden	Noun
sürekliliğimiz	Noun
parçalanmalar	Noun
verniğimizin	Noun
görmediniz	Verb
karttan	Noun
düştüm	Verb
parlatmıyor	Verb
arzusuna	Noun
geçmiş	Noun
hamamda	Noun
jaguara	Noun
kıracak	Verb
yakınımızda	Noun
yarımadalar	Noun
üzümümü	Noun
teklifte	Noun
algoritmadan	Noun
sülükler	Noun
iletiyor	Verb
vermedim	Verb
korkuyorduk	Verb
ziyaretçiye	Noun
sevkiyatlar	Noun
sisteminizde	Noun
etler	Noun
çizerim	Verb
veledinizde	Noun
halılardan	Noun
yardıma	Noun
görür	Verb
fibrinojenlerimi	Noun
veriyi	Noun
sultanınızı	Noun
dağıtır	Verb
dönüşler	Noun
kutlamalardan	Noun
kolonyaymışız	Noun
çıktısı	Noun
kışkırtıyorlardı	Verb
atılmıyordum	Verb
gerisinden	Noun
ölçüleceksin	Verb
kalıplardan	Noun
butonlara	Noun
kağıtlar	Noun
makinası	Noun
yolculuğa	Noun
zamanlarda	Noun
yumurtasına	Noun
kazan	Noun
enjeksiyonlarımı	Noun
kafataslarını	Noun
alıştım	Verb
savaşımı	Noun
tabancalarda	Noun
durumumuz	Noun
onura	Noun
salonlara	Noun
müzikalden	Noun
mendiller	Noun
çeviriyoruz	Verb
bastırma	Noun
anjiyolar	Noun
cenneti	Noun
ilişkide	Noun
kirin	Noun
öldürmeyecekler	Verb
tabağın	Noun
büyüklükten	Noun
tanıdım	Verb
sürgün	Noun
inanmıyordu	Verb
tütecek	Verb
zurnalarınızda	Noun
zibidisini	Noun
titreşimden	Noun
âleminizin	Noun
ölümsüzlüğün	Noun
pişiyorum	Verb
efelere	Noun
âlemde	Noun
yarışmasında	Noun
coşku	Noun
protestosunun	Noun
sayfalarınıza	Noun
gökadayı	Noun
kuşkonmazlarım	Noun
böcekler	Noun
ölçer	Verb
kapayacaksın	Verb
çalışırsınız	Verb
kokmuyordu	Verb
sekmen	Noun
almıyor	Verb
yolda	Noun
harçlıklarınızın	Noun
kaza	Noun
yonttular	Verb
kurul	Noun
süzgeçte	Noun
kozan	Noun
örtüyor	Verb
yelekten	Noun
tümörlerin	Noun
şortlar	Noun
enişteyi	Noun
makarna	Noun
eriğimi	Noun
raketi	Noun
koşulur	Verb
zurnayız	Noun
yapmama	Noun
güzü	Noun
payıma	Noun
astronot	Noun
inanıyoruz	Verb
bağladın	Verb
yıldız	Noun
takvime	Noun
öğrenecek	Verb
hikâyede	Noun
oynayacak	Verb
binden	Noun
kullanılırlar	Verb
koruyucunda	Noun
kolikasına	Noun
pancarımızdan	Noun
itileceğim	Verb
koltuğa	Noun
kevgirimiz	Noun
baklavasına	Noun
yanıtlar	Noun
algoritmasını	Noun
galaksilerden	Noun
supaplar	Noun
banliyöde	Noun
teklife	Noun
manalarda	Noun
kalpağımızdan	Noun
yönde	Noun
çalışmadım	Verb
yarışmasının	Noun
çıkacak	Verb
payda	Noun
olgunluk	Noun
orangutan	Noun
bitirttirirler	Verb
merkezlerde	Noun
yörüngeye	Noun
aletime	Noun
işlemesi	Noun
geliştiriyoruz	Verb
marulumu	Noun
önerisini	Noun
ışınımı	Noun
saklayacağım	Verb
tanrıya	Noun
tahditlerimden	Noun
külde	Noun
belediyelere	Noun
çile	Noun
meşrubatlar	Noun
bağa	Noun
yaratınıza	Noun
gölgesinden	Noun
kurtaracaksın	Verb
protestoda	Noun
cevherden	Noun
belediyeden	Noun
tecrübesinin	Noun
gösteriyoruz	Verb
tasarruflar	Noun
kazana	Noun
hocadan	Noun
ayinlerden	Noun
karanlık	Noun
aydınlığa	Noun
istiyorlar	Verb
öfkelendirmedin	Verb
primitif	Adjective
inanmıyor	Verb
kuzulara	Noun
yutaktan	Noun
nüfuzun	Noun
yaralanmalar	Noun
savaş	Noun
mukavemeti	Noun
ofis	Noun
çıkmadılar	Verb
izliyor	Verb
girersiniz	Verb
işletimlermişiz	Noun
kusmuk	Noun
dinçliklerinizde	Noun
eskemezsin	Verb
pandeistiniz	Noun
uzunlukta	Noun
dükkânda	Noun
arşivler	Noun
cephelerimi	Noun
kraliçe	Noun
fitillerimize	Noun
ayın	Noun
güneşi	Noun
bamyasının	Noun
üçüzler	Noun
unutmayacağım	Verb
tipografimizde	Noun
kıblemizden	Noun
otomobillerden	Noun
omletlerimizin	Noun
şairler	Noun
gözlemciye	Noun
enstrümantaller	Noun
tarafımdan	Noun
senaryolar	Noun
katacak	Verb
hazırlık	Noun
sütyenler	Noun
ayrıldık	Verb
otelde	Noun
iskeletlerin	Noun
zeytinden	Noun
savaşlardan	Noun
kullanıcılarımızdan	Noun
üzüyor	Verb
kireçte	Noun
deneyimimi	Noun
yardımcısını	Noun
yazıtlardan	Noun
tercihlermişim	Noun
dizinden	Noun
dışkılarda	Noun
adamlarımdan	Noun
saklanır	Verb
vardık	Verb
çığlıklar	Noun
yardımcılığa	Noun
bermudamı	Noun
kovdurur	Verb
toplumumuzda	Noun
uzanırlar	Verb
kaçırır	Verb
ayırırız	Verb
hastalığa	Noun
harften	Noun
vahalara	Noun
kameran	Noun
koy	Noun
dolmuşunuzda	Noun
doğurur	Verb
boyadım	Verb
melodilere	Noun
kanlılıklar	Noun
çöpçatanlıklarımın	Noun
eğitimimi	Noun
düşmandan	Noun
vuruyoruz	Verb
simyanın	Noun
yarasalara	Noun
kusma	Noun
kopuyor	Verb
ebede	Noun
şaşılıyorum	Verb
gösterdik	Verb
sacın	Noun
pırasamızda	Noun
krizlere	Noun
çılgınlık	Noun
cemaate	Noun
dükten	Noun
ekonomistlerin	Noun
kullanmamıza	Noun
gökadaların	Noun
derlemelerde	Noun
astronotlar	Noun
takıyordu	Verb
çobana	Noun
günümüze	Noun
öğrencisine	Noun
fonksiyonda	Noun
ettirmedi	Verb
ermedi	Verb
bozalarımı	Noun
küvette	Noun
süzersin	Verb
tavuklara	Noun
öğretiler	Noun
sorusundan	Noun
bükülmesi	Noun
patlıyordu	Verb
kokusundan	Noun
lokantasında	Noun
uygulamalarımda	Noun
ritüel	Noun
keserim	Verb
bölgenizden	Noun
kalırım	Verb
ilâçlar	Noun
korkuluk	Noun
göbeğe	Noun
dudak	Noun
oyuncuda	Noun
seçeneklerde	Noun
maldı	Noun
kıroymuşsun	Noun
zangoç	Noun
kurbağalamada	Noun
yaratıyordu	Verb
lepistesimizden	Noun
zeval	Noun
mahzenime	Noun
okulumuzdan	Noun
perisine	Noun
yaratıklardan	Noun
psikiyatristi	Noun
çekirdekte	Noun
skrotum	Noun
yuvalarımızın	Noun
tozlardan	Noun
ritm	Noun
tarar	Verb
gözbebekleri	Noun
köpüklerimiz	Noun
öfkelendirir	Verb
asteroitler	Noun
çedarınızın	Noun
bilmeyecek	Verb
dakikalar	Noun
yapmıyorlar	Verb
meydanlardan	Noun
dilsizliğimizde	Noun
değiştirmedi	Verb
maldan	Noun
köpeklere	Noun
ortaklardan	Noun
sisteminizden	Noun
tandıra	Noun
yardımcısının	Noun
okudunuz	Verb
çizer	Verb
sevdi	Verb
gübrelerde	Noun
tatlısı	Noun
pozitronların	Noun
güneşlerin	Noun
çağırıyordu	Verb
dönmediler	Verb
kelebeklerde	Noun
almadık	Verb
mazotunuzda	Noun
tutulmaya	Noun
aradın	Verb
işlemez	Verb
yerime	Noun
lokması	Noun
haçlar	Noun
minber	Noun
bankta	Noun
kaltağınızı	Noun
üretir	Verb
dizeler	Noun
hedeflerde	Noun
yapması	Noun
netlerimi	Noun
mutfağa	Noun
parçasının	Noun
isyanda	Noun
patlıyor	Verb
dizin	Noun
özlemlerimde	Noun
karaciğer	Noun
dinozorlardan	Noun
kazanıyorum	Verb
kümenizde	Noun
siyasetçilerden	Noun
acıkmıyordunuz	Verb
melodileri	Noun
mikrofonda	Noun
söyleşi	Noun
sekmeler	Noun
bulunmuyorum	Verb
çubuklarımız	Noun
karıştırtırlar	Verb
köylülerimizi	Noun
halıların	Noun
güvenlerde	Noun
müracaat	Noun
azınlıkta	Noun
katılmadı	Verb
uğratılmıyorduk	Verb
kullanıcıymışım	Noun
şiirler	Noun
âlimdi	Noun
piyanosunun	Noun
arşivi	Noun
balalaykamı	Noun
amacıma	Noun
şarkıcısına	Noun
gönlüm	Noun
çalışmalarımızı	Noun
tahdit	Noun
devlerdir	Noun
düşmez	Verb
sitemde	Noun
mihraba	Noun
küçüklük	Noun
çarşaflarda	Noun
akvaryumlara	Noun
komikleşiyordunuz	Verb
deneyimlerimizden	Noun
dikişimize	Noun
diler	Verb
cisimde	Noun
yerimize	Noun
karıştırtmayacaksın	Verb
sirkten	Noun
çapan	Noun
paşadan	Noun
kimlikten	Noun
kesiyorum	Verb
değişirim	Verb
ilkeyi	Noun
aktörden	Noun
çıkıyoruz	Verb
musonları	Noun
atışırlar	Verb
yıktınız	Verb
dişlek	Noun
konusun	Noun
kosinüs	Noun
sapıklık	Noun
kuzuymuşum	Noun
vaziyette	Noun
portakalınızı	Noun
sürgünler	Noun
üyeliğe	Noun
üşeniyorum	Verb
kimliğimiz	Noun
yoksullaştırmadık	Verb
kereviz	Noun
mikrofondan	Noun
ölçüşmeyeceğiz	Verb
tariflerde	Noun
türedi	Verb
mıknatıslarda	Noun
şüphelerimi	Noun
sporculardan	Noun
yayıncılığa	Noun
savaşçılarımız	Noun
doktrin	Noun
merdivenlerde	Noun
cemaatlere	Noun
algoritmasının	Noun
fikirlerimizden	Noun
kategorisinde	Noun
sayfama	Noun
televizyondan	Noun
gizlendi	Verb
yalıtımlarda	Noun
koşulmadık	Verb
başkentten	Noun
ailelerin	Noun
tütüncülerinizi	Noun
taksilerde	Noun
görecek	Verb
şaşırttırmazsınız	Verb
kızgınım	Adjective
kuvvetliliklerinizin	Noun
dileklerimi	Noun
kaçırıyor	Verb
topçulara	Noun
teorim	Noun
rehineymişler	Noun
kaldın	Verb
kullanıyorsunuz	Verb
çadırdan	Noun
uzandılar	Verb
itilir	Verb
üzüm	Noun
yuvarlamıyorduk	Verb
hastalandı	Verb
çiftlikte	Noun
şamdan	Noun
şampiyonda	Noun
üyesine	Noun
lavaş	Noun
kodu	Noun
sızmaz	Verb
üzüme	Noun
işkencecileriniz	Noun
seslendi	Verb
sahne	Noun
karıştırıyordu	Verb
donmaya	Noun
alkolleri	Noun
batıyor	Verb
orospulardan	Noun
duruyorlar	Verb
yürekleri	Noun
gözlemciyi	Noun
dönüşlerden	Noun
modanızda	Noun
birliktelikler	Noun
izliyorum	Verb
konseyleriniz	Noun
kutsallık	Noun
cisimlerdir	Noun
yanlışım	Adjective
güvercinimde	Noun
içkilerde	Noun
titreşimi	Noun
klarnete	Noun
pop	Noun
sağrısı	Noun
ısırıktan	Noun
anlatmazsın	Verb
zarfları	Noun
ninniydim	Noun
ulamlarınızdan	Noun
kovada	Noun
yenilecek	Verb
mermilerdin	Noun
dakikaya	Noun
söyleşisinde	Noun
sarımsaklar	Noun
noktasında	Noun
tercihe	Noun
mutluluk	Noun
kategorilerde	Noun
edatı	Noun
keseye	Noun
anarşiye	Noun
merkezin	Noun
fazlalıkları	Noun
bisiklette	Noun
uğratılır	Verb
çekirdeklere	Noun
diliyordu	Verb
takılarmışım	Noun
çağırıyorum	Verb
külahlara	Noun
ölümsüzleştirmeyeceksin	Verb
sayfaydı	Noun
yeniliyor	Verb
dehşete	Noun
sinagoglar	Noun
izleyicisine	Noun
kuramdan	Noun
parçalanır	Verb
hazırlar	Adjective
aşiretlerden	Noun
modelden	Noun
savunmuyor	Verb
saçlarda	Noun
vilayetimi	Noun
nosyonumun	Noun
çavuşlarımın	Noun
cephesi	Noun
seyretirsiniz	Verb
varoşlar	Noun
açtılar	Verb
kapasiteyi	Noun
duyacak	Verb
yaratıklar	Noun
animasyonlar	Noun
mesafeden	Noun
okumadı	Verb
çukurun	Noun
kraliçeleri	Noun
şairlere	Noun
vuruyorum	Verb
aynasızlarımıza	Noun
baharlar	Noun
sonra	Noun
pazı	Noun
ramazanlarımızdan	Noun
vikipedistlerdir	Noun
başardı	Verb
kazanda	Noun
birlikteliklerimizde	Noun
yörüngelerde	Noun
sınıflar	Noun
ördeğime	Noun
camilerden	Noun
döndü	Verb
seyis	Noun
ablasından	Noun
vilayetlere	Noun
örneklerimiz	Noun
elçisini	Noun
işlevlerde	Noun
kromozoma	Noun
sorudan	Noun
çevirmediler	Verb
delikler	Noun
ittiriliyorsun	Verb
kaynaştırtacağız	Verb
mısrayı	Noun
ütüleriz	Noun
hukuka	Noun
şüpheyi	Noun
atıldılar	Verb
yağlıyordum	Verb
şehvetlerde	Noun
saçlara	Noun
yuvanızın	Noun
bağlamam	Verb
bakmanı	Noun
ilginçmiş	Adjective
güveniyorlardı	Verb
patenlerde	Noun
sitelerde	Noun
ayçiçeği	Noun
ağlama	Noun
yağmur	Noun
buldular	Verb
pırasanız	Noun
sonuçlardan	Noun
mustatillerimizin	Noun
helikopterlere	Noun
kartpostallar	Noun
şikayeti	Noun
şüpheleriniz	Noun
incir	Noun
tanışırsın	Verb
sunucuda	Noun
evrenler	Noun
televizyonlardan	Noun
dervişlere	Noun
incim	Noun
perdeler	Noun
dirsekten	Noun
paradokslara	Noun
kediye	Noun
kirazıma	Noun
mektuplarda	Noun
yetkisine	Noun
bağlara	Noun
heykelciklerimizi	Noun
yarışmamızda	Noun
kurbağamdan	Noun
basmıyorsunuz	Verb
salon	Noun
aşıksın	Noun
tanede	Noun
bulunmuyordu	Verb
odacıkları	Noun
izleyiciyi	Noun
ölür	Verb
avcısına	Noun
kardeşimizin	Noun
zibidilerimin	Noun
kılıca	Noun
astronotlara	Noun
minberlerimin	Noun
dövüşçüsü	Noun
sis	Noun
gülmedim	Verb
gecemizi	Noun
geçmeme	Noun
suallerim	Noun
salıncakta	Noun
ettirdi	Verb
bekliyorsun	Verb
günlüğünüze	Noun
milyonerlerimizden	Noun
gecelere	Noun
yapılarda	Noun
ojelerimizin	Noun
gondolumdan	Noun
sosluğa	Noun
yaratmasından	Noun
tütsüyü	Noun
nişanlıyı	Noun
çoraplarda	Noun
odadan	Noun
lastiğe	Noun
duruyor	Verb
prototiplerin	Noun
sığıyor	Verb
fizikte	Noun
davranışa	Noun
okudu	Verb
atomlarda	Noun
kullanmaya	Noun
alfabeleri	Noun
erimesi	Noun
otelden	Noun
istemedi	Verb
çöküyor	Verb
lehçelere	Noun
kedilerden	Noun
yarımadasından	Noun
sayfasından	Noun
kiliselere	Noun
güz	Noun
ilettiler	Verb
votkalarmışız	Noun
şikayetlere	Noun
geriden	Noun
korsemizden	Noun
torunlarımıza	Noun
ritimler	Noun
çetelerden	Noun
mısıra	Noun
vermiyorsun	Verb
övgüden	Noun
şovlara	Noun
cesette	Noun
üyeliklere	Noun
saçımı	Noun
cücelerde	Noun
bürokratı	Noun
maestro	Noun
dövüyordu	Verb
limondan	Noun
bıkar	Verb
gazetesi	Noun
gruba	Noun
uyuşturucular	Noun
düzeldi	Verb
etlere	Noun
çalışmanı	Noun
yumurtalara	Noun
günlükte	Noun
aldı	Verb
heyetten	Noun
nedende	Noun
merdiven	Noun
sululuklarımız	Noun
kılkapanlarımdan	Noun
dişimizde	Noun
almadı	Verb
veriden	Noun
hamak	Noun
hazırlığa	Noun
jöle	Noun
maymuna	Noun
düzeltiriz	Verb
kanmayacağız	Verb
amaçlara	Noun
çıkmaz	Verb
depresyona	Noun
iskelette	Noun
sesleniyoruz	Verb
doğurmaz	Verb
klavyesinde	Noun
nargilesi	Noun
başkanlardan	Noun
yastığıma	Noun
armudun	Noun
teşhirim	Noun
reçelleri	Noun
bacıymışım	Noun
develeri	Noun
düşmanda	Noun
iyileştirdi	Verb
konudan	Noun
vazolarda	Noun
boynun	Noun
nüfusa	Noun
kusmanızın	Noun
döndürdü	Verb
Kürtün	Noun
döktün	Verb
götürmeyecek	Verb
uzanıyordu	Verb
düşesin	Noun
hazinenin	Noun
sözcük	Noun
uçurtmam	Noun
bulunuyorum	Verb
piramitte	Noun
ipeğe	Noun
defterden	Noun
sızdı	Verb
yarışlar	Noun
aygıtçıklara	Noun
ofise	Noun
çıkarıyorum	Verb
mazgal	Noun
değişkenlerden	Noun
temsilciliğe	Noun
deney	Noun
kasımda	Noun
davrandılar	Verb
keşkeğiniz	Noun
çalacak	Verb
geometriler	Noun
fakülteden	Noun
ağaçlara	Noun
balığa	Noun
krizden	Noun
kaldırımda	Noun
iblislerden	Noun
nenesi	Noun
prototiplemelerimden	Noun
sürtüklerimde	Noun
işletmeye	Noun
yağlayıcı	Noun
kamerasından	Noun
kaçırdım	Verb
boşandı	Verb
caminde	Noun
başaracağız	Verb
kakıyorsun	Verb
bedevilerdiniz	Noun
tuşlarda	Noun
açlıkta	Noun
vazodan	Noun
eğlendik	Verb
atılmıyor	Verb
çıkmam	Verb
çokgeni	Noun
çipte	Noun
saldırdı	Verb
sıralamasının	Noun
sayfanda	Noun
saca	Noun
bükmememde	Noun
içki	Noun
aşım	Noun
kadayıfı	Noun
fonksiyonlara	Noun
saatlerden	Noun
sekreterler	Noun
övgüye	Noun
şeylerden	Noun
kategorilerimi	Noun
otomobilcin	Noun
şatoda	Noun
geçmeyecek	Verb
menteşeler	Noun
başarıyor	Verb
dükkânlardır	Noun
kurt	Noun
kolaylıklarınızdan	Noun
üçlüler	Noun
elmaya	Noun
teğet	Noun
dediler	Verb
istatistikten	Noun
kapatırlar	Verb
adamım	Noun
dövüş	Noun
beldesinden	Noun
öldürecek	Verb
yıpratmayacaklar	Verb
attırdı	Verb
kötüleştirirler	Verb
atılıyoruz	Verb
sayımda	Noun
tarif	Noun
vitrinler	Noun
bilmezsin	Verb
çevrelere	Noun
ipime	Noun
yapılara	Noun
etiketlerime	Noun
kıyafetten	Noun
kutulara	Noun
oyunculuk	Noun
kedilerimden	Noun
savaşım	Noun
çalışmaz	Verb
ağaçkakan	Noun
faresinde	Noun
yetmez	Verb
papazlara	Noun
tanen	Noun
pencerelerde	Noun
erimesini	Noun
camisine	Noun
patlıcandan	Noun
kumandalarınıza	Noun
kırar	Verb
küremedi	Verb
kristale	Noun
girecek	Verb
kullanırız	Verb
rahatsızlanır	Verb
vaden	Noun
kıskanıyor	Verb
pusulaymışsınız	Noun
cümleni	Noun
körfez	Noun
cihazlarda	Noun
oturdum	Verb
kurudu	Verb
unuttum	Verb
minderler	Noun
deriyorsun	Verb
yangınız	Noun
Kürt	Noun
yazıyorlar	Verb
hocamıza	Noun
küvetimi	Noun
sayfalarımda	Noun
üstverileriz	Noun
imamdan	Noun
uyarır	Verb
süspansuarlarımın	Noun
albümlerde	Noun
ilişkiye	Noun
değiştirir	Verb
gelmezler	Verb
eksenlerden	Noun
karıştırtmayacağız	Verb
yağlayıcımızdan	Noun
okul	Noun
hücresi	Noun
silmiyor	Verb
mukavemetlere	Noun
kip	Noun
mısra	Noun
kırılacak	Verb
hastanesinin	Noun
objeden	Noun
sayfanızdan	Noun
türemiyordu	Verb
tırtılın	Noun
peskütanımıza	Noun
yasayı	Noun
sözlükte	Noun
umduk	Verb
başvurunuz	Noun
efsunum	Noun
konar	Verb
biliriz	Verb
geçiyoruz	Verb
vampire	Noun
öyküye	Noun
sözleşmesini	Noun
acelecilik	Noun
şafak	Noun
damatlarınızın	Noun
emmimden	Noun
yıkmıyorsunuz	Verb
kat	Noun
peniste	Noun
fikrimiz	Noun
ittirtilmedi	Verb
geliştirdim	Verb
ketçaplarınız	Noun
yarada	Noun
ankete	Noun
bilgin	Noun
vahalarda	Noun
canlandırılmayacaksınız	Verb
çarpımda	Noun
kameranı	Noun
ellemiyorum	Verb
köylüde	Noun
helikopterler	Noun
kıyamete	Noun
hocama	Noun
derecelere	Noun
kerpiçler	Noun
katlara	Noun
bağlamaz	Verb
galaksilere	Noun
derecesinin	Noun
elektromanyetizmada	Noun
sınırlarınız	Noun
serer	Verb
saatlere	Noun
gözbebeğini	Noun
değilde	Noun
ibneyiz	Noun
tacizin	Noun
yayaya	Noun
içmiyorum	Verb
yetmiyordu	Verb
söyleşimi	Noun
odası	Noun
artıklar	Noun
gezerim	Verb
geziyor	Verb
tabelaları	Noun
topları	Noun
muhalefete	Noun
kullanımımız	Noun
kolonyalarsın	Noun
masalarımdan	Noun
emniyete	Noun
karakterimiz	Noun
vidası	Noun
psikoterapisi	Noun
kâse	Noun
beklemez	Verb
jelatinlerime	Noun
mevsimlere	Noun
bükülmesini	Noun
yörüngeyi	Noun
birleşiyorduk	Verb
doğurdu	Verb
fazlalıklar	Noun
önümüzde	Noun
patlarlar	Verb
gördüm	Verb
istedi	Verb
temizliyordu	Verb
yersiniz	Noun
birleşmesi	Noun
krep	Noun
katildik	Noun
öykülere	Noun
programlandı	Verb
destanlarda	Noun
kalından	Noun
verilir	Verb
üzdün	Verb
gruplara	Noun
sürücülerde	Noun
dişleklikler	Noun
kuşlar	Noun
yavrusu	Noun
karakoldan	Noun
kanmıyor	Verb
ağamızın	Noun
işçisinin	Noun
üre	Noun
varmıyor	Verb
kırıtmazlar	Verb
balkanlarımızda	Noun
çıkardın	Verb
koltukların	Noun
öper	Verb
mendile	Noun
atılmadı	Verb
süzme	Noun
işçisini	Noun
göçer	Verb
kıyımda	Noun
tepti	Verb
sevmiyorum	Verb
vereceksiniz	Verb
desende	Noun
umuyor	Verb
ettiriyor	Verb
polinom	Noun
anafaz	Noun
faks	Noun
heceye	Noun
yapmamızı	Noun
bildi	Verb
asitlerden	Noun
boklarıma	Noun
öptük	Verb
yaralarınıza	Noun
ateşlerimizden	Noun
tüter	Verb
kolikalarımın	Noun
saksafon	Noun
durdular	Verb
kapısı	Noun
kılıçlardan	Noun
hikâyelere	Noun
unuturum	Verb
hızınızı	Noun
odalarda	Noun
pusulalarda	Noun
yarışlara	Noun
faresinin	Noun
cephelerde	Noun
alkolden	Noun
benzeyecek	Verb
tarttın	Verb
badana	Noun
sıçanınızdan	Noun
takım	Noun
notları	Noun
çözeltilerimizi	Noun
alevdin	Noun
tiplerde	Noun
hazırdılar	Adjective
kaçmayacak	Verb
kafatasının	Noun
enstrümanda	Noun
öküzlere	Noun
omurgayı	Noun
dansçıdan	Noun
küçüktü	Adjective
üyeliğim	Noun
klorofilin	Noun
eklersin	Noun
kalesine	Noun
ketçap	Noun
götürmedi	Verb
etkileriz	Verb
orospudan	Noun
huni	Noun
nosyon	Noun
kaşlar	Noun
hayırseverlerdik	Noun
fotoğraflarınızı	Noun
mevkisinin	Noun
kısacağız	Verb
cenuplarımıza	Noun
fillerinizde	Noun
mobilyalar	Noun
direkmişsin	Noun
bulduk	Verb
tuvaletten	Noun
saksıda	Noun
üyelerimiz	Noun
toplumlara	Noun
anketler	Noun
şerbetçiliğimize	Noun
urlara	Noun
göreceğiz	Verb
cevherde	Noun
kullanmasında	Noun
çeteye	Noun
tıkladım	Verb
çalışmazlar	Verb
burunlar	Noun
şemsiyesinin	Noun
tercümeler	Noun
müzisyenler	Noun
oynatıcılarda	Noun
askerden	Noun
açılır	Verb
boğazlara	Noun
prensipler	Noun
çıpa	Noun
öncelik	Noun
yarışmalar	Noun
leblebisi	Noun
paylaşıyor	Verb
çizgiyi	Noun
mumyayı	Noun
eniştesi	Noun
soslarda	Noun
izolasyonumdan	Noun
fakültesinin	Noun
videoyu	Noun
öğretisini	Noun
görüşlerinizin	Noun
bağırsağa	Noun
yarış	Noun
minareme	Noun
finallerde	Noun
kuvantum	Noun
çadırlar	Noun
yapımcılara	Noun
köylüsünü	Noun
gelmezsin	Verb
dönüşünüzde	Noun
aşkta	Noun
düğmelere	Noun
yüzeyden	Noun
yapmayacağım	Verb
nükleotitleri	Noun
dokuzgenlere	Noun
sarhoşluktan	Noun
anlatacak	Verb
müşterileriniz	Noun
pusulası	Noun
sanatçıda	Noun
kabuğa	Noun
bitiriyorum	Verb
benziyorlardı	Verb
fiiller	Noun
varmadı	Verb
elipslerimizin	Noun
eziyorsun	Verb
maratoncun	Noun
sunulurlar	Verb
aile	Noun
bölgesine	Noun
merkezden	Noun
sayfanı	Noun
dikkatinizi	Noun
ilaçlarda	Noun
soğuyacaksınız	Verb
müzikalde	Noun
mevkinden	Noun
biçimlerde	Noun
kırarım	Verb
pipetlerimize	Noun
uyanacak	Verb
dışımızda	Noun
polislere	Noun
şarkıcılığa	Noun
günahkârda	Noun
haritasında	Noun
öneriyi	Noun
dolaplardan	Noun
bıyıklarınızdan	Noun
temsilcinizin	Noun
kıla	Noun
fiile	Noun
saçlardan	Noun
saymadım	Verb
çalışmıyordu	Verb
çökertilerinizden	Noun
amcamın	Noun
karıncalara	Noun
giysilere	Noun
otostopçulardınız	Noun
öğrenciydik	Noun
oylara	Noun
oynadık	Verb
sagasına	Noun
atoma	Noun
içgüdüsünün	Noun
gülmedi	Verb
çıkmaların	Noun
aşmayacak	Verb
sorularımıza	Noun
kastı	Verb
yuvasına	Noun
bildiriyorum	Verb
arayüzler	Noun
dedikodu	Noun
kontese	Noun
kuğuyduk	Noun
değirmen	Noun
bulgurlarınıza	Noun
fikirde	Noun
eşyasının	Noun
aşiretlerde	Noun
bildim	Verb
gökkuşağında	Noun
bombanda	Noun
düldülümden	Noun
zam	Noun
başkandı	Noun
çığırtkanımız	Noun
çokdilliliklerimizin	Noun
gollerden	Noun
yağması	Noun
işçiyi	Noun
marulumun	Noun
mevzusunda	Noun
konseyler	Noun
meyhaneye	Noun
sıvılaştırırım	Verb
çiziyordu	Verb
kanamıyordum	Verb
görüşümden	Noun
duymamalarınızın	Noun
bekliyorsunuz	Verb
kesesinde	Noun
teşhisten	Noun
kalbimde	Noun
artık	Noun
ortadan	Noun
tayfasının	Noun
tuşların	Noun
yoldaşa	Noun
zorluğun	Noun
ayakkabıymışsın	Noun
kapamıyordunuz	Verb
kanamam	Verb
bombalar	Noun
ayrılmazlar	Verb
sökmüyorum	Verb
işgücünden	Noun
futbolcusunun	Noun
zulme	Noun
çıpalar	Noun
ürünümün	Noun
geometride	Noun
sürüyorum	Verb
fizikten	Noun
ayağımı	Noun
sıvılaştırıyordum	Verb
silkmiyordunuz	Verb
ağlamadan	Noun
ilerisi	Noun
yaklaşmazlar	Verb
temsilcisinde	Noun
kaleden	Noun
sıvılaştırmıyor	Verb
diri	Adjective
taşımıyordu	Verb
kispetlerimizde	Noun
bahtı	Noun
barış	Noun
civcivleri	Noun
vuruyorlardı	Verb
gösteriyordum	Verb
mısırda	Noun
yedirmiyorum	Verb
pipimize	Noun
televizyonlara	Noun
şizofreniyi	Noun
bardaklara	Noun
göstermem	Verb
çıpalarımız	Noun
kocasını	Noun
adınıza	Noun
iletiyi	Noun
aletten	Noun
toplumumuzun	Noun
fizikçiye	Noun
kireçlerime	Noun
kuzusu	Noun
yavşağınız	Noun
doğuda	Noun
çevreyi	Noun
uydusu	Noun
kanıtlıyor	Verb
bakmamız	Noun
dedikodulardan	Noun
dalağa	Noun
sürüsünün	Noun
kullanırım	Verb
sözcükte	Noun
meşelerinizin	Noun
sönmem	Verb
müzisyene	Noun
ölülere	Noun
terörizmi	Noun
karılardık	Noun
yaratıyorlardı	Verb
kırılırsın	Verb
geçindi	Verb
rehinelermişsin	Noun
kokarca	Noun
kayağa	Noun
ülkeniz	Noun
ustadan	Noun
sekmiyordu	Verb
amcasının	Noun
okurum	Verb
hikâyeyi	Noun
fikirlerimi	Noun
toplumlardan	Noun
karnende	Noun
dururlar	Verb
buton	Noun
ulusumuzun	Noun
canlandırması	Noun
oylar	Noun
doktordu	Noun
faresi	Noun
evrenlere	Noun
yapmamız	Noun
sitesinden	Noun
ayırıyoruz	Verb
kıyısına	Noun
kovboy	Noun
şaşırdık	Verb
konunda	Noun
kullanıcısın	Noun
kâinat	Noun
yakışıklı	Adjective
koordinatlarda	Noun
koleksiyonlar	Noun
bacılarınızda	Noun
yakınmış	Noun
üne	Noun
bakana	Noun
yayıyordu	Verb
ısırığa	Noun
kravatlarım	Noun
eziyor	Verb
tatbik	Noun
yarımadasında	Noun
dizisinin	Noun
içeceğe	Noun
bürokrasiye	Noun
anlatmıyor	Verb
geyikler	Noun
yağı	Noun
fiil	Noun
sıralamasından	Noun
küpeler	Noun
gişe	Noun
maskeye	Noun
mikroorganizmayı	Noun
annelerde	Noun
volkanlardan	Noun
gagaları	Noun
avukatlarınızın	Noun
ayırmam	Verb
öykülerimizde	Noun
işçisi	Noun
ölüyorlar	Verb
sosislilerim	Noun
kayıtlar	Noun
yapacağım	Verb
hırsızlardan	Noun
eylemlere	Noun
gezdiler	Verb
kirpikleri	Noun
kurutur	Verb
okuyorlar	Verb
bitmelerimize	Noun
yaratması	Noun
uykuları	Noun
anlatırlar	Verb
demez	Verb
çizmecilermişiz	Noun
kumanıza	Noun
balkanlardım	Noun
malta	Noun
bakandan	Noun
otlara	Noun
tutulmam	Noun
parmaktan	Noun
senaryosunu	Noun
ayarlattırıyordun	Verb
üzülmez	Verb
taksilerimden	Noun
yakanız	Noun
teorisi	Noun
şaşırmadım	Verb
uygulaması	Noun
barışmıyoruz	Verb
bamyamda	Noun
çürüdü	Verb
aşacak	Verb
homoseksüellerimize	Noun
öğretisine	Noun
bitmedi	Verb
katillerdin	Noun
pastası	Noun
cümlenizde	Noun
bulunurlar	Verb
çadırlarda	Noun
gençlikten	Noun
aşmayacağız	Verb
embriyosunda	Noun
silgime	Noun
kızdı	Verb
sonumuz	Noun
işlemciden	Noun
sihirbazlar	Noun
uygulamasında	Noun
kesesine	Noun
kayıklardan	Noun
bürokratlar	Noun
dünürümüzde	Noun
görüşleriniz	Noun
kamerası	Noun
moleküle	Noun
şeftaliler	Noun
aşçılarımın	Noun
yedekte	Noun
oğlancıymışsınız	Noun
dinlenmememizi	Noun
kırbaçlardan	Noun
kapatırım	Verb
deneyler	Noun
ekimin	Noun
bağırsaklarda	Noun
bakmaya	Noun
oyumun	Noun
öğütücüm	Noun
yapımcıların	Noun
kurbağası	Noun
listeyi	Noun
şeydi	Noun
içerler	Verb
tadım	Noun
sekmede	Noun
sebebimin	Noun
dövüşür	Verb
varoş	Noun
benzerdi	Noun
ormanlarımızın	Noun
yanlışlıklar	Noun
köylülerimiz	Noun
çorbaya	Noun
yumuşakçalarımızda	Noun
somlar	Noun
taykonotsunuz	Noun
boksa	Noun
tecrübesi	Noun
tercümelere	Noun
strüktürlerinize	Noun
yetiştirirler	Verb
diyeceksin	Verb
doğadan	Noun
sıvıların	Noun
şimşek	Noun
yıkamıyor	Verb
öğrencileriz	Noun
sunumu	Noun
sildi	Verb
hikaye	Noun
dişlere	Noun
oyunuzu	Noun
buluştu	Verb
ikizden	Noun
yörüngede	Noun
dindarmışsın	Adjective
akbabayı	Noun
kelimesinde	Noun
hislerimiz	Noun
avukata	Noun
parçacıklarda	Noun
şelalede	Noun
şaşırttırmayacağız	Verb
politikacılarda	Noun
kolalarınızın	Noun
konukların	Noun
erimemizde	Noun
menüsüne	Noun
yıldızdan	Noun
duymuyorlar	Verb
dernekten	Noun
silecek	Verb
hecesini	Noun
ilkede	Noun
yakanı	Noun
lokantalar	Noun
keşfettiler	Verb
kaldıracınızı	Noun
süpürgenin	Noun
porta	Noun
yapımcı	Noun
kumandalarınızı	Noun
isim	Noun
adamlar	Noun
paşayı	Noun
bayılması	Noun
ışıklar	Noun
helikopterin	Noun
notilusunuz	Noun
yalancılık	Noun
bekliyorlardı	Verb
şarkıcılardan	Noun
psikoterapimizi	Noun
veriliyor	Verb
korimbozlarda	Noun
geçmişim	Noun
uzunluğa	Noun
yarışlardan	Noun
kıyafetlere	Noun
çekiçler	Noun
vilayete	Noun
çalışmadı	Verb
çarşısında	Noun
okuyorsun	Verb
sözleşmenize	Noun
sönmüyor	Verb
bölümde	Noun
kitaplıkları	Noun
dönüşümde	Noun
düşünürüz	Verb
raporlarda	Noun
lastiklerde	Noun
vaziyete	Noun
yetenekliydi	Adjective
sıralamasında	Noun
odamız	Noun
yarışma	Noun
dinlenmemizde	Noun
gerekmiyor	Verb
savaşımın	Noun
rüyadan	Noun
oya	Noun
inanmıyorum	Verb
vaktimiz	Noun
derilere	Noun
kargaların	Noun
kıldı	Verb
sıvıları	Noun
kimliklerde	Noun
canlandırmasını	Noun
sezer	Verb
bankasının	Noun
kullanıcılarımda	Noun
ciklet	Noun
sosyoloji	Noun
artıyordu	Verb
davranıyorsunuz	Verb
laboratuvarlarda	Noun
gereksinimlere	Noun
güreşçisi	Noun
alıyorlar	Verb
alta	Noun
verildi	Verb
kurbanların	Noun
sekmelerinizin	Noun
çatar	Verb
büyükmüş	Adjective
adenozinlerin	Noun
ördekler	Noun
çöllerden	Noun
kıçta	Noun
masalda	Noun
doktorlardan	Noun
davranırlar	Verb
sundu	Verb
sürülmedi	Verb
battaniyesi	Noun
kargaya	Noun
dövdü	Verb
alem	Noun
mıknatıslarınızın	Noun
jaguarı	Noun
içkilerin	Noun
hecelerde	Noun
şişlikler	Noun
yoruma	Noun
duvarlara	Noun
külodunuz	Noun
frende	Noun
fırınlara	Noun
DVD	Noun
girmiyor	Verb
veriliyorduk	Verb
şahım	Noun
lensten	Noun
gönlüme	Noun
ışınınızda	Noun
eksene	Noun
kıyılara	Noun
sarhoş	Noun
elektromanyetizma	Noun
bademden	Noun
guakamole	Noun
güttü	Verb
denizanaları	Noun
şişer	Verb
hindimizde	Noun
ayaza	Noun
dürbünlerde	Noun
şatosunda	Noun
buluştuk	Verb
üren	Noun
meyhaneler	Noun
eğdik	Verb
oldun	Verb
kipe	Noun
etkilemiyor	Verb
kullanıcılarda	Noun
enjeksiyonımda	Noun
büyüyecek	Verb
madamınızın	Noun
bölgede	Noun
notlar	Noun
beklemiyorum	Verb
piyanosuna	Noun
memesinden	Noun
korkuyorlardı	Verb
kumandalarımda	Noun
fişeklermişim	Noun
dökmedin	Verb
üzmez	Verb
mühendissin	Noun
taklitçisi	Noun
kertenkele	Noun
izolasyondan	Noun
ölçüşmem	Verb
kefir	Noun
patlamalar	Noun
durur	Verb
yüzeylerimin	Noun
günlerden	Noun
kazanıyordu	Verb
sporcusunun	Noun
mısrada	Noun
seçeriz	Verb
kozmonotlar	Noun
integraller	Noun
Yahudilerden	Noun
derecesini	Noun
siliyorsun	Verb
kestirmesini	Noun
ustasını	Noun
yaladın	Verb
rotorlar	Noun
diskotek	Noun
şirket	Noun
temsilciye	Noun
arttınız	Verb
seçerim	Verb
salahiyetten	Noun
bahçelerden	Noun
zorluklardan	Noun
bükülüyorum	Verb
ikiz	Noun
akışkanları	Noun
yapraklarda	Noun
netten	Noun
uyanırlar	Verb
sekmeden	Noun
tensör	Noun
kaderim	Noun
dinmez	Verb
durumunuz	Noun
listelerden	Noun
sihirliydin	Adjective
değiştirmem	Verb
anasonlarmışsın	Noun
bekleyecekler	Verb
düşerim	Verb
tercüme	Noun
panendeistinizde	Noun
balkanlara	Noun
karganın	Noun
yuvamı	Noun
yarışmalardan	Noun
dinliliğimize	Noun
çatacaklar	Verb
kanalı	Noun
pamuklar	Noun
dağıtımlarda	Noun
sevgiliyi	Noun
pedofobi	Noun
değişkenlere	Noun
vapurlarımıza	Noun
belirtmenin	Noun
hidratlar	Noun
deşer	Verb
kırıyor	Verb
kuramda	Noun
mumlar	Noun
çeyreklerin	Noun
sevenler	Noun
kırılırlar	Verb
odunun	Noun
ölüyorum	Verb
takatta	Noun
cennete	Noun
baklavalarımıza	Noun
kevgir	Noun
bağlıyorsunuz	Verb
sunucuyu	Noun
çalışıyorduk	Verb
kafatasına	Noun
kitabesinde	Noun
yetişiyorsun	Verb
homurtu	Noun
duyusu	Noun
çeyrekler	Noun
silmedik	Verb
oyuncaklardan	Noun
aşıklara	Noun
radarım	Noun
gidildin	Verb
ağaç	Noun
koymam	Verb
ürker	Verb
minaresini	Noun
hanımlardık	Noun
oyuncusunun	Noun
odağımızda	Noun
istiridyen	Noun
ofislerde	Noun
gelmesine	Noun
açmayacak	Verb
kullanışınızı	Noun
yataklarda	Noun
doktrinlere	Noun
zamanlara	Noun
silerim	Verb
soğuyacağım	Verb
bakıcısı	Noun
garsonlar	Noun
vilayetten	Noun
karakterinizi	Noun
develerin	Noun
duyacaksınız	Verb
gösteriyor	Verb
tandır	Noun
kireç	Noun
Musevisi	Noun
kumandaya	Noun
sureyi	Noun
kanunlar	Noun
evrenlerde	Noun
ayin	Noun
bölüme	Noun
evlilikler	Noun
kül	Noun
eşyalarımıza	Noun
devinime	Noun
yaratıkların	Noun
yaratırlar	Verb
parçacık	Noun
masallara	Noun
dönemlerde	Noun
kanunda	Noun
tanrınızdan	Noun
ölürsün	Verb
örtülerdin	Noun
kırdıracak	Verb
sekmesini	Noun
başkanımızın	Noun
fişeğimin	Noun
kanundan	Noun
kutunuzu	Noun
baharları	Noun
gölleri	Noun
duttan	Noun
meşalesini	Noun
eğmiyordular	Verb
vapurmuşuz	Noun
yaydılar	Verb
çevrelerde	Noun
bulmam	Verb
rüyanda	Noun
bulunuyordum	Verb
idadiden	Noun
hareketlilikler	Noun
katillerde	Noun
köpeklerin	Noun
goller	Noun
bilirsin	Verb
dövmediniz	Verb
azınlığı	Noun
ilimlere	Noun
kaçmaz	Verb
ütüsün	Noun
sağduyuyu	Noun
aynştaynyumlardan	Noun
bölgelerimizde	Noun
kıyametimizin	Noun
giyiyordu	Verb
dilimler	Noun
getiriyor	Verb
vidamızı	Noun
titreşim	Noun
konserden	Noun
albatros	Noun
çığlık	Noun
sakaların	Noun
kararlarda	Noun
büyümez	Verb
susuzluğa	Noun
hanımlara	Noun
trenlere	Noun
abazandım	Adjective
bulamıyor	Verb
modasını	Noun
soruna	Noun
uzunluklara	Noun
kirpilerde	Noun
mukavemet	Noun
bulunurum	Verb
yazmamız	Noun
isimi	Noun
inanıyorlar	Verb
duraklarız	Noun
futbolcuydu	Noun
şaştım	Verb
zeytinimin	Noun
depresyonlar	Noun
siteme	Noun
getireceğim	Verb
köpeği	Noun
kovdurtmayacaksınız	Verb
asansör	Noun
lordlarımda	Noun
sözdiziminden	Noun
işlemcisine	Noun
kesesinin	Noun
sakladılar	Verb
gülüşlerimin	Noun
şelalemize	Noun
onurunuzu	Noun
ilâçlarda	Noun
cindi	Noun
alınlarınız	Noun
iffetlerime	Noun
kullanıcılarımız	Noun
dağıttım	Verb
örtüsüne	Noun
ararsın	Verb
hahamınıza	Noun
halıları	Noun
şaşırtıyor	Verb
mallarız	Noun
dönüşümü	Noun
kararınızı	Noun
havuca	Noun
söner	Verb
ilerinde	Noun
yapraklar	Noun
popa	Noun
olumsuzluğun	Noun
işlevlerden	Noun
faremizin	Noun
moleküllerimize	Noun
hastalanır	Verb
kabukta	Noun
sunmaz	Verb
pabuçlar	Noun
yolculardan	Noun
yetkiden	Noun
paranoya	Noun
biner	Verb
derisinden	Noun
yuvam	Noun
geçmen	Noun
ayrıldı	Verb
yürek	Noun
hedeflerin	Noun
şahıslardan	Noun
bozmuyor	Verb
babalığı	Noun
karıştırmıyordum	Verb
gidilir	Verb
çalışmalarınızda	Noun
balalaykamızda	Noun
doktorlarız	Noun
mihrabım	Noun
soyluları	Noun
karsın	Noun
çevreleri	Noun
mikroplara	Noun
takıyor	Verb
salahiyet	Noun
lenslerin	Noun
omurganı	Noun
papalardan	Noun
yorumlar	Noun
defterimden	Noun
okullardan	Noun
kirletti	Verb
üretmezler	Verb
şoku	Noun
müşteride	Noun
karantinalardan	Noun
amaçlarımız	Noun
bulut	Noun
duvarlarınız	Noun
yırttık	Verb
işkencede	Noun
anlattı	Verb
bozdu	Verb
ortaklıklara	Noun
kaçtı	Verb
antropoloji	Noun
dağıtıma	Noun
belirtmeden	Noun
kullanıcımızın	Noun
boğazlarda	Noun
antioksidanlar	Noun
adınızı	Noun
sürümler	Noun
yorgunluktan	Noun
kaybolurlar	Verb
akısı	Noun
kullanma	Noun
sarımsaklarım	Noun
öpüşüyordu	Verb
makinalarıma	Noun
değiştirdim	Verb
lezbiyenimi	Noun
çarşaflar	Noun
mümessillikdik	Noun
sıyırır	Verb
maaşa	Noun
ayırdım	Verb
şiirde	Noun
büyüğüm	Adjective
dizilerden	Noun
psikologlar	Noun
kullanıyorduk	Verb
masaldan	Noun
totemlerden	Noun
hayvanı	Noun
bozan	Noun
bilgimizin	Noun
dublörüme	Noun
geçiyor	Verb
düzine	Noun
pompadan	Noun
uçaklarımın	Noun
sıcaklıklarda	Noun
değiştiriyoruz	Verb
ziyaretlerden	Noun
harflerden	Noun
ergenliğimi	Noun
oynuyorum	Verb
torunumuzdan	Noun
gölgeye	Noun
intikamlarda	Noun
yusufçuğa	Noun
geliştiler	Verb
kanatların	Noun
koyuyorlar	Verb
işkenceciliklerinizden	Noun
sakalar	Noun
geçiyorlar	Verb
teşkilatımızı	Noun
helvasından	Noun
yetkimde	Noun
ölümsüzlük	Noun
yorumlarınızı	Noun
bacakların	Noun
karmış	Noun
aileleri	Noun
kıyısından	Noun
wikiyi	Noun
karanlığı	Noun
yıpratır	Verb
barıştan	Noun
kattılar	Verb
alemde	Noun
hükûmetlerde	Noun
koymuyorsun	Verb
yetkisinden	Noun
çocukluğa	Noun
kimlikte	Noun
çerçin	Noun
istedim	Verb
bahçelerde	Noun
viskiymiş	Noun
terziydi	Noun
hayvanlar	Noun
ittirtmiyordu	Verb
görmezler	Verb
araçtan	Noun
birleşmeyi	Noun
bastırmasına	Noun
yardımcılıklarsınız	Noun
gelmeler	Noun
susamımızı	Noun
kullanmazlar	Verb
sahnesinde	Noun
pimsin	Noun
dalgalandırmıyordun	Verb
şelalenizden	Noun
kilisemize	Noun
cephede	Noun
yetecek	Verb
çetelerime	Noun
