irtaantua	None
rauhastulehduksilla	None
seuraajiksi	None
karkaistu	Imperative-Jussive
valotettiin	Indicative
tutustuin	Indicative
lumoa	Imperative-Jussive
puolustelkaa	Imperative-Jussive
supissette	Potential
kaareutuu	Indicative
espanjalaisiksi	None
tikahtuvat	Indicative
puolustautuvat	Indicative
loin	Indicative
tilallinen	None
kuullotetaan	Indicative
pysyivät	Indicative
kiinnity	Imperative-Jussive
syyhytettäköön	Imperative-Jussive
hämmentyy	Indicative
kulminoituivat	Indicative
kiristyy	Indicative
putsata	None
särissen	Potential
elokuvina	None
hämmästyttävät	Indicative
koittakaamme	Imperative-Jussive
rantautuivat	Indicative
koulukunnalla	None
valjastettiin	Indicative
pienenevät	Indicative
yhteismitallinen	None
upposi	Indicative
jumalanpalveluksesta	None
informoitiin	Indicative
ylenee	Indicative
pensasta	Imperative-Jussive
tutustuvat	Indicative
hurjastelit	Indicative
tiettyihin	None
juotettiin	Indicative
psykologisena	None
velo	Imperative-Jussive
joudutte	Indicative
kuuloluut	None
lällärit	None
pelastuvat	Indicative
huitaisee	Indicative
mielipidetiedustelut	None
läpivärjäsin	Indicative
pilkunviilaajissa	None
siirtävät	Indicative
megafoni	None
lakoissa	None
opetellen	Potential
hiippakunnalle	None
treenien	None
perittiin	Indicative
avautuivat	Indicative
kuviossa	None
hälveni	Indicative
kapeni	Indicative
pakottaa	Indicative
nokkakolarilla	None
tasoitettiin	Indicative
työntäisi	Conditional
lietsoi	Indicative
toipilaaksi	None
kaipaat	Indicative
hankaavat	Indicative
emissioisivat	Conditional
eriytyvät	Indicative
kunnostautui	Indicative
vuoropuheluja	None
paista	Imperative-Jussive
konekiväärin	None
seurusteli	Indicative
ammuskelivat	Indicative
vaikutat	Indicative
rutistakaa	Imperative-Jussive
sotkeutuvat	Indicative
materiaksi	None
siemenaihetta	None
hyllyttää	Indicative
hajautettiin	Indicative
energianlähteistä	None
matkasitte	Indicative
pitentänette	Potential
kavaltajitta	None
tapetti	None
muurasi	Indicative
pelottavat	Indicative
soveltuvuus	None
muulin	None
suositaan	Indicative
katsot	Indicative
eläköitynemme	Potential
selittävät	Indicative
kolmiviikkoisella	None
peittävät	Indicative
hukuttautuu	Indicative
pitäisimme	Conditional
armeniankieliseltä	None
lempi	Indicative
miellytti	Indicative
ylisti	Indicative
hapettaa	Indicative
orkidea	None
vajota	None
hidastetaan	Indicative
siivilöitynevät	Potential
tuuhentanevat	Potential
tyyntyy	Indicative
välisiksi	None
lueskeltaisiin	Conditional
sähkövarausten	None
tajuavat	Indicative
sidoksissa	None
läimäissee	Potential
tanskalta	None
lähimmille	None
pelasin	Indicative
polskuttavat	Indicative
määritä	Imperative-Jussive
viittasivat	Indicative
veloittaa	Indicative
spektrografialta	None
harmonistivat	Indicative
ladattiin	Indicative
turvautuu	Indicative
telien	None
piiloutuu	Indicative
ilmoittautuneista	None
sumunnette	Potential
bootattaisiin	Conditional
gynekofobioiden	None
huolestuu	Indicative
ionista	None
yllyttäneen	Potential
tunkeutui	Indicative
kasautuvat	Indicative
automatisoikaa	Imperative-Jussive
hukkaan	Indicative
täydennä	Imperative-Jussive
epäillään	Indicative
kirjoittelivat	Indicative
hahmota	Imperative-Jussive
orkesterisävellyksittä	None
lääkäriin	None
sävellettiin	Indicative
jäädytti	Indicative
urheilullisessa	None
paistoi	Indicative
eheyttää	Indicative
kuvailevat	Indicative
pidättäytyvät	Indicative
säveltänen	Potential
edullisimpia	None
näyteikkunassa	None
ylitti	Indicative
ilmiantaa	Indicative
osallistuttiin	Indicative
nöyryytti	Indicative
pohjaudu	Imperative-Jussive
historiallisina	None
arvioijana	None
isotooppia	None
tuhoutuvat	Indicative
vietiin	Indicative
heittelevät	Indicative
ruotsinsi	Indicative
heltoista	None
ratsastetaan	Indicative
harvennettiin	Indicative
mataloituvat	Indicative
vetäytyisi	Conditional
painostivat	Indicative
hävittäjälentokoneiden	None
vapautti	Indicative
suhtautuivat	Indicative
painostaa	Indicative
lunastivat	Indicative
pyöristyksestä	None
levittivät	Indicative
jonottavat	Indicative
booliin	None
keskusteltaisiin	Conditional
matkusti	Indicative
luksusta	None
vaihtoi	Indicative
yliarvostimme	Indicative
tankattiin	Indicative
kieliopillisen	None
lorauttanet	Potential
isoja	None
aktivistina	None
kosteisiin	None
toivottavat	Indicative
tervehti	Indicative
rastittiin	Indicative
sadattelemme	Indicative
kalastuksen	None
rykelmä	None
loistaa	Indicative
jouduin	Indicative
nimikirjoituksille	None
kerskailivat	Indicative
pysähtyisi	Conditional
kuumenevat	Indicative
vihjailee	Indicative
ennätti	Indicative
valokuvattiin	Indicative
ruokottaneen	Potential
päälliköksi	None
rutattakoon	Imperative-Jussive
arkistoitiin	Indicative
sonettia	None
selitettiin	Indicative
kukun	Indicative
identifioituu	Indicative
äänestää	Indicative
kuunnellee	Potential
jäsenmaista	None
työskennellään	Indicative
roikkui	Indicative
myönsivät	Indicative
veistää	Indicative
kopioiksi	None
öljyteollisuus	None
synnynnäiseksi	None
dubannut	None
kättelevät	Indicative
hetkutellaan	Indicative
palvottiin	Indicative
vastakohtina	None
nykyisiin	None
ehdotin	Indicative
tiedonsiirto	None
ujoiltiin	Indicative
luovu	Imperative-Jussive
majailevat	Indicative
osuttiin	Indicative
laulettaisiin	Conditional
sulkeutuvat	Indicative
hymyile	Imperative-Jussive
luovuttaa	Indicative
tyydytetään	Indicative
tyhjenivät	Indicative
lennätti	Indicative
peiteltäisiin	Conditional
eurooppalaista	Imperative-Jussive
empi	Indicative
muotoilisin	Conditional
muuntavat	Indicative
paukahteli	Indicative
kertun	None
kohahtelisin	Conditional
silvottiin	Indicative
diggaan	Indicative
häipyivät	Indicative
poistat	Indicative
paetkaa	Imperative-Jussive
turvapaikkaan	None
kieltäydyn	Indicative
jännittää	Indicative
viivästynette	Potential
poikkea	Imperative-Jussive
mahtaisi	Conditional
suistun	Indicative
kiirehdittiin	Indicative
kaipaisi	Conditional
kuulostaisi	Conditional
hatussa	None
työpaikasta	None
koneellistuit	Indicative
sopraanon	None
juonittelivat	Indicative
hypätään	Indicative
kuivinta	None
sirpaleiden	None
saavutti	Indicative
langetti	Indicative
täyteläisemmättä	None
ulkoasiainministerin	None
tilavuutta	None
aistii	Indicative
haukuttakoon	Imperative-Jussive
mutisee	Indicative
pakkona	None
huumataan	Indicative
elokuvaan	Indicative
hautausmailta	None
arvaisi	Conditional
ihailivat	Indicative
kiillottaa	Indicative
hirsitalon	None
syvensi	Indicative
tietorakenteen	None
agitaation	None
hermostuneen	None
pysäyttivät	Indicative
madallettiin	Indicative
peittää	Indicative
sertifioidut	None
sälli	None
vankkureilla	None
lyövät	Indicative
vankentaisivat	Conditional
jäsennetään	Indicative
koheni	Indicative
syyllistä	Imperative-Jussive
yhdistetystä	None
lahjoitettiin	Indicative
voihapon	None
hakusanaksi	None
huomauttivat	Indicative
levittää	Indicative
hyötyisi	Conditional
nimiteltiin	Indicative
pakastun	Indicative
kehutaan	Indicative
kävelylle	None
addisonismeilta	None
lämmittivät	Indicative
pelataan	Indicative
lankesivat	Indicative
juppiutuu	Indicative
steriloidaan	Indicative
halkoo	Indicative
siirtolaiset	None
hyväntekeväisyysjärjestöillä	None
esteri	None
haettaisiin	Conditional
hapettuvat	Indicative
nopeutuvat	Indicative
kannustettiin	Indicative
hyväksyisin	Conditional
perusteltaisiin	Conditional
yhteenvetoihin	None
akuutissa	None
ristesivät	Indicative
eli	Indicative
joi	Indicative
konservoitiin	Indicative
ostaisi	Conditional
laivastolla	None
poljen	Indicative
ohittavat	Indicative
polveutunee	Potential
ratkaisivat	Indicative
kuljetaan	Indicative
kansalliskielen	None
vaurioitui	Indicative
keskeyttää	Indicative
perustettiin	Indicative
asutettiin	Indicative
omistetaan	Indicative
perinteisille	None
onteloammuksella	None
alkeenien	None
levittyi	Indicative
varjostin	Indicative
koplasit	Indicative
ompelukone	None
mahdat	Indicative
sosionomi	None
koostuu	Indicative
lokalisoida	None
murtovarkaissa	None
hirnunnoilta	None
korjautuivat	Indicative
kelvollista	None
viikinkiajalla	None
kammonen	Potential
epidemiologioille	None
yllättävät	Indicative
pahoittelen	Indicative
suklaajäätelöjä	None
kyyti	Indicative
lämpene	Imperative-Jussive
pienene	Imperative-Jussive
kiistelivät	Indicative
kessuttakoon	Imperative-Jussive
kasaantuvat	Indicative
poltteitta	None
vanhurskautta	None
istuu	Indicative
yöpyivät	Indicative
laskee	Indicative
horkkasääsket	None
aikuistuu	Indicative
kaarsi	Indicative
niitattiin	Indicative
asialliselta	None
altistavat	Indicative
uudennan	Indicative
käsitetään	Indicative
emättimen	None
jahtaavat	Indicative
kiteydy	Imperative-Jussive
itkevät	Indicative
nauroi	Indicative
jäätänette	Potential
risottakoon	Imperative-Jussive
latkittaisiin	Conditional
karbokationin	None
entistä	Imperative-Jussive
virkataan	Indicative
vajoavat	Indicative
reaalista	Imperative-Jussive
mordvalaisen	None
keskilaiva	None
millaisista	None
kerrattiin	Indicative
tekoälyn	None
siivoa	Imperative-Jussive
luopuisivat	Conditional
irrottavat	Indicative
jyrkistyt	Indicative
suutu	Imperative-Jussive
haksahtanet	Potential
varustaa	Indicative
luikerra	Imperative-Jussive
sääskiä	None
kampuraksi	None
ruiskutetaan	Indicative
uskaltaisin	Conditional
modernisoidun	Indicative
siistitty	None
ruiskua	Imperative-Jussive
bioinformatiikka	None
tutkimustyössä	None
rantautui	Indicative
elektroniikan	None
samaistaa	Indicative
erotetaan	Indicative
fysiologisesta	None
afrikansuorotasta	None
protoplaneetalla	None
keräsi	Indicative
varautuu	Indicative
onnistu	Imperative-Jussive
konnanhaperosta	None
pojantyttären	None
lastasivat	Indicative
kotimaistaisin	Conditional
sietivät	Indicative
metsänhoitajaksi	None
viemäröity	None
tulvii	Indicative
valitin	Indicative
suojauduttava	None
lähensi	Indicative
käyttökelvottoman	None
pyylevöidyimme	Indicative
sulattavat	Indicative
haluttomuudesta	None
kykenen	Indicative
vääristellään	Indicative
häiriydymme	Indicative
lahjoita	Imperative-Jussive
tsekkaan	Indicative
löytyi	Indicative
pienentäisi	Conditional
hiukkasfyysikoille	None
kuvittaa	Indicative
vallankumouksena	None
koluavat	Indicative
segmentoitakoon	Imperative-Jussive
koostui	Indicative
sauvoo	Indicative
julkaisisi	Conditional
loivat	Indicative
siirrän	Indicative
kohdistuvat	Indicative
teloittivat	Indicative
häiritsi	Indicative
kiellettiin	Indicative
äännyn	Indicative
tasattiin	Indicative
hätäsavuineen	None
asteli	Indicative
metsästykseen	None
jyskittiin	Indicative
demokratisoitunee	Potential
päättelee	Indicative
tarkentava	None
patistele	Imperative-Jussive
eronneen	None
pelkistä	Imperative-Jussive
pahentua	None
houkuttivat	Indicative
karvonen	Potential
tuhoaisivat	Conditional
hyväksyn	Indicative
ansaitse	Imperative-Jussive
maharadžatta	None
murehtii	Indicative
kankeuttivat	Indicative
narsissi	None
parempaan	None
vaihdoin	Indicative
eksyttää	Indicative
haluttaisiin	Conditional
liitti	Indicative
patikoikoot	Imperative-Jussive
pestannemme	Potential
rikoksista	None
ekstaasi	None
menestyisivät	Conditional
sairastuvat	Indicative
selvitetään	Indicative
hyrskytään	Indicative
syljeksittäisiin	Conditional
mielikuvituksekkaine	None
pehmenin	Indicative
tyyntyi	Indicative
lumeamme	Indicative
vaihtaisi	Conditional
soraan	Indicative
sisältävät	Indicative
performanssin	None
velttouduttaisiin	Conditional
aloittaisi	Conditional
toteavat	Indicative
vajosi	Indicative
jollotettaneen	Potential
arvostettiin	Indicative
kupertunee	Potential
maisemakuvassa	None
kuulusteli	Indicative
kotiutti	Indicative
tahkoa	Imperative-Jussive
lokalisoidutaan	Indicative
standardoidut	Indicative
säpsähtäisit	Conditional
henkäilisin	Conditional
lataat	Indicative
lumoutuu	Indicative
läskit	None
takaraivoon	None
kapenee	Indicative
tutustuu	Indicative
miestapolta	None
piipahti	Indicative
mimmit	None
paksunisin	Conditional
ansaaseen	None
vääntävät	Indicative
artiklaa	None
kullasta	Imperative-Jussive
lyttäsivät	Indicative
haastattelen	Indicative
kannettavat	None
lähtee	Indicative
taittui	Indicative
hankaloituisin	Conditional
konsernit	None
ristikuulustellemme	Potential
kontrabassoa	None
totesivat	Indicative
mainosti	Indicative
peruuntuu	Indicative
kukkakauppias	None
unohtuu	Indicative
vuorottelevat	Indicative
bändin	None
poikkesivat	Indicative
nakertaa	Indicative
rokkaan	Indicative
puhelin	Indicative
laiskaa	None
pyrinnöstä	None
kytkivät	Indicative
jalkapalloliittoa	None
samanoinemme	Potential
huomautettakoon	Imperative-Jussive
keinun	Indicative
peipon	None
savettavat	Indicative
raivaavat	Indicative
suunnisti	Indicative
höllennettiin	Indicative
soutelisivat	Conditional
kulti	None
formaateilla	None
uudelleenjärjestelyä	None
risteytti	Indicative
heinäsuovaksi	None
ylettänet	Potential
ajankohtaista	Imperative-Jussive
realisoituisi	Conditional
nimisellä	None
täyttänee	Potential
madaltuu	Indicative
lyöt	Indicative
absorptiota	None
suominen	Potential
asusta	Imperative-Jussive
mestaroisi	Conditional
joikattaneen	Potential
rahoitettaisiin	Conditional
klovniksi	None
lastenhoidon	None
metropolialueesta	None
värjättiin	Indicative
koeajakaamme	Imperative-Jussive
ylistettiin	Indicative
vahvistui	Indicative
hukutetaan	Indicative
mekaniikasta	None
ahdistivat	Indicative
käynnistäisi	Conditional
parantaisivat	Conditional
sateenkaarikalatta	None
liuotin	Indicative
johtopäätösten	None
rahtasivat	Indicative
aasianpyhäiibiksiksi	None
kulttuurihistoriaan	None
turrutimme	Indicative
kehätie	None
ylikuumenisit	Conditional
aktivoitaneen	Potential
näkevät	Indicative
sulakkeet	None
yksityiskoulujen	None
paisuttaa	Indicative
gallup	None
lyhenee	Indicative
risiinikasvein	None
tunnetaan	Indicative
punin	None
perustelisi	Conditional
taisi	Indicative
maksimoidaan	Indicative
rajoitettiin	Indicative
astuivat	Indicative
pilkkouduitte	Indicative
sovittiin	Indicative
lueskellemme	Potential
kuristi	Indicative
uskalsivat	Indicative
torjuttiin	Indicative
natriumsulfaatteja	None
kreikkaa	None
lapan	Indicative
laantuu	Indicative
tanssittaa	Indicative
vaarantuisi	Conditional
tavuttakoon	Imperative-Jussive
sydämystytään	Indicative
tuhosivat	Indicative
haihdutetaan	Indicative
tiputetaan	Indicative
pyykkäämisineen	None
myönnät	Indicative
kiipesi	Indicative
selitin	Indicative
koitti	Indicative
rutistaa	Indicative
kuvittelen	Indicative
haastetaan	Indicative
salakuljetettiin	Indicative
lätkäisee	Indicative
tilataan	Indicative
neroutta	None
riisui	Indicative
kirjoittelee	Indicative
erottavat	Indicative
vaaleankeltainen	None
katsoi	Indicative
kliinisessä	None
ripotellaan	Indicative
ostivat	Indicative
lankea	Imperative-Jussive
näykki	Indicative
orgastisille	None
lyöttäytyvät	Indicative
pysäytti	Indicative
tuhopoltot	None
avasivat	Indicative
panttilainakonttoria	None
palele	Imperative-Jussive
rapautuvat	Indicative
jalkapalloa	None
niitit	Indicative
pyllistämme	Indicative
heijastettiin	Indicative
lisääntyivät	Indicative
käytän	Indicative
levitä	Imperative-Jussive
salakuljettaa	Indicative
hyväksyy	Indicative
fyysiselle	None
tarua	None
subjektivismi	None
ryyppäätte	Indicative
yhdistely	None
hadithin	None
liekitämme	Indicative
työstävät	Indicative
painottaisit	Conditional
nähtävyydeksi	None
sarjakuvalla	None
nojautuu	Indicative
mekanisoidun	Indicative
luhistuu	Indicative
tuotettiin	Indicative
tulkitsisin	Conditional
seikkailupelit	None
vuoda	Imperative-Jussive
kokoontunen	Potential
halua	Imperative-Jussive
näyttäytyvät	Indicative
yrittivät	Indicative
vanhentaa	Indicative
inhimillistyisit	Conditional
soittaa	Indicative
dokumenttien	None
neuvonpitoon	None
alennettiin	Indicative
laajensin	Indicative
linnoittaa	Indicative
tervehdykset	None
toimielimiä	None
definitiivisyyksistä	None
konsultaatioita	None
myydään	Indicative
nousin	Indicative
lepoaika	None
juontajan	None
miellyttivät	Indicative
turvallisuuspoliisi	None
rajoittavat	Indicative
kuluttaa	Indicative
moitti	Indicative
kylmään	Indicative
juuttuu	Indicative
aikalaiset	None
hiusharjoitta	None
muistokirjoitus	None
kakkospainikkeesta	None
suostukoon	Imperative-Jussive
sanoivat	Indicative
kytkeytyvät	Indicative
heitä	Imperative-Jussive
koskettaa	Indicative
ehtyivät	Indicative
huikaisisivat	Conditional
pahoinpitelyjä	None
heristyit	Indicative
platonismissa	None
miekkailee	Indicative
kromosomaalisena	None
asentaa	Indicative
rengasta	Imperative-Jussive
ryhdytään	Indicative
vuoteeseen	None
kalifaatissa	None
joutomaata	None
jyryä	Imperative-Jussive
alkaisivat	Conditional
kyse	None
pysäytettiin	Indicative
lahjokoot	Imperative-Jussive
kateellisina	None
jyrähtäisimme	Conditional
vaalitaan	Indicative
suojaisivat	Conditional
kohdellaan	Indicative
märkäiseltä	None
hidasti	Indicative
ripustaa	Indicative
tietynlaista	None
kirjoitutti	Indicative
vaikeutui	Indicative
vilisi	Indicative
paheen	None
leyhähti	Indicative
juoksen	Indicative
velvoittivat	Indicative
sopeutuvuuksille	None
kuunneltiin	Indicative
suosittelivat	Indicative
sävyttivät	Indicative
kannusta	Imperative-Jussive
inflaatiosta	None
häätää	Indicative
kiipeillen	Potential
spraymaalilla	None
portieeriltä	None
ruiskunnevat	Potential
hyväksyisi	Conditional
potkaissut	None
sponsoroidaan	Indicative
äänestäjien	None
säteilevät	Indicative
varjoa	Imperative-Jussive
trubaduureineen	None
kärryille	None
nokkela	None
päätyi	Indicative
rakastelee	Indicative
sakotti	Indicative
huomauta	Imperative-Jussive
veljeskuntaa	None
keskustelimme	Indicative
lamauttivat	Indicative
auttoivat	Indicative
takavetoisten	None
huipentui	Indicative
kaivertavat	Indicative
kohokohtana	None
kiekuu	Indicative
naureskeli	Indicative
pullotetaan	Indicative
vihtonen	Potential
natiiveitta	None
ilmoittaudun	Indicative
kao	Imperative-Jussive
lamaantunemme	Potential
ministereinä	None
jäsentyy	Indicative
koskettanette	Potential
pidetty	None
ylistävät	Indicative
haluaisi	Conditional
selittivät	Indicative
raikuvat	Indicative
muuttujiksi	None
keskikokoisten	None
jymäyteltäköön	Imperative-Jussive
esittely	None
hakeutuu	Indicative
jatkakaamme	Imperative-Jussive
pysähtynyt	None
hinaajaan	None
sijoittuvat	Indicative
pelästyvät	Indicative
kopsasimme	Indicative
löystyvät	Indicative
seikkaperäisyyksissä	None
kiemurteli	Indicative
fuusion	None
valikoidun	Indicative
huonone	Imperative-Jussive
puhui	Indicative
lakastuu	Indicative
vältä	Imperative-Jussive
tuoksut	Indicative
närkästytti	Indicative
huolsin	Indicative
erilaista	Imperative-Jussive
muutuin	Indicative
rockvideoihin	None
kehotin	Indicative
näkemyksen	None
purentavioista	None
ängelmät	None
kahleista	None
sinnittelivät	Indicative
oloon	None
lähetystä	None
alkakoot	Imperative-Jussive
sekalaisesta	None
raajarikoilla	None
prutkutatte	Indicative
kirjoittaisin	Conditional
huuhtoivat	Indicative
vanhuudesta	None
järjestämme	Indicative
sulautetaan	Indicative
allekirjoitti	Indicative
kuparisulfaatin	None
rakennusliikkeet	None
urkki	Indicative
paarman	None
ravistetaan	Indicative
avittaa	Indicative
muovipussiin	None
banaanitasavalta	None
alaraajan	None
ensiesitti	Indicative
sijoittuisi	Conditional
himmentää	Indicative
kansalaisjärjestöjä	None
hormonista	None
varaudu	Imperative-Jussive
heiluttavat	Indicative
yhteenliittymä	None
syytellään	Indicative
likaantuu	Indicative
siirtää	Indicative
juhlapuvulle	None
tukehdutti	Indicative
sirut	None
löysin	Indicative
pääjohtajana	None
kuumenee	Indicative
imisi	Conditional
määriteltiin	Indicative
työhuoneet	None
arvopaperistakaamme	Imperative-Jussive
suomalaisilla	None
patosi	Indicative
ratsiassa	None
hämmensivät	Indicative
puolaimeen	None
annoksen	None
johdattelee	Indicative
kirjoittuisin	Conditional
heikkenivät	Indicative
kerrostuu	Indicative
ankkuroida	None
vaikuttajista	None
aavisti	Indicative
virkistynevät	Potential
vastakkainasettelun	None
kaartuu	Indicative
jalkapalloilijat	None
heikentyy	Indicative
kadonneelle	None
otellen	Potential
pimahtakoon	Imperative-Jussive
juolahti	Indicative
yksiköitimme	Indicative
hotkittaisiin	Conditional
elvytetään	Indicative
mättää	Indicative
oopperalaulajista	None
pidellään	Indicative
ennättävät	Indicative
arvioisivat	Conditional
kiinnostunemme	Potential
kyntämme	Indicative
liitä	Imperative-Jussive
huomautan	Indicative
löyhenen	Indicative
parantolan	None
tanssitaan	Indicative
olympiaurheilijoista	None
myyvät	Indicative
tukahdutettiin	Indicative
pätkään	None
eliminoidaan	Indicative
syntyinen	None
linnoittivat	Indicative
tukialukseksi	None
multaannun	Indicative
sisäpuolta	None
luisu	Imperative-Jussive
mittelevät	Indicative
pituuksien	None
murtautuivat	Indicative
sisällyttävät	Indicative
kirjauduin	Indicative
ajoitettiin	Indicative
äänitti	Indicative
soveliasta	None
säilyköön	Imperative-Jussive
kasvamme	Indicative
poismenon	None
jauhoi	Indicative
vapautetaan	Indicative
folioisimme	Conditional
munalikööri	None
kajakki	None
trendejä	None
onnistunee	Potential
kiristyvät	Indicative
syötäisiin	Conditional
oletettaisiin	Conditional
ulkoilutti	Indicative
sijoitti	Indicative
yksinäisyydessä	None
kukoistivat	Indicative
sairastellen	Potential
melonnasta	None
tuiskutkoot	Imperative-Jussive
liioitellaan	Indicative
kehottaa	Indicative
anionit	None
yleishyödylliseksi	None
luotaan	Indicative
palsamointi	None
ryöväsi	Indicative
satyyrien	None
kannanottoja	None
uppopaistettu	None
täydentäisi	Conditional
puolsi	Indicative
tarjoutui	Indicative
kirkastaa	Indicative
huljahtanevat	Potential
häilyisimme	Conditional
katsastutti	Indicative
tuikkikaa	Imperative-Jussive
löysännemme	Potential
esittäytyvät	Indicative
hierotaan	Indicative
kiemursivat	Indicative
tihku	Imperative-Jussive
vieritti	Indicative
leikkipuistoa	None
vaikuttajana	None
väkivaltaisiksi	None
allekirjoittaisi	Conditional
relaatioiden	None
kevennyttäisiin	Conditional
puolustavat	Indicative
jättiläissaukko	None
muuta	Imperative-Jussive
metsäkaurisuros	None
löyhkät	None
lausuttiin	Indicative
laskettelitte	Indicative
kivettää	Indicative
suhtauduttiin	Indicative
sensuurit	None
koksiudumme	Indicative
hahmottelivat	Indicative
kirpputoreilta	None
tarkastelemme	Indicative
laajenisi	Conditional
levenevät	Indicative
viettivät	Indicative
kihartaisivat	Conditional
liitytään	Indicative
likensin	Indicative
mesoarkeeisiin	None
parantaisi	Conditional
tuota	Imperative-Jussive
kansion	None
kirjautuvat	Indicative
keskitysleireistä	None
vihdot	Indicative
lyhennettiin	Indicative
hirttää	Indicative
tiedusteli	Indicative
uusin	None
kukista	Imperative-Jussive
kulottuisi	Conditional
nelinkertaistakoon	Imperative-Jussive
tarkastaa	Indicative
kivertynevät	Potential
hyödyt	Indicative
syöpynee	Potential
pystytetään	Indicative
luetellaan	Indicative
hoitovirhein	None
lamaantuu	Indicative
pystyttävät	Indicative
hennot	Indicative
päällystivät	Indicative
havaittaisiin	Conditional
keskeytettäisiin	Conditional
kiiruhda	Imperative-Jussive
kietoutuvat	Indicative
ortodoksisiin	None
rakennuttivat	Indicative
lievenevät	Indicative
heikkeni	Indicative
avauksia	None
nuljahtavat	Indicative
laadullista	Imperative-Jussive
helmoissa	None
kustannetaan	Indicative
lehteri	None
erilaistumme	Indicative
differentiaalivaihteet	None
kuljetettiin	Indicative
haasteesta	None
kelkkailisi	Conditional
onnesta	Imperative-Jussive
värähteli	Indicative
osallisiksi	None
satuttaa	Indicative
sinnittelee	Indicative
haistelee	Indicative
valmistanut	None
koepaloja	None
uistin	Indicative
lakkautettiin	Indicative
hoikat	None
testaajan	None
teurastettiin	Indicative
toteutunutta	None
nousi	Indicative
bretagnelainen	None
nöyryyttää	Indicative
hedelmöittyvät	Indicative
kohoavat	Indicative
tarkoittavat	Indicative
kätkee	Indicative
viritettäköön	Imperative-Jussive
ratkaisevat	Indicative
vastustivat	Indicative
muokkautui	Indicative
nykyaikaistaa	Indicative
kuukautiset	None
irlantilaisia	None
varoin	Indicative
puutteisiin	None
pallokiveksi	None
toistivat	Indicative
sotilasmestareina	None
aravalainoitat	Indicative
rikastuttivat	Indicative
osoittauduttaisiin	Conditional
kiroili	Indicative
kulutan	Indicative
laskeutui	Indicative
reagoinut	None
veltostuttakaa	Imperative-Jussive
otsikoidaan	Indicative
päivysti	Indicative
tosikkoon	None
kirjoittaisivat	Conditional
halveksuu	Indicative
putoavat	Indicative
koruommellaan	Indicative
vilahti	Indicative
patenttinahalla	None
noki	Imperative-Jussive
jäähallien	None
jaotteli	Indicative
suvaitsevuuksina	None
karttuvat	Indicative
ulkomaan	None
tunkee	Indicative
juntattiin	Indicative
latkittaneen	Potential
samplataan	Indicative
pystyttää	Indicative
sävelsivät	Indicative
suosittavat	Indicative
purkaa	Imperative-Jussive
korottaa	Indicative
pestiin	Indicative
ideaaliseoksen	None
sodittiin	Indicative
salasi	Indicative
tarmoineen	None
havainnoinut	None
katsovat	Indicative
silmäsi	Indicative
uurtakaamme	Imperative-Jussive
ymmärtäisin	Conditional
kammosi	Indicative
aiheuttanee	Potential
galleriana	None
kasaat	Indicative
esikoisesta	None
valmistautuvat	Indicative
keskitymme	Indicative
poimuttakoon	Imperative-Jussive
valehdellaan	Indicative
saalistaa	Indicative
huijasivat	Indicative
tarkastelivat	Indicative
tarvittiin	Indicative
seuraisivat	Conditional
pahanlaatuisimpien	None
luomukset	None
nauhoittaa	Indicative
esiintymisessä	None
raukaiskaamme	Imperative-Jussive
vuosiluokkia	None
syvennytään	Indicative
laukoo	Indicative
rakastetaan	Indicative
soveltakaa	Imperative-Jussive
pohjoismaista	None
hyväksytti	Indicative
sondeeraan	Indicative
rumentukaa	Imperative-Jussive
panostetaan	Indicative
runsain	None
parasetamolin	None
verottavat	Indicative
keinosiemennys	None
alittaa	Indicative
myyjien	None
vieraile	Imperative-Jussive
pyyhkäissemme	Potential
irtisanotaan	Indicative
suri	Indicative
litistykäämme	Imperative-Jussive
ratsumiesten	None
kaavoittaisivat	Conditional
selvitin	Indicative
vieköön	Imperative-Jussive
ylläpiti	Indicative
murikoihin	None
voimistavat	Indicative
huokaile	Imperative-Jussive
harrastan	Indicative
luetteloidaan	Indicative
karpattakoon	Imperative-Jussive
reagoisi	Conditional
päihittivät	Indicative
tietäisimme	Conditional
keskiaikaiset	None
ensiesitettiin	Indicative
varausten	None
huipentuivat	Indicative
kiroavat	Indicative
luokaa	Imperative-Jussive
kieltäytyisi	Conditional
kärjistivät	Indicative
simuloisitte	Conditional
supistukoot	Imperative-Jussive
sisällissodasta	None
työajan	None
veisi	Conditional
päivänkakkaran	None
haikeuksitta	None
pyörähtää	Indicative
laulakaamme	Imperative-Jussive
ostosrobottina	None
sankaruutta	None
proteiinissa	None
iskeytyi	Indicative
elpyi	Indicative
kumoavat	Indicative
puolustan	Indicative
hävittäjäkoneista	None
ajeli	Indicative
hävitti	Indicative
kolmiportaisen	None
sallikaa	Imperative-Jussive
haavoittui	Indicative
uskovainen	None
ällistyttävä	None
hahmoista	None
julista	Imperative-Jussive
haalittiin	Indicative
vahattaneen	Potential
gabroa	None
paini	None
tarvitsijoista	None
kesyn	None
kidnappasi	Indicative
noukkii	Indicative
peitti	Indicative
jalostaa	Indicative
viiriäinen	None
asetelmaan	None
ponnahduslaudalla	None
loismatojen	None
ostan	Indicative
tulkitsemme	Indicative
merkittäisiin	Conditional
litania	None
lakaisee	Indicative
rykmenttiin	None
muovataan	Indicative
sahasi	Indicative
myöhästyivät	Indicative
selkeyttäisin	Conditional
palkkasivat	Indicative
kohtaavat	Indicative
laskin	Indicative
rakentavat	Indicative
sidotti	Indicative
kuohkea	None
kääntämisessä	None
kondensoituvat	Indicative
haistaa	Indicative
maaseutumaisia	None
pohjautuisi	Conditional
koukistaa	Indicative
rappeutuu	Indicative
kariutui	Indicative
havaittiin	Indicative
pysyisivät	Conditional
lähentyvät	Indicative
kriisiksi	None
takakannessa	None
massiiviseen	None
kuolemanrangaistukseen	None
tyhjeni	Indicative
ramaisitte	Indicative
rakastat	Indicative
hivo	Imperative-Jussive
arvettuu	Indicative
verkkokalvolle	None
laajeni	Indicative
valehtelee	Indicative
läikkyy	Indicative
pyynnöstä	None
hätkähdytti	Indicative
vuorattiin	Indicative
kuljemme	Indicative
kiinalta	None
kašubin	None
odottaisin	Conditional
sekoa	Imperative-Jussive
kohdentuu	Indicative
hetkuteltaneen	Potential
väkevöidään	Indicative
osu	Imperative-Jussive
pitäkäämme	Imperative-Jussive
elätti	Indicative
silpoi	Indicative
lustraatioista	None
kihlattiin	Indicative
loukataan	Indicative
haluta	Imperative-Jussive
valjastetaan	Indicative
yleismaailmallinen	None
kyläkauppojen	None
kimmahduttaisitte	Conditional
kumottiin	Indicative
unhoita	Imperative-Jussive
täsmensi	Indicative
ylittyisi	Conditional
kaupitsivat	Indicative
operoinnin	None
sammuin	Indicative
lunastettiin	Indicative
visko	Imperative-Jussive
väheni	Indicative
nidos	None
kaasuputkelta	None
tyypillisellä	None
äänestit	Indicative
opastettiin	Indicative
silhuetit	None
käyttämiselle	None
mekasta	Imperative-Jussive
autonomiaan	None
vertaillen	Potential
suojelevat	Indicative
valmistautuivat	Indicative
peilaavat	Indicative
halveksittavaan	None
putoaa	Indicative
valloittavat	Indicative
loisteliaan	None
kaksiriviselle	None
romuttuivat	Indicative
indeksoidaan	Indicative
erotuomari	None
liittoutuivat	Indicative
levottomuudet	None
kirjakielenä	None
naurattava	None
paikallistettiin	Indicative
pöytiä	None
sokerista	None
levottomuus	None
peruuttaa	Indicative
varustivat	Indicative
kulki	Indicative
porilainen	None
sulautui	Indicative
ajoittui	Indicative
kaupallistaisitte	Conditional
selvitti	Indicative
täsmennän	Indicative
tunnustettiin	Indicative
kouluttavat	Indicative
lakkoilevat	Indicative
huristaisiin	Conditional
lähtevät	Indicative
lentää	Indicative
vaipui	Indicative
vältellään	Indicative
jääräpäätä	None
maksukyvyttömyyden	None
kouruunnu	Imperative-Jussive
voimisteli	Indicative
nahistakoon	Imperative-Jussive
pystyttänee	Potential
monennat	Indicative
makeampia	None
halveksii	Indicative
draamoissa	None
kumulaatio	None
tuuletatte	Indicative
valotetaan	Indicative
ennustan	Indicative
yläpuolisella	None
joonialaiseen	None
mäkkäreille	None
nielaista	None
raaputtaa	Indicative
yhtyi	Indicative
kalterijääkärit	None
tuijottaa	Indicative
vakuuttukoon	Imperative-Jussive
ripoteltiin	Indicative
taittaa	Indicative
magneettikentille	None
salattiin	Indicative
harvensi	Indicative
hyökkäilee	Indicative
kiilasi	Indicative
permikausitta	None
pallosalama	None
paleotsooinen	None
suonet	Potential
banaania	None
kivittää	Indicative
rientävät	Indicative
betoniset	None
toista	Imperative-Jussive
korjataan	Indicative
painotan	Indicative
raikuu	Indicative
sietävät	Indicative
siperialaisten	None
toimipisteessä	None
biopolttoaineen	None
hylätään	Indicative
talouskasvu	None
jänistä	Imperative-Jussive
kohuttiin	Indicative
räpsinet	Potential
laitettaisiin	Conditional
keinahtaisitte	Conditional
hautautuvat	Indicative
tiibetinhanhi	None
voinemme	Potential
perunasäkkinä	None
laukkaavat	Indicative
värnyttäneen	Potential
putoan	Indicative
kiihottavat	Indicative
epäilijöiden	None
rakastaa	Indicative
halusi	Indicative
kutoo	Indicative
väleihin	None
riskeerattiin	Indicative
takkuili	Indicative
marketista	None
syntymässä	None
odotettaisiin	Conditional
yskähdätte	Indicative
lamaantuivat	Indicative
keikuttaisit	Conditional
pidätetään	Indicative
hoatsinin	None
löytyvät	Indicative
näytimme	Indicative
ennallistaa	Indicative
oikeutetusta	None
kertyy	Indicative
sanaharkka	None
alokkeiksi	None
innovaatioiden	None
huomatkaa	Imperative-Jussive
korjailen	Indicative
epäile	Imperative-Jussive
vuokrasopimukset	None
niputtaa	Indicative
räkättirastaan	None
yllätä	Imperative-Jussive
eläisit	Conditional
jaksottaa	Indicative
vitamiinilla	None
sijoittavat	Indicative
ateismi	None
eräännyttäisiin	Conditional
inspiroitui	Indicative
manasin	Indicative
ylläpitävät	Indicative
toriumin	None
parantuvat	Indicative
keväistä	Imperative-Jussive
määrittäisi	Conditional
suot	Indicative
elpynyt	None
luetteli	Indicative
istuin	Indicative
cirrus	None
vertaisi	Conditional
vuosikertomukseen	None
odottaisivat	Conditional
luotsasivat	Indicative
koputa	Imperative-Jussive
kuivaisi	Conditional
modifioitunee	Potential
kuulusteluihin	None
ilahtuu	Indicative
viittaisi	Conditional
nauran	Indicative
lautakunnissa	None
yllettiin	Indicative
kehuu	Indicative
miellettiin	Indicative
nelinkertaista	Imperative-Jussive
jääviydelle	None
kiellän	Indicative
taikoo	Indicative
vaannette	Potential
vietäisiin	Conditional
sauniota	None
kuunarin	None
kiihottaa	Indicative
suippenen	Indicative
kuopattiin	Indicative
dualismiin	None
haastaa	Indicative
tutustui	Indicative
absorboituu	Indicative
kartoittavat	Indicative
pohjautunee	Potential
lesin	Indicative
kalkkunan	None
herätettiin	Indicative
näpäyksineen	None
marxilaisessa	None
armeijakunnassa	None
arvostellen	Potential
vetybromidin	None
pukeutuvat	Indicative
murrettaisiin	Conditional
tiedostavat	Indicative
merkitsisi	Conditional
juontuivat	Indicative
saksalaistanet	Potential
virunut	None
sammutamme	Indicative
loppuivat	Indicative
otaksui	Indicative
näpistelette	Indicative
virtasi	Indicative
peruutetaan	Indicative
likaantuisimme	Conditional
liikuttuisit	Conditional
vakuutteli	Indicative
murskasi	Indicative
perustele	Imperative-Jussive
ilmaannu	Imperative-Jussive
kypsytetään	Indicative
vihannoinevat	Potential
sortuu	Indicative
salakuunteli	Indicative
yhdisteltiin	Indicative
tietäisit	Conditional
baletinopettajasta	None
puhkaistaan	Indicative
pukeutuivat	Indicative
tarjoilivat	Indicative
meteorit	None
eläinmuseossa	None
myyntiin	None
nelistimme	Indicative
kasetoinet	Potential
rikkoivat	Indicative
lähikuvassa	None
kääntävät	Indicative
kaavamaistaisin	Conditional
selityksiin	None
lainaudumme	Indicative
marmatamme	Indicative
dumdumluoteja	None
vaimentaa	Indicative
brittiläisenä	None
pitelevät	Indicative
sijaitsit	Indicative
systeeminen	None
synkkyys	None
pidättelee	Indicative
rajatulle	None
viipyi	Indicative
vakuuttivat	Indicative
loukkaisi	Conditional
pue	Imperative-Jussive
muodostui	Indicative
mitokondrioita	None
laitumina	None
keskimmäisinä	None
polarisoituu	Indicative
siivoavat	Indicative
hedelmätarhoissa	None
tienvarsille	None
sivua	Imperative-Jussive
hyödyn	Indicative
listautuu	Indicative
tuomitsee	Indicative
smirgelöisit	Conditional
kyseenalaistan	Indicative
työntää	Indicative
värjäydyn	Indicative
haluamme	Indicative
vallitsi	Indicative
ilmaisutapaa	None
majoitetaan	Indicative
hallitsee	Indicative
perustuslakeihin	None
piristyi	Indicative
valtaan	Indicative
vello	Imperative-Jussive
muistutitte	Indicative
sahaavat	Indicative
kaupallisten	None
synkkenette	Indicative
voimisti	Indicative
metsästi	Indicative
muisteli	Indicative
suojelisi	Conditional
poistavat	Indicative
tarkoitamme	Indicative
kimalaista	None
valvottiin	Indicative
hirvittävältä	None
kipusivat	Indicative
luotasi	Indicative
rekisteröitiin	Indicative
niele	Imperative-Jussive
tarkkaillen	Potential
sijaitse	Imperative-Jussive
lähdetään	Indicative
kauhistelimme	Indicative
kiduttivat	Indicative
jalkaterät	None
törröttää	Indicative
palloilijoille	None
tosiasioista	None
halukasta	None
laajentavat	Indicative
reippaita	None
ikuista	Imperative-Jussive
apa	Imperative-Jussive
haaro	Imperative-Jussive
maankäyttöön	None
podcastattaneen	Potential
kerätään	Indicative
kuukittiin	Indicative
joudutti	Indicative
juhlistaa	Indicative
polvista	Imperative-Jussive
kehitellen	Potential
hiotaan	Indicative
teollistui	Indicative
suhtineen	None
liioitteli	Indicative
konstruktiot	None
tuhotaan	Indicative
ehdittiin	Indicative
kiillotukseen	None
palautuvat	Indicative
äänestämme	Indicative
vitsoin	Indicative
juuttuivat	Indicative
sanoin	Indicative
ilmenee	Indicative
johdotan	Indicative
sodankäynti	None
suosittelee	Indicative
filmatisoitiin	Indicative
korisen	Indicative
hoitelee	Indicative
julkistetaan	Indicative
jäljitteli	Indicative
kummasteltiin	Indicative
kommentoisi	Conditional
voitaisiin	Conditional
tärisi	Indicative
epätodeksi	None
syyhyä	Imperative-Jussive
ranskantanee	Potential
periytyisi	Conditional
ripustautukaa	Imperative-Jussive
työnnän	Indicative
erotteluille	None
uskaltautuvat	Indicative
oopperoiden	None
pohjoisosia	None
pelotteli	Indicative
kunnioittanee	Potential
myi	Indicative
pukkia	None
haaraan	Indicative
kerubin	None
varattiin	Indicative
kompensoidaan	Indicative
järjestellään	Indicative
siroa	Imperative-Jussive
taputtaa	Indicative
nevoja	None
luopuisi	Conditional
olentona	None
koskettimista	None
ohjelmasuunnittelu	None
toheloisitte	Conditional
tuutulauluihin	None
nujakoisin	Conditional
rypälettä	None
parfymeriasta	None
äkillisten	None
ilmentänet	Potential
peilipalvelimitta	None
aiheuttavat	Indicative
onnitteli	Indicative
uskottelee	Indicative
teilattiin	Indicative
kysyt	Indicative
haaveilee	Indicative
poliisipäällikköä	None
yhdistyvät	Indicative
karjalaiseen	None
muutostöistä	None
ryöstöviljellette	Potential
tykkäät	Indicative
kiduskannessa	None
sinertäviä	None
näyttelyt	None
sorsasta	Imperative-Jussive
hio	Imperative-Jussive
etsitään	Indicative
kokeilut	None
kiertyvät	Indicative
hörähdämme	Indicative
treenasi	Indicative
puollan	Indicative
kuulustelivat	Indicative
määrätään	Indicative
kirjapainon	None
vastasyntyneellä	None
lopettamiselle	None
istahti	Indicative
nelinkertaistaa	Indicative
likvidoitiin	Indicative
nukkekoteja	None
varoitusajalla	None
rupeavat	Indicative
päivittää	Indicative
lämmittelivät	Indicative
liuottavat	Indicative
pärjäsi	Indicative
opintomenestyksen	None
höyrytyttiin	Indicative
vaivautuisi	Conditional
luodossa	None
leniniläistä	None
hakee	Indicative
päättelevät	Indicative
ulosvirtaus	None
sämpläisin	Conditional
opettavat	Indicative
kahdentuu	Indicative
norjentavat	Indicative
irtautuivat	Indicative
äänesti	Indicative
suosisi	Conditional
kunnostautukoon	Imperative-Jussive
etanoliin	None
tulostukseen	None
nimimerkkien	None
räjäyttivät	Indicative
siemenillä	None
ajoittuivat	Indicative
bluetooth	None
sumuisia	None
kiemurtelevat	Indicative
pimentäkää	Imperative-Jussive
kaikui	Indicative
haudo	Imperative-Jussive
tulenarka	None
menoihin	None
aineista	Imperative-Jussive
toiminnoiksi	None
omaksutaan	Indicative
abstraktisti	Indicative
lohesta	Imperative-Jussive
juonsivat	Indicative
suuttuu	Indicative
toru	Imperative-Jussive
uurretta	None
tulostetaan	Indicative
matsina	None
siirtomaavallasta	None
produktiivistunen	Potential
oireettomissa	None
mahtunee	Potential
harrastaa	Indicative
liukuhihnaa	None
synkensi	Indicative
muunsivat	Indicative
kirjatoukaksi	None
muistuttavat	Indicative
koeajan	Indicative
takkuaa	Indicative
masturbointia	None
kätketään	Indicative
kerskannen	Potential
ryyppäsi	Indicative
poikkesi	Indicative
pistäisi	Conditional
yksikkövektori	None
lajiteltiin	Indicative
lörpöttely	None
kude	Imperative-Jussive
jäykistää	Indicative
alkaisi	Conditional
ahdistanet	Potential
ämyri	None
sijoita	Imperative-Jussive
luovuttivat	Indicative
todentavat	Indicative
suitsuaisitte	Conditional
varttuivat	Indicative
veneineen	None
valun	Indicative
heitellen	Potential
ryösteli	Indicative
syöksypommittajia	None
laukaistaan	Indicative
hinnasto	None
mutkista	Imperative-Jussive
ilmestyisi	Conditional
katselen	Indicative
havumetsät	None
savutti	Indicative
näyttäisivät	Conditional
asiantuntijoilla	None
kannustaa	Indicative
heitellään	Indicative
olettavat	Indicative
rikkoutuu	Indicative
liikarakentaisimme	Conditional
tanssitetaan	Indicative
luistin	Indicative
verrataan	Indicative
parun	Indicative
taritsisit	Conditional
tulkitaan	Indicative
kilpailuetu	None
juot	Indicative
raivosivat	Indicative
kaivattaisiin	Conditional
orpoudelle	None
siistii	Indicative
antina	None
periköön	Imperative-Jussive
termostaatilla	None
kyynelehtisivät	Conditional
kätki	Indicative
kuristaa	Indicative
loppukirin	None
sukulaisten	None
krilliäyriäisineen	None
akvaarioissa	None
samansuuntainen	None
löytynee	Potential
luhisti	Indicative
turmeltakoon	Imperative-Jussive
levähtävät	Indicative
rökitti	Indicative
vaihtuivat	Indicative
laimentaa	Indicative
käniskööt	Imperative-Jussive
vuorovaikuta	Imperative-Jussive
nuorukaisten	None
vauhdittivat	Indicative
selostavat	Indicative
rautuun	None
melot	Indicative
hautuumaissa	None
käsiteltiin	Indicative
läpikuultavasta	None
urilla	None
platinoitiin	Indicative
gravitaatiovoiman	None
rauskuja	None
myrkytys	None
hyväksytään	Indicative
yrittäisin	Conditional
vakuoli	None
ruotsalaiseen	None
valmistauduttiin	Indicative
luhistuisit	Conditional
miekkailevat	Indicative
maallista	None
veisannevat	Potential
trigonometrian	None
voisit	Conditional
valmentajana	None
palovaroittimen	None
punoo	Indicative
estyy	Indicative
kiusoittelee	Indicative
sudenpentujen	None
nöyryytettiin	Indicative
kirjoittavat	Indicative
metsänomistajan	None
vähätellen	Potential
kiroilee	Indicative
kaatuisi	Conditional
vuorataan	Indicative
saunoo	Indicative
peräänkuulutan	Indicative
viestittivät	Indicative
muokattiin	Indicative
ortodoksialle	None
ottelijoista	None
lukiolaisia	None
seestyttäneen	Potential
tuotteistettiin	Indicative
viikonlopussa	None
linjasi	Indicative
kertaavat	Indicative
röyhkeää	None
kirjoittivat	Indicative
satuloikoon	Imperative-Jussive
koristelee	Indicative
uhraavat	Indicative
määrääviä	None
hyödynnettäisiin	Conditional
sairasta	Imperative-Jussive
esineistin	Indicative
heittäydy	Imperative-Jussive
kukkuu	Indicative
ujuttaa	Indicative
kulutetaan	Indicative
valmistaudu	Imperative-Jussive
ihailen	Indicative
uskaltautuivat	Indicative
livo	Imperative-Jussive
kelastit	Indicative
poistuisivat	Conditional
zenbuddhalaisuus	None
kumoutui	Indicative
firenzeläiseen	None
siirtomaapolitiikkoineen	None
kuivataan	Indicative
hoitivat	Indicative
tunkeutuivat	Indicative
bailannet	Potential
geolääketietein	None
yliarvostivat	Indicative
tönäisi	Indicative
yhtymien	None
jalostivat	Indicative
hirveä	Imperative-Jussive
unohdat	Indicative
purkkien	None
pahkasika	None
oletan	Indicative
kallisarvoista	None
aaltoillen	Potential
liberalisoidut	Indicative
virolaisessa	None
häiritään	Indicative
asettelen	Indicative
oikeustiede	None
selvitä	Imperative-Jussive
risteydy	Imperative-Jussive
innostivat	Indicative
hupeni	Indicative
optimoinnin	None
uusnorjaksi	None
tihuttanette	Potential
additiivisen	None
intuitiivisia	None
pohjoisemman	None
taivu	Imperative-Jussive
pureutui	Indicative
soidinnat	Indicative
hiipi	Indicative
selviteltiin	Indicative
kiusaajilla	None
homoavioliittoja	None
vakuutuin	Indicative
palstoitettiin	Indicative
myivät	Indicative
kiduttaneen	Potential
tukehtui	Indicative
saavuttiin	Indicative
säädä	Imperative-Jussive
pallotamme	Indicative
kiekaista	None
okarauskuksi	None
arvosteltiin	Indicative
hurjenimme	Indicative
keitin	Indicative
toteuttaisi	Conditional
rummuttaa	Indicative
krimintataaria	None
vihjaiset	Indicative
kahvitutatte	Indicative
kouluttautuivat	Indicative
uhkaavaan	None
kosmologiasta	None
olympiahuumille	None
intoa	Imperative-Jussive
sovittavat	Indicative
kannustetaan	Indicative
esittävät	Indicative
seurustelee	Indicative
kisattiin	Indicative
viipyvät	Indicative
teologisiin	None
suomalaisti	Indicative
ravistellet	Potential
vuorotteli	Indicative
flaneeraisivat	Conditional
ruoskittiin	Indicative
puhkaisevat	Indicative
notkuttelisivat	Conditional
väitteessä	None
irrottaisivat	Conditional
raivoa	Imperative-Jussive
nivelbussi	None
degeneroidun	Indicative
kääntäisi	Conditional
pestattiin	Indicative
esikoiseksi	None
tuntevat	Indicative
moninkertaistui	Indicative
rökittäisin	Conditional
keinuttaneen	Potential
virittäisitte	Conditional
syöksylaskusta	None
hermottanette	Potential
surivat	Indicative
myöhempi	None
nyppii	Indicative
haastateltaneen	Potential
peruutti	Indicative
samenit	Indicative
teloitetaan	Indicative
lakoutuisit	Conditional
jäljille	None
imaginaariosa	None
soittokunnan	None
poikkeavat	Indicative
kiskobussien	None
avioituu	Indicative
tiheni	Indicative
yllytti	Indicative
omistavat	Indicative
lepäävät	Indicative
riistetään	Indicative
valittavat	Indicative
afganistanilaisen	None
tähdensi	Indicative
henkilöityi	Indicative
virkamiehenä	None
töykittäneen	Potential
sulkavilta	None
polttomoottorin	None
pidemmille	None
levittäytyvät	Indicative
vertaile	Imperative-Jussive
Ö-mapeilla	None
neutriinojen	None
kamassit	None
iankaikkista	None
solmisi	Conditional
bhodžpurin	None
avaruusaluksilla	None
kohtele	Imperative-Jussive
tiuskikaa	Imperative-Jussive
kirkastuu	Indicative
janottaa	Indicative
seostetaan	Indicative
kommentoikaa	Imperative-Jussive
pianolle	None
spekulaatioiden	None
biopolttoaineiden	None
arvostaa	Indicative
vauhditti	Indicative
lypsettiin	Indicative
sivakoinette	Potential
määrittävät	Indicative
rikkoutunemme	Potential
poistettiin	Indicative
toistuu	Indicative
lörötellemme	Potential
ärsyyntyy	Indicative
ongelmallinen	None
malleilla	None
alensivat	Indicative
erottanen	Potential
jatkukoon	Imperative-Jussive
paistaa	Indicative
risteytetään	Indicative
kärjistyi	Indicative
eksaktit	None
näytettiin	Indicative
ajautui	Indicative
likasi	Indicative
kiusaantuneina	None
kampeutui	Indicative
näytellään	Indicative
keskustelevat	Indicative
väheksyi	Indicative
seurasivat	Indicative
mikrofilmille	None
joogin	None
kirjoittakaa	Imperative-Jussive
valloittaisi	Conditional
toivomuksena	None
laskutetaan	Indicative
lastenvahtina	None
kriteereinä	None
valmistautuu	Indicative
atavismina	None
tietokoneinsinööri	None
kiinnitä	Imperative-Jussive
vaahtoa	Imperative-Jussive
voitat	Indicative
urotyön	None
suhtautuu	Indicative
koettavat	Indicative
kiiltävät	Indicative
kokoomushallituksen	None
mahdollistaa	Indicative
puolittui	Indicative
estimaatin	None
näkisin	Conditional
perustunee	Potential
itket	Indicative
muokataan	Indicative
kertaistui	Indicative
heilimöinemme	Potential
kirjasi	Indicative
passittaa	Indicative
alikasvoksista	None
oivalsimme	Indicative
suorittaa	Indicative
harha	None
katkeroituivat	Indicative
arvataan	Indicative
periytyvät	Indicative
närkästyivät	Indicative
käyttäisimme	Conditional
käännyttää	Indicative
aivopestä	None
runtelimme	Indicative
selvennän	Indicative
keräytyy	Indicative
uneksijat	None
ehdottaisi	Conditional
kelkkailisit	Conditional
yllätti	Indicative
hämärtynyt	None
messiaaksi	None
teeskentelevät	Indicative
käsitteistä	Imperative-Jussive
panttasi	Indicative
salakuljetetaan	Indicative
siirrät	Indicative
reaaliseksi	None
lähetetään	Indicative
sekvensoitiin	Indicative
korostuu	Indicative
katkea	Imperative-Jussive
avannevat	Potential
kustantaa	Indicative
lainaan	Indicative
kookoolle	None
laskeudu	Imperative-Jussive
käskee	Indicative
kaikukoppa	None
jutteli	Indicative
idealistiseen	None
vehkeili	Indicative
riitit	Indicative
neutraloidaan	Indicative
innoittaa	Indicative
suojelivat	Indicative
laitetaan	Indicative
surkuteltaneen	Potential
odottaa	Indicative
hinauduit	Indicative
vihdoin	Indicative
siivonnut	None
seivästä	Imperative-Jussive
keikkailee	Indicative
kuvastivat	Indicative
suoltaa	Indicative
ääntyvät	Indicative
väittelee	Indicative
installoitaisiin	Conditional
vietti	Indicative
vihertävät	Indicative
irtisanoo	Indicative
ryöstelivät	Indicative
sotkivat	Indicative
kirkukaamme	Imperative-Jussive
puristuu	Indicative
perehtyy	Indicative
toistetaan	Indicative
prostituoituna	None
viilenee	Indicative
sileä	None
pilaisi	Conditional
harmio	None
livistää	Indicative
määritelmäksi	None
itämerensuomalaisiin	None
tasoitu	Imperative-Jussive
parannellette	Potential
ansaitsee	Indicative
jalattomia	None
paisutellevat	Potential
kiertelevät	Indicative
pudottautuvat	Indicative
kärkiväliksi	None
kärttäkäämme	Imperative-Jussive
omaksuttiin	Indicative
halusit	Indicative
esitin	Indicative
pursuttakoot	Imperative-Jussive
kommitoisi	Conditional
luonnehditaan	Indicative
deen	None
huimaisit	Conditional
eletään	Indicative
jumittui	Indicative
avita	Imperative-Jussive
tuottoisia	None
jäljitti	Indicative
suljettaisiin	Conditional
räppäävät	Indicative
aloittanee	Potential
kavennetaan	Indicative
todensi	Indicative
uinuttakoon	Imperative-Jussive
teknologiana	None
kirkuu	Indicative
tuulieroosio	None
välittyi	Indicative
syökää	Imperative-Jussive
poikalasta	None
usalaisetta	None
laukaisi	Indicative
upotussuolatkaamme	Imperative-Jussive
etene	Imperative-Jussive
setriseitikit	None
lanseerasi	Indicative
universaalisti	Indicative
paljastetaan	Indicative
diokeesi	None
tarkennetaan	Indicative
helponna	Imperative-Jussive
sulkeva	None
kiidättää	Indicative
provosoikoon	Imperative-Jussive
muuttavat	Indicative
kiihtyvät	Indicative
kiskaisee	Indicative
jäljensi	Indicative
kilkatettaneen	Potential
ohjelmistoille	None
arkipäiviä	None
spiritualismi	None
lausun	Indicative
operoidaan	Indicative
eksy	Imperative-Jussive
pakataan	Indicative
rapuruttoa	None
koaguloitakoon	Imperative-Jussive
johtuvat	Indicative
majoittautuu	Indicative
miinuslaskua	None
optimoidaan	Indicative
googlettakaa	Imperative-Jussive
suojeluspyhimykselle	None
erottuu	Indicative
paikkaan	Indicative
sammaltaisin	Conditional
kukintaa	None
värjäytyvät	Indicative
lähivuosien	None
kuitataan	Indicative
koulutat	Indicative
työyhteisöjä	None
balkanisoikaamme	Imperative-Jussive
kiidätettiin	Indicative
yhdistäisin	Conditional
desalinoinneista	None
inttää	Indicative
kerittäneen	Potential
siirtyy	Indicative
käyttäköön	Imperative-Jussive
elokuvat	None
tarkentuu	Indicative
salamurhasi	Indicative
hydromekaniikkoineen	None
oliiviöljyä	None
huumautunee	Potential
kunnioitetaan	Indicative
vaietaan	Indicative
risteävät	Indicative
monipuolistuu	Indicative
kaavoitetaan	Indicative
kalastajina	None
kellahtaa	Indicative
riistettiin	Indicative
suurjännite	None
jodioisi	Conditional
manikyristille	None
ymmärrä	Imperative-Jussive
kiehuvat	Indicative
mukaudu	Imperative-Jussive
semanttisen	None
ehtisin	Conditional
uskoisin	Conditional
hyydy	Imperative-Jussive
kommentoisin	Conditional
siroaa	Indicative
loppui	Indicative
levennettäneen	Potential
haalistettiin	Indicative
spektrometri	None
kiilaan	Indicative
yllättyy	Indicative
läpätkööt	Imperative-Jussive
suihkua	Imperative-Jussive
rakentaisi	Conditional
kiistellee	Potential
rauhoittui	Indicative
antautuisi	Conditional
odotat	Indicative
tallenne	None
kohtelivat	Indicative
kaikenlaisiin	None
unikkoon	None
muistuttivat	Indicative
toteuttavat	Indicative
yksilöllisine	None
savukkeina	None
konfirmaatiota	None
rienasivat	Indicative
psykoterapia	None
rajoittamattoman	None
varteenotettava	None
ukkostaa	Indicative
imetitte	Indicative
sängyt	None
noteerasi	Indicative
palvelimilta	None
pahoinpitelee	Indicative
mellakoitaneen	Potential
kantakielten	None
sovintoon	None
paheksui	Indicative
republikaanien	None
materiaalisesta	None
tyhjene	Imperative-Jussive
riippuu	Indicative
voimistuvat	Indicative
katetaan	Indicative
hermokaasuilla	None
järjestävät	Indicative
seikka	None
metrijärjestelmineen	None
testasivat	Indicative
valssasit	Indicative
kuvittelet	Indicative
virnistykset	None
ydinvoimalaonnettomuuden	None
auttaisivat	Conditional
pieremme	Indicative
harmahtanen	Potential
opettelee	Indicative
tukeutuu	Indicative
käännetään	Indicative
vaurastuit	Indicative
rakentuu	Indicative
tankkasi	Indicative
käynnistyi	Indicative
kidnappasivat	Indicative
selityksiä	None
huomioitaisiin	Conditional
järkkyi	Indicative
kiteytti	Indicative
antibiooteilla	None
houkutin	Indicative
reputti	Indicative
puheenvuoroa	None
hehkuttaa	Indicative
mittajärjestelmä	None
lupautui	Indicative
takiloitiin	Indicative
valtiaatta	None
odotamme	Indicative
nauttisi	Conditional
kehota	Imperative-Jussive
korotetaan	Indicative
elollista	Imperative-Jussive
nollata	None
väärinkäyttää	Indicative
kiinnostuttiin	Indicative
synnyttivät	Indicative
pakeni	Indicative
tipsutetaan	Indicative
miehittävät	Indicative
konteksteihin	None
stripistä	None
meloi	Indicative
mestaruussarja	None
yritän	Indicative
avaruusolio	None
ohimarssin	None
kuronen	Potential
havittelin	Indicative
vihattiin	Indicative
korkkiutunen	Potential
sulatetaan	Indicative
lupaan	Indicative
kaipasi	Indicative
eräännyn	Indicative
asiallisia	None
asuinpaikalla	None
loitonnetaan	Indicative
saarsivat	Indicative
karttelin	Indicative
marras	None
työllistäisi	Conditional
kysyvät	Indicative
etiopialaisen	None
kirjeenvaihtoon	None
karsiutuvat	Indicative
myytäisiin	Conditional
raikkaimmassa	None
sähäköille	None
maailmanmestaruuksista	None
hyppyyn	None
vaihdettaisiin	Conditional
laihdutti	Indicative
laiskiaisen	None
nousivat	Indicative
etsiytyvät	Indicative
neutraaliuteen	None
merkitsisin	Conditional
kaipaan	Indicative
pujottaa	Indicative
sörkkiköön	Imperative-Jussive
palkintoja	None
seikkaili	Indicative
nauttii	Indicative
koristaa	Indicative
kajahti	Indicative
tärvelimme	Indicative
vierailivat	Indicative
toteutettaisiin	Conditional
sisällissodassa	None
työllistä	Imperative-Jussive
muotoillen	Potential
hotellista	None
astutamme	Indicative
toteutuvat	Indicative
kuvasin	Indicative
pakkaavat	Indicative
punastelee	Indicative
fileerataan	Indicative
bentsofenoni	None
obligaatioihin	None
länsimaita	None
lakittavat	Indicative
tarkastettiin	Indicative
kestivät	Indicative
hakkasivat	Indicative
ponnahtaa	Indicative
valvoi	Indicative
estetään	Indicative
varustetaan	Indicative
riippuliidin	Indicative
käsittävät	Indicative
bussimatkoihin	None
pirskeinä	None
väitteli	Indicative
käsitä	Imperative-Jussive
tulittavat	Indicative
ummistanet	Potential
projektiopetukset	None
menettelytapojen	None
määritellään	Indicative
naispuolisia	None
jongleerannevat	Potential
keskittyi	Indicative
paheksun	Indicative
houkuteltiin	Indicative
sotkisi	Conditional
sepitettiin	Indicative
läpäise	Imperative-Jussive
oikaisee	Indicative
pukee	Indicative
melottiin	Indicative
anglosaksiseen	None
pakastetaan	Indicative
kirjoittautui	Indicative
istutaan	Indicative
hälvenee	Indicative
leijui	Indicative
vaikutetaan	Indicative
romiskotta	None
jaotellaan	Indicative
pillitä	Imperative-Jussive
toimintakyvyn	None
ryhdyttäisiin	Conditional
šiia	None
animoitiin	Indicative
kirvelisimme	Conditional
hahatit	Indicative
loittonee	Indicative
satiirisista	None
oletetaan	Indicative
rikkoi	Indicative
harhailtaisiin	Conditional
titaanidioksidia	None
kuuntelivat	Indicative
purskahditte	Indicative
joulukoristeita	None
sähkömäärä	None
arvioinnit	None
rajoin	None
ensisijaista	Imperative-Jussive
kelpaisivat	Conditional
haittaavat	Indicative
sopeutuvat	Indicative
jouduttiin	Indicative
osakekirjassa	None
deponoinette	Potential
kertoimilla	None
etsittiin	Indicative
köysiportaina	None
suodattavat	Indicative
sokaistiin	Indicative
äänieristänemme	Potential
rappeuttaa	Indicative
vierailee	Indicative
ihmetyttää	Indicative
jumalolentojen	None
polveutuisivat	Conditional
lyhenisi	Conditional
laske	Imperative-Jussive
kohdeltaisiin	Conditional
englantilaiset	None
valikoitui	Indicative
survaissette	Potential
lauloin	Indicative
käytävistä	None
poikii	Indicative
junnatkoot	Imperative-Jussive
kahlitsee	Indicative
huuhtoi	Indicative
venytettiin	Indicative
pahoitteli	Indicative
ripa	None
reheville	None
kaupunginosilla	None
istutetaan	Indicative
lohduta	Imperative-Jussive
erillisenä	None
paskottaisiin	Conditional
tiettyinä	None
vyöryy	Indicative
haurastuta	Imperative-Jussive
sopimussakko	None
kutistuu	Indicative
koostanut	None
jalontaisitte	Conditional
suostuisivat	Conditional
saksalaistettiin	Indicative
bulimiaa	None
jatkoivat	Indicative
kumotaan	Indicative
ilmoittivat	Indicative
yliluonnollista	None
viettäisi	Conditional
selittynee	Potential
seilasivat	Indicative
majaileva	None
ratkoivat	Indicative
porsaanreikää	None
taisit	Indicative
hämäsi	Indicative
älisee	Indicative
valtuutti	Indicative
huojistutaan	Indicative
ääkköstettäneen	Potential
kuittaan	Indicative
säilyttävät	Indicative
huopauttivat	Indicative
meriankeriaineen	None
veloittavat	Indicative
vaurastuu	Indicative
kompataan	Indicative
unohdu	Imperative-Jussive
pysäyttää	Indicative
pienennetään	Indicative
tuovat	Indicative
viehättää	Indicative
ylennyt	Indicative
muutostyö	None
hepreaa	None
pakastaa	Indicative
kaartilaisia	None
rakastin	Indicative
vapaapotkusta	None
kulaani	None
ehkäise	Imperative-Jussive
löpiskööt	Imperative-Jussive
hyrskähtää	Indicative
eteläisempien	None
ryöstetään	Indicative
metodistien	None
kouluttautui	Indicative
matkittiin	Indicative
hiostuttanet	Potential
punovat	Indicative
näytettäisiin	Conditional
hoipertelee	Indicative
aamu-unisille	None
koet	Indicative
kaavoitus	None
alushame	None
sinivuokko	None
ulkoisti	Indicative
Joonianmeren	None
pakattiin	Indicative
vesivaroilla	None
autonajoissa	None
hiero	Imperative-Jussive
skippaan	Indicative
kansalaisina	None
juoksisi	Conditional
ralliautoitta	None
lahkeet	None
elin	Indicative
lyhyimmiksi	None
merkkasi	Indicative
torsoksi	None
vähentäisi	Conditional
ruopattiin	Indicative
munaan	Indicative
lahjoo	Indicative
kiistävät	Indicative
semmoiseen	None
upeita	None
työskentele	Imperative-Jussive
suurennettu	None
ilahdutti	Indicative
photoshopattakoon	Imperative-Jussive
apuverbi	None
nopeuksissa	None
kääntää	Indicative
kolkkasi	Indicative
puetaan	Indicative
presidenteille	None
seivästävät	Indicative
kutista	Imperative-Jussive
puikoissa	None
höyrystä	Imperative-Jussive
replikoita	None
metsikköä	None
kirroosiin	None
toteamuksella	None
pohdittaisiin	Conditional
hirtettiin	Indicative
olettaisin	Conditional
puvusti	Indicative
tuulisena	None
palavan	None
länsimaisti	Indicative
kavennettiin	Indicative
jakaantui	Indicative
kihlautuu	Indicative
siipeillee	Potential
purkausaukon	None
päättyvät	Indicative
viemme	Indicative
ruskuisimme	Conditional
ilmestynee	Potential
vetistä	Imperative-Jussive
puoltaisi	Conditional
julistavat	Indicative
venäläistämisissä	None
murenivat	Indicative
häikäistyitte	Indicative
maistereita	None
hankoa	Imperative-Jussive
täydennän	Indicative
istutti	Indicative
nelikerroksinen	None
kaliskaamme	Imperative-Jussive
seikkailivat	Indicative
takapajuloihin	None
skannereita	None
hankaloittivat	Indicative
helpottuu	Indicative
orjatarta	None
mekastakaa	Imperative-Jussive
muuttaisin	Conditional
laukaistaisiin	Conditional
villiintyi	Indicative
sokkelot	None
aukotin	Indicative
olkaniveltä	None
aihkeja	None
myötätuuli	None
kotiuttaisin	Conditional
purtiin	Indicative
suutaroinette	Potential
pysyvät	Indicative
kaltaista	Imperative-Jussive
tuomitsivat	Indicative
keksijän	None
päätellään	Indicative
kokoontuu	Indicative
keskustelemme	Indicative
hajaudutte	Indicative
uhkasi	Indicative
rehottaa	Indicative
kuristin	Indicative
luovutaan	Indicative
kiinteytyy	Indicative
maaotteluja	None
kerry	Imperative-Jussive
paneutui	Indicative
teetätti	Indicative
pelloiksi	None
mopottanet	Potential
totuttaa	Indicative
kadottivat	Indicative
tasapainoilee	Indicative
paimentaa	Indicative
johtavien	None
hehkutetaan	Indicative
sulkisi	Conditional
patruunan	None
orjuutettiin	Indicative
vastataan	Indicative
houkuttelevat	Indicative
rikastavat	Indicative
siedä	Imperative-Jussive
kaiverretaan	Indicative
eristi	Indicative
laulaa	Indicative
kasvaimet	None
suihkutetaan	Indicative
riitti	Indicative
väitteenä	None
viittaavat	Indicative
lukukausi	None
saattoi	Indicative
orastakaa	Imperative-Jussive
allekirjoitetaan	Indicative
puututtaisiin	Conditional
läntillä	None
atomimallissa	None
sairaanhoitajalta	None
sujuu	Indicative
törröttäisit	Conditional
ladata	None
vaalinnoitta	None
joukkoistat	Indicative
nykii	Indicative
erikoistuttiin	Indicative
synnytä	Imperative-Jussive
alkusanojen	None
painostettiin	Indicative
syty	Imperative-Jussive
fuskannevat	Potential
keskustele	Imperative-Jussive
kuplii	Indicative
täsmentää	Indicative
syötin	Indicative
empii	Indicative
yksinkertaisuudesta	None
kysyit	Indicative
levene	Imperative-Jussive
kuuraisit	Conditional
mystifioikaamme	Imperative-Jussive
sijoittaisi	Conditional
spesiaalistitte	Indicative
askelpalauttimissa	None
hovimestareitta	None
viihdy	Imperative-Jussive
määränpäänä	None
noustaan	Indicative
yöpyy	Indicative
löyhentyköön	Imperative-Jussive
stressaantuu	Indicative
nopeutuu	Indicative
ladoissa	None
saartavat	Indicative
myöntänevät	Potential
mongo	None
taistelisi	Conditional
souliin	None
immunisoitunette	Potential
viekää	Imperative-Jussive
pomppi	Indicative
narautetaan	Indicative
luikertelee	Indicative
kiellettäisiin	Conditional
herkkäihoiset	None
rankkaan	Indicative
vaiennan	Indicative
rajattaisiin	Conditional
mätänevät	Indicative
katsele	Imperative-Jussive
kypsyi	Indicative
kierteitä	Imperative-Jussive
äänestän	Indicative
kilometripylväs	None
ministerivaliokuntina	None
ostereita	None
kukkakasveja	None
lastattiin	Indicative
muotoili	Indicative
ratkesivat	Indicative
vahvistuisi	Conditional
poiketaan	Indicative
veganismina	None
saunomista	None
riennä	Imperative-Jussive
miellä	Imperative-Jussive
koostetaan	Indicative
avaruuksista	None
törröttävät	Indicative
ohjeistaa	Indicative
jäsenmaan	None
määrittelemättömiä	None
puukotuksesta	None
magman	None
hanurin	None
laajamittaisesta	None
transformoitaneen	Potential
ydinräjähteen	None
opiskeltiin	Indicative
vuottivat	Indicative
robotisoidut	Indicative
lehtopöllö	None
pyrähtää	Indicative
kylläännyttävät	Indicative
ammottaisitte	Conditional
jäähdytetään	Indicative
paloittelee	Indicative
geenimuokattuina	None
kuohuu	Indicative
museovirastossa	None
jyrkkeni	Indicative
syventyi	Indicative
oskillaattori	None
kipinäväli	None
pinoaisimme	Conditional
selittänee	Potential
harkinnassa	None
matkustajakoneita	None
kuhisee	Indicative
eriyttää	Indicative
tissutettaneen	Potential
joutunee	Potential
laulakaa	Imperative-Jussive
akoittukoon	Imperative-Jussive
avaudu	Imperative-Jussive
fraktioinee	Potential
saran	None
hedelmälihasta	None
juoksi	Indicative
taisin	Indicative
hukkuivat	Indicative
edo	Imperative-Jussive
joettomilta	None
hyvittää	Indicative
lahtelaisten	None
nypitään	Indicative
syytettiin	Indicative
sotilaalliselle	None
tarvon	Indicative
kiistelevät	Indicative
aktiviteetteja	None
oktagonein	None
itkee	Indicative
duosta	None
kvantifioisitte	Conditional
nykäisi	Indicative
kovettaa	Indicative
ryntäsi	Indicative
kiehtoo	Indicative
koe	Imperative-Jussive
haitallisena	None
ohjaimet	None
ehtoja	None
pulma	None
tähdätty	None
bolševikeilta	None
linnoituksella	None
tiukentaa	Indicative
luimistakaamme	Imperative-Jussive
siirtolaiselle	None
järkevöitykää	Imperative-Jussive
antajien	None
säädellään	Indicative
kromosomin	None
mätänin	Indicative
edellyttäisivät	Conditional
siistitään	Indicative
rosvoa	Imperative-Jussive
tuhoan	Indicative
ensisijaistakoon	Imperative-Jussive
liikkumisvapaus	None
rekisteröidään	Indicative
paahtaa	Indicative
lueskelin	Indicative
tilitti	Indicative
vaikeampien	None
ohjautuvat	Indicative
panssaroituun	None
uppoaa	Indicative
tupruttanevat	Potential
sairastuu	Indicative
havaitsivat	Indicative
hoo	None
menehtyy	Indicative
riipu	Imperative-Jussive
nokkelaa	None
kiihtyi	Indicative
viivyttelivät	Indicative
kurvaatte	Indicative
taantuman	None
puuttui	Indicative
taivutettaneen	Potential
tukeutuvat	Indicative
sopupelaamisten	None
velkainen	None
lipevä	None
kyllästyneen	None
vaipuivat	Indicative
tutkimustuloksia	None
rappeuttakaamme	Imperative-Jussive
tottumattomat	None
kangistaa	Indicative
kohdelkaamme	Imperative-Jussive
absurdiin	None
rosee	None
murtui	Indicative
tšekit	None
laadittiin	Indicative
mopin	None
objektiivilla	None
reliabiliteeteista	None
äyskäröinen	Potential
kolmivärinen	None
huonontukaamme	Imperative-Jussive
onnitelkaamme	Imperative-Jussive
agendan	None
noudatteli	Indicative
tikahtui	Indicative
säännöstelee	Indicative
puhkaistiin	Indicative
ratko	Imperative-Jussive
luonnehtiva	None
koitetaan	Indicative
join	Indicative
kaartaa	Indicative
kommunikaatio	None
viistänette	Potential
jumalattariin	None
maaherrojen	None
suoritukseksi	None
ommellaan	Indicative
akatemioista	None
kohautti	Indicative
sopeuttaa	Indicative
leppyi	Indicative
täydentävät	Indicative
tuntumaa	None
kirvoitti	Indicative
keskitytään	Indicative
viestittävät	Indicative
vinttikoiraa	None
päävalmentajina	None
lääkitään	Indicative
kutistuivat	Indicative
nyökyttelisivät	Conditional
hallinnoitiin	Indicative
paahdetaan	Indicative
suurennetaan	Indicative
eriytetään	Indicative
käynnistyisi	Conditional
määräytyi	Indicative
vuotaa	Indicative
tohtoroikoot	Imperative-Jussive
venäläistää	Indicative
koventaa	Indicative
mutavyöryt	None
bongannee	Potential
vuorovaikutitte	Indicative
tuskastui	Indicative
asettuivat	Indicative
loukkauduttaneen	Potential
pidentää	Indicative
tulehtuu	Indicative
korosti	Indicative
törmättäisiin	Conditional
kultakuume	None
lähestyisi	Conditional
portugalilaisissa	None
ostaisivat	Conditional
hallitsen	Indicative
epäonnistuvat	Indicative
valoisine	None
raaennettaneen	Potential
somen	None
helpottaisi	Conditional
tarjoaisivat	Conditional
tulosta	Imperative-Jussive
muodostu	Imperative-Jussive
hyttynen	None
korjaamossa	None
lenkkeilisitte	Conditional
kehystä	Imperative-Jussive
luokittele	Imperative-Jussive
epäselvyydestä	None
junailtiin	Indicative
lipeä	Imperative-Jussive
kirvoittavat	Indicative
hankittaisiin	Conditional
selasin	Indicative
kritisoidaan	Indicative
väijyy	Indicative
lennättävät	Indicative
konkreettisiin	None
suhtaudut	Indicative
käsikirjoittaisi	Conditional
epäillen	Potential
mestasi	Indicative
nablannen	Potential
hävitetään	Indicative
valitetaan	Indicative
vietetään	Indicative
paahdelisit	Conditional
luhistui	Indicative
liikahtelisitte	Conditional
vältän	Indicative
hyökkäisi	Conditional
oikeussosiologia	None
voitiin	Indicative
virkistää	Indicative
omaleimainen	None
heitättäkööt	Imperative-Jussive
polje	Imperative-Jussive
kolhii	Indicative
piirityskoneita	None
pääjaksot	None
köynnehtikää	Imperative-Jussive
kaivoi	Indicative
sortuivat	Indicative
kiehuvatta	None
opetellaan	Indicative
hiillostamme	Indicative
poptaide	None
ajattaa	Indicative
ilmaantuvat	Indicative
ehkäisi	Indicative
kohdistuivat	Indicative
valmistaa	Indicative
pode	Imperative-Jussive
kahdentaa	Indicative
langeta	Imperative-Jussive
diplomitehtaat	None
muistelee	Indicative
territorioilla	None
teilasi	Indicative
häiriöitä	None
tietänee	Potential
pitkittänet	Potential
osallistut	Indicative
fragmentteja	None
kukertaa	Indicative
säteilyttäkööt	Imperative-Jussive
tönäisee	Indicative
ymmärtää	Indicative
ylläpidä	Imperative-Jussive
vihoitteli	Indicative
pitäisivät	Conditional
kinkkaan	Indicative
päättömän	None
rotalla	None
kuultavat	Indicative
öljyautoksi	None
australiankarjakoiriin	None
vahaavat	Indicative
kohotetaan	Indicative
vakiinnutettiin	Indicative
rakennamme	Indicative
kuksittiin	Indicative
ruiskaunokki	None
liikenneonnettomuuksien	None
hytkähti	Indicative
virkisti	Indicative
kukoistavat	Indicative
riensi	Indicative
analysoidaan	Indicative
kohtasi	Indicative
sinkoutuvat	Indicative
raskautan	Indicative
huipensi	Indicative
vastaanottajaksi	None
ruiskutti	Indicative
piirrettyyn	None
hoidan	Indicative
vastikkeeksi	None
päivitä	Imperative-Jussive
muistutettiin	Indicative
alan	Indicative
suojeltaisiin	Conditional
pyörittäisi	Conditional
hautaan	Indicative
liikarakentakoon	Imperative-Jussive
säästelette	Indicative
kirjallisina	None
uranuurtajista	None
näen	Indicative
yhdistyisivät	Conditional
seilasi	Indicative
talvehti	Indicative
kumpuilitte	Indicative
magmaattisilta	None
huvitusta	None
vihjasi	Indicative
lämmitettiin	Indicative
klikkaan	Indicative
sutannevat	Potential
lainataan	Indicative
joutuu	Indicative
tökännevät	Potential
tiivistyy	Indicative
laskutti	Indicative
mitattaisiin	Conditional
eepoksista	None
sakenin	Indicative
valaistun	Indicative
ahnasteltakoon	Imperative-Jussive
soudan	Indicative
tähtitornissa	None
tarjotaan	Indicative
pahennen	Potential
tahriintukaamme	Imperative-Jussive
mahdollistetaan	Indicative
muumiota	None
vertailivat	Indicative
seisahtunemme	Potential
mahtimiehiä	None
polyesteriä	None
ylity	Imperative-Jussive
kuvaavat	Indicative
kanteen	None
verestä	Imperative-Jussive
reunusta	Imperative-Jussive
kastoivat	Indicative
istui	Indicative
haikalan	None
painotuotteet	None
sitovat	Indicative
pudottaa	Indicative
huudat	Indicative
kirkkaankeltaiset	None
elokuvakäsikirjoittajia	None
varioidaan	Indicative
muodostanevat	Potential
esitellään	Indicative
valikoitukoon	Imperative-Jussive
huminaa	None
löydätte	Indicative
arvottaa	Indicative
kuvittelisi	Conditional
toiminnoissa	None
kismittäisivät	Conditional
tähyttäneen	Potential
korostanette	Potential
vannoi	Indicative
pidensivät	Indicative
valitettiin	Indicative
tahrasi	Indicative
vaatimuksiksi	None
puolustautuu	Indicative
aikaansaivat	Indicative
laulavat	Indicative
jakautuisivat	Conditional
nuolin	Indicative
menehtyivät	Indicative
estän	Indicative
kohdistaa	Indicative
hahmoilta	None
sisäytimeen	None
mahdetaan	Indicative
karjahdan	Indicative
abstrahoisin	Conditional
katsellen	Potential
haukattiin	Indicative
rikastuu	Indicative
graniittigneissinä	None
tunnustamisesta	None
tapahtuisivat	Conditional
kummeksinee	Potential
vähättelee	Indicative
maistuisi	Conditional
päiväsi	Indicative
pistäisin	Conditional
kahluupaikaksi	None
murhaaja	None
katkot	Indicative
sivuutettiin	Indicative
naamalle	None
aivastuttaa	Indicative
kreolikielet	None
upotuspiikeittä	None
työväenyhdistykset	None
apinoista	None
tykyttäkää	Imperative-Jussive
partakoneen	None
deklinoinet	Potential
vedottiin	Indicative
jokilaaksot	None
kesäkurpitsa	None
haavoittuu	Indicative
moniste	None
hengetär	None
punaisin	Conditional
koneellinen	None
julkaisevat	Indicative
kihisisimme	Conditional
dominikaaniluostarin	None
oletti	Indicative
kunkkua	None
plombitimme	Indicative
hallitusaikana	None
suostutteli	Indicative
pohdiskelin	Indicative
säätää	Indicative
ääntelyllä	None
kiidätetään	Indicative
käännyttivät	Indicative
epävarmat	None
valaistuu	Indicative
kuormataan	Indicative
lampaita	None
tulkitse	Imperative-Jussive
kumoan	Indicative
virkavaltaistakoon	Imperative-Jussive
muodotaan	Indicative
homogenoinette	Potential
peittäisi	Conditional
taltioitiin	Indicative
finanssikriisiä	None
ryömii	Indicative
karsittiin	Indicative
iskostuttaneen	Potential
hauduttaa	Indicative
venyvät	Indicative
pahentavat	Indicative
vahtikoirana	None
pissis	None
mässäilisitte	Conditional
seinämän	None
rapautui	Indicative
rykisimme	Conditional
lumosi	Indicative
työstettävä	None
soutaminen	None
dubattiin	Indicative
kolumnistina	None
syrjäytyivät	Indicative
noutaa	Indicative
liittynee	Potential
säästyy	Indicative
ghettouduitte	Indicative
tallasin	Indicative
neorealistisia	None
noudattelee	Indicative
hidasteli	Indicative
nimistössä	None
äänenpaineista	None
nietosta	Imperative-Jussive
angiotensiini	None
raikkauksin	None
ällistykseltä	None
irtaantui	Indicative
miellyttää	Indicative
nettisivuilta	None
päädyn	Indicative
älykkyystasoilta	None
tapat	Indicative
liettykää	Imperative-Jussive
yrjöä	Imperative-Jussive
suotuisaa	None
täsmennettiin	Indicative
katalysaattori	None
tekijöitä	None
kuljettaa	Indicative
verhoavat	Indicative
intresseissä	None
jysky	Imperative-Jussive
continuum	None
osaamme	Indicative
ruttaatte	Indicative
heittivät	Indicative
lännenelokuvassa	None
tavoittele	Imperative-Jussive
louhitaan	Indicative
hyväksyi	Indicative
totutettiin	Indicative
ymmärsivät	Indicative
kourun	None
kuohahda	Imperative-Jussive
tarpeellisen	None
avattaisiin	Conditional
suhtaudu	Imperative-Jussive
otusta	None
palvoi	Indicative
lyhdyin	None
napapilkulle	None
vongannevat	Potential
liottaa	Indicative
hyödynsivät	Indicative
pyrähdät	Indicative
sidottiin	Indicative
pippuroinen	Potential
suojannen	Potential
tyydytti	Indicative
ammattilaista	Imperative-Jussive
riittivät	Indicative
maatui	Indicative
rakennettiin	Indicative
puutun	Indicative
murtauduttiin	Indicative
lujittivat	Indicative
rehellisellä	None
siirrettäisiin	Conditional
rajaisi	Conditional
koneista	Imperative-Jussive
torin	None
laskisin	Conditional
juontuu	Indicative
järjestäisi	Conditional
mandariineiksi	None
kromittanevat	Potential
rynnistää	Indicative
kojeisiin	None
silpoivat	Indicative
nolottaa	Indicative
tehostaisi	Conditional
muuntuivat	Indicative
luopuvat	Indicative
animismi	None
kirjaudut	Indicative
latinisoisit	Conditional
kuroutuu	Indicative
seestyy	Indicative
yletä	Imperative-Jussive
livahtaa	Indicative
tappakaa	Imperative-Jussive
kokivat	Indicative
säästyttiin	Indicative
sammutti	Indicative
lupautuivat	Indicative
keisareilla	None
siirretään	Indicative
mestaruusottelua	None
tuhoaisi	Conditional
juonittelisimme	Conditional
voitelee	Indicative
kokkaat	Indicative
passiivista	Imperative-Jussive
meneteltäisiin	Conditional
pohjoisosien	None
hidastuivat	Indicative
suomensin	Indicative
harkitsen	Indicative
ystävystyivät	Indicative
polveutui	Indicative
valmensivat	Indicative
perustakaa	Imperative-Jussive
kimalsitte	Indicative
maallisena	None
mitoittaa	Indicative
kontrolloidaan	Indicative
haaskaantunevat	Potential
hyödyllisen	None
mutkistui	Indicative
ampuilkaa	Imperative-Jussive
irvinen	Potential
sähkönjohtavuuksilla	None
kamppailkoon	Imperative-Jussive
resepteissä	None
selkeyttäisi	Conditional
murskautuisimme	Conditional
kasvojenkohotuksen	None
televisiokanavien	None
uskallettiin	Indicative
pore	None
keskitettiin	Indicative
katkeroittaisimme	Conditional
helähdyttänen	Potential
häädetään	Indicative
skitsofrenian	None
vesitiivistätte	Indicative
tapahtuisi	Conditional
söin	Indicative
kovensi	Indicative
dollmanninpuuhiiriin	None
tummuu	Indicative
etääntyy	Indicative
svengataan	Indicative
kiehnäsin	Indicative
napataan	Indicative
rumbaisivat	Conditional
tuhlaavat	Indicative
ylikuumentuisin	Conditional
hammastuttiin	Indicative
valaistut	Indicative
ilmaantuisi	Conditional
laajentaisi	Conditional
kohentaa	Indicative
suistaa	Indicative
maatuu	Indicative
liikautat	Indicative
teräaseella	None
sokeuttaa	Indicative
ideaalista	Imperative-Jussive
uudenvuodenaaton	None
aseksuaalisuus	None
tyhjensivät	Indicative
virtaviivaisen	None
yhteisöllisen	None
tuotiin	Indicative
tarhataan	Indicative
ydinonteloista	None
hajautui	Indicative
mahdollista	Imperative-Jussive
meditaatiosta	None
taikinoinet	Potential
voisi	Conditional
plyysihuonekaluna	None
muodostumina	None
ohjelmajulistukselta	None
joukkotuhoaseiden	None
vaalennettaisiin	Conditional
kotiuttaa	Indicative
pelasti	Indicative
pääryhmiä	None
prinssille	None
kiirehdittäneen	Potential
kuivata	Imperative-Jussive
kosketin	Indicative
sotilasdiktaattoreilta	None
käärittiin	Indicative
mutkistuu	Indicative
lihakirves	None
kotimaistaisitte	Conditional
tiedota	Imperative-Jussive
soistui	Indicative
täydentää	Indicative
valmistellaan	Indicative
harustit	Indicative
arvo	Imperative-Jussive
vanhenee	Indicative
avartaa	Indicative
nyppinet	Potential
huomasin	Indicative
haurastutte	Indicative
paljasti	Indicative
vintturi	None
predikaattilogiikan	None
palasi	Indicative
runsailla	None
vanno	Imperative-Jussive
meriraja	None
singolla	None
näet	Indicative
keihäsmiehiä	None
puri	Indicative
kerosiinia	None
konfirmaatio	None
vesittää	Indicative
liputti	Indicative
neurotieteet	None
kuron	Indicative
kääntäjän	None
toisi	Conditional
vaikertanette	Potential
siteerattiin	Indicative
keitetään	Indicative
pysäköinemme	Potential
pidentyi	Indicative
imivät	Indicative
korjasit	Indicative
käännytettiin	Indicative
himmeni	Indicative
saavuttaa	Indicative
kiroillen	Potential
kaivettu	None
houkutellen	Potential
kaavoitti	Indicative
syntymätodistuksille	None
järjestettäisiin	Conditional
kaunokirjallisuudessa	None
pakottivat	Indicative
kiviaines	None
vauraaksi	None
mukula-artisokiksi	None
pinkonee	Potential
bullaa	None
kuvastettiin	Indicative
tarjoan	Indicative
sikotautina	None
puolitettiin	Indicative
rohkenen	Indicative
mittasivat	Indicative
uhmasi	Indicative
kumoat	Indicative
plaaniin	None
neito	None
utele	Imperative-Jussive
virtuaalisia	None
sojottaa	Indicative
haistavat	Indicative
suuntautuisi	Conditional
käkätit	Indicative
ylettyivät	Indicative
harhauta	Imperative-Jussive
lauhkeat	None
tunnisti	Indicative
käytännöllistä	Imperative-Jussive
uursi	Indicative
lisävarusteelle	None
pamahtaa	Indicative
pärsky	Imperative-Jussive
vuorovaikuttavat	Indicative
pyykkäsitte	Indicative
aseista	Imperative-Jussive
rankattiin	Indicative
toivotan	Indicative
kiihdytettiin	Indicative
tutkimustyöhön	None
saasteista	None
selitän	Indicative
varoittivat	Indicative
itketä	Imperative-Jussive
huoistamme	Indicative
suomentaa	Indicative
kohentui	Indicative
taivutetaan	Indicative
erittää	Indicative
hedelmöitetään	Indicative
yhtenäistä	Imperative-Jussive
eritimme	Indicative
karttui	Indicative
vinyyliklorideiksi	None
kotiutui	Indicative
vierasottelua	None
noudattaisi	Conditional
kuopaisivat	Indicative
olet	Indicative
ryittää	Indicative
abstraktina	None
rikastutte	Indicative
työstä	Imperative-Jussive
prepannemme	Potential
valvovat	Indicative
häikäistyit	Indicative
rannikkojääkäriltä	None
suosikkijärjestelmittä	None
rahoittajan	None
rakennettaisiin	Conditional
peräänkuuluttaa	Indicative
rullatuoleilla	None
noudetaan	Indicative
juoksivat	Indicative
totutetaan	Indicative
egyptiläisen	None
jäätyy	Indicative
kutitimme	Indicative
survo	Imperative-Jussive
tunnustetaan	Indicative
varaavat	Indicative
hakeutui	Indicative
myrkyttivät	Indicative
nollannen	Potential
hiipuvat	Indicative
hiljensi	Indicative
hopeisiin	None
konkurssipesään	None
säestitte	Indicative
tasauksella	None
hurjettakoon	Imperative-Jussive
harhaanjohtavat	Indicative
monipuolistaa	Indicative
burka	None
lauhdutettaneen	Potential
silvotaan	Indicative
jäähtyy	Indicative
kilotin	Indicative
kariutetaan	Indicative
väiteltiin	Indicative
järkkynette	Potential
melkoisen	None
katsojat	None
määritettiin	Indicative
neuvotellaan	Indicative
kovenee	Indicative
lopetettaisiin	Conditional
pyyhkii	Indicative
helpottui	Indicative
paloittelivat	Indicative
työllistettiin	Indicative
lumoutui	Indicative
teetetään	Indicative
haihtuvan	None
sisusta	Imperative-Jussive
sivutaan	Indicative
sivallettakoon	Imperative-Jussive
kokisivat	Conditional
geneettisissä	None
ilotellette	Potential
olympiahistorian	None
haluan	Indicative
piirrän	Indicative
erotukset	None
elokuvafestivaali	None
hyväksyt	Indicative
muusikoilla	None
keräilivät	Indicative
vaaleanruskean	None
tarkoitat	Indicative
päättelet	Indicative
demonauhan	None
raskaassa	None
kaupunkilaistuisitte	Conditional
keitä	Imperative-Jussive
tyytännemme	Potential
poistun	Indicative
oletamme	Indicative
poistuu	Indicative
astronauttia	None
muisti	Indicative
onnistuisivat	Conditional
kuoreutuisit	Conditional
janitsaarissa	None
mysteerioita	None
kiristää	Indicative
peittoa	Imperative-Jussive
kuivattiin	Indicative
pyllystä	None
kartanoilla	None
kompastui	Indicative
halusin	Indicative
hössötä	Imperative-Jussive
epäiltiin	Indicative
suojele	Imperative-Jussive
pohdiskelee	Indicative
jäähdytti	Indicative
korjaili	Indicative
linkoa	Imperative-Jussive
raastaa	Indicative
löydä	Imperative-Jussive
upokkaaseen	None
kaadutaan	Indicative
äkkipikainen	None
levyttäisi	Conditional
maisemakuvat	None
kastu	Imperative-Jussive
irrottelin	Indicative
korostuivat	Indicative
paksusuolen	None
karbideja	None
konetykkiä	None
opasteisiin	None
ohittivat	Indicative
platformista	None
vastikkeetta	None
lohko	None
myöntyi	Indicative
suojuslehti	None
kattaisi	Conditional
korjauslukijalle	None
huutaa	Indicative
viitsii	Indicative
etääntyvät	Indicative
sohjoutuisin	Conditional
hehkuvat	Indicative
kuvitetaan	Indicative
illustraatioita	None
kunnostautuivat	Indicative
muodostaisivat	Conditional
ilmaisi	Conditional
uudistetaan	Indicative
pidättävät	Indicative
löllyimme	Indicative
laukaisevat	Indicative
houselle	None
kapusi	Indicative
hygroskooppista	None
suosittelisin	Conditional
vioituimme	Indicative
paloiteltiin	Indicative
tarvike	None
keloudun	Indicative
poistamisen	None
taittoi	Indicative
radikalisoituivat	Indicative
hahmotu	Imperative-Jussive
suhtaudutaan	Indicative
kilpailijoiksi	None
nuorrutitte	Indicative
nollataan	Indicative
porattiin	Indicative
absorptioitta	None
kostautui	Indicative
raadellemme	Potential
potutimme	Indicative
keinutan	Indicative
tallennetaan	Indicative
säikähti	Indicative
puristelisivat	Conditional
harkitse	Imperative-Jussive
ohitti	Indicative
ratsastivat	Indicative
nuortunet	Potential
lipeää	Indicative
tähdättiin	Indicative
kiipeää	Indicative
glutamaattia	None
hylkeenrasvojen	None
huljutettava	None
yksinkertaisti	Indicative
puhuttelevat	Indicative
rehellisyys	None
kuvastaisi	Conditional
vaihdeltiin	Indicative
heiketään	Indicative
gammapurkauksin	None
manifestoidaan	Indicative
suodin	Indicative
salvottaisiin	Conditional
nukuttaa	Indicative
kostuu	Indicative
kumartaa	Indicative
paulaan	None
katkettakoon	Imperative-Jussive
nelinkertaistuisit	Conditional
päivittivät	Indicative
laantui	Indicative
sarasta	Imperative-Jussive
halusivat	Indicative
valmiuden	None
muodostuivat	Indicative
puutuu	Indicative
tilastotieteestä	None
harventaa	Indicative
kaikerrettakoon	Imperative-Jussive
molekyyleiksi	None
muistotilaisuuksia	None
lääkärit	None
panssaroitiin	Indicative
vakioisit	Conditional
hengitetään	Indicative
raiskataan	Indicative
totea	Imperative-Jussive
airoja	None
vasemmistopuolueet	None
nalkutatte	Indicative
estäisin	Conditional
valtionkirkko	None
sekoittaisi	Conditional
vaivautuvat	Indicative
vihlaisisimme	Conditional
havaintoja	None
rohtukoon	Imperative-Jussive
omaksuvat	Indicative
pahensi	Indicative
kuvittelisin	Conditional
haihtumista	None
kauppakeskusten	None
kodinhoitajan	None
sairasti	Indicative
mielinen	Potential
mikrofilmin	None
tyhmennyn	Indicative
mykistänet	Potential
otaksuttiin	Indicative
kiekkoilijoita	None
alentaisi	Conditional
puhkeaa	Indicative
leikkii	Indicative
barbaariudetta	None
listasivat	Indicative
puhkaisee	Indicative
älyittä	None
dialektiikkaa	None
paikannussatelliitti	None
suurentaa	Indicative
lastuttiin	Indicative
vuosittaista	None
elintapaa	None
siteeraan	Indicative
etuilette	Indicative
järkyttivät	Indicative
lyöty	Imperative-Jussive
vietä	Imperative-Jussive
kiivettiin	Indicative
harjoiteltiin	Indicative
vei	Indicative
pätisitte	Conditional
löytyisi	Conditional
lohestimme	Indicative
uupuisit	Conditional
määräytyivät	Indicative
celsiusta	None
puolivälillä	None
entisiksi	None
romutti	Indicative
edellisvuotta	None
epäilisin	Conditional
haittasivat	Indicative
kaatuilevat	Indicative
syyttää	Indicative
vitamiineja	None
uupui	Indicative
suuntautuvat	Indicative
käsitteellistää	Indicative
lemppasi	Indicative
sulautettiin	Indicative
täydennettiin	Indicative
vuottaa	Indicative
pienensi	Indicative
tietokoneohjelmia	None
irtisanoi	Indicative
käärinevät	Potential
rohkaisi	Indicative
unohtuvat	Indicative
laitoshoitoa	None
ystävätärtä	None
kuljettivat	Indicative
pettävät	Indicative
konstaapelia	None
mellakatta	None
voittamattomina	None
päivään	Indicative
kehottavat	Indicative
salatut	None
estäisi	Conditional
katekismus	None
buprenorfiini	None
neuvonantajiin	None
mameroina	None
verottaa	Indicative
hämmästytti	Indicative
onnittelut	None
nuorensi	Indicative
kainostuttanen	Potential
kasvitieteellisiä	None
suostuin	Indicative
heität	Indicative
pakene	Imperative-Jussive
luotan	Indicative
azerintanee	Potential
miljardikertainen	None
syklisen	None
hoikistutaan	Indicative
sopeutetaan	Indicative
valmistui	Indicative
rehevöityisivät	Conditional
havaiji	None
raidat	None
pyydystää	Indicative
suotavana	None
taoismien	None
välikohtauksen	None
pelkistyvät	Indicative
lietsutkaa	Imperative-Jussive
toistettiin	Indicative
hyttyset	None
yhtenäistetään	Indicative
himmenee	Indicative
karkeista	Imperative-Jussive
hoksasin	Indicative
tiedostetaan	Indicative
ympärivuotiseen	None
pyhitti	Indicative
kaksinkertaista	Imperative-Jussive
progression	None
pyörisi	Conditional
nopeuksilla	None
toistaa	Indicative
akselistojen	None
paikantavat	Indicative
veikkaan	Indicative
vallankumousta	None
hankittiin	Indicative
arkontit	None
ilmaan	Indicative
fasismille	None
kilpistyivät	Indicative
jakoi	Indicative
paineastian	None
feminismiä	None
yhdentää	Indicative
turmelivat	Indicative
katkeaisi	Conditional
luopuisit	Conditional
latinalaisilla	None
inhosi	Indicative
viettelee	Indicative
kirkuvat	Indicative
havitteli	Indicative
henkilökohtaisuuksia	None
analogian	None
etuilivat	Indicative
matittaa	Indicative
syyllistyvät	Indicative
lennättää	Indicative
taisteli	Indicative
spektroskopiassa	None
opintorahan	None
korkeusperäsimistä	None
mummonmarkkaa	None
kirjoita	Imperative-Jussive
tarkoittaisi	Conditional
kirkastui	Indicative
hengailitte	Indicative
täyttäisivät	Conditional
derivaattoja	None
installoikaa	Imperative-Jussive
kaavaili	Indicative
kiverryttävä	None
samaista	Imperative-Jussive
kaakkoiseen	None
periytyi	Indicative
erkanee	Indicative
hirvettäneen	Potential
soma	None
piikiteltäköön	Imperative-Jussive
saattaisi	Conditional
kävelyllä	None
jaavalaisten	None
tapoin	Indicative
voidettiin	Indicative
mittasi	Indicative
väärennettäisiin	Conditional
esitellen	Potential
lopetusta	None
joustavoisimme	Conditional
kiitotietä	None
pakenisi	Conditional
raiskattiin	Indicative
upotettiin	Indicative
kevytmoottoripyöriä	None
käsikirjoitti	Indicative
hämmästyttäkööt	Imperative-Jussive
haaksirikkoutui	Indicative
määrään	Indicative
luokittunen	Potential
arkkimandriittana	None
lempinen	Potential
mesodermiltä	None
arvostetaan	Indicative
mikrofilmiltä	None
ikävuodet	None
loppuisivat	Conditional
lainasivat	Indicative
ristesi	Indicative
blantraisivat	Conditional
ikkunaostosten	None
hienoin	None
ylimääräisillä	None
divisioonat	None
kylvi	Indicative
leiripaikka	None
pysähtyivät	Indicative
sairastu	Imperative-Jussive
vangittiin	Indicative
tykkäsivät	Indicative
huomasi	Indicative
kostutetaan	Indicative
spekengundista	None
turvatyynyllä	None
hämmentyisit	Conditional
keveämpää	None
vien	Indicative
psykopaatti	None
esittänee	Potential
leijaili	Indicative
jakoivat	Indicative
järjestysnumeroon	None
osuisi	Conditional
aktiivista	Imperative-Jussive
puolustautui	Indicative
suljetaan	Indicative
harrastanemme	Potential
näit	Indicative
jäljensivät	Indicative
vakuuta	Imperative-Jussive
pelastautuivat	Indicative
hankaudumme	Indicative
sallittaisiin	Conditional
tarkasti	Indicative
täyty	Imperative-Jussive
taivutat	Indicative
puutteellinen	None
musketit	None
patriarkaksi	None
hipoi	Indicative
spekuloidaan	Indicative
olympiahopeaan	None
halkesi	Indicative
säästele	Imperative-Jussive
solmii	Indicative
hedonistisen	None
hilaan	Indicative
perään	Indicative
paimensi	Indicative
höyrystetään	Indicative
värjäsi	Indicative
käristyisitte	Conditional
rokannette	Potential
gingiviiteittä	None
maistuvan	None
karussa	None
raivokohtauksen	None
korreloisin	Conditional
hölmöjen	None
tarttuivat	Indicative
hellitti	Indicative
suorituksena	None
teurasti	Indicative
säätelee	Indicative
jokivarresta	None
kansita	Imperative-Jussive
yllätyin	Indicative
trilogian	None
himmenevät	Indicative
uskonpuhdistuksessa	None
hyödyntää	Indicative
veltostuttanet	Potential
laottakaa	Imperative-Jussive
välttyi	Indicative
tulistetaan	Indicative
äkämystyttäisit	Conditional
aivotärähdyksellä	None
väärinkäytetään	Indicative
jatkaisivat	Conditional
lapsenkaitsijaan	None
tahdista	Imperative-Jussive
todennäköisemmistä	None
sietää	Indicative
selvitän	Indicative
kitui	Indicative
sirota	Imperative-Jussive
viiltää	Indicative
klamydia	None
vaikuttivat	Indicative
nimittävät	Indicative
vyötä	Imperative-Jussive
hermostuttaa	Indicative
strategisilla	None
herneet	None
tervehdittiin	Indicative
jähmettyvät	Indicative
häivy	Imperative-Jussive
samaistavat	Indicative
limusiinin	None
vaarantaa	Indicative
seurakoirat	None
tarinaksi	None
pörhistyin	Indicative
äännähditte	Indicative
tornittaisimme	Conditional
säheltäisivät	Conditional
jäytäköön	Imperative-Jussive
reservaatit	None
vitsailevat	Indicative
kesyjen	None
ennakkopäätöstä	None
tottelemattomuuteen	None
ojentavat	Indicative
mursi	Indicative
edistyi	Indicative
kaipaisivat	Conditional
moduloidaan	Indicative
sukkinaatilla	None
tämänkaltaisten	None
kuivuivat	Indicative
fibaamme	Indicative
puhujalla	None
bantustanit	None
viittoo	Indicative
huuhtelee	Indicative
kirjo	Imperative-Jussive
busseihin	None
eskaloinut	None
virroittavat	Indicative
pingottakaa	Imperative-Jussive
nimikkeestä	None
kysymme	Indicative
nuorensit	Indicative
siivittää	Indicative
kuntouttaa	Indicative
slumppasin	Indicative
pyydystä	Imperative-Jussive
kuulostivat	Indicative
walesinspringerspanielissa	None
puhkesi	Indicative
harannette	Potential
soutu	None
pudottavat	Indicative
huoltaa	Indicative
katsekontaktista	None
kidutettiin	Indicative
ammatillistut	Indicative
noususta	None
pakina	None
kirmailkaamme	Imperative-Jussive
kankesimme	Indicative
kansallispuistoa	None
röhisette	Indicative
kompromissien	None
julkaistaisiin	Conditional
kovitteeksi	None
ääntävät	Indicative
tehokkaampaan	None
anniskelisi	Conditional
paikannutaan	Indicative
pussitetaan	Indicative
mahdollistavat	Indicative
ruuhkautuu	Indicative
suorittivat	Indicative
pudotin	Indicative
hakisit	Conditional
hyväksymme	Indicative
odotetaan	Indicative
riepottelevat	Indicative
pelotti	Indicative
vanhentuu	Indicative
varaudutaan	Indicative
kuusikulmaisia	None
merikäärmeeseen	None
lukittuu	Indicative
luvallistin	Indicative
hirttäkää	Imperative-Jussive
jutusta	Imperative-Jussive
suojautuivat	Indicative
tarkennettakoon	Imperative-Jussive
päällystää	Indicative
kotieläintieteittä	None
poikkeavalle	None
korjauksiin	None
sovelsit	Indicative
levittäytynette	Potential
osoittaudu	Imperative-Jussive
aasialaiset	None
poikasineen	None
kauluksella	None
rajoituksetta	None
jahdattiin	Indicative
tehoaisi	Conditional
yrität	Indicative
tasapainottavat	Indicative
puhun	Indicative
rajoitin	Indicative
vähentyi	Indicative
luoteisosassa	None
valikoitiin	Indicative
ukonputkiksi	None
ylläpitää	Indicative
puheohjelma	None
muuntui	Indicative
huononsi	Indicative
linjatkoon	Imperative-Jussive
lankesi	Indicative
joulukuusta	None
hyökkäile	Imperative-Jussive
vapautui	Indicative
tuulettaa	Indicative
sidonnaisine	None
epäluotettavaa	None
syrjäyttäisi	Conditional
oppimisympäristöä	None
vaihtakaa	Imperative-Jussive
rynnäkkökivääreitä	None
valikoituvat	Indicative
viimeisteli	Indicative
hakisin	Conditional
kielikuvat	None
sotilaallisin	None
aseistautuivat	Indicative
vähentää	Indicative
kehottivat	Indicative
köyhyysraja	None
erkanevat	Indicative
huippujen	None
ähkyn	Indicative
tunnistavat	Indicative
bahaiksi	None
hyväksyttää	Indicative
akkukäyttöisiä	None
toimittaa	Indicative
kuulalaakereissa	None
huitaisisin	Conditional
laittomuuksia	None
unohtivat	Indicative
haaksirikkoutuu	Indicative
veräjän	None
haluaa	Indicative
kohdellevat	Potential
naarmuttaa	Indicative
huviloita	None
morjenstakoot	Imperative-Jussive
muista	Imperative-Jussive
purjelautailuihin	None
heittoistuimen	None
puhuttaisiin	Conditional
sekoitetaan	Indicative
sievissä	None
ydinreaktioon	None
opastuksia	None
laulamme	Indicative
jalostetaan	Indicative
anasti	Indicative
vastustamattoman	None
haaveellisuudet	None
havaitsee	Indicative
tarvitsevat	Indicative
kerjäläisin	None
juottavat	Indicative
lepotilassa	None
murhaisi	Conditional
haetaan	Indicative
samoaa	Indicative
palautua	None
yhtiöitti	Indicative
korjasin	Indicative
ennustajat	None
valmista	Imperative-Jussive
järjestäjillä	None
propagandakuvalle	None
halo	Imperative-Jussive
mutkistuvat	Indicative
georgialaisten	None
kaipaisit	Conditional
adoptoitiin	Indicative
erottuvat	Indicative
diagnostisia	None
haisevammasta	None
toteutin	Indicative
herjaavat	Indicative
lievittyy	Indicative
oksensi	Indicative
asukkaille	None
vaurioituivat	Indicative
repeytyy	Indicative
täydensin	Indicative
ihannoidaan	Indicative
enenimme	Indicative
salakuuntelee	Indicative
asettautuivat	Indicative
tarkastavat	Indicative
nouseviin	None
signaalinkäsittely	None
itkivät	Indicative
höyhenpukua	None
barrakudana	None
soinnun	Indicative
tilastoidaan	Indicative
kranaatinheittimien	None
öljynkeräysaluksia	None
heikennemme	Potential
elättivät	Indicative
älyllistä	Imperative-Jussive
lomautettiin	Indicative
hallituskaudelta	None
kaivan	Indicative
hehtaarin	None
välittivät	Indicative
siiderin	None
räpäytettävä	None
purskauttaa	Indicative
löydät	Indicative
tallon	Indicative
modernisoitui	Indicative
ennättää	Indicative
koittaisi	Conditional
positiivi	None
kovettanet	Potential
pahastuin	Indicative
ruukussa	None
rauhoitteli	Indicative
järkyttyi	Indicative
uusiutui	Indicative
kovempana	None
voidaan	Indicative
mainosta	Imperative-Jussive
tutustut	Indicative
harkitsi	Indicative
sähköistä	Imperative-Jussive
tiilitä	Imperative-Jussive
ratkoo	Indicative
alppiniityillä	None
aloin	Indicative
soidinsivat	Indicative
sinkoa	Imperative-Jussive
alkuperistä	None
portaalilta	None
vakiintuivat	Indicative
anorektikot	None
suree	Indicative
värjätään	Indicative
pidättäytyivät	Indicative
murensi	Indicative
vähentyy	Indicative
ulostaa	Indicative
lohduttaa	Indicative
luovuttavat	Indicative
uinunemme	Potential
uutisoidaan	Indicative
talletetaan	Indicative
teologiselle	None
säälii	Indicative
jonotettiin	Indicative
epätavallisten	None
jäljittelivät	Indicative
hyväksyttäisi	Conditional
ilmeni	Indicative
valokin	None
krottikalalta	None
muutettaisiin	Conditional
palkitsevat	Indicative
rintasyöpien	None
kapseleina	None
noudatellen	Potential
paheksuivat	Indicative
riisutaan	Indicative
karista	Imperative-Jussive
uusiutuvat	Indicative
nirsoilisitte	Conditional
järisköön	Imperative-Jussive
kaiversi	Indicative
kielsi	Indicative
soveltuivat	Indicative
hartiassa	None
pyydystettiin	Indicative
ylvästelitte	Indicative
kielelliset	None
tuimene	Imperative-Jussive
marttyyrin	None
kertaantuu	Indicative
reversiibeliä	None
lanaisin	Conditional
houkutteeksi	None
vääristyvät	Indicative
uhoaa	Indicative
kursiivin	None
tapailee	Indicative
oleillen	Potential
nautitaan	Indicative
merimerkein	None
teurastaa	Indicative
yksityistettiin	Indicative
palaisi	Conditional
etsisi	Conditional
esittäisin	Conditional
tähteistä	None
taavetissa	None
informaatioteoria	None
oksisto	None
pänttäsin	Indicative
hierottakaamme	Imperative-Jussive
soitettiin	Indicative
juohdun	Indicative
liigajoukkuetta	None
pääkalloa	None
pauhun	None
freestylehiihtoon	None
lähettäisi	Conditional
ryhdyn	Indicative
nähtäisiin	Conditional
hakemuksista	None
syöttäjäksi	None
muotoisella	None
kaon	Indicative
hauskana	None
kaatuminen	None
mitätöntäisimme	Conditional
paleontologien	None
huokailisivat	Conditional
toimitettaisiin	Conditional
lukuisille	None
oppikaa	Imperative-Jussive
puutomaateitta	None
pehmensi	Indicative
paperoisi	Conditional
lomailevat	Indicative
kaivosmiehiä	None
muotoillevat	Potential
surmien	None
suositti	Indicative
ärrytään	Indicative
taipuisi	Conditional
säesti	Indicative
tykännee	Potential
emootioita	None
stola	None
lääkeaine	None
ruokailevat	Indicative
injektoidaan	Indicative
patentoitiin	Indicative
ristiriidattomia	None
sekopäinen	None
säästettäisiin	Conditional
oppikirjaa	None
arvostelevat	Indicative
tuoksun	Indicative
kastelee	Indicative
teoreettisista	None
neutralisoitiin	Indicative
piirittää	Indicative
öljykatastrofien	None
samaistuivat	Indicative
uroksia	None
syrjäyttivät	Indicative
haarautui	Indicative
matkustaa	Indicative
uskotellaan	Indicative
liukastuta	Imperative-Jussive
mätkäisee	Indicative
huolehtii	Indicative
rikastakoon	Imperative-Jussive
nähnevät	Potential
kruununvarastoitta	None
kirjastosta	None
liisaan	Indicative
kiinteisiin	None
rahoittaa	Indicative
nojasivat	Indicative
voittaisi	Conditional
hakeudutaan	Indicative
hölmöilee	Indicative
jättiputket	None
tarkistettiin	Indicative
kirjoittaisi	Conditional
sanottaisiin	Conditional
rehentelee	Indicative
tutkittavat	Indicative
ympäröitiin	Indicative
lomauttavat	Indicative
monumentteja	None
parannettaisiin	Conditional
leimaan	Indicative
varoitettiin	Indicative
avarsi	Indicative
lisäisivät	Conditional
itäsuomalainen	None
rukoili	Indicative
hapetetaan	Indicative
ahdistelevat	Indicative
käänteisfunktioita	None
apeuduttaisiin	Conditional
janoavat	Indicative
pohditaan	Indicative
vaihteista	None
osattaisiin	Conditional
olona	None
härmistyy	Indicative
perättäisinä	None
säännöstellään	Indicative
vangitsevat	Indicative
huononivat	Indicative
lyhentyy	Indicative
auttoi	Indicative
angolalaisista	None
juotti	Indicative
vanhentuvat	Indicative
sokaisi	Indicative
oksenneltaisiin	Conditional
vastaanottaa	Indicative
nostelee	Indicative
saartanette	Potential
vuorottelivat	Indicative
apureineen	None
kuusiaitaa	None
apilat	None
tallaan	Indicative
putkimieheen	None
infrastruktuuri	None
laitan	Indicative
läpsytellette	Potential
kurvikas	None
asettuvat	Indicative
vuotavat	Indicative
podin	Indicative
niitettiin	Indicative
metsästivät	Indicative
turhautui	Indicative
melotaan	Indicative
lisensoitiin	Indicative
tutkittaisiin	Conditional
kaasuunnun	Indicative
suuryrityksen	None
syttyisi	Conditional
liimannee	Potential
motti	None
komponentista	None
johdonmukaistanemme	Potential
maisemasuunnittelun	None
iskutilavuudella	None
kihujen	None
irrotuimme	Indicative
presisoidaan	Indicative
vauraasta	None
todennut	Indicative
mammonan	None
gastrektomioilla	None
vähenivät	Indicative
ruvetaan	Indicative
viitattiin	Indicative
abstrahointi	None
pakkailtaneen	Potential
sulkeutuu	Indicative
keskusyksikkö	None
supermarketissa	None
laskutaidoitta	None
juttelivat	Indicative
puuhaavat	Indicative
kavaltaa	Indicative
miljonääriksi	None
houkuttelivat	Indicative
välikorvan	None
vaarantavat	Indicative
ammattimaisesta	None
kosmonautteja	None
takaseinän	None
esittäytyi	Indicative
jaksotettakoon	Imperative-Jussive
langettivat	Indicative
merkitsevät	Indicative
kuurnitsen	Indicative
ampukaa	Imperative-Jussive
meloo	Indicative
valokset	None
näsiä	None
näppäilee	Indicative
syvensin	Indicative
ilmoittautumisen	None
yhteiskuntavastuun	None
potkaisi	Indicative
systemoikaa	Imperative-Jussive
johtolangoin	None
varmistuu	Indicative
kuluttaisi	Conditional
vongannet	Potential
elävöitti	Indicative
yhtenäistää	Indicative
koostuisivat	Conditional
näkivät	Indicative
pyörsimme	Indicative
suunnitelmasta	None
villasukat	None
siroavat	Indicative
ilmetty	None
vähäteltiin	Indicative
rymynnemme	Potential
ratkaisisivat	Conditional
mallintaa	Indicative
laavassa	None
mutatoiduttiin	Indicative
valmistaudutaan	Indicative
sääntelevät	Indicative
hermostuivat	Indicative
harkittiin	Indicative
paiskasi	Indicative
esivanhempi	None
viilettäisimme	Conditional
prekambrikaudella	None
nykyaikaisti	Indicative
katsoimme	Indicative
varautuivat	Indicative
lensi	Indicative
ystävystyi	Indicative
rajoitu	Imperative-Jussive
raiskaavat	Indicative
tukehduttaa	Indicative
uinut	Indicative
törmäsivät	Indicative
ulappalinnut	None
heliometrittä	None
hakeutuivat	Indicative
jouduttaa	Indicative
sotilaita	None
isontuisi	Conditional
aikeet	None
taannuttiin	Indicative
siirtomaatyylit	None
kylvivät	Indicative
innostuivat	Indicative
hymähdän	Indicative
järkyttyivät	Indicative
oikeamielisyys	None
konsulaatista	None
tipu	Imperative-Jussive
umpeuttaisi	Conditional
aitajuoksun	None
alivoimamaalia	None
pystyttäisi	Conditional
erikoisuutta	None
osui	Indicative
pieksänee	Potential
motorisoidut	Indicative
koettelee	Indicative
ennustivat	Indicative
katkeavat	Indicative
asentavat	Indicative
tehonnen	Potential
lannisti	Indicative
riistänemme	Potential
vaikeuttaa	Indicative
pumpataan	Indicative
vaikutin	Indicative
laajakaistaisesta	None
paastoin	None
ilmiannat	Indicative
interventiolla	None
syöttää	Indicative
muutti	Indicative
pyöräili	Indicative
hertsiin	None
nasaloinet	Potential
juopotta	None
pyörryttänen	Potential
laiskasta	None
kotiseudun	None
tarjoilee	Indicative
sokeutunut	None
huononee	Indicative
raahattiin	Indicative
äänestäkää	Imperative-Jussive
taittuvat	Indicative
irtautui	Indicative
viljelee	Indicative
kantaatit	None
kiellät	Indicative
lämpeni	Indicative
käyttökelpoisuus	None
pysähdymme	Indicative
paljoudesta	None
kamppailee	Indicative
lähetin	Indicative
lukitsevat	Indicative
sykliseksi	None
tunkeuduttiin	Indicative
ilmoittautui	Indicative
sotkeudu	Imperative-Jussive
mainitsen	Indicative
tehollisarvo	None
käsikirjoittivat	Indicative
omannee	Potential
aakkosta	Imperative-Jussive
valotti	Indicative
niityiksi	None
kukkuloilla	None
helpottuisi	Conditional
diletanteilla	None
aikaansaisi	Conditional
oikeusavustajana	None
ristinmerkillä	None
akustiikassa	None
kosiskelee	Indicative
esteettömiä	None
tiivistin	Indicative
konsertoikoon	Imperative-Jussive
lisääntyi	Indicative
keinu	Imperative-Jussive
vastatkoon	Imperative-Jussive
holistoonaan	Indicative
markkinointikampanjassa	None
luokiteltiin	Indicative
uskonnollisia	None
alavalla	None
hukkasivat	Indicative
myöhäisestä	None
aktiivipalvelukseen	None
balsamoidaan	Indicative
vaurioittaa	Indicative
sensuroidaan	Indicative
jatkunee	Potential
suomalaistaa	Indicative
purkaukset	None
perustivat	Indicative
terminaaleihin	None
linnoitettiin	Indicative
reunusti	Indicative
lyhensin	Indicative
paikannettiin	Indicative
kronikassa	None
ihasteli	Indicative
käsitti	Indicative
kutonen	Potential
jakaantuvat	Indicative
valmistelivat	Indicative
veti	Indicative
moninaistuttakoon	Imperative-Jussive
kiertolainen	None
asutetaan	Indicative
vason	Indicative
haarautuvat	Indicative
palaisivat	Conditional
altista	Imperative-Jussive
osallistu	Imperative-Jussive
laudalta	None
ponnistaa	Indicative
jalkapöydänluut	None
pestäisiin	Conditional
hiihtävät	Indicative
laventaa	Indicative
selittyisi	Conditional
umpieritysjärjestelmä	None
puhallettiin	Indicative
alkukohdaksi	None
hautautui	Indicative
menestyviä	None
vanhennat	Indicative
päälaelta	None
noudatat	Indicative
asusteli	Indicative
tasapainotetaan	Indicative
katsastusta	None
tekstintänemme	Potential
jätätti	Indicative
ajelehti	Indicative
havaitsen	Indicative
megawatin	None
ensihoitoon	None
harjoittelisin	Conditional
tulokirjauksilla	None
asioida	None
vastaanota	Imperative-Jussive
tarkasteli	Indicative
uudistui	Indicative
nuhtelu	None
dryasmarakatilta	None
puvusta	Imperative-Jussive
lähiomaisina	None
karkasivat	Indicative
räävittävä	None
auskultoinnin	None
seuraan	Indicative
nakkelee	Indicative
laiminlöi	Indicative
lipsahti	Indicative
sähköistää	Indicative
huumaantunee	Potential
kätkevät	Indicative
korjauttaisivat	Conditional
suunnista	Imperative-Jussive
unohduitte	Indicative
rullaluistellemme	Potential
omaksui	Indicative
omaksuu	Indicative
soittaisi	Conditional
unohtaa	Indicative
muotoilevat	Indicative
näyttelyihin	None
aiottiin	Indicative
voimistaa	Indicative
pakkaan	Indicative
pöyhistävät	Indicative
tunge	Imperative-Jussive
soutaa	Indicative
italialaisella	None
biometrisenä	None
kuvitelkoot	Imperative-Jussive
tiedotettiin	Indicative
katkeilee	Indicative
alentavat	Indicative
spiikatkaa	Imperative-Jussive
juoksuttaa	Indicative
tarjoaisi	Conditional
lievennettiin	Indicative
koodaavat	Indicative
työntyi	Indicative
vilisee	Indicative
musertaa	Indicative
veisti	Indicative
uhkailevat	Indicative
kohteliaana	None
kanuunoiden	None
vaurioita	Imperative-Jussive
onnistuit	Indicative
puhdistetaan	Indicative
myrskyä	Imperative-Jussive
hämärtää	Indicative
viihdyttää	Indicative
ystävystyvät	Indicative
hiisku	Imperative-Jussive
vaikutusvaltaisessa	None
sovellan	Indicative
huusivat	Indicative
kiisteltiin	Indicative
kuvakirja	None
grillattaneen	Potential
ulkoista	Imperative-Jussive
vakiota	None
kuristajan	None
riittäisivät	Conditional
ylevöittäisitte	Conditional
kiistelee	Indicative
suunnistavat	Indicative
kehitä	Imperative-Jussive
kaappaamme	Indicative
prepatkoot	Imperative-Jussive
kykenisivät	Conditional
hautautuivat	Indicative
toivotettiin	Indicative
tutustutaan	Indicative
solukkoihin	None
johdu	Imperative-Jussive
reunustavat	Indicative
automekaanikoille	None
alustavat	Indicative
huuhtoutuvat	Indicative
äänikerraksi	None
onkinen	Potential
ponnisti	Indicative
eksplanatiivinen	None
ruotsalaista	Imperative-Jussive
ajanmukaistettiin	Indicative
riippuisi	Conditional
diskosi	Indicative
porata	None
vaapun	Indicative
maestrot	None
käytettiin	Indicative
vartiomiehiin	None
oleskelee	Indicative
rikkoo	Indicative
kantautuivat	Indicative
vältyttäisiin	Conditional
löi	Indicative
puuroudut	Indicative
kantautui	Indicative
tehostavat	Indicative
harjoitellaan	Indicative
toimenpiteisiin	None
eläköityi	Indicative
lävistetty	None
rikkoutuvat	Indicative
kuuntelevat	Indicative
lähentelevät	Indicative
pahoinpidellään	Indicative
yltetään	Indicative
jokeltelemme	Indicative
rintamassa	None
lyyhistyn	Indicative
luistellen	Potential
kiihtyy	Indicative
herättää	Indicative
ompelulangoille	None
helpota	Imperative-Jussive
kuulosti	Indicative
kellertävät	Indicative
uitettiin	Indicative
niityllä	None
osmania	None
suojaan	Indicative
vanun	Indicative
hohkasilikaatteihin	None
kulissia	None
saksalaistetaan	Indicative
todennetaan	Indicative
itsenäistyvät	Indicative
jatka	Imperative-Jussive
purevia	None
selvitettiin	Indicative
aneli	Indicative
pyöritä	Imperative-Jussive
uhkarohkean	None
muokkasin	Indicative
piirtänette	Potential
rahamarkkinoilla	None
sarakkeiden	None
kansantajuistettaneen	Potential
paheni	Indicative
sadistein	None
diivaillen	Potential
opettele	Imperative-Jussive
tapattaa	Indicative
ansaitaan	Indicative
demokratisoidu	Imperative-Jussive
höyryä	Imperative-Jussive
ilmoittavat	Indicative
soikoon	Imperative-Jussive
peittele	Imperative-Jussive
lastenlääkärin	None
mestataan	Indicative
listaan	Indicative
vetäydyttiin	Indicative
tallensit	Indicative
nääntyi	Indicative
huuteli	Indicative
raivasivat	Indicative
numeroitiin	Indicative
skismaa	None
kilpailutetaan	Indicative
susihämähäkille	None
simulaatioita	None
mollasivat	Indicative
kryptaan	Indicative
jankuttaa	Indicative
modernisti	Indicative
viskatkoon	Imperative-Jussive
suoritti	Indicative
naamioidut	Indicative
onki	Indicative
paikkasi	Indicative
latvasta	None
huonontui	Indicative
palttava	None
matkaavat	Indicative
pistävät	Indicative
ulvoo	Indicative
juurtui	Indicative
tulpinnevat	Potential
vaikuttanee	Potential
raamatullisessa	None
sameutukoot	Imperative-Jussive
tilasi	Indicative
andalusiitti	None
pääjohtajaa	None
pistettiin	Indicative
muuntuvat	Indicative
mytologiaa	None
duffeleilla	None
listasi	Indicative
hirtetään	Indicative
rahastoisimme	Conditional
voinen	Potential
liimattiin	Indicative
koristi	Indicative
peruivat	Indicative
sytyttämistä	None
rokahduttakoon	Imperative-Jussive
rähjännette	Potential
katsoisi	Conditional
lejeeraan	Indicative
kangastuimme	Indicative
valmistun	Indicative
pilkkaavat	Indicative
tukinuiton	None
parasiitit	None
kytkeytyi	Indicative
käristettäneen	Potential
kaihtavat	Indicative
etsikää	Imperative-Jussive
nolottavat	Indicative
vilkaisen	Indicative
dramatiikkana	None
kiihdytykseen	None
haluaisimme	Conditional
ilmenisi	Conditional
saippuaoopperaa	None
lievitetään	Indicative
rajoitti	Indicative
suuntasivat	Indicative
sisällytettiin	Indicative
eriytyä	None
ohittaa	Indicative
pamputtaa	Indicative
nukahtaa	Indicative
vannon	Indicative
vastustamme	Indicative
tuijotatte	Indicative
ydinjätteiden	None
tappoi	Indicative
ruskistuu	Indicative
mustatiira	None
mahtuivat	Indicative
sienestä	Imperative-Jussive
kokeneesta	None
vahvoja	None
simulaation	None
naisväen	None
vedettiin	Indicative
karsastuksen	None
erimielisyyksissä	None
seikkailusarja	None
seinämiä	None
vihellettiin	Indicative
kierähti	Indicative
pelasivat	Indicative
jarruttavat	Indicative
risteyttää	Indicative
suostumuksella	None
steppaajineen	None
raivosi	Indicative
kiepsahtanen	Potential
passittanemme	Potential
laajensi	Indicative
provosoikaa	Imperative-Jussive
vaso	Imperative-Jussive
merkkaavat	Indicative
merkkaan	Indicative
balsapuusta	None
kaupataan	Indicative
harrasti	Indicative
hupsahtivat	Indicative
pilapiirtäjät	None
kolahtaa	Indicative
alppihiihdossa	None
tympeytyisitte	Conditional
syöksee	Indicative
ihailijaksi	None
vierailtiin	Indicative
laitosta	Imperative-Jussive
tulostaa	Indicative
puolustele	Imperative-Jussive
pimeyteen	None
tietosanakirjojen	None
integroidaan	Indicative
muokkaisin	Conditional
ennustat	Indicative
ovovivipaarisuuksiksi	None
suojelkoon	Imperative-Jussive
kirpaisee	Indicative
vähätteli	Indicative
valvokaa	Imperative-Jussive
säiliötä	None
koituivat	Indicative
törmäytetään	Indicative
ruusuja	None
turvauduttiin	Indicative
pidimme	Indicative
kadehdittiin	Indicative
erottunevat	Potential
paatosta	None
dialektista	None
aurataan	Indicative
testaan	Indicative
menehtyisi	Conditional
ihastuu	Indicative
pahoittelee	Indicative
hävitettäisiin	Conditional
jukan	None
ratkaisin	Indicative
yhteytä	Imperative-Jussive
muistin	Indicative
nastoittakaamme	Imperative-Jussive
ohita	Imperative-Jussive
ballistisista	None
polttavaa	None
tuulen	Indicative
asettuu	Indicative
laita	Imperative-Jussive
vahingoitettiin	Indicative
arkistoitaisiin	Conditional
kantautuva	None
perinnöllisyystiedettä	None
jakaisivat	Conditional
taisteltiin	Indicative
virtahepo	None
pelästyi	Indicative
lakkautetaan	Indicative
hyrisit	Indicative
sekoili	Indicative
metsästysase	None
liioittelivat	Indicative
elliptinen	None
ilmoitan	Indicative
eritellään	Indicative
kesti	Indicative
turhautuisit	Conditional
humanistisiin	None
suostuvat	Indicative
kaivavat	Indicative
palautteita	None
välittää	Indicative
tyvissä	None
alakulttuuri	None
prikaatia	None
riemuitse	Imperative-Jussive
analytiikan	None
pelastettiin	Indicative
taiottaisiin	Conditional
integraalille	None
vierähti	Indicative
luopui	Indicative
ohjeistetaan	Indicative
epäreiluna	None
opetetaan	Indicative
epäonnistuttiin	Indicative
yksityistää	Indicative
sylkäisi	Indicative
palentukoon	Imperative-Jussive
kiihdytin	Indicative
emäaluksista	None
viivyttivät	Indicative
merisaarron	None
sukaisee	Indicative
nautiskellevat	Potential
uppopaistetaan	Indicative
laotti	Indicative
tavoiteltaneen	Potential
seittejä	None
kokoelmalla	None
kiristävät	Indicative
palataan	Indicative
pesee	Indicative
käärylettä	None
ranskalaistetaan	Indicative
kiedotaan	Indicative
huomaisit	Conditional
viuhdot	Indicative
julkaisemiseen	None
saksalaistui	Indicative
pyörittelimme	Indicative
kysellen	Potential
petkutti	Indicative
ravista	Imperative-Jussive
karstaantukoot	Imperative-Jussive
koettelevat	Indicative
kerääntyi	Indicative
edesauttaisi	Conditional
alaviitteisiin	None
huomioihin	None
skannasi	Indicative
henkiolento	None
harmaina	None
vajoaa	Indicative
laillistukoot	Imperative-Jussive
luokittelisi	Conditional
kiittelee	Indicative
tukeudutaan	Indicative
keskeyttivät	Indicative
videopeliksi	None
tiedotteet	None
diagrammi	None
tarkistakaa	Imperative-Jussive
harjoitti	Indicative
luottivat	Indicative
epämääräisen	None
remontoidaan	Indicative
ojensi	Indicative
pesältä	None
kestin	Indicative
aakkostetaan	Indicative
analysoitiin	Indicative
toffeet	None
elähdyttäkää	Imperative-Jussive
kääntäisin	Conditional
ylettyi	Indicative
oravalla	None
venähtää	Indicative
fransiskaanien	None
ujeltakaa	Imperative-Jussive
murisee	Indicative
hyötöreaktorin	None
varmista	Imperative-Jussive
punertavaan	None
painiskeli	Indicative
pyöristä	Imperative-Jussive
kiinnitti	Indicative
kulkevat	Indicative
avatkaa	Imperative-Jussive
transversaalilta	None
sisällytetään	Indicative
ruumiinosa	None
jätevedenpuhdistamot	None
vesittyi	Indicative
siirtyivät	Indicative
tarkistan	Indicative
kuumensivat	Indicative
leiriytyivät	Indicative
varmistaa	Indicative
pelkistettiin	Indicative
ilmoittaisivat	Conditional
miedontaisivat	Conditional
välttävät	Indicative
harjataan	Indicative
runomittaa	None
arvoin	Indicative
ritilä	None
katolikos	None
vilkaisisimme	Conditional
pohjustettiin	Indicative
spraydeodorantteihin	None
osaisin	Conditional
tohtoreiksi	None
sammuisi	Conditional
samaistivat	Indicative
muotoutuu	Indicative
hyökätään	Indicative
raportoikaamme	Imperative-Jussive
rukoile	Imperative-Jussive
poistuisi	Conditional
rakastelivat	Indicative
haukutaan	Indicative
tehokkaampana	None
tihkuu	Indicative
kaapattiin	Indicative
kivettiin	Indicative
mieltävät	Indicative
katkon	Indicative
vieroksutaan	Indicative
sakaalin	None
mahdollistettiin	Indicative
tehoaa	Indicative
sekoittui	Indicative
näkökulmiin	None
kestettiin	Indicative
romahduttaa	Indicative
lahjoitti	Indicative
kaivaa	Indicative
instrumentein	None
hiukkasfyysikko	None
värilliselle	None
työstetään	Indicative
joudun	Indicative
separaatiot	None
lakkautettava	None
kotieläimiä	None
vellonen	Potential
tippui	Indicative
hillinnyt	None
vannotaan	Indicative
graafista	None
huijataan	Indicative
onnistuivat	Indicative
pakastuisi	Conditional
suojelijoiksi	None
rikiksi	None
kesäyö	None
liberaalistuisin	Conditional
tunkeutuvat	Indicative
ajellaan	Indicative
käsittelisi	Conditional
kokan	None
kaupallistui	Indicative
koskettavat	Indicative
ennustavat	Indicative
sallittiin	Indicative
selviytykää	Imperative-Jussive
johdatella	None
kaipaisin	Conditional
viivästyivät	Indicative
korvataan	Indicative
pysäyttävät	Indicative
kiirastorstai	None
järkyttävät	Indicative
nukahti	Indicative
turvapaikanhakijoille	None
siteenä	None
kiidätti	Indicative
tyhjentävät	Indicative
pelehtikäämme	Imperative-Jussive
mekanismiksi	None
mitataan	Indicative
täyttyi	Indicative
isänmaallisiin	None
näytelmillä	None
vähäksyisitte	Conditional
rajoittuisi	Conditional
vakuuttuu	Indicative
kieltää	Indicative
puraisee	Indicative
bitumoisitte	Conditional
kuolettavat	Indicative
pöpelikköihin	None
rasiaa	None
tarkensi	Indicative
raakakypsyttäisimme	Conditional
kelpuutettiin	Indicative
taipui	Indicative
kunniallisia	None
meripihkoista	None
voittaa	Indicative
repesivät	Indicative
juottaa	Indicative
mutkittelevat	Indicative
kehittäisivät	Conditional
hyökättiin	Indicative
ompeli	Indicative
kolminkertaistuu	Indicative
erottuivat	Indicative
pikakurssi	None
puolustat	Indicative
laskevat	Indicative
eräänlainen	None
viihtyvät	Indicative
rikotaan	Indicative
hassutellee	Potential
kannatin	Indicative
vakuutettiin	Indicative
väistävät	Indicative
kasvinsyöjien	None
arkisin	None
mummolan	None
avioituivat	Indicative
kypsyy	Indicative
esitetään	Indicative
ilmasta	Imperative-Jussive
kiiltonahoilta	None
hammastivat	Indicative
summaan	Indicative
laukaisee	Indicative
edustavalla	None
kellastuttaisivat	Conditional
purjehditaan	Indicative
kaivataan	Indicative
hapettuu	Indicative
vaikeutetaan	Indicative
hävittäjälentäjän	None
poneihin	None
uudistaa	Indicative
kiihtyvällä	None
naksuta	Imperative-Jussive
eristävät	Indicative
tehostetaan	Indicative
siirtonopeuden	None
suoda	Imperative-Jussive
rällättiin	Indicative
syyllisty	Imperative-Jussive
päde	Imperative-Jussive
puristetaan	Indicative
välittyvät	Indicative
uhrattiin	Indicative
tilden	None
ulotettiin	Indicative
ruotsalaistuivat	Indicative
lohduttaisi	Conditional
kopahdin	Indicative
palaavat	Indicative
polttareihin	None
haukina	None
vankeusaika	None
orjuutti	Indicative
korjauskelvottomaksi	None
uhkailtiin	Indicative
sormustimellisesta	None
jäädytettiin	Indicative
hievauttavat	Indicative
jakaantuisi	Conditional
suosikeista	None
luonnosteltiin	Indicative
karsittaisiin	Conditional
säänteli	Indicative
valtaapitävän	None
arvaan	Indicative
suosisin	Conditional
maskannette	Potential
pullistuvat	Indicative
sokaistaan	Indicative
kuihtuu	Indicative
ehdotti	Indicative
monipuolistuvat	Indicative
virittää	Indicative
ilmaisesta	None
rakastuin	Indicative
eroteltiin	Indicative
korjailin	Indicative
ulottui	Indicative
pidetään	Indicative
grillataan	Indicative
ajatteluun	None
otatti	Indicative
purjehti	Indicative
natisutamme	Indicative
metsästän	Indicative
ylistelisin	Conditional
tehosta	Imperative-Jussive
piristä	Imperative-Jussive
nebuloosa	None
järjesteltiin	Indicative
kerrostalojen	None
hohtavat	Indicative
esiinny	Imperative-Jussive
kisaavat	Indicative
vesitti	Indicative
korvasin	Indicative
verrata	None
koeteltiin	Indicative
uittaa	Indicative
hanurista	None
ilmennyt	Indicative
luiskahdellen	Potential
muokkautuvat	Indicative
lakkoiltiin	Indicative
hepreaksi	None
huiskittaneen	Potential
valloitettiin	Indicative
liittyivät	Indicative
istuisi	Conditional
rinteellä	None
havittelee	Indicative
mainostoimistoa	None
estetismin	None
vastasit	Indicative
esiarkeeista	None
sisältyivät	Indicative
erikoisesta	None
autoin	Indicative
iskostuisin	Conditional
emissio	None
samankaltaista	Imperative-Jussive
annostellaan	Indicative
testaavat	Indicative
tyrmäystippoina	None
rukoillen	Potential
hämätkööt	Imperative-Jussive
osoitteiksi	None
eliminoitiin	Indicative
kilpailisivat	Conditional
jähmettyivät	Indicative
suortukaamme	Imperative-Jussive
perustaisi	Conditional
kehittää	Indicative
hoikistanevat	Potential
nuijasota	None
väkivallalla	None
lahjoitusten	None
debattiin	Indicative
moninkertaisti	Indicative
huokoistukoot	Imperative-Jussive
tekaistiin	Indicative
svengattakoon	Imperative-Jussive
puhkeavat	Indicative
intiantiikeri	None
huokailisimme	Conditional
valtaavat	Indicative
kandelan	None
jousta	Imperative-Jussive
sinelmiä	None
sotii	Indicative
mafioilta	None
paleltuvat	Indicative
viitsikööt	Imperative-Jussive
kasautuu	Indicative
kannattajanikama	None
luomisopin	None
oopperoita	None
tuuletti	Indicative
äänitettiin	Indicative
neulokselle	None
liittoutui	Indicative
mietiskelevä	None
komensi	Indicative
kaareutuisin	Conditional
kirjoitettaisiin	Conditional
nokea	Imperative-Jussive
peittoon	None
tapahtunee	Potential
rahoittaisi	Conditional
peruselintarvikkeita	None
kestävät	Indicative
optiona	None
homoseksuaalisuutta	None
kaliiperia	None
tuumailisivat	Conditional
säikäytti	Indicative
tummenna	Imperative-Jussive
yöpyi	Indicative
malariaan	None
mukautuu	Indicative
griljeeraat	Indicative
liskon	None
luisti	Indicative
vastaanottokeskuksen	None
hengaillaan	Indicative
toteutuu	Indicative
swahilia	None
paistattelevat	Indicative
museoitiin	Indicative
liberalisoituvat	Indicative
vieroksuvat	Indicative
lämmitti	Indicative
vangitsi	Indicative
enterokokit	None
tokeegekko	None
pienentävät	Indicative
höyryttäisi	Conditional
jäykistyvät	Indicative
vaarallisiksi	None
selity	Imperative-Jussive
saavun	Indicative
abstraktistetaan	Indicative
puhdistanen	Potential
vääristi	Indicative
pankkiirien	None
seuloisin	Conditional
heijastunemme	Potential
rytistettäneen	Potential
oppisivat	Conditional
translitteroidaan	Indicative
huivi	None
jatkojohtoon	None
estin	Indicative
ohjastaa	Indicative
köyristyttiin	Indicative
maametallista	None
graavasimme	Indicative
järjestelmällistä	Imperative-Jussive
ymmärsin	Indicative
balkanisoitunee	Potential
kiroaa	Indicative
potkaisee	Indicative
valtasivat	Indicative
suuntaan	Indicative
tuimennette	Potential
aineistetaan	Indicative
avartukoon	Imperative-Jussive
tallentunut	None
useimmissa	None
elinvuosien	None
rauhoittuisi	Conditional
avaruusolioita	None
kuntoutuksella	None
jonottivat	Indicative
haalistuu	Indicative
naulaisimme	Conditional
voitaneen	Potential
lavassa	None
kääriytyisivät	Conditional
maleksisivat	Conditional
kulkisi	Conditional
läpäisevät	Indicative
nytkäyttävät	Indicative
hautoi	Indicative
kasvatettaisiin	Conditional
halkaisi	Indicative
nykynäkymään	None
läsisivät	Conditional
korjattiin	Indicative
ohjelmoidaan	Indicative
hyvästeli	Indicative
purjelautailisi	Conditional
liittyisi	Conditional
ilmensi	Indicative
kaarekkeilta	None
sisältyy	Indicative
uskaltakaamme	Imperative-Jussive
parantelee	Indicative
resurssi	None
säntäävät	Indicative
pumpun	None
muokkautuu	Indicative
pienenivät	Indicative
haavoittivat	Indicative
ratsasti	Indicative
toteutunee	Potential
lisäisi	Conditional
veikistelijät	None
keskittävät	Indicative
sodankäynnissä	None
erottuisi	Conditional
hitsaajan	None
sotke	Imperative-Jussive
selkiintynet	Potential
taisteluksi	None
lyheni	Indicative
juontaa	Indicative
taivalsi	Indicative
painottavat	Indicative
onnistuttiin	Indicative
synteesien	None
unhoittaa	Indicative
katselette	Indicative
tunnustaisivat	Conditional
selviytyi	Indicative
juontui	Indicative
jatkaa	Indicative
uidaan	Indicative
sallisivat	Conditional
tulipaloihin	None
pysäyttelevät	Indicative
väistyvät	Indicative
paukkunen	Potential
harjoitetaan	Indicative
käännytetään	Indicative
tuhoudu	Imperative-Jussive
telejä	None
suositeltiin	Indicative
staattisuus	None
läpinäkyväksi	None
täsmensin	Indicative
alustavissa	None
kopioidaan	Indicative
merilain	None
järjestettiin	Indicative
teetettiin	Indicative
metyylivinyyliketonit	None
istuutui	Indicative
tyhjensi	Indicative
nuokahtelette	Indicative
päättäjäisissä	None
jauhettiin	Indicative
pysytään	Indicative
velkaisimmassa	None
tiedä	Imperative-Jussive
vandaaleilla	None
taottiin	Indicative
sekaantuisi	Conditional
istuutuu	Indicative
hankaloitui	Indicative
liigautukoot	Imperative-Jussive
vääntelisimme	Conditional
tyrehtyisin	Conditional
patisti	Indicative
heittäytyivät	Indicative
mielletään	Indicative
kalterien	None
odottavat	Indicative
muistat	Indicative
korjatkaa	Imperative-Jussive
surmattiin	Indicative
äänestettiin	Indicative
pohdiskelevat	Indicative
haistoi	Indicative
maadumme	Indicative
lauloi	Indicative
päihittäköön	Imperative-Jussive
käsittäisin	Conditional
jalostettiin	Indicative
ylikonstaapeli	None
hedelmäisiksi	None
jarruuntuvat	Indicative
laivalastilliseksi	None
ulostavat	Indicative
kosiskeli	Indicative
parantuisi	Conditional
sisustan	Indicative
letittäkää	Imperative-Jussive
jauhaannutaan	Indicative
outokvarkkeja	None
dynastiana	None
ihastutti	Indicative
eroottista	Imperative-Jussive
syrjäytyi	Indicative
kansallispäiviltä	None
saartaa	Indicative
helmestä	Imperative-Jussive
pursottaisit	Conditional
maantieteelliset	None
kohdistui	Indicative
kuvasivat	Indicative
viljellään	Indicative
kidutetaan	Indicative
pursuaa	Indicative
johdattavat	Indicative
nopeutti	Indicative
komppaan	Indicative
maamyyriin	None
diskannevat	Potential
valu	Imperative-Jussive
rautaesiripuin	None
aiheuttaa	Indicative
lineaarikuvaus	None
toi	Indicative
katso	Imperative-Jussive
huomattakoon	Imperative-Jussive
trakyyteille	None
jännäisi	Conditional
heikentäisi	Conditional
peräsi	Indicative
heittäytyy	Indicative
soveltaa	Indicative
vahingoittivat	Indicative
saksalaisia	None
kalaisia	None
parantavat	Indicative
plussaan	Indicative
jaotat	Indicative
kiinnittää	Indicative
valikoidut	Indicative
määräävät	Indicative
värjäytynette	Potential
lypsivät	Indicative
hukuttaa	Indicative
parittelevat	Indicative
sähköenergian	None
pysynen	Potential
etuuden	None
valloittaa	Indicative
paikallisti	Indicative
ruikuttakoot	Imperative-Jussive
rikastui	Indicative
keikkaillen	Potential
kliseitä	None
hämmentää	Indicative
koulutuskeskus	None
keikkaili	Indicative
sisältyi	Indicative
sivuta	Imperative-Jussive
vannoo	Indicative
siemenaiheita	None
pitkittää	Indicative
sikailevat	Indicative
vastahiukkasena	None
maustettiin	Indicative
keskitetään	Indicative
asuntomessuilla	None
katalysoinet	Potential
ihmetelkööt	Imperative-Jussive
käynnistettiin	Indicative
puhuisi	Conditional
suutaroinevat	Potential
kiihottuu	Indicative
kaatui	Indicative
antautuisivat	Conditional
friteeraisi	Conditional
vahingollisiksi	None
kohdista	Imperative-Jussive
flirttaili	Indicative
sivilisaatioissa	None
pelkistetään	Indicative
siivoaa	Indicative
otsikoitiin	Indicative
ataksiaa	None
katsoisin	Conditional
fakkiintunen	Potential
nimiöisimme	Conditional
vihjataan	Indicative
valjasti	Indicative
tuonen	Potential
kuljettiin	Indicative
luomme	Indicative
syyllistyn	Indicative
jäntevöittävät	Indicative
murskasivat	Indicative
käräyttää	Indicative
homottelen	Indicative
kahvalla	None
uudistivat	Indicative
ylpeilee	Indicative
kasvojenkohotus	None
kadotetaan	Indicative
jonottaa	Indicative
kanalisoinevat	Potential
jouda	Imperative-Jussive
etsisin	Conditional
yksittäiseltä	None
rampaantuisit	Conditional
lennätin	Indicative
purjehtinen	Potential
loppuu	Indicative
mitattiin	Indicative
ajattelija	None
vakuutti	Indicative
uudistusmielinen	None
solmikoot	Imperative-Jussive
mustapää	None
kypsennyttäisiin	Conditional
sytyttäneen	Potential
sepitti	Indicative
klassismin	None
uranuurtajien	None
ässällä	None
divisioonissa	None
vieraillen	Potential
riensivät	Indicative
leimautui	Indicative
pistä	Imperative-Jussive
jaksoksi	None
turvattiin	Indicative
muutu	Imperative-Jussive
vakaan	Indicative
ohene	Imperative-Jussive
austroaasialaisetta	None
pitäisit	Conditional
hehtaariin	None
zoofiili	None
selkeytti	Indicative
perustat	Indicative
kiihdyttävät	Indicative
vähentyisi	Conditional
uskalsin	Indicative
tekoälyyn	None
jakautui	Indicative
viitannut	None
toivotti	Indicative
ilmaisimesta	None
erikoistui	Indicative
hämmensi	Indicative
nuoruusaika	None
kunnianhimon	None
vapauttakaa	Imperative-Jussive
raahasivat	Indicative
kyselivät	Indicative
mielenilmauksia	None
miellyttävät	Indicative
vakiinnuttaa	Indicative
kyntäkäämme	Imperative-Jussive
ilmoituksella	None
kellertyisin	Conditional
komeili	Indicative
sisennys	None
kertautukoot	Imperative-Jussive
raotuttiin	Indicative
tunnusti	Indicative
suorita	Imperative-Jussive
kuikka	None
kumppanuuksia	None
tasoittuvat	Indicative
haukkuu	Indicative
hurmasi	Indicative
menettelee	Indicative
majoittaa	Indicative
päädymme	Indicative
maksullista	Imperative-Jussive
kelpaisi	Conditional
riippukoon	Imperative-Jussive
määrätietoiseksi	None
aminohappoihin	None
kohtaamme	Indicative
pyöräilee	Indicative
katsahdettu	None
kuvioinen	Potential
laitoin	Indicative
sairaudessa	None
menetellen	Potential
aavikkojerbon	None
naavoitutte	Indicative
vakiintuu	Indicative
kulminoituu	Indicative
peittyy	Indicative
allekirjoita	Imperative-Jussive
ivataan	Indicative
syöttävät	Indicative
briiffannee	Potential
muodostanette	Potential
negligoisitte	Conditional
pyramidien	None
alkusoitolla	None
kannattelitte	Indicative
siittiöstä	None
soittivat	Indicative
kammoaisin	Conditional
putkipostitta	None
heijastin	Indicative
pyhitämme	Indicative
laihdu	Imperative-Jussive
silene	Imperative-Jussive
asetehtaat	None
totuttaisiin	Conditional
tasapainoillaan	Indicative
sylinterimäisessä	None
juoksee	Indicative
sujuivat	Indicative
vety	Imperative-Jussive
epäsuotuisia	None
antautuvat	Indicative
ontui	Indicative
mutistaan	Indicative
koekilpi	None
loit	Indicative
kampakeraamista	None
jatku	Imperative-Jussive
haki	Indicative
katkesi	Indicative
naurata	Imperative-Jussive
koneellistuisit	Conditional
raataa	Indicative
ihmettelivät	Indicative
kolonisoikaamme	Imperative-Jussive
kolminkertaistaa	Indicative
taustasäteilyä	None
maaliviivasta	None
täplitetään	Indicative
julistivat	Indicative
hommautukaa	Imperative-Jussive
ylitarkastajaksi	None
orjuuttaa	Indicative
pelastuivat	Indicative
jähmetti	Indicative
opastanut	None
faneerilta	None
huiskintoihin	None
ruskossa	None
laahaantukoot	Imperative-Jussive
komissiota	None
värähtelevät	Indicative
tunsin	Indicative
vastaavaksi	None
kartioleikkausta	None
lisäsin	Indicative
heru	Imperative-Jussive
takavuosilta	None
lahjovat	Indicative
kärjistä	Imperative-Jussive
tyhjentää	Indicative
lauantaisin	None
avaavat	Indicative
harjoitutti	Indicative
yhdysvaltalainen	None
pysäytit	Indicative
futurismista	None
lamautimme	Indicative
moraalisin	None
haalenitte	Indicative
ravistellaan	Indicative
satuttaisi	Conditional
pingiksillä	None
hyperbolisessa	None
ostin	Indicative
dieselöinniksi	None
ropiskoon	Imperative-Jussive
torjun	Indicative
kasvatti	Indicative
hypnotisoija	None
uskottiin	Indicative
dubataan	Indicative
jäähdyttävät	Indicative
ostelin	Indicative
fanita	Imperative-Jussive
piirityskone	None
hakkasi	Indicative
vaivasivat	Indicative
äännettiin	Indicative
nuru	Imperative-Jussive
laajenevat	Indicative
johdattaisitte	Conditional
tylppenemme	Indicative
tuhlaisi	Conditional
lausuvat	Indicative
taivaankappaleisiin	None
sitoutuvat	Indicative
rintamapalvelukseen	None
rukoilee	Indicative
maadoittaisi	Conditional
kopioitiin	Indicative
suovat	Indicative
irvailen	Indicative
täyttyvät	Indicative
raunioitti	Indicative
siirtäisivät	Conditional
pauloihin	None
vainosivat	Indicative
sekaantuu	Indicative
aurinkokaloitta	None
kestit	Indicative
puna	None
räjäyttävät	Indicative
ikivihreiden	None
jäsentävät	Indicative
levittäytyi	Indicative
väritettiin	Indicative
tarpeellisella	None
golfia	None
veikataan	Indicative
epäilisivät	Conditional
irrotti	Indicative
varjosi	Indicative
ruohonleikkureita	None
koettelivat	Indicative
ryhmittymistä	None
puunannet	Potential
väljennettävä	None
riippui	Indicative
tankkaus	None
hierontaan	None
hupenivat	Indicative
kiittää	Indicative
harpon	Indicative
lomailee	Indicative
nimeäisimme	Conditional
näytettä	None
homoseksuaalisuudeksi	None
syötettiin	Indicative
avantgardistinen	None
välttyy	Indicative
arkeologisin	None
hennon	Indicative
valuttaa	Indicative
välttelee	Indicative
juonet	Potential
hoituu	Indicative
alittivat	Indicative
pidennetään	Indicative
uskoteltiin	Indicative
salataan	Indicative
tuliaseilla	None
läntätkäämme	Imperative-Jussive
pituuksille	None
pronssiottelu	None
pohdittiin	Indicative
hiihtää	Indicative
liioittelevat	Indicative
tasasi	Indicative
putoilivat	Indicative
aaltoa	Imperative-Jussive
ekologiset	None
varmistettaisiin	Conditional
kurottavat	Indicative
tallimestareina	None
hurmion	None
tunkeutuu	Indicative
halailkaa	Imperative-Jussive
lommouduttiin	Indicative
bongasin	Indicative
lapsuudesta	None
puhaltavat	Indicative
jaksossa	None
neuvostoliittolaiselle	None
ostajan	None
kaivaudu	Imperative-Jussive
prosessoidaan	Indicative
maankuori	None
kelpuuttaa	Indicative
unohtaisi	Conditional
tunnustamme	Indicative
painottaa	Indicative
muotoilee	Indicative
kurjan	None
lyyhistyi	Indicative
laskeutuisi	Conditional
hämättäneen	Potential
palstoittaa	Indicative
punertavat	Indicative
tasoittanut	None
vilkuilevat	Indicative
haittaan	Indicative
nykyaikaisuuksille	None
alita	Imperative-Jussive
oksetutin	Indicative
sotataito	None
valtuutuksella	None
radikaalisti	Indicative
peilaillen	Potential
sukeltaa	Indicative
kevettäköön	Imperative-Jussive
neuvottele	Imperative-Jussive
aristan	Indicative
urheiluseuroille	None
tavoittelivat	Indicative
virvatulina	None
sallituissa	None
yritä	Imperative-Jussive
vahinkoa	None
tiedeseura	None
määrittivät	Indicative
kunnostautuu	Indicative
kärkyit	Indicative
inositoli	None
kuihtui	Indicative
saksinen	Potential
muotoillaan	Indicative
kirosi	Indicative
pestautui	Indicative
vesialueet	None
huipentuvat	Indicative
möivät	Indicative
puraisi	Indicative
sisustaa	Indicative
purista	Imperative-Jussive
välilehteen	None
kumosit	Indicative
jesuiitat	None
etuilkoon	Imperative-Jussive
kasuavat	Indicative
kiveksiin	None
traileria	None
marjo	Imperative-Jussive
yrittää	Indicative
omaehtoiselle	None
itsestäänselvyys	None
odottakaa	Imperative-Jussive
kaunistaa	Indicative
sivulliset	None
naamioitiin	Indicative
syöksit	Indicative
vertasin	Indicative
esiintyy	Indicative
tyhmensivät	Indicative
nujerra	Imperative-Jussive
rukoilisi	Conditional
käsittelemme	Indicative
äänestetään	Indicative
luontevalla	None
nauroivat	Indicative
lepäsin	Indicative
mukailee	Indicative
uurasti	Indicative
kiiruhtivat	Indicative
kirjallisella	None
arvostavat	Indicative
peruskorjataan	Indicative
koostaa	Indicative
orientaation	None
suositteli	Indicative
rytmiikka	None
kopautit	Indicative
alleviivasi	Indicative
aikaistaa	Indicative
muistellen	Potential
soita	Imperative-Jussive
haastettiin	Indicative
kansoittaa	Indicative
heijastui	Indicative
kuohkeni	Indicative
data-arkistolta	None
synnyttää	Indicative
rohkein	None
hahmotti	Indicative
luovun	Indicative
kihlasi	Indicative
muuttaisi	Conditional
lahjoi	Indicative
ketjuttivat	Indicative
ennustaa	Indicative
kykenevät	Indicative
köyhtyivät	Indicative
päkistänemme	Potential
lineaariseksi	None
varrensi	Indicative
lähdekoodi	None
huuhtoisi	Conditional
selittää	Indicative
ripusti	Indicative
heiluvat	Indicative
risteily	None
mielenkiinnosta	None
ilmoitit	Indicative
väittivät	Indicative
intohimoon	None
rouhiuduttaisiin	Conditional
mobilisoitiin	Indicative
suolla	Imperative-Jussive
kinoassa	None
juonittelee	Indicative
kohdistuu	Indicative
smokkipukuisiin	None
digitaalistukaa	Imperative-Jussive
ulkoilevat	Indicative
arpoi	Indicative
kovetetaan	Indicative
riisuvat	Indicative
hivuttaudumme	Indicative
korttipakasta	None
altistaa	Indicative
ampuisi	Conditional
epävirallisena	None
jainalaisuus	None
rauhoittuivat	Indicative
rattaiden	None
instrumentoisin	Conditional
haavoittaa	Indicative
luonnehdittakoon	Imperative-Jussive
vekitin	Indicative
kamppailussa	None
rahapulassa	None
kuivaus	None
hurrasi	Indicative
puna-armeijaa	None
asetehtaiden	None
digitalisoitiin	Indicative
toteuttivat	Indicative
juonii	Indicative
sahaamisista	None
väitän	Indicative
hormoneja	None
kilpailevat	Indicative
lämmitin	Indicative
piristää	Indicative
osakilpailuissa	None
tosiasialliset	None
happamoittavat	Indicative
makeampi	None
tangossa	None
ruokintapaikalle	None
suudellaan	Indicative
messua	Imperative-Jussive
revolvereilla	None
ryhtyvät	Indicative
ehtisivät	Conditional
valtasi	Indicative
heikkenevät	Indicative
peruuntui	Indicative
järjestyy	Indicative
heraldiikka	None
hierottiin	Indicative
posliinikaupan	None
ostavat	Indicative
painellaan	Indicative
leikitään	Indicative
peräänkuulutti	Indicative
rappeuduttaisiin	Conditional
altistutaan	Indicative
syöt	Indicative
supistui	Indicative
omissa	None
lukukauden	None
rientää	Indicative
irrottivat	Indicative
kuumuuden	None
mainostavat	Indicative
kohahdeltaisiin	Conditional
skaalauduttaneen	Potential
vilahtavat	Indicative
keskitin	Indicative
lukuja	None
luovuttiin	Indicative
rentoutusten	None
sellaiselta	None
metsästäjää	None
epäonnistuisi	Conditional
säästyi	Indicative
tulista	Imperative-Jussive
synagogasta	None
tarkastellen	Potential
vaarantaisi	Conditional
korostetaan	Indicative
tasoittivat	Indicative
keskittyivät	Indicative
autettiin	Indicative
kustansivat	Indicative
selostin	Indicative
peittyivät	Indicative
kohdistuisi	Conditional
ehkäistään	Indicative
modifioidut	Indicative
hait	Indicative
mullistaa	Indicative
kuljimme	Indicative
sitoivat	Indicative
splitannette	Potential
pysyi	Indicative
harsikoon	Imperative-Jussive
katkesivat	Indicative
eritteli	Indicative
selitykset	None
varustettaisiin	Conditional
tarttuisi	Conditional
iskijän	None
kuoriainen	None
postitetaan	Indicative
hakivat	Indicative
piti	Indicative
tiedät	Indicative
harkituista	None
kastoi	Indicative
pottuiltaneen	Potential
sairaalloisuuksin	None
paisuttelisivat	Conditional
perennana	None
lylyiksi	None
fäppäätte	Indicative
välttivät	Indicative
jouluaikaan	None
unkarilaista	None
pohjustivat	Indicative
hermokudoksessa	None
isketään	Indicative
peruspalveluja	None
naulata	None
rikkoisi	Conditional
kätkeytyi	Indicative
taivutti	Indicative
jäljentää	Indicative
huudettiin	Indicative
taskurapu	None
käräjillä	None
vääristyttäisiin	Conditional
sporalogia	None
jalanjäljen	None
kuivatettiin	Indicative
akallinen	None
työministeriön	None
kiihdytte	Indicative
siipien	None
painottui	Indicative
kuljetin	Indicative
taklasi	Indicative
ällistellee	Potential
teroitettiin	Indicative
langetetaan	Indicative
ryhmittymä	None
tyrmistyttäisivät	Conditional
lankaisivat	Conditional
pujottanevat	Potential
kirjelmän	None
tiesit	Indicative
kumoutuu	Indicative
köyttä	None
systemaattisen	None
pompoteltaisiin	Conditional
levenen	Indicative
tiedotusvälineet	None
rimpuillee	Potential
hoidettaisiin	Conditional
huononevat	Indicative
räjähti	Indicative
tallentaa	Indicative
auditiivinen	None
saapuivat	Indicative
naamioituivat	Indicative
peruu	Indicative
suitsutuspuikosta	None
suoritetaan	Indicative
puolittavat	Indicative
kuvottaisin	Conditional
paanuttanet	Potential
osanottoa	None
järjesteli	Indicative
kannustin	Indicative
luotaneen	Potential
kerrostui	Indicative
jauhaa	Indicative
sanajärjestyksen	None
hovioikeudet	None
pyöritetään	Indicative
rikkaalle	None
pelikonsoleineen	None
dubata	None
koituisi	Conditional
juotaneen	Potential
alkavat	Indicative
kuljettaisi	Conditional
pistän	Indicative
tonkii	Indicative
huomauttaisin	Conditional
hyppynarulta	None
suomalaisina	None
pidätti	Indicative
studioalbumiksi	None
suosita	Imperative-Jussive
tiedusteltiin	Indicative
suostun	Indicative
irrottaa	Indicative
tyypilliset	None
liimaantui	Indicative
tilaan	Indicative
kaikkinielevästä	None
valtionuskonnon	None
itsenäistyisi	Conditional
kyettiin	Indicative
kajahtaisin	Conditional
juodaan	Indicative
maalajit	None
halia	None
sieppaus	None
suulaki	None
ikkunoinen	Potential
kiihkon	None
lakkauttaa	Indicative
sisäistä	Imperative-Jussive
löysi	Indicative
haukkuivat	Indicative
luvata	None
yhdenmukaistettiin	Indicative
kodittoman	None
tiedostettiin	Indicative
paloitellaan	Indicative
maatalossa	None
muuttujien	None
lähetät	Indicative
osuin	Indicative
lainopillisen	None
höllentää	Indicative
valmentavat	Indicative
kuvittele	Imperative-Jussive
pelikenttä	None
tuoksu	Imperative-Jussive
anodien	None
äestyttänen	Potential
artikkeleissa	None
majoitti	Indicative
riitelevät	Indicative
ikääntyvät	Indicative
turvannet	Potential
hiljentää	Indicative
japanissa	None
väärentää	Indicative
tuoksuu	Indicative
peloteltiin	Indicative
joukkoviestintä	None
kostoilta	None
rotukoiriksi	None
krepsien	None
joivat	Indicative
sotaisia	None
lyhenevät	Indicative
maratonille	None
johdattaisi	Conditional
merkittiin	Indicative
kätyrien	None
suuttuivat	Indicative
ennätyksellisen	None
aseidenriisunnan	None
raahautuu	Indicative
lahoa	None
istun	Indicative
väistin	Indicative
asumukseen	None
tärväsi	Indicative
epäilen	Indicative
luhistuisi	Conditional
malta	Imperative-Jussive
totesit	Indicative
laskettaisiin	Conditional
kerskutte	Indicative
rasvatonta	None
juhlistettiin	Indicative
viisasta	Imperative-Jussive
tunnettaneen	Potential
pimeni	Indicative
porautuu	Indicative
lamantiini	None
järjestelee	Indicative
suurennettiin	Indicative
hankkiutui	Indicative
harvinaistuu	Indicative
jäätyisi	Conditional
poissulkisivat	Conditional
naura	Imperative-Jussive
ohentumatta	None
keskeytettiin	Indicative
pelastivat	Indicative
ilmestyvät	Indicative
varjo	None
pysyin	Indicative
määrittelisi	Conditional
ydinjätehuollon	None
partaisinta	None
kannettavia	None
kruunattakoon	Imperative-Jussive
eläköön	Imperative-Jussive
pyörähti	Indicative
tehoa	Imperative-Jussive
sotilasvallankaappauksen	None
juoksijoille	None
muuteltiin	Indicative
emännöitsijä	None
imeytetään	Indicative
valokuvaajaksi	None
uhkaan	Indicative
venäläistykää	Imperative-Jussive
kohahdutti	Indicative
äänestysoikeuden	None
karkottivat	Indicative
feminiinisyys	None
avataan	Indicative
suunnannen	Potential
soditaan	Indicative
luopuivat	Indicative
eksyin	Indicative
venyttivät	Indicative
tutkita	Imperative-Jussive
lentotukialukset	None
väheksy	Imperative-Jussive
lämpösäde	None
tartutti	Indicative
nelonen	None
puhelinkioskit	None
takavetoisen	None
soitellaan	Indicative
vilkastui	Indicative
heiluttaa	Indicative
lentopallon	None
käytti	Indicative
ampumisessa	None
runsassiemenisessa	None
hapatetaan	Indicative
saksofonistin	None
viljoista	None
rikun	Indicative
laskeuduttaneen	Potential
ajastin	Indicative
puolustautua	None
mölisisin	Conditional
joogaan	Indicative
jatkettiin	Indicative
ojentuvat	Indicative
jatkavat	Indicative
sulkavan	None
faktaa	None
saneerasimme	Indicative
rätkäisköön	Imperative-Jussive
paistaisi	Conditional
rankkarit	None
irrottautui	Indicative
sisäpiirin	None
näyttäytyi	Indicative
ihmeteltiin	Indicative
pukeudu	Imperative-Jussive
nälkiintyisitte	Conditional
liberaalinen	None
konkannevat	Potential
etäännyttää	Indicative
säestää	Indicative
nykymusiikkia	None
pidät	Indicative
sateiseen	None
numeeristaisivat	Conditional
karsintaottelut	None
haastoivat	Indicative
ylikuumeni	Indicative
tyydyttiin	Indicative
imusuonet	None
laivataan	Indicative
välkkyvät	Indicative
säädettäisiin	Conditional
säädettiin	Indicative
ajauduin	Indicative
laihtuu	Indicative
harrastettiin	Indicative
pyyhitään	Indicative
ketsuppia	None
pimensi	Indicative
koosta	Imperative-Jussive
litran	None
tallennu	Imperative-Jussive
perua	None
kapeimmassa	None
koettaa	Indicative
saksansi	Indicative
kiikasta	Imperative-Jussive
käyneet	None
heitti	Indicative
tummumista	None
uuttuisimme	Conditional
ristiluu	None
näytetään	Indicative
kunnarin	None
isähahmona	None
lenninräpylöissä	None
kastauduitte	Indicative
kansakoulujen	None
lätkitty	None
huiputtaa	Indicative
nähtiin	Indicative
keisarikunnalla	None
liehuu	Indicative
sievenee	Indicative
antautuu	Indicative
aktivoidaan	Indicative
tervehditään	Indicative
seison	Indicative
valkenee	Indicative
solmitaan	Indicative
tšuvassia	None
forinteitta	None
vertailee	Indicative
etulinjasta	None
opastaa	Indicative
paperitehdasta	None
kata	Imperative-Jussive
ilahdu	Imperative-Jussive
vuorijonoja	None
sulki	Indicative
arvioiva	None
määräytyvät	Indicative
krypto	None
keskittyisivät	Conditional
neutraalista	Imperative-Jussive
kommitoinemme	Potential
kierroslukumittarissa	None
varmistan	Indicative
isoympyrä	None
putosi	Indicative
sahattiin	Indicative
löydettiin	Indicative
pidättyi	Indicative
koristellaan	Indicative
derivoidaan	Indicative
fyssiin	None
ymmärretään	Indicative
räikeän	None
hajusta	Imperative-Jussive
agraarisille	None
soittaisivat	Conditional
prerafaeliitit	None
pokassa	None
osta	Imperative-Jussive
unohduksen	None
rakennutti	Indicative
tarvitse	Imperative-Jussive
avustajiin	None
sirotellaan	Indicative
kulje	Imperative-Jussive
uitetaan	Indicative
eriytyi	Indicative
armeijakunnasta	None
piirikunnaksi	None
uhrautuu	Indicative
hiillostaa	Indicative
kehui	Indicative
kytkennässä	None
sisäpihoilla	None
rakenteista	Imperative-Jussive
provosoidu	Imperative-Jussive
mekastatte	Indicative
tupsahti	Indicative
leivos	None
vitsaili	Indicative
alentuisin	Conditional
tahoitta	None
kerrosta	Imperative-Jussive
tiivistävät	Indicative
pariloida	None
jokihelmisimpukoilta	None
yllyttivät	Indicative
väkirehuun	None
kampitetaan	Indicative
jokeri	None
pakenivat	Indicative
rikottiin	Indicative
atriumeina	None
kiisteli	Indicative
aiheutuisi	Conditional
myrkkykaasua	None
hyödytti	Indicative
aallotar	None
nappasivat	Indicative
ratsastajat	None
pääsaarella	None
hiippailee	Indicative
viimeistellen	Potential
tulium	None
suuntautuivat	Indicative
näppäyksinä	None
edistää	Indicative
inspiraatioita	None
kehityshäiriöiden	None
ratkaisi	Indicative
palveluntarjoaja	None
kokoontuisivat	Conditional
epäsäännöllisin	None
leyhyivät	Indicative
kokisin	Conditional
vastustettiin	Indicative
saarnaavat	Indicative
jäljittänyt	None
vesitiivistä	Imperative-Jussive
liikunnanohjaajaksi	None
ukkosta	Imperative-Jussive
venesatamaa	None
epäiltyä	None
palasivat	Indicative
kuvittelivat	Indicative
uhkaili	Indicative
vaakunaan	None
tuottavat	Indicative
murtoviiva	None
narisutimme	Indicative
velvollisuuksien	None
ulottivat	Indicative
lokerosta	None
hämmästyi	Indicative
sambannee	Potential
tokaisi	Indicative
äpärät	None
palloteltaneen	Potential
räjäytetään	Indicative
puoltavat	Indicative
sivuutetaan	Indicative
harmaantuvat	Indicative
mansiin	None
saattueeseen	None
pakkolunastaa	Indicative
toin	Indicative
edistäviä	None
varttui	Indicative
perusta	Imperative-Jussive
vinttikoirat	None
filmatisoinnissa	None
yksinkertaisuuden	None
edulliseksi	None
konvergoisivat	Conditional
väsytettäneen	Potential
kullattu	None
pysyvää	None
pelkältä	None
mittelöllä	None
tavoitellaan	Indicative
aritmetiikassa	None
ruokintapaikoilla	None
viritettiin	Indicative
ihottuma	None
innostuvat	Indicative
ymmärrätte	Indicative
kukistavat	Indicative
moninkertaistimme	Indicative
muokkaan	Indicative
vedenlaatuun	None
kajoa	Imperative-Jussive
puhalletaan	Indicative
ahdistuneisuushäiriö	None
lukkiutuvat	Indicative
käsitän	Indicative
terrakotta	None
raivoaa	Indicative
lukusana	None
nojautuvat	Indicative
suurentavat	Indicative
helähtäisin	Conditional
diskoteekit	None
sekoittivat	Indicative
hämmästeli	Indicative
seestyin	Indicative
lyhentänyt	None
jakautuivat	Indicative
rotko	None
häikäistään	Indicative
hoikennevat	Potential
häämötti	Indicative
pilkkoutuvat	Indicative
pyöristettiin	Indicative
mekanismi	None
täytä	Imperative-Jussive
ihmiskunnalle	None
äärettömyys	None
oion	Indicative
hoitelevat	Indicative
oksideista	None
substantiivilla	None
kirjoitin	Indicative
mainitsisi	Conditional
alennuksen	None
kintsanaa	None
puoltaisivat	Conditional
fossiiliset	None
paljastaa	Indicative
änkyttää	Indicative
jarrutti	Indicative
sairasteli	Indicative
lähennymme	Indicative
pohjusti	Indicative
oksasta	Imperative-Jussive
tehopisteittä	None
hetkellisistä	None
viritetään	Indicative
tragedioissa	None
puhutellaan	Indicative
subarktista	None
näyttävät	Indicative
vaivaiskoivuja	None
uhkaisivat	Conditional
valitan	Indicative
kieltoihin	None
tyrmättiin	Indicative
meisti	Indicative
valoisalta	None
tampataan	Indicative
kyrpiköön	Imperative-Jussive
kissaeläimistä	None
heikkenee	Indicative
löisi	Conditional
kalasta	Imperative-Jussive
hidastettiin	Indicative
siivitti	Indicative
kuljetti	Indicative
mannapuurosta	None
hahmottuvat	Indicative
epäonnistui	Indicative
hiljaisin	None
sijoitetaan	Indicative
taittuivat	Indicative
kostan	Indicative
värväsi	Indicative
nivoutui	Indicative
pyöristetään	Indicative
luonnistavat	Indicative
simpanssi	None
kasvititte	Indicative
yllättyivät	Indicative
rellestää	Indicative
saveuduitte	Indicative
latinaistanee	Potential
vinoilla	None
räjähtävät	Indicative
rikkovat	Indicative
värjään	Indicative
selosti	Indicative
pannoittaisivat	Conditional
tarkastuksen	None
haihtuvat	Indicative
paistettiin	Indicative
paperitehtaat	None
nablattaneen	Potential
liioiteltiin	Indicative
taukoa	Imperative-Jussive
tutustuttanemme	Potential
asutat	Indicative
samaistui	Indicative
koituvat	Indicative
uskottelivat	Indicative
riivattu	None
veistivät	Indicative
opettelevat	Indicative
työskentelen	Indicative
ärsyyntyi	Indicative
kolmiulotteisuuden	None
ylpistänet	Potential
eskaloitui	Indicative
biofysiikka	None
divarin	None
kiinnityksiä	None
kummastuttaa	Indicative
työnnältäisitte	Conditional
kätkettiin	Indicative
valehtelevat	Indicative
koristeiden	None
logossa	None
möläyttää	Indicative
tukialueita	None
nukuttaisimme	Conditional
rengastetaan	Indicative
korostin	Indicative
patosivat	Indicative
harotatte	Indicative
keskittivät	Indicative
varattomia	None
latelisit	Conditional
kankea	Imperative-Jussive
suostuttelivat	Indicative
kesyyntyy	Indicative
osoittautuu	Indicative
kissattomien	None
tilittää	Indicative
provosoituu	Indicative
luonnistu	Imperative-Jussive
luovutettu	None
lanseerasivat	Indicative
kaavinta	None
varoittaa	Indicative
kyti	Indicative
riivasi	Indicative
tunnistin	Indicative
laittavat	Indicative
kirjaudu	Imperative-Jussive
hidastui	Indicative
paiskautui	Indicative
kerrostimme	Indicative
lavat	None
ennakoisimme	Conditional
vahti	Indicative
kohderyhmäksi	None
puurtaa	Indicative
ohjeisti	Indicative
jakautuu	Indicative
rakkaussuhteet	None
yllättivät	Indicative
viritä	Imperative-Jussive
torjuvat	Indicative
kuristustaudit	None
haudataan	Indicative
kiinailimme	Indicative
rakensivat	Indicative
tarinana	None
hälyttävät	Indicative
kuuntelee	Indicative
kalskahdettaisiin	Conditional
millaisissa	None
saarnasivat	Indicative
alkoivat	Indicative
porataan	Indicative
tepsutetaan	Indicative
imperfektiä	None
pienistä	None
luokittuvat	Indicative
parittele	Imperative-Jussive
filamenttilangatta	None
lukitsi	Indicative
hiirestä	Imperative-Jussive
katsonee	Potential
kovistelee	Indicative
kiukkuna	None
pahentaa	Indicative
synnytetään	Indicative
käytäntöjen	None
mielsi	Indicative
keskusteltiin	Indicative
viestittää	Indicative
paljasta	Imperative-Jussive
puolitin	Indicative
edustuksen	None
merkitsivät	Indicative
kymmenjärjestelmä	None
omakotitaloa	None
kuittasi	Indicative
kuukahtakoot	Imperative-Jussive
suututtaa	Indicative
yhtämittaisuutena	None
nuorukaiseen	None
autiommalta	None
uudestisyntynet	Potential
kuvautuvat	Indicative
pidättää	Indicative
lämpenevät	Indicative
vaikutti	Indicative
lomittukoot	Imperative-Jussive
nytkykää	Imperative-Jussive
hypoteesiin	None
modernisoidut	Indicative
keisareihin	None
vahingoittuivat	Indicative
sinertävät	Indicative
rahoittivat	Indicative
sinkoutui	Indicative
käsitykseksi	None
univormua	None
sorkkinen	Potential
tokaisimme	Indicative
roseen	None
rikon	Indicative
pysykööt	Imperative-Jussive
roiku	Imperative-Jussive
kunnaria	None
australialaisuuksilta	None
kalskahtaa	Indicative
lihoo	Indicative
manuaalia	None
järkytti	Indicative
kuorrut	Indicative
haavoittuvat	Indicative
kerjäläiset	None
vainoaa	Indicative
ulotteiset	None
käsilaukku	None
auttava	None
mitoitetaan	Indicative
hengitti	Indicative
kajentakoon	Imperative-Jussive
rasitus	None
rikka	None
moodi	None
kombinaatista	None
vuodat	Indicative
tarjoutuu	Indicative
ratsukkoihin	None
voimistui	Indicative
kiihdytti	Indicative
sortivat	Indicative
harmittavat	Indicative
huudattaisi	Conditional
tulehduskipulääke	None
nälkiintyivät	Indicative
yksityishenkilönä	None
kirahtaisin	Conditional
pronssiset	None
kiedottiin	Indicative
hopeamitalisteineen	None
rullat	None
koostuivat	Indicative
teurastavat	Indicative
sairastivat	Indicative
sitoi	Indicative
kannattelivat	Indicative
merkitset	Indicative
omistettiin	Indicative
sisälmykset	None
piereksinemme	Potential
sukkia	None
aluevesiltä	None
väistä	Imperative-Jussive
murhattiin	Indicative
toisinajattelijoihin	None
pullottaa	Indicative
nakkelisivat	Conditional
yleistävät	Indicative
valloitetaan	Indicative
hoitaisi	Conditional
ravintotiheinä	None
vierastaa	Indicative
paijaisivat	Conditional
rojalteista	None
rohkenin	Indicative
kuolainta	None
onnistutaan	Indicative
katkottiin	Indicative
promenadikonserttiin	None
klaaratkoot	Imperative-Jussive
oranssinpunaisia	None
aikovat	Indicative
haaksirikkoutunut	None
seisoitte	Indicative
löydettäisiin	Conditional
romuttui	Indicative
tähkikööt	Imperative-Jussive
paiskautukaa	Imperative-Jussive
tasapainotti	Indicative
aateloitu	None
rakensi	Indicative
merileijonien	None
klaaraisin	Conditional
ruiskutettiin	Indicative
katkaisee	Indicative
konstruoidaan	Indicative
vääntyvät	Indicative
kartoittaisivat	Conditional
jouduttaisi	Conditional
sitoutuisivat	Conditional
vahingoittui	Indicative
kurssissa	None
naureskellen	Potential
marmoroitaisiin	Conditional
taloudenhoitajitta	None
peruskorjasi	Indicative
irvaili	Indicative
