opettelee	Third person Singular
pettyy	Third person Singular
hermotettaisiin	None
kansliapäällikkönä	None
turmeli	Third person Singular
rehulle	None
kastuu	Third person Singular
jumiutui	Third person Singular
salakuljettaa	Third person Singular
sähköenergiaa	None
rappeutumassa	None
kohoa	Second person Singular
farkkuihin	None
näkee	Third person Singular
ehkäisevät	Third person Plural
puvusta	Second person Singular
humanismeilta	None
suitset	Second person Singular
lakanoita	None
hellittää	Third person Singular
upposivat	Third person Plural
huutokaupalla	None
nopeutuisi	Third person Singular
mustangia	None
löytyy	Third person Singular
nyppäisee	Third person Singular
kiehu	Second person Singular
tulemiseen	None
tuberkuloosin	None
inhoan	First person Singular
valkuaisaineiden	None
kiteyttäisi	Third person Singular
kuivuu	Third person Singular
esiintymisistä	None
filantrooppiseen	None
kellotaajuudet	None
seuloi	Third person Singular
purkauksessa	None
mutkisti	Third person Singular
kipusi	Third person Singular
hallitsi	Third person Singular
estäisi	Third person Singular
pohjautuivat	Third person Plural
alkaaneilla	None
virheellisinä	None
koordinaatistoille	None
purkautuivat	Third person Plural
plaanannet	Second person Singular
vekititte	Second person Plural
osia	None
huolestuivat	Third person Plural
mielekkyydestä	None
täytti	Third person Singular
sitoi	Third person Singular
peninkulmasta	None
lumisessa	None
ikääntymiseen	None
tunnistin	First person Singular
leikki	Third person Singular
katkoa	None
käyttäytyi	Third person Singular
voitelee	Third person Singular
räjäytti	Third person Singular
pysäyttää	Third person Singular
paloittelevat	Third person Plural
sivuuttaa	Third person Singular
siroaa	Third person Singular
riisuu	Third person Singular
erkaantui	Third person Singular
jakaantuivat	Third person Plural
lumimyrskyn	None
istumapaikkaa	None
vehkeilevät	Third person Plural
kerry	Second person Singular
katselisimme	First person Plural
vaihtelevat	Third person Plural
hallintajärjestelmät	None
valloitti	Third person Singular
hyvästelevät	Third person Plural
tunnette	Second person Plural
kumoaa	Third person Singular
löystyvät	Third person Plural
paranteli	Third person Singular
hummaisivat	Third person Plural
varoi	Third person Singular
editoisitte	Second person Plural
suhtautui	Third person Singular
vallankumouksellisena	None
pätkii	Third person Singular
käyttäydy	Second person Singular
huhtoi	Third person Singular
pamputtaa	Third person Singular
pyhitti	Third person Singular
aikuisviihdettä	None
vietit	Second person Singular
pakenee	Third person Singular
kesti	Third person Singular
teloittaa	Third person Singular
kertaistui	Third person Singular
lennättää	Third person Singular
paperiliittimissä	None
yövyimme	First person Plural
ylityksessä	None
kiteytti	Third person Singular
ruhjoi	Third person Singular
viritin	First person Singular
eduskuntavaalit	None
kaupunginhallitusta	None
telakoituivat	Third person Plural
naimattomuus	None
frekventatiiveissa	None
sihdannen	First person Singular
eskaloitui	Third person Singular
ärsyttivät	Third person Plural
korkopisteeksi	None
jatkuu	Third person Singular
tympeydyn	First person Singular
harjoittelee	Third person Singular
riemuitsevat	Third person Plural
ratkaise	Second person Singular
pahentaisi	Third person Singular
sahanpurua	None
syrjäytyivät	Third person Plural
muotoili	Third person Singular
huuhtoi	Third person Singular
epävakaiden	None
astutin	First person Singular
sijaisimme	First person Plural
taisin	First person Singular
sekaantuvat	Third person Plural
vähenevät	Third person Plural
ukottui	Third person Singular
pese	Second person Singular
tehoaa	Third person Singular
lautasliinoille	None
dekoodereista	None
aasianrakonokalla	None
siirtyisivät	Third person Plural
yhdyskuntia	None
keskeytyvät	Third person Plural
painostanemme	First person Plural
yksinäistynet	Second person Singular
edellytti	Third person Singular
estellen	First person Singular
köysissä	None
lennätti	Third person Singular
turbulenssiin	None
kielii	Third person Singular
sijaista	Second person Singular
säästä	Second person Singular
liukasta	Second person Singular
julistaisi	Third person Singular
aktuaalista	Second person Singular
ryntäävät	Third person Plural
tapiseerasitte	Second person Plural
muurasi	Third person Singular
aristan	First person Singular
luokittelee	Third person Singular
italialaistanen	First person Singular
uinuu	Third person Singular
haurastutan	First person Singular
tekstiviestein	None
oviaukkojen	None
juoksentelee	Third person Singular
lainaan	First person Singular
puhuisivat	Third person Plural
yksinkertaistuu	Third person Singular
jakoivat	Third person Plural
yhtenäistänee	Third person Singular
sallisivat	Third person Plural
asteli	Third person Singular
karppasi	Third person Singular
levittäjää	None
höyrystäisin	First person Singular
diboraaneille	None
iskivät	Third person Plural
tappele	Second person Singular
työskentelisi	Third person Singular
laukaisevat	Third person Plural
uudistuvat	Third person Plural
romuttui	Third person Singular
virtsatieinfektioita	None
beetalaktamaasin	None
käyttäytyy	Third person Singular
arvostan	First person Singular
tutustumme	First person Plural
pysähtyy	Third person Singular
kuvastaisi	Third person Singular
maanviljelyksen	None
puhkesivat	Third person Plural
laajentuu	Third person Singular
piiloutuu	Third person Singular
venäläistykööt	Third person Plural
herkistyitte	Second person Plural
metyyli-isobutyyliketoneja	None
kulmakiveksi	None
eonia	None
teollisuustyöntekijän	None
ryntäsivät	Third person Plural
magneettinauhoja	None
leimahtaa	Third person Singular
vaikutuksen	None
huolestuttaa	Third person Singular
käännökset	None
yllättyivät	Third person Plural
eristä	Second person Singular
huomatkaa	Second person Plural
rupesivat	Third person Plural
jäljestävät	Third person Plural
tarjoutuvat	Third person Plural
sotaharjoituksessa	None
liimakkeesta	None
viivakoodit	None
tuotantolaitokset	None
pussitiaista	None
peilaavat	Third person Plural
loukkaantuivat	Third person Plural
säädin	First person Singular
dreijaat	Second person Singular
lähestyivät	Third person Plural
puhalsivat	Third person Plural
kenottanet	Second person Singular
rappeutua	None
menetteli	Third person Singular
asteroideihin	None
hapettuu	Third person Singular
suosikkeja	None
yhteistyötä	None
nurjahdin	First person Singular
unohtumattomia	None
oleskelevat	Third person Plural
nieli	Third person Singular
pelaavat	Third person Plural
kiehtoo	Third person Singular
kohdistuivat	Third person Plural
piilottavat	Third person Plural
tiivisti	Third person Singular
odottaisin	First person Singular
tekijänoikeuslain	None
alivalotuttu	None
allekirjoittivat	Third person Plural
moikkasitte	Second person Plural
kardinaaleista	None
ahdistaa	Third person Singular
oivalluskyvyin	None
pitänee	Third person Singular
ketjuutunevat	Third person Plural
lojui	Third person Singular
pallottakaamme	First person Plural
kiistelee	Third person Singular
rauhoittuvat	Third person Plural
kaaridyynillä	None
kutistuvat	Third person Plural
sävytti	Third person Singular
puhuin	First person Singular
selvensi	Third person Singular
harvenivat	Third person Plural
tuokaa	Second person Plural
nyrkistäisitte	Second person Plural
tiukentui	Third person Singular
vahventui	Third person Singular
jälkiä	None
neutraalisti	Third person Singular
risteää	Third person Singular
vastaanota	Second person Singular
tunnustivat	Third person Plural
pidättyi	Third person Singular
rappausta	None
bosnia	None
rekka	None
kaivertaa	Third person Singular
pitelevät	Third person Plural
valmistaisi	Third person Singular
määrittelee	Third person Singular
puristi	Third person Singular
valtiomies	None
hilpaisitte	Second person Plural
optimoisimme	First person Plural
koulutamme	First person Plural
korostuivat	Third person Plural
juhlisti	Third person Singular
löysätkää	Second person Plural
pystyakselin	None
typistää	Third person Singular
haaroo	Third person Singular
pienenevät	Third person Plural
puhdistivat	Third person Plural
barreli	None
valvokaa	Second person Plural
häiriintyy	Third person Singular
katselee	Third person Singular
matkustajamäärien	None
suorista	Second person Singular
englanninvinttikoiraa	None
pehmitti	Third person Singular
tiedottavat	Third person Plural
leimautui	Third person Singular
pysyy	Third person Singular
kuumavalssatkoot	Third person Plural
näyttelisi	Third person Singular
monipuoluejärjestelmän	None
luopuivat	Third person Plural
märkinemme	First person Plural
tyrehdytti	Third person Singular
laventaa	Third person Singular
byrokratisoisivat	Third person Plural
pohjaisimme	First person Plural
opinto-ohjausten	None
irrationaalista	None
grönlantia	None
alkaa	Third person Singular
älynnevät	Third person Plural
vaikuttanee	Third person Singular
moiti	Second person Singular
kyseenalaistan	First person Singular
yhdy	Second person Singular
harvinaistuu	Third person Singular
hajulukoiksi	None
lisäyksestä	None
virittävät	Third person Plural
kuulla	Second person Singular
äkäisyys	None
häipätkää	Second person Plural
tasoittaa	Third person Singular
farmari	None
soluttautui	Third person Singular
hermostuu	Third person Singular
ylipäällikölle	None
tylsistyttänee	Third person Singular
porautuu	Third person Singular
suostutteli	Third person Singular
voimamiestä	None
voimistuu	Third person Singular
tihenee	Third person Singular
aktuaalistutaan	None
naamioitui	Third person Singular
maalialueen	None
pudotti	Third person Singular
siltaisin	First person Singular
esti	Third person Singular
tunnusti	Third person Singular
pyöräili	Third person Singular
loihtii	Third person Singular
korostuu	Third person Singular
ryhtyy	Third person Singular
espoolaiset	None
vihassa	None
julistautuu	Third person Singular
juon	First person Singular
uskalla	Second person Singular
murhetta	None
sekasin	First person Singular
istuimia	None
muotinäytöksen	None
soitat	Second person Singular
niitä	Second person Singular
haperot	None
hyväksytti	Third person Singular
tiesit	Second person Singular
hipaisee	Third person Singular
suitsuttanemme	First person Plural
turhuus	None
verottavat	Third person Plural
taittui	Third person Singular
erikoislääkäriksi	None
neliöinen	First person Singular
kohoaa	Third person Singular
löydöksen	None
käännä	Second person Singular
taipumuksen	None
kaksikerroksiseen	None
puraisulla	None
homogeenista	Second person Singular
pukeutuu	Third person Singular
jussit	None
kypsyttää	Third person Singular
niputtaa	Third person Singular
esiteltiin	None
yksiköitä	Second person Singular
kuulustelun	None
pelätköön	Third person Singular
harjoitellen	First person Singular
yleistajuistat	Second person Singular
laudoitin	First person Singular
baryytit	None
sotii	Third person Singular
omaksui	Third person Singular
bussiin	None
diggaan	First person Singular
houkuttele	Second person Singular
käynnistäisi	Third person Singular
rikkoi	Third person Singular
kata	Second person Singular
unohtivat	Third person Plural
keskeyttäkää	Second person Plural
poikii	Third person Singular
lämmitellen	First person Singular
vaistoaa	Third person Singular
heiluttavat	Third person Plural
spaklannet	Second person Singular
kirjallisessa	None
värähtelee	Third person Singular
vapautuisi	Third person Singular
hintaindeksi	None
jäädy	Second person Singular
lyllertänen	First person Singular
kangastuisivat	Third person Plural
avioituvat	Third person Plural
lutkuttanen	First person Singular
päällystänee	Third person Singular
kivikirkkoon	None
asensin	First person Singular
koeajan	First person Singular
lietti	Third person Singular
luhisti	Third person Singular
karnevaaleilla	None
sammuisi	Third person Singular
kirjoittelee	Third person Singular
höyryä	Second person Singular
nuolee	Third person Singular
pettyivät	Third person Plural
tulija	None
uppoaisi	Third person Singular
yhtiöitti	Third person Singular
ajanmukaista	Second person Singular
liekissä	None
lyöttäytyy	Third person Singular
varmistuu	Third person Singular
huuhtoivat	Third person Plural
koettivat	Third person Plural
leikkautti	Third person Singular
näin	First person Singular
räjäytä	Second person Singular
kykenivät	Third person Plural
kirjautuu	Third person Singular
puhuta	Second person Singular
oleskelee	Third person Singular
kynnyskysymys	None
miekkaili	Third person Singular
hiipi	Third person Singular
oppisivat	Third person Plural
vaikuttaisivat	Third person Plural
suojelualueet	None
propagandaelokuvassa	None
kiillottaa	Third person Singular
vaihtuu	Third person Singular
kuivaukseen	None
pimittää	Third person Singular
tokenin	First person Singular
korpivoirousku	None
kuvaisivat	Third person Plural
palkita	Second person Singular
korvausten	None
arkaistisiin	None
syntymätodistukseen	None
nuolevat	Third person Plural
hiljaisten	None
tiukkaan	None
myrkkyihin	None
käskevät	Third person Plural
suomentanen	First person Singular
karukkokankaana	None
tarkastelin	First person Singular
paarman	None
vannon	First person Singular
verhoavat	Third person Plural
joulupäivältä	None
sekulaaristakoot	Third person Plural
epäonnistuisi	Third person Singular
punaisit	Second person Singular
rauhansopimusten	None
pipoja	None
harppi	Third person Singular
riippulukotta	None
kitisen	First person Singular
reumakuume	None
laillistanevat	Third person Plural
laimenee	Third person Singular
lukumäärällä	None
unhottakoon	Third person Singular
peräänkuulutti	Third person Singular
vaaput	Second person Singular
tuskastui	Third person Singular
vahvistivat	Third person Plural
taukosivat	Third person Plural
mielitautien	None
natise	Second person Singular
suurlähetystölle	None
lausun	First person Singular
puhutteli	Third person Singular
kammiossa	None
pirstovat	Third person Plural
lievensi	Third person Singular
suistuu	Third person Singular
bungaat	Second person Singular
fuuga	None
madaltui	Third person Singular
uneksii	Third person Singular
yritän	First person Singular
kiihtyivät	Third person Plural
joukkoistanemme	First person Plural
sylkäisee	Third person Singular
hätiköity	None
sotki	Third person Singular
menehtyisi	Third person Singular
suuntaisi	Third person Singular
havaitsen	First person Singular
ennustavat	Third person Plural
katsotte	Second person Plural
rikon	First person Singular
korilla	None
katkesi	Third person Singular
ravistelivat	Third person Plural
kansalaisoikeuksia	None
suurvallasta	None
jobentsaamihappoja	None
harppailet	Second person Singular
voinevat	Third person Plural
aloitamme	First person Plural
avara	None
vertaan	First person Singular
sijaitsisi	Third person Singular
päärmäsimme	First person Plural
ratkesi	Third person Singular
sisällytettiin	None
pää-äänenkannattaja	None
paaduttaneen	None
kiihotti	Third person Singular
puhuisi	Third person Singular
säätivät	Third person Plural
tiedä	Second person Singular
katsoisin	First person Singular
selluloidi	None
kiinteytyy	Third person Singular
venyy	Third person Singular
tottuivat	Third person Plural
luovuttavat	Third person Plural
tunnustamme	First person Plural
pommittavat	Third person Plural
klarinetisti	None
plussaisivat	Third person Plural
ohene	Second person Singular
normittanet	Second person Singular
vierailevat	Third person Plural
pudottavat	Third person Plural
hukkuisi	Third person Singular
öykkäröinteinä	None
orjuuttivat	Third person Plural
kansallistaa	Third person Singular
älyllistä	Second person Singular
parantelin	First person Singular
perustuisivat	Third person Plural
tsekkasin	First person Singular
tihkuu	Third person Singular
ärtyisille	None
jamaikalaisten	None
kylmenivät	Third person Plural
ekotyyppi	None
puoltaa	Third person Singular
niele	Second person Singular
siirtyisi	Third person Singular
pieneksynemme	First person Plural
väsyttänette	Second person Plural
herjaavat	Third person Plural
miehittävät	Third person Plural
torju	Second person Singular
nokea	Second person Singular
langettaa	Third person Singular
synnyttäisi	Third person Singular
haulia	None
sumuuntunevat	Third person Plural
tarkoitamme	First person Plural
haaveillen	First person Singular
häikäisee	Third person Singular
pukija	None
välttävät	Third person Plural
kourallisen	None
unohtaa	Third person Singular
vääntyisi	Third person Singular
kanadalainen	None
ehkäise	Second person Singular
höyhentäkää	Second person Plural
löytäisivät	Third person Plural
suurennuttanet	Second person Singular
suostuvat	Third person Plural
äkkinäistä	None
ammattien	None
kroaatiksi	None
toivota	Second person Singular
vastakahdennan	First person Singular
huutaa	Third person Singular
tympikööt	Third person Plural
pitäkäämme	First person Plural
podin	First person Singular
kilpailuttaa	Third person Singular
takkuili	Third person Singular
madan	First person Singular
prosenttiluvut	None
muunnelmina	None
pissii	Third person Singular
tasaavat	Third person Plural
törmäsin	First person Singular
hehkulamput	None
laskivat	Third person Plural
lupasi	Third person Singular
hehku	Second person Singular
kenttäpelaajana	None
selventää	Third person Singular
kiinnittivät	Third person Plural
heikennä	Second person Singular
ymmärrätte	Second person Plural
iskeytyvät	Third person Plural
jarrutti	Third person Singular
varrentakaa	Second person Plural
teurastaa	Third person Singular
nimimerkeistä	None
varjosti	Third person Singular
manaan	First person Singular
ohjautui	Third person Singular
kirjoittele	Second person Singular
kataraktin	None
helkätkää	Second person Plural
päättelin	First person Singular
kytkettiin	None
juonen	First person Singular
kalvikoot	Third person Plural
pilasi	Third person Singular
yllättivät	Third person Plural
risteytyivät	Third person Plural
teipit	None
vastustaisin	First person Singular
pienensin	First person Singular
houkuttelivat	Third person Plural
heraldinen	None
siistii	Third person Singular
kyylännen	First person Singular
kasvaisi	Third person Singular
puristuu	Third person Singular
esitti	Third person Singular
houkuttaa	Third person Singular
samaista	Second person Singular
arvostaa	Third person Singular
päihitti	Third person Singular
vältä	Second person Singular
alankomaalaista	None
liiku	Second person Singular
suositaan	None
rassasin	First person Singular
pomppii	Third person Singular
biomolekyylien	None
vakuuttavasta	None
pohdi	Second person Singular
predestinoinette	Second person Plural
sipsuttaisimme	First person Plural
laukaisisi	Third person Singular
huomauttavat	Third person Plural
liehun	First person Singular
koristi	Third person Singular
koostuu	Third person Singular
suostuttelevat	Third person Plural
katolisista	None
aiheutuvat	Third person Plural
valitti	Third person Singular
suomalaistaa	Third person Singular
epäonnistu	Second person Singular
ugrilaisista	None
tuhoa	Second person Singular
purjekangas	None
aikaansai	Third person Singular
sauvo	Second person Singular
kiusaannumme	First person Plural
sulautuu	Third person Singular
frekvensseillä	None
ammattitutkintoa	None
liottaa	Third person Singular
reaktioaikoineen	None
kiistätte	Second person Plural
synnyttävät	Third person Plural
valtuutettua	None
ohjaustangon	None
ravustit	Second person Singular
yllätyshyökkäyksestä	None
karkeista	Second person Singular
ehtyi	Third person Singular
näe	Second person Singular
pysäköintipaikkoja	None
sinnikkyyden	None
pohjustivat	Third person Plural
sumenen	First person Singular
haluaisi	Third person Singular
uinnista	None
eritteet	None
sulkee	Third person Singular
palta	Second person Singular
mallintaa	Third person Singular
tiheni	Third person Singular
teloi	Third person Singular
pohdiskelevat	Third person Plural
peitteli	Third person Singular
verson	First person Singular
räjähtivät	Third person Plural
seikkailivat	Third person Plural
määräytyvät	Third person Plural
kommunikea	None
rientää	Third person Singular
tarvitsevat	Third person Plural
pidättäydyn	First person Singular
rajaan	First person Singular
tuikkikoot	Third person Plural
leppyi	Third person Singular
odotin	First person Singular
karpatkaa	Second person Plural
selvitä	Second person Singular
tanssimisen	None
tallautuisivat	Third person Plural
yhteyttää	Third person Singular
suippenee	Third person Singular
poistuisivat	Third person Plural
parantelee	Third person Singular
ylistän	First person Singular
nuohonnen	First person Singular
käyttöliittymissä	None
sävellajista	None
animesta	None
sarjallisuutta	None
festivaalit	None
artikkeleilta	None
raunioita	Second person Singular
tarvitsen	First person Singular
yrjötimme	First person Plural
kapinoijilta	None
hetkauta	Second person Singular
osaan	First person Singular
kelpuuttaisi	Third person Singular
lähenteli	Third person Singular
näyttelevät	Third person Plural
kiintyvät	Third person Plural
turhauduin	First person Singular
sisällyttävät	Third person Plural
voittakoon	Third person Singular
porstuoihin	None
polkee	Third person Singular
aamiaista	Second person Singular
risteyttää	Third person Singular
keskeytyi	Third person Singular
poliisikoirat	None
tarvitsee	Third person Singular
kasan	None
neuvottelivat	Third person Plural
riitelevät	Third person Plural
rokahtuisimme	First person Plural
lastentarhanopettajana	None
kivikaudeksi	None
heilutellen	First person Singular
lenkkeilyksi	None
kesäinen	None
alusti	Third person Singular
sintratkoot	Third person Plural
puskaradio	None
tarkistavat	Third person Plural
suvereeni	None
suljen	First person Singular
imettää	Third person Singular
kehittäisivät	Third person Plural
sotatilasta	None
kapeni	Third person Singular
kuulostavat	Third person Plural
seisoi	Third person Singular
laimennumme	First person Plural
sammui	Third person Singular
pahenevat	Third person Plural
tilavia	None
vähentävät	Third person Plural
klassismi	None
rupesin	First person Singular
vietti	Third person Singular
lenteli	Third person Singular
vanhahtava	None
saneli	Third person Singular
polkenen	First person Singular
katsot	Second person Singular
laajennut	Second person Singular
vertaillen	First person Singular
osaat	Second person Singular
rauhansuunnitelman	None
varjelee	Third person Singular
tanskalaisten	None
kyselen	First person Singular
saattaa	Third person Singular
vieroittaa	Third person Singular
kangasta	Second person Singular
lujitti	Third person Singular
voitamme	First person Plural
hermoimpulssien	None
suoritin	First person Singular
aiheutti	Third person Singular
pohjautuva	None
uusiutuva	None
erottautui	Third person Singular
kahlasitte	Second person Plural
mononukleoosi	None
jesuiitoista	None
lennä	Second person Singular
valmistui	Third person Singular
koontanevat	Third person Plural
määräsi	Third person Singular
kesätöihin	None
lyhentyy	Third person Singular
holoseenikaudella	None
inhositte	Second person Plural
tärissemme	First person Plural
säännöttömissä	None
nenu	None
näet	Second person Singular
jytissette	Second person Plural
muunsi	Third person Singular
paranisivat	Third person Plural
kuohua	Second person Singular
verottivat	Third person Plural
vaihtui	Third person Singular
mahdollistuisi	Third person Singular
laukoo	Third person Singular
kiinteillä	None
laukon	First person Singular
touhua	Second person Singular
kyynärluun	None
täytän	First person Singular
poistaisin	First person Singular
ostavat	Third person Plural
toipuivat	Third person Plural
ympätkööt	Third person Plural
joutuivat	Third person Plural
laukeavat	Third person Plural
monimutkaistuisitte	Second person Plural
tuulet	Second person Singular
hemmottelee	Third person Singular
yöpyy	Third person Singular
diskomusiikkia	None
epäonnistuu	Third person Singular
omeletteineen	None
kasvuhormoni	None
piiritti	Third person Singular
funktionaalisuuksineen	None
erakoitunut	None
tappaisi	Third person Singular
kärkipaikoille	None
innostuu	Third person Singular
kuningaskunnista	None
henno	Second person Singular
yleistyy	Third person Singular
sairastuivat	Third person Plural
maaliviivalta	None
vieraantui	Third person Singular
edustajiksi	None
maksullistin	First person Singular
australialaistan	First person Singular
julista	Second person Singular
kohtele	Second person Singular
siivellä	None
karttunen	First person Singular
kiinteyttäisitte	Second person Plural
syöksivät	Third person Plural
sulatti	Third person Singular
kilpistyi	Third person Singular
lypsää	Third person Singular
lajiutumista	None
kyselee	Third person Singular
haasta	Second person Singular
saksinen	First person Singular
suoriutui	Third person Singular
ordalle	None
pohjustaa	Third person Singular
irrallisista	None
koheltanette	Second person Plural
lähde	Second person Singular
sinkoaa	Third person Singular
maistaa	Third person Singular
virittää	Third person Singular
vaurioituivat	Third person Plural
luhistuivat	Third person Plural
sinkoavat	Third person Plural
kiteytyy	Third person Singular
siunaavat	Third person Plural
kuolinsyyn	None
naimattomille	None
stimuloinet	Second person Singular
saunoisimme	First person Plural
välähti	Third person Singular
kääröjä	None
ampaisi	Third person Singular
telakoikaa	Second person Plural
veivät	Third person Plural
jyrähti	Third person Singular
lupauksista	None
syvensi	Third person Singular
ratkaisee	Third person Singular
lykkäsivät	Third person Plural
vertahyytävissä	None
kypsyit	Second person Singular
karisti	Third person Singular
kunnostautuisit	Second person Singular
ryösti	Third person Singular
purista	Second person Singular
nauravat	Third person Plural
toraillet	Second person Singular
samastui	Third person Singular
taon	First person Singular
pehmensi	Third person Singular
viileämmän	None
riittivät	Third person Plural
tuhosivat	Third person Plural
kirkuu	Third person Singular
merkitsisin	First person Singular
omasivat	Third person Plural
kaduttaisitte	Second person Plural
sairastaa	Third person Singular
juontajat	None
rikoit	Second person Singular
nojaan	First person Singular
vastalääkkeen	None
vaimenee	Third person Singular
järjestyivät	Third person Plural
peittyi	Third person Singular
nauratti	Third person Singular
rampautti	Third person Singular
vakiinnutti	Third person Singular
saalistuksessa	None
soittajien	None
summasi	Third person Singular
kirjoittakaa	Second person Plural
kannatan	First person Singular
viestitti	Third person Singular
kansoitti	Third person Singular
hankinta	None
säilyi	Third person Singular
kamppailivat	Third person Plural
herättelee	Third person Singular
uudenaikaista	Second person Singular
latinantanemme	First person Plural
poistakoon	Third person Singular
keskiosien	None
abessiivi	None
tuuppaat	Second person Singular
läntännevät	Third person Plural
vaapun	First person Singular
paheksuvat	Third person Plural
helle	None
poistui	Third person Singular
mukailevat	Third person Plural
korkeatasoisen	None
remunnen	First person Singular
hiutuu	Third person Singular
ympäristöystävällisyys	None
tiukkuivat	Third person Plural
rottamakeille	None
käpertänevät	Third person Plural
tunnemme	First person Plural
kerosiinia	None
ennätysajassa	None
pysyttelevät	Third person Plural
kirjonen	First person Singular
vanhene	Second person Singular
uusiseelantilaisten	None
kuitatkaamme	First person Plural
yksityisautoilu	None
skandaalissa	None
tunnustaisivat	Third person Plural
ohjasti	Third person Singular
siunatkoon	Third person Singular
kehity	Second person Singular
tarkensivat	Third person Plural
laajentaa	Third person Singular
käynnistyi	Third person Singular
selvittää	Third person Singular
muuttelee	Third person Singular
syrjäyttivät	Third person Plural
rajoitu	Second person Singular
laihduttaa	Third person Singular
käräyttää	Third person Singular
kuroutui	Third person Singular
uusiutui	Third person Singular
riku	Second person Singular
tunnustautuu	Third person Singular
nauhoittivat	Third person Plural
hälvensivät	Third person Plural
helkyttäisit	Second person Singular
peruivat	Third person Plural
katselevat	Third person Plural
telonette	Second person Plural
lainkohta	None
tallentuu	Third person Singular
kuoriutuivat	Third person Plural
häiritsi	Third person Singular
piteli	Third person Singular
monipuolistui	Third person Singular
päättyy	Third person Singular
paklannen	First person Singular
vasemmistolaistuisin	First person Singular
jaoin	First person Singular
mittauksessa	None
pidimme	First person Plural
elinympäristöstä	None
rahtilaivan	None
taivalsi	Third person Singular
seisahtui	Third person Singular
hamput	None
muistuttivat	Third person Plural
uinu	Second person Singular
verivihollisia	None
rapista	Second person Singular
kertyisi	Third person Singular
jakeli	Third person Singular
sadonkorjuista	None
valloittaa	Third person Singular
bantustan	None
digitaalista	Second person Singular
pyhiinvaellusmatka	None
alumiinikloridi	None
jäähdytellette	Second person Plural
uhmasivat	Third person Plural
sulki	Third person Singular
kanssakäymisessä	None
umpeentunemme	First person Plural
dramaattisia	None
koordinaattoineen	None
lättänättä	None
voidellaan	None
paskoi	Third person Singular
kertyvät	Third person Plural
kerääntyy	Third person Singular
suutele	Second person Singular
päätteeksi	None
levittäytyi	Third person Singular
kenottaisit	Second person Singular
kielsi	Third person Singular
piiskasi	Third person Singular
jakaudu	Second person Singular
luutinemme	First person Plural
nostin	None
hapettavat	Third person Plural
näyttele	Second person Singular
meuhkaisitte	Second person Plural
pelikieltoja	None
loikki	Third person Singular
risteä	Second person Singular
painottaisit	Second person Singular
välittyisi	Third person Singular
dominantti	None
lastulevyn	None
veistos	None
kalastusalusta	None
mullistaa	Third person Singular
puhun	First person Singular
tuhkanharmaat	None
sunnalaisen	None
päättelen	First person Singular
lumoutuu	Third person Singular
elpymisen	None
rahtilaivalla	None
käyttäytynet	Second person Singular
railannette	Second person Plural
löytyi	Third person Singular
vaikeutuu	Third person Singular
tempen	None
säännöstellen	First person Singular
hiirihaukat	None
rukoilkaa	Second person Plural
kaihtaa	Third person Singular
lampuilla	None
nimeän	First person Singular
tuoksut	Second person Singular
hyödytti	Third person Singular
muikistanet	Second person Singular
kolmansille	None
räpiköiköön	Third person Singular
tulkkia	None
eläytyvät	Third person Plural
riso	Second person Singular
käyttävät	Third person Plural
valehtelivat	Third person Plural
toimittaisi	Third person Singular
vaimenevat	Third person Plural
opettelin	First person Singular
ylensi	Third person Singular
ryösteli	Third person Singular
latinoikoon	Third person Singular
lyyhistyi	Third person Singular
opi	Second person Singular
lahjoitti	Third person Singular
tuiki	Second person Singular
ponkaisi	Third person Singular
istuttanen	First person Singular
citykulttuureissa	None
seepramalawinahventa	None
älykkyystestin	None
lippaaseen	None
pahasta	None
stabiiliksi	None
tarkoitti	Third person Singular
vaipuu	Third person Singular
lievittää	Third person Singular
loivat	Third person Plural
katsele	Second person Singular
piilotti	Third person Singular
asiantuntijat	None
viihdyttäneen	None
noudattaisivat	Third person Plural
pidätä	Second person Singular
kieltäytyivät	Third person Plural
iäkkäänä	None
hepoasteilla	None
näppäimistöltä	None
irvistytin	First person Singular
luota	Second person Singular
vaikutat	Second person Singular
telakoitui	Third person Singular
ansiota	None
haaraan	First person Singular
turmeltui	Third person Singular
varovaisuudesta	None
epäilyttää	Third person Singular
vakinaista	Second person Singular
taloyhtiöt	None
kavaltaa	Third person Singular
jääräpäisittä	None
kovensi	Third person Singular
ajastin	First person Singular
tavoittelivat	Third person Plural
tasapainottaa	Third person Singular
liiraisi	Third person Singular
burkina	None
höpisevät	Third person Plural
kehitelkäämme	First person Plural
kiitänee	Third person Singular
tarkistan	First person Singular
nappaavat	Third person Plural
kilpaili	Third person Singular
laitoshoitoon	None
ilmamassan	None
lainasi	Third person Singular
edistyn	First person Singular
akuuteista	None
sameutuvat	Third person Plural
auranvantaassa	None
rääkkäisit	Second person Singular
myönnä	Second person Singular
velvoita	Second person Singular
laajennan	First person Singular
kulmahiomakoneitta	None
poseerasi	Third person Singular
katsovat	Third person Plural
katkeaa	Third person Singular
vaihtelee	Third person Singular
kieliköön	Third person Singular
yksinkertaistettiin	None
tallensin	First person Singular
mahdollistaisi	Third person Singular
maksaja	None
ahertaa	Third person Singular
kilohaili	None
löysivät	Third person Plural
autioittivat	Third person Plural
nimeämättömään	None
tajua	Second person Singular
raskaampiin	None
kiihtyy	Third person Singular
kiintyi	Third person Singular
autotehtaassa	None
nollannen	First person Singular
lorottakoot	Third person Plural
vasemmistolaistui	Third person Singular
sperma	None
salvoisit	Second person Singular
kantoraketti	None
ponnisteli	Third person Singular
perään	First person Singular
kansantajuista	Second person Singular
lakiesityksiin	None
erikoisuuden	None
pakotti	Third person Singular
sinnittelivät	Third person Plural
vingahtanen	First person Singular
sadettanet	Second person Singular
mätänee	Third person Singular
vyöryi	Third person Singular
juontuvat	Third person Plural
koulutti	Third person Singular
velvoittaa	Third person Singular
vatjaa	None
edomme	First person Plural
sekaantuivat	Third person Plural
selitykseen	None
taikurien	None
soittivat	Third person Plural
vetäytyi	Third person Singular
iissä	None
voimistui	Third person Singular
pinnallistuttu	None
pyyhkäisisimme	First person Plural
lanasi	Third person Singular
saksalaistui	Third person Singular
vaihtavat	Third person Plural
kuvautuu	Third person Singular
ehdokkailta	None
segmentointi	None
herut	Second person Singular
ilotellen	First person Singular
vapauttaa	Third person Singular
jymisivät	Third person Plural
läntistyin	First person Singular
aiheuttanee	Third person Singular
korjaisi	Third person Singular
puoltavat	Third person Plural
viimeistellen	First person Singular
vittuuntuisitte	Second person Plural
termiikkeinä	None
sekoittaisi	Third person Singular
keventynee	Third person Singular
jättiläiskilpikonna	None
seulovat	Third person Plural
munuaiskotelo	None
putoaa	Third person Singular
lieventää	Third person Singular
lanaan	First person Singular
harmaannuttakoot	Third person Plural
tuhoisaan	None
puisin	First person Singular
pinkoi	Third person Singular
kuninkaallisiksi	None
sisarusta	None
osakerekistereistä	None
syöksi	Third person Singular
toistan	First person Singular
matkijoiden	None
sanomia	None
rauhoittui	Third person Singular
näette	Second person Plural
utele	Second person Singular
allekirjoitti	Third person Singular
tunnen	First person Singular
ruiskutti	Third person Singular
ylikuumenemisen	None
niklaisivat	Third person Plural
pahoitteli	Third person Singular
esihistoriallisesta	None
hienostuit	Second person Singular
liittyy	Third person Singular
tutustuttaa	Third person Singular
uhraisi	Third person Singular
myisi	Third person Singular
pyörisi	Third person Singular
käynnisty	Second person Singular
yrittäisin	First person Singular
tukikohta	None
rajasin	First person Singular
parani	Third person Singular
poistuivat	Third person Plural
lusikat	None
fluoroisin	First person Singular
mielikuvitukselliset	None
kerääntyi	Third person Singular
peruskirjaan	None
liuskoina	None
kirjoitusvirheet	None
katsomme	First person Plural
maustaa	Third person Singular
siirrymme	First person Plural
taistelukärjellä	None
kakaisimme	First person Plural
juosteen	None
tutustutti	Third person Singular
lihottaa	Third person Singular
opetussuunnitelmiin	None
vuottaa	Third person Singular
infektoisitte	Second person Plural
muokkautui	Third person Singular
lähettivät	Third person Plural
keskeyttävät	Third person Plural
uskontokuntien	None
teilasi	Third person Singular
rasittein	None
hoilottanee	Third person Singular
hankoa	Second person Singular
troolaisit	Second person Singular
valinnaksi	None
avautuisivat	Third person Plural
imin	First person Singular
ampumahiihdoiksi	None
toimittivat	Third person Plural
valtakunnalliselta	None
sadepilviksi	None
jouda	Second person Singular
voinen	First person Singular
spot-kaupat	None
puristin	First person Singular
biisistä	None
kestä	Second person Singular
kätkeytynet	Second person Singular
suhtautuvat	Third person Plural
jainalaisuudeksi	None
pitäkää	Second person Plural
pelotteli	Third person Singular
vastustaisi	Third person Singular
ivailevat	Third person Plural
modeemin	None
illanvietossa	None
onnistuisivat	Third person Plural
moderoikoot	Third person Plural
majoittuvat	Third person Plural
kulje	Second person Singular
uskallettu	None
toimialaan	None
äriskööt	Third person Plural
tarkastajille	None
parafoisimme	First person Plural
ylläpiti	Third person Singular
määräytyivät	Third person Plural
juolukoiksi	None
kauhistuttaa	Third person Singular
ilahdu	Second person Singular
kaasuonkaloista	None
vauhkoutunevat	Third person Plural
sahatavara	None
käännytys	None
hyökkäilivät	Third person Plural
lankeaisi	Third person Singular
seuraannoksi	None
lomaili	Third person Singular
käyttökelpoisuuden	None
lamauttavat	Third person Plural
keskittyi	Third person Singular
pohjukka	None
rinnastanut	None
oletan	First person Singular
sokaistuisit	Second person Singular
moderoisin	First person Singular
iskevät	Third person Plural
elliptisellä	None
viettävät	Third person Plural
heiluttivat	Third person Plural
lääkärintarkastusta	None
jutaisimme	First person Plural
karioituisin	First person Singular
ennättää	Third person Singular
hämärtyvät	Third person Plural
kulminoitui	Third person Singular
kotoista	Second person Singular
selventävät	Third person Plural
lauko	Second person Singular
turhauttaisit	Second person Singular
ympärileikkaukseen	None
haarautuivat	Third person Plural
runnoi	Third person Singular
syttyvät	Third person Plural
jauhaantuisin	First person Singular
kirjaan	First person Singular
annostelimme	First person Plural
repesi	Third person Singular
liikahti	Third person Singular
rantasauna	None
venyttivät	Third person Plural
vakuutuin	First person Singular
ympäristökriisinä	None
ilveilisin	First person Singular
maolaisia	None
kumosi	Third person Singular
lokaali	None
muistoksi	None
puolla	Second person Singular
paimensivat	Third person Plural
spriitä	None
epäile	Second person Singular
lävistivät	Third person Plural
asettuisi	Third person Singular
helmien	None
kököttelisin	First person Singular
kasvatit	Second person Singular
kuolinaikaa	None
polte	None
lautamies	None
pakenijat	None
satsuman	None
joikuu	Third person Singular
nolota	Second person Singular
ruskeutunevat	Third person Plural
löydä	Second person Singular
sopeutuvat	Third person Plural
kasaavat	Third person Plural
skeittauksen	None
urakoisi	Third person Singular
perusteettomana	None
käsikirjoittivat	Third person Plural
kerskui	Third person Singular
tuulettaa	Third person Singular
katsastutat	Second person Singular
vääristelkää	Second person Plural
säikyttänee	Third person Singular
räjäyttävät	Third person Plural
vaihdellen	First person Singular
istuisi	Third person Singular
kalpi	Second person Singular
käytti	Third person Singular
sujuisi	Third person Singular
kutovat	Third person Plural
yhteistoiminnallisen	None
kaivavat	Third person Plural
kerrointa	None
asentaa	Third person Singular
soudan	First person Singular
liukui	Third person Singular
jatkui	Third person Singular
kumoutuu	Third person Singular
suojaan	First person Singular
vannonut	None
käyttäjiksi	None
syyllistyy	Third person Singular
duoksi	None
vaikuttaisi	Third person Singular
ympäröinee	Third person Singular
riippuivat	Third person Plural
tulehduskipulääkkeillä	None
loukkasi	Third person Singular
suitsutti	Third person Singular
aaltoillen	First person Singular
kuihtuvat	Third person Plural
kristallisoituisit	Second person Singular
lisäsi	Third person Singular
uskotte	Second person Plural
ajankohtaista	Second person Singular
matkustivat	Third person Plural
ohjausjärjestelmä	None
hotkaiskaa	Second person Plural
erittyy	Third person Singular
pistokkaista	None
eettisiin	None
muuttuu	Third person Singular
haavoittunutta	None
johtuisi	Third person Singular
sivilisaatio	None
vaihtaa	Third person Singular
parantuu	Third person Singular
juottaa	Third person Singular
päällystää	Third person Singular
kuvailivat	Third person Plural
kirjoitteli	Third person Singular
näkökohtien	None
šamanoinevat	Third person Plural
kaarteet	None
valimo	None
kaipaisit	Second person Singular
suominen	First person Singular
haistakaa	Second person Plural
kangistui	Third person Singular
lokeja	None
leikkii	Third person Singular
kolkuttaa	Third person Singular
aurinkoisissa	None
kirjeenvaihdoiksi	None
vesittyi	Third person Singular
viheltää	Third person Singular
paikkasi	Third person Singular
neidoista	None
matkatelevisioin	None
vähentyisi	Third person Singular
liität	Second person Singular
koimme	First person Plural
kalistellee	Third person Singular
hämmentyi	Third person Singular
kumoutui	Third person Singular
germaaneilta	None
kylvävät	Third person Plural
määrittelivät	Third person Plural
sukeltavat	Third person Plural
hillereitä	None
tyhmyyksiä	None
pönkittivät	Third person Plural
jupisit	Second person Singular
edustavista	None
yhdennet	Second person Singular
ylpeilkäämme	First person Plural
etäisyyksiin	None
kirjoitatte	Second person Plural
epävakaudesta	None
vähentyy	Third person Singular
tokaisi	Third person Singular
deponoitakoon	None
yksikkövektori	None
huntupäisestä	None
tärkkelyspitoinen	None
työstettiin	None
hiilidisulfidiin	None
liukenee	Third person Singular
erikoistuivat	Third person Plural
vyötitte	Second person Plural
heltyy	Third person Singular
ruskohiiltä	None
virtaan	First person Singular
löydätte	Second person Plural
kuvastin	First person Singular
hautasi	Third person Singular
onkinen	First person Singular
viittasivat	Third person Plural
konsertista	None
vihastui	Third person Singular
uskoisitte	Second person Plural
tatit	None
selittävät	Third person Plural
työnsivät	Third person Plural
elättivät	Third person Plural
rikot	Second person Singular
nollautunee	Third person Singular
joutuisi	Third person Singular
koneet	None
varoittelee	Third person Singular
voiteen	None
eläinmaailma	None
kermokoon	Third person Singular
torjuivat	Third person Plural
tuhrannevat	Third person Plural
avaavat	Third person Plural
ryhdistäydytte	Second person Plural
avioitui	Third person Singular
johtuminen	None
synketä	None
puukotti	Third person Singular
puutu	Second person Singular
näyttämöksi	None
murensi	Third person Singular
tuomiopäivä	None
globaalista	Second person Singular
resoluutioksi	None
luetteloinen	First person Singular
näköiseen	None
maapallosta	None
haukkui	Third person Singular
tehostaa	Third person Singular
okranvärinen	None
taistelukentäksi	None
suosituissa	None
julkaise	Second person Singular
eliöt	None
kiihtyi	Third person Singular
rappeutuvat	Third person Plural
katsoivat	Third person Plural
pahentui	Third person Singular
askelsivat	Third person Plural
kasvitieteessä	None
rantautuvat	Third person Plural
myötäilevät	Third person Plural
heiluivat	Third person Plural
kuusettuivat	Third person Plural
pujotteluun	None
tuohella	None
toteaisin	First person Singular
lippoa	Second person Singular
luottotappiot	None
tarjoaisi	Third person Singular
pyydystä	Second person Singular
kerjäävät	Third person Plural
kuluta	Second person Singular
selventäisi	Third person Singular
linjaan	First person Singular
huonontaa	Third person Singular
laulattaa	Third person Singular
tukehduttaa	Third person Singular
viittoo	Third person Singular
täsmennä	Second person Singular
amerikkalaista	Second person Singular
jokunen	None
häippäisemme	First person Plural
portsari	None
viilentää	Third person Singular
ideoinemme	First person Plural
taputtaa	Third person Singular
satuta	Second person Singular
himmentää	Third person Singular
absorboiduitte	Second person Plural
uudestisyntyisitte	Second person Plural
saatelkoot	Third person Plural
keitti	Third person Singular
hapantukoot	Third person Plural
rakasta	Second person Singular
kaavailivat	Third person Plural
ruuhkautuu	Third person Singular
sisällyttivät	Third person Plural
lukittuu	Third person Singular
käynnistyivät	Third person Plural
vuorolla	None
tuomitsee	Third person Singular
prosenttilukua	None
aneli	Third person Singular
valoisana	None
mehua	None
sanoo	Third person Singular
tarkkailivat	Third person Plural
värväsi	Third person Singular
taantumuksellisena	None
kehnontuisin	First person Singular
lakkoilevat	Third person Plural
palellutti	Third person Singular
tsaariksi	None
kosketuksiin	None
tarjoutuu	Third person Singular
nostossa	None
paviaani	None
myllynkivi	None
löytää	Third person Singular
tuplaan	First person Singular
hihnoittanee	Third person Singular
korvaantui	Third person Singular
sirottavat	Third person Plural
konservatoriota	None
mullistit	Second person Singular
istahtaa	Third person Singular
ladan	None
painavimman	None
käännyttää	Third person Singular
kohautti	Third person Singular
ämpärillisestä	None
sulautuisitte	Second person Plural
ylittää	Third person Singular
myrkkyjen	None
odotti	Third person Singular
heilahtaa	Third person Singular
laajensivat	Third person Plural
haastoivat	Third person Plural
lejeerannee	Third person Singular
kulkeudut	Second person Singular
siirsin	First person Singular
varoittelivat	Third person Plural
sojottavat	Third person Plural
ulottuvuuden	None
taisit	Second person Singular
bongasin	First person Singular
juottavat	Third person Plural
kengänkiillottajitta	None
vastatkoon	Third person Singular
jyrkistä	Second person Singular
korikseksi	None
keilailu	None
kaarrun	First person Singular
työntyivät	Third person Plural
arrakkipunssit	None
mosaiikki	None
sietävät	Third person Plural
orastanevat	Third person Plural
kiristyy	Third person Singular
koituvat	Third person Plural
dekadenttia	None
ennusti	Third person Singular
kaikkoavat	Third person Plural
sallikaa	Second person Plural
kietoutuvat	Third person Plural
tehoaisi	Third person Singular
lihottaisimme	First person Plural
huijarit	None
suppene	Second person Singular
sanokaamme	First person Plural
sinkoutui	Third person Singular
kaiku	None
vähätelköön	Third person Singular
suosittelevat	Third person Plural
punertuu	Third person Singular
kiusasivat	Third person Plural
osititte	Second person Plural
yksityisomaisuutta	None
osaisin	First person Singular
saarnata	None
nasevoisimme	First person Plural
melon	First person Singular
istui	Third person Singular
kivahtanet	Second person Singular
panettelisimme	First person Plural
lähetin	First person Singular
kaipaisi	Third person Singular
passiivistuisitte	Second person Plural
kaksoisvoittoa	None
edustuksellisesta	None
ränsistyttänemme	First person Plural
rikkoutui	Third person Singular
kohahdutti	Third person Singular
hakeutuisitte	Second person Plural
lakitan	First person Singular
hermottaa	Third person Singular
jauheesta	None
rukoillen	First person Singular
vaellukset	None
möyryän	First person Singular
salakirjoitusta	None
yhdistäkööt	Third person Plural
attentaatin	None
sisältävät	Third person Plural
närästää	Third person Singular
inhota	Second person Singular
kartion	None
ohjaili	Third person Singular
yhtenevät	Third person Plural
heilahtelee	Third person Singular
siivitti	Third person Singular
tarpeellisuudesta	None
toimittavat	Third person Plural
kambrin	None
viivästyivät	Third person Plural
piittaat	Second person Singular
herneluulla	None
salakuuntelee	Third person Singular
vahingoittivat	Third person Plural
nipisteli	Third person Singular
järkyttävät	Third person Plural
kalvan	First person Singular
kondensoisi	Third person Singular
jytisisi	Third person Singular
näimme	First person Plural
talonpoikaisen	None
tummasolusyövät	None
maltti	None
tunnustautui	Third person Singular
rajoitin	First person Singular
pälättäisi	Third person Singular
karahtaisi	Third person Singular
tarjosivat	Third person Plural
sosiaalitoimineen	None
tyrskyävä	None
mittelevät	Third person Plural
sukupuolineutraali	None
kätilöikäämme	First person Plural
keskustelin	First person Singular
sotilaallista	Second person Singular
taantui	Third person Singular
tyytyvät	Third person Plural
feissaukset	None
ruostenopsasiipi	None
lukkaroinee	Third person Singular
tehtailta	None
sopivia	None
ulotti	Third person Singular
poletteja	None
lovea	Second person Singular
kertaantuu	Third person Singular
vääntyy	Third person Singular
heiluntojen	None
puhdistaisi	Third person Singular
helpotti	Third person Singular
kerääntyivät	Third person Plural
rikitti	Third person Singular
laiskiintuisit	Second person Singular
lankea	Second person Singular
medestäjiin	None
kiinnostuivat	Third person Plural
globalisaatiosta	None
omaavat	Third person Plural
näkymällä	None
tajuan	First person Singular
luotsasivat	Third person Plural
aloittanee	Third person Singular
rekisteröinet	Second person Singular
raapi	Third person Singular
pinkoisit	Second person Singular
vitonen	First person Singular
ohjelmasarjoilta	None
rassaan	First person Singular
kaltevuuden	None
huusivat	Third person Plural
kyllästyvät	Third person Plural
hakekaa	Second person Plural
robotille	None
eteni	Third person Singular
kotimaista	Second person Singular
kaivelee	Third person Singular
käännepisteeseen	None
tähytkää	Second person Plural
ehdotat	Second person Singular
vaaransivat	Third person Plural
jakaa	Third person Singular
ylittyi	Third person Singular
heittäytyy	Third person Singular
pestautui	Third person Singular
vääntelee	Third person Singular
kehittyivät	Third person Plural
käsitteli	Third person Singular
mielenrauhalla	None
lyllerrämme	First person Plural
spektrissä	None
stabiilein	None
kihlautuu	Third person Singular
olympiaedustajia	None
epäisi	Third person Singular
spinellin	None
avittaa	Third person Singular
hirvittää	Third person Singular
juopotteli	Third person Singular
laillistanut	None
korianteria	None
järjestivät	Third person Plural
kyrilliseen	None
alanurkalla	None
aiheuttaa	Third person Singular
lainasivat	Third person Plural
lykkääntyisimme	First person Plural
majailee	Third person Singular
pysyi	Third person Singular
kivittää	Third person Singular
istuivat	Third person Plural
digannette	Second person Plural
turhautti	Third person Singular
siirrän	First person Singular
hauduttaa	Third person Singular
suositti	Third person Singular
arvoista	None
naamioituivat	Third person Plural
raivottaret	None
mannerlaattoja	None
huoltaa	Third person Singular
ohitti	Third person Singular
lyötti	Third person Singular
pronssasimme	First person Plural
mallastakoot	Third person Plural
kuitukankaina	None
kellertävät	Third person Plural
perustelet	Second person Singular
estin	First person Singular
sotkeutuvat	Third person Plural
järjestämme	First person Plural
neutraalista	Second person Singular
aloitin	First person Singular
uskoo	Third person Singular
joikuisivat	Third person Plural
päivittäistavarakaupoissa	None
osattomien	None
yltää	Third person Singular
kommentissa	None
ajoittuu	Third person Singular
gambiitti	None
romahti	Third person Singular
siivittänette	Second person Plural
joustanette	Second person Plural
merkitsi	Third person Singular
hyökkäilevät	Third person Plural
lauluista	None
kudo	Second person Singular
oikeanpuoleisessa	None
autonrenkaat	None
ahdistelivat	Third person Plural
odotimme	First person Plural
teeskentelivät	Third person Plural
suomennokseksi	None
viihdyttää	Third person Singular
sotija	None
frankeilta	None
nojaavat	Third person Plural
säädä	Second person Singular
perisi	Third person Singular
pelikortti	None
kuvittajina	None
läheisiksi	None
huomioikaa	Second person Plural
muodikasta	None
primaariaineistoa	None
pistivät	Third person Plural
entisti	Third person Singular
tavoittele	Second person Singular
vastoisitte	Second person Plural
joukkoliikenne	None
vuoropuheluja	None
ryysyllä	None
sitoutuisivat	Third person Plural
kyykkisin	First person Singular
virukseen	None
lepakot	None
hirttäytyi	Third person Singular
luodinkestävä	None
epävakaat	None
jakaisi	Third person Singular
pahastutimme	First person Plural
huolestui	Third person Singular
hukkaan	First person Singular
sisustaa	Third person Singular
samoaa	Third person Singular
sotisi	Third person Singular
helpottivat	Third person Plural
rauhanturvaoperaatio	None
sairastuvat	Third person Plural
salamurhasivat	Third person Plural
kuljettivat	Third person Plural
ulottui	Third person Singular
koukkua	Second person Singular
häilähtänet	Second person Singular
osoittautuu	Third person Singular
porhaltanette	Second person Plural
helvetissä	None
oudoksun	First person Singular
opasteisiin	None
vuorovaikuttaa	Third person Singular
silmäillen	First person Singular
puren	First person Singular
tarjoilevat	Third person Plural
valtaisivat	Third person Plural
sokaisee	Third person Singular
paloautoksi	None
homogeeniseksi	None
kysy	Second person Singular
säikähti	Third person Singular
pitelivät	Third person Plural
tiedätte	Second person Plural
floppasi	Third person Singular
lyhensi	Third person Singular
tallentui	Third person Singular
alista	Second person Singular
aikaisti	Third person Singular
alifaattisten	None
tiivistäisi	Third person Singular
sotkevat	Third person Plural
käsitteellistää	Third person Singular
sammuttivat	Third person Plural
hankkisivat	Third person Plural
autamme	First person Plural
päihteet	None
wicca-liikkeettä	None
sano	Second person Singular
selvittämisessä	None
lopetan	First person Singular
limittyvät	Third person Plural
värjäytyvät	Third person Plural
kapselin	None
tuonnista	None
kumoudumme	First person Plural
priorisointia	None
napsauttaa	Third person Singular
luopuisin	First person Singular
närkästyivät	Third person Plural
abstraktisti	Third person Singular
muodosta	Second person Singular
rohisit	Second person Singular
appelsiini	None
ylimystöstä	None
valmistuivat	Third person Plural
magnesiumia	None
vedät	Second person Singular
oksentaa	Third person Singular
kellahtavat	Third person Plural
käsitteistäkää	Second person Plural
tarvitsisit	Second person Singular
kouluikäisille	None
vaalentaa	Third person Singular
parantuivat	Third person Plural
ekonomin	None
noudatti	Third person Singular
pistelee	Third person Singular
myöntyy	Third person Singular
huononna	Second person Singular
unohtakaa	Second person Plural
käreissä	None
yleistänen	First person Singular
rikkaita	None
moninkertaisten	None
höyryttele	Second person Singular
hedelmöittyvät	Third person Plural
sijaitsivat	Third person Plural
päättyivät	Third person Plural
ajetun	First person Singular
vaipui	Third person Singular
vakioinen	First person Singular
moraalisesta	None
punaisin	First person Singular
varoitti	Third person Singular
piilottaisi	Third person Singular
asetella	None
purasruohona	None
paheni	Third person Singular
voittaa	Third person Singular
punovat	Third person Plural
watin	None
opettelevat	Third person Plural
naureskellee	Third person Singular
kohdistui	Third person Singular
plebeiji	None
luopuisivat	Third person Plural
kumpuaa	Third person Singular
vesitiivistä	Second person Singular
väkivallattomien	None
eläinlääketieteessä	None
pelota	Second person Singular
hiljenette	Second person Plural
huutele	Second person Singular
loistaa	Third person Singular
maajoukkueisiin	None
hoidettu	None
kohtauksessa	None
kulkekaa	Second person Plural
tax-freeiksi	None
poikkesi	Third person Singular
päivitin	First person Singular
käyttäytyisivät	Third person Plural
parane	Second person Singular
venäläistänemme	First person Plural
eläinkokeisiin	None
yhtyy	Third person Singular
tuuppikoot	Third person Plural
liittäisi	Third person Singular
kuningaspareista	None
tyytymättömyyden	None
perustui	Third person Singular
näyttäytyvät	Third person Plural
ohjautuisi	Third person Singular
linkoa	Second person Singular
kadettina	None
vaihtoi	Third person Singular
skandeerasit	Second person Singular
kammon	First person Singular
torjuu	Third person Singular
päätyi	Third person Singular
itäsuomalaisista	None
kaatuvat	Third person Plural
lähdetä	Second person Singular
pahoitti	Third person Singular
metsästivät	Third person Plural
plombittakaa	Second person Plural
nurkkaan	First person Singular
subjektivismin	None
irtonaisen	None
radiopuhelin	None
ristiinnaulitsivat	Third person Plural
mongoleilla	None
pieneni	Third person Singular
devalvoinen	First person Singular
veistivät	Third person Plural
maistuisi	Third person Singular
kulttuuritoimi	None
kiinannee	Third person Singular
allegoriana	None
yöpyvät	Third person Plural
starttasivat	Third person Plural
kyykkyyn	None
laskuttanevat	Third person Plural
filmistä	None
professuureja	None
antautuu	Third person Singular
hohkukaamme	First person Plural
valaistut	Second person Singular
tikkauksineen	None
köyhdyttää	Third person Singular
asusteli	Third person Singular
kuohuvat	Third person Plural
satimeen	None
autoin	First person Singular
mekanisoidun	First person Singular
tuumaan	First person Singular
järjestäytyi	Third person Singular
säilyttäisivät	Third person Plural
uzbekkeja	None
leimasi	Third person Singular
surevien	None
peuhaisivat	Third person Plural
jättäydyimme	First person Plural
etujoukkoja	None
jongleerasivat	Third person Plural
istutti	Third person Singular
irrottivat	Third person Plural
herttuakuntaan	None
pienene	Second person Singular
ilmensi	Third person Singular
topin	None
lasken	First person Singular
EU-maahan	None
väitellyt	None
muisti	Third person Singular
siirtäisivät	Third person Plural
tallensi	Third person Singular
tehopisteellä	None
puhutte	Second person Plural
takoo	Third person Singular
säästyy	Third person Singular
kellastuttanemme	First person Plural
sortuu	Third person Singular
laajentaisi	Third person Singular
ohjaimilla	None
veroilmoitusten	None
ilmaisin	First person Singular
edeemoineen	None
raivaavat	Third person Plural
syvenee	Third person Singular
havittelivat	Third person Plural
vekseleitä	None
ilmasilta	None
nitovat	Third person Plural
salakuunnellet	Second person Singular
porotokkina	None
pyörähti	Third person Singular
potkurin	None
rakoon	None
sovitin	First person Singular
attribuuttien	None
opastukset	None
tasoittivat	Third person Plural
syyhyt	Second person Singular
säilyisivät	Third person Plural
ryhdyin	First person Singular
kääntää	Third person Singular
maailmanjärjestystä	None
heikontukaa	Second person Plural
säilyttivät	Third person Plural
käsikirjoittaa	Third person Singular
harkitsivat	Third person Plural
kehkeää	Third person Singular
pensasta	Second person Singular
riitin	First person Singular
alligaattori	None
tulkitsee	Third person Singular
hinasimme	First person Plural
valehtelen	First person Singular
postmoderniksi	None
kalastivat	Third person Plural
heijastavat	Third person Plural
tasoituksineen	None
kadotti	Third person Singular
sivuutti	Third person Singular
sanoutuivat	Third person Plural
kiellä	Second person Singular
teollistanemme	First person Plural
pyöritti	Third person Singular
väkisinmaatkaamme	First person Plural
panssarintorjuntaohjuksia	None
friikannet	Second person Singular
polttoainetankki	None
videopeleille	None
venyi	Third person Singular
edellytä	Second person Singular
lahjoittanut	None
jakomielitautisitta	None
alpiinisessa	None
aloittaisin	First person Singular
velon	First person Singular
iskee	Third person Singular
loppuunmyisivät	Third person Plural
polaariset	None
sulje	Second person Singular
lämmitin	First person Singular
aarrekammioon	None
kiihottuu	Third person Singular
rivitaloasunnoista	None
kaarnoitutte	Second person Plural
keskeytettynä	None
jousta	Second person Singular
vaikuttuu	Third person Singular
ilmaisimen	None
hukkautuisin	First person Singular
sinertäisit	Second person Singular
vaikuta	Second person Singular
eoseenikaudella	None
uskoisin	First person Singular
kunniamerkeillä	None
tihku	Second person Singular
yleistävät	Third person Plural
luvuista	None
kuvittelee	Third person Singular
kiteyttää	Third person Singular
noutivat	Third person Plural
lounasti	Third person Singular
standardoidun	First person Singular
lävistävät	Third person Plural
ilmoitin	First person Singular
pehmittimestä	None
virologia	None
hermostutitte	Second person Plural
alitti	Third person Singular
järjestäytyisitte	Second person Plural
matkailen	First person Singular
ärsyyntyy	Third person Singular
ajoittuvat	Third person Plural
sikahirvi	None
panostivat	Third person Plural
myöhäiskivihiilikaudella	None
kaivelet	Second person Singular
peräsi	Third person Singular
kohenisi	Third person Singular
kiristi	Third person Singular
työttömiä	None
sanoisi	Third person Singular
murskautui	Third person Singular
järisi	Third person Singular
palvoi	Third person Singular
kävelyttäisimme	First person Plural
allergisoivia	None
työmarkkinoita	None
pelastautuvat	Third person Plural
hytkäyttävät	Third person Plural
väistyy	Third person Singular
miinusta	Second person Singular
asettautuivat	Third person Plural
onnistaa	Third person Singular
komppaan	First person Singular
tupakansavun	None
tarkastelivat	Third person Plural
kuusivuotiaita	None
viittaavat	Third person Plural
martaassa	None
tarjoili	Third person Singular
seiltä	None
kehuitte	Second person Plural
rehevöittivät	Third person Plural
lentotukikohtia	None
varista	Second person Singular
formaattina	None
ihaili	Third person Singular
noudattelee	Third person Singular
virkistää	Third person Singular
puolijohteilla	None
noudatamme	First person Plural
tulkitsivat	Third person Plural
vapaan	None
keväistivät	Third person Plural
langetetaan	None
luontukoon	Third person Singular
paheksun	First person Singular
aitaan	First person Singular
varomaton	None
monimutkaistaa	Third person Singular
jarruttivat	Third person Plural
vaikeudesta	None
sotkeutui	Third person Singular
huoneita	None
tiivistivät	Third person Plural
aseistuksesta	None
ryypännen	First person Singular
päivysti	Third person Singular
pilkkasi	Third person Singular
paremmalta	None
pienenivät	Third person Plural
luettelee	Third person Singular
reunusta	Second person Singular
kuvaili	Third person Singular
astahdimme	First person Plural
kierteitä	Second person Singular
venoissa	None
myönnyn	First person Singular
vuotaisi	Third person Singular
toksikologian	None
paahtaisitte	Second person Plural
päättyisivät	Third person Plural
vaihdelaatikon	None
hyräillä	None
hengitän	First person Singular
ylikorostaa	Third person Singular
elokuvantekijöitä	None
merkitse	Second person Singular
kohotti	Third person Singular
sovittavat	Third person Plural
gepardi	None
kaksikoiksi	None
vihaiset	None
tykkäsi	Third person Singular
vaivasi	Third person Singular
ammuskellette	Second person Plural
hellitti	Third person Singular
heltiäisimme	First person Plural
kuumenette	Second person Plural
viihdyttävät	Third person Plural
hattuuntunemme	First person Plural
ilmiantaa	Third person Singular
veneenveistäjiä	None
ampumahaavaa	None
epäilivät	Third person Plural
kimmahtanevat	Third person Plural
sterilointi	None
kuljettaminen	None
vuotisjuhlassa	None
paranee	Third person Singular
itkevät	Third person Plural
käännekohdat	None
irvinen	First person Singular
pyörähtää	Third person Singular
ilmene	Second person Singular
magneetin	None
optikko	None
kehittyy	Third person Singular
treenasi	Third person Singular
ohittaisi	Third person Singular
nesteyttää	Third person Singular
nielaisi	Third person Singular
tykkäät	Second person Singular
metsäkauriit	None
suppenee	Third person Singular
tarkistakaa	Second person Plural
kiukuttakoon	Third person Singular
nauhasilikaateiksi	None
kohauttanette	Second person Plural
velkauttaisit	Second person Singular
rodeo	None
sovittivat	Third person Plural
naavoittunemme	First person Plural
unkarilaisena	None
raitista	Second person Singular
kurkumaa	None
parittaa	Third person Singular
vedenalainen	None
suhtautuu	Third person Singular
alkajaisiksi	None
esittäytyi	Third person Singular
kipuatte	Second person Plural
vahvennu	Second person Singular
aivotoimintaa	None
säännöllisine	None
raukkaa	None
harhailee	Third person Singular
tylsistyy	Third person Singular
odottivat	Third person Plural
helpota	Second person Singular
vastusta	Second person Singular
vuorovaikuttavat	Third person Plural
houkutteli	Third person Singular
kohtaisi	Third person Singular
napsauttelevat	Third person Plural
yllytti	Third person Singular
luovu	Second person Singular
sutannevat	Third person Plural
laajensi	Third person Singular
toisti	Third person Singular
kiitä	Second person Singular
taio	Second person Singular
kehräsi	Third person Singular
tapan	First person Singular
rahoita	Second person Singular
harmonista	Second person Singular
säilytä	Second person Singular
apeutuisivat	Third person Plural
lasisilta	None
rikkoivat	Third person Plural
tilavassa	None
söisivät	Third person Plural
onkimiehittä	None
hyväntekijä	None
modernista	Second person Singular
raukaisevat	Third person Plural
järjestäjälle	None
ununoktium	None
vesitti	Third person Singular
parantelevat	Third person Plural
mussuttaisimme	First person Plural
yllätyksellinen	None
pyydysti	Third person Singular
jauheille	None
leijailee	Third person Singular
massatkaa	Second person Plural
luvattomia	None
orbitaalin	None
täyttävät	Third person Plural
teurastavat	Third person Plural
tuksuttakaa	Second person Plural
väärinkäyttänyt	None
nostokurki	None
kunnioittivat	Third person Plural
aiheutui	Third person Singular
surrealistisia	None
keskenmenoon	None
koittaisi	Third person Singular
öljyteollisuuden	None
salaisempina	None
oikeudenkäynnit	None
lapan	First person Singular
pilapiirtäjäksi	None
kuidun	None
epäonnistumisista	None
hyväksyttävät	Third person Plural
bassoviulutta	None
hirveät	Second person Singular
pienenee	Third person Singular
vähemmistössä	None
vastatoimet	None
sitaiskoon	Third person Singular
vahtimestarille	None
vilkuttaa	Third person Singular
periytyy	Third person Singular
julkista	Second person Singular
bramiinein	None
uittaa	Third person Singular
hoivaavat	Third person Plural
hiitannee	Third person Singular
tuurilla	None
ylistä	Second person Singular
rajoittuu	Third person Singular
joudumme	First person Plural
langeta	Second person Singular
siippoja	None
ruotsalaisilla	None
lääkinnöistä	None
vaivu	Second person Singular
erääntyisi	Third person Singular
lyhentäisi	Third person Singular
kerrytti	Third person Singular
metafysiikkaa	None
valehtele	Second person Singular
kuseksinet	Second person Singular
arvon	First person Singular
heftoista	None
itsekantavalla	None
urjetkoon	Third person Singular
demoralisoidut	Second person Singular
miehisiä	None
syökää	Second person Plural
menoa	Second person Singular
kookosmaito	None
reunaehtoja	None
tarttui	Third person Singular
nopeuttivat	Third person Plural
joviaalitta	None
laitoit	Second person Singular
harhauttaa	Third person Singular
kannattanee	Third person Singular
ylikersanteissa	None
kannattaa	Third person Singular
sisälsivät	Third person Plural
peruspalveluministerit	None
kiekkoillut	None
muotoutuvat	Third person Plural
juhannukseen	None
silmäilin	First person Singular
ärsyttää	Third person Singular
uuslatinan	None
lokeroinen	First person Singular
valloittaisi	Third person Singular
kumoavat	Third person Plural
lentoreitti	None
jaokkeita	None
varaavat	Third person Plural
amerikansuomalaisina	None
julmia	None
biseksuaalisuus	None
muniva	None
sääkartoista	None
erotti	Third person Singular
moninkertaistuisivat	Third person Plural
kohtaan	First person Singular
redusoisi	Third person Singular
munkkikorppikotka	None
sallii	Third person Singular
kelalta	None
googlasin	First person Singular
rientävät	Third person Plural
pidätän	First person Singular
pelannee	Third person Singular
hermottavat	Third person Plural
tulehtuvat	Third person Plural
luottamushenkilöt	None
tarkentui	Third person Singular
vetäytyisivät	Third person Plural
toimintaelokuvassa	None
balansoinemme	First person Plural
viipyy	Third person Singular
vieraillen	First person Singular
suostuttelee	Third person Singular
tietyntyyppiset	None
hommaan	First person Singular
heikontukoot	Third person Plural
tippuu	Third person Singular
harvennan	First person Singular
kaasupilvestä	None
selvennee	Third person Singular
metsästä	Second person Singular
paarustavat	Third person Plural
periytyi	Third person Singular
paransivat	Third person Plural
hahmotteli	Third person Singular
läimäyttäkää	Second person Plural
vihertävät	Third person Plural
huolestutti	Third person Singular
ulkoista	Second person Singular
seinäkoristeilla	None
rellestää	Third person Singular
liittynevät	Third person Plural
villiintyy	Third person Singular
lähetät	Second person Singular
kehitin	First person Singular
visuaalista	Second person Singular
sinertävät	Third person Plural
tuulee	Third person Singular
rupeaisin	First person Singular
peruuttivat	Third person Plural
juttelin	First person Singular
letin	None
kättelevät	Third person Plural
alttosaksofonia	None
mukautuivat	Third person Plural
syytti	Third person Singular
tarkastaisi	Third person Singular
maalautti	Third person Singular
elokuvakäsikirjoittaja	None
ontui	Third person Singular
monipuolista	Second person Singular
muotoillen	First person Singular
kasvavat	Third person Plural
rouhennatte	Second person Plural
asukkaaseen	None
kahnatkaamme	First person Plural
geenivirroista	None
keihästä	Second person Singular
vollotitte	Second person Plural
synnyttää	Third person Singular
valokuviin	None
kyseli	Third person Singular
bunkkerimaisista	None
kiteydy	Second person Singular
tansaniittina	None
helpottuivat	Third person Plural
apulaisesta	None
filippiikeillä	None
johtuivat	Third person Plural
viruu	Third person Singular
auttavat	Third person Plural
synkistä	Second person Singular
rikastuttavat	Third person Plural
rupeaa	Third person Singular
kulmaan	First person Singular
kiinteys	None
aktuaalistunemme	First person Plural
jääkenttä	None
moreenia	None
nopeammin	None
prosessiteollisuuden	None
lopettivat	Third person Plural
länsimaisti	Third person Singular
vedän	First person Singular
selkeyttää	Third person Singular
kilometreihin	None
höyrystin	First person Singular
huipentuvat	Third person Plural
lynkkasi	Third person Singular
sammut	Second person Singular
hävitti	Third person Singular
iloitsivat	Third person Plural
juontavat	Third person Plural
paikallistavat	Third person Plural
kannatti	Third person Singular
sivuseikaksi	None
astuttaisi	Third person Singular
pelästyi	Third person Singular
trotskismi	None
vältän	First person Singular
pelimanneja	None
peruuttaa	Third person Singular
autismeja	None
seisot	Second person Singular
pudottaisimme	First person Plural
perustelut	None
pakinoitsijoista	None
jytistäisivät	Third person Plural
spekuloikoot	Third person Plural
laitamyötäisenä	None
mitatkaa	Second person Plural
välisiä	None
ansaitset	Second person Singular
päätteessä	None
sääntelevät	Third person Plural
vanhennat	Second person Singular
likaisempana	None
luonnonsuojelua	None
pelaat	Second person Singular
pyyhälsi	Third person Singular
laiskotellen	First person Singular
nasevoisivat	Third person Plural
ylivertaiseksi	None
kuolevasta	None
hyökkäävänä	None
suunnitelmalla	None
kohtelee	Third person Singular
häiritsivät	Third person Plural
vanhimmasta	None
piirsi	Third person Singular
perustellen	First person Singular
pistooleihin	None
haupitsin	None
morsiuspuvuissa	None
kapenevat	Third person Plural
hidastu	Second person Singular
lättäjalkaisen	None
isottelimme	First person Plural
menetelmällisiä	None
polvistuisin	First person Singular
elinvoimaisuutta	None
haaroittuvat	Third person Plural
kartoittivat	Third person Plural
haastoi	Third person Singular
löytyvät	Third person Plural
sivuttanen	First person Singular
työskentelivät	Third person Plural
ylenkatsonen	First person Singular
mielipidemittauksina	None
pudottaa	Third person Singular
ahdisti	Third person Singular
oleiinihapon	None
nimittäisi	Third person Singular
masensivat	Third person Plural
aloitteikkaatta	None
kuumentavat	Third person Plural
varmistan	First person Singular
alavan	None
hyödyttävät	Third person Plural
aioin	First person Singular
siivittivät	Third person Plural
kanavoitui	Third person Singular
hiffaisivat	Third person Plural
tuuliset	None
bulgarialle	None
asukaslukuineen	None
pukevat	Third person Plural
venyisi	Third person Singular
nukkauksilta	None
nauhoittaa	Third person Singular
sessioiden	None
asuttivat	Third person Plural
krapulapaskaa	None
kehuu	Third person Singular
puhallan	First person Singular
loppuunmyynemme	First person Plural
tuoksuu	Third person Singular
pierun	None
tuntisi	Third person Singular
sanomalehtipaperia	None
vauvaperhe	None
pienensivät	Third person Plural
pidättää	Third person Singular
kylmään	First person Singular
kehotan	First person Singular
komppaniaa	None
kestäisi	Third person Singular
efektilaitteesta	None
säästyisi	Third person Singular
taittuvat	Third person Plural
harvinaisia	None
ryhtyisivät	Third person Plural
siivosin	First person Singular
torun	First person Singular
suren	First person Singular
demobilisoinen	First person Singular
kuljet	Second person Singular
sumerilaisten	None
asumattomat	None
kyhmystä	None
jäykistyy	Third person Singular
moduloinee	Third person Singular
suolattomassa	None
pelastakaa	Second person Plural
yhdisteli	Third person Singular
kruununvoutina	None
omaksuivat	Third person Plural
uskaltaa	Third person Singular
satsannevat	Third person Plural
hyväksymme	First person Plural
koetteli	Third person Singular
odottavista	None
kyljessä	None
panostanevat	Third person Plural
sydänpysähdys	None
avoimeen	None
korostaa	Third person Singular
kankeat	Second person Singular
kunnosta	Second person Singular
tyrkyttää	Third person Singular
leimasin	First person Singular
häviäjä	None
tekstaillevat	Third person Plural
kariutuu	Third person Singular
muistelisin	First person Singular
passiivista	Second person Singular
kellotti	Third person Singular
ohjastaa	Third person Singular
pelloille	None
rehuihin	None
ajattaa	Third person Singular
hibernoisit	Second person Singular
murenee	Third person Singular
opiskelupaikkaa	None
haarotti	Third person Singular
selittivät	Third person Plural
golfkentillä	None
voida	Second person Singular
navigoikaamme	First person Plural
lentäisivät	Third person Plural
kuumavalssaisin	First person Singular
ydinsodassa	None
luonnistu	Second person Singular
pienentyy	Third person Singular
automaattista	Second person Singular
kunnioittavat	Third person Plural
murtui	Third person Singular
kuvittaa	Third person Singular
väijyvät	Third person Plural
pommittaa	Third person Singular
oksettavat	Third person Plural
tapattaa	Third person Singular
kehuvat	Third person Plural
lämmittelivät	Third person Plural
nojautui	Third person Singular
tahrannette	Second person Plural
lentelivät	Third person Plural
alan	First person Singular
symmetrisiin	None
jakautui	Third person Singular
lipeää	Third person Singular
tekijänoikeuksin	None
orpotyttönä	None
omituista	None
hallitulla	None
vartan	First person Singular
hidastuisi	Third person Singular
puutuin	First person Singular
sovittanee	Third person Singular
aatelisherratta	None
kumpuavat	Third person Plural
erotteli	Third person Singular
voimistelijoita	None
suoranaisia	None
erkanevat	Third person Plural
koveni	Third person Singular
taloustieteellisen	None
surkastuvat	Third person Plural
polveutuivat	Third person Plural
maestrolta	None
haetutti	Third person Singular
puristaisin	First person Singular
laskettelijoita	None
tapahtuisi	Third person Singular
taisi	Third person Singular
loisii	Third person Singular
telonen	First person Singular
päädyt	Second person Singular
kaappikellojen	None
arjesta	None
virulentteja	None
tartun	First person Singular
törmäävät	Third person Plural
lisäisivät	Third person Plural
kytkevät	Third person Plural
loogisten	None
asennoista	None
hyökkäävällä	None
selvittivät	Third person Plural
säätelevät	Third person Plural
aiheuta	Second person Singular
esittelevät	Third person Plural
perustuisi	Third person Singular
hukkasivat	Third person Plural
rakennuttaa	Third person Singular
tuntisivat	Third person Plural
ulottuisi	Third person Singular
pysyn	First person Singular
yläsävelsarja	None
pidättivät	Third person Plural
komedialle	None
soinnilliset	None
suorittaisi	Third person Singular
lukeutuivat	Third person Plural
väänsivät	Third person Plural
tarkentavat	Third person Plural
tulilinjalle	None
yltäisi	Third person Singular
leivinjauhe	None
valottaisitte	Second person Plural
pyrkimykselle	None
kuljin	First person Singular
hiihtämisiltä	None
luhistuvat	Third person Plural
kysyn	First person Singular
juoksevasta	None
pikkukylissä	None
miellän	First person Singular
höyhensin	First person Singular
järvestä	None
hiilipitoisia	None
mutisee	Third person Singular
improvisoitu	None
hyväksyisin	First person Singular
spiritualisti	None
tuulsivat	Third person Plural
löytäisi	Third person Singular
epäilytti	Third person Singular
sisäänkäynniltä	None
nopeutuvat	Third person Plural
tuomitsisi	Third person Singular
porasi	Third person Singular
jakeiden	None
kurkistaa	Third person Singular
viitekehyksestä	None
karauta	Second person Singular
toteavat	Third person Plural
markkinaa	None
panostavat	Third person Plural
venäläistyi	Third person Singular
keuhkopussintulehduksesta	None
sitouduttava	None
toimintasäde	None
plagioinevat	Third person Plural
kruusailimme	First person Plural
soittakaa	Second person Plural
perheyrityksen	None
listautuisivat	Third person Plural
könynnyt	None
ilmoittaa	Third person Singular
pyrähtänevät	Third person Plural
malttaa	Third person Singular
kirjaudut	Second person Singular
keskustele	Second person Singular
havainnollista	Second person Singular
selitän	First person Singular
ohjeisti	Third person Singular
hioivat	Third person Plural
tasokkaan	None
röyhtäyksen	None
tavoittelevat	Third person Plural
sanailet	Second person Singular
aloit	Second person Singular
paloittelivat	Third person Plural
palelluttakaamme	First person Plural
säästäisi	Third person Singular
laottaisivat	Third person Plural
suojelijoiksi	None
illasta	Second person Singular
lähettäjäksi	None
leikkauttaa	Third person Singular
poistavat	Third person Plural
havainnollisti	Third person Singular
tainnut	Second person Singular
siirtyvät	Third person Plural
sanatarkkaa	None
korostanemme	First person Plural
formaalistitte	Second person Plural
kalleuksia	None
löystyy	Third person Singular
kuvailee	Third person Singular
uhoaa	Third person Singular
funtsannen	First person Singular
pressun	None
valtauksia	None
yksikätisissä	None
väistävät	Third person Plural
vyöryn	First person Singular
kuiskannemme	First person Plural
tietävät	Third person Plural
sulkavalle	None
ukkosta	Second person Singular
kukonharjoihin	None
saattaisi	Third person Singular
ei-välttämättömiin	None
liioittelivat	Third person Plural
virkistyksen	None
lujittui	Third person Singular
taputti	Third person Singular
pahentaisit	Second person Singular
kansoittanee	Third person Singular
jantrassa	None
yksimielinen	None
pariteetilta	None
anteliaalle	None
kuulustelivat	Third person Plural
komppaniana	None
keinu	Second person Singular
seuraavat	Third person Plural
vihastu	Second person Singular
erottavat	Third person Plural
piispoilla	None
julkaiset	Second person Singular
join	First person Singular
kuronen	First person Singular
metsästää	Third person Singular
absolutismia	None
ääntele	Second person Singular
tarkoituksella	None
laajentuivat	Third person Plural
fagottiin	None
rintamilla	None
väitän	First person Singular
esitän	First person Singular
putoavat	Third person Plural
anasti	Third person Singular
vannoivat	Third person Plural
menševikit	None
modifioidun	First person Singular
sävelsivät	Third person Plural
veit	Second person Singular
juoksevat	Third person Plural
yhdensuuntaista	Second person Singular
yrittivät	Third person Plural
suhtautuisin	First person Singular
yrittäisivät	Third person Plural
lähettävät	Third person Plural
kiittelivät	Third person Plural
näölle	None
havutti	Third person Singular
kohtuutta	None
erillisillä	None
teknikkoa	None
väliseinät	None
huomasimme	First person Plural
sijaitsi	Third person Singular
traktorien	None
skeittilaudoitta	None
uiskentelee	Third person Singular
sadepäivä	None
hännätönleikoilla	None
hartsannemme	First person Plural
romanttisesta	None
yhdistelmämateriaaleista	None
painukaa	Second person Plural
alapuoliseen	None
pulppuaa	Third person Singular
kuuntelet	Second person Singular
synkkenevät	Third person Plural
virallistui	Third person Singular
parrakkaissa	None
kovettuva	None
laktoositon	None
säilyisi	Third person Singular
haihtuvat	Third person Plural
monistoja	None
kilottavat	Third person Plural
ryskyy	Third person Singular
jalkauttivat	Third person Plural
käsittelivät	Third person Plural
hämmästelivät	Third person Plural
väistivät	Third person Plural
palvo	Second person Singular
feeniksin	None
voitti	Third person Singular
pidättäytyvät	Third person Plural
ohittivat	Third person Plural
ujutti	Third person Singular
tarkastavat	Third person Plural
loveaisitte	Second person Plural
saapastelisin	First person Singular
viskasi	Third person Singular
huolestuvat	Third person Plural
blokkiinnuit	Second person Singular
liestyy	Third person Singular
pilkkoo	Third person Singular
varsokoot	Third person Plural
sidottanette	Second person Plural
virosta	None
tarkastuksista	None
toteuttaisi	Third person Singular
jumittuu	Third person Singular
pelastaisi	Third person Singular
tarkoitin	First person Singular
perehtyivät	Third person Plural
hahmotitte	Second person Plural
vieraile	Second person Singular
merkitköön	Third person Singular
sujui	Third person Singular
pulloruokinnoista	None
ilmentyvät	Third person Plural
kiusaannut	Second person Singular
kasaan	First person Singular
huikaiskaamme	First person Plural
kirskauttaisitte	Second person Plural
kaunista	Second person Singular
sujuvat	Third person Plural
tukeutuu	Third person Singular
hävettää	Third person Singular
lähensi	Third person Singular
taioilla	None
suojaisi	Third person Singular
loikkasi	Third person Singular
vertaat	Second person Singular
kaipasivat	Third person Plural
häiriintyvät	Third person Plural
nuolenpäitä	None
jokeriksi	None
laskisin	First person Singular
epäilyttävät	Third person Plural
pohjavedet	None
ravissa	None
valvoisi	Third person Singular
perustelisi	Third person Singular
heikentyvät	Third person Plural
lehmihakana	None
muutat	Second person Singular
papillisen	None
pelastautuivat	Third person Plural
saapuisi	Third person Singular
tupsahti	Third person Singular
venytti	Third person Singular
lakkauttivat	Third person Plural
ilmestynee	Third person Singular
silene	Second person Singular
digitalisoitiin	None
lisäsit	Second person Singular
suoltunette	Second person Plural
välimatkojen	None
haaskautukoot	Third person Plural
luovat	Third person Plural
lietsoi	Third person Singular
ohjautuva	None
seuraisi	Third person Singular
selitin	First person Singular
vakauttaa	Third person Singular
sarastaa	Third person Singular
henkilöityy	Third person Singular
tökkii	Third person Singular
pysäköinevät	Third person Plural
luisteli	Third person Singular
luokittelisin	First person Singular
pidellen	First person Singular
kaarruin	First person Singular
kuuntelin	First person Singular
junaili	Third person Singular
laudanumia	None
heijastu	Second person Singular
pikeäisin	First person Singular
mahtimiehet	None
luottaa	Third person Singular
suuntaukset	None
näytteli	Third person Singular
aldehydin	None
maatamme	First person Plural
litografiassa	None
menehtyivät	Third person Plural
myyn	First person Singular
loogiseksi	None
tukeutui	Third person Singular
syttyy	Third person Singular
reunustaa	Third person Singular
väittävät	Third person Plural
hiljaisia	None
katsoin	First person Singular
lihankidutuksiksi	None
kointähti	None
käyttäisimme	First person Plural
kertoilee	Third person Singular
kiekkoili	Third person Singular
pyörähtävät	Third person Plural
sähkölaitokselle	None
energianlähteittä	None
riistävät	Third person Plural
osteopatiat	None
kiellän	First person Singular
tietää	Third person Singular
vakavalta	None
haaksirikkoutui	Third person Singular
arginiinia	None
huonone	Second person Singular
johtunee	Third person Singular
saatoin	First person Singular
järjestäytynyttä	None
epämiehekkyyksien	None
tulittaa	Third person Singular
vien	First person Singular
oppi	Third person Singular
lyön	First person Singular
helikopterissa	None
hyväksyisi	Third person Singular
nyrjäytti	Third person Singular
sävelien	None
heprealaisella	None
pommitti	Third person Singular
kertyivät	Third person Plural
hövelien	None
pyöräillen	First person Singular
väitit	Second person Singular
jäsentää	Third person Singular
lumihiutaleiden	None
pysy	Second person Singular
ällöttäisivät	Third person Plural
pakottavat	Third person Plural
smoolanninajokoirassa	None
karbonaateista	None
edullisin	None
harjoittavat	Third person Plural
tunkkaseitikeissä	None
palele	Second person Singular
yhdisti	Third person Singular
hyötyivät	Third person Plural
tappelivat	Third person Plural
tihkui	Third person Singular
uhrasivat	Third person Plural
esteli	Third person Singular
tarjoan	First person Singular
kuivui	Third person Singular
jatku	Second person Singular
lahjoi	Third person Singular
syyrialaisista	None
oivaltaa	Third person Singular
rumistutte	Second person Plural
avaruusluotainta	None
vaikeuttaa	Third person Singular
jaksota	Second person Singular
kantapäästä	None
levitä	Second person Singular
traditiossa	None
naruttanet	Second person Singular
mutkistuu	Third person Singular
ehdokas	None
roomalaista	Second person Singular
vyöarvo	None
elä	Second person Singular
puristautuisit	Second person Singular
vaikeutetaan	None
esittänyt	None
puhkaisee	Third person Singular
tapailivat	Third person Plural
jutusta	Second person Singular
kysykää	Second person Plural
selvensin	First person Singular
unettomuudesta	None
tuijottavat	Third person Plural
leventää	Third person Singular
vaihda	Second person Singular
jätätti	Third person Singular
mukautuu	Third person Singular
tietäisit	Second person Singular
isoon	None
käännytti	Third person Singular
harmittelevat	Third person Plural
harvenee	Third person Singular
kummastuttaa	Third person Singular
palosuojaavat	Third person Plural
vääristyy	Third person Singular
tunnisti	Third person Singular
sypressien	None
taimia	None
kätkee	Third person Singular
erikoistuu	Third person Singular
valittavat	Third person Plural
toistuivat	Third person Plural
voimassaoloaikana	None
kohtaamme	First person Plural
hahmottui	Third person Singular
helpottui	Third person Singular
kieppunet	Second person Singular
syyllistyin	First person Singular
ruostu	Second person Singular
nuokkuvat	Third person Plural
paikallistaa	Third person Singular
läikytitte	Second person Plural
mielikuvitusystävä	None
kuljemme	First person Plural
väistä	Second person Singular
horrostavat	Third person Plural
lerppunemme	First person Plural
nopeutui	Third person Singular
halottiin	None
nivoutuvat	Third person Plural
poikinut	None
paneutuu	Third person Singular
totesimme	First person Plural
palaisivat	Third person Plural
öljymaalaukset	None
puhuttelevat	Third person Plural
julkistaa	Third person Singular
kahnatkaa	Second person Plural
suunnitteissa	None
morsiamesta	None
repeytyy	Third person Singular
joutunee	Third person Singular
käyttäytyivät	Third person Plural
testaan	First person Singular
samaistivat	Third person Plural
latistu	Second person Singular
käsittäisin	First person Singular
skannauksen	None
kaltaista	Second person Singular
takaosaa	None
kiehtoi	Third person Singular
viekoittele	Second person Singular
lahkolaiset	None
aikailkaamme	First person Plural
tähdittänet	Second person Singular
laulaisi	Third person Singular
päde	Second person Singular
tuijotin	First person Singular
juurtui	Third person Singular
sipaisimme	First person Plural
kiistän	First person Singular
implantti	None
hankaan	First person Singular
suikaloisimme	First person Plural
käännyttivät	Third person Plural
kannattelee	Third person Singular
saarnasi	Third person Singular
huudatti	Third person Singular
paskantaa	Third person Singular
kondensoituvat	Third person Plural
rauhoitu	Second person Singular
puistokadun	None
sivistää	Third person Singular
kipristäisitte	Second person Plural
sotke	Second person Singular
kaihtanevat	Third person Plural
keskityn	First person Singular
viitannee	Third person Singular
tšagatai	None
trimmauksessa	None
vastannee	Third person Singular
oppimisvaikeus	None
kaikkoa	Second person Singular
totean	First person Singular
kavensi	Third person Singular
tekeytyi	Third person Singular
kyhäisin	First person Singular
vihossa	None
läimäyttää	Third person Singular
peuranvasoissa	None
paukun	First person Singular
opasti	Third person Singular
nuorensi	Third person Singular
oleilevat	Third person Plural
kokeiluksi	None
ratsasi	Third person Singular
lauttaatte	Second person Plural
paranormaalia	None
ammuu	Third person Singular
hyödytä	Second person Singular
mustuu	Third person Singular
paleltui	Third person Singular
torjuvat	Third person Plural
kommentoikaa	Second person Plural
huononsi	Third person Singular
kaasuputkea	None
saavuta	Second person Singular
halkaisee	Third person Singular
harvenevat	Third person Plural
venähti	Third person Singular
äkkijyrkän	None
öykkäsit	Second person Singular
lanseerasivat	Third person Plural
putoa	Second person Singular
johdatteli	Third person Singular
kuvittelet	Second person Singular
piristä	Second person Singular
perliiteiksi	None
kajahtaa	Third person Singular
nokkoskasvitta	None
suostuu	Third person Singular
ulottaudun	First person Singular
uskon	First person Singular
matkailu	None
tietänee	Third person Singular
paranna	Second person Singular
torjun	First person Singular
vieraskielisestä	None
koskettimisto	None
läksyttää	Third person Singular
yksinkertaistui	Third person Singular
kuvasin	First person Singular
monopolisoinniksi	None
polttavalla	None
hurrasi	Third person Singular
kiinnostaisi	Third person Singular
kuluttajat	None
äveriäisyyksin	None
varastivat	Third person Plural
akateemiseksi	None
vertailin	First person Singular
liputtaa	Third person Singular
lähdön	None
tyyntyy	Third person Singular
rikastaa	Third person Singular
kuljettavat	Third person Plural
koin	First person Singular
kompaktiuksilla	None
lamautti	Third person Singular
tangeriineilla	None
joutui	Third person Singular
eristivät	Third person Plural
omistaisi	Third person Singular
kannattaisin	First person Singular
moraalisessa	None
meänkieltä	None
käsittelevät	Third person Plural
kuumensi	Third person Singular
syyllistyivät	Third person Plural
lähdekoodina	None
talvihorroksessa	None
kuljetti	Third person Singular
deaktivoinee	Third person Singular
suvaitsi	Third person Singular
harrasta	Second person Singular
kadehtii	Third person Singular
latvuston	None
keskustelemme	First person Plural
samaistavat	Third person Plural
uskaltautuu	Third person Singular
propanoleitta	None
kirjaimistotta	None
salasi	Third person Singular
tutkimuksista	None
toisintaa	Third person Singular
paheksuivat	Third person Plural
kiveä	Second person Singular
syyhyä	Second person Singular
valaistun	First person Singular
määrittää	Third person Singular
jarrulevyttä	None
kelmetkööt	Third person Plural
turkkilaisista	None
oppikirjojen	None
seuloo	Third person Singular
läpäisee	Third person Singular
loksahti	Third person Singular
ukkostaa	Third person Singular
hiostuttaa	Third person Singular
vilkastuvat	Third person Plural
kuuntelevat	Third person Plural
limakalvo	None
saavu	Second person Singular
muusille	None
neliöinevät	Third person Plural
rajoittaa	Third person Singular
halot	Second person Singular
imeytyvät	Third person Plural
odotellen	First person Singular
puhumme	First person Plural
harmailla	None
vihastuu	Third person Singular
estäkää	Second person Plural
hiljeni	Third person Singular
venyttää	Third person Singular
frankiumia	None
huomasi	Third person Singular
puurtaa	Third person Singular
muistellen	First person Singular
saatamme	First person Plural
nielaisee	Third person Singular
lipsautit	Second person Singular
mätästäkää	Second person Plural
huipensitte	Second person Plural
lensin	First person Singular
läträtkööt	Third person Plural
varauduttava	None
ihmetyttää	Third person Singular
määritteli	Third person Singular
dumari	None
oikeuttaa	Third person Singular
näykki	Third person Singular
haittaisi	Third person Singular
pörhistänette	Second person Plural
hienonen	First person Singular
merikelpoisuudella	None
hanki	Second person Singular
koit	Second person Singular
viljaympyrät	None
äänestämme	First person Plural
näyttäisivät	Third person Plural
kuplii	Third person Singular
ylisti	Third person Singular
muistuttavat	Third person Plural
stressautuisi	Third person Singular
vetäköön	Third person Singular
köyhentykööt	Third person Plural
teollistui	Third person Singular
pidätteli	Third person Singular
harittanemme	First person Plural
huoltajien	None
raamissa	None
nukahtaa	Third person Singular
pilaavat	Third person Plural
vastuksella	None
huristaisin	First person Singular
kymotrypsiineihin	None
liputti	Third person Singular
kielsivät	Third person Plural
uinut	Second person Singular
luonnut	Second person Singular
etääntyivät	Third person Plural
kohosivat	Third person Plural
kinnerjänteen	None
omasi	Third person Singular
konnun	None
myötäillee	Third person Singular
valuu	Third person Singular
tarvinnee	Third person Singular
hoikka	None
kehräsivät	Third person Plural
zarathustralaisen	None
allastivat	Third person Plural
murehtii	Third person Singular
suosittaa	Third person Singular
teollisuusalueena	None
seuratkaa	Second person Plural
heltisi	Third person Singular
pyörittelee	Third person Singular
loppukäyttäjälle	None
vaateet	None
pikkulinnuille	None
halvaantuu	Third person Singular
muuntunette	Second person Plural
opiskelee	Third person Singular
elele	Second person Singular
kiihottuivat	Third person Plural
yltä	Second person Singular
pistouvaat	Second person Singular
punoisi	Third person Singular
virittelisitte	Second person Plural
levittivät	Third person Plural
avitti	Third person Singular
heijasta	Second person Singular
uupuivat	Third person Plural
kirjasi	Third person Singular
vikittelee	Third person Singular
laittaisin	First person Singular
falsifioituvissa	None
alentaisi	Third person Singular
tuottajia	None
saavuttaisi	Third person Singular
hautautuu	Third person Singular
telkku	None
asuinpaikoilla	None
kuraantuu	Third person Singular
kattoivat	Third person Plural
lohikäärmeeltä	None
iske	Second person Singular
bridgeä	None
pikeäisitte	Second person Plural
valotti	Third person Singular
juonittelivat	Third person Plural
vastaanotin	First person Singular
puhuttaa	Third person Singular
fibannen	First person Singular
laattaan	First person Singular
järjestää	Third person Singular
murskasi	Third person Singular
ylänne	None
materialisoitukoon	Third person Singular
kampaajana	None
lausuivat	Third person Plural
rumentavat	Third person Plural
rakastin	First person Singular
siivittyivät	Third person Plural
paista	Second person Singular
kumpusi	Third person Singular
seurasin	First person Singular
osuin	First person Singular
jäätyvät	Third person Plural
koulutuksia	None
ympärileikkausten	None
hautautui	Third person Singular
leijui	Third person Singular
hehkulamppujen	None
seison	First person Singular
istu	Second person Singular
masennuslääkkeitä	None
hopeanväriset	None
tuhisemme	First person Plural
repeä	Second person Singular
tiedusteli	Third person Singular
lauluille	None
läpäisevät	Third person Plural
loitsii	Third person Singular
avioliitoissa	None
kokisi	Third person Singular
tähtisumuin	None
lykkäsi	Third person Singular
kinasit	Second person Singular
pienentyi	Third person Singular
korkkiintunevat	Third person Plural
notkeudella	None
koukistaa	Third person Singular
alittavat	Third person Plural
itsenäistyivät	Third person Plural
tapahtui	Third person Singular
rakastajattaresta	None
katkeroitti	Third person Singular
mölisisitte	Second person Plural
nojautuvat	Third person Plural
kielteistykäämme	First person Plural
koukkuatte	Second person Plural
sivakoitu	None
intoa	Second person Singular
paistavat	Third person Plural
murahtaisitte	Second person Plural
verovapautta	None
muisteli	Third person Singular
rukoilevat	Third person Plural
humisisin	First person Singular
viilentävät	Third person Plural
huutavat	Third person Plural
ryöstelevät	Third person Plural
nekrofiliaa	None
sivuavat	Third person Plural
periköön	Third person Singular
rikkiatomi	None
säännösteli	Third person Singular
masentui	Third person Singular
osallistui	Third person Singular
digitoitiin	None
tolvanalle	None
arponen	First person Singular
obligaatioita	None
hakeutuivat	Third person Plural
hehkutti	Third person Singular
vekkasin	First person Singular
psykoanalyyttisesta	None
kyyn	None
tahrautukaa	Second person Plural
härmistyy	Third person Singular
haihtuisi	Third person Singular
uuttaa	Third person Singular
peruuntui	Third person Singular
satanismi	None
tarratkaamme	First person Plural
somentanen	First person Singular
tohdi	Second person Singular
katselmuksen	None
vääntelisi	Third person Singular
kodinhoitohuoneessa	None
tipu	Second person Singular
huolsin	First person Singular
viileään	None
huipentuivat	Third person Plural
tuholaismyrkkynä	None
vahvisti	Third person Singular
buuasi	Third person Singular
sammun	First person Singular
sujut	Second person Singular
kakkosesta	None
saarnalta	None
ampuisivat	Third person Plural
afääriä	None
vaijereilla	None
täydensi	Third person Singular
kubistiset	None
esiintyisi	Third person Singular
biomin	None
pienenisi	Third person Singular
kärjistänen	First person Singular
havaitse	Second person Singular
palstoittaa	Third person Singular
huudan	First person Singular
ohentuisitte	Second person Plural
samastuu	Third person Singular
työntävät	Third person Plural
robotisoituisin	First person Singular
kolkkaan	First person Singular
poistin	First person Singular
hypi	Second person Singular
koputa	Second person Singular
hammastanet	Second person Singular
rekonstruoisimme	First person Plural
toteutuisivat	Third person Plural
kunnioittaa	Third person Singular
heilutti	Third person Singular
hiirestä	Second person Singular
kohtelevat	Third person Plural
rautaisen	None
vaelluksen	None
teloituksilla	None
muuttaisit	Second person Singular
paineista	Second person Singular
tulehdusta	None
roju	None
postimerkillä	None
tuotemerkeistä	None
vältteli	Third person Singular
latasin	First person Singular
hätääntyy	Third person Singular
lataat	Second person Singular
hälvennyimme	First person Plural
narri	None
liimautuisitte	Second person Plural
rakasti	Third person Singular
hyökkäili	Third person Singular
hätäkutsu	None
uupui	Third person Singular
vakinaisena	None
vanhenee	Third person Singular
elit	Second person Singular
jalostui	Third person Singular
tarjoamme	First person Plural
mietiskeli	Third person Singular
lakkoiltiin	None
kärjistyisin	First person Singular
suorita	Second person Singular
vaiheilta	None
srapnelli	None
arvaisin	First person Singular
palentukaamme	First person Plural
ruuvaisimme	First person Plural
madalsi	Third person Singular
rauhoitellemme	First person Plural
tiedottivat	Third person Plural
elliptisen	None
siirrännäiset	None
äänestyspäivänä	None
bamburuo'oissa	None
nielevät	Third person Plural
laskutuksen	None
muokkaat	Second person Singular
viistotkaamme	First person Plural
kiinalaista	None
heitän	First person Singular
periaatteet	None
ihmettelisin	First person Singular
paikallisilla	None
hämärtävät	Third person Plural
lääkäreiksi	None
luokkien	None
vihaavat	Third person Plural
kirjoituksesta	None
jännittäväksi	None
kehtaisi	Third person Singular
pussikaniinit	None
jaottelee	Third person Singular
kastoi	Third person Singular
raiskasivat	Third person Plural
kyselevät	Third person Plural
ansaitsevat	Third person Plural
nälväisisitte	Second person Plural
yhdentää	Third person Singular
puhelinnumeron	None
kyselyjen	None
riippuliidin	First person Singular
juolukka	None
löyhennyt	Second person Singular
tennismailoista	None
puheenparsi	None
rakastelivat	Third person Plural
pelästyy	Third person Singular
sohjouduitte	Second person Plural
värväytykää	Second person Plural
korsia	None
surmataan	None
ponnistelee	Third person Singular
erinäisiä	None
vaelsi	Third person Singular
jäsentelit	Second person Singular
radikalisoitui	Third person Singular
vilkastuu	Third person Singular
myöhästyvät	Third person Plural
keikuttaa	Third person Singular
avustavat	Third person Plural
purskahtaa	Third person Singular
opettele	Second person Singular
ripautan	First person Singular
derivaattoja	None
hidasta	Second person Singular
syötäväksi	None
diivaillen	First person Singular
nuotteja	None
viheltävät	Third person Plural
malta	Second person Singular
eloon	None
konklaavissa	None
villipetoja	None
joogasit	Second person Singular
kertotauluineen	None
jippoilimme	First person Plural
suoltunemme	First person Plural
kitaristiin	None
jatkoi	Third person Singular
rupeaisi	Third person Singular
ydinaseista	Second person Singular
tiivistää	Third person Singular
väisti	Third person Singular
peruu	Third person Singular
päärmäisin	First person Singular
avartaa	Third person Singular
ulottuivat	Third person Plural
kiertelevät	Third person Plural
altista	Second person Singular
toivotitte	Second person Plural
välähdimme	First person Plural
vyötäröön	None
niksu	Second person Singular
vakuuttivat	Third person Plural
kauppakamaria	None
valvoin	First person Singular
noki	Second person Singular
uumoiltiin	None
kevetköön	Third person Singular
ruoskii	Third person Singular
kasautuu	Third person Singular
haastaa	Third person Singular
työskennellette	Second person Plural
limoittukaamme	First person Plural
suosisit	Second person Singular
palvelijattareen	None
sodanlietsojiksi	None
imivät	Third person Plural
tuutia	None
ohjautuvat	Third person Plural
tiesivät	Third person Plural
kompastuu	Third person Singular
majoittakaa	Second person Plural
hälisisi	Third person Singular
kytkin	First person Singular
tuonen	First person Singular
kaipaavat	Third person Plural
ruiskuttanen	First person Singular
repeäisin	First person Singular
luista	Second person Singular
valmistuvat	Third person Plural
mekastatte	Second person Plural
lumosi	Third person Singular
näivettyi	Third person Singular
hyödyt	Second person Singular
islamismin	None
karsikko	None
hahmottavat	Third person Plural
hoputtaisin	First person Singular
höllentää	Third person Singular
juovamangustista	None
paksujen	None
toitottakoot	Third person Plural
kostuu	Third person Singular
gravitaatioon	None
onnistunee	Third person Singular
universaaleja	None
kunnioitan	First person Singular
puolitangossa	None
kylpevät	Third person Plural
puutun	First person Singular
vaikeuttavat	Third person Plural
salpaatte	Second person Plural
negatiivi	None
ainesosia	None
äännähti	Third person Singular
huolimattoman	None
onnellistuttanen	First person Singular
merenpintaa	None
camembert	None
nimesivät	Third person Plural
välitä	Second person Singular
parantelivat	Third person Plural
sirppimäinen	None
muodostelmia	None
pensastava	None
kohonnut	None
ohikulkijoille	None
paisuisi	Third person Singular
iskisi	Third person Singular
taisteli	Third person Singular
rakentui	Third person Singular
massaan	First person Singular
hoitavat	Third person Plural
sensuuria	None
maita	Second person Singular
rettelöinen	First person Singular
estäisivät	Third person Plural
eroottista	Second person Singular
taitaa	Third person Singular
yrjöä	Second person Singular
jäädyttänyt	None
ulottautui	Third person Singular
nopeuttaisi	Third person Singular
kaiverrettiin	None
aristuksin	None
kohteli	Third person Singular
sopinee	Third person Singular
beaujolaisviinin	None
säästettävä	None
häämötti	Third person Singular
kuutioisissa	None
kuluttivat	Third person Plural
luovuttaisi	Third person Singular
vähästä	None
apeudut	Second person Singular
mukautuvat	Third person Plural
bruukannet	Second person Singular
nauttisi	Third person Singular
käyttökelpoisia	None
pyörenette	Second person Plural
hankaloittaa	Third person Singular
välisiksi	None
kyseenalaistavat	Third person Plural
yritti	Third person Singular
pettävät	Third person Plural
vajosi	Third person Singular
toimituksen	None
haulien	None
kadunmies	None
rauhoittelee	Third person Singular
löysetkää	Second person Plural
hiostui	Third person Singular
vaikuttavat	Third person Plural
kuvannut	Second person Singular
mikrovaltioita	None
sovelsi	Third person Singular
kirjoittaa	Third person Singular
heivata	None
erämaita	None
reagoisivat	Third person Plural
huomaatte	Second person Plural
temperoikoot	Third person Plural
puhkeaa	Third person Singular
haittasivat	Third person Plural
tukeutuvat	Third person Plural
hassuttanette	Second person Plural
haltijoille	None
leimasivat	Third person Plural
myöhäisiltaan	None
puolustat	Second person Singular
liukastui	Third person Singular
oreksiinien	None
lähettää	Third person Singular
lohdutti	Third person Singular
puski	Third person Singular
halveksui	Third person Singular
häämöttänee	Third person Singular
perustelisivat	Third person Plural
materiaalistuvat	Third person Plural
käsitellen	First person Singular
täyttänee	Third person Singular
kuntoutuksena	None
tunkee	Third person Singular
mainostaa	Third person Singular
erottaa	Third person Singular
noettuisin	First person Singular
haaksirikkoutuu	Third person Singular
salamurhasi	Third person Singular
uskoi	Third person Singular
riistää	Third person Singular
jaksellevat	Third person Plural
jalokivien	None
kansanvaltaista	Second person Singular
aikoi	Third person Singular
haarautui	Third person Singular
laivueita	None
käväisi	Third person Singular
hyväuskoinen	None
söin	First person Singular
korvaavat	Third person Plural
söi	Third person Singular
kylmennet	Second person Singular
kehottivat	Third person Plural
pehmentävät	Third person Plural
tukahdutti	Third person Singular
yritä	Second person Singular
megalopoliin	None
karvoituin	First person Singular
syöttäjän	None
halvaantui	Third person Singular
aavisti	Third person Singular
ruiskua	Second person Singular
koittivat	Third person Plural
avaamaton	None
lääkintämiehen	None
osavaltiot	None
ruoti	Third person Singular
ostaisivat	Third person Plural
hybridisaatio	None
salakuljetti	Third person Singular
kirkasta	Second person Singular
räjähtäisimme	First person Plural
poissaoleva	None
lomittuvat	Third person Plural
verso	Second person Singular
eheyttää	Third person Singular
varmistivat	Third person Plural
myyvät	Third person Plural
napsautat	Second person Singular
varautuneista	None
monacolaiset	None
kourii	Third person Singular
neutraloitakoon	None
yliviivasin	First person Singular
viivästyi	Third person Singular
koukuttaa	Third person Singular
ontuu	Third person Singular
suon	First person Singular
purjehtinemme	First person Plural
valmistautui	Third person Singular
toipuvat	Third person Plural
vangitsevat	Third person Plural
riutui	Third person Singular
instituutiotta	None
karvaan	First person Singular
jyrkänne	None
poistakaa	Second person Plural
lopetat	Second person Singular
uskaltavat	Third person Plural
äänestit	Second person Singular
reaalista	Second person Singular
saumaan	First person Singular
suorittivat	Third person Plural
kovistelee	Third person Singular
pyörenisit	Second person Singular
haarapääsky	None
selviytyjät	None
soittaa	Third person Singular
estettävä	None
kaivosyhtiön	None
jatka	Second person Singular
turhautuisit	Second person Singular
vaikutusvaltaista	None
sukeltajana	None
tarkistin	First person Singular
suitsevat	Third person Plural
pygmiltä	None
vierastakaamme	First person Plural
vesikirput	None
mainosti	Third person Singular
puhuivat	Third person Plural
paukkunen	First person Singular
itketä	Second person Singular
tavoitti	Third person Singular
heikkenee	Third person Singular
ratkaisi	Third person Singular
duuman	None
julkisen	None
päätyisi	Third person Singular
selasin	First person Singular
luon	First person Singular
epäluottamuslausetta	None
hyökkäisivät	Third person Plural
motorisoidu	Second person Singular
unihalvaus	None
pysäyttäkää	Second person Plural
virun	First person Singular
saarnaajina	None
istuttaa	Third person Singular
ilmoittautuivat	Third person Plural
katkovat	Third person Plural
vaella	Second person Singular
tulkitsi	Third person Singular
päiväntasauksesta	None
toimittaa	Third person Singular
plaseerasimme	First person Plural
rodulta	None
pöhötyit	Second person Singular
vääntyvät	Third person Plural
velmuilin	First person Singular
gratinoisivat	Third person Plural
kieltäydytään	None
rykmentteihin	None
surmaavat	Third person Plural
puettavat	Third person Plural
erilaista	Second person Singular
viimeisimpään	None
kiroan	First person Singular
metaboliiteilta	None
tähtäsivät	Third person Plural
vakiinnuttivat	Third person Plural
siniviivaan	None
näytöissä	None
rikkonen	First person Singular
subduktiovyöhykkeet	None
pitkänomaista	None
vääristi	Third person Singular
jäähalleista	None
mäntyöljyn	None
koksaamme	First person Plural
tuorein	None
äännähtänen	First person Singular
monipuolistuu	Third person Singular
tuotteista	Second person Singular
väkivaltaisuuteen	None
ylikuormittaa	Third person Singular
kuku	Second person Singular
nautti	Third person Singular
kaatuu	Third person Singular
tarkastelevat	Third person Plural
kivuliaalta	None
potkaisi	Third person Singular
kannata	Second person Singular
päätoimittajasta	None
vertauskuvallista	Second person Singular
suututti	Third person Singular
päntännet	Second person Singular
havaitsevat	Third person Plural
kuolinkamppailuilla	None
vastaamme	First person Plural
toisin	First person Singular
kirjoitan	First person Singular
viet	Second person Singular
löytyisi	Third person Singular
oksaalihappoa	None
pysähtyivät	Third person Plural
lahota	Second person Singular
luonnostelivat	Third person Plural
varron	First person Singular
huipensi	Third person Singular
muotoa	Second person Singular
halkesi	Third person Singular
korjaamaton	None
länsimaailmaan	None
hirttivät	Third person Plural
suosittelisi	Third person Singular
kiinnostivat	Third person Plural
vähentyivät	Third person Plural
ratsaat	Second person Singular
kykenen	First person Singular
merelliset	None
liukuu	Third person Singular
fiaskoineen	None
tuottaisi	Third person Singular
närkästynyt	None
sietää	Third person Singular
kihartunemme	First person Plural
masentuu	Third person Singular
liversit	Second person Singular
kyrsältä	None
hopeaseppä	None
poista	Second person Singular
kuulostaa	Third person Singular
puhu	Second person Singular
kanavoida	None
tasasi	Third person Singular
homehtuu	Third person Singular
kostuttaa	Third person Singular
pinoa	Second person Singular
suodatin	First person Singular
äänimäärässä	None
sappikiveen	None
korvasivat	Third person Plural
limittyisitte	Second person Plural
imettävä	None
ojentavat	Third person Plural
masensi	Third person Singular
sodanvastaisen	None
voimakkaiksi	None
mainitsin	First person Singular
kantelussa	None
luotsata	None
luisti	Third person Singular
halkoo	Third person Singular
todensi	Third person Singular
ihmettelee	Third person Singular
hypähdellet	Second person Singular
sammaloidu	Second person Singular
yöpynyt	None
suonet	Second person Singular
salaili	Third person Singular
salamurhaajaa	None
yhtymät	None
ehtisin	First person Singular
magneettikentät	None
vaikuttukaa	Second person Plural
pullistuu	Third person Singular
kasvoin	First person Singular
selvittäisi	Third person Singular
huiputtaa	Third person Singular
lukukaudella	None
levitti	Third person Singular
lepuuttaa	Third person Singular
nostattavat	Third person Plural
raivostuivat	Third person Plural
uhrasi	Third person Singular
korostuvat	Third person Plural
hierottaisi	Third person Singular
kukista	Second person Singular
kurssilla	None
suojasi	Third person Singular
kutevat	Third person Plural
ryysyläisiltä	None
tuppaavat	Third person Plural
miekaksi	None
omahyväinen	None
karsisi	Third person Singular
tähdittävät	Third person Plural
haarniskaa	None
maanosia	None
määrään	First person Singular
pötsin	None
sivuutat	Second person Singular
suuntaan	First person Singular
sopi	Third person Singular
testamenttina	None
kompastui	Third person Singular
huomautan	First person Singular
postulaatit	None
tahrasi	Third person Singular
propyleeniglykoli	None
kasvitieteeseen	None
värjäytyy	Third person Singular
hortensioilta	None
rantautui	Third person Singular
tupsahtaa	Third person Singular
kirjoittelivat	Third person Plural
astunnalla	None
teettivät	Third person Plural
harhauttaminen	None
holahdat	Second person Singular
mökeltäkää	Second person Plural
työpöydällä	None
levenen	First person Singular
pasmasimme	First person Plural
painalletaan	None
nöyryyttävänä	None
puhdista	Second person Singular
käsikirjoitti	Third person Singular
huitaisee	Third person Singular
kvartettoa	None
vastakkainasettelusta	None
vuorottelivat	Third person Plural
keinutin	First person Singular
puolitti	Third person Singular
innosti	Third person Singular
taivun	First person Singular
pakkolunasti	Third person Singular
harkitsen	First person Singular
tunnukselle	None
sylkäisi	Third person Singular
aloitat	Second person Singular
kärjistä	Second person Singular
puuttuivat	Third person Plural
läpikäyvät	Third person Plural
pöytään	First person Singular
kannustaisin	First person Singular
erkanivat	Third person Plural
lyhensivät	Third person Plural
kiehuu	Third person Singular
tulehtui	Third person Singular
enkku	None
petit	Second person Singular
ymmärrät	Second person Singular
yakuzoiden	None
vauhditimme	First person Plural
tappoivat	Third person Plural
kiinteää	None
tietyltä	None
määrittelyjen	None
mielialoista	None
aakkosta	Second person Singular
säiliöalusten	None
harjoitutti	Third person Singular
ripuloikaa	Second person Plural
heltynevät	Third person Plural
linnoitukset	None
kaupunkilaistuu	Third person Singular
pidättelee	Third person Singular
vahti	Third person Singular
vedenpaisumus	None
hävetkää	Second person Plural
mainitsisi	Third person Singular
ruskettuivat	Third person Plural
helly	Second person Singular
niveltynette	Second person Plural
kommenteista	None
kasautuivat	Third person Plural
majoittuu	Third person Singular
kierrättää	Third person Singular
työllistäisi	Third person Singular
poikkeusluvalla	None
huokuu	Third person Singular
kilpailutetaan	None
höllyn	First person Singular
innosta	Second person Singular
psykologinen	None
irtisanoi	Third person Singular
sovi	Second person Singular
valtiopäivämiehiä	None
tentti	Third person Singular
etsimiseksi	None
jaan	First person Singular
uudistivat	Third person Plural
odottelisimme	First person Plural
ripotti	Third person Singular
koe	Second person Singular
kaupungistuivat	Third person Plural
kuunnellen	First person Singular
rynnistää	Third person Singular
vieraili	Third person Singular
akuutissa	None
tunsi	Third person Singular
suosittelemme	First person Plural
kytkeytyi	Third person Singular
jyskynet	Second person Singular
saalistaa	Third person Singular
mieltävät	Third person Plural
olettamuksiin	None
harjoita	Second person Singular
taloustiedettä	None
sprayhoodiksi	None
sylinterilohko	None
vieroitti	Third person Singular
surkeaan	None
kukistuu	Third person Singular
yrittää	Third person Singular
sisälly	Second person Singular
kaakeliuuneja	None
suortunen	First person Singular
sekoitu	Second person Singular
äänitorvena	None
uusiutuivat	Third person Plural
hyvästellette	Second person Plural
oikeutti	Third person Singular
lempeän	None
rupeavat	Third person Plural
hyppäsivät	Third person Plural
kelpaisivat	Third person Plural
vuokraisimme	First person Plural
muuntohuumeena	None
sekoaa	Third person Singular
turmellut	Second person Singular
auttoi	Third person Singular
kasvatti	Third person Singular
kohdeyleisönä	None
jumittaa	Third person Singular
sosialismista	None
lainvastainen	None
aseistamattomilla	None
tarkoittaisi	Third person Singular
kaivertavat	Third person Plural
korostuisi	Third person Singular
arvostivat	Third person Plural
miksasivat	Third person Plural
mahtunee	Third person Singular
suurensi	Third person Singular
höyrystäisi	Third person Singular
liesmoista	None
ruuduilla	None
kuohut	Second person Singular
installaatiota	None
jousituksella	None
kuohutat	Second person Singular
kilpaile	Second person Singular
lukukausimaksut	None
kuparisten	None
janoa	Second person Singular
kuvaavat	Third person Plural
saattueiksi	None
ristiinnaulitkoot	Third person Plural
lankeavat	Third person Plural
lisäytyisivät	Third person Plural
kansalaisyhteiskunnan	None
panoroinevat	Third person Plural
lannistuu	Third person Singular
uupuvat	Third person Plural
hervonnee	Third person Singular
lähtisin	First person Singular
valosapelia	None
kytkeydyt	Second person Singular
hämäävät	Third person Plural
manasi	Third person Singular
pahoitellen	First person Singular
maalittomana	None
ilmeiseltä	None
hertta	None
ammattilaistan	First person Singular
tarinoiksi	None
vanhenivat	Third person Plural
keskustellen	First person Singular
lähtisi	Third person Singular
naispuoliseksi	None
pudotit	Second person Singular
muistakaa	Second person Plural
kilpailijasta	None
erkaantuivat	Third person Plural
surmaan	First person Singular
kuluttaa	Third person Singular
jyristänet	Second person Singular
edelsit	Second person Singular
kiraalisuus	None
hiiltyi	Third person Singular
suhteellisuuden	None
surevat	Third person Plural
laskutelinettä	None
koodaavat	Third person Plural
lentovene	None
menehtyi	Third person Singular
perustele	Second person Singular
varokaa	Second person Plural
sinfonian	None
vaihteli	Third person Singular
ilolauluksi	None
lisäävät	Third person Plural
tuhoudu	Second person Singular
toteuttavat	Third person Plural
triglyseridejä	None
porvarillisti	Third person Singular
hyljeksisitte	Second person Plural
kalentereissa	None
etäännytti	Third person Singular
parantaisivat	Third person Plural
kelvollisiksi	None
hehkulamppua	None
halaiskaamme	First person Plural
uskoin	First person Singular
serbokroaatin	None
keskeyttänen	First person Singular
pelaisi	Third person Singular
köyhdyttivät	Third person Plural
kuosin	None
sydämentahdistimissa	None
pilkkasivat	Third person Plural
viitteellinen	None
glykoleiksi	None
jännitti	Third person Singular
ryhtyvät	Third person Plural
aaltoilevat	Third person Plural
viileni	Third person Singular
kruunasivat	Third person Plural
liittoutuvat	Third person Plural
nolostuttaisitte	Second person Plural
kasakka	None
lasket	Second person Singular
kummastelee	Third person Singular
huomauttaisi	Third person Singular
polarisoituu	Third person Singular
enteilivät	Third person Plural
valitin	First person Singular
kantturaa	None
tallennat	Second person Singular
vedä	Second person Singular
saneerattiin	None
rukouksesta	None
myönnän	First person Singular
avaat	Second person Singular
närkästyy	Third person Singular
hautaavat	Third person Plural
skandaalijutuin	None
mahdollista	Second person Singular
helpottaisivat	Third person Plural
olympiaurheilijoita	None
sykkiköön	Third person Singular
modernisoinnilta	None
joutavat	Third person Plural
kalkyyleissa	None
mittaavat	Third person Plural
poljennoille	None
koituivat	Third person Plural
pihkaantuisi	Third person Singular
sääteli	Third person Singular
sähkövastuksilla	None
käyttää	Third person Singular
ripsikää	Second person Plural
kohahdutitte	Second person Plural
hahmottuvat	Third person Plural
kasku	None
haaste	None
kirkastuu	Third person Singular
rauhallista	None
pelottanut	None
tasavaltalaista	None
keräsin	First person Singular
vasokaamme	First person Plural
absorboituu	Third person Singular
nollasi	Third person Singular
jäykistää	Third person Singular
vatkasi	Third person Singular
heijastin	First person Singular
hävittäisi	Third person Singular
pelasta	Second person Singular
painaltakaa	Second person Plural
raksuttelevat	Third person Plural
muistivat	Third person Plural
tapahtuivat	Third person Plural
naksuttelet	Second person Singular
palvoivat	Third person Plural
guruna	None
yökätkää	Second person Plural
kiirehdi	Second person Singular
liikuttunevat	Third person Plural
peukaloinen	First person Singular
tilaavat	Third person Plural
alkuperäisin	None
bounssaisitte	Second person Plural
etene	Second person Singular
istun	First person Singular
henkisillä	None
aivosyöpään	None
muistelin	First person Singular
häiriöissä	None
suolistaisivat	Third person Plural
pyörtää	Third person Singular
dollarinseteli	None
arvostelevassa	None
orientaatioilla	None
eristänette	Second person Plural
suihkuttimitta	None
iskostan	First person Singular
kolhuilta	None
kiistelivät	Third person Plural
indiumeja	None
estelit	Second person Singular
akettakoon	Third person Singular
haihdutetaan	None
perustivat	Third person Plural
perustu	Second person Singular
ilmaisi	Third person Singular
rein	None
sitaattina	None
elpyi	Third person Singular
dieselmoottorissa	None
sinnitteli	Third person Singular
juonena	None
kupannen	First person Singular
kiertokangen	None
kisailevat	Third person Plural
äänestäkää	Second person Plural
hurmasi	Third person Singular
pyhittää	Third person Singular
soveltuivat	Third person Plural
luovuttiin	None
kuvataan	None
maatalojen	None
maatuu	Third person Singular
hirttäkää	Second person Plural
hakee	Third person Singular
vihjasi	Third person Singular
sisilialaisia	None
klimppisopat	None
vaivaan	First person Singular
tasohyppelyä	None
listautui	Third person Singular
vietteli	Third person Singular
kummitustalo	None
liehuivat	Third person Plural
tulkitsin	First person Singular
väre	None
lähdet	Second person Singular
remontista	None
arvioita	Second person Singular
rahvasta	None
elokuvantekijän	None
vakuuta	Second person Singular
kroonista	Second person Singular
kärjistivät	Third person Plural
valistuttava	None
rullaisin	First person Singular
rynnisti	Third person Singular
kaareutuisi	Third person Singular
ryhmäpaineista	None
puolusteli	Third person Singular
viranomaisilla	None
vetysidoksista	None
radikalisoituu	Third person Singular
rintamalinjojen	None
juhlistaa	Third person Singular
villitsee	Third person Singular
häälahjaksi	None
bulgariaksi	None
suojellen	First person Singular
sähköistä	Second person Singular
rajoitti	Third person Singular
lahjoita	Second person Singular
synnytti	Third person Singular
rastaan	None
erottelevat	Third person Plural
kipinöinet	Second person Singular
läimäiset	Second person Singular
liuotan	First person Singular
juoppokuskia	None
satelliitteja	None
lausu	Second person Singular
viihdytti	Third person Singular
kansanmurhaksi	None
sydänhalvaukseen	None
rauhanliikettä	None
demonstraation	None
vaaratonta	None
lannistaa	Third person Singular
varautua	None
polvistui	Third person Singular
tarjoilijaksi	None
hirvestä	Second person Singular
tietäkää	Second person Plural
laskija	None
jaa	Second person Singular
himmensi	Third person Singular
yhdistävät	Third person Plural
koostuisivat	Third person Plural
rajuna	None
kostaisi	Third person Singular
teetä	Second person Singular
purevat	Third person Plural
luhistui	Third person Singular
pitkitti	Third person Singular
määräytyisi	Third person Singular
tuomitsi	Third person Singular
vastustan	First person Singular
koostuvat	Third person Plural
säikäytti	Third person Singular
käsitti	Third person Singular
vihastunen	First person Singular
jyräsi	Third person Singular
pitäisimme	First person Plural
korotti	Third person Singular
neurasteenikoksi	None
edeltäjä	None
kalasta	Second person Singular
varautuu	Third person Singular
pakastuisit	Second person Singular
lipan	None
viljelijän	None
tuomme	First person Plural
vauhkoonnuin	First person Singular
ylimääräisiin	None
tarjoilisi	Third person Singular
hämäsi	Third person Singular
alotti	Third person Singular
modernisoitui	Third person Singular
alensi	Third person Singular
värittää	Third person Singular
kiiruhtivat	Third person Plural
tehota	Second person Singular
kansoittavat	Third person Plural
radikalisoitunut	None
kevytmoottoripyöriä	None
taittaa	Third person Singular
jäähdyttää	Third person Singular
fokusoikaa	Second person Plural
tienasi	Third person Singular
kellistä	Second person Singular
palkkasoturiksi	None
luovuttivat	Third person Plural
vispilöiköön	Third person Singular
kiinnittäisin	First person Singular
optisessa	None
hapetin	First person Singular
orientein	None
luistin	First person Singular
kestäisivät	Third person Plural
nimeää	Third person Singular
säänteli	Third person Singular
pöllyttäisit	Second person Singular
yhtäläistä	Second person Singular
hiillostaa	Third person Singular
seiso	Second person Singular
laborantti	None
sulattavat	Third person Plural
avaudu	Second person Singular
opiskelevat	Third person Plural
tyydyttää	Third person Singular
nojautuu	Third person Singular
numeroinen	First person Singular
sammuttavat	Third person Plural
merkkaan	First person Singular
juoksen	First person Singular
terroristien	None
nöyryyttivät	Third person Plural
leijuu	Third person Singular
inahtaisivat	Third person Plural
sublimoituu	Third person Singular
puolustajiksi	None
turmelin	First person Singular
irrottavat	Third person Plural
savutti	Third person Singular
tarttuisi	Third person Singular
liioitellen	First person Singular
painottaa	Third person Singular
testaat	Second person Singular
yrität	Second person Singular
naksahdus	None
huononsivat	Third person Plural
oletamme	First person Plural
toivotan	First person Singular
huulenheittäjä	None
kokoelmalta	None
huumaavat	Third person Plural
ehdotti	Third person Singular
muodostukoon	Third person Singular
kanonista	Second person Singular
siivoavat	Third person Plural
villiintyi	Third person Singular
eessä	None
esiintyvät	Third person Plural
mispeli	None
muoviin	None
huolehtisi	Third person Singular
tapella	None
rupsahtanemme	First person Plural
teeskentelee	Third person Singular
kornin	None
ajautuvat	Third person Plural
rikkoutuvat	Third person Plural
huudahtaa	Third person Singular
sudenmaitoihin	None
kiitävät	Third person Plural
yhdenvertaisia	None
häiritsisi	Third person Singular
puhdistaa	Third person Singular
yrittäkää	Second person Plural
täydentäisi	Third person Singular
hillu	Second person Singular
asumusten	None
sisustan	First person Singular
ratkovat	Third person Plural
kaivautuivat	Third person Plural
loukkaantui	Third person Singular
jäsensi	Third person Singular
pelisäännöistä	None
kaadu	Second person Singular
heitellen	First person Singular
maasälvät	None
lanseeraisin	First person Singular
senttimetristä	None
elävämpine	None
liikenneonnettomuudet	None
tajusivat	Third person Plural
olympialippu	None
petraisin	First person Singular
vajoaisi	Third person Singular
hyperbelin	None
arkkuun	None
lipsahtaa	Third person Singular
vuoropuhelussa	None
tahdon	None
tainnutti	Third person Singular
perustamiskirjan	None
ohdakkeen	None
saajasta	None
halua	Second person Singular
kohdistuvat	Third person Plural
rapautuvat	Third person Plural
kehitteli	Third person Singular
kukistuivat	Third person Plural
moninkertaisia	None
kansallispuistossa	None
irrotti	Third person Singular
halusit	Second person Singular
hoiteli	Third person Singular
käsittelisi	Third person Singular
mittasi	Third person Singular
pidit	Second person Singular
foneettista	None
ehtisi	Third person Singular
riistäytyi	Third person Singular
kukoistaa	Third person Singular
ylänköä	None
sisarpuolia	None
tykkään	First person Singular
kajota	Second person Singular
paiskaudut	Second person Singular
sähköuuneihin	None
tallon	First person Singular
kiskaisee	Third person Singular
voisin	First person Singular
kehu	Second person Singular
takoi	Third person Singular
tyrehtyi	Third person Singular
uskonopit	None
vieraannuttaa	Third person Singular
väittäisi	Third person Singular
henkilöisivät	Third person Plural
syventää	Third person Singular
sanoittivat	Third person Plural
rumennettaneen	None
monitieteiseksi	None
tiivistä	Second person Singular
haittaan	First person Singular
kellauttanet	Second person Singular
unohtuisi	Third person Singular
muuttui	Third person Singular
kehui	Third person Singular
kehittyi	Third person Singular
analoginen	None
palkin	None
ylläpidä	Second person Singular
kuihtui	Third person Singular
ekosysteemit	None
hormoneilla	None
murtautuu	Third person Singular
selittäisi	Third person Singular
sotkat	None
kirjautuivat	Third person Plural
tassi	None
passiivistaisitte	Second person Plural
kahlasi	Third person Singular
yli-ikäisenä	None
kajoa	Second person Singular
yhtenäistin	First person Singular
kannatin	First person Singular
rakensi	Third person Singular
loppuaikoina	None
nurkkauksessa	None
syyttää	Third person Singular
tykitti	Third person Singular
kasapanos	None
vakuuttavaa	None
liberalisoisivat	Third person Plural
urheilukenttiä	None
koskettaa	Third person Singular
nokihaperon	None
lobbari	None
painostivat	Third person Plural
kiehahtakaamme	First person Plural
kuvasta	Second person Singular
nyrkistäisin	First person Singular
välisiin	None
ratkoo	Third person Singular
huminoinet	Second person Singular
altisti	Third person Singular
mentaalihygieniana	None
omaksuvat	Third person Plural
kehkeytyi	Third person Singular
vanhenevat	Third person Plural
keitin	First person Singular
rajoittavat	Third person Plural
juhlaviikkojen	None
polveutuisivat	Third person Plural
supistui	Third person Singular
siirtäkää	Second person Plural
naistenmies	None
liitosta	Second person Singular
laatii	Third person Singular
kaksinkertaistuivat	Third person Plural
tiikerihai	None
kukoistitte	Second person Plural
alkuperäiskansojen	None
vein	First person Singular
sokeuteen	None
inspiroitui	Third person Singular
yleistyvät	Third person Plural
sisempään	None
kakuta	Second person Singular
vaivaavat	Third person Plural
pätisivät	Third person Plural
kompressori	None
ranskalaistaisimme	First person Plural
ilmestyi	Third person Singular
vedenkulutuksille	None
tuhotkaa	Second person Plural
fenyylietikkahappo	None
siemensin	First person Singular
internetissä	None
lievittyy	Third person Singular
tyypeistä	None
antaudun	First person Singular
introduktion	None
kontrolloisit	Second person Singular
suodin	First person Singular
kutonen	First person Singular
murisee	Third person Singular
curling	None
seksuaalivähemmistöille	None
suureni	Third person Singular
taukoa	Second person Singular
taltuttaa	Third person Singular
huljuttaisit	Second person Singular
kao	Second person Singular
tehoa	Second person Singular
laajenisi	Third person Singular
prässäydytty	None
loputtomasta	None
matkasivat	Third person Plural
sähkömäärälle	None
isovanhemman	None
opastivat	Third person Plural
kunnioita	Second person Singular
ravista	Second person Singular
kaiut	Second person Singular
tarpeettomista	None
koitti	Third person Singular
juoksijoissa	None
pettää	Third person Singular
tiedustelivat	Third person Plural
ilahtui	Third person Singular
onnistuit	Second person Singular
lasinpuhaltajat	None
skannasin	First person Singular
surmasivat	Third person Plural
haasteelliset	None
hidastaa	Third person Singular
femakkoja	None
heikentyi	Third person Singular
poistuvat	Third person Plural
hivutellevat	Third person Plural
nyrpistäisimme	First person Plural
ruusuinen	None
siivoa	Second person Singular
säästyvät	Third person Plural
totea	Second person Singular
mastonkaatolaitteeksi	None
friikkaisivat	Third person Plural
viivytti	Third person Singular
glykogeenista	None
balettiteatteri	None
keinutan	First person Singular
kätkeytyy	Third person Singular
viivyttelivät	Third person Plural
luonnista	Second person Singular
virtaviivaistanet	Second person Singular
veistä	Second person Singular
vuorotellette	Second person Plural
järjesty	Second person Singular
jupakassa	None
keikkailee	Third person Singular
immunisoituisit	Second person Singular
helähdän	First person Singular
riuhtaisisit	Second person Singular
puolustautuvat	Third person Plural
metsittyi	Third person Singular
sulattaa	Third person Singular
kääpiöplaneettoja	None
kerrosta	Second person Singular
syventyi	Third person Singular
kiipeilee	Third person Singular
noudatteli	Third person Singular
riistäytyy	Third person Singular
matemaattistakoon	Third person Singular
hidastavat	Third person Plural
keksijöinä	None
haluttaviin	None
tukahduttaa	Third person Singular
vitaminoinen	First person Singular
paalain	None
epätyydyttävällä	None
vierastaa	Third person Singular
idolin	None
unohda	Second person Singular
navakoidutte	Second person Plural
diplomaattisella	None
korvarenkaisiin	None
suojelemme	First person Plural
loimua	None
virkoaa	Third person Singular
kehystävät	Third person Plural
mendeleviumissa	None
murskautuu	Third person Singular
tytäryhtiötä	None
epäonnistuivat	Third person Plural
kalvennan	First person Singular
upotussuolaisimme	First person Plural
kauhistuvat	Third person Plural
kouluttavat	Third person Plural
guadeloupelaisesta	None
tiedustelkoot	Third person Plural
rakastan	First person Singular
vakiintui	Third person Singular
verenpaineeseen	None
onnistuin	First person Singular
lankaan	First person Singular
häiritsevät	Third person Plural
vastatkaa	Second person Plural
keskivartaloon	None
adenoidektomioilla	None
muutti	Third person Singular
gammapurkausten	None
öljyvarannot	None
perittiin	None
lukumäärät	None
kauhistuu	Third person Singular
tuloveroja	None
kumpareesta	None
valmisti	Third person Singular
jäähtyi	Third person Singular
haavoittuivat	Third person Plural
seurustelivat	Third person Plural
ylätasankoja	None
loitontaisit	Second person Singular
tyhjennä	Second person Singular
irtosivat	Third person Plural
voittaisi	Third person Singular
pulttasit	Second person Singular
varttuivat	Third person Plural
sopeuttanee	Third person Singular
kaapelitelevision	None
viettää	Third person Singular
sanoitukseen	None
perustelevat	Third person Plural
päivystänemme	First person Plural
sävyttivät	Third person Plural
elokuvasi	Third person Singular
päivittää	Third person Singular
kavaltajaa	None
kiilasivat	Third person Plural
vesittää	Third person Singular
näyttäisi	Third person Singular
aallonnette	Second person Plural
miellyttävät	Third person Plural
tehosivat	Third person Plural
kaakattanet	Second person Singular
vihasivat	Third person Plural
lastaan	First person Singular
klikkaat	Second person Singular
oikeuttavat	Third person Plural
liehui	Third person Singular
veny	Second person Singular
äänestäisi	Third person Singular
kehystää	Third person Singular
riisui	Third person Singular
sekundäärisiä	None
alkaisivat	Third person Plural
äännettävä	None
rätinöillä	None
koukistuu	Third person Singular
lehmänrokot	None
barbadoslaisen	None
roikkui	Third person Singular
käsiajalle	None
tuaregiksi	None
syyttivät	Third person Plural
hevoskärryt	None
osta	Second person Singular
veturinkuljettajana	None
keskittyisivät	Third person Plural
vuorokaudenaikaan	None
hidastaisi	Third person Singular
huonontui	Third person Singular
uhrautui	Third person Singular
esittäisin	First person Singular
kahlehtikaa	Second person Plural
tiheydellä	None
ruokailla	None
kuluttakaamme	First person Plural
saostaa	Third person Singular
vilkuilevat	Third person Plural
jahtasi	Third person Singular
vahingoittuvat	Third person Plural
valun	First person Singular
tilasivat	Third person Plural
bingo	None
muuttanut	None
hankittiin	None
likaannuin	First person Singular
varjoisalla	None
asemasotaa	None
päättyi	Third person Singular
poistaisimme	First person Plural
vaipuivat	Third person Plural
kultaseppien	None
joutuvat	Third person Plural
kirurgiksi	None
valtasi	Third person Singular
voisivat	Third person Plural
voitelukannussa	None
tallensivat	Third person Plural
selänteestä	None
arkipäiväistä	Second person Singular
sisällytä	Second person Singular
vaiensi	Third person Singular
nielaisuilla	None
itsenäistänet	Second person Singular
ennustaisi	Third person Singular
seisoo	Third person Singular
sorkkinen	First person Singular
taistelivat	Third person Plural
varhaiselta	None
menehtyy	Third person Singular
riepotteli	Third person Singular
kvartääreittä	None
poplaulajana	None
tunkeutuivat	Third person Plural
europarlamentaarikoista	None
hallitsivat	Third person Plural
lopettaisi	Third person Singular
psykooseja	None
hehkun	First person Singular
kreikankielisen	None
kiertyy	Third person Singular
eristävät	Third person Plural
kypsyyksiä	None
presidenttiydestä	None
ehkäisee	Third person Singular
värein	None
kintuissa	None
haudattava	None
simpukankuoret	None
lukitsee	Third person Singular
tarttuvat	Third person Plural
tappelu	None
sekulaaristi	Third person Singular
lähetyksinä	None
oppikirjoihin	None
häivy	Second person Singular
tunnustaisi	Third person Singular
pääomistajina	None
aprillauksin	None
sinkosimme	First person Plural
kyssittä	None
järjestäytymätön	None
seuraat	Second person Singular
lisäisin	First person Singular
eksyin	First person Singular
laskuvarjohypyn	None
kyberavaruus	None
halannen	First person Singular
hymyilevät	Third person Plural
poistaisi	Third person Singular
rakastu	Second person Singular
tervehti	Third person Singular
eriytyy	Third person Singular
muuttunut	None
lupaili	Third person Singular
kaitsenette	Second person Plural
raottaa	Third person Singular
liikuttuu	Third person Singular
rukoilulla	None
malka	None
lyhenisi	Third person Singular
palkkaan	First person Singular
vapauta	Second person Singular
budjannette	Second person Plural
doktriinia	None
auttakaa	Second person Plural
harrastaa	Third person Singular
telepaattisten	None
unohtuivat	Third person Plural
kiekuu	Third person Singular
panostaa	Third person Singular
kuroutuu	Third person Singular
kulttiin	None
kuuntelee	Third person Singular
proksimaalisen	None
ranskalaista	Second person Singular
laillista	Second person Singular
hohti	Third person Singular
kyti	Third person Singular
synteettiseksi	None
pysäyttäisi	Third person Singular
murtautuvat	Third person Plural
levittävät	Third person Plural
maistoi	Third person Singular
tomua	Second person Singular
erota	Second person Singular
luovuin	First person Singular
osasi	Third person Singular
valtakirja	None
lievenee	Third person Singular
kaatui	Third person Singular
erottuvat	Third person Plural
voitanee	Third person Singular
ohjattavan	None
suostuisi	Third person Singular
koittaa	Third person Singular
lisätköön	Third person Singular
kotelopulloitta	None
korvamerkitsi	Third person Singular
ryyppäsi	Third person Singular
puhuit	Second person Singular
vaimentimet	None
romaneita	None
ydinkäyttöisistä	None
ehdotan	First person Singular
pudottautuu	Third person Singular
rakentuvat	Third person Plural
jäykistä	Second person Singular
työpaikkana	None
omaehtoinen	None
yhdistellen	First person Singular
anastivat	Third person Plural
evakuointeja	None
sitoisi	Third person Singular
ribosomeissa	None
hälyttävät	Third person Plural
poistun	First person Singular
käytät	Second person Singular
plonkannemme	First person Plural
valtaisi	Third person Singular
epäpätevänä	None
karkeloinet	Second person Singular
totu	Second person Singular
suoritti	Third person Singular
saavuttaisivat	Third person Plural
myönnytys	None
tarjoa	Second person Singular
hapetu	Second person Singular
pirauttaisimme	First person Plural
varttunen	First person Singular
kvanttiteorian	None
nurisisit	Second person Singular
kuohuu	Third person Singular
mutatoituu	Third person Singular
purjelautailette	Second person Plural
kasvatin	First person Singular
diftongiutunee	Third person Singular
poistoissa	None
neuvokas	None
ratkesivat	Third person Plural
yliluonnolliseen	None
haluan	First person Singular
purjehtii	Third person Singular
lisätkää	Second person Plural
hieroo	Third person Singular
jerseyn	None
puristuvat	Third person Plural
eläköitynyt	None
puhdistitte	Second person Plural
ajantasaista	Second person Singular
suojautuu	Third person Singular
halpeni	Third person Singular
helikoptereilla	None
tunge	Second person Singular
elektroniset	None
suutelevat	Third person Plural
muunna	Second person Singular
soraan	First person Singular
ruotsissa	None
astuisi	Third person Singular
taikoi	Third person Singular
purppurapihtana	None
innoittaa	Third person Singular
kurottautuu	Third person Singular
päivittäisi	Third person Singular
usuttaa	Third person Singular
varustautui	Third person Singular
matkusta	Second person Singular
ansiotuloja	None
virottava	None
putosin	First person Singular
tassuttelivat	Third person Plural
sekosi	Third person Singular
rakennustyömaalle	None
peto	None
pureutuvat	Third person Plural
tekstitys	None
rivissä	None
kyseenalaisiksi	None
ratkaisivat	Third person Plural
kirjoittautuu	Third person Singular
kopisuttakaamme	First person Plural
horjahti	Third person Singular
jäljentää	Third person Singular
metsäiset	None
vuorottelee	Third person Singular
säteilköön	Third person Singular
pysyttelivät	Third person Plural
muodostunee	Third person Singular
pimeni	Third person Singular
hyppään	First person Singular
ulkoasuja	None
nahkatakkia	None
tähtimäinen	None
ehtoihin	None
artikuloisi	Third person Singular
sinkoudun	First person Singular
huvituit	Second person Singular
lamauttivat	Third person Plural
ajokortissa	None
approksimoinette	Second person Plural
ennaltaehkäisköön	Third person Singular
houkuttivat	Third person Plural
hidastuu	Third person Singular
selkäydin	None
jalostivat	Third person Plural
suolaiseksi	None
helistin	First person Singular
kutistuivat	Third person Plural
puutuu	Third person Singular
ilmoittautuvat	Third person Plural
vaihtele	Second person Singular
työllistyivät	Third person Plural
näyttää	Third person Singular
satakunnan	None
kiitämme	First person Plural
kannattivat	Third person Plural
differentiaaliyhtälöt	None
maailmanlaajuiseksi	None
tukaanit	None
pensovat	Third person Plural
kulkivat	Third person Plural
hoikennat	Second person Singular
ylitäyttäkäämme	First person Plural
lupasit	Second person Singular
kieltosanoissa	None
hiekkapuhalla	Second person Singular
kaivoon	None
voisit	Second person Singular
muotinäytöksiä	None
elimessä	None
kokisitte	Second person Plural
kurotti	Third person Singular
pelästyivät	Third person Plural
kurkottaa	Third person Singular
itsepuolustusta	None
palautuisivat	Third person Plural
viilteli	Third person Singular
soittaisi	Third person Singular
imisi	Third person Singular
innostui	Third person Singular
laittaisivat	Third person Plural
kitakielekkeettä	None
korvahylkeiden	None
taluttaa	Third person Singular
perustelkoon	Third person Singular
latinannettiin	None
mieltää	Third person Singular
rappeutui	Third person Singular
kännännemme	First person Plural
laajenivat	Third person Plural
vahingoittuisi	Third person Singular
äänittää	Third person Singular
karkonnevat	Third person Plural
pyhäköissä	None
elvyttävät	Third person Plural
tornittanevat	Third person Plural
juonsi	Third person Singular
palaudu	Second person Singular
nielaisevat	Third person Plural
majoittui	Third person Singular
vältti	Third person Singular
melua	Second person Singular
kroolannet	Second person Singular
hentoa	Second person Singular
merkinnee	Third person Singular
sielut	None
häiriintyisi	Third person Singular
marjastavat	Third person Plural
meinasi	Third person Singular
aromi	None
pääilmansuuntina	None
kuivattaa	Third person Singular
riehun	First person Singular
kiirehdän	First person Singular
naaraan	First person Singular
kielioppeja	None
äänestyspaikkana	None
riistivät	Third person Plural
siroa	Second person Singular
kuti	Third person Singular
hämmästelee	Third person Singular
eteläafrikkalaisen	None
valmista	Second person Singular
vulkanoisitte	Second person Plural
ylimatruusi	None
voimistuivat	Third person Plural
osaavat	Third person Plural
karsiutuivat	Third person Plural
kostun	First person Singular
tasapainoilimme	First person Plural
häiritse	Second person Singular
törröttävät	Third person Plural
mestasi	Third person Singular
valuttaa	Third person Singular
saastui	Third person Singular
riisuvat	Third person Plural
tutustui	Third person Singular
teetti	Third person Singular
harmittelee	Third person Singular
hedelmöityksinä	None
räikinät	None
kymmeneltä	None
häkämyrkytyksen	None
kiristäkäämme	First person Plural
ekonomistina	None
vähene	Second person Singular
etsintäkuulutuksilta	None
kompasseja	None
leimautuivat	Third person Plural
kotiuttaa	Third person Singular
virulensseihin	None
kaunistus	None
kimmeltäisivät	Third person Plural
maruna	None
työntyi	Third person Singular
proseduuri	None
liityn	First person Singular
liitännäinen	None
löylyttänen	First person Singular
kieltäytyi	Third person Singular
viehättää	Third person Singular
tiivistävät	Third person Plural
kouluttautuivat	Third person Plural
jäsennellä	None
heität	Second person Singular
vihjaavat	Third person Plural
onttosarvista	None
ventiloisimme	First person Plural
lukituksena	None
kyseenalaista	Second person Singular
jymäyttelisit	Second person Singular
pyöräilee	Third person Singular
suojelevat	Third person Plural
mielikuvituksellisia	None
nöyhtäydytte	Second person Plural
tupruavat	Third person Plural
ihailijoita	None
ryysinet	Second person Singular
ystävystyy	Third person Singular
lämpene	Second person Singular
taistele	Second person Singular
onnistuisi	Third person Singular
kannustatte	Second person Plural
vahvistuivat	Third person Plural
kyllästyy	Third person Singular
liuotin	First person Singular
muuta	Second person Singular
palautuvat	Third person Plural
lapsilisää	None
muokkasivat	Third person Plural
öljysorastakoot	Third person Plural
julistautuivat	Third person Plural
mallineessa	None
koetusta	None
mateli	Third person Singular
elvyttänemme	First person Plural
lyllertäkää	Second person Plural
karkeloinette	Second person Plural
löytynee	Third person Singular
heiluvat	Third person Plural
viitsii	Third person Singular
luokittelevat	Third person Plural
kahdentaa	Third person Singular
vääntää	Third person Singular
ehdottavat	Third person Plural
kelmensi	Third person Singular
kutoivat	Third person Plural
kiinnostuu	Third person Singular
lohduttaisi	Third person Singular
sepitti	Third person Singular
siedämme	First person Plural
ärsyyntyi	Third person Singular
sulkivat	Third person Plural
juontuu	Third person Singular
blanseeratkoon	Third person Singular
suoristuu	Third person Singular
selität	Second person Singular
klassillisen	None
faktuaaliseksi	None
hotaisisitte	Second person Plural
valuivat	Third person Plural
levittyi	Third person Singular
kiilaan	First person Singular
järkiintynevät	Third person Plural
savutitte	Second person Plural
ammattilaistakaamme	First person Plural
kätkevät	Third person Plural
osui	Third person Singular
raahautuu	Third person Singular
oltermannilla	None
turnaus	None
hirvittävät	Third person Plural
yhtenäisti	Third person Singular
tyhjensi	Third person Singular
huijaavat	Third person Plural
kiinnostavat	Third person Plural
hermoimpulssit	None
maljaa	None
mielekkäitä	None
valssannen	First person Singular
pystyttää	Third person Singular
talvehdittaisimme	First person Plural
haet	Second person Singular
lakeijoissa	None
siteeraavat	Third person Plural
lakastuu	Third person Singular
kuvittelevat	Third person Plural
äänittivät	Third person Plural
pilaisi	Third person Singular
lapasotka	None
tuultanee	Third person Singular
raikastimeksi	None
voitat	Second person Singular
horjuu	Third person Singular
torkkunet	Second person Singular
demytologisaationa	None
aukaisee	Third person Singular
sponssannette	Second person Plural
vetivät	Third person Plural
puraisee	Third person Singular
perii	Third person Singular
perustaa	Third person Singular
kalustanee	Third person Singular
pienennä	Second person Singular
mahonia	None
kariutti	Third person Singular
suomenruotsalaisille	None
yhtäläistyttiin	None
viimeistelivät	Third person Plural
tuhoutunette	Second person Plural
uusiseelantilaista	None
väliaikaiselta	None
puutarhuri	None
kohdistun	First person Singular
etsiskelkää	Second person Plural
juppeja	None
kaupungistaa	Third person Singular
janoava	None
jankuttaa	Third person Singular
totesin	First person Singular
pilkkoutuvat	Third person Plural
alempaa	None
vilisi	Third person Singular
viitsisi	Third person Singular
etäisyyksiä	None
surin	First person Singular
muodista	Second person Singular
kaappauksessa	None
kaappaisit	Second person Singular
loihtikaa	Second person Plural
monistaa	Third person Singular
pelletoisivat	Third person Plural
väittelee	Third person Singular
teknologioihin	None
hiersi	Third person Singular
bodaisimme	First person Plural
arsenikin	None
teroitti	Third person Singular
katkoo	Third person Singular
kaartaa	Third person Singular
vespan	None
sumuttimelle	None
jälkeisissä	None
toteutuksista	None
rahoituskriisin	None
kuivettuisivat	Third person Plural
kiivaimmalla	None
mystiselle	None
työpäivästä	None
soukentanee	Third person Singular
saattoi	Third person Singular
suunnittelukilpailuun	None
laihtuu	Third person Singular
tahmasit	Second person Singular
mestasivat	Third person Plural
sisusti	Third person Singular
maailmanmusiikki	None
kuvasivat	Third person Plural
sidon	First person Singular
laskee	Third person Singular
kynnenalukselle	None
siirtäisin	First person Singular
hätkähdytti	Third person Singular
jeesatkaa	Second person Plural
suree	Third person Singular
kärkipaikalta	None
vierähtää	Third person Singular
siivilöisit	Second person Singular
päädy	Second person Singular
laitteista	None
joutaisivat	Third person Plural
johdattivat	Third person Plural
hätäännyn	First person Singular
köysien	None
vuotavaa	None
aksenttia	None
pujottaa	Third person Singular
lajittelevat	Third person Plural
kisasivat	Third person Plural
akromegaliaa	None
salamurhaan	First person Singular
tyydyttäisi	Third person Singular
äidinisältä	None
inhimillistä	Second person Singular
vanheni	Third person Singular
ohjeeseen	None
puhureille	None
pilkistää	Third person Singular
alistakaamme	First person Plural
modernisoidut	Second person Singular
juhlista	Second person Singular
irtautuu	Third person Singular
mättää	Third person Singular
elän	First person Singular
konduktöörinä	None
siemenaiheen	None
moitti	Third person Singular
ravistaa	Third person Singular
keikkaillen	First person Singular
oppilasmatrikkeleista	None
huljauttakoon	Third person Singular
tuplasi	Third person Singular
tartu	Second person Singular
punertuvat	Third person Plural
lyhemmin	None
kattaa	Third person Singular
Joonianmereen	None
uhkaillen	First person Singular
toivu	Second person Singular
homogenisoinen	First person Singular
indiumia	None
ehtoolliseen	None
öljyvarantojen	None
paloautoissa	None
keihästää	Third person Singular
sukeltaa	Third person Singular
vaivautuvat	Third person Plural
pohjautuu	Third person Singular
hiilihydraattien	None
sodanvastaisesta	None
noudatin	First person Singular
niittivät	Third person Plural
reunustivat	Third person Plural
huushollasitte	Second person Plural
aikailivat	Third person Plural
heinittäisimme	First person Plural
puuvillakankaan	None
klimatologi	None
raskautitte	Second person Plural
lakkimakakeja	None
rikastuttaa	Third person Singular
juhlallisessa	None
imee	Third person Singular
kauppasin	First person Singular
muistellaan	None
nyi	Second person Singular
ryhdistäytyi	Third person Singular
riemuisaan	None
mainitsevat	Third person Plural
viivyttelin	First person Singular
kommentoisi	Third person Singular
tutkailla	None
mahdollistuu	Third person Singular
kietoutui	Third person Singular
nynnyillen	First person Singular
katkeavat	Third person Plural
laukkonen	First person Singular
epärehellisin	None
pikkuplaneetat	None
kovenee	Third person Singular
kylmenee	Third person Singular
estää	Third person Singular
aikoo	Third person Singular
tulostu	Second person Singular
kurjistui	Third person Singular
juuttuivat	Third person Plural
haltiattarista	None
hohtaa	Third person Singular
lähentyvät	Third person Plural
kemialliset	None
itsehallinnollisista	None
myrtyisin	First person Singular
ylimalkaista	None
yllätti	Third person Singular
ydinkokeisiin	None
toistuvien	None
alkanen	First person Singular
hiljensi	Third person Singular
puhdistuu	Third person Singular
painattaa	Third person Singular
rajoittui	Third person Singular
kansanmurhaa	None
yhtyivät	Third person Plural
livahtaa	Third person Singular
elävät	Third person Plural
uhanalaisuuteen	None
luotaisi	Third person Singular
toistin	First person Singular
havahduttaisitte	Second person Plural
värväytyivät	Third person Plural
jutteli	Third person Singular
talousjohtaja	None
näyttäydy	Second person Singular
kaunistaa	Third person Singular
puolipiste	None
painekyllästät	Second person Singular
kasvamme	First person Plural
täyttyisivät	Third person Plural
huolestuttakoot	Third person Plural
polttamiset	None
piikikkäitä	None
maailmallistukaa	Second person Plural
kiipeillen	First person Singular
palaisi	Third person Singular
yksinkertaistuvat	Third person Plural
bosniakein	None
temaattista	None
estivät	Third person Plural
salviosta	None
elävöittää	Third person Singular
kaihoa	Second person Singular
kaavain	None
adoptoinut	None
illallista	Second person Singular
roiku	Second person Singular
jäätyisi	Third person Singular
puhaltimella	None
kaula-aukolla	None
ammensivat	Third person Plural
virheestä	None
hillitsi	Third person Singular
vahvistaisi	Third person Singular
hankkinette	Second person Plural
hilaan	First person Singular
muslimin	None
kohtaat	Second person Singular
amurinrastaina	None
pidin	First person Singular
perusteli	Third person Singular
syytät	Second person Singular
ulostavat	Third person Plural
jaostoa	None
asumattomien	None
hiertävät	Third person Plural
sudenkorentoja	None
söisi	Third person Singular
hautautuvat	Third person Plural
vaurioittavat	Third person Plural
näyttivät	Third person Plural
hämärryttäisit	Second person Singular
lontoolaisella	None
todentavat	Third person Plural
majailivat	Third person Plural
räppäsi	Third person Singular
päädyn	First person Singular
petä	Second person Singular
puki	Third person Singular
urassa	None
vanhanaikaisia	None
halveksuu	Third person Singular
käsitettä	None
aloittelevat	Third person Plural
haikaili	Third person Singular
edesauttaisimme	First person Plural
allergista	Second person Singular
mahtuivat	Third person Plural
velvoittivat	Third person Plural
yhdysvaltalaiseksi	None
visko	Second person Singular
surkastuu	Third person Singular
seosta	Second person Singular
esteettä	None
listautuisimme	First person Plural
alustaa	Third person Singular
roikotat	Second person Singular
varpaaseen	None
valvo	Second person Singular
reserviläiset	None
jäljittivät	Third person Plural
kuohu	Second person Singular
huuteli	Third person Singular
palkkasi	Third person Singular
häiriöön	None
selittää	Third person Singular
riennä	Second person Singular
ropisivat	Third person Plural
liaaneiksi	None
klusiili	None
ordinaatalla	None
harmistuu	Third person Singular
pelastusveneessä	None
vastaavalle	None
liipaisin	First person Singular
alistui	Third person Singular
fyllaat	Second person Singular
pintavedessä	None
haluaa	Third person Singular
harjaan	First person Singular
happikatoa	None
kuljettaa	Third person Singular
yhdistelivät	Third person Plural
maantakoon	Third person Singular
siedit	Second person Singular
mafialla	None
muunnelmana	None
totonnevat	Third person Plural
irstailisitte	Second person Plural
majailevat	Third person Plural
kosii	Third person Singular
työväenyhdistyksestä	None
saippuoita	Second person Singular
listaavat	Third person Plural
selkkauksissa	None
juoksuttaa	Third person Singular
rakastelevat	Third person Plural
ripustautunee	Third person Singular
varttui	Third person Singular
varoitteli	Third person Singular
lompakoissa	None
sileitä	None
etsiytyvät	Third person Plural
alentavat	Third person Plural
koputti	Third person Singular
sipisen	First person Singular
liikatkaamme	First person Plural
jäähdytti	Third person Singular
keskushyökkääjän	None
aivastuttakoot	Third person Plural
puolittaa	Third person Singular
hyväile	Second person Singular
juontaisi	Third person Singular
pikeä	Second person Singular
kutoo	Third person Singular
pakkaan	First person Singular
graniittiset	None
kuolettanen	First person Singular
kilvoitteli	Third person Singular
irtosi	Third person Singular
perustelen	First person Singular
sovittaa	Third person Singular
mahdollistut	Second person Singular
kansoittanemme	First person Plural
kirjokortteilta	None
muistan	First person Singular
kalakantaan	None
pakene	Second person Singular
kohdistavat	Third person Plural
törmäyttää	Third person Singular
väärentänevät	Third person Plural
patistelisimme	First person Plural
uusiutuu	Third person Singular
kaivautti	Third person Singular
kastelimme	First person Plural
jättäytyi	Third person Singular
puolustaisi	Third person Singular
laajentui	Third person Singular
kuiduista	None
kuohui	Third person Singular
astu	Second person Singular
muokkaisin	First person Singular
tuultanette	Second person Plural
verkkopalvelusta	None
etelänavasta	None
monikulttuurisuuden	None
pilkkaavat	Third person Plural
ostaisi	Third person Singular
empii	Third person Singular
parveksi	None
vilkastuin	First person Singular
näyttäytyivät	Third person Plural
kytkeytyvät	Third person Plural
yksinkertaisten	None
noiduin	First person Singular
valloitussotien	None
uiskoin	None
uhkauksen	None
jäähtyvät	Third person Plural
tuholaisten	None
astuivat	Third person Plural
itkee	Third person Singular
päivänkukkina	None
viisikko	None
myötäili	Third person Singular
seurustelusta	None
hämmästyttävät	Third person Plural
miellyttäisi	Third person Singular
innoittivat	Third person Plural
opiskellen	First person Singular
hyödyttäisi	Third person Singular
ahnailta	None
junnaisivat	Third person Plural
pahoinpiteli	Third person Singular
vapaudu	Second person Singular
huomaavat	Third person Plural
ohjaukseen	None
tanskandogit	None
sulkisi	Third person Singular
suoda	Second person Singular
liitän	First person Singular
juolahti	Third person Singular
tervaannut	Second person Singular
helmimyllyjä	None
nopeuttanemme	First person Plural
huomioiva	None
törmään	First person Singular
lempein	None
radikalisoituivat	Third person Plural
ruotsinsi	Third person Singular
katat	Second person Singular
aseistaa	Third person Singular
käsittää	Third person Singular
tavallisuudesta	None
harvinaistunut	None
basaarit	None
salakuljettaja	None
henkseleiksi	None
erittävät	Third person Plural
tulostin	First person Singular
viilsi	Third person Singular
väitti	Third person Singular
äpöstänette	Second person Plural
säätelivät	Third person Plural
kansainvälistyi	Third person Singular
matkustajavaunuille	None
sure	Second person Singular
kärjistyivät	Third person Plural
kangistaa	Third person Singular
comebackeja	None
puolanna	Second person Singular
rengasti	Third person Singular
ambulanssiksi	None
mopoja	None
jelppaan	First person Singular
ratkaisevat	Third person Plural
venäläistyivät	Third person Plural
valvoi	Third person Singular
istuksinemme	First person Plural
rukoilee	Third person Singular
maustekrasseitta	None
isokuovi	None
ylläpidän	First person Singular
höyryää	Third person Singular
vajoaa	Third person Singular
käytimme	First person Plural
makuun	None
haukkuvat	Third person Plural
geenimutaation	None
sotkitte	Second person Plural
pimitti	Third person Singular
aavikkokultakontiainen	None
tiirikoikoot	Third person Plural
pelottelevat	Third person Plural
koveriin	None
luettelevat	Third person Plural
lennättävät	Third person Plural
istahti	Third person Singular
huljuttaisitte	Second person Plural
juttelevat	Third person Plural
matemaattista	Second person Singular
ahvenkalaa	None
tarkistivat	Third person Plural
kaliumista	None
luonnontieteeseen	None
rivimiehenä	None
innovaation	None
paljastuivat	Third person Plural
maistu	Second person Singular
vähenisivät	Third person Plural
ehdollistuisivat	Third person Plural
ruiskuttavat	Third person Plural
tasapuolisen	None
vilkuilen	First person Singular
luonnosteli	Third person Singular
myllynkiveä	None
turskukoot	Third person Plural
kiinnostanevat	Third person Plural
vahingolliseksi	None
alensivat	Third person Plural
tanssii	Third person Singular
säilyvät	Third person Plural
maanjäristysten	None
absorboituvat	Third person Plural
räystään	None
jymäytellet	Second person Singular
aiheutuivat	Third person Plural
ojentuvat	Third person Plural
tarkenna	Second person Singular
raivostuttaa	Third person Singular
hukuttaa	Third person Singular
keskeytyy	Third person Singular
sairasta	Second person Singular
juuttui	Third person Singular
kamiinoista	None
kotikentälle	None
välttyisi	Third person Singular
ryhdyn	First person Singular
allastakaamme	First person Plural
sieraimet	None
onnitteli	Third person Singular
äänitti	Third person Singular
signaalinkäsittelyn	None
muotoutui	Third person Singular
törmäsi	Third person Singular
ehdyttänette	Second person Plural
katalogia	None
häipyi	Third person Singular
valmistautuvat	Third person Plural
konkarit	None
pyörsi	Third person Singular
vahvistan	First person Singular
sinimailasen	None
tunnistaisi	Third person Singular
ohjelmistoja	None
kaarevassa	None
kuulostaisi	Third person Singular
protektoraatin	None
teloitti	Third person Singular
rahoittaa	Third person Singular
kaavamaista	Second person Singular
teokratian	None
kiihottaa	Third person Singular
vääntävät	Third person Plural
vetäydyn	First person Singular
mittelemme	First person Plural
tarkemmasta	None
pakottivat	Third person Plural
murtavat	Third person Plural
sumenee	Third person Singular
kasvoi	Third person Singular
järkytti	Third person Singular
hioi	Third person Singular
kalkutan	First person Singular
hakivat	Third person Plural
koristelevat	Third person Plural
varoita	Second person Singular
limaan	First person Singular
neutralisoinevat	Third person Plural
yleistajuista	Second person Singular
välittävät	Third person Plural
tietosisällön	None
voiteli	Third person Singular
painuu	Third person Singular
poistaisivat	Third person Plural
saksankielisiin	None
täytyimme	First person Plural
joudutti	Third person Singular
ilmestyisivät	Third person Plural
opeta	Second person Singular
tunnistaisivat	Third person Plural
vitsaili	Third person Singular
joukkuetakaa-ajolta	None
jaat	Second person Singular
sisustusta	None
edellyttäkää	Second person Plural
lumennut	None
etsisivät	Third person Plural
uskaltautuvat	Third person Plural
souda	Second person Singular
päivystää	Third person Singular
tuottavat	Third person Plural
täytät	Second person Singular
untuvilla	None
valkenee	Third person Singular
noukkii	Third person Singular
sotaratsutta	None
läiskähtivät	Third person Plural
jättäytyivät	Third person Plural
lukulaitteen	None
karhentaisivat	Third person Plural
kaksinkertaisti	Third person Singular
tarjoutukaamme	First person Plural
viisasta	Second person Singular
opastetut	None
varjostaa	Third person Singular
jäädyttävät	Third person Plural
änkytyksen	None
bluesia	None
proteomiikalta	None
liikuteltavan	None
hoitaisi	Third person Singular
ulvovat	Third person Plural
datša	None
telakoituu	Third person Singular
suuntaavat	Third person Plural
livon	First person Singular
nykytaiteesta	None
järvisyyhyksi	None
iloitse	Second person Singular
kisaan	First person Singular
toteutin	First person Singular
sävyttää	Third person Singular
häikäistyisitte	Second person Plural
hautasivat	Third person Plural
käännät	Second person Singular
esittävät	Third person Plural
nyrkkeilyottelussa	None
guineanruostegueretsalla	None
maistui	Third person Singular
perustelivat	Third person Plural
ylittäisi	Third person Singular
taukosi	Third person Singular
muistuttaisin	First person Singular
korvautui	Third person Singular
jakautuvat	Third person Plural
tiedustellen	First person Singular
lypsivät	Third person Plural
palailee	Third person Singular
laidunsivat	Third person Plural
kuvaudu	Second person Singular
talvisiin	None
kovenevat	Third person Plural
kadottivat	Third person Plural
myöntää	Third person Singular
välttyy	Third person Singular
mestariteoksista	None
saksannee	Third person Singular
maaliviivalle	None
ratko	Second person Singular
vaellamme	First person Plural
harhailevat	Third person Plural
varustivat	Third person Plural
kaljuuntuvat	Third person Plural
koituisi	Third person Singular
autoilijoita	None
hakevat	Third person Plural
tuule	Second person Singular
kiipeilette	Second person Plural
vertaisi	Third person Singular
toteuta	Second person Singular
tarvitsisivat	Third person Plural
tykkäsivät	Third person Plural
laajene	Second person Singular
taidegallerioissa	None
aavikoittaisitte	Second person Plural
mitättömimmässä	None
mittaisi	Third person Singular
virtaisi	Third person Singular
vähenisi	Third person Singular
kartun	First person Singular
läpäisivät	Third person Plural
hämmentyy	Third person Singular
korvautuivat	Third person Plural
kartoittavat	Third person Plural
alamaisista	None
vastakkainasettelut	None
pehmeämpää	None
hikoilee	Third person Singular
etujärjestönä	None
tulittavat	Third person Plural
riistalle	None
valottanet	Second person Singular
ikäisiksi	None
koettakaa	Second person Plural
teippi	None
karkotti	Third person Singular
heikommat	None
huomautin	First person Singular
tuhoutuvat	Third person Plural
kaatuivat	Third person Plural
punakoiso	None
muurasivat	Third person Plural
kiristivät	Third person Plural
vaarallisuus	None
parsekin	None
salakuuntelu	None
kideveden	None
kierrätyskeskukselta	None
löisi	Third person Singular
hallintokuntien	None
fakta	None
jahkaiskoot	Third person Plural
rikoitte	Second person Plural
lievitti	Third person Singular
nurmetut	Second person Singular
laillisti	Third person Singular
liedestä	None
katkeilisivat	Third person Plural
inkarnaatioita	None
riittäisi	Third person Singular
romahtavat	Third person Plural
alusta	Second person Singular
häämöttää	Third person Singular
raahasi	Third person Singular
seistä	None
vaurastuu	Third person Singular
saarsi	Third person Singular
etureunan	None
älyllistää	Third person Singular
tylyä	None
tehtaisiin	None
mielipidekirjoituksiin	None
silmälasikarhu	None
taisteluista	None
työskentelee	Third person Singular
ylensyön	First person Singular
kokonaistaideteos	None
painajaisiin	None
käärmeitä	None
olettavat	Third person Plural
edistyy	Third person Singular
oioit	Second person Singular
maailmancupeilla	None
örkkien	None
höynäyttäkää	Second person Plural
kuristin	First person Singular
hienonnat	Second person Singular
painatti	Third person Singular
siteerasin	First person Singular
ääntyvät	Third person Plural
pienensi	Third person Singular
höyrystät	Second person Singular
ähkyisi	Third person Singular
työntyy	Third person Singular
etikkaeetteriin	None
punnitsi	Third person Singular
suorittaisivat	Third person Plural
sellutehdas	None
ajoitukseksi	None
aktiviteettiin	None
unohtuu	Third person Singular
ostan	First person Singular
melotte	Second person Plural
koeajaa	Third person Singular
liikemäärä	None
vakaan	First person Singular
fantastinen	None
pyyhinnöillä	None
liittyisi	Third person Singular
lahjakas	None
pettivät	Third person Plural
saostuisitte	Second person Plural
paakarin	None
keskikokoisten	None
karkottivat	Third person Plural
keskeisvoimasta	None
voittamattomaksi	None
yllätä	Second person Singular
pakottakoot	Third person Plural
levittäjien	None
alentui	Third person Singular
julkaisemiseen	None
atrium	None
kahleita	None
mätä	Second person Singular
esittelisi	Third person Singular
haastattelee	Third person Singular
koettaa	Third person Singular
ukulelea	None
rinnakkaisessa	None
kirjoittelevat	Third person Plural
tutkimuskeskus	None
painottuivat	Third person Plural
kolmilehtisittä	None
katsomosta	None
siteerasi	Third person Singular
altolle	None
vapautuivat	Third person Plural
työhaastatteluun	None
miinoittivat	Third person Plural
juhlistavat	Third person Plural
toistu	Second person Singular
möivät	Third person Plural
ablaatioon	None
soluttautuvat	Third person Plural
baletteja	None
suureen	None
jyrkkeni	Third person Singular
löytäisin	First person Singular
syveni	Third person Singular
tainnutimme	First person Plural
eläinlääkärinä	None
allekirjoittavat	Third person Plural
atomimallia	None
valmistunee	Third person Singular
valmistellen	First person Singular
aikoivat	Third person Plural
uimapolyypeiksi	None
immenkalvo	None
hyytyivät	Third person Plural
kuljettu	None
äänesti	Third person Singular
deittailtava	None
asetuit	Second person Singular
käyttäköön	Third person Singular
suoneniskentä	None
yllyttää	Third person Singular
vedetöntä	None
liikunnasta	None
jonottaa	Third person Singular
hakulaitteelta	None
kärjistyvät	Third person Plural
joutuu	Third person Singular
elin	First person Singular
romahtivat	Third person Plural
loisti	Third person Singular
maista	Second person Singular
vakoilut	None
kunnosti	Third person Singular
asteikkojen	None
puolustusvoimalla	None
vapahtaisivat	Third person Plural
kaavattakoon	None
paljastivat	Third person Plural
ilmaan	First person Singular
lepäisit	Second person Singular
siivekästä	None
pimentää	Third person Singular
nukahtivat	Third person Plural
uita	Second person Singular
aristukaamme	First person Plural
kaiva	Second person Singular
näytellen	First person Singular
pakeni	Third person Singular
virologi	None
meinaan	First person Singular
ehdota	Second person Singular
avoimuutta	None
määritti	Third person Singular
lipideistä	None
hämmästyttivät	Third person Plural
julkisti	Third person Singular
oikeuttivat	Third person Plural
sulkeutuu	Third person Singular
pelastivat	Third person Plural
pullottaa	Third person Singular
lukittuvat	Third person Plural
katajia	None
tervataan	None
sadoista	None
säestivät	Third person Plural
steinerkoulu	None
pihistivät	Third person Plural
kantamasta	None
surrealististen	None
kaseteille	None
taittoi	Third person Singular
bensiiniä	None
ilmatilassa	None
pakenija	None
periytyvät	Third person Plural
muistuttaisivat	Third person Plural
korjauttaa	Third person Singular
kaivaisi	Third person Singular
lauantaisista	None
tekeytyy	Third person Singular
heikkenivät	Third person Plural
venähtää	Third person Singular
löysi	Third person Singular
pythagoralaisuudesta	None
aikasarjoille	None
sonaatti	None
turhautui	Third person Singular
lujentuu	Third person Singular
oopperaserenaditta	None
nyrkkeilykintaassa	None
roolina	None
onnistun	First person Singular
helppotajuista	Second person Singular
aion	First person Singular
kierrätti	Third person Singular
paljasti	Third person Singular
tarkasteli	Third person Singular
hydrokodoni	None
viettivät	Third person Plural
kiinnostuvat	Third person Plural
tihkutit	Second person Singular
kirjasin	First person Singular
hoksasin	First person Singular
isäntämaiden	None
miljonäärin	None
ikäeroin	None
ilmenisi	Third person Singular
pönkittää	Third person Singular
päädymme	First person Plural
kuohuttanut	None
laivaan	First person Singular
kirpoa	Second person Singular
vastustatte	Second person Plural
suomalaista	Second person Singular
siirryt	Second person Singular
nuukahdatte	Second person Plural
lataan	First person Singular
kuvittanemme	First person Plural
liikehti	Third person Singular
tienaavat	Third person Plural
poistu	Second person Singular
supistuvat	Third person Plural
hiirihaukka	None
lisäosasta	None
tarkoittavat	Third person Plural
panttasi	Third person Singular
ilmaisella	None
metsätyyppeihin	None
kaipaisin	First person Singular
tilasin	First person Singular
kuvata	None
pelastettu	None
kapina	None
harrastumme	First person Plural
oppikouluja	None
kiinnittäisi	Third person Singular
tyhjeni	Third person Singular
valita	Second person Singular
muuntuvat	Third person Plural
pohjaavat	Third person Plural
monimutkaistuu	Third person Singular
suurentaa	Third person Singular
irrottautuu	Third person Singular
auttaisivat	Third person Plural
bussilastia	None
vyöryvät	Third person Plural
nuohonnee	Third person Singular
merkiltä	None
pursuit	Second person Singular
lyhentyi	Third person Singular
tarvitsemme	First person Plural
uskaltaisin	First person Singular
keräillen	First person Singular
syklistä	None
tukeutunut	None
ilmaisku	None
turvota	Second person Singular
heilauttaa	Third person Singular
kuutioisivat	Third person Plural
mainitsi	Third person Singular
tarjoaisivat	Third person Plural
representaatiot	None
vakuuttelivat	Third person Plural
kastunut	None
kirjoitutti	Third person Singular
toteutuu	Third person Singular
kapsaisiineihin	None
nopeutti	Third person Singular
fosfaattia	None
sointuna	None
naureskeli	Third person Singular
briljeerasi	Third person Singular
pukeutuvat	Third person Plural
hengittää	Third person Singular
uudentunee	Third person Singular
tikahtuisin	First person Singular
asuttajien	None
esimiehille	None
äänsi	Third person Singular
lykännet	Second person Singular
loukkaisi	Third person Singular
äänsivät	Third person Plural
ylittivät	Third person Plural
näytönohjaimilla	None
kummastuisit	Second person Singular
painautuvat	Third person Plural
piirsin	First person Singular
astuu	Third person Singular
kytkeytyy	Third person Singular
pelaajalta	None
oppaan	None
taistellen	First person Singular
riehuivat	Third person Plural
vetotkaa	Second person Plural
punaisuus	None
eristäytyi	Third person Singular
madonnalla	None
näyttäytyi	Third person Singular
odottakoon	Third person Singular
vaihdan	First person Singular
vapautti	Third person Singular
vakautti	Third person Singular
paisui	Third person Singular
ilmoitit	Second person Singular
pohjavillaa	None
ryömii	Third person Singular
ensisijaista	Second person Singular
taidat	Second person Singular
nurminahikkaille	None
tieteelliseltä	None
kuvaileva	None
kirahvien	None
pilailevat	Third person Plural
kaksiulotteisena	None
galakseista	None
tarkennutte	Second person Plural
puhkeaisi	Third person Singular
myivät	Third person Plural
juurinen	First person Singular
paukutan	First person Singular
sinisenä	None
pulkkaillen	First person Singular
paleoseenikaudelta	None
hyväkäs	None
poikkeavat	Third person Plural
lankannen	First person Singular
aikaillevat	Third person Plural
pinnallistuisin	First person Singular
suuntautuisi	Third person Singular
kaon	First person Singular
murustanee	Third person Singular
silmäsi	Third person Singular
katkeilee	Third person Singular
kiusoittelevat	Third person Plural
kunnallispolitiikkaa	None
maanviljelyksiä	None
ruuhkista	None
aaltoa	Second person Singular
karttuu	Third person Singular
juontiin	None
tiedosta	Second person Singular
puolsi	Third person Singular
punnitse	Second person Singular
moninkertaistuivat	Third person Plural
intoan	First person Singular
työllistävät	Third person Plural
kuohun	First person Singular
nimeäisi	Third person Singular
kohtisuorissa	None
sijaitsisivat	Third person Plural
muistelet	Second person Singular
integumentti	None
rohkeni	Third person Singular
toimita	Second person Singular
hankinnassa	None
pärjäisi	Third person Singular
siedä	Second person Singular
mainitsit	Second person Singular
nyökkinet	Second person Singular
kiipeilevät	Third person Plural
astun	First person Singular
kokoustavat	Third person Plural
erehdyttänette	Second person Plural
lukkiudut	Second person Singular
homoseksuaalinen	None
maksakirroosin	None
nimittävät	Third person Plural
planetaarisista	None
kiinnittyivät	Third person Plural
dementoinemme	First person Plural
romuttaa	Third person Singular
vakiintuivat	Third person Plural
symbolisoisivat	Third person Plural
kirjoitti	Third person Singular
muistojuhlassa	None
juutalaisiin	None
tulisia	None
tykein	None
vaikeutuisi	Third person Singular
ulkoasujen	None
kiusaantunemme	First person Plural
siintävät	Third person Plural
hommasi	Third person Singular
seisomme	First person Plural
nissen	None
upottivat	Third person Plural
innostaa	Third person Singular
juonitelkaa	Second person Plural
saattueessa	None
asuinalueeksi	None
kinunnen	First person Singular
törmäsivät	Third person Plural
märkäpuvun	None
sivalsi	Third person Singular
kehräsluuna	None
tarkkailevat	Third person Plural
painiskeli	Third person Singular
vääristyvät	Third person Plural
syyhy	Second person Singular
purin	First person Singular
määräämme	First person Plural
sulkeutuvat	Third person Plural
haluttaisi	Third person Singular
nipsauttavat	Third person Plural
sitoutuivat	Third person Plural
tokaisee	Third person Singular
valehteli	Third person Singular
rauhoittuisi	Third person Singular
leimahtivat	Third person Plural
lottoa	Second person Singular
demokraattista	Second person Singular
mädättäisi	Third person Singular
kiemurtelevat	Third person Plural
kestävät	Third person Plural
ylity	Second person Singular
laiduntaa	Third person Singular
abrakialla	None
rakenteista	Second person Singular
juonittelun	None
leningin	None
kavalan	None
joudun	First person Singular
moninkertaistaa	Third person Singular
muistaisin	First person Singular
hymyä	Second person Singular
lapsettoman	None
selityksen	None
yksilölliseen	None
kiepauttanemme	First person Plural
hermostomyrkkyihin	None
viittaan	First person Singular
nuppuja	None
suodattaa	Third person Singular
kierrätä	Second person Singular
havahtui	Third person Singular
räjähdä	Second person Singular
kuohat	None
mahdollistavat	Third person Plural
bussimatkatta	None
aiheuttaisivat	Third person Plural
laulavat	Third person Plural
eksyttää	Third person Singular
kantautui	Third person Singular
arvostaisi	Third person Singular
diivoja	None
mullistavat	Third person Plural
laserista	None
purskahti	Third person Singular
kumartavat	Third person Plural
lahjoitin	First person Singular
finaaleita	None
jyräsivät	Third person Plural
pyörryttäkööt	Third person Plural
telkesi	Third person Singular
nivoutuu	Third person Singular
hurmaudutte	Second person Plural
kypsyi	Third person Singular
sammu	Second person Singular
interpoloinnin	None
seilasivat	Third person Plural
talutti	Third person Singular
murhaavat	Third person Plural
järjestelivät	Third person Plural
kauppaan	First person Singular
jalansijoja	None
siirrettäköön	None
ratkeaa	Third person Singular
komentaisin	First person Singular
lannoittunevat	Third person Plural
äityy	Third person Singular
hytkähtäisimme	First person Plural
lahdelman	None
siirtää	Third person Singular
tasoitti	Third person Singular
käänsin	First person Singular
kommunistisista	None
havaitsee	Third person Singular
tappoon	None
erittelee	Third person Singular
koulaisin	First person Singular
jupinoilla	None
vuotavista	None
ompeli	Third person Singular
kunnostautuu	Third person Singular
paistoajoiksi	None
kehittyisivät	Third person Plural
neuroleptejä	None
suomensivat	Third person Plural
peräänkuulutan	First person Singular
epäilytätte	Second person Plural
koetti	Third person Singular
haluaisin	First person Singular
säärten	None
suojaiset	None
suurikokoiset	None
etsii	Third person Singular
spesiaalistuin	First person Singular
mureutukaa	Second person Plural
ydinpolttoainekierto	None
tietosanakirjat	None
pyöritä	Second person Singular
solmii	Third person Singular
nyrkistä	Second person Singular
aiheuttaisi	Third person Singular
kummenen	First person Singular
noudattivat	Third person Plural
talleta	Second person Singular
keskustelivat	Third person Plural
korjaamattomia	None
arkuus	None
morkkiksille	None
hyväksyitte	Second person Plural
ruostuu	Third person Singular
kurista	Second person Singular
haarniskoihin	None
noustaan	None
kuutiojuurena	None
tuuli	Third person Singular
oppikaa	Second person Plural
umpeutui	Third person Singular
sitkene	Second person Singular
ilolintua	None
tavoitellen	First person Singular
poikkeaisi	Third person Singular
ravistelee	Third person Singular
pelottelivat	Third person Plural
leipäpuiden	None
lähtee	Third person Singular
ryhdistäytynen	First person Singular
puolsivat	Third person Plural
viilennemme	First person Plural
valikoituivat	Third person Plural
näyttelisit	Second person Singular
kasvatustieteen	None
myöntävät	Third person Plural
täpläravun	None
porrastanemme	First person Plural
sanoisit	Second person Singular
tyhjenevät	Third person Plural
valkeni	Third person Singular
sanoutuisin	First person Singular
metsäisiä	None
vesialtaaseen	None
barokkityylin	None
vapauttivat	Third person Plural
soopelin	None
varoitin	First person Singular
käärii	Third person Singular
henkilöstöhallinnon	None
julkaisemiseksi	None
epäonnistuneiden	None
aineistukoot	Third person Plural
noudattelivat	Third person Plural
lentoaikaa	None
soveltuu	Third person Singular
ilmastoon	None
rehottaa	Third person Singular
oudoksuttaa	Third person Singular
luhistuisi	Third person Singular
lisään	First person Singular
listasin	First person Singular
kalvakaa	Second person Plural
höyrystyi	Third person Singular
jatkan	First person Singular
suuntaudu	Second person Singular
jylhenet	Second person Singular
pommittivat	Third person Plural
voittavat	Third person Plural
koneista	Second person Singular
mulkaisisin	First person Singular
riensi	Third person Singular
murentaa	Third person Singular
tulkitse	Second person Singular
turmellun	First person Singular
lykkääntyy	Third person Singular
hapanimelä	None
kesyyntyvät	Third person Plural
unihäiriöt	None
liittoutuivat	Third person Plural
arvaan	First person Singular
suuttuu	Third person Singular
lainailisimme	First person Plural
kaivata	Second person Singular
jysky	Second person Singular
vilahtaa	Third person Singular
tiedostolla	None
labradorista	None
frankiumin	None
luistat	Second person Singular
luottamustoimien	None
jatkakaa	Second person Plural
sotalapselta	None
rantautuu	Third person Singular
lorota	Second person Singular
julkaisemme	First person Plural
rikkoo	Third person Singular
lukinkalvonalaistilat	None
rakennuttakaamme	First person Plural
poljen	First person Singular
harvinaistuivat	Third person Plural
hätäännyimme	First person Plural
kehotin	First person Singular
asentajia	None
korvautuvat	Third person Plural
arvottaa	Third person Singular
pilkkoivat	Third person Plural
jättiläisten	None
erottuisi	Third person Singular
kidevirheitä	None
toit	Second person Singular
lankeaa	Third person Singular
alennettiin	None
sisäiseltä	None
seuraan	First person Singular
vainoavat	Third person Plural
pysykää	Second person Plural
rauhoitettuja	None
tarkastele	Second person Singular
lupautui	Third person Singular
suuttuvat	Third person Plural
urheuksilla	None
suomenpeuran	None
avautuvat	Third person Plural
muodostavat	Third person Plural
sakottaa	Third person Singular
paakkuuntunemme	First person Plural
koettelevat	Third person Plural
kuivu	Second person Singular
hinaat	Second person Singular
vaihdat	Second person Singular
ruiskuttaa	Third person Singular
faktori	None
punapäille	None
ruuhkautui	Third person Singular
kloraalihydraattien	None
sisusta	Second person Singular
näyttelivät	Third person Plural
jaksottaa	Third person Singular
kännäsin	First person Singular
menestyisivät	Third person Plural
riittäisivät	Third person Plural
karsta	None
käynnistytte	Second person Plural
lyhyimmille	None
vaarantuisi	Third person Singular
pomoksi	None
epäsosiaalisilta	None
ketjuuduin	First person Singular
kultit	None
kumoaisi	Third person Singular
sulautuivat	Third person Plural
aikaista	Second person Singular
protektionismin	None
painottuu	Third person Singular
vapauttaisi	Third person Singular
väestöpyramidi	None
juontunee	Third person Singular
varoittivat	Third person Plural
seivästitte	Second person Plural
puukotit	Second person Singular
kiistävät	Third person Plural
yöpyi	Third person Singular
paikantaa	Third person Singular
kaivan	First person Singular
hyllytti	Third person Singular
hiljentyi	Third person Singular
purkittakoot	Third person Plural
valtaan	First person Singular
kirroosi	None
pakastaa	Third person Singular
yöapinoiksi	None
väijyy	Third person Singular
johtuu	Third person Singular
tuskaisuus	None
rakastui	Third person Singular
välimerentaateli	None
nuuskisin	First person Singular
immuunivastetta	None
päättelee	Third person Singular
jatkuivat	Third person Plural
veistää	Third person Singular
liiallisten	None
normaalisti	Third person Singular
elpyy	Third person Singular
aggressiivisemman	None
vuoda	Second person Singular
vaahdotamme	First person Plural
järjestelmästä	None
tyydy	Second person Singular
vaikutin	First person Singular
sihisee	Third person Singular
tarrautuvat	Third person Plural
innostavat	Third person Plural
laskevat	Third person Plural
järkyttynee	Third person Singular
vanukaamme	First person Plural
hukutti	Third person Singular
sammuu	Third person Singular
monimuotoistuvat	Third person Plural
poikkeusten	None
sulautui	Third person Singular
kiusauksilla	None
ahdistavat	Third person Plural
tyhjensin	First person Singular
yllättäisi	Third person Singular
saastuttaa	Third person Singular
kärjisti	Third person Singular
katkaise	Second person Singular
riippuisi	Third person Singular
ylläpitävät	Third person Plural
populaareilta	None
viistetty	None
kuoppaan	First person Singular
osu	Second person Singular
polveutui	Third person Singular
kumota	Second person Singular
säilyttäjänä	None
saata	Second person Singular
epäilyä	None
osastoisin	First person Singular
mainosta	Second person Singular
viivy	Second person Singular
kapenivat	Third person Plural
ylittyisi	Third person Singular
pinnistä	Second person Singular
hidastuivat	Third person Plural
pyyhkäiset	Second person Singular
tuhoutuivat	Third person Plural
köhiset	Second person Singular
tervehtikää	Second person Plural
siirapista	None
ylitarkastajaksi	None
ruttaannut	Second person Singular
syrjäyttävät	Third person Plural
suovat	Third person Plural
syötettiin	None
painosti	Third person Singular
hihittäköön	Third person Singular
reikäkorteista	None
lainautui	Third person Singular
rytky	Second person Singular
muuntanette	Second person Plural
nykyaikaista	Second person Singular
tulostuvat	Third person Plural
osakehinnoille	None
irrottautui	Third person Singular
kelasta	Second person Singular
vanhainkodeissa	None
kuivaan	First person Singular
irrottautunut	None
dogmatiikassa	None
kohoaisi	Third person Singular
rakennuttivat	Third person Plural
komista	Second person Singular
humanistisessa	None
turhaudu	Second person Singular
urissa	None
kiipeilevä	None
proteeseja	None
parannuit	Second person Singular
lähdettänemme	First person Plural
kohottaa	Third person Singular
kaniinit	None
karmaissevat	Third person Plural
äärioikeistolaiseksi	None
rumbannee	Third person Singular
ylittyy	Third person Singular
pokaalit	None
skanneri	None
laske	Second person Singular
kylmentää	Third person Singular
kiihdytyksen	None
vaimenet	Second person Singular
pikkujutuista	None
oliivinvihreät	None
valkovenäläisiä	None
edesauta	Second person Singular
pehmentää	Third person Singular
lanseerasi	Third person Singular
tasoittavat	Third person Plural
jäätyy	Third person Singular
nappasi	Third person Singular
lähettiläistä	None
vaahtoaisimme	First person Plural
laukeaa	Third person Singular
huuhtelee	Third person Singular
zambo	None
jänistätte	Second person Plural
onnekas	None
katkesivat	Third person Plural
sinkoutuu	Third person Singular
syytää	Third person Singular
keskustelen	First person Singular
kellastuu	Third person Singular
genetiikka	None
katkaisee	Third person Singular
rohkaisee	Third person Singular
suuntasivat	Third person Plural
toistui	Third person Singular
pysytellen	First person Singular
luettelin	First person Singular
ooppera	None
kaarramme	First person Plural
fontit	None
kirkastunevat	Third person Plural
tinaat	Second person Singular
työnohjaus	None
mädättää	Third person Singular
osoitteeksi	None
vaarantavat	Third person Plural
vääristävät	Third person Plural
lujittaa	Third person Singular
olympiakisoista	None
haaroittuu	Third person Singular
alistaa	Third person Singular
laiduntavat	Third person Plural
ilahdutti	Third person Singular
tunnusteli	Third person Singular
kulutti	Third person Singular
päihittivät	Third person Plural
salvo	Second person Singular
viipyvät	Third person Plural
vieroksuvat	Third person Plural
lämmittää	Third person Singular
kannatteli	Third person Singular
liberalisoituisitte	Second person Plural
sammutin	First person Singular
alamme	First person Plural
osoittautuvat	Third person Plural
saattavat	Third person Plural
vaikutusvaltaisista	None
pahenivat	Third person Plural
ohjastajat	None
sodi	Second person Singular
kenraalin	None
kylvi	Third person Singular
listasivat	Third person Plural
vipannee	Third person Singular
riittänevät	Third person Plural
vääristynevät	Third person Plural
uurasti	Third person Singular
hae	Second person Singular
laulun	None
koki	Third person Singular
muninut	None
taipuisi	Third person Singular
luhtakanaan	None
hiippaisit	Second person Singular
latinantakoon	Third person Singular
syttymistä	None
houkutti	Third person Singular
elektrolyyttia	None
varastoa	None
ponnisti	Third person Singular
sitoivat	Third person Plural
vauhdittivat	Third person Plural
sosialismiin	None
koukkasi	Third person Singular
transplantoikoon	Third person Singular
matematisoinevat	Third person Plural
virkisti	Third person Singular
hälyttää	Third person Singular
virttyisit	Second person Singular
selostaa	Third person Singular
katsoimme	First person Plural
kätkeytyi	Third person Singular
haettu	None
rullasi	Third person Singular
pakasta	Second person Singular
monologia	None
jumaltenpuulla	None
luistelevat	Third person Plural
afrikkalaiseen	None
juotti	Third person Singular
fluorittanette	Second person Plural
varmistavat	Third person Plural
vihertää	Third person Singular
hahmota	Second person Singular
vingahtaisit	Second person Singular
perikunnan	None
kidnappasivat	Third person Plural
hypyssä	None
hyppäsin	First person Singular
väläyttää	Third person Singular
ähkyn	First person Singular
elämäkertaan	None
langennut	None
osallistu	Second person Singular
alppeja	None
kraiveliin	None
joustaa	Third person Singular
katsoisi	Third person Singular
liho	Second person Singular
keskeytin	First person Singular
kovista	Second person Singular
pienat	None
vierittäisit	Second person Singular
eläköityi	Third person Singular
jähmetti	Third person Singular
takaistuimella	None
pistouvaisi	Third person Singular
muistakaamme	First person Plural
monisivuisen	None
painotti	Third person Singular
hipovat	Third person Plural
kopernikaanista	None
sikhiläisyyden	None
idolissa	None
tuomitsevat	Third person Plural
valitat	Second person Singular
kalorimetreistä	None
lohikäärmeelle	None
saavuttaa	Third person Singular
mahdottomuuteen	None
elokuvaan	First person Singular
vastustin	First person Singular
erilaistuvat	Third person Plural
sotaveteraani	None
työstää	Third person Singular
pidättäytyivät	Third person Plural
synnyn	None
tylsistytät	Second person Singular
kokoillette	Second person Plural
sitovat	Third person Plural
sekoittuisi	Third person Singular
ravisteli	Third person Singular
alamaisina	None
levyttäisi	Third person Singular
hypännyt	None
ilmaisilla	None
kulkevat	Third person Plural
päällystänette	Second person Plural
virpoo	Third person Singular
rupea	Second person Singular
emäksisessä	None
kierrejouset	None
ladot	None
näkevät	Third person Plural
nousevat	Third person Plural
korjaan	First person Singular
tajuttomia	None
rakastavat	Third person Plural
myrkytti	Third person Singular
kuivuivat	Third person Plural
tehokkainta	None
jaksoissa	None
liigajoukkue	None
isommat	None
käyttäjinä	None
repeää	Third person Singular
kieltäydy	Second person Singular
kypsentää	Third person Singular
tummuvat	Third person Plural
täyttyi	Third person Singular
viilenee	Third person Singular
uhkailevat	Third person Plural
raiskaan	First person Singular
voimistivat	Third person Plural
seksistinen	None
huollatamme	First person Plural
johdattaa	Third person Singular
ulotu	Second person Singular
riistaeläimiä	None
lojuu	Third person Singular
prutkuttakoon	Third person Singular
luisui	Third person Singular
tuohtui	Third person Singular
porasivat	Third person Plural
värväävät	Third person Plural
pämppäillet	Second person Singular
kävelykatua	None
vakuutteli	Third person Singular
otatti	Third person Singular
samaistui	Third person Singular
masurkka	None
hyönteislajit	None
edeltää	Third person Singular
vipoine	None
pelikaaneja	None
hävittävät	Third person Plural
suosita	Second person Singular
tarkasta	Second person Singular
vähenee	Third person Singular
positiivisiksi	None
ilmoittaudun	First person Singular
hillitsee	Third person Singular
rajoittuvat	Third person Plural
viittasit	Second person Singular
regeneroitukaa	Second person Plural
hypittänee	Third person Singular
aaltoili	Third person Singular
sysäsivät	Third person Plural
siirtyy	Third person Singular
palvovat	Third person Plural
riivasi	Third person Singular
muuttuisi	Third person Singular
katsokaa	Second person Plural
ahtautukaa	Second person Plural
kallonmurtuma	None
riitä	Second person Singular
rakastelee	Third person Singular
kuppi	None
substituoinevat	Third person Plural
taivuttavat	Third person Plural
kansliapäälliköt	None
yhdistymässä	None
ponnistuksista	None
lahjoittavat	Third person Plural
lävistää	Third person Singular
vähentyi	Third person Singular
riehuu	Third person Singular
kumartuu	Third person Singular
kalkinnet	Second person Singular
ufologia	None
teollista	Second person Singular
pahoinpidelty	None
palkkaatte	Second person Plural
kehota	Second person Singular
erikoistui	Third person Singular
hermoromahdus	None
sijoittuisi	Third person Singular
belgialaiset	None
porrasta	Second person Singular
saalistavat	Third person Plural
representaatio	None
vastaanottivat	Third person Plural
teipannee	Third person Singular
