най-истинни	Masculine
пушенето	Neuter
котарак	None
по-разсъдителна	Feminine
любознателният	Masculine
оцветилата	Feminine
по-мишия	Masculine
руната	None
премрелият	Masculine
деленето	Neuter
балканските	None
забождам	None
сеизмично	Neuter
яйцевиден	Masculine
винен	Masculine
обзаведено	Neuter
тигър	None
изнудващият	Masculine
преживява	None
бесило	Neuter
изговаря	None
адекватното	Neuter
лилавия	Masculine
речи	None
грабеното	Neuter
пресният	Masculine
брането	Neuter
по-еластична	Feminine
загубено	Neuter
най-агитационно	Neuter
най-италианско	Neuter
контрамерки	None
по-очното	Neuter
завеждай	None
заповядване	Neuter
търсещият	Masculine
светлосини	Masculine
златната	Feminine
бушуващото	Neuter
арестувайки	None
убиваме	None
преживявате	None
лижещ	Masculine
по-испанска	Feminine
по-хубавото	Neuter
преживяването	Neuter
построената	Feminine
предричаща	Feminine
губеха	None
гълъб	None
обезсмъртяваният	Masculine
комбинирания	Masculine
дивото	Neuter
наплитащият	Masculine
сприятелиш	None
отваряната	Feminine
арменско	Neuter
вярно	Neuter
абразивно	Neuter
строен	Masculine
молела	Feminine
ограничавано	Neuter
безкраен	Masculine
авторската	Feminine
балканският	Masculine
припада	None
повторени	None
въоръжен	Masculine
счупил	Masculine
най-ананасовата	Feminine
антена	None
най-безгрижната	Feminine
безмилостна	Feminine
вземаща	Feminine
бастуна	None
свещеници	None
дълбоко	Neuter
злоупотребила	Feminine
пълните	None
нещастният	Masculine
започващата	Feminine
небесносин	Masculine
плешиво	Neuter
абсолютния	Masculine
най-азбучната	Feminine
пяла	Feminine
правителствен	Masculine
най-неголяма	Feminine
алигатори	None
начело	Neuter
обичащо	Neuter
смазан	Masculine
портокалов	Masculine
аберация	None
схватки	None
алкохолна	Feminine
обезсмъртявалия	Masculine
тъпа	Feminine
забранено	Neuter
обезсмъртилата	Feminine
взводовете	None
най-турската	Feminine
подписаната	Feminine
госпожи	None
глупавия	Masculine
забраняваща	Feminine
леко	Neuter
инвестиращия	Masculine
бедния	Masculine
щателна	Feminine
благородното	Neuter
правела	Feminine
допринася	None
студовете	None
покривите	None
красиви	Masculine
недостатъчни	Masculine
аварино	None
работещ	Masculine
мрялата	Feminine
номер	None
докажел	Masculine
строят	None
коремното	Neuter
вероятния	Masculine
мъдрото	Neuter
по-дълбокият	Masculine
желала	Feminine
по-лилавото	Neuter
зелена	Feminine
спираща	Feminine
глупавата	Feminine
деветото	Neuter
отмрелия	Masculine
дива	Feminine
наведена	Feminine
одобрената	Feminine
побеждаваният	Masculine
смазана	Feminine
черен	Masculine
въвлечахме	None
избрано	Neuter
комерсиалното	Neuter
подслушах	None
разнесени	None
опасваща	Feminine
протичащия	Masculine
възможният	Masculine
виждаше	None
плътно	Neuter
премрелия	Masculine
тяло	None
чуващ	Masculine
отнасян	Masculine
повлякъл	Masculine
навлизащ	Masculine
сънуващия	Masculine
козия	Masculine
предсказване	Neuter
съчетаване	Neuter
тъмносиньото	Neuter
повярвали	None
дяволската	Feminine
саркастичния	Masculine
пишела	Feminine
засечени	None
граничело	Neuter
очакването	Neuter
смазващ	Masculine
излязлото	Neuter
оцеляване	Neuter
протекло	Neuter
лъвица	None
най-надколенни	Masculine
биенето	Neuter
преведените	None
чуващата	Feminine
подчертаният	Masculine
албанската	Feminine
ебане	Neuter
мост	None
по-ядосани	Masculine
изпитащ	Masculine
любов	None
възпирай	None
чуващи	None
предупреждавана	Feminine
извлечало	Neuter
крадена	Feminine
искаща	Feminine
обвинил	Masculine
препрочитане	Neuter
анатемосване	Neuter
протекла	Feminine
съгласния	Masculine
работещата	Feminine
катерица	None
изпълними	Masculine
дъга	None
спреният	Masculine
вакъф	None
очният	Masculine
привнасянето	Neuter
препекло	Neuter
заплашваща	Feminine
сравнявано	Neuter
плашел	Masculine
италианките	None
прелъстена	Feminine
саркастичното	Neuter
лекарска	Feminine
изминаването	Neuter
предплатилата	Feminine
лява	Feminine
хапането	Neuter
пристигащ	Masculine
превъзнесат	None
плакала	Feminine
най-мъдро	Neuter
дометеше	None
криво	Neuter
изслушат	None
отнесохте	None
зареждането	Neuter
счупена	Feminine
най-стар	Masculine
граници	None
болнички	Masculine
използваното	Neuter
простиране	Neuter
по-добър	Masculine
сказуемо	None
вещ	Masculine
сатанинските	None
сладко	Neuter
въоръжения	Masculine
горо	None
озадачаващо	Neuter
спирайки	None
делящи	None
аварийната	Feminine
най-абатската	Feminine
подчертахте	None
ближело	Neuter
немецът	None
свръхестествения	Masculine
бивол	None
парашут	None
въвлича	None
повтарялите	None
ловки	Masculine
глупавото	Neuter
абитуриентко	None
кухните	None
забременяване	Neuter
седмо	Neuter
предсказвали	None
бадемите	None
шестия	Masculine
рача	None
архаични	Masculine
подписала	Feminine
оцветена	Feminine
завлеченият	Masculine
италианското	Neuter
заплитаха	None
строила	Feminine
северозападният	Masculine
яла	Feminine
обучаващите	None
изречена	Feminine
най-босичкото	Neuter
любителския	Masculine
наричаща	Feminine
назовавайки	None
по-подобен	Masculine
кореместа	Feminine
най-мускулният	Masculine
второто	Neuter
по-антипартийно	Neuter
аленият	Masculine
по-опитно	Neuter
използвана	Feminine
счупилият	Masculine
унасящото	Neuter
обучавалият	Masculine
смазвайки	None
срещаната	Feminine
пратените	None
мускулеста	Feminine
изминавайки	None
обича	None
соколи	None
мразиш	None
продължилият	Masculine
най-сребърният	Masculine
щастлива	Feminine
комерсиалният	Masculine
небрежното	Neuter
съобщения	Masculine
нареченият	Masculine
предупреден	Masculine
отечи	None
ходенето	Neuter
съвършено	Neuter
най-осъществимата	Feminine
победил	Masculine
доблестен	Masculine
заплашени	None
сънувано	Neuter
заподозрения	Masculine
запридане	Neuter
облаци	None
сметана	None
азалии	None
заслужилият	Masculine
юбилеите	None
най-серни	Masculine
играещите	None
лектор	None
ален	Masculine
нахапаният	Masculine
убеждаването	Neuter
стари	Masculine
пишеха	None
закупят	None
чашо	None
истинна	Feminine
смажем	None
ангелският	Masculine
анатеми	None
швейцарци	None
източна	Feminine
заплашвах	None
пречупващата	Feminine
дебели	Masculine
аварийни	Masculine
заплел	Masculine
високо	Neuter
преведен	Masculine
решителният	Masculine
рязане	Neuter
лилави	Masculine
нарекъл	Masculine
уставите	None
неща	None
човек	None
закупено	Neuter
платило	Neuter
тънка	Feminine
комбинирането	Neuter
обзавеждано	Neuter
получаван	Masculine
избодяло	Neuter
учил	Masculine
доведена	Feminine
гъвкаво	Neuter
дебелият	Masculine
доенето	Neuter
благодариш	None
благословена	Feminine
обрича	None
най-яко	Neuter
небрежна	Feminine
наказвания	Masculine
понапичам	None
жестокият	Masculine
довличалата	Feminine
отвесния	Masculine
тресеният	Masculine
бясна	Feminine
заплашили	None
изковаване	Neuter
станеш	None
изчетено	Neuter
мазала	Feminine
автомобилът	None
препоръчан	Masculine
започнатата	Feminine
южняшко	Neuter
подклалите	None
победял	Masculine
абониране	None
най-гневното	Neuter
авангардната	Feminine
падащият	Masculine
най-действителната	Feminine
използващият	Masculine
обсъдило	Neuter
еластичния	Masculine
корем	None
най-вещественото	Neuter
голяма	Feminine
допрочитах	None
коряла	Feminine
ябълки	None
диня	None
подвеждащ	Masculine
виждалата	Feminine
близкият	Masculine
отречи	None
окото	None
гаджето	None
зверското	Neuter
загубения	Masculine
най-благоразумна	Feminine
прегръщат	None
спасения	Masculine
привнесяхте	None
лекарството	None
прехапвам	None
ушиването	Neuter
наказала	Feminine
по-бактерийното	Neuter
обречено	Neuter
въоръжената	Feminine
болничка	Feminine
заспалия	Masculine
най-благоразумен	Masculine
първоразредния	Masculine
сигурна	Feminine
надвнасялото	Neuter
най-североизточния	Masculine
бистра	Feminine
телевизорът	None
низшия	Masculine
добрия	Masculine
продаваното	Neuter
писаното	Neuter
мажещото	Neuter
шибаше	None
изпасващата	Feminine
одобреният	Masculine
благото	Neuter
обезглавяващата	Feminine
правена	Feminine
изпитването	Neuter
целувам	None
забранената	Feminine
отварящия	Masculine
наказаният	Masculine
радеело	Neuter
донасяна	Feminine
мазах	None
погледнем	None
неумело	Neuter
лесна	Feminine
кестен	None
забождаща	Feminine
тигъра	None
лятното	Neuter
изминатото	Neuter
ароматът	None
доверчиви	Masculine
обвиненият	Masculine
езика	None
потънала	Feminine
изпила	Feminine
наводнявано	Neuter
изпивайки	None
старо	Neuter
произнасям	None
по-тъпи	Masculine
доплетения	Masculine
инфантилни	Masculine
възпрян	Masculine
чакащ	Masculine
възлизащо	Neuter
сравнено	Neuter
потреси	None
доказаното	Neuter
разумните	None
продължен	Masculine
по-храбрата	Feminine
хоризонтална	Feminine
анатемосваща	Feminine
сигурно	Neuter
пепелници	None
опасял	Masculine
белият	Masculine
убиващ	Masculine
скучната	Feminine
правителствата	None
селата	None
ръбове	None
изнесели	None
словенска	Feminine
обвинена	Feminine
заметен	Masculine
авторитетно	Neuter
хубава	Feminine
взимаме	None
отричащ	Masculine
подобрения	Masculine
най-силното	Neuter
безкрайни	Masculine
ябълковата	Feminine
горелката	None
повтарящ	Masculine
исканата	Feminine
метено	Neuter
амвонът	None
най-ненадеждни	Masculine
отворената	Feminine
подписалия	Masculine
срещане	Neuter
продължих	None
купува	None
преведял	Masculine
шантажиращите	None
ядосани	Masculine
изричане	Neuter
госпожата	None
зачитат	None
сприятелявах	None
амбициозен	Masculine
допринасяща	Feminine
подметат	None
по-възсиньо	Neuter
допринасящо	Neuter
пасяло	Neuter
козята	Feminine
присъствам	None
отворило	Neuter
смазваща	Feminine
жребците	None
ортогонален	Masculine
убедената	Feminine
доле	None
мярката	None
акцентите	None
победено	Neuter
помагащото	Neuter
разбралият	Masculine
съвършеното	Neuter
авторитарният	Masculine
причинил	Masculine
поизмиталото	Neuter
антична	Feminine
храната	None
изпридаща	Feminine
състезателния	Masculine
сладкият	Masculine
подчертано	Neuter
батерийната	Feminine
заречената	Feminine
ползваха	None
учената	Feminine
гласуваната	Feminine
разнасящите	None
бране	Neuter
по-дръзка	Feminine
стомашни	Masculine
източни	Masculine
присъствалия	Masculine
вуйчовците	None
започналото	Neuter
столиците	None
падежа	None
храбрец	None
лизалият	Masculine
убеждаване	Neuter
боядисващо	Neuter
най-валидни	Masculine
естетични	Masculine
докторът	None
дели	None
преживяна	Feminine
изпиване	Neuter
действителният	Masculine
балюстради	None
прел	Masculine
молещият	Masculine
плачещият	Masculine
наследена	Feminine
компетенции	None
некомпетентно	Neuter
заплитан	Masculine
тънкият	Masculine
отнасящо	Neuter
подкупило	Neuter
изслушван	Masculine
далечни	Masculine
хубави	Masculine
тресящия	Masculine
по-важно	Neuter
чернодробни	Masculine
подобната	Feminine
часовника	None
капещ	Masculine
безгрижно	Neuter
капеща	Feminine
царица	None
най-мъртъв	Masculine
зареждаща	Feminine
най-слаби	Masculine
най-лекомисления	Masculine
неопитни	Masculine
агроном	None
озаглавила	Feminine
най-жълто	Neuter
широкия	Masculine
шантажира	None
по-авиационни	Masculine
охраняващ	Masculine
авгиева	Feminine
епицентър	None
събудено	Neuter
орлиците	None
крале	None
закона	None
бедничкия	Masculine
розата	None
анахронизма	None
летен	Masculine
чешкият	Masculine
затъмнение	None
разнесен	Masculine
колежки	None
саркастични	Masculine
пристигнало	Neuter
четяща	Feminine
давана	Feminine
честван	Masculine
произнесли	None
поглеждаш	None
пренасяне	Neuter
лев	None
портокаловия	Masculine
превежданата	Feminine
влизащия	Masculine
тъжните	None
най-яки	Masculine
детинска	Feminine
отрицателният	Masculine
модерното	Neuter
князе	None
допринесяла	Feminine
порта	None
четено	Neuter
кокоша	Feminine
раняващия	Masculine
ароматен	Masculine
югозападният	Masculine
обучавайки	None
хубавия	Masculine
подобен	Masculine
чакалия	Masculine
презряха	None
обковаващата	Feminine
най-глупавото	Neuter
абаносово	Neuter
по-южняшките	None
отвориш	None
алармен	Masculine
заслужаваната	Feminine
присъстват	None
най-унгарските	None
играеш	None
обесила	Feminine
наричащо	Neuter
измрете	None
произлизащият	Masculine
съпрузи	None
пренасяше	None
желязно	Neuter
бесещият	Masculine
антични	Masculine
капела	Feminine
сенки	None
реалистичния	Masculine
презирали	None
съобщаването	Neuter
накълваващия	Masculine
уклончиво	Neuter
небрежната	Feminine
произлизаща	Feminine
допрочелото	Neuter
лекото	Neuter
потъвалата	Feminine
отвлеченият	Masculine
очаквате	None
еластичен	Masculine
най-гръдна	Feminine
слънчевият	Masculine
ял	Masculine
делило	Neuter
уволнен	Masculine
строена	Feminine
превеждан	Masculine
заковава	None
най-чудати	Masculine
станала	Feminine
гръдната	Feminine
допринесял	Masculine
ананасовата	Feminine
допрочиталия	Masculine
автентична	Feminine
измитащо	Neuter
изкупуване	Neuter
зашивам	None
паланка	None
бою	None
портокалите	None
бавен	Masculine
плетенето	Neuter
занесох	None
отнесе	None
дългата	Feminine
създадено	Neuter
пълната	Feminine
соколица	None
усти	None
зачетоха	None
наводняващия	Masculine
авиационни	Masculine
зачитаното	Neuter
изпитаната	Feminine
авиационно	Neuter
унгарският	Masculine
отрицателен	Masculine
пратилата	Feminine
безмилостни	Masculine
по-автономни	Masculine
по-смелия	Masculine
по-порнографичният	Masculine
светлосиня	Feminine
наемано	Neuter
прелъстявалия	Masculine
огънят	None
крокодили	None
извеждани	None
непоколебимата	Feminine
изтърваващият	Masculine
бездейни	Masculine
албанският	Masculine
грозно	Neuter
говорило	Neuter
по-алено	Neuter
винящият	Masculine
затреслата	Feminine
победила	Feminine
бакалаври	None
южния	Masculine
съществуващия	Masculine
старите	None
губел	Masculine
отчитана	Feminine
допираната	Feminine
антиките	None
упрекван	Masculine
обещан	Masculine
презрелият	Masculine
по-креативни	Masculine
вторият	Masculine
навлизане	Neuter
кралският	Masculine
активно	Neuter
лукав	Masculine
заредения	Masculine
учел	Masculine
пасенето	Neuter
поведението	None
по-авансово	Neuter
пасения	Masculine
получено	Neuter
отнесели	None
ръката	None
делфинът	None
тръгвалото	Neuter
кано	None
ляво	Neuter
комерсиални	Masculine
по-възсин	Masculine
опитния	Masculine
живот	None
получаващо	Neuter
потънал	Masculine
навестеният	Masculine
по-авгиеви	Masculine
интересуващия	Masculine
унищожения	Masculine
осиновилото	Neuter
разболявалия	Masculine
бодри	Masculine
пасене	Neuter
отеца	None
изпасвана	Feminine
способният	Masculine
потреслото	Neuter
най-къртичето	Neuter
храстът	None
смелото	Neuter
съвременното	Neuter
абатството	None
писаната	Feminine
анулиране	Neuter
превеждаше	None
бегълката	None
отнасяния	Masculine
омразата	None
тънкия	Masculine
полувисше	Neuter
балканската	Feminine
охраняваните	None
заслужил	Masculine
губене	Neuter
белогвардейката	None
якото	Neuter
построено	Neuter
най-бялата	Feminine
оцетът	None
измитаха	None
най-сигурната	Feminine
по-абаносовия	Masculine
сребърни	Masculine
докторско	Neuter
сравнен	Masculine
абразивния	Masculine
гъската	None
подобрена	Feminine
политиката	None
нает	Masculine
важна	Feminine
радяло	Neuter
отваряме	None
порнографското	Neuter
герой	None
шестата	Feminine
красив	Masculine
получилата	Feminine
евтина	Feminine
антроположката	None
забравен	Masculine
най-сатанинското	Neuter
ясна	Feminine
сприятелил	Masculine
омразо	None
принуждават	None
режат	None
голямото	Neuter
сереш	None
самолет	None
съобщила	Feminine
заричани	None
разходен	Masculine
почитаното	Neuter
сокове	None
гъвкава	Feminine
абстрактно	Neuter
наводняващо	Neuter
господарския	Masculine
наркоман	None
виждалият	Masculine
архипелаг	None
убеден	Masculine
по-абдоминален	Masculine
костите	None
авиатори	None
любопитна	Feminine
най-креативната	Feminine
истинското	Neuter
най-практично	Neuter
комерсиален	Masculine
баби	None
крал	Masculine
мъдрия	Masculine
слаб	Masculine
преживял	Masculine
закупени	None
най-козето	Neuter
препоръчване	Neuter
съчетаването	Neuter
построила	Feminine
евфемизмът	None
авион	None
клюнове	None
написващото	Neuter
медицинската	Feminine
скучна	Feminine
съгласни	Masculine
най-абстрактна	Feminine
неблагоразумния	Masculine
гласуващ	Masculine
изпитваща	Feminine
по-продажбеното	Neuter
нисши	Masculine
по-преподавателско	Neuter
далото	Neuter
насмел	Masculine
наклажданият	Masculine
отвеждането	Neuter
всезнайко	None
токсична	Feminine
одобрило	Neuter
най-югозападният	Masculine
водният	Masculine
скъпото	Neuter
най-важният	Masculine
попеченото	Neuter
пелият	Masculine
цунамита	None
оцветяващият	Masculine
безделничи	None
разбиране	Neuter
забравеното	Neuter
наплетяла	Feminine
модерният	Masculine
посещаван	Masculine
говореща	Feminine
играещ	Masculine
отвесната	Feminine
убедила	Feminine
отвеждат	None
разболееха	None
навестявалия	Masculine
по-яйцевидно	Neuter
потъна	None
избрахме	None
обещава	None
ползващи	None
надвнесло	Neuter
изпитваният	Masculine
сънуват	None
започнали	None
пренесъл	Masculine
адресираната	Feminine
слабо	Neuter
мечтаната	Feminine
оскъдния	Masculine
по-съгласна	Feminine
попитвано	Neuter
изминаване	Neuter
забравим	None
ограничен	Masculine
подробни	Masculine
абониранията	None
алкохолни	Masculine
прозирания	Masculine
глобяване	Neuter
говорил	Masculine
уволнявалия	Masculine
написания	Masculine
важни	Masculine
превеждалата	Feminine
изпяха	None
протеста	None
по-болногледаческия	Masculine
изплашва	None
по-неблагоразумното	Neuter
работилия	Masculine
живял	Masculine
пилите	None
писана	Feminine
решаваща	Feminine
действителни	Masculine
по-босичкия	Masculine
акуратно	Neuter
обилна	Feminine
подчертаващата	Feminine
доказали	None
ядосано	Neuter
счупваме	None
заслужаваш	None
забранявания	Masculine
погребвахте	None
най-болничък	Masculine
агентка	None
написваме	None
друго	Neuter
получавате	None
бедната	Feminine
съчетаващо	Neuter
надонасящото	Neuter
изчезва	None
анатомични	Masculine
заречах	None
спираш	None
нисш	Masculine
четящият	Masculine
интересувах	None
ангел	None
ранената	Feminine
забранявалото	Neuter
платения	Masculine
кучетата	None
абстрактния	Masculine
псувните	None
благороден	Masculine
отсичани	None
даденото	Neuter
бившият	Masculine
използваният	Masculine
танцуване	Neuter
превеждащата	Feminine
възбелият	Masculine
способен	Masculine
съгласният	Masculine
най-атомно	Neuter
докторската	Feminine
ирландци	None
започващия	Masculine
обещаваща	Feminine
по-швейцарския	Masculine
азотния	Masculine
понапичан	Masculine
врабча	Feminine
алвеола	None
практични	Masculine
вечността	None
възлизането	Neuter
ходят	None
навирана	Feminine
аварският	Masculine
авантюристичния	Masculine
танцувана	Feminine
доказва	None
набождалата	Feminine
по-яки	Masculine
отнасяна	Feminine
умният	Masculine
заведохте	None
честитеното	Neuter
овцете	None
отличните	None
отчетената	Feminine
некомпетентна	Feminine
козя	Feminine
аплодираното	Neuter
запичана	Feminine
телефониращата	Feminine
наследилият	Masculine
изнесено	Neuter
убиеха	None
врелият	Masculine
мажел	Masculine
заведено	Neuter
най-осъществимия	Masculine
чешко	Neuter
изпяване	Neuter
погребван	Masculine
благо	Neuter
анални	Masculine
влахо	None
беден	Masculine
налога	None
нокътят	None
пива	None
роза	None
свръхестественото	Neuter
озадачавана	Feminine
босичко	Neuter
нишка	None
плашехме	None
по-азотните	None
обсъдите	None
бившия	Masculine
изпяващото	Neuter
студентско	Neuter
отключван	Masculine
повлякохте	None
заченалият	Masculine
изпял	Masculine
обричания	Masculine
отнасящи	None
най-забранителна	Feminine
елипси	None
чиракът	None
азбучната	Feminine
лиза	None
пожарите	None
крадял	Masculine
написани	None
месо	None
бомбардиран	Masculine
плачеща	Feminine
загиналата	Feminine
бедствията	None
учителския	Masculine
нахапващото	Neuter
изобретателите	None
безверният	Masculine
амониевия	Masculine
батерийния	Masculine
оцелелия	Masculine
най-лекторска	Feminine
разлюбваното	Neuter
довлечените	None
прясно	Neuter
спирани	None
подчертаването	Neuter
патриарси	None
отворен	Masculine
вестници	None
нещастно	Neuter
лятно	Neuter
възлизат	None
пратилият	Masculine
кривото	Neuter
обезсмъртявалата	Feminine
нараняваното	Neuter
подобно	Neuter
забременявах	None
силен	Masculine
избрал	Masculine
сприятелено	Neuter
повтаряше	None
ябълкови	Masculine
стандарта	None
влажната	Feminine
обсъждаше	None
белодробния	Masculine
молят	None
авиобомбите	None
киноцентърът	None
ставане	Neuter
грабил	Masculine
плетени	None
загубените	None
азбучно	Neuter
втория	Masculine
сръчността	None
запрялото	Neuter
заслуженото	Neuter
сякъл	Masculine
играли	None
по-адамовите	None
забравяш	None
обличане	Neuter
по-скучни	Masculine
топлият	Masculine
по-аварийна	Feminine
изпредените	None
чернодробен	Masculine
въвиращия	Masculine
адекватни	Masculine
авторският	Masculine
по-забранителната	Feminine
бесещ	Masculine
авторитетен	Masculine
забравил	Masculine
по-плътни	Masculine
понесохме	None
тесни	Masculine
рибо	None
съществуване	Neuter
авантюрата	None
абако	None
оцветеният	Masculine
най-августовската	Feminine
продължилия	Masculine
разпростират	None
австралийците	None
пътуващи	None
предречена	Feminine
сядане	Neuter
намекналата	Feminine
понапечения	Masculine
насичано	Neuter
подобрявали	None
кучета	None
охраняването	Neuter
студен	Masculine
водоравно	Neuter
ясното	Neuter
заслужи	None
майсторско	Neuter
започнато	Neuter
уволнят	None
спираната	Feminine
изговорят	None
припичания	Masculine
изгризващо	Neuter
построило	Neuter
злото	Neuter
козите	None
безбройния	Masculine
вертикалния	Masculine
влажният	Masculine
безаварийният	Masculine
било	Neuter
сядаща	Feminine
умелия	Masculine
германската	Feminine
изневери	None
болен	Masculine
побеждаващ	Masculine
осо	None
полудявалите	None
проницателни	Masculine
обезглавени	None
очакваният	Masculine
мълния	None
североизточни	Masculine
бледосини	Masculine
обясняван	Masculine
проклятие	None
винил	Masculine
студентката	None
по-продаваческо	Neuter
най-сеизмичният	Masculine
продължаващият	Masculine
заченало	Neuter
изминала	Feminine
генералисимуси	None
изпълнимите	None
започване	Neuter
запалвалата	Feminine
отсъстваха	None
швейцарската	Feminine
любезни	Masculine
абсорбирайте	None
смела	Feminine
токсично	Neuter
племе	None
хоризонталната	Feminine
срядата	None
дъвчех	None
обвинено	Neuter
анално	Neuter
най-батерийният	Masculine
автора	None
ползваният	Masculine
бяло	Neuter
книгата	None
тухла	None
превеждалият	Masculine
бял	Masculine
продължете	None
безформеното	Neuter
закупуваните	None
презиращ	Masculine
излизащ	Masculine
изковаването	Neuter
плашила	Feminine
продължите	None
отвеждащ	Masculine
автоматично	Neuter
по-ароматният	Masculine
абсолютни	Masculine
заболия	Masculine
изнудван	Masculine
построена	Feminine
създал	Masculine
реалистичният	Masculine
заподозрените	None
осиновила	Feminine
подпиралия	Masculine
подклаждани	None
вратовръзка	None
облозите	None
време	None
най-еластични	Masculine
забранявана	Feminine
зъболекарска	Feminine
биел	Masculine
ексаметъра	None
восъци	None
западното	Neuter
лекарския	Masculine
завеждащ	Masculine
унищожаването	Neuter
оцеляваща	Feminine
надонасящо	Neuter
широка	Feminine
реалният	Masculine
абсолвентския	Masculine
безстрашни	Masculine
причинила	Feminine
осъществими	Masculine
спрелите	None
преведения	Masculine
забравения	Masculine
щастливо	Neuter
заведената	Feminine
белодробното	Neuter
обещаващото	Neuter
разлюбванията-нетата	None
добро	Neuter
постройте	None
запалили	None
сечащо	Neuter
построен	Masculine
разпростиращ	Masculine
нагребващият	Masculine
слабото	Neuter
посещавания	Masculine
по-преподавателската	Feminine
спиралата	Feminine
спечели	None
студентския	Masculine
пъргав	Masculine
опрощение	None
ароматна	Feminine
неловка	Feminine
амбициозното	Neuter
търсенето	Neuter
четящата	Feminine
алхимика	None
агностик	None
ограничаващ	Masculine
разлюбена	Feminine
нанесяло	Neuter
искахте	None
произлизащ	Masculine
загубен	Masculine
свръхестествен	Masculine
обзавеждан	Masculine
винящия	Masculine
четвърта	Feminine
най-практичния	Masculine
лукавия	Masculine
нанесените	None
разбирах	None
зарекло	Neuter
запридах	None
гръдни	Masculine
плачещия	Masculine
даване	Neuter
нисшия	Masculine
капе	None
боядисвани	None
добра	Feminine
златен	Masculine
червени	Masculine
ушила	Feminine
поспираният	Masculine
повторена	Feminine
археолози	None
преведа	None
царицата	None
южняците	None
спирания	Masculine
пишещият	Masculine
кралю	None
унищожа	None
погледнати	None
аналитичната	Feminine
най-досадно	Neuter
абдоминални	Masculine
ери	None
интересуващ	Masculine
ходела	Feminine
напечем	None
внимателните	None
повличайки	None
отнесъл	Masculine
силният	Masculine
предсказваща	Feminine
запичане	Neuter
испанското	Neuter
чупела	Feminine
агнетата	None
изслушване	Neuter
десни	Masculine
бягай	None
отвориха	None
слънце	None
по-безстрашно	Neuter
отича	None
по-азотист	Masculine
забременеем	None
отнасяше	None
съгласие	None
капещия	Masculine
граничеща	Feminine
дъвкалата	Feminine
скучно	Neuter
възголяма	Feminine
преживяното	Neuter
живеене	Neuter
спестил	Masculine
надеждният	Masculine
бягайки	None
залезе	None
любителско	Neuter
излезе	None
предсказват	None
озаглавен	Masculine
понесената	Feminine
ограничаван	Masculine
наводнен	Masculine
наследили	None
питаше	None
забраняването	Neuter
дъвкане	Neuter
обзаведете	None
нещастния	Masculine
среди	None
яркостта	None
мускулният	Masculine
прозира	None
искрено	Neuter
отвличанията-нетата	None
котко	None
некомпетентното	Neuter
ползвате	None
мразена	Feminine
спряното	Neuter
снимката	None
работещия	Masculine
начетяла	Feminine
турско	Neuter
целите	None
преживяната	Feminine
най-актуален	Masculine
по-храбра	Feminine
аметистови	Masculine
отведен	Masculine
заспали	None
запридащия	Masculine
обковаването	Neuter
изчезнала	Feminine
обясняваща	Feminine
най-ортогоналният	Masculine
заекът	None
най-гладния	Masculine
безмилостните	None
кървящият	Masculine
обсъждалото	Neuter
чакаща	Feminine
най-здрав	Masculine
коремест	Masculine
активни	Masculine
по-щастливи	Masculine
винения	Masculine
купували	None
коритото	None
пръста	None
забождане	Neuter
създало	Neuter
премиралата	Feminine
безделничил	Masculine
вдишването	Neuter
визо	None
наводнявания	Masculine
изслушате	None
по-правителствената	Feminine
чорапите	None
акула	None
най-саркастичните	None
комбинирана	Feminine
озадачаващия	Masculine
мряна	None
кравето	Neuter
спирано	Neuter
по-анасоновото	Neuter
тревогите	None
авансирах	None
пристигаше	None
най-абитуриентска	Feminine
ноктите	None
жребеца	None
набождалото	Neuter
бърно	None
върхове	None
акцента	None
обучилият	Masculine
виждан	Masculine
доплитания	Masculine
вулкани	None
забраняващ	Masculine
изгребваш	None
залязох	None
изведат	None
по-яйцевидни	Masculine
най-лявата	Feminine
пишел	Masculine
назовавано	Neuter
италианският	Masculine
абдала	None
аварийният	Masculine
низша	Feminine
обвиняваща	Feminine
написването	Neuter
неопитен	Masculine
озаглавил	Masculine
германка	None
давали	None
комунистът	None
аморфният	Masculine
излезехме	None
по-възбелият	Masculine
чакат	None
актуални	Masculine
влажна	Feminine
спичания	Masculine
тъжният	Masculine
благородна	Feminine
изпитана	Feminine
горяла	Feminine
неголямата	Feminine
горял	Masculine
загребвалата	Feminine
отрови	None
упрекване	Neuter
черната	Feminine
опасен	Masculine
произтичащи	None
повлекат	None
заплашения	Masculine
косите	None
играна	Feminine
северозападното	Neuter
разхождат	None
подробно	Neuter
заплашващите	None
прътове	None
отмяната	None
зашиел	Masculine
най-небесносинята	Feminine
австрийска	Feminine
оцеляването	Neuter
надколенния	Masculine
най-естетично	Neuter
протека	None
разхождахте	None
срещат	None
попитвали	None
ненадеждно	Neuter
най-ягодови	Masculine
пристигането	Neuter
хомяк	None
съобщаваната	Feminine
използването	Neuter
адекватен	Masculine
принудената	Feminine
изсеченият	Masculine
четяла	Feminine
препрочитайте	None
абаджийка	None
отвлечен	Masculine
будала	None
прозиращата	Feminine
закупеше	None
опрем	None
зетя	None
осмите	None
привнесено	Neuter
отключена	Feminine
важното	Neuter
очакващи	None
донасяли	None
простил	Masculine
най-учителската	Feminine
разнасянето	Neuter
дадения	Masculine
човекът	None
сравнилата	Feminine
по-атомна	Feminine
благоразумния	Masculine
решителен	Masculine
лястовиците	None
простреният	Masculine
сръчни	Masculine
забравих	None
ябълковия	Masculine
осиновено	Neuter
благословил	Masculine
най-щателните	None
реален	Masculine
втечнявалия	Masculine
помело	Neuter
произнасян	Masculine
намекваща	Feminine
обичане	Neuter
секлите	None
въоръжаването	Neuter
търсено	Neuter
опитът	None
чудесните	None
отключвалия	Masculine
по-ангелско	Neuter
искащо	Neuter
навлязоха	None
по-аления	Masculine
нагребвайки	None
презираните	None
преведеш	None
по-осъществимите	None
къща	None
отмиралият	Masculine
причиняващо	Neuter
по-бавничкия	Masculine
обричане	Neuter
гончетата	None
съветващ	Masculine
създавания	Masculine
удовлетворяваната	Feminine
убеждаваното	Neuter
учителката	None
алена	Feminine
насметеше	None
моме	None
корилия	Masculine
наковавали	None
усърден	Masculine
разумния	Masculine
аби	None
були	None
ягодова	Feminine
източен	Masculine
предсказана	Feminine
сложен	Masculine
удари	None
висшето	Neuter
антипартиен	Masculine
заоравалата	Feminine
най-югоизточното	Neuter
противобесният	Masculine
по-белодробна	Feminine
създаващата	Feminine
обсъждайте	None
недостатъчен	Masculine
гневен	Masculine
бавните	None
безмилостния	Masculine
желал	Masculine
говорене	Neuter
донесен	Masculine
долът	None
падането	Neuter
уволняваха	None
полудява	None
по-единадесетото	Neuter
казал	Masculine
кървяло	Neuter
прекрасна	Feminine
политиките	None
агенция	None
насякоха	None
грабеният	Masculine
напредваща	Feminine
студения	Masculine
бит	Masculine
различният	Masculine
полковник	None
най-дръзка	Feminine
авиационна	Feminine
снасянето	Neuter
насечена	Feminine
висши	Masculine
по-некадърния	Masculine
подвеждаща	Feminine
напишела	Feminine
старата	Feminine
правено	Neuter
ставан	Masculine
загубеният	Masculine
отворена	Feminine
агресорите	None
назоваване	Neuter
мразове	None
нещастна	Feminine
отречено	Neuter
бактериална	Feminine
бинокли	None
купена	Feminine
повярвам	None
авторитетната	Feminine
започваща	Feminine
младият	Masculine
ловък	Masculine
лека	Feminine
изчезналите	None
посещаваната	Feminine
по-безпарична	Feminine
подвеждан	Masculine
отваря	None
доказаната	Feminine
безделничилият	Masculine
наклала	Feminine
швейцарецът	None
наклаждахте	None
зеленото	Neuter
окрадял	Masculine
двубои	None
обзаведена	Feminine
поведения	Masculine
решилите	None
мъртвия	Masculine
по-благородният	Masculine
умела	Feminine
тръгващо	Neuter
насичащо	Neuter
мечтаели	None
изнудва	None
изберете	None
опако	Neuter
опрях	None
изведели	None
най-безскрупулно	Neuter
по-сатанистични	Masculine
допринасяне	Neuter
изплетена	Feminine
почетен	Masculine
заплашен	Masculine
заслужила	Feminine
играещият	Masculine
писателят	None
можело	Neuter
високото	Neuter
купеният	Masculine
пометена	Feminine
енергично	Neuter
хапала	Feminine
аналния	Masculine
наследения	Masculine
низши	Masculine
плачещата	Feminine
парадоксални	Masculine
честитилият	Masculine
помагането	Neuter
танцувалата	Feminine
дъвкахме	None
обвинява	None
извело	Neuter
измиралият	Masculine
кладяла	Feminine
пада	None
изчете	None
счупело	Neuter
вярвам	None
скъпи	Masculine
ухо	None
искреното	Neuter
предрекла	Feminine
предричам	None
решаващият	Masculine
излязлата	Feminine
мразещ	Masculine
безразсъдно	Neuter
дългият	Masculine
изведените	None
по-бебешкия	Masculine
отсъстващо	Neuter
администрация	None
уволненият	Masculine
възможно	Neuter
измитано	Neuter
августовския	Masculine
най-аметистовото	Neuter
убиването	Neuter
решаването	Neuter
славното	Neuter
арестувано	Neuter
отсечената	Feminine
завеждащият	Masculine
най-хомосексуалното	Neuter
пренесат	None
по-коремното	Neuter
месец	None
радостите	None
медицинско	Neuter
навеждана	Feminine
неразумния	Masculine
убеждавайки	None
брана	Feminine
обясним	None
щурец	None
изчезнал	Masculine
изсичането	Neuter
обещаният	Masculine
големи	Masculine
получаваната	Feminine
изговаряща	Feminine
говорещо	Neuter
замък	None
артикула	None
опичаната	Feminine
осиновявали	None
купиш	None
вождовете	None
загинала	Feminine
желан	Masculine
евфемизъм	None
запалка	None
обещаващите	None
напичаният	Masculine
удовлетворяващ	Masculine
препоръчва	None
бързи	Masculine
по-възможния	Masculine
примиралите	None
руската	Feminine
несръчните	None
по-различен	Masculine
августейшо	Neuter
съветвахме	None
поопеклия	Masculine
питащият	Masculine
удовлетворявана	Feminine
дребното	Neuter
североизточният	Masculine
оцеляла	Feminine
делилото	Neuter
по-проницателна	Feminine
гладно	Neuter
купи	None
съчетаваната	Feminine
започват	None
подвеждането	Neuter
козето	Neuter
забременеела	Feminine
почитат	None
чешкия	Masculine
немската	Feminine
адресиране	Neuter
изпитано	Neuter
наивни	Masculine
предреклата	Feminine
подписващ	Masculine
брави	None
жерава	None
по-ловко	Neuter
безгрижни	Masculine
срещаният	Masculine
здравите	None
оцветявания	Masculine
абатската	Feminine
изпяваните	None
обучаващ	Masculine
правенето	Neuter
замел	Masculine
вятъра	None
аборигенското	Neuter
излизали	None
анулиращия	Masculine
търсения	Masculine
мускулест	Masculine
произнесен	Masculine
западна	Feminine
пилата	Feminine
обещаващо	Neuter
търсена	Feminine
пътуващата	Feminine
съблазън	None
бягащото	Neuter
по-новия	Masculine
пречупвания	Masculine
причинило	Neuter
най-стомашен	Masculine
момци	None
старателна	Feminine
асансьори	None
гей	None
изтичането	Neuter
най-еластична	Feminine
племето	None
обучаващият	Masculine
загивания-нета	None
шепот	None
ядящия	Masculine
помага	None
корено	Neuter
северни	Masculine
предсказваш	None
заораваш	None
тъп	Masculine
наричаше	None
мъртвата	Feminine
изсичаните	None
изгребващия	Masculine
балканския	Masculine
отсякъл	Masculine
избиране	Neuter
убивалият	Masculine
сив	Masculine
въоръжилия	Masculine
хрян	None
довеждане	Neuter
охраняване	Neuter
напредналото	Neuter
господарствалата	Feminine
най-вещото	Neuter
предете	None
изпредем	None
жираф	None
тежкия	Masculine
смазващата	Feminine
бебешко	Neuter
тясното	Neuter
кралица	None
създаващите	None
мразели	None
другия	Masculine
по-анархично	Neuter
мечтаеш	None
по-амониево	Neuter
осиновява	None
бившата	Feminine
обичалото	Neuter
чембало	None
водни	Masculine
потекло	Neuter
крамоли	None
обрекъл	Masculine
широкото	Neuter
подведена	Feminine
можещият	Masculine
най-аварийни	Masculine
абразивна	Feminine
ухапалите	None
препечени	None
произлизащо	Neuter
строяла	Feminine
по-тъпата	Feminine
коронясвалият	Masculine
избраното	Neuter
нисшата	Feminine
несръчна	Feminine
австрийския	Masculine
превеждането	Neuter
отличната	Feminine
обречен	Masculine
измрелия	Masculine
отваряте	None
сиялото	Neuter
отрицателно	Neuter
болницата	None
умиралата	Feminine
заведения	Masculine
вдишан	Masculine
по-майсторска	Feminine
светлият	Masculine
презира	None
бивола	None
напреднала	Feminine
господарстващият	Masculine
най-актуалния	Masculine
нанесената	Feminine
подклаждайте	None
словенския	Masculine
ангелско	Neuter
италианския	Masculine
чорапогащник	None
по-изкусният	Masculine
поизмело	Neuter
изчетох	None
живее	None
можел	Masculine
чернодробните	None
бременност	None
най-неловка	Feminine
краткото	Neuter
казано	Neuter
изпечена	Feminine
заредените	None
възпре	None
паразитът	None
опреденото	Neuter
благословените	None
най-сръбската	Feminine
шофьорът	None
ъгъл	None
отсъстващ	Masculine
платяла	Feminine
пръчка	None
хомосексуалната	Feminine
избраната	Feminine
безкрайното	Neuter
плачел	Masculine
подкупите	None
произлязла	Feminine
заспеше	None
мрем	None
коронясан	Masculine
изслушвайки	None
анулираният	Masculine
играели	None
създавам	None
най-доверчиво	Neuter
славна	Feminine
набол	Masculine
завела	Feminine
безразсъден	Masculine
по-учтивия	Masculine
албанския	Masculine
виждащото	Neuter
арогантен	Masculine
способна	Feminine
палката	None
пасящата	Feminine
възлизащ	Masculine
алкохолното	Neuter
по-бодрото	Neuter
най-тъмносиньо	Neuter
най-другия	Masculine
одобряваш	None
бистрата	Feminine
зеленият	Masculine
неверния	Masculine
вечеряй	None
бомбардирано	Neuter
изнасян	Masculine
гръдният	Masculine
изпълнима	Feminine
повторения	Masculine
бягане	Neuter
избожданите	None
следобедите	None
изкупел	Masculine
изпасената	Feminine
непокътната	Feminine
удар	None
доведената	Feminine
гневната	Feminine
абонат	None
белодробни	Masculine
преподавателския	Masculine
железен	Masculine
обезглавено	Neuter
умовете	None
написаното	Neuter
отнасяното	Neuter
ключове	None
затечете	None
казахме	None
способни	Masculine
невряла	Feminine
отрекли	None
ангели	None
писателските	None
горящият	Masculine
заплашило	Neuter
решително	Neuter
пеещата	Feminine
привнесли	None
пристигналият	Masculine
излезлите	None
сериозният	Masculine
набожен	Masculine
забраняващо	Neuter
обичан	Masculine
изпитване	Neuter
извлякъл	Masculine
арестуването	Neuter
нанасяне	Neuter
изпитващия	Masculine
най-ловки	Masculine
по-бързичкият	Masculine
снимките	None
опирайте	None
изнудването	Neuter
най-железни	Masculine
озаглавявана	Feminine
по-ненадежден	Masculine
най-адекватна	Feminine
намекващото	Neuter
погребването	Neuter
продължил	Masculine
млъквалата	Feminine
съществуването	Neuter
питам	None
спирайте	None
ядосаната	Feminine
молен	Masculine
по-шеста	Feminine
токсичен	Masculine
по-лилав	Masculine
по-абсолютната	Feminine
припечеше	None
отчетена	Feminine
кралско	Neuter
разпрострат	None
адаптацийо	None
отровното	Neuter
желаещият	Masculine
унищожавана	Feminine
погледнат	Masculine
мускулно	Neuter
препоръча	None
обучаваща	Feminine
диво	Neuter
бензин	None
гъсоци	None
сложено	Neuter
топлото	Neuter
навряното	Neuter
половина	None
повтаряната	Feminine
девето	Neuter
буден	Masculine
наетата	Feminine
обясни	None
доказващо	Neuter
подвел	Masculine
дават	None
момичетата	None
анатомичната	Feminine
висшите	None
недостатъчна	Feminine
създаденото	Neuter
отлично	Neuter
обвиняване	Neuter
активистки	None
изслушването	Neuter
вземането	Neuter
съвременен	Masculine
най-хубавата	Feminine
навлязлата	Feminine
простила	Feminine
отвличайки	None
въоръжат	None
навлизащият	Masculine
по-ангелска	Feminine
по-чудесна	Feminine
неумел	Masculine
плачещ	Masculine
югоизточни	Masculine
обсъдена	Feminine
можехте	None
изплашилия	Masculine
най-детинския	Masculine
повтаря	None
погледнала	Feminine
битият	Masculine
по-зелен	Masculine
получавайки	None
упреквания	Masculine
по-порнографско	Neuter
предсказан	Masculine
абдоминална	Feminine
принуждавано	Neuter
обръщения	None
търсеше	None
одобрила	Feminine
разбере	None
широк	Masculine
овче	Neuter
пренесе	None
здрав	Masculine
ушита	Feminine
възлезлият	Masculine
тръгващ	Masculine
сетаметърът	None
мел	Masculine
дебеляла	Feminine
по-широк	Masculine
срещащата	Feminine
шефе	None
германката	None
получаване	Neuter
горящата	Feminine
хипопотами	None
италианската	Feminine
падащата	Feminine
засякла	Feminine
подписалите	None
казала	Feminine
донесеното	Neuter
вероятни	Masculine
гладният	Masculine
прощаването	Neuter
зелената	Feminine
припичаните	None
азотистата	Feminine
дене	None
отключат	None
обвинения	Masculine
изпий	None
обичам	None
най-отличните	None
путката	None
счупваше	None
произлязло	Neuter
докторска	Feminine
приятелка	None
принасялия	Masculine
наричан	Masculine
прозре	None
кадифе	None
некомпетентната	Feminine
събудила	Feminine
досадна	Feminine
загиващото	Neuter
изпявахте	None
най-абразивния	Masculine
съществуващият	Masculine
фургона	None
колене	None
раняващата	Feminine
обсъден	Masculine
реалистично	Neuter
почитането	Neuter
капане	Neuter
разнесла	Feminine
близалия	Masculine
донася	None
озадачаваш	None
светлата	Feminine
мъртвеца	None
по-набожното	Neuter
обичаната	Feminine
изпичащата	Feminine
парадоксалната	Feminine
обезглавявай	None
взимайте	None
започнатият	Masculine
разхождащ	Masculine
по-злите	None
сигурния	Masculine
зареждане	Neuter
саркастично	Neuter
нещастни	Masculine
потъналият	Masculine
продължи	None
бавния	Masculine
завеждате	None
слушаха	None
получаващото	Neuter
най-хоризонтално	Neuter
абсорбиран	Masculine
отнасяно	Neuter
стандарти	None
костенурката	None
чернодробния	Masculine
токсичният	Masculine
виждането	Neuter
наобличалия	Masculine
грешен	Masculine
атомно	Neuter
лесен	Masculine
инвестираните	None
отнеса	None
неспособна	Feminine
загубеха	None
избирайте	None
танцувалият	Masculine
австрийското	Neuter
училища	None
прегръщане	Neuter
стомаха	None
реалната	Feminine
донесла	Feminine
железни	Masculine
най-анасоновия	Masculine
захапване	Neuter
уволнявалият	Masculine
донесох	None
спираха	None
заповяданото	Neuter
заплетем	None
отвлекат	None
повторен	Masculine
въвличане	Neuter
абсурдна	Feminine
некомпетентни	Masculine
извел	Masculine
счупване	Neuter
пишели	None
принуден	Masculine
низш	Masculine
наблюдение	None
изтекло	Neuter
зашиване	Neuter
правилото	Neuter
безалкохолната	Feminine
съседи	None
руското	Neuter
бикове	None
прелъстяването	Neuter
отвесен	Masculine
обяснявано	Neuter
избран	Masculine
пречупило	Neuter
заченала	Feminine
отичащ	Masculine
югозападната	Feminine
австриеца	None
съгласната	Feminine
владика	None
търговете	None
южната	Feminine
допиране	Neuter
комбинирани	None
изсичане	Neuter
стряхата	None
най-бързият	Masculine
тъмносиньо	Neuter
отвличаща	Feminine
ангела	None
ухапваното	Neuter
нагребваха	None
елена	None
наречеш	None
пронасях	None
преподавателска	Feminine
спасявали	None
подчертали	None
ухапване	Neuter
зидар	None
дъх	None
прочитания	Masculine
посъветваше	None
будещи	None
пречупения	Masculine
изкупена	Feminine
капело	Neuter
най-ананасово	Neuter
точния	Masculine
обсъжданата	Feminine
ананасовият	Masculine
горена	Feminine
гълъбите	None
работещото	Neuter
решаващите	None
лекомислени	Masculine
коронясали	None
ударът	None
тясно	Neuter
изкупеният	Masculine
арменците	None
най-руското	Neuter
заплетат	None
обсъдим	None
по-безпаричният	Masculine
документи	None
немска	Feminine
хоризонталният	Masculine
наранена	Feminine
отвеждане	Neuter
американския	Masculine
замиралата	Feminine
нанесъл	Masculine
вярваща	Feminine
бедрото	None
изкусно	Neuter
обричай	None
ухапваща	Feminine
капак	None
картата	None
по-ягодовият	Masculine
изпълнимата	Feminine
продавалият	Masculine
причинен	Masculine
плетене	Neuter
швейцарският	Masculine
отбодеше	None
по-бързото	Neuter
накажем	None
казана	Feminine
изреченията	None
най-лек	Masculine
пиле	None
авантюристична	Feminine
болногледаческото	Neuter
реално	Neuter
допичащи	None
планината	None
бомбардиране	Neuter
изговарян	Masculine
забравяне	Neuter
челият	Masculine
влизаща	Feminine
допичащото	Neuter
място	None
изчезването	Neuter
произнасяната	Feminine
падащия	Masculine
заплашващо	Neuter
архаичната	Feminine
далечния	Masculine
портокаловите	None
получаваха	None
подобрил	Masculine
езана	None
хлябът	None
умряха	None
падаща	Feminine
белодробно	Neuter
по-нов	Masculine
плашилото	Neuter
говориш	None
напекло	Neuter
по-възтесен	Masculine
гръдна	Feminine
по-единадесетата	Feminine
азотна	Feminine
обяснява	None
обилното	Neuter
предупредена	Feminine
наблюдения	None
тресенето	Neuter
надеждния	Masculine
бавни	Masculine
пътувам	None
интересен	Masculine
атоми	None
работещо	Neuter
каза	None
любопитният	Masculine
пеело	Neuter
изчитане	Neuter
опечен	Masculine
най-сладки	Masculine
по-аборигенският	Masculine
най-слаб	Masculine
евтиното	Neuter
деляща	Feminine
арестувалата	Feminine
внимателен	Masculine
почетеното	Neuter
епицентъра	None
наследявайки	None
яйцата	None
глупавият	Masculine
казали	None
купувайки	None
шибащи	None
уплашена	Feminine
назовават	None
непряко	Neuter
аплодиращият	Masculine
започвам	None
плащания	Masculine
начетена	Feminine
започната	Feminine
щастливото	Neuter
плешивия	Masculine
най-бившият	Masculine
най-различен	Masculine
любителският	Masculine
безделничещ	Masculine
безпокойство	None
обсъждано	Neuter
вярвалото	Neuter
немец	None
изчезналото	Neuter
бегли	Masculine
донесения	Masculine
неопитният	Masculine
първоразрядното	Neuter
вярването	Neuter
танцуващият	Masculine
литри	None
съвременния	Masculine
наричаното	Neuter
изричането	Neuter
архаизмите	None
озадачената	Feminine
стремето	None
най-ягодова	Feminine
надонасяно	Neuter
честващ	Masculine
безстрашно	Neuter
по-антипартийна	Feminine
победената	Feminine
продължилото	Neuter
кърви	None
царства	None
агробиолози	None
обещае	None
най-перпендикулярния	Masculine
подобното	Neuter
университетите	None
припадането	Neuter
станалата	Feminine
присъстващ	Masculine
победа	None
винях	None
комунисте	None
поведена	Feminine
любопитното	Neuter
обвинила	Feminine
извлечени	None
авторитарна	Feminine
отвесните	None
заплетеното	Neuter
получаването	Neuter
по-леви	Masculine
най-бързичко	Neuter
губиш	None
смените	None
обвинихме	None
подкупването	Neuter
режещ	Masculine
евтино	Neuter
работо	None
анулиран	Masculine
граничела	Feminine
изкусни	Masculine
спасил	Masculine
ядял	Masculine
унгарския	Masculine
бедняци	None
най-цялото	Neuter
упрекнал	Masculine
врана	None
слушания	Masculine
пещерата	None
руска	Feminine
изпечен	Masculine
неразумната	Feminine
отсъстващата	Feminine
закусилия	Masculine
значителният	Masculine
автострада	None
частта	None
произнесената	Feminine
оскъдна	Feminine
шибащата	Feminine
камилите	None
омитаното	Neuter
отвелото	Neuter
подмитаното	Neuter
глобяваната	Feminine
по-любознателния	Masculine
раняваният	Masculine
търсеният	Masculine
пастир	None
потичате	None
ухапало	Neuter
най-гладно	Neuter
компютри	None
запалвана	Feminine
изпичане	Neuter
кратката	Feminine
червеното	Neuter
допрени	None
истинното	Neuter
доплитан	Masculine
допиращи	None
левият	Masculine
действително	Neuter
предскаже	None
заподозирано	Neuter
оцветяващо	Neuter
клетвите	None
западния	Masculine
доведеният	Masculine
любителското	Neuter
по-неловкото	Neuter
решаха	None
по-треторазредния	Masculine
игран	Masculine
довеждането	Neuter
опак	Masculine
различното	Neuter
облечения	Masculine
учителското	Neuter
будещ	Masculine
преводач	None
йоктолитрите	None
купел	Masculine
противничката	None
обясняващ	Masculine
благославящ	Masculine
козе	Neuter
мазал	Masculine
пило	Neuter
безформен	Masculine
най-беглия	Masculine
най-тясно	Neuter
забравялото	Neuter
по-отвесно	Neuter
отворено	Neuter
грабели	None
умен	Masculine
уволняващ	Masculine
насичаният	Masculine
чистият	Masculine
намекнал	Masculine
предупредя	None
най-невярното	Neuter
платената	Feminine
отсичания	Masculine
подкупване	Neuter
ябълкова	Feminine
невярно	Neuter
смазващото	Neuter
умната	Feminine
точните	None
презиралият	Masculine
близък	Masculine
тънък	Masculine
пречупен	Masculine
преведената	Feminine
преподавателският	Masculine
подписваният	Masculine
словосъчетание	None
най-августейшият	Masculine
сечене	Neuter
непокътнатата	Feminine
най-четвъртият	Masculine
абонаментна	Feminine
съобщаващия	Masculine
обучавано	Neuter
продавачо	None
сярно	Neuter
пронасялият	Masculine
най-неузрелият	Masculine
навлезлите	None
стъклата	None
най-азотната	Feminine
честитена	Feminine
продължаване	Neuter
говорили	None
четеното	Neuter
извличан	Masculine
кривия	Masculine
изкупувания-нета	None
преживявания	Masculine
произнесени	None
обесват	None
дъгата	None
лулата	None
цветя	None
легализиране	Neuter
болното	Neuter
омитащо	Neuter
работлив	Masculine
решения	Masculine
болестите	None
ограничаващия	Masculine
италианката	None
смелия	Masculine
недостатъчно	Neuter
аморфния	Masculine
комбиниращ	Masculine
широката	Feminine
ядосания	Masculine
любезна	Feminine
грабенето	Neuter
нараняване	Neuter
забранило	Neuter
осиновена	Feminine
вате	None
спестена	Feminine
можем	None
загивалите	None
охранявано	Neuter
десетия	Masculine
арабско	Neuter
заповядван	Masculine
южняшка	Feminine
извлече	None
бледничкото	Neuter
подчертана	Feminine
опаса	None
бистро	Neuter
отвесно	Neuter
ближе	None
нивата	None
плътна	Feminine
босичката	Feminine
цукалата	None
запалела	Feminine
наемане	Neuter
най-агресивният	Masculine
гребно	Neuter
единадесетото	Neuter
прочетената	Feminine
произнеслото	Neuter
съветващия	Masculine
принася	None
мускулесто	Neuter
загубило	Neuter
презиращият	Masculine
сатанинско	Neuter
почетем	None
учтива	Feminine
давате	None
щрауси	None
пронесло	Neuter
арогантни	Masculine
бавният	Masculine
любопитен	Masculine
по-слаба	Feminine
плоде	None
разболеехте	None
искана	Feminine
одобрените	None
най-разумен	Masculine
сапуни	None
писалата	Feminine
прочетеното	Neuter
мрящ	Masculine
писателският	Masculine
чернодробна	Feminine
крадени	None
поведен	Masculine
търсил	Masculine
албанска	Feminine
най-слънчева	Feminine
озадачават	None
аналното	Neuter
най-първоразредният	Masculine
аморфни	Masculine
победилата	Feminine
даващия	Masculine
набоденият	Masculine
доказалото	Neuter
предат	None
произнасянето	Neuter
изчезване	Neuter
по-безаварийното	Neuter
казването	Neuter
изминалото	Neuter
сядащия	Masculine
взимат	None
отчитането	Neuter
силно	Neuter
удовлетворят	None
заподозрян	Masculine
най-силна	Feminine
значителни	Masculine
давайте	None
студени	Masculine
дъждове	None
сияния-нета	None
разплакало	Neuter
очакващия	Masculine
отвлечеш	None
оцелялото	Neuter
виждаща	Feminine
загубят	None
анестезиолог	None
анулирано	Neuter
бягаща	Feminine
седма	Feminine
поопичаше	None
западни	Masculine
най-абразивна	Feminine
желязното	Neuter
купела	Feminine
комета	None
най-азиатска	Feminine
по-скучен	Masculine
учена	Feminine
най-бездейната	Feminine
ненадеждна	Feminine
най-дебелия	Masculine
азиатска	Feminine
седмия	Masculine
запалващото	Neuter
наковавате	None
граничещо	Neuter
куклата	None
най-мъдър	Masculine
значителното	Neuter
бактериалната	Feminine
резките	None
непряк	Masculine
дръзката	Feminine
испанския	Masculine
анонимния	Masculine
тухлата	None
виждайки	None
дълбоки	Masculine
бирата	None
корящото	Neuter
гласуваният	Masculine
чупите	None
наемащия	Masculine
дам	None
въжетата	None
студентстването	Neuter
платено	Neuter
купено	Neuter
изораваната	Feminine
взимате	None
изгубените	None
непокътнати	Masculine
решаваме	None
слушаната	Feminine
череша	None
безалкохолните	None
най-авиационен	Masculine
работила	Feminine
авангардна	Feminine
аварската	Feminine
живелите	None
обсъждайки	None
автор	None
абстрактна	Feminine
западно	Neuter
подобря	None
корен	Masculine
летния	Masculine
щателни	Masculine
студентското	Neuter
майсторска	Feminine
ушиваме	None
космато	Neuter
допрочитане	Neuter
разпрострените	None
ковчези	None
използване	Neuter
зачетено	Neuter
портокал	None
името	None
безгрижна	Feminine
изгубената	Feminine
парашутът	None
подвеждаме	None
спаси	None
присъстващия	Masculine
зашиващо	Neuter
дъще	None
словенското	Neuter
по-недостатъчната	Feminine
облечена	Feminine
щастлив	Masculine
кочове	None
наводняваната	Feminine
десният	Masculine
най-компетентни	Masculine
непоколебими	Masculine
попечена	Feminine
глухонемите	None
нощ	None
припечели	None
актьорът	None
бежанци	None
енергичното	Neuter
изнесеният	Masculine
отвлекли	None
лесбийките	None
най-аларменото	Neuter
насеченото	Neuter
прозираното	Neuter
пчелата	None
прегърнатото	Neuter
мъдър	Masculine
най-агрегатна	Feminine
облечено	Neuter
внимателна	Feminine
станем	None
можеща	Feminine
горелка	None
стомахо	None
отнесла	Feminine
закупуваният	Masculine
прехапват	None
чудото	None
поведели	None
мъдрият	Masculine
ароматната	Feminine
жестока	Feminine
азотният	Masculine
наизлизащото	Neuter
протест	None
отвел	Masculine
спасяващият	Masculine
североизточния	Masculine
сериозното	Neuter
убих	None
щателно	Neuter
науките	None
най-авангардното	Neuter
завело	Neuter
спряхме	None
превеждахте	None
як	Masculine
най-лесни	Masculine
изрече	None
търсел	Masculine
завеждащия	Masculine
по-арогантен	Masculine
разбирания	Masculine
унесеното	Neuter
отричайки	None
тъжна	Feminine
дадената	Feminine
предсказано	Neuter
припадащото	Neuter
живеещ	Masculine
наводняване	Neuter
победилият	Masculine
по-досадното	Neuter
поотичащото	Neuter
по-инфантилни	Masculine
съперница	None
бушуващата	Feminine
най-безформеният	Masculine
отключело	Neuter
изрекъл	Masculine
начетен	Masculine
естетичен	Masculine
плелите	None
наследеното	Neuter
по-бездейният	Masculine
северозападната	Feminine
назоваващата	Feminine
човека	None
въвряното	Neuter
построявайки	None
довлеченото	Neuter
метен	Masculine
недостатъчния	Masculine
прочетено	Neuter
съзиралият	Masculine
плътната	Feminine
по-сатанистично	Neuter
енергичният	Masculine
най-стомашни	Masculine
дясната	Feminine
изкупи	None
пристигащия	Masculine
даден	Masculine
благослови	None
авторитетна	Feminine
по-акуратната	Feminine
аерогара	None
сече	None
злоупотребяване	Neuter
отключват	None
най-сръчния	Masculine
пелени	None
сприятеляхме	None
по-агресивното	Neuter
пристигаха	None
най-значителни	Masculine
засечен	Masculine
златно	Neuter
очакваща	Feminine
интелигентният	Masculine
архаизми	None
ангелския	Masculine
по-разсъдливият	Masculine
кървяла	Feminine
модерната	Feminine
питалото	Neuter
делфина	None
слизащо	Neuter
тичай	None
неумели	Masculine
адаптация	None
най-лесното	Neuter
излезлия	Masculine
смазал	Masculine
красивия	Masculine
най-продаваческо	Neuter
подвеждалият	Masculine
нива	None
живелия	Masculine
грозната	Feminine
продаваната	Feminine
по-анонимен	Masculine
турското	Neuter
заплетен	Masculine
еластична	Feminine
изкупиха	None
построил	Masculine
реалното	Neuter
създаващ	Masculine
далечният	Masculine
нагребване	Neuter
изпилия	Masculine
влажни	Masculine
съществували	None
най-добрата	Feminine
прочетена	Feminine
пушена	Feminine
стан	None
авариен	Masculine
унищожена	Feminine
зелени	Masculine
опичаща	Feminine
пиела	Feminine
бледничка	Feminine
сравняванията-нетата	None
италианска	Feminine
по-подколянна	Feminine
досадния	Masculine
пренесла	Feminine
ханосите	None
произнасяно	Neuter
упрекнала	Feminine
жълтия	Masculine
потичалия	Masculine
преживяват	None
прегърнал	Masculine
по-осъществимия	Masculine
анасоново	Neuter
южна	Feminine
скучни	Masculine
аварите	None
по-кратка	Feminine
изсеченото	Neuter
заподозира	None
унищожавалата	Feminine
зло	Neuter
наричаният	Masculine
решетка	None
заплашвайки	None
безпаричното	Neuter
правило	Neuter
полудяха	None
стрино	None
забрави	None
писателствахме	None
ходел	Masculine
отхапания	Masculine
най-първоразредни	Masculine
обещаното	Neuter
обвиняват	None
неспособни	Masculine
патицата	None
алтовия	Masculine
излизащата	Feminine
сия	None
наоблечено	Neuter
близката	Feminine
пъпеши	None
грешеното	Neuter
учела	Feminine
използващия	Masculine
шкафа	None
зрящ	Masculine
абсолютна	Feminine
забравяме	None
залязло	Neuter
умрем	None
афоризмите	None
най-бледосинята	Feminine
одобрени	None
забраняван	Masculine
най-сръчното	Neuter
продаването	Neuter
съгласието	None
близалата	Feminine
повтарян	Masculine
правеща	Feminine
токо	None
второ	Neuter
швейцарския	Masculine
пита	Feminine
абитуриентския	Masculine
легализирана	Feminine
астролозите	None
компетентен	Masculine
изпичалото	Neuter
славно	Neuter
донесъл	Masculine
най-абстрактния	Masculine
най-благоразумния	Masculine
отвлечените	None
принуждаването	Neuter
предплащани	None
чута	Feminine
умелата	Feminine
осиновявалото	Neuter
удовлетворяваща	Feminine
вождът	None
допринасянето	Neuter
турската	Feminine
най-добрите	None
учителска	Feminine
спестено	Neuter
зъболекарската	Feminine
глоба	None
автомобил	None
по-влажна	Feminine
водно	Neuter
прегърнала	Feminine
деца	None
провира	None
по-точния	Masculine
простиралият	Masculine
прехапвалият	Masculine
боядисана	Feminine
пренасянето	Neuter
крокодилите	None
по-ловки	Masculine
посъветвани	None
оцеля	None
запаленият	Masculine
изляза	None
коремен	Masculine
абсолютната	Feminine
пели	None
бедни	Masculine
чупилото	Neuter
отличния	Masculine
арестуващ	Masculine
агресор	None
падайки	None
донесеш	None
предупреждаване	Neuter
обзавеждана	Feminine
агротехника	None
бягането	Neuter
заченатия	Masculine
изгубена	Feminine
вляза	None
студеното	Neuter
агитационна	Feminine
бойлерът	None
анатемосан	Masculine
въоръжено	Neuter
руския	Masculine
парашута	None
по-ясният	Masculine
забременее	None
избирайки	None
най-лековерната	Feminine
довлечахме	None
сеизмичната	Feminine
учителската	Feminine
възпират	None
десето	Neuter
по-германската	Feminine
обилния	Masculine
засеклият	Masculine
измела	Feminine
най-авгиевата	Feminine
епицентърът	None
получаващ	Masculine
господарувалия	Masculine
проницателен	Masculine
по-бели	Masculine
оцеляващото	Neuter
най-ягодовият	Masculine
цитат	None
кирпич	None
агитационни	Masculine
загинали	None
влязлата	Feminine
подчертаващ	Masculine
искано	Neuter
преведеното	Neuter
сеизмична	Feminine
написаната	Feminine
обвинявана	Feminine
бактериалното	Neuter
правене	Neuter
стандарт	None
най-пълни	Masculine
отваряща	Feminine
обсъдя	None
уволняван	Masculine
змия	None
изведен	Masculine
захапвани	None
подробният	Masculine
чист	Masculine
американско	Neuter
по-безмилостното	Neuter
сребърна	Feminine
вярвах	None
лекомислен	Masculine
доме	None
леки	Masculine
изпълним	Masculine
обезсмъртяло	Neuter
плетен	Masculine
опитна	Feminine
обещай	None
македонското	Neuter
подчертавай	None
навеждалия	Masculine
арабската	Feminine
жълтото	Neuter
съобщаване	Neuter
мечтае	None
простите	None
извличане	Neuter
плащайте	None
коронясана	Feminine
здрава	Feminine
изгубено	Neuter
обсъдено	Neuter
избирането	Neuter
прощаваш	None
пръчките	None
чел	Masculine
умното	Neuter
жестокия	Masculine
най-модерния	Masculine
глупаво	Neuter
писания	Masculine
облекат	None
принасянето	Neuter
кокошето	Neuter
създали	None
наказвали	None
наболият	Masculine
обзавеждане	Neuter
австралийска	Feminine
интересно	Neuter
сравнена	Feminine
по-авиаторският	Masculine
злия	Masculine
наеми	None
века	None
насичаната	Feminine
чиста	Feminine
гладна	Feminine
повлечено	Neuter
подвеждани	None
най-свръхестествени	Masculine
отключил	Masculine
течността	None
пристигане	Neuter
смазани	None
извличаща	Feminine
документът	None
по-сребърния	Masculine
бащите	None
несериозна	Feminine
вземания	Masculine
сечен	Masculine
решаващата	Feminine
наричано	Neuter
пеперудо	None
изчезващия	Masculine
кукувиче	Neuter
билата	Feminine
пеещите	None
създаваната	Feminine
храбри	Masculine
окрадващ	Masculine
помагане	Neuter
пътуващият	Masculine
грешили	None
глобил	Masculine
бомбардиращ	Masculine
сърцето	None
трева	None
заченат	Masculine
обличащото	Neuter
станат	None
губещата	Feminine
мазането	Neuter
разумното	Neuter
чистата	Feminine
авантюристката	None
доплела	Feminine
красивите	None
построилият	Masculine
тъмносиня	Feminine
заповядваният	Masculine
ставащият	Masculine
изнесе	None
заслужавалият	Masculine
оцветената	Feminine
речник	None
несъмнени	Masculine
по-бистрата	Feminine
ягодов	Masculine
аморфно	Neuter
наела	Feminine
уплашено	Neuter
югоизточно	Neuter
изкусен	Masculine
по-бившият	Masculine
врабчето	Neuter
най-саркастичен	Masculine
най-верните	None
по-неважният	Masculine
търсене	Neuter
най-гърдести	Masculine
краденето	Neuter
произнесена	Feminine
антико	None
рязката	None
аналитична	Feminine
по-саркастичният	Masculine
затичащата	Feminine
по-отвесна	Feminine
плътния	Masculine
мечтаейки	None
гвоздей	None
студентският	Masculine
най-топла	Feminine
решат	None
авторския	Masculine
сияещ	Masculine
близкия	Masculine
коминът	None
по-азотисто	Neuter
неголямо	Neuter
убиват	None
действителното	Neuter
пристигнаха	None
облечен	Masculine
югоизточната	Feminine
пушене	Neuter
по-влажният	Masculine
надвнеслия	Masculine
обезсмъртяването	Neuter
мечката	None
танцували	None
най-пълния	Masculine
модерни	Masculine
аналитичното	Neuter
ялова	Feminine
интересния	Masculine
осиновен	Masculine
хомосексуалния	Masculine
разболявана	Feminine
препоръчвания	Masculine
дюлята	None
ограничил	Masculine
крака	None
най-близко	Neuter
обесена	Feminine
избраният	Masculine
подкупен	Masculine
стадиона	None
сярната	Feminine
съвършен	Masculine
племенник	None
нога	None
слънчевата	Feminine
азиатската	Feminine
противничките	None
отнасянето	Neuter
заплетено	Neuter
опасващи	None
спряна	Feminine
залязването	Neuter
рачещото	Neuter
одобрявали	None
слязат	None
би	None
азбестов	Masculine
интелигентни	Masculine
беднякът	None
лукавата	Feminine
фонемата	None
изплитащия	Masculine
произлизат	None
играл	Masculine
създадения	Masculine
влизащите	None
привнасяният	Masculine
произнесла	Feminine
рачел	Masculine
правителственото	Neuter
спеклия	Masculine
най-порнографичното	Neuter
упрекнат	Masculine
белодробна	Feminine
най-тесния	Masculine
по-действителния	Masculine
учело	Neuter
боя	None
събираеми	None
опридащия	Masculine
коч	None
алчни	Masculine
нозете	None
отварящата	Feminine
навела	Feminine
хамбургер	None
изтичам	None
заспят	None
получавам	None
забравяща	Feminine
опиращо	Neuter
плетена	Feminine
пренесената	Feminine
най-възголямо	Neuter
бият	None
отвеждалият	Masculine
доен	Masculine
пречупваща	Feminine
важно	Neuter
иконите	None
най-безгрижен	Masculine
купувахте	None
лилавото	Neuter
зърната	None
комарът	None
написала	Feminine
закупения	Masculine
по-серният	Masculine
несъмнен	Masculine
навестилият	Masculine
гълъби	None
подслушвалата	Feminine
авантюристко	None
поднесената	Feminine
новият	Masculine
автоматичния	Masculine
простено	Neuter
наказвано	Neuter
изведено	Neuter
пушеща	Feminine
принудила	Feminine
по-анонимното	Neuter
аметист	None
бита	Feminine
изпивалото	Neuter
създаден	Masculine
отвличащ	Masculine
най-азотен	Masculine
земетръсни	Masculine
протичането	Neuter
по-злата	Feminine
болногледачка	None
създалият	Masculine
голям	Masculine
казващо	Neuter
поднесено	Neuter
взимането	Neuter
бас	None
получена	Feminine
рачило	Neuter
сръбска	Feminine
пристигнала	Feminine
най-отличния	Masculine
превоз	None
сечащия	Masculine
най-алтова	Feminine
грозният	Masculine
замиране	Neuter
изкусните	None
почетена	Feminine
сладки	Masculine
закупена	Feminine
получената	Feminine
убиващи	None
комунистки	None
аскер	None
подпират	None
заслужаващ	Masculine
тъпата	Feminine
най-светлосини	Masculine
стършелите	None
плашещ	Masculine
бронтозавъра	None
пристигнат	None
комбиниралото	Neuter
чела	Feminine
миша	Feminine
повлечаха	None
по-анасонови	Masculine
авторитарни	Masculine
по-неловко	Neuter
пушеното	Neuter
удовлетворило	Neuter
най-плътни	Masculine
подкупете	None
сивото	Neuter
искрите	None
варварското	Neuter
посъветван	Masculine
изнесена	Feminine
по-антипартийното	Neuter
най-порнографските	None
провиращ	Masculine
комбиниралата	Feminine
реални	Masculine
мястото	None
потъването	Neuter
поопичащи	None
автентичните	None
навлезлия	Masculine
изтичалият	Masculine
възлизаща	Feminine
пращан	Masculine
целият	Masculine
извеждането	Neuter
куче	Neuter
австрийският	Masculine
произнесеното	Neuter
десетата	Feminine
виното	None
заречете	None
светлосин	Masculine
анална	Feminine
най-болната	Feminine
най-италианският	Masculine
полудея	None
обичалата	Feminine
пуйча	Feminine
по-лекарският	Masculine
питаш	None
очаквания	Masculine
стрехи	None
черно	Neuter
спиралото	Neuter
наивен	Masculine
аборигенско	Neuter
зареждания	Masculine
вертолетите	None
гигалитъра	None
най-изкусният	Masculine
ухапвалият	Masculine
допринасянията-нетата	None
авторитарната	Feminine
обосноваването	Neuter
получил	Masculine
пречупени	None
забранял	Masculine
гласуване	Neuter
анатемосваният	Masculine
четейки	None
банкрут	None
зачената	Feminine
по-млад	Masculine
сърните	None
лисугерите	None
разхожданият	Masculine
батарейната	Feminine
студената	Feminine
умелият	Masculine
облечаха	None
шеста	Feminine
търсим	None
желязото	None
убития	Masculine
най-старият	Masculine
дребен	Masculine
по-енергични	Masculine
по-здравият	Masculine
отвеждаща	Feminine
горящ	Masculine
обещаващ	Masculine
намерения	None
желаните	None
будят	None
студентко	None
хубав	Masculine
ялият	Masculine
влезеш	None
най-бавничкият	Masculine
потресях	None
говорения	Masculine
припичано	Neuter
молещ	Masculine
навелият	Masculine
пречупване	Neuter
начиталия	Masculine
гребна	Feminine
подписвайки	None
автобуса	None
по-ароматната	Feminine
състезателите	None
наизлязох	None
опрялото	Neuter
очната	Feminine
австралийка	None
зеления	Masculine
най-състезателно	Neuter
преподавателско	Neuter
визата	None
силното	Neuter
анатомичният	Masculine
слънца	None
абонатите	None
хубавото	Neuter
по-слънчево	Neuter
ученички	None
по-студената	Feminine
загинела	Feminine
слизането	Neuter
полудели	None
нисшето	Neuter
поизмитащия	Masculine
интересували	None
извеждаща	Feminine
адресираният	Masculine
испанско	Neuter
несериозно	Neuter
начитането	Neuter
пренасяна	Feminine
ставащото	Neuter
овена	None
фениксът	None
западният	Masculine
анасонова	Feminine
ранил	Masculine
воден	Masculine
режещата	Feminine
построеният	Masculine
топъл	Masculine
сечели	None
дръзкият	Masculine
най-тясното	Neuter
добрата	Feminine
съществувалият	Masculine
юнакините	None
отичане	Neuter
алено	Neuter
подобрят	None
уста	None
предсказваният	Masculine
почитане	Neuter
тухли	None
бедно	Neuter
спестеният	Masculine
напредващата	Feminine
назоваващ	Masculine
ръцете	None
състезателни	Masculine
дал	Masculine
по-широкото	Neuter
потушил	Masculine
отсичане	Neuter
граничехме	None
осиновяващия	Masculine
опирането	Neuter
потушава	None
неопитния	Masculine
удовлетворявано	Neuter
млад	Masculine
умрелите	None
южняшките	None
изсичам	None
силата	None
бомбардиращата	Feminine
дъвкало	Neuter
влажен	Masculine
лекомислената	Feminine
лекомисленото	Neuter
арменката	None
поизмитаното	Neuter
куча	Feminine
озадачаваща	Feminine
опитният	Masculine
засичащия	Masculine
уволняване	Neuter
ненадеждният	Masculine
анонимните	None
цял	Masculine
засичане	Neuter
причинено	Neuter
привнесени	None
запичаната	Feminine
биещ	Masculine
закупите	None
сръчно	Neuter
гласуваш	None
навлязло	Neuter
ушито	Neuter
чудесен	Masculine
акробатка	None
купуването	Neuter
по-белодробната	Feminine
ябълката	None
аероснимки	None
обещаващата	Feminine
наследявана	Feminine
създаденият	Masculine
осъществимият	Masculine
чуваното	Neuter
по-очната	Feminine
обещавано	Neuter
заричаната	Feminine
креативно	Neuter
азотното	Neuter
азиатското	Neuter
зачитаната	Feminine
танцувам	None
клада	None
демокрациите	None
отречаха	None
обещала	Feminine
порнографичен	Masculine
бито	Neuter
обсъдил	Masculine
попитваше	None
спирането	Neuter
петата	Feminine
светлосиния	Masculine
завличаше	None
наричана	Feminine
по-лукава	Feminine
заспала	Feminine
живеещата	Feminine
поизмиталия	Masculine
обилни	Masculine
активната	Feminine
запиращ	Masculine
черният	Masculine
протести	None
изгубилият	Masculine
най-абисинската	Feminine
принесен	Masculine
прелъстявайки	None
словата	None
глобяващ	Masculine
безбройната	Feminine
активна	Feminine
забравила	Feminine
хапел	Masculine
болна	Feminine
доблестно	Neuter
озадачаващи	None
навестява	None
по-абонаментното	Neuter
боят	None
пишещата	Feminine
можещата	Feminine
поотечем	None
наричащ	Masculine
най-студеното	Neuter
ушиващият	Masculine
будете	None
дометете	None
протичайки	None
изплетената	Feminine
подробната	Feminine
пристигащите	None
запален	Masculine
изчезна	None
пътуващия	Masculine
слончета	None
най-азотистият	Masculine
голямо	Neuter
изпрелия	Masculine
най-осмо	Neuter
зрялото	Neuter
захапала	Feminine
най-близки	Masculine
най-недостатъчният	Masculine
различна	Feminine
обичано	Neuter
най-красиви	Masculine
принесат	None
желязна	Feminine
красивият	Masculine
по-неразсъдително	Neuter
почитаните	None
кукувичето	Neuter
визитка	None
зидарите	None
по-големият	Masculine
вождове	None
търсещ	Masculine
уволнява	None
затичащо	Neuter
пчелояд	None
парадоксалното	Neuter
нанесеното	Neuter
по-недовряла	Feminine
пия	None
напитките	None
висша	Feminine
вдишване	Neuter
по-авгиев	Masculine
простиращ	Masculine
свиращия	Masculine
надонесеният	Masculine
лекомислено	Neuter
ставането	Neuter
аплодирана	Feminine
надонасялото	Neuter
заплашила	Feminine
получаващия	Masculine
съществуваха	None
сръбските	None
пестил	Masculine
дълбока	Feminine
запечен	Masculine
войводата	None
втечнена	Feminine
вършеещото	Neuter
дебел	Masculine
донеса	None
завел	Masculine
изпълнимия	Masculine
избоденото	Neuter
тъжната	Feminine
ножовете	None
пишело	Neuter
слоница	None
продължа	None
обичаният	Masculine
отрицателната	Feminine
изкупила	Feminine
преди	None
съветвалия	Masculine
отричаща	Feminine
северозападен	Masculine
по-хепатален	Masculine
яловият	Masculine
най-зелената	Feminine
болния	Masculine
забравяния-нета	None
сериозно	Neuter
тесния	Masculine
ниви	None
най-практичното	Neuter
изнудите	None
най-яйцевидни	Masculine
запалилата	Feminine
ухапването	Neuter
разбиран	Masculine
превъзнесели	None
амвони	None
запирания	Masculine
интересувахме	None
по-чешкото	Neuter
третия	Masculine
безскрупулно	Neuter
враните	None
най-хомосексуалния	Masculine
загубилият	Masculine
наказано	Neuter
аларменият	Masculine
най-словенска	Feminine
съгласна	Feminine
ядосана	Feminine
работилото	Neuter
касапинът	None
довличане	Neuter
изплете	None
спестявам	None
ученика	None
полукълбото	None
безалкохолна	Feminine
препоръчвана	Feminine
решена	Feminine
превъзнесеното	Neuter
подчертаваме	None
ароматичните	None
автоматичният	Masculine
градини	None
забождането	Neuter
посетил	Masculine
шибаме	None
храсте	None
водоравни	Masculine
некадърния	Masculine
най-бърз	Masculine
влажно	Neuter
кратка	Feminine
изсечена	Feminine
белгиеца	None
сравнявали	None
желае	None
най-отровно	Neuter
инвестиралия	Masculine
по-източният	Masculine
покрива	None
намерение	None
осиновил	Masculine
новата	Feminine
арапина	None
влюбванията-нетата	None
зидарка	None
анархия	None
решен	Masculine
използвах	None
олигарх	None
продавачи	None
пуйката	None
разбран	Masculine
упреквате	None
посещаваният	Masculine
отнасяната	Feminine
спиране	Neuter
заслужаващо	Neuter
агробиолога	None
победения	Masculine
въвличаната	Feminine
въоръженият	Masculine
създалата	Feminine
храни	None
топло	Neuter
решиш	None
удовлетворилият	Masculine
запалила	Feminine
най-агитационния	Masculine
внимателни	Masculine
кокоше	Neuter
причиняваща	Feminine
простели	None
най-възсиньо	Neuter
сложени	Masculine
метеорите	None
бесещия	Masculine
изсечен	Masculine
по-скъп	Masculine
състезателна	Feminine
западен	Masculine
тежка	Feminine
запалки	None
прочетените	None
губещ	Masculine
плащан	Masculine
деляла	Feminine
съвършеният	Masculine
четял	Masculine
абсорбираща	Feminine
сядали	None
пето	Neuter
пристигналите	None
потресени	None
можехме	None
моркова	None
запрян	Masculine
комбинира	None
по-западна	Feminine
изминалите	None
озаглавилото	Neuter
въоръжава	None
чобани	None
забравяй	None
получилият	Masculine
касапите	None
неверни	Masculine
уплашен	Masculine
апетит	None
искрената	Feminine
мраз	None
ранения	Masculine
боядисано	Neuter
счупения	Masculine
учих	None
по-безразсъдния	Masculine
сребърната	Feminine
интересни	Masculine
алвеоло	None
осмия	Masculine
силния	Masculine
забравям	None
грижливо	Neuter
вярващо	Neuter
отхапващото	Neuter
очаквана	Feminine
въвирането	Neuter
картите	None
писателската	Feminine
строящата	Feminine
въоръжена	Feminine
челата	Feminine
златни	Masculine
благодарящо	Neuter
сраната	Feminine
най-акуратна	Feminine
прочетен	Masculine
разпростира	None
жълти	Masculine
изпитани	None
изминалия	Masculine
невярна	Feminine
повторило	Neuter
принасящият	Masculine
разумни	Masculine
станал	Masculine
авангардния	Masculine
лятна	Feminine
озадачавалото	Neuter
зебрата	None
вероятност	None
авгиеви	Masculine
пясъкът	None
по-шестото	Neuter
по-водоравната	Feminine
студентстващото	Neuter
продължения	Masculine
създаването	Neuter
предупреждаваща	Feminine
светлосиньо	Neuter
по-безидейният	Masculine
напредваме	None
слушането	Neuter
оцветено	Neuter
плаших	None
сребърният	Masculine
здрави	Masculine
изпитаните	None
лилаво	Neuter
почитащ	Masculine
поднесяха	None
корабът	None
педя	None
мазан	Masculine
навлизащата	Feminine
охраняван	Masculine
най-старата	Feminine
овце	None
пренасящ	Masculine
горящо	Neuter
поведе	None
произнасяхме	None
превеждано	Neuter
затрисалия	Masculine
инфантилна	Feminine
по-хепаталната	Feminine
продължено	Neuter
души	None
строената	Feminine
атомния	Masculine
зареждахте	None
пялата	Feminine
казват	None
говорен	Masculine
богини	None
абдикиращото	Neuter
убиван	Masculine
вземайте	None
използващо	Neuter
очаквано	Neuter
по-голямото	Neuter
посещавано	Neuter
шестият	Masculine
вдишван	Masculine
помелата	Feminine
щастливата	Feminine
арбитърът	None
най-ялова	Feminine
авторитарния	Masculine
могла	Feminine
героини	None
по-оскъдния	Masculine
въвлечена	Feminine
коремния	Masculine
скъпата	Feminine
фургон	None
наука	None
поднеслите	None
по-южняшката	Feminine
по-хоризонтално	Neuter
далечен	Masculine
дебелия	Masculine
борби	None
подписаният	Masculine
сериозен	Masculine
донасящ	Masculine
преподавателската	Feminine
любезният	Masculine
гласуват	None
обосновавана	Feminine
азербайджанците	None
отвеждано	Neuter
верният	Masculine
ортогоналната	Feminine
обилният	Masculine
довличането	Neuter
превъзнесеният	Masculine
токсични	Masculine
гласувам	None
припрения	Masculine
обсъждана	Feminine
звездо	None
отварящ	Masculine
превозите	None
най-северозападна	Feminine
повтарящата	Feminine
предпазлива	Feminine
шведския	Masculine
прощаване	Neuter
бесилото	Neuter
по-бързият	Masculine
еластичната	Feminine
изминавания	Masculine
лихви	None
криле	None
изговаряте	None
загиването	Neuter
овчаря	None
легализирахме	None
подслушващата	Feminine
препоръчваща	Feminine
заподозирания-нета	None
кучки	None
плашела	Feminine
влакове	None
казало	Neuter
обосноваващата	Feminine
съвременно	Neuter
ходилия	Masculine
азиатският	Masculine
най-низш	Masculine
най-мускулни	Masculine
таралежите	None
губещо	Neuter
попитваща	Feminine
изведена	Feminine
лесове	None
заплетена	Feminine
турският	Masculine
компетентната	Feminine
продажба	None
уволнения	Masculine
по-умелото	Neuter
абаносовата	Feminine
наранявания	Masculine
метенето	Neuter
най-батерийния	Masculine
най-белодробното	Neuter
осиновеният	Masculine
загубила	Feminine
отключилото	Neuter
благославя	None
дяволско	Neuter
препрочитащото	Neuter
обучаване	Neuter
агнета	None
разболяла	Feminine
университете	None
правели	None
загинало	Neuter
свръхестествената	Feminine
сериозна	Feminine
наранено	Neuter
най-неумело	Neuter
шестото	Neuter
червеният	Masculine
закупила	Feminine
използваща	Feminine
писателска	Feminine
отсъствали	None
очен	Masculine
питана	Feminine
обяснявайте	None
яка	Feminine
любителската	Feminine
ортогонални	Masculine
питите	None
котва	None
стандарте	None
изплела	Feminine
потъналото	Neuter
молел	Masculine
атинянката	None
слоновете	None
изгубило	Neuter
решителни	Masculine
спестяват	None
вярване	Neuter
по-червена	Feminine
подписана	Feminine
капи	None
понесен	Masculine
умели	Masculine
дързък	Masculine
докторе	None
запалвайки	None
планина	None
изпичано	Neuter
досадни	Masculine
победилите	None
по-близката	Feminine
абстрактните	None
допринесат	None
мрежа	None
спрения	Masculine
повеждалото	Neuter
продажбеният	Masculine
преподавателското	Neuter
отвеждащия	Masculine
източният	Masculine
ставаха	None
бъбрекът	None
врящо	Neuter
умирането	Neuter
избрала	Feminine
благословях	None
отсъстващия	Masculine
загиналия	Masculine
отвела	Feminine
помагат	None
абдукцията	None
пълни	Masculine
боята	None
по-портокаловото	Neuter
княгини	None
биографии	None
обезглавявана	Feminine
състезателно	Neuter
подслушаният	Masculine
по-болничката	Feminine
писателския	Masculine
най-интересна	Feminine
безмилостното	Neuter
докажело	Neuter
сраженията	None
анатомично	Neuter
делящ	Masculine
вертикалният	Masculine
по-низш	Masculine
отчел	Masculine
писа	None
автономии	None
отваряне	Neuter
умиращата	Feminine
уплашилия	Masculine
решило	Neuter
търсела	Feminine
лявото	Neuter
баса	None
анатомична	Feminine
преде	None
наивната	Feminine
по-дребна	Feminine
създаваше	None
съвършения	Masculine
по-безаварийният	Masculine
опиращ	Masculine
влизаш	None
най-безгрижно	Neuter
осиновения	Masculine
оцветен	Masculine
изтичащите	None
провирате	None
лихвата	None
вертикално	Neuter
почвалият	Masculine
заспиване	Neuter
източния	Masculine
оцветяване	Neuter
пратен	Masculine
гущера	None
напреднало	Neuter
отмиране	Neuter
портокалови	Masculine
нанесена	Feminine
пречупена	Feminine
допечала	Feminine
можахме	None
чаплите	None
по-топлият	Masculine
прегърнати	None
най-арабският	Masculine
инвестирали	None
подкладен	Masculine
танцуващ	Masculine
живеещият	Masculine
сериозната	Feminine
скубело	Neuter
губила	Feminine
заплашил	Masculine
подпиране	Neuter
оцветят	None
тигърът	None
разболял	Masculine
принесъл	Masculine
по-азотният	Masculine
грижлива	Feminine
закупувани	None
най-смелия	Masculine
най-ароматичен	Masculine
космата	Feminine
купят	None
най-непокътнат	Masculine
серен	Masculine
попитано	Neuter
благородни	Masculine
посетих	None
живяло	Neuter
почитаща	Feminine
съчетаел	Masculine
граничели	None
абсурден	Masculine
потъналата	Feminine
креативната	Feminine
по-любителската	Feminine
отровни	Masculine
нанасялото	Neuter
подобни	Masculine
капалия	Masculine
очаква	None
прозираш	None
лед	None
унасяната	Feminine
отровният	Masculine
мускул	None
реалистични	Masculine
досадното	Neuter
изгубвайки	None
оцеляло	Neuter
телескопи	None
доверчив	Masculine
бременна	Feminine
интересният	Masculine
наведен	Masculine
кореместото	Neuter
зачеване	Neuter
амбициозната	Feminine
чайка	None
пилото	Neuter
започнало	Neuter
понесъл	Masculine
ковчеже	None
второразредни	Masculine
най-червения	Masculine
ароматично	Neuter
арсенали	None
руският	Masculine
по-евтиният	Masculine
ниво	None
смело	Neuter
надонесохте	None
най-първоразрядната	Feminine
разбрания	Masculine
по-разумно	Neuter
плачещи	None
разстоянията	None
яребиците	None
излязъл	Masculine
птиците	None
най-неразсъдлива	Feminine
разболявания	Masculine
сраното	Neuter
обучено	Neuter
безбрачието	None
простираното	Neuter
по-отрицателния	Masculine
значителен	Masculine
излезем	None
анонимното	Neuter
смазването	Neuter
започнат	Masculine
спиращ	Masculine
действие	None
изговарящо	Neuter
единадесетата	Feminine
най-акуратни	Masculine
кратък	Masculine
даващ	Masculine
чешката	Feminine
изчезнеш	None
влязъл	Masculine
ватове	None
по-активни	Masculine
ъгълът	None
забравеният	Masculine
изчезващата	Feminine
най-болничко	Neuter
доказа	None
произлязъл	Masculine
допринасящ	Masculine
грозен	Masculine
агрегатна	Feminine
искали	None
навежда	None
възголямото	Neuter
понесла	Feminine
друг	Masculine
наследилата	Feminine
шведското	Neuter
най-актуална	Feminine
изплашеният	Masculine
наркоманите	None
донесло	Neuter
модификации	None
изпеклото	Neuter
уши	None
цялото	Neuter
осъществим	Masculine
поотеклият	Masculine
удовлетворяването	Neuter
наказалият	Masculine
подчертания	Masculine
мечтая	None
отрицателния	Masculine
ограничаването	Neuter
живя	None
преживявано	Neuter
уплашената	Feminine
писателско	Neuter
северно	Neuter
сечена	Feminine
доблестни	Masculine
най-мишето	Neuter
прозираха	None
боите	None
обзаведената	Feminine
наричане	Neuter
ангелска	Feminine
зашиело	Neuter
наследяване	Neuter
наводняването	Neuter
лекомислена	Feminine
квадрата	None
причинена	Feminine
закусилата	Feminine
най-неблагоразумното	Neuter
протичаща	Feminine
ураган	None
изминало	Neuter
пята	Feminine
стомашна	Feminine
попекохте	None
по-несъмнен	Masculine
североизточно	Neuter
мразил	Masculine
убитата	Feminine
убиец	None
езикът	None
коремести	Masculine
по-италианското	Neuter
любознателни	Masculine
купен	Masculine
почитаната	Feminine
извеждане	Neuter
по-студен	Masculine
по-арабското	Neuter
по-анално	Neuter
гълъбът	None
полученото	Neuter
влъхви	None
албанците	None
реалния	Masculine
изоравания	Masculine
получилия	Masculine
добри	Masculine
благословят	None
безформени	Masculine
порнографския	Masculine
стремена	None
цунамито	None
вярваме	None
шибам	None
плод	None
водна	Feminine
най-стомашния	Masculine
изплашвахме	None
заповядайте	None
най-прекрасното	Neuter
строения	Masculine
запалено	Neuter
надеждна	Feminine
даденият	Masculine
сонети	None
евтиният	Masculine
опичаха	None
бомбардират	None
низшите	None
патици	None
алената	Feminine
ходещ	Masculine
мълниите	None
анатемите	None
наследяването	Neuter
арменската	Feminine
предплащане	Neuter
жестоки	Masculine
по-сеизмична	Feminine
аналозите	None
вода	None
атомни	Masculine
вярвате	None
чудесния	Masculine
вдишвалото	Neuter
унищожаващото	Neuter
умиращ	Masculine
изпяла	Feminine
разбирано	Neuter
надеждни	Masculine
коритата	None
подслушайте	None
най-абсурден	Masculine
бия	None
ползвана	Feminine
запеченият	Masculine
оцветяваната	Feminine
македонския	Masculine
препоръчат	None
най-млечнобелият	Masculine
управителя	None
близано	Neuter
повличането	Neuter
внимателно	Neuter
победена	Feminine
по-козият	Masculine
охраняваната	Feminine
комерсиалния	Masculine
благ	Masculine
мускулестата	Feminine
бактерийна	Feminine
глоби	None
сомът	None
действителен	Masculine
довлечена	Feminine
мечтали	None
най-оскъден	Masculine
изкусна	Feminine
бавничко	Neuter
оцветяваното	Neuter
мела	Feminine
водоравна	Feminine
узаконяването	Neuter
ловка	Feminine
коронясалият	Masculine
наричания	Masculine
най-порнографични	Masculine
подклажданите	None
бушуваща	Feminine
допрочитаното	Neuter
могло	Neuter
загубването	Neuter
решените	None
прилагателното	None
подвеждане	Neuter
актьора	None
практичното	Neuter
попичащия	Masculine
наследил	Masculine
падалото	Neuter
автомобилостроене	None
алчната	Feminine
авантюристе	None
перпендикулярното	Neuter
антрополога	None
изпят	Masculine
способно	Neuter
очакваната	Feminine
раняване	Neuter
красивото	Neuter
мечтала	Feminine
попитана	Feminine
съветвам	None
обезглавяван	Masculine
аварийното	Neuter
плашило	Neuter
напредването	Neuter
по-северното	Neuter
зъболекарско	Neuter
раненият	Masculine
чакане	Neuter
играела	Feminine
презиран	Masculine
обезсмъртилия	Masculine
възпирана	Feminine
бивша	Feminine
любопитния	Masculine
млади	Masculine
правителства	None
смазвам	None
земетръсна	Feminine
бързата	Feminine
поведено	Neuter
бебе	None
набождащ	Masculine
безгрижното	Neuter
некадърни	Masculine
най-правителствената	Feminine
ножици	None
подчертаната	Feminine
ароматно	Neuter
повтаряне	Neuter
чествалото	Neuter
десетият	Masculine
привнесена	Feminine
мечта	None
ометяло	Neuter
полудял	Masculine
по-североизточните	None
конопа	None
вещата	Feminine
обесвали	None
доказано	Neuter
подобриха	None
привнесен	Masculine
вестник	None
подкупваният	Masculine
по-досадният	Masculine
пращане	Neuter
заплашвана	Feminine
вертикална	Feminine
започнал	Masculine
правехме	None
решаващо	Neuter
шибан	Masculine
тънки	Masculine
телбод	None
валидни	Masculine
понапичани	None
учтив	Masculine
ограничавани	None
по-серни	Masculine
умиращият	Masculine
устите	None
изнесло	Neuter
уплашеният	Masculine
светла	Feminine
порнографските	None
най-естетичния	Masculine
гълъбица	None
най-любезният	Masculine
креативния	Masculine
дръзкото	Neuter
сечението	None
гръдния	Masculine
ударникът	None
врели	None
изплашил	Masculine
несъмнена	Feminine
играеха	None
отчетено	Neuter
учените	None
носът	None
изнудилото	Neuter
ходило	Neuter
цица	None
анонимната	Feminine
изнасяно	Neuter
обезсмъртен	Masculine
по-хомосексуалният	Masculine
обучила	Feminine
получавана	Feminine
монарси	None
казвах	None
бегъл	Masculine
ученият	Masculine
събуден	Masculine
отхапването	Neuter
написа	None
отключила	Feminine
понеса	None
посещаване	Neuter
събудена	Feminine
дланите	None
преживях	None
горила	Feminine
сънуването	Neuter
бактериен	Masculine
спиран	Masculine
излез	None
мъртъв	Masculine
гневно	Neuter
стомашен	Masculine
генералите	None
раняван	Masculine
хектолитра	None
диньо	None
изпети	None
вечер	None
по-кукувичият	Masculine
най-далечната	Feminine
сладкия	Masculine
преживян	Masculine
съзреният	Masculine
досадният	Masculine
сохо	None
присъства	None
господарката	None
влизане	Neuter
разбрахме	None
бившето	Neuter
проповедта	None
автоголове	None
сигурната	Feminine
новото	Neuter
даването	Neuter
наоблеченият	Masculine
пят	Masculine
режещия	Masculine
сивия	Masculine
цялата	Feminine
зареди	None
австралийският	Masculine
небесносини	Masculine
амнистиите	None
смазване	Neuter
преден	Masculine
авторите	None
отчитащ	Masculine
инфаркта	None
порто	None
отнеслата	Feminine
повторил	Masculine
разнасяне	Neuter
северозападно	Neuter
пътуването	Neuter
подпряхме	None
авансирания-нета	None
азбучното	Neuter
подобрената	Feminine
плащането	Neuter
североизточна	Feminine
принасяне	Neuter
втечнен	Masculine
слънчевото	Neuter
препоръчано	Neuter
назоваващия	Masculine
донесял	Masculine
наречената	Feminine
оцветеното	Neuter
избере	None
понапичат	None
непрякото	Neuter
произтичащо	Neuter
агитпропчикът	None
спасеният	Masculine
загубиш	None
решеният	Masculine
наречения	Masculine
зачеването	Neuter
произтекоха	None
озадачавалия	Masculine
измирането	Neuter
заплашващ	Masculine
по-топла	Feminine
създаван	Masculine
по-абдоминално	Neuter
прочитането	Neuter
най-щастливите	None
извеждалият	Masculine
присъстващо	Neuter
писателстващият	Masculine
продажби	None
забраняващата	Feminine
внимателното	Neuter
работело	Neuter
заметоха	None
близичкото	Neuter
бездейното	Neuter
принесения	Masculine
царя	None
пял	Masculine
арменското	Neuter
анонимни	Masculine
бактериалния	Masculine
по-кратки	Masculine
неголемият	Masculine
ограничения	Masculine
разбирани	None
мъдро	Neuter
протичащо	Neuter
броненосеца	None
сапунът	None
по-кравя	Feminine
заподозряна	Feminine
потресен	Masculine
медицинското	Neuter
отвесна	Feminine
понапичаните	None
краля	None
водоравната	Feminine
вероятното	Neuter
въоръжете	None
врабче	Neuter
ползването	Neuter
наизлизам	None
испанският	Masculine
изслушвания	Masculine
героините	None
получен	Masculine
изгубихме	None
най-ароматна	Feminine
предсказания	Masculine
нисшите	None
оцелее	None
погледната	Feminine
авторство	None
наказването	Neuter
навира	None
автоматична	Feminine
допринасящите	None
тъжния	Masculine
бодър	Masculine
съчетала	Feminine
подписало	Neuter
играещо	Neuter
принуждава	None
анатемосаното	Neuter
благословената	Feminine
извличат	None
стомашно	Neuter
поизмитащ	Masculine
будел	Masculine
третият	Masculine
глава	None
ранила	Feminine
пасяла	Feminine
господарската	Feminine
благодарила	Feminine
оцелявали	None
интересувалото	Neuter
каже	None
обезглавяването	Neuter
почитайки	None
белодробната	Feminine
потъналия	Masculine
купуван	Masculine
несъмненото	Neuter
чупел	Masculine
сврени	None
забранила	Feminine
батареен	Masculine
курви	None
зрялата	Feminine
подвеждащата	Feminine
понапичахме	None
кривият	Masculine
неопитна	Feminine
анатемосвания	Masculine
чупила	Feminine
сокола	None
продължило	Neuter
изгубеното	Neuter
по-яката	Feminine
сръчен	Masculine
сок	None
интелигентната	Feminine
аристокрации	None
любезен	Masculine
поспиращо	Neuter
слаби	Masculine
австрийската	Feminine
охраняват	None
въвлечено	Neuter
австрийско	Neuter
наплитащата	Feminine
безалкохолни	Masculine
изминатият	Masculine
най-кореместите	None
обвиниш	None
плешиви	Masculine
пеещ	Masculine
преживяла	Feminine
загинал	Masculine
литра	None
плачете	None
лековерен	Masculine
дивия	Masculine
замрялото	Neuter
северен	Masculine
широко	Neuter
по-свръхестественият	Masculine
прелъстяване	Neuter
адамов	Masculine
заповядано	Neuter
зашити	None
бавна	Feminine
арогантно	Neuter
написано	Neuter
по-слънчевият	Masculine
предричания	Masculine
заплашено	Neuter
победен	Masculine
най-парадоксален	Masculine
благородният	Masculine
слязла	Feminine
най-уклончив	Masculine
получило	Neuter
обречената	Feminine
главоболия	None
господарските	None
нанесло	Neuter
занеслия	Masculine
доведения	Masculine
посъветвана	Feminine
танцуваш	None
по-плешивият	Masculine
съвременният	Masculine
продължена	Feminine
гласовете	None
опрян	Masculine
доят	None
ухапал	Masculine
изпитващ	Masculine
дълга	Feminine
наивният	Masculine
най-любезен	Masculine
автентичен	Masculine
навестявалият	Masculine
портокалово	Neuter
раним	None
озаглавявания	Masculine
комбиниращо	Neuter
получения	Masculine
доказващ	Masculine
по-ненадеждното	Neuter
устни	None
говорещ	Masculine
болни	Masculine
абстрактен	Masculine
по-дребното	Neuter
по-нисшият	Masculine
извличането	Neuter
наизлизалото	Neuter
съветващата	Feminine
доказването	Neuter
най-античния	Masculine
уплашила	Feminine
космати	Masculine
унищоженият	Masculine
аргументи	None
търбуха	None
тока	None
полудее	None
баклава	None
бинокълът	None
привнасяше	None
косатка	None
закупувалото	Neuter
значителния	Masculine
наводнени	None
най-неразсъдливо	Neuter
чупенето	Neuter
непокътнато	Neuter
разпростирана	Feminine
германска	Feminine
захапело	Neuter
по-алтов	Masculine
недостатъчното	Neuter
лакът	None
чело	Neuter
по-сърдита	Feminine
залязващото	Neuter
причинявани	None
благословения	Masculine
поопечем	None
четеният	Masculine
бягащо	Neuter
докаже	None
адресирането	Neuter
ранявания	Masculine
използвали	None
пречупването	Neuter
некомпетентен	Masculine
по-дивият	Masculine
най-якия	Masculine
чернодробното	Neuter
възпираща	Feminine
чакането	Neuter
отхапани	None
набожда	None
четената	Feminine
смазващо	Neuter
опираме	None
амониеви	Masculine
адресираща	Feminine
реалистичното	Neuter
докажа	None
възможната	Feminine
сигурен	Masculine
албанско	Neuter
мечтаното	Neuter
студентът	None
пращалите	None
безстрашен	Masculine
запалваното	Neuter
легализирано	Neuter
комерсиално	Neuter
навлязъл	Masculine
разплаквани	None
неспособния	Masculine
посетено	Neuter
опираща	Feminine
зачитащото	Neuter
обричаното	Neuter
бактериални	Masculine
посетен	Masculine
доплитането	Neuter
антика	None
озадачахме	None
препоръчана	Feminine
лекции	None
въвлякло	Neuter
мишокът	None
припираният	Masculine
наема	None
сечало	Neuter
амониев	Masculine
желаният	Masculine
по-важна	Feminine
накладяха	None
истинно	Neuter
по-македонският	Masculine
свещ	None
актьорите	None
юнаците	None
граничил	Masculine
принудил	Masculine
прътовете	None
планините	None
птици	None
прясната	Feminine
хапете	None
озадачавалата	Feminine
правителствения	Masculine
създавалите	None
изговаряно	Neuter
истинни	Masculine
най-дребното	Neuter
изнасящо	Neuter
обвинявано	Neuter
евтин	Masculine
понапечал	Masculine
лели	None
наизлизащия	Masculine
по-коремен	Masculine
удовлетворена	Feminine
попеклият	Masculine
плътното	Neuter
донесено	Neuter
събудиха	None
вършалите	None
получаващите	None
лесното	Neuter
получавано	Neuter
подобряващ	Masculine
плащащата	Feminine
коремни	Masculine
изчезвалия	Masculine
изминава	None
разлюбван	Masculine
сладка	Feminine
най-болногледаческа	Feminine
пестилата	Feminine
длан	None
изминаваното	Neuter
отците	None
по-плешивото	Neuter
изкупената	Feminine
очния	Masculine
навеждан	Masculine
предпазливи	Masculine
потичащо	Neuter
казваща	Feminine
доплете	None
вертикални	Masculine
абаносовия	Masculine
болният	Masculine
басе	None
по-авансови	Masculine
лястовича	Feminine
жените	None
чисто	Neuter
паяка	None
чул	Masculine
избирали	None
отведено	Neuter
пресни	Masculine
деветият	Masculine
жълъди	None
автентичното	Neuter
звънците	None
алкохолната	Feminine
чистия	Masculine
слънчевия	Masculine
преживявали	None
решава	None
слабия	Masculine
надвнеслото	Neuter
ягодово	Neuter
втечнявалият	Masculine
молело	Neuter
работил	Masculine
третото	Neuter
отчитани	None
изпил	Masculine
искрена	Feminine
създадяла	Feminine
унасящо	Neuter
паси	None
казан	Masculine
заченато	Neuter
низшата	Feminine
изгубени	None
наследило	Neuter
бягайте	None
аперитивите	None
построяваме	None
по-грижлив	Masculine
подкупили	None
отвлечала	Feminine
пълното	Neuter
адамовия	Masculine
по-сврачата	Feminine
преживяло	Neuter
върша	None
вършеенето	Neuter
актрисата	None
яденето	Neuter
еластични	Masculine
високите	None
булите	None
най-яйцевидна	Feminine
завлечената	Feminine
обучените	None
можете	None
мреш	None
писателка	None
обучавайте	None
платеният	Masculine
железния	Masculine
нещастната	Feminine
златният	Masculine
висш	Masculine
най-докторското	Neuter
стани	None
заслужена	Feminine
пестенето	Neuter
щастливия	Masculine
спра	None
хапане	Neuter
пикаейки	None
жълта	Feminine
авансиращото	Neuter
заведеното	Neuter
единадесетия	Masculine
шесто	Neuter
одобрявам	None
шизофреници	None
умиращите	None
арменеца	None
изпяващият	Masculine
отвлечената	Feminine
опекла	Feminine
обещало	Neuter
интелигентните	None
довеждаща	Feminine
практичната	Feminine
приятелки	None
по-азотния	Masculine
яйцевидни	Masculine
горения-нета	None
облекли	None
майко	None
аморфната	Feminine
компетентността	None
измирания-нета	None
шибалото	Neuter
очаквалото	Neuter
най-немско	Neuter
монасите	None
ползване	Neuter
студентските	None
парадоксална	Feminine
сладък	Masculine
прелъстил	Masculine
лявата	Feminine
заплашван	Masculine
работа	None
произнасяща	Feminine
заслужело	Neuter
изпасваното	Neuter
строените	None
забранява	None
далия	Masculine
запалващ	Masculine
опитната	Feminine
интелигентния	Masculine
прясна	Feminine
обсъждане	Neuter
най-водоравна	Feminine
пренеса	None
олигарси	None
ограничило	Neuter
доблестния	Masculine
излизахте	None
предупредено	Neuter
узаконени	None
полудяла	Feminine
англичани	None
портокаловият	Masculine
пушено	Neuter
висшият	Masculine
падалия	Masculine
узаконявалата	Feminine
абстрактният	Masculine
скучния	Masculine
пасения-нета	None
опиралата	Feminine
безформено	Neuter
подклажда	None
живяното	Neuter
забраняваният	Masculine
написал	Masculine
по-яка	Feminine
врящата	Feminine
гъба	None
предрекъл	Masculine
предсказахте	None
протекъл	Masculine
по-сериозния	Masculine
прочела	Feminine
законите	None
ухапващ	Masculine
навлезли	None
болногледачите	None
плашещо	Neuter
слушахме	None
тресящо	Neuter
отвлякъл	Masculine
вре	None
възлите	None
най-бързичкият	Masculine
различно	Neuter
северната	Feminine
най-некомпетентен	Masculine
храброто	Neuter
разум	None
бедствия	None
вълко	None
скубещото	Neuter
моми	None
ползвани	None
отварят	None
абатския	Masculine
перпендикулярна	Feminine
обезсмъртена	Feminine
най-топлото	Neuter
най-бебешкия	Masculine
по-ябълковия	Masculine
пестилият	Masculine
оскъдното	Neuter
неверният	Masculine
обсъждаща	Feminine
по-интелигентна	Feminine
адаптации	None
преживени	None
по-реалистичният	Masculine
следобеди	None
водата	None
дребни	Masculine
горяща	Feminine
предсказваното	Neuter
надвнасялият	Masculine
тънката	Feminine
агрегатния	Masculine
нарека	None
начитащите	None
отчитаният	Masculine
изчезвали	None
непокътнат	Masculine
обясните	None
отричано	Neuter
гребната	Feminine
съчетаващият	Masculine
истинен	Masculine
изнесената	Feminine
наказания	Masculine
алчният	Masculine
неловки	Masculine
довличалия	Masculine
непоколебим	Masculine
болничко	Neuter
плета	None
най-продаваческата	Feminine
живееща	Feminine
най-анатомична	Feminine
щастливият	Masculine
най-истинен	Masculine
легализиращ	Masculine
по-азбучен	Masculine
аскера	None
ябълково	Neuter
заведен	Masculine
монахът	None
навиращото	Neuter
прощавам	None
полувисшия	Masculine
бременната	Feminine
ясният	Masculine
отрицателните	None
събудил	Masculine
по-кадърният	Masculine
наказал	Masculine
автомобилостроенето	None
немското	Neuter
пълния	Masculine
бойлер	None
даващо	Neuter
изоравано	Neuter
бясната	Feminine
създадената	Feminine
закусващия	Masculine
гениите	None
по-атомната	Feminine
по-железен	Masculine
наетото	Neuter
доказан	Masculine
предсказващото	Neuter
продължаващия	Masculine
начела	Feminine
отречените	None
бактерийните	None
полковници	None
македонският	Masculine
решителните	None
построяващото	Neuter
повярват	None
античен	Masculine
видри	None
доброто	Neuter
чистото	Neuter
алармени	Masculine
очакваното	Neuter
усилия	None
юнаци	None
подробен	Masculine
даван	Masculine
най-болният	Masculine
агрегатите	None
нишката	None
въвирахте	None
прелъстили	None
най-леката	Feminine
четящо	Neuter
имането	Neuter
девета	Feminine
принуждаваният	Masculine
обсъждан	Masculine
мъдрата	Feminine
обичана	Feminine
отричате	None
изслушалия	Masculine
одобрено	Neuter
купувана	Feminine
по-руско	Neuter
слушан	Masculine
чешка	Feminine
господин	None
карто	None
кацата	None
комерсиалната	Feminine
по-авиаторския	Masculine
моля	None
господарствува	None
микроорганизми	None
закусващият	Masculine
мечтаният	Masculine
по-детинският	Masculine
посещаващ	Masculine
позволителни	None
тъжни	Masculine
несериозната	Feminine
интересувам	None
наело	Neuter
учило	Neuter
по-слабия	Masculine
оскъдни	Masculine
разбрана	Feminine
коремна	Feminine
другото	Neuter
обещания	Masculine
ограничавайки	None
по-аналитичните	None
приятелю	None
обещано	Neuter
любопитни	Masculine
обезглавен	Masculine
суеверията	None
благодарих	None
изтеклите	None
сестрите	None
занесен	Masculine
бърз	Masculine
краищата	None
славен	Masculine
пилето	None
англичанка	None
кажат	None
вряната	Feminine
кучето	Neuter
отболата	Feminine
най-златния	Masculine
виненото	Neuter
повелите	None
медицинският	Masculine
подмитана	Feminine
проврени	None
по-сръбският	Masculine
активен	Masculine
пеперудата	None
повеждащата	Feminine
поднесло	Neuter
зареждащата	Feminine
най-млечнобялото	Neuter
изричали	None
зъболекарския	Masculine
обесване	Neuter
мъдрост	None
забравена	Feminine
енергичната	Feminine
удовлетворен	Masculine
боядисвах	None
обосноваване	Neuter
търсещи	None
наетия	Masculine
бесния	Masculine
автоматичните	None
патока	None
пития	Masculine
разбираме	None
пристигналата	Feminine
стар	Masculine
извлечахме	None
опитно	Neuter
съществуващите	None
по-решителни	Masculine
отчитано	Neuter
препоръчалия	Masculine
отбоденото	Neuter
актуалната	Feminine
славният	Masculine
моливите	None
възел	None
арестувана	Feminine
говорещия	Masculine
учила	Feminine
абсурдният	Masculine
вероятният	Masculine
хубаво	Neuter
античната	Feminine
обичате	None
кървене	Neuter
бебешките	None
аварското	Neuter
нанасян	Masculine
разплакван	Masculine
чайката	None
любителска	Feminine
по-сатанистичното	Neuter
по-авторитетният	Masculine
допринесло	Neuter
спирахме	None
построяването	Neuter
мъртва	Feminine
отхапал	Masculine
десния	Masculine
перпендикулярни	Masculine
говорено	Neuter
арабите	None
гласувано	Neuter
швейцарското	Neuter
актуалното	Neuter
попитани	None
присъстващият	Masculine
ножиците	None
срещано	Neuter
доказване	Neuter
докторските	None
хомосексуални	Masculine
умелото	Neuter
неспособното	Neuter
винило	Neuter
венеца	None
по-слаб	Masculine
възпиращи	None
ушивалото	Neuter
танцуващо	Neuter
лижат	None
най-сладко	Neuter
тесен	Masculine
комбиниране	Neuter
разболяло	Neuter
алуминиевата	Feminine
най-арменският	Masculine
момчето	None
виждана	Feminine
преподавателските	None
дяволския	Masculine
бялото	Neuter
чучулигата	None
по-мише	Neuter
давахме	None
босичките	None
мазане	Neuter
окрадена	Feminine
препрочитащ	Masculine
подпиралият	Masculine
пито	Neuter
арменският	Masculine
лесни	Masculine
реч	None
полудеел	Masculine
взвода	None
анасонови	Masculine
говореният	Masculine
мъдростта	None
агресивният	Masculine
по-абисинските	None
рязала	Feminine
възпиращ	Masculine
сравнил	Masculine
слушали	None
бактериално	Neuter
полувремена	None
изгубен	Masculine
абисинския	Masculine
автономните	None
писано	Neuter
бежанецът	None
най-водоравното	Neuter
наплитания	Masculine
ограничаващото	Neuter
по-сърдити	Masculine
бежанка	None
изчетеният	Masculine
алуминиеви	Masculine
съчетан	Masculine
победеното	Neuter
счупваният	Masculine
по-неразсъдителната	Feminine
зрелият	Masculine
бивши	Masculine
вдишващият	Masculine
по-детинска	Feminine
делящо	Neuter
повела	Feminine
съвременната	Feminine
подметени	None
ароматни	Masculine
таралежи	None
най-сложения	Masculine
потресена	Feminine
черните	None
най-неузряло	Neuter
срещан	Masculine
различния	Masculine
чуло	Neuter
въвличането	Neuter
целуване	Neuter
по-господарското	Neuter
накълвавахме	None
левия	Masculine
брада	None
унесена	Feminine
въврения	Masculine
по-чистия	Masculine
недостатъчната	Feminine
акуратното	Neuter
пометен	Masculine
козият	Masculine
чудати	Masculine
по-немското	Neuter
авиационният	Masculine
варварско	Neuter
трезвен	Masculine
оскъден	Masculine
съществувалата	Feminine
продаваща	Feminine
студентстваща	Feminine
лятната	Feminine
наведе	None
мишият	Masculine
ват	None
схватката	None
варваринът	None
опаслият	Masculine
сабите	None
най-августейшо	Neuter
модерен	Masculine
снеслото	Neuter
криви	Masculine
отмират	None
платила	Feminine
най-нисшето	Neuter
корита	None
уплашат	None
абсолютният	Masculine
естетична	Feminine
атомна	Feminine
най-коремно	Neuter
младото	Neuter
отвличания-нета	None
измелият	Masculine
по-вероятното	Neuter
архаично	Neuter
закупихте	None
братоубийце	None
отчети	None
абхазкото	Neuter
дясна	Feminine
желания	Masculine
обезсмъртявалото	Neuter
гласуващите	None
опича	None
крадене	Neuter
слабите	None
грешеният	Masculine
растения	None
драките	None
ученичките	None
корейки	None
надонесеш	None
вечеряне	Neuter
пеел	Masculine
венците	None
нисше	Neuter
навеждащ	Masculine
гневното	Neuter
удовлетворяващото	Neuter
австралийско	Neuter
повличана	Feminine
започващ	Masculine
длани	None
смели	Masculine
вярната	Feminine
велосипеди	None
автентичният	Masculine
фасула	None
аналогът	None
чудесно	Neuter
тополата	None
обзавеждайте	None
влакна	None
осмо	Neuter
дълбокият	Masculine
автономен	Masculine
седмицата	None
помагащ	Masculine
урагана	None
погребване	Neuter
несъмнено	Neuter
аморфна	Feminine
използваната	Feminine
сръбско	Neuter
невярната	Feminine
одобрил	Masculine
подклало	Neuter
наплетен	Masculine
нов	Masculine
изпитащият	Masculine
счупването	Neuter
неразумни	Masculine
най-анархичното	Neuter
най-преподавателското	Neuter
небесносиньо	Neuter
пчелар	None
аварска	Feminine
най-аналитична	Feminine
заключението	None
кокошият	Masculine
аго	None
убеди	None
пуяците	None
писателя	None
саркастична	Feminine
азбестови	Masculine
студентска	Feminine
камъкът	None
изпята	Feminine
словосъчетанието	None
най-неизкусен	Masculine
авторитетното	Neuter
усърдната	Feminine
четен	Masculine
по-бавен	Masculine
по-земетръсен	Masculine
отмиралия	Masculine
почел	Masculine
серния	Masculine
подчертал	Masculine
дълбоката	Feminine
предплатил	Masculine
чупене	Neuter
убивали	None
най-бялото	Neuter
по-деветия	Masculine
хомосексуален	Masculine
пишат	None
серяха	None
по-умна	Feminine
по-недовряло	Neuter
припаднал	Masculine
горяхме	None
албанските	None
грешаща	Feminine
студентската	Feminine
занасяне	Neuter
съществуващото	Neuter
адресиран	Masculine
извелото	Neuter
истинската	Feminine
узаконена	Feminine
агитационно	Neuter
восък	None
отричам	None
гълъба	None
обличащата	Feminine
пратила	Feminine
пеенето	Neuter
оскъдно	Neuter
одобряваме	None
ботушите	None
слизам	None
по-безмилостния	Masculine
свряна	Feminine
глухонеми	Masculine
бягали	None
арабския	Masculine
вулкана	None
бесни	Masculine
инвестиране	Neuter
загиване	Neuter
азотен	Masculine
автентични	Masculine
августовска	Feminine
ухапе	None
почитан	Masculine
топла	Feminine
античният	Masculine
изпасващия	Masculine
отличното	Neuter
авангардният	Masculine
най-надежден	Masculine
бодра	Feminine
кошове	None
доведено	Neuter
погребващата	Feminine
подобрен	Masculine
използващ	Masculine
обзавеждането	Neuter
сладолед	None
наследената	Feminine
жълт	Masculine
дълъг	Masculine
голямата	Feminine
сойка	None
хипопотама	None
най-лесен	Masculine
обяснени	None
югоизточният	Masculine
възпирахме	None
по-бременната	Feminine
пресния	Masculine
обезглавеното	Neuter
яката	Feminine
вещи	Masculine
гъвкавите	None
абхазкият	Masculine
ограничението	None
изпреда	None
най-хоризонтален	Masculine
изпитваш	None
вдишаното	Neuter
умна	Feminine
изтеклия	Masculine
опридахте	None
алманаха	None
италианците	None
запалват	None
по-абстрактна	Feminine
наранената	Feminine
ухапаното	Neuter
закупил	Masculine
господарки	None
нагризвалия	Masculine
тъмносин	Masculine
заплашат	None
чудесни	Masculine
озаглавено	Neuter
по-бегло	Neuter
красива	Feminine
зачетете	None
замирането	Neuter
тънкото	Neuter
ангелите	None
подиробеде	None
съвършени	Masculine
авторитарен	Masculine
мише	Neuter
врящия	Masculine
инфаркте	None
челото	Neuter
снежинка	None
одобрена	Feminine
най-болен	Masculine
най-авторитетно	Neuter
най-американска	Feminine
най-важно	Neuter
агитационен	Masculine
слязъл	Masculine
перпендикулярен	Masculine
убитият	Masculine
сериозни	Masculine
косатката	None
сметано	None
неразумният	Masculine
атомен	Masculine
забодените	None
честващия	Masculine
попиташ	None
виждащият	Masculine
сръбския	Masculine
загивалата	Feminine
засекли	None
очаквай	None
зачела	Feminine
несериозен	Masculine
най-благороден	Masculine
биене	Neuter
слънчев	Masculine
северняшка	Feminine
единадесето	Neuter
източното	Neuter
изтичаща	Feminine
търсеното	Neuter
кокалите	None
колачката	None
ядяло	Neuter
молил	Masculine
чавката	None
дъвкано	Neuter
изнесла	Feminine
убивана	Feminine
северния	Masculine
злата	Feminine
по-кокошия	Masculine
плащане	Neuter
чобанка	None
ученическия	Masculine
произтичанията-нетата	None
валидната	Feminine
изпитвана	Feminine
най-активната	Feminine
агресори	None
тръгвали	None
наведените	None
подчертан	Masculine
сладката	Feminine
вишна	None
съзиращото	Neuter
принудено	Neuter
старото	Neuter
заведеше	None
изпичането	Neuter
храбра	Feminine
умрелия	Masculine
ходеща	Feminine
презряхте	None
преподавателя	None
ясната	Feminine
изнасянето	Neuter
довеждащ	Masculine
излизането	Neuter
обсъждането	Neuter
навестилото	Neuter
отречена	Feminine
най-хоризонталният	Masculine
авиаторско	Neuter
решила	Feminine
алуминиев	Masculine
отвесни	Masculine
сярна	Feminine
играха	None
извляклата	Feminine
абстрактни	Masculine
подкупил	Masculine
правените	None
скубещият	Masculine
сладкото	Neuter
най-предпазливото	Neuter
безмилостен	Masculine
мерки	None
изнесен	Masculine
чая	None
съобщеният	Masculine
абсурдно	Neuter
господа	None
зачитан	Masculine
комини	None
запалването	Neuter
дарът	None
отвлякла	Feminine
чествано	Neuter
авантюристи	None
гладния	Masculine
благословен	Masculine
щуката	None
завелият	Masculine
отрицателни	Masculine
най-неузряла	Feminine
наивния	Masculine
чадъри	None
изпетият	Masculine
сияя	None
по-аналното	Neuter
най-антично	Neuter
главоболието	None
спестявания	Masculine
звезда	None
погледнал	Masculine
получаващият	Masculine
унищоженото	Neuter
най-водното	Neuter
най-вероятната	Feminine
навлизащия	Masculine
безгрижен	Masculine
подчертаваща	Feminine
ученическо	Neuter
обесения	Masculine
ухапала	Feminine
актьори	None
висшата	Feminine
започналата	Feminine
неважното	Neuter
произлизащия	Masculine
чадър	None
снесените	None
по-старите	None
заплашване	Neuter
по-агресивно	Neuter
секлия	Masculine
ранявайки	None
наизлезел	Masculine
абсурдното	Neuter
лесният	Masculine
символа	None
заплитане	Neuter
сравняван	Masculine
умел	Masculine
продължаващо	Neuter
отсичате	None
обичаща	Feminine
ранен	Masculine
пратя	None
висока	Feminine
алигаторите	None
вярващ	Masculine
разбери	None
арменския	Masculine
паяци	None
ученическа	Feminine
очакван	Masculine
разумна	Feminine
простираща	Feminine
германския	Masculine
еластично	Neuter
неутриното	None
ушиел	Masculine
изнасяна	Feminine
плащана	Feminine
по-водно	Neuter
значително	Neuter
сабя	None
изгубвалото	Neuter
ковчезите	None
племенница	None
засичащият	Masculine
изплашила	Feminine
изнесеното	Neuter
съобщяло	Neuter
ерите	None
жълтият	Masculine
варварската	Feminine
озадачен	Masculine
учещ	Masculine
високата	Feminine
архаичен	Masculine
биели	None
поизметеш	None
маже	None
ново	Neuter
падащите	None
измиране	Neuter
дебело	Neuter
най-слабото	Neuter
държава	None
търсеща	Feminine
тъпо	Neuter
препоръчам	None
прегръщаната	Feminine
разумната	Feminine
забоде	None
лекарската	Feminine
медицинска	Feminine
ябълка	None
самолети	None
осиновената	Feminine
отличният	Masculine
занесъл	Masculine
наклаждащата	Feminine
падеж	None
патриарсите	None
енергичния	Masculine
корели	None
пратела	Feminine
замиталия	Masculine
безбройно	Neuter
изтичащото	Neuter
целува	None
източно	Neuter
дъждът	None
взимаш	None
отровен	Masculine
анархично	Neuter
македонско	Neuter
купиха	None
узаконяла	Feminine
отварялите	None
заслужилите	None
най-скъп	Masculine
потушаването	Neuter
важния	Masculine
гласуваното	Neuter
безпокойствата	None
най-алчното	Neuter
искащ	Masculine
по-значителен	Masculine
опити	None
отсечените	None
отреченото	Neuter
стаи	None
продължаващото	Neuter
най-абсурдната	Feminine
делейки	None
желаейки	None
най-топъл	Masculine
гласуващия	Masculine
отнесена	Feminine
бухали	None
създала	Feminine
загубената	Feminine
колежките	None
бежанците	None
състезания	None
унищожената	Feminine
алчна	Feminine
обясняването	Neuter
разплаквахте	None
разбиралото	Neuter
наводните	None
отнесения	Masculine
отвлечения	Masculine
комин	None
ходил	Masculine
зареваваш	None
въоръжилата	Feminine
азбучна	Feminine
свръхестествена	Feminine
очистително	None
златното	Neuter
провирането	Neuter
ходим	None
унищожила	Feminine
шизофреничка	None
радеещ	Masculine
подклаждан	Masculine
убедило	Neuter
абсурдния	Masculine
адреса	None
искрени	Masculine
билия	Masculine
заревават	None
спирана	Feminine
обещал	Masculine
посетеният	Masculine
боядисан	Masculine
узаконен	Masculine
по-актуалният	Masculine
по-висок	Masculine
спасени	None
автономният	Masculine
продаваш	None
безбожието	None
легализиран	Masculine
сръндак	None
говорещият	Masculine
архаичният	Masculine
въвличалият	Masculine
по-стария	Masculine
сатанистични	Masculine
охранява	None
предупреждавали	None
сядам	None
напредналите	None
благоразумен	Masculine
предплатената	Feminine
изтичащо	Neuter
учителско	Neuter
агресивния	Masculine
яйцевидно	Neuter
аперитиви	None
месеци	None
хомосексуалните	None
лукави	Masculine
навра	None
абонаментен	Masculine
осиновяване	Neuter
поглеждах	None
некадърен	Masculine
плати	None
потушеното	Neuter
най-любознателни	Masculine
грижа	None
нанесла	Feminine
невярващ	Masculine
виждаха	None
обяснявай	None
мечтания	Masculine
пингвини	None
граничих	None
съобщя	None
ортогонално	Neuter
изчитането	Neuter
най-лилавият	Masculine
бирите	None
унищожено	Neuter
гребните	None
изпития	Masculine
артилерия	None
най-гладното	Neuter
удовлетворено	Neuter
изпридания	Masculine
свине	None
искането	Neuter
крокодил	None
по-абсолвентско	Neuter
довличащото	Neuter
коловете	None
чапли	None
най-хепатално	Neuter
сребърния	Masculine
създадена	Feminine
довлекли	None
благи	Masculine
най-краткият	Masculine
състезателният	Masculine
одобряването	Neuter
разбирането	Neuter
нахапваният	Masculine
строели	None
пишещия	Masculine
момъка	None
обесил	Masculine
обвиняващото	Neuter
адвентистко	None
нанеслия	Masculine
наричали	None
спасяване	Neuter
наивното	Neuter
анулира	None
способния	Masculine
наплитанията-нетата	None
погледнел	Masculine
запалят	None
навлизането	Neuter
смазва	None
отричана	Feminine
токсичния	Masculine
желаел	Masculine
обяснен	Masculine
заплашваше	None
отчетяха	None
гръдно	Neuter
опитен	Masculine
съобщавано	Neuter
броненосците	None
алкохолен	Masculine
адамова	Feminine
отсечен	Masculine
съчетания	Masculine
загребващия	Masculine
практичен	Masculine
аборигенската	Feminine
обещана	Feminine
искрен	Masculine
победили	None
обяснена	Feminine
лесната	Feminine
пестящият	Masculine
обезглавил	Masculine
одобряване	Neuter
молеща	Feminine
северозападна	Feminine
извличалия	Masculine
южно	Neuter
бактерийни	Masculine
комбинираният	Masculine
наемането	Neuter
майсторската	Feminine
заливи	None
ядене	Neuter
зашиването	Neuter
летни	Masculine
анализът	None
питано	Neuter
другата	Feminine
тежък	Masculine
лебеда	None
анулирана	Feminine
по-старата	Feminine
засичалия	Masculine
пратено	Neuter
адвокатите	None
влезе	None
продължила	Feminine
палци	None
реалистичната	Feminine
слива	None
белия	Masculine
гласувате	None
арбитрите	None
слониците	None
мъртвото	Neuter
бегло	Neuter
нещастните	None
шведска	Feminine
отричалото	Neuter
влизалата	Feminine
зъболекари	None
заковаваната	Feminine
подпираните	None
кантар	None
измамите	None
изтеклото	Neuter
магазин	None
агитките	None
по-веществените	None
произтичаща	Feminine
седмици	None
пренесени	None
по-отвесният	Masculine
наследен	Masculine
космести	Masculine
съобщаващ	Masculine
правещ	Masculine
мъдри	Masculine
неважната	Feminine
феите	None
слуша	None
искания	Masculine
продължилата	Feminine
допринасяйки	None
плащащите	None
най-варварското	Neuter
бродяги	None
балканско	Neuter
целувалия	Masculine
ангелът	None
дивият	Masculine
забраняване	Neuter
изтърваващия	Masculine
посещавана	Feminine
ушитият	Masculine
мразещият	Masculine
оцелелият	Masculine
американското	Neuter
навеждане	Neuter
заплашена	Feminine
прекрасни	Masculine
анархичният	Masculine
обезглави	None
комбинираното	Neuter
най-доблестна	Feminine
опитното	Neuter
най-любознателно	Neuter
противобясна	Feminine
античното	Neuter
подчертавалия	Masculine
попечен	Masculine
набожни	Masculine
живеела	Feminine
изпиващият	Masculine
чаканото	Neuter
по-възбялото	Neuter
аморфното	Neuter
дебелата	Feminine
повтаряте	None
адресирано	Neuter
учен	Masculine
дребна	Feminine
вероятен	Masculine
шофьор	None
по-неголямото	Neuter
отсякохте	None
пренесох	None
бабата	None
четенето	Neuter
по-светлосиньо	Neuter
любопитната	Feminine
унгарското	Neuter
подобна	Feminine
гласувани	None
счупва	None
крив	Masculine
валидна	Feminine
нозе	None
обезсмъртявайте	None
бърни	None
изнесения	Masculine
питан	Masculine
изковаващият	Masculine
аплодиран	Masculine
гвоздеите	None
получавания	Masculine
полувисш	Masculine
акуратни	Masculine
мета	None
ползват	None
пениси	None
произлиза	None
анонимен	Masculine
язовецът	None
продължават	None
най-яловото	Neuter
потушили	None
учи	None
доверчива	Feminine
загиналите	None
плодовете	None
сека	None
горящия	Masculine
гребния	Masculine
прегърна	None
живеещо	Neuter
плешивото	Neuter
врат	None
втечнявано	Neuter
животи	None
най-арабска	Feminine
очаквалия	Masculine
нещастното	Neuter
метеорът	None
най-хепатален	Masculine
ограничаващо	Neuter
ученическото	Neuter
произнеслия	Masculine
любезната	Feminine
бъчвар	None
непряка	Feminine
падащи	None
ползваната	Feminine
актуалният	Masculine
бойци	None
лисица	None
лес	None
превеждане	Neuter
влязох	None
фургоните	None
подробния	Masculine
реална	Feminine
германско	Neuter
отречен	Masculine
главоболие	None
благодарил	Masculine
чембалата	None
губели	None
тръгвалата	Feminine
заметял	Masculine
слизане	Neuter
славната	Feminine
продължаването	Neuter
посъветваните	None
антично	Neuter
порнографската	Feminine
слънчево	Neuter
обясняващо	Neuter
упрекната	Feminine
влизащият	Masculine
храбрата	Feminine
навирано	Neuter
загиналият	Masculine
чете	None
наведения	Masculine
срещанията-нетата	None
поотичалото	Neuter
скъпият	Masculine
назоваването	Neuter
падащото	Neuter
напредващи	None
нещата	None
по-лястовича	Feminine
валидния	Masculine
отмирах	None
убеждава	None
преведена	Feminine
произнесено	Neuter
царе	None
учебникът	None
бързото	Neuter
небрежен	Masculine
гончето	None
питащи	None
честитиш	None
подмиталия	Masculine
по-югоизточна	Feminine
инфантилната	Feminine
акварелисти	None
глупава	Feminine
ябълков	Masculine
попекъл	Masculine
засичането	Neuter
заповядвали	None
най-абисинските	None
тичали	None
причинените	None
смелият	Masculine
засякъл	Masculine
засечена	Feminine
ходилата	Feminine
подобрила	Feminine
предсказва	None
амбиции	None
по-свръхестествената	Feminine
довлечал	Masculine
губещия	Masculine
гъвкавото	Neuter
змейове	None
простора	None
адекватно	Neuter
млечнобял	Masculine
ученичка	None
зашила	Feminine
грозното	Neuter
превежданите	None
обличан	Masculine
европейка	None
активния	Masculine
падане	Neuter
искане	Neuter
азиатския	Masculine
завлечен	Masculine
говорещото	Neuter
изпитания	Masculine
ясния	Masculine
шофьора	None
вършеещият	Masculine
забраняващи	None
ушивани	None
опират	None
погребват	None
югоизточния	Masculine
обрекли	None
препоръчаните	None
желаното	Neuter
анилинови	Masculine
отчитане	Neuter
овчата	Feminine
проврелия	Masculine
далечната	Feminine
пикания	Masculine
мачовете	None
най-осъществими	Masculine
купила	Feminine
по-майсторския	Masculine
наследилия	Masculine
метеори	None
запечи	None
врене	Neuter
снасян	Masculine
решаващ	Masculine
силна	Feminine
златна	Feminine
плетящото	Neuter
дадем	None
запечено	Neuter
най-дивото	Neuter
говорих	None
дадох	None
северняците	None
актуалния	Masculine
довличай	None
капел	Masculine
създаваният	Masculine
изпасели	None
по-нещастна	Feminine
надвнесохме	None
северозападни	Masculine
завличана	Feminine
най-азотист	Masculine
връвта	None
полученият	Masculine
удовлетворил	Masculine
режещите	None
алкохолния	Masculine
плътни	Masculine
препоръчвано	Neuter
наричащата	Feminine
честването	Neuter
пеещото	Neuter
ходело	Neuter
прекрасния	Masculine
донасяха	None
млъкващо	Neuter
изпита	Feminine
интересуван	Masculine
чорапи	None
влязла	Feminine
пълният	Masculine
пушело	Neuter
разумно	Neuter
обезсмъртяващия	Masculine
биела	Feminine
затичането	Neuter
течности	None
разнесено	Neuter
измината	Feminine
подклажданото	Neuter
бира	None
кратки	Masculine
съобщилият	Masculine
поопекли	None
побеждаван	Masculine
взимащи	None
анахронизми	None
най-дребния	Masculine
отровно	Neuter
пушен	Masculine
причинилия	Masculine
гъркиня	None
бездеен	Masculine
сиялата	Feminine
най-предпазливо	Neuter
кожите	None
по-северозападното	Neuter
североизточната	Feminine
лъвиците	None
господаруващия	Masculine
важната	Feminine
чаят	None
веществената	Feminine
дола	None
комбинираща	Feminine
досадната	Feminine
заплитащото	Neuter
бременни	Masculine
пилият	Masculine
безскрупулна	Feminine
доверие	None
по-батерийна	Feminine
извежданията-нетата	None
излизалият	Masculine
даре	None
завлечахме	None
разбра	None
коронясва	None
питието	None
автоматичен	Masculine
замъкът	None
разболяване	Neuter
загребва	None
отключващ	Masculine
спестяван	Masculine
избиран	Masculine
бързеи	None
изложба	None
излязла	Feminine
говорело	Neuter
заслужилия	Masculine
абисинска	Feminine
корена	Feminine
седмата	Feminine
глобо	None
дояла	Feminine
археолозите	None
въврелите	None
предохте	None
изкупуването	Neuter
периодът	None
пясъците	None
усърдно	Neuter
маси	None
вишните	None
библиотеките	None
започването	Neuter
възможния	Masculine
по-доблестни	Masculine
червено	Neuter
пренася	None
удовлетворения	Masculine
най-недостатъчния	Masculine
сечала	Feminine
суграшица	None
доказала	Feminine
най-сръчните	None
апетитни	Masculine
гърдата	None
говорените	None
неспособен	Masculine
ползвайте	None
по-умелият	Masculine
зашивалия	Masculine
астролози	None
по-верен	Masculine
наето	Neuter
искани	None
надонасялия	Masculine
най-аметистов	Masculine
по-осъществими	Masculine
желаем	None
четящ	Masculine
мечока	None
най-абаносовото	Neuter
точен	Masculine
големия	Masculine
домата	None
забременяват	None
прегърнат	Masculine
североизточното	Neuter
даваща	Feminine
убедена	Feminine
най-златната	Feminine
чакащият	Masculine
заредената	Feminine
обучело	Neuter
срещаното	Neuter
компютър	None
несръчен	Masculine
почитана	Feminine
вярното	Neuter
пращането	Neuter
реалистична	Feminine
бягащите	None
доказваща	Feminine
решителната	Feminine
потънало	Neuter
наследила	Feminine
подобриш	None
най-автономно	Neuter
благодарения	Masculine
пепелта	None
изсичано	Neuter
вдишвате	None
възможното	Neuter
практична	Feminine
македонската	Feminine
съобщаваш	None
изслушан	Masculine
занесли	None
по-невяращата	Feminine
свръхестествено	Neuter
избираното	Neuter
запалилото	Neuter
небе	None
прехапаното	Neuter
учителските	None
зрелия	Masculine
сравнявана	Feminine
гренландците	None
набождащата	Feminine
най-влажния	Masculine
обучаващия	Masculine
оцелял	Masculine
отсечено	Neuter
акушерката	None
захапаната	Feminine
изчезналият	Masculine
абхазка	Feminine
по-неразсъдителния	Masculine
пикаещото	Neuter
пълно	Neuter
понавлезеха	None
авангардно	Neuter
подведен	Masculine
невярното	Neuter
анулиращо	Neuter
делфин	None
най-разсъдлива	Feminine
неразсъдителна	Feminine
изгубвате	None
думата	None
планини	None
сливите	None
предплатяла	Feminine
реалистичен	Masculine
съчетано	Neuter
допекохте	None
богиня	None
наемалия	Masculine
безкрайно	Neuter
навело	Neuter
обезсмъртяване	Neuter
съперник	None
агрегатни	Masculine
обучавана	Feminine
най-лесна	Feminine
пчелари	None
заченела	Feminine
отлична	Feminine
спреш	None
отчитаща	Feminine
припиралата	Feminine
съзирането	Neuter
построеното	Neuter
нова	Feminine
отчитаната	Feminine
адекватна	Feminine
невнимателни	Masculine
свраката	None
купуване	Neuter
омитаща	Feminine
хубавелките	None
по-бързичкия	Masculine
второразрядна	Feminine
дъвчещото	Neuter
снесения	Masculine
алегории	None
абсолвенте	None
кометите	None
най-нисша	Feminine
изчезващи	None
отсечала	Feminine
автостоп	None
прозирана	Feminine
крушата	None
заключение	None
старица	None
пит	Masculine
най-батареен	Masculine
зимите	None
изнудване	Neuter
адресирани	None
произнасяна	Feminine
най-жесток	Masculine
предупредила	Feminine
забранения	Masculine
навлича	None
довело	Neuter
препоръчван	Masculine
създаване	Neuter
пъргава	Feminine
гласувай	None
госпожицата	None
словенецът	None
леката	Feminine
най-амбициозната	Feminine
авторското	Neuter
платеното	Neuter
подведено	Neuter
варварска	Feminine
коча	Feminine
комунистка	None
съществуваща	Feminine
изоравалия	Masculine
болната	Feminine
оцветявано	Neuter
мускулести	Masculine
алуминиевият	Masculine
произтичащите	None
най-изпълнимия	Masculine
затресем	None
северният	Masculine
чуто	Neuter
започващият	Masculine
по-авгиево	Neuter
благодарилото	Neuter
възпираната	Feminine
плачейки	None
волята	None
щуреца	None
най-трезвено	Neuter
обречения	Masculine
влизащо	Neuter
алени	Masculine
понапичалият	Masculine
кралската	Feminine
аплодирани	None
изтичат	None
отворила	Feminine
назоваван	Masculine
втечнилите	None
аварския	Masculine
извлечена	Feminine
спасило	Neuter
по-учителския	Masculine
принудило	Neuter
сърцата	None
дълбок	Masculine
мрежата	None
счупиха	None
кожи	None
гърда	None
зареждащ	Masculine
заподозре	None
отмени	None
сигурното	Neuter
децата	None
одобрят	None
режещо	Neuter
шум	None
състезателен	Masculine
оцелялата	Feminine
парадоксите	None
станаха	None
австралийското	Neuter
студена	Feminine
охраняваща	Feminine
хоризонтално	Neuter
дъвкалия	Masculine
нарекла	Feminine
влаковете	None
коронясването	Neuter
зла	Feminine
далечното	Neuter
снесено	Neuter
изпитвате	None
непреки	Masculine
влизащ	Masculine
смажеш	None
най-бивше	Neuter
най-обилни	Masculine
детинският	Masculine
американска	Feminine
зашилото	Neuter
амперметър	None
плешивата	Feminine
убит	Masculine
по-мускулните	None
осинови	None
лековерни	Masculine
обезглавена	Feminine
започващо	Neuter
изпитан	Masculine
младо	Neuter
възможен	Masculine
ялово	Neuter
подписвано	Neuter
построявалият	Masculine
архаичното	Neuter
сръбската	Feminine
изсичащ	Masculine
черни	Masculine
изчезващото	Neuter
чета	None
най-цял	Masculine
недостатъчните	None
хоризонтален	Masculine
тресени	None
арабският	Masculine
ограниченото	Neuter
довеждали	None
изпеела	Feminine
продаващ	Masculine
атомната	Feminine
бягащата	Feminine
донесат	None
интелигентно	Neuter
подписващите	None
казвано	Neuter
подписано	Neuter
най-бърза	Feminine
авангарден	Masculine
озаглавяване	Neuter
обучената	Feminine
живелият	Masculine
търсен	Masculine
потресохте	None
пълна	Feminine
интелигентен	Masculine
сравнения	Masculine
засичаният	Masculine
работя	None
поотекла	Feminine
подобрява	None
дясното	Neuter
влезлият	Masculine
проповед	None
взводе	None
ходеха	None
леви	Masculine
разбрала	Feminine
ненадеждни	Masculine
книга	None
учителка	None
слаба	Feminine
довеждалата	Feminine
най-неумела	Feminine
безвярната	Feminine
възможна	Feminine
обръщение	None
словенците	None
била	Feminine
вратовръзки	None
наплитащ	Masculine
станът	None
нокти	None
по-недостатъчен	Masculine
честват	None
снасяне	Neuter
точни	Masculine
одеяло	None
презирана	Feminine
премиралият	Masculine
възголямата	Feminine
говорила	Feminine
пушил	Masculine
преведат	None
ортогоналното	Neuter
авгиевото	Neuter
поопичащият	Masculine
изпълнимото	Neuter
забравено	Neuter
активното	Neuter
секира	None
пилия	Masculine
виждащ	Masculine
подчертавания	Masculine
заметено	Neuter
дяволска	Feminine
силната	Feminine
замъците	None
по-бодра	Feminine
дребният	Masculine
ферибот	None
припевът	None
хрене	None
аварията	None
занеса	None
излизащо	Neuter
по-апетитния	Masculine
врабчият	Masculine
протичащият	Masculine
отричан	Masculine
назовавана	Feminine
ясно	Neuter
адът	None
храбрият	Masculine
горене	Neuter
молила	Feminine
лекарското	Neuter
победиш	None
четвъртият	Masculine
вряха	None
буля	None
земетресението	None
ученическата	Feminine
подслушването	Neuter
по-абхазкото	Neuter
понапичащия	Masculine
валиден	Masculine
ветрове	None
питащата	Feminine
болногледачът	None
живеенето	Neuter
ухапан	Masculine
грешащото	Neuter
отрекла	Feminine
сигурни	Masculine
бъбреците	None
комерсиалните	None
причинихте	None
преживяване	Neuter
донасяни	None
по-летния	Masculine
търбусите	None
зебрите	None
аналитичен	Masculine
анулирането	Neuter
уволних	None
безаварийно	Neuter
серният	Masculine
коремно	Neuter
възлизалото	Neuter
скучен	Masculine
песен	None
четена	Feminine
работете	None
дребния	Masculine
отхапалите	None
подобряваните	None
по-азиатската	Feminine
изобретателя	None
продължаваща	Feminine
напреднал	Masculine
порти	None
най-бавничка	Feminine
подвелото	Neuter
майсторския	Masculine
станало	Neuter
нарекло	Neuter
чешкото	Neuter
светлия	Masculine
по-алтовото	Neuter
дясно	Neuter
поизмитам	None
перпендикулярната	Feminine
благославях	None
кошуля	None
по-чешкия	Masculine
абсорбирането	Neuter
козо	None
евтините	None
пееш	None
втечняващата	Feminine
влязло	Neuter
края	None
авансово	Neuter
амнистия	None
охранявания	Masculine
построявай	None
можахте	None
отвореният	Masculine
рязали	None
глупави	Masculine
комерсиална	Feminine
зъболекаря	None
навряна	Feminine
наречена	Feminine
въпросът	None
произтичащата	Feminine
дяволският	Masculine
деветия	Masculine
скуа	None
създаваха	None
изтеклата	Feminine
коремът	None
некадърна	Feminine
аргумента	None
точно	Neuter
смазаната	Feminine
уволнена	Feminine
протичащата	Feminine
изгубения	Masculine
цяло	Neuter
довеждащо	Neuter
кажело	Neuter
практичният	Masculine
отвлечена	Feminine
строял	Masculine
търсилия	Masculine
комбинираната	Feminine
шведският	Masculine
тъмносиния	Masculine
инфантилен	Masculine
мечтал	Masculine
прегръщалите	None
губещото	Neuter
ангелската	Feminine
убилият	Masculine
ухапваният	Masculine
калфи	None
