vlažniji	spljoštenijemu	Comparison
rabote	pročitana	Number
savršena	monetarno	Gender
hrvatska	čitkoga	Number
sablažnjena	žudela	Tense
bludnoj	pravnicima	Case
implicira	djeluje	Person
podsjećaj	iznajmimo	Mood
cijeljena	prigovori	Tense
zgušnjavajmo	budali	Mood
najverodostojnija	verodostojnije	lemma
štedimo	obuhvati	Mood
mamurnije	hermetičnijima	Comparison
ženke	iscrpna	Number
serioznijemu	popularizatorska	Gender
najbjednijima	najbogohulnije	Comparison
čestitiji	zgodnija	Comparison
najsusretljivijega	železni	Gender
saznasmo	rastavila	Tense
mešala	sračunavaše	Tense
preventivne	najkrućom	Gender
trudnu	lagodnima	Gender
najkraće	apokrifnih	Gender
anarhičnih	rustičnije	Gender
osvećivao	prostirasmo	Tense
svesrdnija	žalosnijima	Comparison
nenavidelo	razjedinismo	Tense
zmijina	samouvjereni	Gender
rodoljubivije	pišljivije	Comparison
anđeoski	pustinjski	Gender
plećata	kanadska	Gender
šaraše	rješavahu	Tense
bocnula	nadvisivaste	Tense
najbezvrednijima	najstrahotnije	Comparison
avijacijo	teatar	Number
piroksilínu	neuspešnim	Number
samokritičnom	najsevernijima	Case
smokove	leksikološko	Case
nikao	uspavljivasmo	Tense
čvrsti	neshvatljivim	Gender
samokritičnom	anakronističnijima	Case
prostri	pomnožimo	Mood
obuzelo	ulovljeni	Tense
unitarističkomu	muljavima	Gender
listani	ojačavah	Tense
simbolično	rješivi	Number
nejasnijoj	najmukliji	Number
prepirah	podržani	Tense
saznamo	sporazumevajmo	Person
najrustičnijemu	najsablasnijima	Comparison
dodijelimo	pripovedaj	Mood
kantonskim	zelenilo	Number
razdražena	opali	Tense
ogavnija	najkrupnije	Gender
dojavljuj	zamjenjujmo	Mood
blagoslovimo	potrudi	Mood
simetričan	žive	Gender
iskušajmo	razdražuj	Mood
zadavalo	najmršavija	Gender
odmaknuli	štrihiraše	Mood
remećahu	polude	Person
tešnje	aprilske	Gender
besnjeli	cementiraše	Mood
najaktuelnijih	bodra	Case
ujedini	pojavljivala	Tense
kulture	težite	Number
paničnije	moralnijemu	Comparison
rascijepi	djelajmo	Mood
najsmirenije	najkonstruktivnijega	Comparison
poštovanijoj	najtrošnijemu	Number
siluješ	odoli	Person
kantonskim	glomaznome	Number
gađaste	bljuzgaše	Tense
samouvjereniji	lapidarnima	Gender
porozan	ponizilo	Number
zuraše	kotrljaš	Person
mirisno	mirisnoj	lemma
kompleksnima	maorski	Gender
ovenčavate	udomiste	Person
агогични	nečovječnoj	Number
riđokosom	indološkome	Number
barbarskijoj	mamurnijih	Comparison
najsapunastije	amajliji	Number
pridruži	opsovali	Tense
najsvrhovitije	najcelovitijemu	Comparison
stradala	sagledavao	Tense
najekstremnijima	najopasnijemu	Comparison
najrustičnijemu	najsirovije	Comparison
nejasnijoj	антипатичан	Number
asfaltiraš	istupimo	Tense
piroksilínu	pročitana	Number
najraniji	jestivi	Gender
lakomislenijima	bestijalniji	Comparison
nizinsku	urođenima	Gender
populacije	kuknjavo	Case
promišljeno	koprenu	Number
prepustimo	menjaj	Mood
diskutiraše	svrbaše	Person
sitnijim	prozirnih	Gender
pratnju	mesa	Case
tragična	gavrana	Number
prestravljivahu	prikrilo	Tense
sretnijima	nemarnijoj	Comparison
parade	koprenu	Number
pamćaste	rastavila	Tense
razmjerno	tamošnjih	Gender
odolele	nerealnih	Number
prekidaj	nastanjujmo	Mood
tutorstvo	zelenilo	Number
rezistentniji	najstrmiju	Number
krivudala	zacementiraše	Tense
razodevala	utvrdiše	Tense
pomažu	ukrštahu	Person
utrkuj	zapustimo	Mood
združujmo	ukori	Mood
hrvatska	elektromagnetskoga	Number
prolomimo	ceni	Mood
osveta	istraživačkoj	Number
krunisahu	apsorbirah	Mood
konkurencijom	slepima	Case
nabrasmo	namnažala	Tense
flamanskomu	pripomenuti	Gender
sistematičnija	uzornije	Comparison
novozelandski	pobjede	Case
paleontološki	zlonamjerne	Case
trošio	sintetiziraše	Tense
skucaš	golicaše	Person
ugrejavaše	hoćaše	Person
tremovima	horugvama	Number
dževajirima	puzimo	Number
crtala	zapuštahu	Tense
najvoljnijima	ljekovitoj	Gender
dosađivahu	nalomljena	Tense
podlima	očinsku	Gender
razvedenosti	inicijativa	Number
priveži	postignimo	Mood
humanističkima	neprijateljskome	Gender
dereš	pohaba	Person
дебљи	mamurnijih	Comparison
razbolijevaj	pokopajmo	Mood
zapadnjačkom	mirotvorkama	Case
šupljikave	krstašima	Number
susretljiva	bajato	Gender
razaznajmo	cerekaj	Mood
prikradi	prikrivajmo	Mood
kanceroznijima	diskretniji	Comparison
posrednija	čudotvorniji	Comparison
razgovjetnijemu	podmuklije	Comparison
mekšima	ubogijim	Comparison
zarudimo	obaveštavaj	Mood
linjaš	ošišaj	Person
besvjesnim	burmu	Number
zbunjujmo	obuhvati	Mood
opasna	ljuće	Gender
trojanskih	strmi	Number
trenutna	razbaštinjeno	Gender
obiđu	rasipavam	Tense
nasledi	uspava	Person
djelatnosti	protivnicama	Case
uvlačeno	štemovali	Tense
skucaš	povraćaj	Person
sarkastičnije	obilatijega	Comparison
nedužne	mehaničke	Gender
almanahu	predavačima	Case
čekana	opsovali	Tense
potrebnije	mršavije	Comparison
srdžbe	malima	Number
motrah	prekipim	Person
najimpresivnijih	dodatna	Number
razrušiste	šiljite	Person
suluda	metalo	Gender
zauzdavane	oivičivaše	Tense
mnogostruk	smotre	Number
izravnaj	zamjenjujmo	Mood
rudimentarnijoj	razbludnija	Comparison
zlonámērnosti	prijevremenima	Case
popravili	doseljenici	Number
najznakovitija	najnepovjerljivijim	Comparison
preštampavana	prislanjasmo	Tense
istoimenoga	doživotno	Number
probavljivijima	probirljivi	Number
gorskih	odjeli	Number
križno	spominje	Number
prisnome	neuporabljivima	Gender
proćutjela	prozvaše	Tense
dokučimo	pripovedaj	Mood
kićena	sabirnoga	Number
samozadovoljstvom	hektarima	Case
primitivne	primitivniji	lemma
verifikacije	jabučna	Number
kršnijom	ljepši	Comparison
postanimo	javljaj	Mood
pripremnih	kružna	Gender
iscijeliš	okrivljuj	Person
prognozirahu	doručkovah	Mood
najnebuloznijima	najmiliju	Comparison
birokratskijima	nestalniji	Comparison
retardiranijima	nepovezanima	Number
rustičnijega	rustičnima	lemma
najlakomislenijom	najsličnijih	Comparison
dotiskaste	doprite	Person
finom	zemljoradnicima	Case
sjenovitiji	bolesnijima	Comparison
nepretencioznijih	spokojniji	Comparison
zavređujmo	celivaj	Mood
telekomunikacijskih	telekomunikacijskima	lemma
neposrednim	smotre	Number
triangulirah	onemogućim	Person
šlampavima	porobljivana	Gender
plastična	problematičnih	Gender
svrbiš	janjimo	Tense
najživahnije	najživahnijemu	lemma
razdražujemo	iscjeđujmo	Person
neolitičkih	latinskoga	Case
dugoročniji	šarmantne	Gender
iščupaj	sapiraše	Person
obrađivasmo	pripremao	Tense
tugovao	pozvana	Tense
zadavljuj	opredelimo	Mood
svetlijima	razumljivijemu	Comparison
dokučimo	zagrizi	Mood
ponestajaše	vrijeđa	Person
heterozigotnu	filmskima	Gender
razmijenio	spektakularnu	Number
prizvuku	teatar	Number
razuvjeravaj	kokodačimo	Mood
utješno	suicidalnosti	Number
usavrši	probirimo	Mood
nazivajmo	iscjeđuj	Mood
izrezivani	čeprka	Tense
najnepogodnijemu	najdvoličnijima	Comparison
kontroverzije	sledeća	Number
razvedena	limunov	Case
nemogući	lakomi	Gender
priznata	kazivao	Tense
dijete	tankih	Case
gnjevnima	srodnikom	Case
seksualne	stran	Case
najbrojniji	paganizmu	Number
odjebemo	popraćivasmo	Person
mnȍžino	vremenitu	Number
kontroverzije	vata	Number
najbezbolnija	palatalom	Number
plati	pomnožimo	Mood
obasjah	učlanjivani	Tense
uzrujaj	uvažimo	Mood
civiliziraniju	veća	Comparison
obelodanjivano	trianguliraj	Tense
prostri	novačimo	Mood
razmisle	svučem	Tense
kvadratnoj	retrofleksne	Gender
sjao	podešavasmo	Tense
besparica	autentične	Case
predlagan	zapališe	Tense
kukah	ulovljeni	Tense
negodovaste	šapućite	Person
gorskih	patkica	Number
topolama	ukočenih	Number
neurastenije	tvrdokornima	Number
gotičke	rezultata	Case
isključi	branimo	Mood
namernoj	blatno	Number
brojniji	crvljivije	Comparison
usavrši	djelajmo	Mood
tehnološko	puščani	Case
ohlađivano	pobegle	Tense
isteravajmo	oporiči	Mood
pratnju	tehnologije	Case
najpokretniji	najcelovitijemu	Comparison
vozačima	vȃrci	Case
implicira	prkosi	Person
ležernijima	mudrija	Comparison
vitrine	najkrakatijima	Number
nailazi	spajajmo	Mood
emotivni	igrači	Case
razložismo	brzao	Tense
bèzūmnosti	malicioznima	Case
svinjara	mesa	Case
zabranjeni	prigovori	Tense
izliječe	prosjačim	Tense
mile	mila	lemma
prozirniji	masovnijim	Comparison
isuši	preostanimo	Mood
izgledaj	krpimo	Mood
avijacijo	predvidljiviji	Number
najvrletnije	najsklonijoj	Comparison
istrijebi	uklanjale	Tense
sede	koprenu	Number
zmijina	supersonični	Gender
zaklinjimo	prekali	Mood
ponavljala	prostirasmo	Tense
bezbojni	bezbojnih	lemma
razdrobimo	raširuj	Mood
neodređenih	narodnom	Gender
najapstraktnijih	odjeli	Number
najkompaktniji	najbrutalnije	Comparison
uobičajeniji	čudesnijemu	Comparison
ingenioznih	ingenioznijoj	lemma
maknuo	povraćaj	Person
rožnica	kompilacijama	Number
šiljasto	lajk	Number
najnezgrapnijima	najčudesnija	Comparison
uspostavljane	naga	Number
izvršiše	navaljen	Tense
zadubimo	javljaj	Mood
najsolidarnijemu	najfleksibilnijima	Comparison
težimo	celivaj	Mood
nesavjesnu	pridevu	Number
težimo	uživaj	Mood
najcrvljivijoj	najbučnijima	Comparison
najzapadnijega	najoskudnije	Comparison
jaši	pomnožimo	Mood
službenijima	savršenijoj	Comparison
razumij	zgražavajmo	Mood
glomaznijima	rȍgu	Case
problematična	gorska	Case
udavana	prebrodi	Tense
najneaktivnija	najmješovitijoj	Comparison
stradala	budaljaše	Tense
simbolično	apstrahirala	Number
dokučimo	oporavljaj	Mood
zovite	razglabate	Person
popravili	minimalna	Number
neprobojnih	ledenijega	Case
glineno	njujorška	Gender
ohlađivano	ždrijebali	Tense
srčite	razglabate	Person
zgrozite	povećavate	Person
optužujemo	uresismo	Person
čȍbānā	glazbene	Case
krucijalni	pustinjski	Gender
pogreši	namenjuješ	Person
nadleti	krpimo	Mood
prezalogajivah	sijalice	Number
preračunaste	dopuštate	Person
ekipe	vaseljenskih	Number
najrevolucionarnija	најразорнији	Comparison
probitačnije	ljuća	Comparison
bodimo	osudi	Mood
najtajanstvenije	efemerno	Number
domišljate	domišljatiji	lemma
zabranjeni	krepavala	Tense
razumnu	pljačkama	Case
kvantitativna	čitkoga	Number
jednooka	mikrofonom	Number
дебљи	pohlepnijima	Comparison
hrvatskosrpsko	procenjena	Gender
zasenjuj	isceđujmo	Mood
uspijevaše	pojačavani	Tense
zagradismo	tetoviramo	Person
osunčano	duboka	Gender
nailazi	branimo	Mood
škodljivi	škodljivima	lemma
primjetnija	primjetnu	lemma
nahuška	rascijepile	Tense
smeđastoj	smelije	Number
nabadajmo	podvostruči	Mood
никакав	travnati	Gender
uzbudljivih	predsjednice	Number
izvodljivijemu	osvetoljubivijima	Comparison
najvjerojatnije	drska	Gender
realnih	nepogodne	Number
predlagan	bljuzgale	Tense
najfleksibilnija	problematičnih	Gender
razložismo	prikrilo	Tense
ìzvor	blagonaklonoga	Number
podgrađujmo	odobrovoljuj	Mood
zbrinimo	obuhvati	Mood
listani	ukrštah	Tense
najnepogodnijemu	najsvadljivija	Comparison
najpozornijim	najsuznije	Comparison
odmotavano	tovljahu	Tense
samokritičniji	sretnija	Comparison
najnezanimljivijih	pohlepna	Gender
vitrine	limunov	Case
službenijima	zavojitijega	Comparison
bezosjećajnijoj	ruševnija	Comparison
problematična	neostvariva	Case
krnjimo	krljuštima	Number
kompleksnijima	sjenovito	Gender
kićasmo	poštovalo	Tense
izvožasmo	odjahivala	Tense
zabranjeni	prikrilo	Tense
abecednoga	paleontološki	Gender
najraniji	nežni	Gender
najneobičnije	izjednačio	Number
zinemo	sjetismo	Person
provokativno	najprovokativniji	lemma
sadrenoj	najšarenijima	Gender
avijacijo	poslovnijom	Number
žabinoj	aprilske	Gender
razastri	ispitajmo	Mood
mešala	prigovori	Tense
neobuzdanije	savršenijoj	Comparison
kvadratnoj	zdravije	Gender
svetliji	zgodnijemu	Comparison
trošio	napredovaše	Tense
najneustrašivije	najblještavijemu	Comparison
komplicirah	opali	Tense
prolomimo	prelistavaj	Mood
najimpresivnijih	apsurdna	Number
najpovršnije	najepohalnijima	Comparison
moćnici	bezobzirnijima	Number
inspiriramo	najedosmo	Person
uverljivija	mudrija	Comparison
najneaktivnija	najsklonijoj	Comparison
slivenik	sistematska	Case
nečovječnija	latinički	Case
izabrani	izabranih	lemma
umisle	oporavljahu	Person
križišnima	jabučna	Number
napomenimo	dogovori	Mood
brojniji	plodnije	Comparison
nailazi	gorčajmo	Mood
ustvrdimo	podstavi	Mood
nepremostive	nepremostiva	lemma
bedastijih	bedastijima	lemma
obdarimo	zamijenismo	Person
paprenijim	apatičnija	Comparison
najbesavesnijima	najslobodoumnije	Comparison
skrasi	osvetimo	Mood
najtočnijima	najcelovitijemu	Comparison
sledećih	освојив	Gender
najrjeđe	najznatiželjnijemu	Comparison
najpotištenijima	najbogohulnije	Comparison
anđeoskim	mučni	Gender
kampanje	verovanja	Case
osvećivao	opozivasmo	Tense
bestjelesnu	dostižeš	Number
latismo	navoženo	Tense
transformiraš	obmanjuj	Person
umeren	jestivi	Gender
najsablažnjivijima	najposrednije	Comparison
homogenu	količniku	Number
uzdržao	uzdržana	lemma
rascijepano	onesposobljivale	Tense
ubrao	prepiljena	Tense
dosadnima	zaviđahu	Number
paprenijim	smrdljivije	Comparison
birokratskijima	samouverenijega	Comparison
dosadi	opčinimo	Mood
tiši	tihu	lemma
isprobajmo	celivaj	Mood
kontroverzije	takozvana	Number
razjedini	nabijajmo	Mood
urugvajskim	suprotnima	Gender
zgodno	aerobnim	Number
obezglavljivaste	cvokoćite	Person
prelaznih	užasna	Gender
najfotogeničnijih	najnepravednijim	Comparison
najglasnijih	hidrauličkima	Number
mačevaste	ponižavah	Tense
nezasitni	brzopletih	Number
junačnijega	vidljivije	Comparison
prenela	budžetiraše	Tense
euro	teškoće	Case
najkompaktniji	agrotehnički	Gender
nemogući	najsposobnijima	Gender
grne	šetaše	Person
prisjetiste	razumeo	Tense
opljačkajmo	urešavaj	Mood
bogohulili	iznudi	Tense
pobeljivane	skuvao	Tense
neumerenijim	sićušnija	Comparison
propijaj	zapustimo	Mood
alpskoj	zgađen	Number
nasmešimo	popisuj	Mood
pozivana	zaplaši	Tense
svjesnijima	spljoštenijemu	Comparison
rađalo	prostirasmo	Tense
stvarne	stvarnoj	lemma
najotegotnije	najprozirnijima	Comparison
ugovorimo	čađi	Mood
najpotišteniji	najoštrija	Comparison
pohvali	podržani	Tense
motkama	kaspijskom	Case
povećavaj	raspodeliš	Person
turpijali	kaubojski	Gender
zijevaju	zaželim	Tense
razastrte	sračunavaše	Tense
najzbunjenija	neprijateljskome	Gender
najimpresivnijih	zabubaste	Number
pohvali	ždrijebali	Tense
inertne	inertnih	lemma
rodoljubnijih	izravnavano	Gender
najprimernijih	najispraznije	Comparison
potpuna	dokazima	Number
mirila	najekscentičnijemu	Gender
najfiniji	primitivnu	Gender
sagorimo	uđosmo	Person
podudari	vrgnuli	Tense
povlačimo	dodeljuj	Mood
najznanijih	најнормалнији	Comparison
laganije	žestokoj	Gender
propovedajmo	pupaj	Mood
bakrena	basnoslovno	Number
latismo	navaljen	Tense
sazreo	umaknuli	Mood
davio	tepijaste	Tense
paneliraše	rafiniraste	Mood
razradili	dopisa	Tense
darivale	vrištalo	Tense
sagorimo	probuši	Mood
najalarmantnijemu	najfunkcionalnijih	Comparison
izjavi	raspetljajmo	Mood
ostaviste	učvrstio	Tense
isijecimo	urešavaj	Mood
crvenjaše	iskazala	Tense
neodlučena	trigonometrijskih	Gender
ćeretava	škverana	Case
najriskantnijemu	ushićenima	Case
podučavajmo	nakalemismo	Person
siluješ	opovrže	Person
politeizmom	efemerno	Number
najimpresivnijim	najimpresivnijima	lemma
razočarani	imitiraše	Tense
bespovratan	demokratske	Case
radikalnijima	čudotvorniji	Comparison
uglovi	severoistočnima	Number
pomirismo	posjedovala	Tense
koriš	prebrodi	Person
signala	sumnjive	Number
šarmera	najnesavesnija	Case
prava	pravima	lemma
željeznima	најтајанственији	Gender
kićene	poručnici	Number
rubne	ruglo	Case
kampanje	metropolisa	Case
spoznajem	nameravate	Tense
čulo	lajk	Number
modernim	najmodernija	lemma
sablažnjivijima	eruptivnije	Comparison
bistrijima	opsežnije	Comparison
koščatijega	ljepši	Comparison
nastanjivani	najsublimnijemu	Gender
neredovitima	riječnomu	Case
isprljano	ukorjenjivahu	Tense
posreduju	naslutiše	Person
proučavajmo	beži	Mood
oružanih	iranske	Case
zacelimo	hvali	Mood
najiskoristivija	tendenciozne	Gender
giljotiniraše	ojačavalo	Tense
komešaj	trgnimo	Mood
ismijao	jurcana	Tense
protjerana	unela	Tense
zavarala	srkaste	Tense
čekirao	najgramzivije	Number
najbesavesnijemu	najočiglednijima	Comparison
maknuo	veseli	Person
kašljimo	prelistavaj	Mood
ženke	primjeri	Number
isuši	zurimo	Mood
onanirahu	pobude	Person
filantropija	navalila	Number
najodmornija	najnesavesnijoj	Comparison
prisutnijim	vješcu	Number
torzijskih	reprezentativnijega	Case
služaste	kazivao	Tense
proučavajmo	miješaj	Mood
decembarski	travnati	Gender
razjedinjavan	željezničkima	Gender
rustikalno	najrustikalnijemu	lemma
osvetite	štujete	Person
samobitnijih	prepredenijemu	Comparison
ugovorimo	sadržavaj	Mood
najnebuloznijima	najnesavesnijoj	Comparison
intervale	trorogima	Number
šupljikave	krljuštima	Number
istupaj	šećimo	Mood
prisilnih	katoličku	Gender
glatka	najvaravije	Gender
bičevaše	nadvladavani	Tense
košmarnima	ozbiljnijih	Number
najanonimnijih	najtemeljitijega	Comparison
prestupile	proricaše	Tense
jesnima	crvenkastima	Number
zagrijavan	nagrdiste	Tense
stavi	gužvajmo	Mood
besparica	teškoće	Case
pokunji	servisiraš	Person
nevernici	najsumanutiji	Number
ukrasne	rodoljubivo	Case
ekvinocij	devalvacija	Number
zasađuj	sagrešimo	Mood
dugoročnijemu	amoralnu	Number
očiglednu	bogat	Number
sračunavali	dopisa	Tense
želite	ubrzava	Tense
prisnome	apokrifnih	Gender
razdvajana	federalnima	Gender
sračunavali	štampa	Tense
najpovršnije	najlakovernijima	Comparison
zabrljalo	pohabane	Tense
intimnu	njujorška	Gender
moralnima	porušiste	Number
lascivnije	temporalna	Gender
publiciraše	klikćeš	Person
odrađivala	oivičivaše	Tense
čȍbānā	rudimentarnije	Case
snabdevah	podgrejavam	Person
makljaže	najfrivolnijima	Number
kićasmo	hvaljena	Tense
proračunali	zagrebe	Tense
kruljila	ponižavah	Tense
najvjerojatnije	sabornička	Gender
najrepresivnijima	najdrevnijemu	Comparison
sagore	oplovila	Tense
nesvesna	zaoravaše	Number
fragilnijega	progresivnijima	Comparison
intelektualne	nerealnih	Number
crtala	rješavahu	Tense
mračno	strašnija	Gender
pripaja	radozalu	Number
sjemena	munjovod	Case
grimasi	maloljetnička	Number
proslavio	poznata	Number
uzgojili	štitasti	Gender
napravimo	ukori	Mood
trodimenzionalno	ekonomičnija	Gender
neuredne	egzorcista	Case
čovječniji	lukavijih	Comparison
najguravijim	najusamljenijima	Comparison
vodili	iscrpljena	Tense
besprimjerna	bečke	Gender
dozovemo	zaželi	Tense
parade	devalvacija	Number
najimpresivnijih	prešni	Number
pozivana	posedovala	Tense
srčite	izlučiste	Person
predlagan	unela	Tense
čučni	opredelimo	Mood
najšiljatijih	ogorčeni	Gender
glorificiraste	poniženo	Tense
dosadnima	nagrdismo	Number
romantičnijih	dijaboličnijoj	Comparison
morfeme	svečanu	Case
ekstaze	nesputana	Number
pribadam	izgledaju	Tense
golenjače	protečena	Number
zavarala	istraživana	Tense
crkavaše	namenjuješ	Person
gramatičkoga	strašnija	Gender
čovekoljubivima	elitni	Gender
drastičnih	drastičnijima	lemma
žonglirao	sredismo	Tense
skupljačem	ciglara	Number
poduzimajmo	sadi	Mood
guščadi	rješivi	Number
imenjak	pregovarala	Number
paljeni	ojačavah	Tense
uvetnim	maternjima	Gender
povjerimo	odobrovoljuj	Mood
zijevaju	potičem	Tense
cilindričnoga	živahnijih	Case
zaštićuj	zurimo	Mood
razrađujmo	podvostruči	Mood
pomirismo	utemeljena	Tense
neoštećene	proticana	Gender
lukavu	zelenilo	Number
isušivane	silazio	Tense
vredniji	krstašima	Number
poznatima	poznatiji	lemma
bezbolne	vedskome	Gender
precizno	najprecizniji	lemma
bavarska	izvodljiv	Case
teoretizira	ispitivački	Number
načitanijega	lunarnu	Number
sagore	prožela	Tense
začnimo	osudi	Mood
suočavaste	drobite	Person
patetičnije	patetičnih	lemma
zlovoljnijima	drastičniji	Comparison
najsarkastičnijima	crvenkastima	Number
horizontalnomu	enklitikom	Number
razodjeni	nabacujmo	Mood
prikupile	uspava	Tense
autoritarnijemu	dostizala	Gender
tužnijoj	neaktivnije	Comparison
nejasnijoj	речни	Number
punašnijih	zobala	Gender
moralnima	nametljivijima	Number
podmazuje	svjedočimo	Tense
teoretizira	posteljicu	Number
trošio	anketiraste	Tense
neodgovornom	neodgovornih	lemma
zarudimo	osiromašuj	Mood
guščadi	poslovnijom	Number
pitoresknijega	pitoresknima	lemma
vitrine	nepromenjeno	Case
besposleni	samoglasnička	Number
razmišljaj	miješajmo	Mood
najbezobraznijemu	vunasti	Gender
plodonosnima	plodonosnijih	lemma
nasiti	posustale	Tense
najneobičnijih	dostižnijega	Case
lukaviji	inicijativa	Number
preseli	ugasi	Person
razotkrih	driblana	Tense
najfotogeničnijih	najegzotičnijega	Comparison
zgodno	fildišu	Number
anakroničnija	anakronično	lemma
severnjacima	patkica	Number
mešala	zaplaši	Tense
najdragocjenijemu	najljućima	Comparison
riđokosom	burmu	Number
šljemaše	izgrađuješ	Person
svladane	susretaše	Tense
prsimo	najedosmo	Person
nenavidelo	sintetiziraše	Tense
neophodnoj	najsklonije	Gender
haluciniraše	tračaše	Person
najteatralnijemu	teatralniju	lemma
zavidi	dodirnimo	Mood
nikao	impresionirale	Tense
pretuci	šećimo	Mood
zasenjuj	opredelimo	Mood
prvorazredni	ime	Number
ležernijima	osjetnija	Comparison
čeliči	opredelimo	Mood
neurastenije	odmeravajmo	Number
darovah	stavljeni	Tense
izljuti	novačimo	Mood
kȑčmē	prošaše	Number
najfiniji	antireligioznu	Gender
svjesnijima	prevashodniji	Comparison
priznata	formulira	Tense
mističnijima	transmisijsko	Gender
šištao	zapuštahu	Tense
najnezahvalnijih	najnezahvalniji	lemma
kušate	zgrabi	Tense
ludnička	definitivnu	Number
sledećih	znojavim	Gender
zavladaj	smažimo	Mood
popularnijih	prisutnijemu	Comparison
finalnom	sejšelske	Gender
uplovljavajmo	utovi	Mood
anđeoskim	longitudinalne	Gender
rojenih	samouvereni	Number
uzgojili	amorfnu	Gender
obavezne	obaveznih	lemma
gosti	množimo	Mood
libijskima	vedskome	Gender
pripaja	blatno	Number
silno	pregovarala	Number
najotrcanijemu	lajk	Number
najbesmislenijima	sagibate	Number
dostavljaj	pogibaš	Person
proričete	statìstičārkā	Number
picajzle	malima	Number
skupljačem	olakšana	Number
nedostaj	posramljujmo	Mood
neistinitijemu	rodovima	Case
prisluškivali	utemeljena	Tense
zamene	neukrotivi	Case
bombastičnima	iscjeđujemo	Number
intenzivni	intenzivnijima	lemma
blagoslovimo	hapsi	Mood
krčimo	podrignusmo	Person
pljuni	zamjenjujmo	Mood
unitarističkomu	neuništivima	Gender
najnepovjerljivijemu	karizmatičnima	Case
nerazgovetnoj	problematičnih	Gender
znanije	zakonodavnoj	Gender
imbecilnija	najimbecilnijih	lemma
alergičnije	crvljivije	Comparison
ugovorimo	nadmi	Mood
najpotišteniji	najsamozadovoljnijima	Comparison
proračunali	zauze	Tense
aprilske	parazitske	Number
spljoštenih	apanaže	Case
prvorazredni	servisira	Number
ksenofobija	doživotno	Number
primjerenijih	prevashodniji	Comparison
angažiranih	tromjesečja	Number
prikupile	zaplaši	Tense
suzbiste	nagovijestio	Tense
brdovitiji	nečovečnije	Comparison
kvantitativne	najneuobičajenijima	Gender
najpovršnije	najkovrčavijih	Comparison
dominantne	dominantna	lemma
najelokventnijoj	najsediji	Comparison
travnatije	manji	Comparison
odvežimo	obuhvati	Mood
silno	veselim	Number
pamćaste	odlete	Tense
negostoljubiva	teatar	Number
najneobičniji	neobičnoj	lemma
finskih	rudimentarnije	Case
reprezentativna	reprezentativnom	lemma
ustvrdimo	olabavi	Mood
proničeš	nastojimo	Tense
obeščašćeno	zajahali	Tense
mahni	zatražimo	Mood
tužnijoj	ažurnija	Comparison
pogreši	sniježi	Person
svestrana	norveško	Number
odbijam	hine	Tense
odgodim	transcendiraju	Tense
sramniji	znojnijima	Comparison
najnezgrapnijima	najneskromnijoj	Comparison
zlostavljan	lakomi	Gender
rascijepi	obilujmo	Mood
najfinija	doseljenici	Number
neobrijanu	popularizatorska	Gender
obogati	pretraživala	Tense
najpotištenijima	najneobuzdanijega	Comparison
prevagni	ocenjujmo	Mood
sustajao	tepijaste	Tense
svrati	otpadajmo	Mood
poroznijima	nestabilnijim	Comparison
svjesnijima	čudotvorniji	Comparison
zasađuj	smijmo	Mood
nečovječnija	rajski	Case
nečovečna	leksikografskoj	Number
opasna	sejšelske	Gender
ukopavate	iznuđujte	Person
bolnoj	prdnule	Gender
najužasnije	najakustičniji	Comparison
ilustrativnijih	besmrtnu	Gender
tople	ruglo	Case
golišavih	češnjake	Number
penji	trebajmo	Mood
otporno	asirskoga	Number
nagradimo	razbijaj	Mood
odvodimo	zavedimo	Person
srebren	sporne	Number
probavljivoj	anketnima	Case
posuđivao	posteljicu	Number
tugovao	preračunata	Tense
агогични	profinjenije	Number
pokrio	zapuštahu	Tense
najprofitabilnije	najodvažnijim	Comparison
srdžbe	limunov	Case
bezazlenijemu	najlicemjernijemu	Number
uobičajeniji	vlažnijoj	Comparison
jesnima	arhitekture	Number
protestima	omamljivu	Case
državljane	poslana	Number
najprogresivnije	najrupičastije	Comparison
uvlačena	prikazivahu	Tense
položile	izabran	Tense
najrazložnije	najdruštveniji	Comparison
uvlačena	sintetiziraše	Tense
probirala	ulovljeni	Tense
zgražate	uhapsiste	Person
najbrojniji	bačkomu	Number
neodređenih	kružna	Gender
prisutnijim	proreče	Number
obrtničke	najkrućom	Gender
istraživali	iscrpljena	Tense
znamenito	pedantnije	Number
odrađivala	gorčana	Tense
demonima	bezbrojnim	Case
zauzdavane	zapisah	Tense
platnenu	smotre	Number
iskoristiše	venčavana	Tense
gore	najozbiljnijih	Case
dozovemo	otvori	Tense
zlokobnim	najzlokobnija	lemma
najangažiranijemu	angažirani	lemma
priznata	ponižavah	Tense
glađim	bezopasnije	Comparison
nevernici	mlada	Number
kramara	naga	Number
religioznu	aromatične	Gender
najjezovitijega	nemarnih	Case
simentalsko	maštovita	Gender
versificirali	crnčilo	Tense
izljuti	zamjenjujmo	Mood
sramota	učtivoga	Case
simbolično	vrludave	Number
preraspodelimo	odledi	Mood
izganjala	gakasmo	Tense
pohvali	pozvana	Tense
najneumesnijima	povjerljivijih	Number
silno	lajk	Number
utuci	pobeđujmo	Mood
nagovešteni	ojačavah	Tense
beščasniji	zloćudnije	Comparison
najrječitijim	najsamozadovoljnijima	Comparison
istrijebi	pripremane	Tense
umrijeste	sašilo	Tense
razumevaš	opovrže	Person
počni	smijmo	Mood
podrazumijevao	preračunata	Tense
paljeni	posedovala	Tense
prisilnih	smetala	Gender
provjerena	logorovaste	Tense
najmlađu	najsamozadovoljnijima	Comparison
srdžbe	apsurdna	Number
izrezivani	oivičivaše	Tense
obimnije	najobimniji	lemma
rudimentarnijoj	trezvenijih	Comparison
dočaravan	obustavila	Tense
blatio	uglednima	Gender
podesnijemu	podesnoj	lemma
osvetite	nadjenete	Person
filantropija	sijalice	Number
podsjećaj	gužvajmo	Mood
trijumvìrāt	ispitivački	Number
prosečnoj	prosečni	lemma
mrači	studirajmo	Mood
dašćimo	sadi	Mood
alarmantna	pokrenuto	Gender
prvorazredni	posteljicu	Number
neobjašnjiva	vremenski	Case
spriječiše	beseđahu	Person
sitnu	paleontološki	Gender
alarmantna	majčino	Gender
darivale	porušilo	Tense
najčastoljubivija	najpaničnijoj	Comparison
zavidi	opazimo	Mood
svibanjski	izvrsna	Case
iskrcamo	traumatizirasmo	Person
nesvesna	norveško	Number
najrazumljivije	najusamljenijima	Comparison
najširega	najsuženijima	Comparison
destruktivne	kotorska	Gender
najvrletnije	najneočekivanijoj	Comparison
učenička	doseljenici	Number
rabote	nabodeno	Number
sjemena	svečanu	Case
najlošiji	svirajte	Number
rasklapasmo	sašilo	Tense
okupite	škiljaste	Person
najhumornijom	tranzistorske	Gender
krase	krparahu	Person
miroljubiva	filmskima	Gender
podsjećaj	pobledimo	Mood
aerodinamičniji	aerodinamičnu	lemma
suoči	celivaj	Person
beznačajna	nepismena	Gender
ponijaše	smaknuli	Mood
zavladaj	pomnožimo	Mood
zacelimo	razdražuj	Mood
zamene	nakanu	Case
jogunastim	najjogunastija	lemma
ukorjenjuj	opozivajmo	Mood
najzapadnijega	najmlitavijima	Comparison
ovjeriše	razdirano	Tense
našla	štampa	Tense
signala	arogantne	Number
čȍbānā	dostižnijega	Case
kratkovidnosti	najkakofoničnijega	Number
zahodskima	milijarderu	Case
preostanemo	izlučuješ	Tense
šanče	munjevita	Case
najrazgovorljivijima	најразорнији	Comparison
neplodnih	arhitekture	Number
predajmo	prelistavaj	Mood
uplovljavajmo	duši	Mood
najobilatijima	najlucidnijoj	Comparison
svanemo	preplašimo	Person
nabusitijima	rečitijemu	Comparison
sagradimo	budali	Mood
lukavu	najtrošnijemu	Number
izbegoše	namiču	Person
kliskija	kliskijima	lemma
dočekivaše	andaluzijski	Number
najsmrdljivije	najbanalniji	Comparison
uračunavaj	habajmo	Mood
beznačajna	zadovoljno	Gender
iscijedismo	izbegavamo	Person
parade	količniku	Number
mračno	popularizatorska	Gender
pripaja	basnoslovno	Number
krnjimo	nadmi	Mood
ostaviste	iskorenjen	Tense
ćešeni	bljuzgaše	Tense
tešila	narođeni	Tense
anđeoski	najnormalniji	Gender
snabdevah	prebrođujem	Person
napijahu	otpadaju	Person
vitrine	tromjesečja	Number
uobičajeniji	tmastije	Comparison
mekšaše	odfakale	Tense
predaje	rasplačete	Tense
mrači	naslutimo	Mood
dževajirima	atašeima	Number
opominjaše	rasklopi	Person
sadrenoj	sporedne	Gender
uzbudljivih	penušaviji	Number
izravnaj	veštačimo	Mood
prijedložnih	mirne	Case
obećava	plješćemo	Tense
najpovršnije	najmlitavijima	Comparison
armenska	darovitija	Case
samouprava	neobjašnjiva	Case
prognale	pobijeljeno	Tense
oživimo	proslavi	Mood
pozivana	nagovijestio	Tense
pozivana	štampa	Tense
apatetičnijih	herojske	Case
trenutna	spasilačko	Gender
iscrpniji	senovitijima	Comparison
nepotrebni	izvrsna	Case
livadska	mikrofonom	Number
satrvena	učvrstio	Tense
čupavijima	gavrana	Number
uspješnije	jednostavna	Gender
smicalice	nepromočivo	Number
čitah	navaljujem	Person
utješno	pročitana	Number
najrobusnije	najblještavijemu	Comparison
isijecimo	razbijaj	Mood
spretna	istaknute	Gender
apstraktnijoj	uzornijima	Comparison
aktuelnijima	blistavije	Comparison
prikupile	prebrodi	Tense
nestalnije	zabubaste	Number
најинвентивнији	najtrpeljivijima	Comparison
alpskoj	antimaterijo	Number
kulture	bešavne	Number
krčkima	krčkomu	lemma
najglupavijega	najmatorija	Comparison
grȗdnjāci	snizujte	Number
najbrojniji	smotre	Number
federacijom	medvedice	Number
slabijega	neaktivnijih	Comparison
cepnut	logorovaste	Tense
odudaraj	zatražimo	Mood
obvezivaše	jurcana	Tense
simbolično	zelenilo	Number
razmicahu	prostru	Person
bogaćasmo	preotiman	Tense
nadleti	uvežbajmo	Mood
najharmoničnijima	najbuđavijega	Comparison
zaračunaše	spremilo	Tense
nasiti	prigovarala	Tense
cičahu	ruše	Person
impliciram	vagnu	Tense
potrebnije	čudesnijemu	Comparison
razglašavaj	postignimo	Mood
zreloj	teatar	Number
našla	raščlanjivaše	Tense
najtupoglaviji	najoholijih	Comparison
odustaje	podčinjavaše	Person
skupocenih	ledenijega	Case
oštrijemu	bezosećajnijima	Comparison
tremovima	sanjkanja	Number
najraniji	izvršnima	Gender
tekstualne	odseku	Case
proizvede	nastupaj	Person
hlapljaste	odjahivala	Tense
neophodnoj	mehaničke	Gender
zajahan	imuniziraše	Tense
raskalašnima	svirajte	Number
kulturnije	neiskusnijima	Comparison
grješnijima	uvereniji	Comparison
uštinimo	pripovedaj	Mood
kihnuše	umeću	Person
razuvjeravaj	studirajmo	Mood
obilniju	indolentniji	Comparison
nagrđuj	golicaše	Person
pojavljivah	slizana	Tense
znaniji	pišljivije	Comparison
verifikacije	najotegotnije	Number
prenela	prepolovismo	Tense
jednačim	zbližih	Person
obećane	prigovori	Tense
provjerena	grmljaste	Tense
izmišljate	djelam	Tense
najguravijim	najkvalitetnijima	Comparison
uvlačeno	pogledavaste	Tense
posijedjela	rješavahu	Tense
staklenih	manje	Gender
ažurne	entuzijastičnih	Number
govorljivijemu	slasnije	Comparison
obuhvaćena	patkica	Number
mačevaste	otpilio	Tense
najčuvenijim	najlicemjernijima	Comparison
autoritarnih	šaljivim	Gender
najjalovijega	ustrojila	Number
ovlašćuj	pokopajmo	Mood
pripaja	elokventno	Number
mnogih	mnoga	lemma
konzervativnijoj	trezvenijih	Comparison
namočen	potplatile	Tense
empirijskome	inicijalu	Number
nadopunjeno	cerom	Number
stječi	pogibaš	Person
najekscentičniji	najneotesanije	Comparison
najdrastičniji	najoholijih	Comparison
najelokventnijoj	najozbiljnije	Comparison
severnjacima	hidrauličkima	Number
preoraste	cvokoćite	Person
neodređenih	zakonodavnoj	Gender
znatna	mehaničke	Gender
propih	množila	Tense
najmanje	najiskusniji	Comparison
naberimo	iscjeđuj	Mood
najelokventnijoj	najsočnijih	Comparison
pobelila	tovljahu	Tense
dozovemo	vrzma	Tense
nasmešimo	preslikavaj	Mood
oslabiš	napijaj	Person
ilustratore	brižljivi	Case
blagoslovimo	naslućuj	Mood
apartnih	škodljivu	Gender
najintrigantnijima	severoistočnima	Number
svezuj	obrezivaše	Person
doprinesene	iznudi	Tense
dojavljuj	obilujmo	Mood
neposrednim	bibera	Number
promenjuješ	opisivaše	Person
otpade	zakočiš	Person
gvozdeno	astmatična	Gender
stare	najstarijima	lemma
utoli	umišljaše	Person
pojedinačni	petini	Number
zacementiraj	ispitajmo	Mood
najznanijih	najsvetlijemu	Comparison
makljaže	autoritativnijima	Number
ekvinocij	argentinski	Number
imenjak	izdisaše	Number
obrisana	zaplaši	Tense
romantičnijih	sujetniji	Comparison
sporazumijevaste	mahalo	Tense
treperavijemu	razbludnija	Comparison
razdrobimo	odaberi	Mood
nasledne	zakonodavnoj	Gender
događaste	spajate	Person
labavimo	rvaj	Mood
skalpiraše	odmeravaju	Person
ponovnih	ponovnu	lemma
religioznu	vrsnih	Gender
golicale	vjerna	Gender
vidljiviji	vidljivu	lemma
zacementiraj	smijmo	Mood
znatna	totemističkima	Gender
doplovi	studirajmo	Mood
potkopaste	dostavilo	Tense
tresijah	ispečem	Person
izvožasmo	otpao	Tense
prokušavaš	profinjenije	Number
spajale	imitiraše	Tense
primjerniji	železni	Gender
najvjerojatnije	vjerojatnijim	lemma
srći	kartajmo	Mood
najobjesnijom	omamljivih	Gender
najopscenijima	opscenije	lemma
uvrebane	stigao	Tense
razaznajmo	podvostruči	Mood
negostoljubiva	sijalice	Number
odmotavano	rascijepile	Tense
inhalacijom	jesna	Number
prekrio	ukorjenjivahu	Tense
pretučeno	tepijaste	Tense
inferiornijih	inferiornu	lemma
najobjesnijom	jednolične	Gender
tričavijima	kvantitativnomu	Case
proizvodne	sejšelske	Gender
neposrednim	norveško	Number
svračjih	obaveštájci	Number
obasjah	množila	Tense
radosnim	bogat	Number
izjavi	podsetimo	Mood
iskušajmo	sadržavaj	Mood
šaraše	začarale	Tense
otkrivajmo	duguj	Mood
pravovjerna	mekani	Case
pregnantnijim	dugovječne	Gender
zevni	astralnu	Number
šašavijoj	neaktivnijih	Comparison
zaposlili	formulira	Tense
slepu	dostižeš	Number
naberimo	gnjij	Mood
beščasnijima	beščasnu	lemma
skupljačem	najbigotniji	Number
najekscentičniji	najhranjivijima	Comparison
iščupa	povraćena	Tense
združujmo	probuši	Mood
hoćaše	sotonizira	Person
rascepljivasmo	posjedovala	Tense
caklili	mlitavima	Number
uplovljavajmo	ogovaraj	Mood
neopipljiva	bezdušniji	Case
poblijedimo	pokrsti	Mood
kompletnom	kompletnih	lemma
rasprodana	ozbiljnijih	Number
propovedajmo	guši	Mood
šparasmo	razmaknemo	Person
odsutna	aprilske	Gender
livadska	najtegobnijega	Number
angažiranih	poslana	Number
poblijedje	zakočiš	Person
najneaktivnija	najbeskrupulozniji	Comparison
divji	ukočenih	Number
sigurnije	najsigurniji	lemma
krabulji	apstrahirala	Number
persirate	trorogima	Number
opominjimo	potakni	Mood
najzrnatiji	mesa	Case
prašno	gornja	Gender
kravaricama	ključnima	Number
priznata	izobliči	Tense
sarkastičnije	opsežnije	Comparison
nadjačavaj	skrasimo	Mood
obrisana	formulira	Tense
otpisa	narođeni	Tense
sledećih	bistroumnomu	Gender
zabunimo	proslavi	Mood
razglobljivao	ulagahu	Tense
neuvjerljiviju	plahiji	Comparison
isceljivao	povraćena	Tense
omogućavajte	prigušiste	Person
valovitijima	krištanovečka	Gender
rabote	spokojnim	Number
urugvajskim	neshvatljive	Gender
isecaše	izgrađuješ	Person
hrvatska	najkancerogeniji	Number
vrzmaše	jednači	Person
sretnijima	raspoznatljivijemu	Comparison
ustvrdimo	osudi	Mood
nečitljivi	nečitljivijima	lemma
obodi	branimo	Mood
plastična	najšarenijima	Gender
tjesnac	pobjede	Case
očiglednu	norveško	Number
globljah	skrpavam	Person
podvaljivale	uzverah	Tense
mršavijoj	najnetačnijima	Case
lažnima	nedoumicom	Case
pridruži	pobegle	Tense
uspješnije	egocentričnima	Gender
izdacima	svirajte	Number
bombastičnima	doseljenici	Number
bifurkacije	zvézdā	Number
zakrvarili	најтајанственији	Gender
uvećah	vrgnuli	Tense
podsjećaj	novačimo	Mood
riđu	učinkovitije	Number
odvukli	limeni	Gender
razmijenio	doživotno	Number
raskošnijemu	razbludnija	Comparison
najosjećajnijima	najljubaznijoj	Comparison
bludnoj	srećnijima	Case
haploidnom	inicijalu	Number
proizvede	paradiraš	Person
odsutna	trigonometrijskih	Gender
razaznajmo	duguj	Mood
borile	dopisa	Tense
zaredih	osušena	Tense
iskušajmo	naslućuj	Mood
punašnijih	igrivoj	Gender
najnepoštenijemu	nepošteniju	lemma
najupadljivijima	najmutavije	Comparison
pomodnomu	smrdljivijih	Gender
rešene	odlete	Tense
oružaše	hoćaše	Person
rasklapasmo	rastavila	Tense
grimasi	blagonaklonoga	Number
sprovodima	flegmatičnijemu	Case
ovalnima	netaktičnomu	Gender
potkopaste	duvnuo	Tense
zbližismo	huljeno	Tense
rustikalnija	rustikalnijima	lemma
svrstavao	meljasmo	Tense
golem	izostavljeni	Gender
zaračunaše	krepavala	Tense
trianguliraš	odenemo	Tense
naseli	tajasmo	Tense
razglašeni	metaše	Tense
spiralno	računovođe	Case
vitrine	ozbiljnijih	Number
filtrira	krikneš	Person
propatimo	razdražuj	Mood
lekovitijima	agilan	Gender
snimili	medijskim	Gender
zavodite	baleta	Number
dojavile	iznudi	Tense
pripremnih	ekvivalentnu	Gender
bljujmo	pobij	Mood
prelaznih	katoličku	Gender
svrstavao	povraćena	Tense
opasna	istaknute	Gender
najrigidnijima	zglobnu	Gender
искусни	središne	Number
dereš	opovrže	Person
fašističke	povjerljivijih	Number
kašljimo	prodri	Mood
izbacujemo	nastavljaš	Tense
neprihvatljiva	mehaničke	Gender
bilateralnom	normalnostima	Case
ledeniji	blještavija	Comparison
bljujmo	presahnjuj	Mood
dašćimo	osiguraj	Mood
lateralno	lateralnoj	lemma
utanačili	zauze	Tense
najmonotonijima	najbogohulnije	Comparison
najvjerojatnije	užasna	Gender
događaste	otuđujete	Person
rubne	ihtiološki	Case
razglašivali	nalomljena	Tense
razvedena	varvarskiju	Case
eskimska	nedokazivima	Number
horizontalnomu	zaoravaše	Number
sintetskoga	najspretniji	Number
prekretaste	spremilo	Tense
ledeniji	vetrenjastijima	Comparison
sijedimo	ukori	Mood
poduzimajmo	spazi	Mood
pismohranama	netočnu	Case
zaračunaše	nagovijestio	Tense
elokventnima	бесраман	Gender
uvodimo	miješaj	Mood
nosimo	smještaj	Mood
kakvu	bibera	Number
sazreo	abortirahu	Mood
proizvođaše	bljuzgale	Tense
umrijeste	krepavala	Tense
rojenih	najeruptivniji	Number
imenjak	glagolska	Number
izdržavajmo	zgražavaj	Mood
ekstaze	poručnici	Number
razroka	totemističkima	Gender
servilne	prdnule	Gender
internacionalnima	internacionalna	lemma
zamene	nepromenjeno	Case
kovrdžavi	kovrdžavija	lemma
otkrivasmo	opravdamo	Person
preruši	razodjenimo	Mood
podmitljivi	gnjiljasmo	Number
preplivavajmo	otimaj	Mood
umrijeste	razdirano	Tense
napasti	prijesno	Case
povjerimo	dodeljuj	Mood
poklanjahu	pogledan	Tense
snimili	pohlepna	Gender
zaračunaše	kušala	Tense
beznačajnijima	monstruoznoj	Case
škripnuh	zaostajem	Person
objahah	hranim	Person
gandži	nenameran	Number
rožnica	aritmetička	Number
ekstaze	iscrpna	Number
rodimo	smještaj	Mood
razvedenosti	ozbiljnijih	Number
isprobajmo	miješaj	Mood
saznasmo	kušala	Tense
pljuni	povrijedimo	Mood
iznuđivale	očara	Tense
bubni	nabijajmo	Mood
dokazivasmo	nabavljajmo	Person
obliži	priušćujmo	Mood
šarmera	najnedostižnija	Case
zaštićuj	sagrađujmo	Mood
dočekuj	posramljujmo	Mood
izvodile	transportira	Tense
sjekle	postavljaše	Tense
najšarenijemu	najljudskijih	Comparison
podgrejavajmo	uvaljuj	Mood
pokrio	izložena	Tense
ometi	skrasimo	Mood
uglovi	baleta	Number
uvodimo	posti	Mood
sitnijim	konveksnima	Gender
isprljano	prsnusmo	Tense
razmjerno	ptičja	Gender
krijumčaraste	ojačavalo	Tense
osunčano	strašnija	Gender
potpuna	ranima	Number
fašističke	baleta	Number
razodjeni	priopćavajmo	Mood
levajmo	uživaj	Mood
javnijoj	spominje	Number
skrasi	razagnajmo	Mood
prkosnih	sledeća	Number
nikao	pozvana	Tense
dosađivaše	ulovljeni	Tense
stanični	lunarnu	Number
kontrola	penušaviji	Number
položile	otera	Tense
oštrijemu	crvljivije	Comparison
centrifuge	bezizražajna	Case
zablistajmo	ašikuj	Mood
opsjedaj	paradiraš	Person
plemeniti	taktilnu	Gender
višnjama	snizujte	Number
svibanjski	obavještajna	Case
faktori	odgovarajte	Number
najrupičastiji	jesna	Number
smicalice	spektakularnu	Number
stanični	angloamerička	Number
naturalnom	vješcu	Number
iznenađivaše	traži	Person
preraspodelimo	popisuj	Mood
ponavljala	pogledavaste	Tense
seksualnom	najobzirnijih	Gender
bistroa	nostalgije	Case
huškao	oženiše	Tense
uvozila	tepijaste	Tense
sedlasta	sistematska	Case
mlaču	hermetičnijima	Comparison
naseli	narođeni	Tense
proćelavo	popularizatorska	Gender
žarčima	krakatijim	Comparison
rigoroznu	strategijska	Gender
šiljasto	antimaterijo	Number
najrobusnije	najprikladnijemu	Comparison
puhnimo	načni	Mood
suvišan	suvišni	lemma
kivnijim	crvljivije	Comparison
naoblači	miješajmo	Mood
prepirah	trianguliraj	Tense
shizofrenije	šumniji	Case
najsamobitnijima	najrazuzdanijim	Comparison
severozapadna	najblatnjaviji	Number
razradili	presvlačena	Tense
kovertiramo	zagrlismo	Person
lukaviji	porušiste	Number
najosvetoljubivijom	najvještije	Comparison
štedimo	karaj	Mood
nenametljivi	vedskome	Gender
trgale	stigao	Tense
raspravljan	zaračunaste	Tense
obrtničke	žestokoj	Gender
pogriješile	čeprka	Tense
prisećajmo	overavaj	Mood
najumjerenija	lagodnima	Gender
medveđe	prirodne	Case
nečovječnija	bezizražajna	Case
kaspijskoga	nerazvodnjenih	Gender
ništavnoga	kanadska	Gender
vriskali	aritmetička	Number
umeren	supersonični	Gender
opominjem	ušetah	Person
naiđu	doseljenici	Number
mračno	tamošnjih	Gender
uvećah	narođeni	Tense
svestrana	mikrofonom	Number
asonancama	brakom	Case
probdij	opčinimo	Mood
sijedimo	vadi	Mood
ustupi	ispraznimo	Mood
vrludasmo	izgrebemo	Person
treperavijemu	blještavija	Comparison
trošio	zapuštahu	Tense
klizah	navaljujem	Person
kompleksnima	najspremniji	Gender
dugotrajan	pregovarala	Number
nasiti	potplatile	Tense
zamene	svečanu	Case
teoretizira	najdrskijim	Number
prodrla	daljnje	Gender
najprivlačnijima	privlačnih	lemma
skupljala	osušena	Tense
decembarski	bezvodnima	Gender
predložio	slizana	Tense
najintrigantnijima	inicijativa	Number
dosadi	raznežimo	Mood
povlačimo	odaberi	Mood
srnčadi	obrazovanima	Number
naizmjenična	osorne	Gender
najkompaktniji	zajahao	Gender
anđeoski	probudio	Gender
sjemena	društveni	Case
sklopi	kalkulirajmo	Mood
zadubimo	prevladavaj	Mood
ненамеран	mikrofonom	Number
najkompetentnijega	najstrašnijima	Comparison
napasti	skelete	Case
kontrola	zavidni	Number
versificirali	ojačavalo	Tense
pecan	unela	Tense
najnesavjesnijega	najužasnijima	Comparison
kvadratnoj	sklonije	Gender
probdij	opredelimo	Mood
knjižim	težah	Person
bogaćasmo	naduto	Tense
uspostavljane	svetlih	Number
stiskajte	crvenkastima	Number
afirmativne	vjerna	Gender
ekvinocij	vrludave	Number
prepustimo	odaberi	Mood
raspravljan	venčasmo	Tense
zagradismo	iscjeđujmo	Person
kriminalizirasmo	penimo	Person
zbližismo	posedovala	Tense
bifurkacije	nepovezanima	Number
najdalji	kompilacijama	Number
najglasovitijima	glasovitije	lemma
rožnica	iscrpna	Number
najkomunikativnijih	мандарински	Gender
raseče	glasali	Tense
odolele	principijelnima	Number
ovladala	razjedinismo	Tense
riđu	paganizmu	Number
revolucionarnijima	zrnatijega	Comparison
sjao	preračunata	Tense
livadska	ceremonijála	Number
sentimentalnih	rudimentarnije	Case
davno	proklinjana	Gender
bombastičnima	krasnorečivima	Number
sočnija	sočno	lemma
impliciram	usvajate	Tense
izljuti	sagrešimo	Mood
najsklerotičnijima	majčino	Gender
propovedajmo	obaveštavaj	Mood
najdremljivije	najdremljivijemu	lemma
nepotrebni	parataksa	Case
združujmo	izbjegavaj	Mood
vojujem	obavijah	Person
rodoljubivije	golišavijemu	Comparison
cijenjaše	nastanjeni	Tense
radosnim	ispitivački	Number
gostili	prebrodi	Tense
izumre	trabunjaš	Person
proizvoljnijom	živahnijima	Comparison
smicalice	ulizao	Number
najravnomjerniji	uglovi	Case
šlampavijima	platnima	Number
najodmornije	najživopisniji	Comparison
negativni	maorski	Gender
očiglednu	elektromagnetskoga	Number
razbolijevaj	obilujmo	Mood
šmrknula	čeprka	Tense
odmotavano	zapuštahu	Tense
preseli	raspeš	Person
osjetljivijim	neshvatljive	Gender
izvodile	raščlanjivaše	Tense
flamanskomu	travnati	Gender
vrednovaste	pravite	Person
tremovima	ozbiljne	Number
pogriješile	zauze	Tense
lagodniju	bodrijima	Comparison
rađalo	trijebljene	Tense
svestrana	mržnji	Number
taktilno	računovođe	Case
vitrine	poslana	Number
opominjimo	odrađuj	Mood
orala	ždrijebah	Tense
rodimo	oporiči	Mood
ojačasmo	odevana	Tense
besparica	najosjetljiviji	Case
parazitskih	parazitska	lemma
napasti	dobročinstvo	Case
hrvatska	ratoborna	Number
idealistkinjama	entuzijastičnih	Number
rupičavoga	suicidalnosti	Number
prepustimo	odrađuj	Mood
nadjačavaj	kokodačimo	Mood
rodimo	pokaži	Mood
paučja	šiljatomu	Gender
vojujem	sevah	Person
razbolijevaj	veštačimo	Mood
kašljimo	odrađuj	Mood
gramatičkoga	bednija	Gender
zauzdavane	porušilo	Tense
najstrahotnije	strahotnima	lemma
divljaštva	poslednja	Number
zahvaljujem	kristijanizirah	Person
istrijebi	snižavali	Tense
bukureštansku	ulizao	Number
zastrije	prisjetismo	Tense
državljane	nesavladiva	Number
nepovoljnijima	vaseljenskih	Number
inventivnijega	talasavoj	Number
stradala	onemogući	Tense
snižavalo	napredovaše	Tense
homogenu	norveško	Number
najkraće	njujorška	Gender
najneobičnije	jesna	Number
sede	bezopasno	Number
najtajanstvenijemu	tajanstveniju	lemma
bezazlenijemu	astralnu	Number
svibanjski	veslanje	Case
davno	osornih	Gender
osvetite	ispatite	Person
suzbiste	bljuzgaše	Tense
zaklinjimo	zgražavaj	Mood
preruši	branimo	Mood
poznajmo	obaveštavaj	Mood
dugotrajan	mržnji	Number
krši	slavimo	Mood
samouverene	ominozne	Gender
nahuška	opsovali	Tense
divljaštva	strmi	Number
čekirao	ratoborna	Number
inhalacijom	zgađen	Number
penji	isceđujmo	Mood
obarao	pripojene	Tense
simplificiraste	uručite	Person
bombastičnima	rasformiraju	Number
rascepljivasmo	zablejalo	Tense
tiskahu	razluče	Person
križno	pljačkan	Number
glasovitija	bednijega	Comparison
državljane	ključnima	Number
obrnute	bolja	Gender
otkrivajmo	prekali	Mood
kvantitativne	mehaničke	Gender
zagrijavan	razlikovala	Tense
cepnut	nadvisivaste	Tense
najneovisniji	filmskima	Gender
imenjak	антипатичан	Number
ekvinocij	ispitivački	Number
sretnijima	privrženijega	Comparison
pričljivima	ukidao	Gender
naoblači	ispraznimo	Mood
mačevaste	iscrpljena	Tense
laganije	adekvatna	Gender
rešene	pripremao	Tense
krabulji	mlada	Number
najposlušnije	kreketavima	Gender
guščadi	samoglasnička	Number
poveravaše	najavila	Tense
bogaćasmo	krepavala	Tense
nejasnijoj	efemerno	Number
sramim	težah	Person
predlagan	prozvaše	Tense
najrobusnije	најразорнији	Comparison
oholjaše	otpočivaj	Person
samouverene	jednolične	Gender
pokrivana	krepavala	Tense
priznata	iznudi	Tense
anarhističkih	maternji	Gender
harfe	odgovarajte	Number
gostili	onemogući	Tense
ujedini	rodili	Tense
razumevaš	sapiraše	Person
kroatizacija	najkrnjima	Number
vrludaše	povraćaj	Person
najčastoljubivijemu	najsvečanije	Comparison
najnametljivijemu	najbodrijima	Comparison
ćirilici	osamljenost	Number
centrifugalnih	svirajte	Number
čežnjahu	odbace	Person
noćašnjima	tenisačke	Number
kraljuju	tenisačke	Number
provokativnijoj	najprovokativnijemu	lemma
ukradena	otera	Tense
razmijenio	samoglasnička	Number
istrijebi	pretraživala	Tense
prestravljivahu	krepavala	Tense
nasmešimo	uvaljuj	Mood
koagulirah	obračunah	Person
trenutna	najvaravije	Gender
bakrena	zelenilo	Number
ozljeđivana	izgradi	Tense
izručeno	tikali	Tense
osveta	beskičmena	Number
zasenjuj	utopimo	Mood
nekakve	nekakvoj	lemma
najkraće	jednostavna	Gender
istarskoga	litoralne	Case
zlostavljan	travnati	Gender
plaćate	slušajte	Person
investicijskima	investicijskomu	lemma
realnih	asistiramo	Number
šeći	servisiraš	Person
preračunavajmo	uvaljuj	Mood
nailazi	postignimo	Mood
zastreš	strahovaše	Person
razmjerno	narodnih	Gender
rasijavalo	izoravahu	Tense
cijeljena	opsedaše	Tense
pokunji	ljubakaj	Person
srčite	gorčaste	Person
saznamo	preplašimo	Person
snežimo	progrizimo	Person
cela	majčino	Gender
stradala	zagrebe	Tense
latismo	onemogući	Tense
najpraktičnijom	mirotvorkama	Case
najšepavijima	najodanija	Comparison
stradala	prigovori	Tense
svjesnijima	važniji	Comparison
brdovita	brdovitijoj	lemma
neprimjetljivima	odgrizalo	Gender
tutorstvo	apriornoga	Number
glađim	tačniji	Comparison
tjesnac	zlobne	Case
najnehotičnijemu	nehotičnijom	lemma
civiliziraniju	složnija	Comparison
kaznile	izražen	Tense
krepavaše	biglisale	Tense
kvantitativnu	ime	Number
destruktivne	smetala	Gender
izljuti	pristavimo	Mood
hvastaviju	trezvenijih	Comparison
domet	demokratske	Case
komešaj	zagasimo	Mood
podgrizeš	fasciniraše	Person
postanimo	prodri	Mood
najslinavijemu	najhisteričnije	Comparison
zadavalo	ptičja	Gender
pretuci	preostanimo	Mood
podržavaj	raznežimo	Mood
razvezala	utemeljena	Tense
prisećajmo	potrudi	Mood
nevernici	posteljicu	Number
iščupa	opali	Tense
obrisana	razdraživao	Tense
pripremana	šiljatomu	Gender
najskrušenijega	notorna	Case
grimasi	apriornoga	Number
čađavljaste	poverujte	Person
anarhističkiji	strpljivija	Comparison
zinemo	preplašimo	Person
cijeljena	projahao	Tense
procenjuj	fasciniraše	Person
trojanskih	autoritativnijima	Number
zreloj	devalvacija	Number
noćašnjima	fotke	Number
zastreš	promisli	Person
najodgovornijih	najodgovorniji	lemma
komercijalnoga	vešalice	Case
neprokušanome	izbirljivijih	Gender
optužujemo	penimo	Person
najprostranija	prostranije	lemma
razgrizao	optuživaste	Tense
bljujmo	guši	Mood
ponavljala	zacementiraše	Tense
najbezobrazniji	najbogohulnije	Comparison
pogibaše	balavila	Tense
aerodinamičnije	sanjkanja	Number
besmrtnu	besmrtne	lemma
izgubi	proplivajmo	Mood
jahača	neaktivnim	Number
abnormalne	zdravije	Gender
ledeniji	častohlepnije	Comparison
osvježi	razodjenimo	Mood
počni	studirajmo	Mood
svojstvenim	bezopasno	Number
probavljivijima	doseljenici	Number
pamćaste	odmamljivana	Tense
ovladala	narođeni	Tense
kakvu	ganutljivije	Number
pribranijih	efektnija	Comparison
romantičnijih	važniji	Comparison
bezgranična	skelete	Case
najgladnijih	najneočekivanijoj	Comparison
najdramatičniji	dramatičnoj	lemma
rojenih	puzimo	Number
propih	zapuštahu	Tense
aterirahu	koaliraše	Mood
negiraše	cementirasmo	Mood
najrezistentnijima	najcelovitijemu	Comparison
tukla	neslanima	Number
topivih	najilustrativnijim	Gender
tešnje	sporedne	Gender
razvio	opozivasmo	Tense
satrvena	otpilio	Tense
finskih	prtljažnika	Case
neproduktivniji	najinstruktivnije	Number
najčujnije	najoholijih	Comparison
krhotinama	careve	Number
raspravljan	odupresmo	Tense
preračunaste	štujete	Person
miru	glomaznome	Number
razmaknut	travnati	Gender
neodlučena	mehaničke	Gender
najniže	najcelovitijemu	Comparison
suhe	egzorcista	Case
adverbnih	transmisijsko	Gender
najalarmantnijima	obaveštájci	Number
razrokija	dremljivih	Gender
umerene	umerenoj	lemma
ugovorimo	odledi	Mood
iregularnome	razdvojive	Number
centrifugalnim	pročitana	Number
agronomskima	maternji	Gender
najmasnijemu	najmlitavijima	Comparison
persirate	najinstruktivnije	Number
smokove	latinički	Case
moćnici	vata	Number
istupaj	opredelimo	Mood
pecan	obustavila	Tense
potkrepimo	zagrijavajmo	Person
preruši	trebajmo	Mood
hiljadama	prahistorijom	Case
napomenimo	ulizuj	Mood
plastična	najsklonije	Gender
anakroničnija	anakronične	lemma
levajmo	razdražuj	Mood
kratimo	guši	Mood
latismo	razneživalo	Tense
proplivavani	kompilacijama	Number
zlostavljan	neshvatljive	Gender
protjerana	oslobodila	Tense
sputajmo	smenjuj	Mood
nazovi	poremećuješ	Person
pamćaste	dotiskana	Tense
najrezonantniji	najglupavijima	Comparison
hrvatskosrpskima	strašno	Gender
tešila	preračunata	Tense
rojenih	penušaviji	Number
krepkijoj	najkrepkijemu	lemma
najneobičnijih	prethodnoga	Case
trudnu	najšarenijima	Gender
ekscerptu	smelije	Number
utrkuj	dodirnimo	Mood
zavidi	zapregnimo	Mood
sagradimo	naslućuj	Mood
čvrstima	najsporednije	Gender
najdramatičnijih	najdramatičniji	lemma
istovarila	neslanima	Number
istupaj	veštačimo	Mood
ujedini	opsovali	Tense
nadopunjeno	neuspešnim	Number
ekvinocij	blagonaklonoga	Number
prebijan	vrludave	Number
isecaše	nastupaj	Person
dodijelimo	oporiči	Mood
topolama	budžake	Number
ubrao	pripojene	Tense
melankoličnija	presenete	Number
krhotinama	torzijskih	Number
skočimiševima	nerealnih	Number
stradala	trgovao	Tense
probitačne	prijesno	Case
snažnim	najsnažnija	lemma
štemano	posustale	Tense
težimo	overavaj	Mood
zanemarivao	zanemarivana	lemma
iščupa	prerasla	Tense
izgubi	opozivajmo	Mood
vrisnule	otera	Tense
prevagni	kokodačimo	Mood
ohlađeno	opozivasmo	Tense
mnogostruk	petini	Number
svanemo	podrazumevajmo	Person
kretske	nakanu	Case
rodoljubivije	oporijemu	Comparison
uzrujaj	sagrađujmo	Mood
aspekt	hrskave	Case
namočen	rješavahu	Tense
razjedini	skupljajmo	Mood
ponavljala	povraćena	Tense
flamanskomu	čvornate	Gender
čovječna	pravovjernomu	Number
imenjak	bogat	Number
zavide	sniježahu	Person
utrkuj	ocenjujmo	Mood
uvetnim	duboka	Gender
ujedini	crvenjena	Tense
bježiš	iznajmi	Person
razodevala	pridodaste	Tense
probijajmo	grni	Mood
pretuci	raznežimo	Mood
bludnoj	neparnima	Case
ukrotivo	smotre	Number
frekventne	frekventnije	lemma
zamene	esej	Case
pribranijih	nesebičnijega	Comparison
uobičajeniji	veselije	Comparison
skrilo	nadvisivaste	Tense
ekvinocij	tričavo	Number
najrazrokijega	najrečitijima	Comparison
anđeoski	iskričavijemu	Gender
uvećavajmo	hrknemo	Person
najkovrčavijim	najudaljenije	Comparison
teatri	primjeri	Number
kićasmo	prijala	Tense
izdacima	iscrpna	Number
torzijskih	cenzusa	Case
prekrio	ženjaste	Tense
podgrađujmo	miješaj	Mood
bogohulili	razdraživaše	Tense
šištao	osušena	Tense
šepa	primećujemo	Tense
kretske	madras	Case
humanističkima	najkrupnije	Gender
pojavljivah	pohabane	Tense
izvožasmo	zavezao	Tense
razvedenosti	nepristupačna	Number
najfinija	sagibate	Number
usavršuje	batinaše	Person
temperamentniji	čuvenijima	Comparison
trijebi	zatražimo	Mood
iznajmite	odjeljujem	Tense
vjernijima	dokazima	Number
vojna	ceremonijála	Number
talasaj	krivuljajmo	Mood
vlažniji	vjernije	Comparison
usavrši	borimo	Mood
preruši	pomnožimo	Mood
najbjednijima	najznatiželjnije	Comparison
oživimo	zaboravi	Mood
razgovarasmo	uzrujala	Tense
zadivljavah	sokolile	Tense
poslovotkinja	jednosobne	Case
teoretizira	elokventno	Number
najneaktivnija	najživopisniji	Comparison
glatke	efemerno	Number
nesvesna	basnoslovno	Number
sagrešila	štampa	Tense
pozornijima	pozornima	lemma
zadavljuj	pokopajmo	Mood
nevernici	glagolska	Number
iznuđivale	iskorenjen	Tense
preoraste	oglodavate	Person
najprofitabilnije	najjestivijega	Comparison
najdetaljnijega	najmlitavijima	Comparison
promišljeno	zelenilo	Number
europski	antisemitskima	Gender
propereš	duši	Person
ograničila	podržani	Tense
omogućavajte	survavate	Person
prozovi	iskašljavajmo	Mood
pripremnih	egipatskoj	Gender
rodoljubivije	principijelnije	Comparison
počni	nabijajmo	Mood
proizvodne	zdravije	Gender
omogućavajte	rovaraste	Person
najsigurniji	sigurnoj	lemma
blagoslovimo	pupaj	Mood
spriječiše	otpadaju	Person
ćeretava	ćeretavima	lemma
junačnijega	neočekivanija	Comparison
giljotiniraše	presvlačena	Tense
uspješnijemu	bubuljičavijima	Comparison
prisutnijim	koprenu	Number
teatri	takozvana	Number
blatili	predvodila	Tense
izravnijemu	zgodnija	Comparison
uzbudljivih	ispitivanja	Number
preračunavajmo	oporavljaj	Mood
svrbiš	istovarimo	Tense
digni	prikupljaš	Person
stiša	poboljšaš	Person
borile	odlete	Tense
korenitiji	jasnija	Comparison
ugodnijemu	najsposobnijima	Gender
najnepoverljivijima	najciničnijemu	Comparison
neodgovornija	uzornijima	Comparison
bezosjećajnijoj	sićušnija	Comparison
sukobljavaj	iskočimo	Mood
zažele	zamrzneš	Tense
broji	iskočimo	Mood
elokventnima	iskričavijemu	Gender
srdžbe	varvarskiju	Case
abecednih	ukidao	Gender
začnimo	olabavi	Mood
najsmješnijom	najveštija	Comparison
podnošeni	uzverah	Tense
anđeoskim	spljošteniji	Gender
svjedočaste	sagledavao	Tense
sporazumijevaste	odevana	Tense
noćašnjima	rastavljane	Number
prostirimo	beži	Mood
doprinesene	raskolilo	Tense
srdžbe	svakakvo	Case
rupičavoga	teistu	Number
železnomu	železnoj	lemma
novozelandski	promišljena	Case
beznačajnijima	traumatičnome	Case
opominjimo	popisuj	Mood
natjeravao	balavljene	Tense
dražesnije	izdisaše	Number
razaznajmo	izbjegavaj	Mood
ćoravljaše	traži	Person
dojašimo	ukori	Mood
trudnu	jednolične	Gender
mnȍžino	burmu	Number
anestezijo	iznenađene	Case
istraživali	dopisa	Tense
špendirane	prebrodi	Tense
havajskih	najprisutniji	Gender
sklopi	pomnožimo	Mood
havajskih	tankoćutan	Gender
tužnijoj	ispraznija	Comparison
najdalji	odjeli	Number
najnevernijemu	olakšana	Number
zgodnome	odijevani	Gender
kanceroznijima	manji	Comparison
ludnička	bibera	Number
istovarila	poručnici	Number
afirmativne	kritična	Gender
iscrpniji	neočekivanijima	Comparison
najzaboravnijemu	lajk	Number
vjerili	cevni	Gender
podudari	podržani	Tense
riskantnijemu	apstrahirala	Number
preraspodelimo	preslikavaj	Mood
načina	najotmenijih	Case
čovekoljubivije	korektnijoj	Comparison
pasivnima	krstašima	Number
naturalnom	najkakofoničnijega	Number
stidljiva	egzorcista	Case
najgladnijih	najneaktivniji	Comparison
unitarističkomu	kanadska	Gender
najsarkastičnijima	krasnorečivima	Number
najekscentičniji	najsvečanije	Comparison
nostalgičarima	asistiramo	Number
grješnijima	mudrija	Comparison
izjavimo	proslavi	Mood
signala	nesavladiva	Number
pohlepna	pohlepnijemu	lemma
razbjegoh	razvalile	Tense
akomodira	povodiš	Person
najsitnijemu	lajk	Number
neumornim	maternjima	Gender
pretuci	opredelimo	Mood
temperamentniji	znojnijima	Comparison
istrijebi	opali	Tense
čovjekoljubivija	čovjekoljubivo	lemma
simbolično	mržnji	Number
krȉčavosti	spominje	Number
krȉčavosti	izjednačio	Number
probdij	punimo	Mood
ženstvenima	kaspijskom	Case
odvodimo	umijmo	Person
bezobrazna	norveško	Number
svladane	nagovijestio	Tense
moraj	verimo	Mood
jamči	probirimo	Mood
sumornije	radoznalijima	Comparison
никакав	najmnogoljudniji	Gender
postupi	osnova	Person
idealistkinjama	frigidni	Number
lični	plimnih	Number
gotičke	najozbiljnijih	Case
saperu	porastoše	Person
svanemo	ispilismo	Person
sagradimo	prekali	Mood
zavladavaju	doseljenici	Number
apartnih	trebljeno	Gender
onanirahu	sagore	Person
pazarahu	rangiraše	Mood
rasklapasmo	poštovalo	Tense
ruska	sumnjive	Number
dozovemo	meće	Tense
perverznije	perverznijih	lemma
sablažnjivijima	beznačajnija	Comparison
kontroverzije	strmi	Number
elokventnima	agilan	Gender
humanijega	bubuljičavijima	Comparison
preruši	zagasimo	Mood
uplivam	privikavate	Tense
pribranije	količniku	Number
ostvaruju	inovirahu	Person
preskoči	nabacujmo	Mood
snizivala	susretaše	Tense
trenutna	najreprezentativnije	Gender
prognale	opsedaše	Tense
smotriste	prijala	Tense
prelaznih	provokativna	Gender
opsjedaj	hoćaše	Person
najkažnjivijom	najsamozadovoljnijima	Comparison
najrjeđe	најцјеловитији	Comparison
izvodile	zauze	Tense
pohvali	prerasla	Tense
kratkovidnosti	aerobnim	Number
prisećajmo	ogovaraj	Mood
oplemenjivano	ulagahu	Tense
letačima	ažurnije	Number
divljaštva	brzopletih	Number
destruktivne	sabornička	Gender
taktna	taktnima	lemma
talentiranijih	talentiranu	lemma
prisnome	najapolitičnija	Gender
zamamnijim	čuvenijima	Comparison
zlonamjernu	najravnopravnijom	Number
kroatiziraše	razgrizu	Person
makljaže	patkica	Number
junačnijima	izopačenijega	Comparison
birokratskijima	arogantnija	Comparison
zgrejavamo	nabavljajmo	Person
križno	aerobnim	Number
pismohranama	gerijatrijskomu	Case
eskimska	upornijima	Number
bogaćasmo	navaljen	Tense
najsuznijega	najtragikomičnijima	Comparison
najlakomislenijom	najsenzacionalnijih	Comparison
posijedjela	srtasmo	Tense
jezivima	najsluzavijom	Gender
važnima	zglobnu	Gender
ksenofobija	efemerno	Number
bolnoj	daljnje	Gender
privlačnija	trigonometrijskih	Gender
sagorimo	ispitaj	Mood
skvrči	žgoljavom	Number
težimo	ujedini	Mood
muti	zataškajmo	Mood
proslavio	fantastičnu	Number
aromatična	aromatičnijoj	lemma
sporazumijevaste	pizdeo	Tense
najkovrčaviji	najčarobnije	Comparison
škodi	upecajmo	Mood
rožnica	sumnjive	Number
ugovorimo	uzrujavaj	Mood
antiimperijalizme	nevelikima	Number
upravljaste	prilagodite	Person
najljuću	najdruštveniji	Comparison
obdarimo	zagrijavajmo	Person
pridruži	obarale	Tense
najumišljenijih	vremešnu	Gender
propih	raznježene	Tense
rodimo	pripomeni	Mood
razbjegoh	obustavila	Tense
večite	kotorska	Gender
nečiste	najspremniji	Gender
svezuj	akcentira	Person
zavladaj	ispraznimo	Mood
upijte	zamjeriste	Person
uvećah	stavljeni	Tense
abnormalne	tranzistorske	Gender
krivudala	podržani	Tense
najbezuspješnijih	najciničnijemu	Comparison
porozan	suicidalnosti	Number
tutorstvo	najbigotniji	Number
smokove	debilni	Case
krevetne	aromatične	Gender
prekidaj	prikrivajmo	Mood
jantarni	dodatna	Number
kruljila	susretaše	Tense
letačima	dodelila	Number
nestalnije	budžake	Number
inhalacijom	doživotno	Number
ksenofobija	najkakofoničnijega	Number
razjedini	preostanimo	Mood
verska	metalo	Gender
obasjajmo	vadi	Mood
najrupičastiji	definitivnu	Number
borile	izgradi	Tense
najvjerojatnije	besciljna	Gender
ujedini	pripremane	Tense
zabrljaj	ocenjujmo	Mood
zapali	šetaše	Person
rascijepi	kokodačimo	Mood
najekscentičniji	najiznenađenijima	Comparison
flamanskomu	frustrirani	Gender
proizvodne	istaknute	Gender
osetljivijima	svetlih	Number
sljubim	kristijanizirah	Person
najsolidarnijemu	najsuznije	Comparison
tržištima	inicijativa	Number
proračunali	stigao	Tense
ženke	ozbiljnijih	Number
spomenusmo	razdirano	Tense
najrazložnijih	najglavatije	Comparison
laganije	nezakonitom	Gender
najčitljiviji	najslobodoumnije	Comparison
ublaži	raspetljajmo	Mood
oružaše	izgrađuješ	Person
anđeoski	najprisutniji	Gender
spretna	zdravije	Gender
krepavaše	štemovali	Tense
najbudnijih	pojedinačna	Gender
iscuri	iscurilo	lemma
najznanijih	najposrednije	Comparison
najkraće	popularizatorska	Gender
probavljivijima	oficirima	Number
verifikacije	strmi	Number
isušivane	punio	Tense
hlapljaste	prikrilo	Tense
spoznaj	krikneš	Person
etažo	količniku	Number
pričljivijoj	razbludnija	Comparison
najtrjezniji	željeznima	Gender
krulji	zapregnimo	Mood
ustupismo	preplatimo	Person
moralnima	plimnih	Number
pretuci	razaspimo	Mood
istarskoga	računovođe	Case
zakazuju	savetujem	Tense
posuđivan	venčasmo	Tense
najglasnijih	doseljenici	Number
proizvede	odoli	Person
najbesavjesnije	šuplje	Case
sramota	prekrasne	Case
beznačajna	spasilačko	Gender
bezglasni	najklimavija	Number
najnestalnije	apsurdnima	Gender
ненамеран	rudlavomu	Number
monasima	najbližom	Case
ručao	ručasmo	lemma
pokvarenijima	скандалознији	Comparison
bezazlenijemu	asirskoga	Number
lisci	prijesno	Case
sitnu	najsposobnijima	Gender
nehotičnijih	herojske	Case
rezistentniji	spominje	Number
filantropkinjama	jabučna	Number
poslušaš	hine	Tense
fosilne	očinsku	Gender
šiljasto	devalvacija	Number
pridružuj	opčinimo	Mood
zabijana	klađahu	Tense
neumornim	ekonomičnija	Gender
predložio	ženjaste	Tense
najindiskretnijima	најцјеловитији	Comparison
najšarolikijom	šarolikiji	lemma
junačnijima	bednijega	Comparison
teoretizira	beživotna	Number
izjavi	borimo	Mood
preostaj	izganjajmo	Mood
skupljala	zacementiraše	Tense
nevernici	besplatne	Number
verska	najdarovitijim	Gender
laganijima	efikasnijim	Comparison
postanimo	odobrovoljuj	Mood
srdžbe	ždrala	Case
očiglednu	ispitivački	Number
susretljiva	metalo	Gender
promišljeno	posteljicu	Number
krȉčavosti	najdragocenije	Number
najzaslužnijima	načitani	Gender
kontroverzije	crvenkasta	Number
čitave	daljnje	Gender
najsitnijemu	pregovarala	Number
najanonimnijih	najiskoristivije	Comparison
агогични	bačkomu	Number
sede	pozornost	Number
preostaj	smažimo	Mood
mrči	neočekivanijima	Comparison
državljane	takozvana	Number
bakrena	neaktivnim	Number
predajmo	miješaj	Mood
tupljoj	rupičavijima	Comparison
emocionalnima	težite	Number
euro	uzaludna	Case
ugovorimo	javljaj	Mood
najposlušnija	podmitljivijega	Gender
pretučeno	pobegle	Tense
kratkovidne	očinsku	Gender
osmanskoga	tankih	Case
žabinoj	daljnje	Gender
najzavodljiviji	šumovite	Gender
nadopunjeno	devalvacija	Number
pripremnih	bolja	Gender
najsmješnijom	najblažima	Comparison
tutorstvo	internacionalan	Number
solidni	solidnija	lemma
opljačkajmo	vadi	Mood
hiljadama	katastrofalnom	Case
gore	verovanja	Case
tržištima	ispitivanja	Number
komercijalnoga	mesa	Case
izvršiše	hvaljena	Tense
najpostojanijima	prijemčivo	Gender
pozivana	ždrijebah	Tense
osvježi	trgnimo	Mood
svjedočaste	dvojila	Tense
tumarajmo	obuhvati	Mood
imun	trubadurska	Case
lipanjske	sjedala	Gender
izmišljate	naviknem	Tense
rascepljivasmo	stigao	Tense
aseptičnomu	narodnih	Gender
specificiraše	skandalizirahu	Mood
osjećajnih	Zemljina	Case
objahah	pobjeđujem	Person
jaši	upecajmo	Mood
obasjajmo	pokaži	Mood
neuspješniju	neuspješnija	lemma
fotogeničnih	fotogeničnijoj	lemma
proračunali	naoštri	Tense
živahan	injekcije	Case
najspontanije	najprimjernije	Comparison
gađaste	spremilo	Tense
bifurkacije	mobilnima	Number
prekidaj	množimo	Mood
iščupa	pobegle	Tense
krȉčavosti	bludniji	Number
najnostalgičnijim	nostalgične	lemma
najevidentnija	evidentnije	lemma
mamurnije	bolesnijima	Comparison
izljuti	skupljajmo	Mood
ščitom	izvedenicama	Case
lutèrān	najkakofoničnijega	Number
pokvarenijima	dugovječnije	Comparison
najznanijih	најискренији	Comparison
krepavaše	raznježene	Tense
crvljivima	zabubaste	Number
moraj	raznežimo	Mood
bičevaše	driblana	Tense
dereš	opisivaše	Person
primoramo	izlučuješ	Tense
obuzelo	pripekoše	Tense
spretniju	najspretnijima	lemma
verifikacije	predsjednice	Number
razradili	otera	Tense
nađen	travnati	Gender
prisegni	raspustiš	Person
sporazumijevaste	ojačavah	Tense
instruktivnijega	hermetičnijima	Comparison
nazivajmo	zabijaj	Mood
bodimo	proslavi	Mood
letačima	autorizirala	Number
specijalno	specijalnoj	lemma
najrječitijim	najneotesanije	Comparison
rasplamsavaj	poremećuješ	Person
kaznile	zauze	Tense
najkrepkijima	kompetentnijima	Number
kriptičnijemu	neumesnije	Comparison
označiše	pobude	Person
zgurimo	popisuj	Mood
najdalji	plimnih	Number
naježi	brusimo	Tense
najbjednijima	najbrutalnije	Comparison
škodi	pomnožimo	Mood
razumevaš	otpočivaj	Person
libijskima	zdepast	Gender
zavodite	plimnih	Number
neoštećene	smetala	Gender
mračno	njujorška	Gender
uzbunjivana	puzimo	Number
vriskali	nesputana	Number
najzaboravnije	neuvjerljiva	Gender
najbrojniji	kuci	Number
radosnim	koprenu	Number
ozljeđivana	skuvao	Tense
ranjivo	najranjiviji	lemma
oholjaše	usađuješ	Person
pratnju	promišljena	Case
nagovešteni	formulira	Tense
istoimenoga	pročitana	Number
iskrcamo	penimo	Person
načina	grešnijih	Case
alarmantna	metalo	Gender
tešnje	istaknute	Gender
zastreš	osnova	Person
inhalacijom	čunu	Number
kušate	meće	Tense
realni	realna	lemma
nabrasmo	zgražavaše	Tense
temperamentniji	mušičavijima	Comparison
neodlučeno	asirskoga	Number
predajmo	odobrovoljuj	Mood
iznošaše	otpočivaj	Person
odanije	uviđavniji	Comparison
najobjesnijom	energične	Gender
nečovječnija	najnečovječnijih	lemma
pismohranama	riječnomu	Case
iscijedismo	posvećujemo	Person
prisilnih	samozadovoljavana	Gender
neprimjetljivima	šaljivim	Gender
iščupaj	trabunjaš	Person
znamenito	bibera	Number
luetičare	tvrdokornima	Number
potkopaste	popran	Tense
nerotkinju	inicijalu	Number
preračunam	transcendiraju	Tense
najšiljatijih	ovlašćivao	Gender
primjedbe	metropolisa	Case
najbodljikaviji	najmuljevitije	Comparison
nesebičnijima	nesebičnome	lemma
najlojalnijim	kuci	Number
obliži	naslutimo	Mood
evidentnoga	autoritativnija	Gender
osuđuj	poboljšaš	Person
šiljasto	prošaše	Number
vetrovitijoj	najvetrovitijemu	lemma
najsvesrdnijega	najoštrija	Comparison
povjerljivija	povjerljivijima	lemma
rešene	zauze	Tense
tragična	baleta	Number
adijabatskim	rupčagama	Case
umrijeste	sniženo	Tense
završi	ublažile	Tense
svetlijima	префриганији	Comparison
razglašivali	utemeljena	Tense
neizbežnih	maorski	Gender
probirala	uloviste	Tense
ugušujmo	urešavaj	Mood
lukaviji	nežnijemu	Comparison
suzbiste	nadživljavan	Tense
nasmijaše	crnčilo	Tense
priznata	posedovala	Tense
događaste	osedlavate	Person
picajzle	vatrenijih	Number
sagradimo	savij	Mood
izdacima	ključnima	Number
razmijenio	vodstvu	Number
obezglavio	sijalice	Number
luduj	opozivajmo	Mood
prognozirahu	stigao	Mood
proćelavo	besposlenijima	Gender
raznobojni	raznobojna	lemma
вреднији	nedohvatljivih	Gender
položile	prebrodi	Tense
procenjuj	sagradiš	Person
jahača	apstrahirala	Number
odanije	ljepši	Comparison
kušate	ubrzava	Tense
grebla	odevana	Tense
najsabranije	sabranijim	lemma
pridrijemala	proćućena	Tense
razdražena	nadvisivaste	Tense
jamči	naslutimo	Mood
natjeravao	jurcana	Tense
čeliči	položimo	Mood
obistinim	kristijanizirah	Person
zaračunaše	izražen	Tense
sramoćah	učlanjivani	Tense
postupalo	islamiziraš	Number
najlojalnijim	vodstvu	Number
sledećih	medijskim	Gender
podgrađujmo	odrađuj	Mood
podržavaj	veštačimo	Mood
krnjimo	najubogijih	Number
pretučeno	zacementiraše	Tense
ponestajaste	poveravate	Person
strašnije	sujevernija	Comparison
gostili	odlete	Tense
najslasnije	škverana	Case
obdari	hoćaše	Person
faktori	ozbiljnijih	Number
retardiranijima	saberivih	Number
pratnju	nekomercijalna	Case
iščupa	stavljeni	Tense
konkurencijom	zemljoradnicima	Case
najzabrinutije	najsediji	Comparison
pohvali	ulovljeni	Tense
kurčaše	otpravi	Person
najkompaktniji	divljačkoga	Gender
odudaraj	nastanjujmo	Mood
lijepu	lijepe	lemma
primoramo	zamrzneš	Tense
simbolično	enklitikom	Number
iščupaj	proširuješ	Person
inverzni	gorska	Case
lišavajmo	nadmi	Mood
oživimo	razlabavi	Mood
nadvisivaše	rudlavomu	Number
odanije	apatičnija	Comparison
snizivala	izgradi	Tense
vlažniji	suvislijemu	Comparison
obrađivasmo	zgražavaše	Tense
zlostavljan	najsposobnijima	Gender
snižavalo	budžetiraše	Tense
rascjepljivasmo	navoženo	Tense
anarhičnih	metalo	Gender
sjala	sredismo	Tense
prisećasmo	izražen	Tense
prognale	formulira	Tense
srebren	izmigoljeno	Number
besparica	igrači	Case
tankoćutnija	tankoćutnima	lemma
predomišljalo	gakasmo	Tense
spomenuti	školjkaste	Number
dodjeljuj	pobledimo	Mood
prozivaš	plješćemo	Tense
razrušiste	trivijaliziraste	Person
topivih	manje	Gender
dražesnije	pridevu	Number
prisećasmo	sašilo	Tense
krabulji	besplatne	Number
zavodite	svetlih	Number
baratani	mahalo	Tense
dosadi	ispraznimo	Mood
najzaboravnijemu	nepromočivo	Number
najrazgovjetnijim	njujorška	Gender
anarhističkih	најчеститији	Gender
najmuževniji	najoštrija	Comparison
luetičare	krivi	Number
smicalice	andaluzijski	Number
smokove	svakakvo	Case
popustljivijima	pišljivije	Comparison
prekidaj	slavimo	Mood
najnezanimljivijih	neshvatljivim	Gender
broji	borimo	Mood
poštenih	poštenu	lemma
bezveznu	spljošteniji	Gender
bljujmo	ispitaj	Mood
provjerena	tikali	Tense
sječiva	šuplje	Case
poduzimajmo	sadržavaj	Mood
sramota	suptilnije	Case
nadjačavaj	raspetljajmo	Mood
kopnenih	majčino	Gender
najsolidarnijemu	najkovrčavijih	Comparison
najnezanimljivijih	detinjastiji	Gender
ustvrđen	ublažile	Tense
najsvesrdnijega	najprodornijima	Comparison
proslavio	čunu	Number
mačevaste	upecala	Tense
grȗdnjāci	netačnima	Number
baratani	prisezalo	Tense
harfe	gavrana	Number
napričasmo	zavezujmo	Person
prisnome	kritičnija	Gender
sicilijanskoj	ucenama	Case
samouverene	transplantacijskima	Gender
najfotogeničnijih	najbogohulnije	Comparison
završi	uvećavala	Tense
metni	proplivajmo	Mood
bodimo	ulizuj	Mood
skupljala	povraćena	Tense
provjerena	imuniziraše	Tense
nepokretnijoj	istaknute	Gender
naiđu	odjeli	Number
najhumornijemu	humorniju	lemma
prepirah	budžetiraše	Tense
kratkovidne	najcrvljivijom	Gender
neuvjerljiviju	tačniji	Comparison
nevernici	elektromagnetskoga	Number
glađim	lukavijih	Comparison
najjezgrovitije	najutješnijemu	Comparison
usidre	beseđahu	Person
potocima	bešavne	Number
monasima	nemom	Case
osetljivijima	crvenkasta	Number
zacementiraj	borimo	Mood
sukobljavaj	osjećajmo	Mood
decembarski	nogometnih	Gender
vrisnule	pobijeljeno	Tense
ukradena	silazio	Tense
invalidsko	najapatičniji	Case
dosađivaše	uzbuđivale	Tense
simbolično	prethodnoj	Number
uzgajahu	odjahivala	Tense
luetičare	asistiramo	Number
ćelavija	najćelaviji	lemma
najjezgrovitije	najšarenijim	Comparison
obezglavljujem	pripravih	Person
koščatijega	jestiviji	Comparison
ustvrdimo	celivaj	Mood
gutam	kristijanizirah	Person
tržištima	svetlih	Number
namernoj	najverojatnijim	Number
finskih	nostalgije	Case
fosilne	sužanjskom	Gender
najobilatije	najblažima	Comparison
koštamo	plutajmo	Person
križarska	pokrenuto	Gender
povjerimo	uzrujavaj	Mood
svićete	raznese	Tense
najzabrinutije	najcelovitijima	Comparison
besprimjerna	najmnogoljudniji	Gender
verni	vernijima	lemma
sablažnjivijima	ključnijemu	Comparison
najspontanije	najhranjivijima	Comparison
nasledne	žestokoj	Gender
spretnim	dostizala	Gender
ogrijah	lijepim	Person
uzvikuj	trebajmo	Mood
tipične	skelete	Case
primetljivijoj	najprimetljivijemu	lemma
punašnijih	pobeljena	Gender
golenjače	vata	Number
najfotogeničnijih	najbeskrupulozniji	Comparison
dijete	metropolisa	Case
preračunavajmo	urešavaj	Mood
najalarmantnijemu	najgrješnijima	Comparison
tiskaj	ocenjujmo	Mood
kopnenih	manje	Gender
pripovjedimo	prilagođuj	Mood
sljedećima	arhitekture	Number
фрустриранији	železni	Gender
intervale	refleksivnijima	Number
žabina	primernim	Gender
razočarani	mlelo	Tense
populariziraste	objedovaše	Mood
sadrena	prdnule	Gender
ekstaze	gavrana	Number
dokučimo	stari	Mood
lekovitu	profinjenije	Number
horizontalnosti	neprijateljstvima	Case
sakupi	smažimo	Mood
fosilne	najsujevernije	Gender
ekvinocij	neizvjesnu	Number
obezglavio	obezglavljena	lemma
obodi	osvetimo	Mood
primjedbe	najhladnijih	Case
ćešeni	posjedovala	Tense
despotske	kranjskoga	Gender
pretpostavljajte	otuđujete	Person
pobeljivane	ulizah	Tense
krckane	ždrijebah	Tense
neumesnijih	razumljivijemu	Comparison
ćešeni	ponižavah	Tense
vrednijega	vrijednima	lemma
lojalniji	neočekivanijima	Comparison
sažaljevah	trianguliraj	Tense
vjerili	несигуран	Gender
jednooka	profinjenije	Number
višom	visokoga	lemma
lipanjske	samozadovoljavana	Gender
svračjih	školjkaste	Number
sagore	biglisale	Tense
razglasimo	zagrizi	Mood
feničke	jadnima	Gender
najekstremnijima	najnesavesnijoj	Comparison
sidrila	zvaše	Tense
povjerimo	zađi	Mood
izjasnih	usvajam	Person
najpovjerljivija	najzavojitiji	Comparison
najrepresivnijima	najprijemčivije	Comparison
razrušiste	bojite	Person
kovertiramo	izgradimo	Person
najzaslužnijima	несигуран	Gender
završi	glasali	Tense
nenameran	zelenilo	Number
bezglasni	budžake	Number
obdari	fasciniraše	Person
kucah	hlapim	Person
vagama	šatrovačkomu	Case
sagledivi	sagledivih	lemma
prisjetiste	prevođaše	Tense
strastvene	istaknute	Gender
prostre	rasijavamo	Tense
uspješnije	sentimentalna	Gender
najčastohlepnijim	najčastohlepnijima	lemma
najdragocjenijemu	najlakovernijima	Comparison
zarudimo	sklanjaj	Mood
najelokventnijoj	najnestalnijima	Comparison
bezobrazna	količniku	Number
najpribraniji	pribranu	lemma
najkršnija	kršnije	lemma
obogati	osušena	Tense
nailazi	srušimo	Mood
zaglibiš	plašaše	Person
topivih	najtromije	Gender
provjeravahu	prostru	Person
nečovečni	nečovečniji	lemma
dosegnimo	preslikavaj	Mood
najmanjega	najbogohulnije	Comparison
himbenije	ponositijemu	Comparison
propereš	plašaše	Person
najučinkovitijemu	pripomenuti	Gender
najzaslužnijima	iskričavijemu	Gender
opsjedaj	klikćeš	Person
hvalospjevima	aritmetička	Number
prirodna	prirodnoga	lemma
dojašimo	guši	Mood
kapnu	nabiše	Person
zborimo	stari	Mood
nerazgovetnoj	ovisnije	Gender
dževajirima	platnima	Number
bočicu	poznata	Number
despotske	maorski	Gender
ponavljala	podržani	Tense
razdražena	množila	Tense
poželite	uručite	Person
pomažu	davahu	Person
sljedećima	vata	Number
govorljivije	bezosećajnijima	Comparison
verifikacije	ozbiljne	Number
čitave	prebacivane	Gender
doprinesene	kazivao	Tense
sretnijima	beznačajniju	Comparison
uglovi	tjestenine	Number
odvežimo	zabijaj	Mood
pišljiviji	šarmantne	Gender
sagore	osušena	Tense
emotivni	teškoće	Case
proračunali	dočekana	Tense
preplaćeni	raščlanjivaše	Tense
najplesnivijim	najepohalnijima	Comparison
gostili	zgražavaše	Tense
pecan	uvećavala	Tense
poznajmo	ašikuj	Mood
gospodarite	isteravajte	Person
protjerana	gakasmo	Tense
sapletu	beseđahu	Person
progrizam	najtegobnijega	Number
razrokija	prebacivane	Gender
diskvalificirasmo	nabavljajmo	Person
opeklo	razjedinismo	Tense
tuberkuloznima	građevinskoga	Gender
obogati	opali	Tense
istovarila	bezobzirnijima	Number
humanijega	crvljivije	Comparison
silno	asirskoga	Number
neplodnih	otvorenije	Number
aktivnu	najrezistentnijom	Number
uvezujmo	dogovori	Mood
zaglibiš	sniježi	Person
najstrašnijemu	izdisaše	Number
namočen	delale	Tense
zovite	opremite	Person
svrati	udarajmo	Mood
mrači	ocenjujmo	Mood
trpi	krpimo	Mood
pojedosmo	ispitivanja	Number
prepustimo	nadmi	Mood
mnogovrsnijom	radoznalijima	Comparison
tulumarimo	zaželi	Tense
nepopustljivijima	saberivih	Number
čekirao	nepromočivo	Number
preventivne	sputanija	Gender
čitave	zdravije	Gender
lucidnomu	trapavima	Gender
morfeme	društveni	Case
najpovjerljivija	najkišniji	Comparison
isključi	sagrešimo	Mood
rustikalnih	uzvišenijom	Gender
krhotinama	naga	Number
oblizivana	prepolovismo	Tense
najmanjega	najbanalniji	Comparison
umiri	pregovarala	Number
dunuli	pohlepna	Gender
oglođi	iznajmimo	Mood
spomenuti	torzijskih	Number
bubaj	ocenjujmo	Mood
podučavaše	djeluje	Person
višnjama	gavrana	Number
najgladnijih	најразорнији	Comparison
najdrastičniji	najudaljenije	Comparison
kòpljanīk	limunove	Case
pripaja	učinkovitije	Number
razrađivano	sniježaste	Tense
obranila	odupresmo	Tense
rasklapasmo	ražestila	Tense
državljane	obaveštájci	Number
zadavljuj	kokodačimo	Mood
razmišljaj	nastanjujmo	Mood
umrijeste	mlelo	Tense
najdražesnijih	najčudesnija	Comparison
basnoslovne	agrotehnički	Gender
skupljačem	dovitljivoj	Number
svrstavao	napredovaše	Tense
utrkuj	studirajmo	Mood
neuralgičnoj	neuralgični	lemma
obasjajmo	svladavaj	Mood
tiskahu	izjednače	Person
romantičnijih	očevidnijemu	Comparison
bježiš	zaviruj	Person
protestima	taktičnoj	Case
sporazumijevaste	iscrpljena	Tense
nečiste	ogorčeni	Gender
uviđaj	otpadajmo	Mood
bubuljičavijima	mlađe	Comparison
kriminalizacija	najdragocenije	Number
uverljivija	neaktivnije	Comparison
izdacima	bešavne	Number
kriptičnijemu	savjesnije	Comparison
najrezonantniji	najsablasnijima	Comparison
izjavi	uvažimo	Mood
ustavni	samouvjerenijemu	Gender
krucijalni	najprisutniji	Gender
potpuna	paucima	Number
najnezgrapnijima	најбљештавији	Comparison
jahača	najsumanutiji	Number
trijumvìrāt	ratoborna	Number
pritisneš	opovrže	Person
izbrisale	odlete	Tense
imenjak	bezopasno	Number
topivih	majčino	Gender
primjerniji	nežni	Gender
prenela	zaraćeni	Tense
nadmoćni	nadmoćnija	lemma
luduj	branimo	Mood
sanjkamo	jabučna	Number
zakrvarili	seizmičkoga	Gender
proničeš	oslanjamo	Tense
kićena	spokojnim	Number
zlostavljan	mučni	Gender
filantropija	mržnji	Number
dosljednije	ekskluzivnijih	Comparison
centrifugalnim	ispitivački	Number
srdžbe	crvenkastima	Number
najsklonija	sklonije	lemma
krȉčavosti	недоказив	Number
žabinoj	totemističkima	Gender
smotriste	prevaljivana	Tense
najrepresivnijima	najegoističnijoj	Comparison
najzaboravnije	strategijska	Gender
ubrao	okruživane	Tense
uspješnije	njujorška	Gender
nemilijima	nemilu	lemma
najglupavijega	najsuvislijima	Comparison
zlotvornijima	bucmastija	Comparison
glosarima	najrelevantnijemu	Case
najrjeđe	najneuspješnijemu	Comparison
eksplozivnima	eksplozivna	lemma
najodvratnijima	najfrekventnije	Comparison
civiliziraniju	civilizovanijima	Comparison
gandži	servisira	Number
ozlede	uzmičem	Tense
zaceljivaše	secira	Person
smotriste	zapisah	Tense
travestija	zavidni	Number
ponestajaste	poverujte	Person
skupljala	štipana	Tense
najrazvedenije	norveško	Number
obrisana	zauze	Tense
nadopunjeno	besplatne	Number
paprenijim	sićušnija	Comparison
izručeno	imuniziraše	Tense
pripaja	sporne	Number
čučni	raznosimo	Mood
ukrotivo	pleonastičan	Number
razoružavahu	dočekana	Tense
aktivnu	zbiljskome	Number
omogućavajte	okivaste	Person
karboksilna	proreče	Number
slućah	napomenem	Person
neuredne	tankih	Case
simplificiraste	povećavate	Person
doprinesene	odlete	Tense
krši	podsetimo	Mood
urugvajskim	bestelesnima	Gender
labavimo	podvostruči	Mood
preseli	paradiraš	Person
rigoroznu	proklinjana	Gender
empirijskome	prethodnoj	Number
saperu	tuširahu	Person
ekscerptu	internacionalan	Number
najpribližnije	najcelovitijima	Comparison
upijte	ukopavaste	Person
imenovaste	anotirah	Mood
prizvuku	skladnijemu	Number
kićene	najklizavijima	Number
темпераментни	lajk	Number
kockaju	nadživiš	Tense
prenela	osušena	Tense
zasađuj	zapustimo	Mood
najpreciznijima	besmrtnu	Gender
razglašavaj	trgnimo	Mood
nepretencioznijih	prepredenijemu	Comparison
sastavim	obračunah	Person
retardiranijima	krljuštima	Number
preseli	namenjuješ	Person
lutèrān	bludniji	Number
pripremana	monetarno	Gender
isušivane	čeprka	Tense
pretpostavljajte	dopuštate	Person
ustrajna	petini	Number
aktivnu	elektromagnetskoga	Number
završi	opsovali	Tense
kanalskima	osmijesima	Number
bezosjećajna	najbezosjećajnije	lemma
pogasismo	podrazumevajmo	Person
najčudotvorniji	neobičnome	Number
napasti	odseku	Case
sprovodima	pozornijemu	Case
transliteriraste	otuđujete	Person
junačnijega	strahotnije	Comparison
ledeniji	složnija	Comparison
našla	rascijepljen	Tense
najradosnijim	najuspravnijima	Comparison
miru	rješivi	Number
bodimo	smaži	Mood
kulturnije	neistinitijih	Comparison
krepljahu	najantipatičniji	Number
pecan	optuživaste	Tense
podgrađujmo	tali	Mood
skupljala	ulagahu	Tense
hvastavijoj	jestiviji	Comparison
valovitijima	proticana	Gender
trijebi	povrijedimo	Mood
najsenovitijima	najmuljevitije	Comparison
vagama	neredovitoj	Case
najhranjivijemu	najhranjivije	lemma
zgurimo	pobij	Mood
špijala	nadživljavan	Tense
odstupaše	pristavlja	Person
pripaja	речни	Number
nesvesna	lajk	Number
prisećajmo	krvari	Mood
zborimo	uživaj	Mood
riđu	fildišu	Number
cimnu	ugađam	Tense
elementarna	teatar	Number
smokove	naglo	Case
ksenofobija	poduhvatu	Number
junačnijima	ukočenijim	Comparison
natjerujete	izluči	Tense
obodi	proplivajmo	Mood
godišnjih	godišnja	lemma
najznakovitija	najmilitantnijom	Comparison
jahača	gracioznijega	Number
kompaktno	dostizala	Gender
nasmešimo	cerekaj	Mood
vitrine	esej	Case
kramara	budžake	Number
nasiti	biglisale	Tense
razočarani	očara	Tense
utješno	ulizao	Number
prenela	anketiraste	Tense
savršena	strašno	Gender
nelegalnima	nelegalnu	lemma
nejasnijoj	blagonaklonoga	Number
propatimo	ometaj	Mood
pokvarenijima	eruptivnijega	Comparison
elitnima	elitnomu	lemma
objesniju	objesnija	lemma
uzvikuj	skrasimo	Mood
najmutniji	mutno	lemma
pritisneš	posveti	Person
pitomije	izmigoljeno	Number
propih	nastanjeni	Tense
podvede	pobjeljujete	Tense
sijedimo	načni	Mood
neprovidnim	lunarnu	Number
razglašeni	zvaše	Tense
ismijavaj	krikneš	Person
logičkima	mišićavoga	Gender
sjenovitiji	pohlepnijima	Comparison
raseče	učlanjivani	Tense
mnȍžino	najsavjesniju	Number
najiskoristivija	nerafiniranima	Gender
izoštri	pomnožimo	Mood
bezosjećajnijoj	bodrijima	Comparison
djelomične	prijesno	Case
najsablažnjivijima	najbrutalnije	Comparison
bubaj	borimo	Mood
šištao	rukovođasmo	Tense
poruši	prokle	Person
zablistajmo	truj	Mood
livadska	inicijalu	Number
tijesne	otmeniji	Case
najcrvljivijoj	najpljesnivijima	Comparison
kȑčmē	izmigoljeno	Number
destruktivne	provokativna	Gender
homogenu	elektromagnetskoga	Number
tržištima	obaveštájci	Number
ojačasmo	opčinjavan	Tense
težimo	olabavi	Mood
paprenijim	složnija	Comparison
odnarođuju	naslutiše	Person
odvukli	ogorčeni	Gender
stradala	silazio	Tense
sablažnjivijima	privrženijega	Comparison
porozan	pročitana	Number
najsolidarnijemu	najljudskijih	Comparison
najkomunikativnijih	несигуран	Gender
pregrijana	zaposlenije	Gender
provaljuješ	transcendiraju	Tense
arhaičnoga	strategijska	Gender
svrati	preostanimo	Mood
nasiti	uvećavala	Tense
zgurimo	odrađuj	Mood
najznanijih	najprikladnijemu	Comparison
pristanimo	zabijaj	Mood
analgetičkima	analgetički	lemma
odgovarajte	preminuste	Person
zabrljalo	zapuštahu	Tense
samobitnijih	pišljivije	Comparison
liberalniju	liberalnija	lemma
apartnih	sjenovito	Gender
savinu	reminiscirahu	Person
rešene	otera	Tense
obezglavljivaste	otuđujete	Person
najsamobitnijima	најбљештавији	Comparison
blještavo	najblještaviji	lemma
najnezanimljivijega	nezanimljivo	lemma
zastrašiste	pogledan	Tense
autoritarnih	najkrupnije	Gender
nabusitijima	iznenađenijemu	Comparison
sagorevana	sanjkanja	Number
motkama	svetskim	Case
opljačkajmo	osiguraj	Mood
preštampavana	prožela	Tense
sjao	grmljaste	Tense
najimpresivnijih	krstašima	Number
borile	opsedaše	Tense
pomirismo	asfaltirala	Tense
čestitiji	debilnijima	Comparison
čulo	prethodnoj	Number
naseli	uklanjale	Tense
opeklo	odupresmo	Tense
uzvišeno	najuzvišeniji	lemma
posuđivan	uspavljivasmo	Tense
preskoči	smažimo	Mood
naoblači	zapustimo	Mood
funkcionalna	funkcionalnima	lemma
tešila	izoravahu	Tense
prezalogajivah	krolavaj	Number
snizivala	kušala	Tense
banalnija	strpljivija	Comparison
sjala	srkaste	Tense
dašćimo	sadržavaj	Mood
prenela	nastanjeni	Tense
znamenito	spominje	Number
medveđe	zlonamjerne	Case
predomišljalo	učlanjivani	Tense
gospodaraše	zabeležila	Tense
rascijepano	rodili	Tense
naiđu	atašeima	Number
obranila	porobljavani	Tense
besnjeli	faksiraše	Mood
isprobajmo	rvaj	Mood
bifurkacije	nepristupačna	Number
strašnije	čudesnijemu	Comparison
tržištima	crvenkasta	Number
svesnije	svesnijih	lemma
besvjesnim	zakopavam	Number
puhnimo	potrudi	Mood
prigušivala	štampa	Tense
gađaste	pizdeo	Tense
iščupaj	ugasi	Person
oglođi	podsetimo	Mood
neprimjetljivima	pokrenuto	Gender
uzbudljivih	dokazima	Number
velikodušnije	ljepši	Comparison
nagliji	vjetrovitijima	Comparison
upravljaste	uručite	Person
signala	strmi	Number
namernoj	zbiljskome	Number
razrokija	totemističkima	Gender
najšarenijemu	najtraumatičnijima	Comparison
tešnje	daljnje	Gender
istoimenoga	nabodeno	Number
dosadnima	donošasmo	Number
lukavu	izjednačio	Number
neprincipijelnomu	sanacijama	Case
smotriste	dostavilo	Tense
razgrizao	pomicahu	Tense
svjetlija	najsvjetliji	lemma
najnelojalnije	nelojalnima	lemma
poljubimo	sklanjaj	Mood
crkavaše	izgrađuješ	Person
odvukli	iskričavijemu	Gender
verodostojniju	najverodostojnijima	lemma
beznačajnijima	vȃrci	Case
protjeramo	dotrčimo	Person
izliječe	djelam	Tense
jamči	sagrešimo	Mood
svestrana	ceremonijála	Number
naiđu	ispitivanja	Number
zlovoljnijima	veselije	Comparison
pridobivala	zgražavaše	Tense
kolokvijalni	najsublimnijemu	Gender
prelaznih	kotorska	Gender
nečiste	najproizvoljnijega	Gender
podudari	osušena	Tense
priznata	osvajaše	Tense
najfotogeničnijih	najispraznije	Comparison
najneobičnije	učinkovitije	Number
najbezobrazniji	najfrekventnije	Comparison
bezbolni	bezbolna	lemma
dohvate	nadvladavaš	Tense
najintenzivnijom	intenzivniji	lemma
prisluškivali	poniženo	Tense
nabadajmo	pokrsti	Mood
prelaznih	zglobnu	Gender
obvezivaše	sokolile	Tense
čitljive	čitljiva	lemma
sramota	nostalgije	Case
iščupa	izložena	Tense
najbesavesnijima	najispraznije	Comparison
proučavajmo	podstavi	Mood
stiskajte	jeknule	Number
pratnju	zlonamjerne	Case
obuzelo	impresionirale	Tense
preračunavajmo	uživaj	Mood
obogati	bljuzgale	Tense
ruska	saberivih	Number
svesnija	savršenijoj	Comparison
crkavaše	otpočivaj	Person
pedagoga	zlonamjerne	Case
nezamjenjivo	apsurdnima	Gender
siromašniji	siromašnu	lemma
rasijavalo	budžetiraše	Tense
lošija	najlošiji	lemma
tešila	avanzirala	Tense
razotkrih	pohabane	Tense
kantonskim	najdragocenije	Number
nenavidelo	prsnusmo	Tense
besposleni	ratoborna	Number
najrodoljubivija	neobičnome	Number
opominjimo	odobrovoljuj	Mood
komešaj	zanimajmo	Mood
beskompromisnoj	karizmatičnima	Case
učenička	bolujmo	Number
sakupi	kartajmo	Mood
heterozigotnu	longitudinalne	Gender
propijaj	pomnožimo	Mood
indoeuropskim	osornih	Gender
usavrši	raznežimo	Mood
srnuste	zadajte	Person
protjerana	opali	Tense
anarhičnih	trlo	Gender
svračjih	nervoznima	Number
cičahu	razgrizu	Person
turpijali	samouvjerenijemu	Gender
najkonvencionalnijoj	sanacijama	Case
obrisana	onemogući	Tense
nemoćna	sporedne	Gender
skupljajmo	izgrebemo	Person
niža	najnižih	lemma
топивији	zavojitijih	Comparison
verska	najreprezentativnije	Gender
opljačkajmo	popisuj	Mood
angažiranih	krstašima	Number
dragocjenijima	važniji	Comparison
upozoravah	impresionirale	Tense
spletko	puščani	Case
koriš	veseli	Person
luduj	frigajmo	Mood
napravimo	vrijeđaj	Mood
suhe	bandoglavih	Case
najvoljnijima	besavesnom	Gender
pokrivana	odlete	Tense
preruši	glasimo	Mood
darovah	obarale	Tense
armenska	veslanje	Case
pritisneš	sapiraše	Person
nadzirimo	zamrznusmo	Person
ovladala	istraživana	Tense
obasjajmo	karaj	Mood
skočimiševima	iscjeđujemo	Number
kontrola	nepristupačna	Number
šarmera	tehnologije	Case
despotske	prospektivnome	Gender
šupljikave	paucima	Number
iznuđivale	huljeno	Tense
potpisivala	stavljeni	Tense
zavladavaju	portfeljima	Number
sagore	najavila	Tense
proriči	opredelimo	Mood
najbistroumnije	trivijalnima	Gender
najiskoristivijima	najponosnijim	Comparison
aterirahu	asfaltirah	Mood
najnepoštenijima	najneodlučnijemu	Comparison
zauzdajmo	dremni	Mood
divljaštva	tvrdokornima	Number
najljubomornijom	najglupavijima	Comparison
čavčjih	čavčja	lemma
vjerno	najvjerniji	lemma
aspekt	albanologijska	Case
podržavao	podržavana	lemma
simetričan	najmnogoljudniji	Gender
umiri	lunarnu	Number
razinom	slepima	Case
mahni	zapregnimo	Mood
razmijenio	ekstravagantnijom	Number
skupljajmo	śedimo	Person
predajmo	osudi	Mood
najmelankoličnijima	najneobuzdanijega	Comparison
tupljoj	ljuća	Comparison
neprimetnima	antireligioznu	Gender
usuđuje	nameravate	Tense
potmule	suludima	Gender
čamama	statìstičārkā	Number
samokritičniji	pregnantnije	Comparison
lojalniji	sretnija	Comparison
najvjerojatnije	neizlečiva	Gender
uglovi	sumnjive	Number
najiskričavija	iskričavije	lemma
upila	dremljivih	Gender
obuzelo	sredismo	Tense
otmei	fotke	Number
iznuđivale	učiše	Tense
bifurkacije	oficirima	Number
popularnijih	префриганији	Comparison
kranjski	inovativna	Case
znamenito	cerom	Number
rascijepi	punimo	Mood
najapstraktnijih	grabljivima	Number
hrani	zgruša	Person
remećahu	razgrizu	Person
вреднији	paleontološki	Gender
dražesnije	sabotaži	Number
potpuna	ozbiljnijih	Number
ojačasmo	spominjalo	Tense
isključi	udarajmo	Mood
uzrujaj	nabrbljajmo	Mood
potocima	crvenkastima	Number
najdijaboličnijom	šumnomu	Number
uplovimo	miješaj	Mood
mahni	osjećajmo	Mood
kakvu	pokunji	Number
ublažavana	izoravahu	Tense
lakomislenijima	čudotvorniji	Comparison
zrnate	šaroliko	Case
dugoročniji	žive	Gender
usavrši	množimo	Mood
senovitiju	najsenovitijima	lemma
nesavesnija	ažurnija	Comparison
balkaniziraše	anatemizirasmo	Mood
besramne	sledeća	Number
parade	kvarna	Number
aprilske	strmi	Number
pojedinih	pojedina	lemma
simetričan	frustrirani	Gender
dosežemo	nabiješ	Tense
urešena	mehaničke	Gender
razdvajana	sejšelske	Gender
агогични	činjenična	Number
obeščašćeno	rješavahu	Tense
najsmješnijom	najotrovnijima	Comparison
najčudotvorniji	slasnom	Number
zapadnima	nacrtajte	Number
poblijedimo	pobij	Mood
snižavalo	olabaviste	Tense
najzaboravnije	muljavima	Gender
adverbnih	sjenovito	Gender
miru	mlada	Number
najjadnije	najiskoristivije	Comparison
kulture	doseljenici	Number
obasjah	obustavila	Tense
najnepoverljivijima	najlucidnijoj	Comparison
šira	široko	lemma
učenička	osmijesima	Number
tajaše	zasloni	Person
sahranjujemo	laštasmo	Person
severnjacima	zvézdā	Number
huškao	avanzirala	Tense
stružimo	zagrlismo	Person
serioznijih	oporijemu	Comparison
nagradimo	presadi	Mood
najsjenovitijima	najgrešnijim	Comparison
razastrte	odlete	Tense
zabrljaj	razodjenimo	Mood
fašističke	tjestenine	Number
sagorimo	razjedinjavaj	Mood
znakovito	najznakovitije	lemma
sjašimo	utovi	Mood
zijevaju	skalpiram	Tense
vitrine	bolujmo	Number
tipične	odseku	Case
jamči	glasimo	Mood
razgovetne	netaktičnomu	Gender
nekomunikativna	problematičnih	Gender
pripaja	aerobnim	Number
vernija	najverniji	lemma
najlošiji	patkica	Number
balkaniziraše	kleknuli	Mood
odvukli	agilan	Gender
bezglasni	otvorenije	Number
domislimo	izgradimo	Person
slobodnima	slobodniji	lemma
olabavimo	najedosmo	Person
finskih	cenzusa	Case
prostri	pokopajmo	Mood
muti	uvažimo	Mood
travestija	nepogodne	Number
guščadi	inicijalu	Number
združismo	rascijepljen	Tense
kramara	netačnima	Number
zapregnu	okrivljuj	Person
protestima	drenu	Case
najpotišteniji	najromantičnijima	Comparison
shizofrenije	asimetričan	Case
uštinimo	miješaj	Mood
plemeniti	izrezao	Gender
najbezglavijih	najdrevnijemu	Comparison
sklopi	smijmo	Mood
poseduju	nabiše	Person
kvantitativnu	palatalom	Number
hrvatskosrpskima	odgrizalo	Gender
sukobljavaj	pobledimo	Mood
obogati	najavila	Tense
ljigavu	učinkovitije	Number
poblijedimo	odaberi	Mood
najbezbolnija	definitivnu	Number
primjedbe	židovskih	Case
diskriminira	posveti	Person
dosegnimo	osiguraj	Mood
kolokvijalni	najhimbeniji	Gender
položile	transportira	Tense
čovječniji	podmuklije	Comparison
ažurne	poslednja	Number
ustupi	otpadajmo	Mood
utješno	pljačkan	Number
čulo	poduhvatu	Number
ostvaruju	sniježahu	Person
najekstremnijima	najnepodobnijemu	Comparison
potocima	tenisačke	Number
nastanjivani	seizmičkoga	Gender
šeći	iskočimo	Mood
primitivnima	pokrenuto	Gender
kantonskim	prozirno	Number
inspiriramo	popraćivasmo	Person
najbesavesnijemu	najveštija	Comparison
dosađivahu	sasijecan	Tense
pojedinačni	poduhvatu	Number
ovjenčaste	zapošljavajte	Person
čeliči	iskočimo	Mood
predajmo	ogovaraj	Mood
mame	frontalnih	Case
iregularnome	teistu	Number
crkavahu	otapala	Tense
fluvijalne	suludima	Gender
sagorevana	horugvama	Number
razjedini	porumenimo	Mood
alpskoj	efemerno	Number
sumnjičavija	sumnjičavijima	lemma
mračno	strategijska	Gender
platnenu	pridevu	Number
lukavu	rješivi	Number
ustvrđen	zabeležila	Tense
golenjače	crvenkastima	Number
najintrigantnijima	netačnima	Number
kićasmo	obuzdavalo	Tense
simpatičnoga	taksistom	Number
kriminalizirasmo	pretražismo	Person
samostalnima	samostalnija	lemma
tutorstvo	korjeniti	Number
odudaraj	odmamljujmo	Mood
ozlede	slomiš	Tense
najstrmijega	strmo	lemma
penji	nabijajmo	Mood
nizinsku	merljivima	Gender
brojniji	strpljivija	Comparison
dojašimo	cerekaj	Mood
srći	odmamljujmo	Mood
pregrejani	obuzdavalo	Tense
smicalice	veselim	Number
šljìvīk	nenameran	Number
sledećih	elitni	Gender
rađalo	oženiše	Tense
neodlučena	urođenima	Gender
razuvjeravaj	obilujmo	Mood
kratkovidnosti	najlicemjernijemu	Number
neobuzdanije	zloćudnije	Comparison
smiči	pravdaše	Person
nepokretnijoj	retrofleksne	Gender
usisao	samoglasnička	Number
čamama	vatrenijih	Number
bajonete	istinoljubivija	Case
lutèrān	visprenoj	Number
deminutivi	baleta	Number
pojavljivah	osušena	Tense
razlikujmo	ulizuj	Mood
skupljačem	apriornoga	Number
najnepogodnijemu	najbrža	Comparison
odustaje	upriliči	Person
bezbolne	radozaloga	Gender
privlačnija	sporedne	Gender
tučeno	pridodaste	Tense
prisjetiste	posedovala	Tense
najdemokratskijih	najdemokratskiji	lemma
uračunavaj	opčinimo	Mood
naseli	uvećavala	Tense
provjerena	razlikovala	Tense
serioznijih	drastičniji	Comparison
krucijalni	rudničkomu	Gender
naberimo	savij	Mood
duhnu	preskoči	Person
najneobičnije	paganizmu	Number
gorskih	crvenkasta	Number
sablažnjena	ulizah	Tense
prostirimo	dogovori	Mood
aspekt	promišljena	Case
najtrjezniji	žive	Gender
ruska	svirajte	Number
mucaste	ponižavate	Person
dragocenija	gavrana	Number
pismenima	brakom	Case
jednostavnije	vetrenjastijima	Comparison
monasima	brakom	Case
dosađivahu	ukrštah	Tense
prekidaj	naslutimo	Mood
procenjuj	akcentira	Person
nezgodniji	talmudske	Number
paljeni	proricaše	Tense
napih	postignem	Person
začahurivaste	opremite	Person
preostaj	krpimo	Mood
upila	najobzirnijih	Gender
plati	krivuljajmo	Mood
ukrasne	veslanje	Case
uzbunismo	posjedovala	Tense
lični	primjeri	Number
besnjeli	stigao	Mood
razvodnjavah	lijepim	Person
dobaciš	ošišaj	Person
listani	razdraživaše	Tense
golenjače	plimnih	Number
neuspelomu	neuspeloj	lemma
najalarmantnijemu	najpljesnivijima	Comparison
svesnija	nepodobnijega	Comparison
uvećavajmo	gibljemo	Person
uštinimo	podstavi	Mood
najkompaktnijima	ozlijeđena	Number
golem	paleontološki	Gender
cijepljasmo	rafiniraše	Mood
nepokretnijoj	najhuđe	Gender
sugrađankama	monstruoznoj	Case
sagorevana	najeruptivniji	Number
grebla	ždrijebah	Tense
nedostaj	pomnožimo	Mood
čulo	tričavo	Number
cvetaj	trebajmo	Mood
dodaj	osnova	Person
uspijevaše	uzbuđivale	Tense
obasjajmo	čađi	Mood
obvezivaše	prerasla	Tense
sagori	natjerujmo	Mood
svojstvenim	asirskoga	Number
mirnijima	probojnija	Comparison
organizirasmo	agitiraše	Mood
neprovidnim	glomaznome	Number
najnastranijih	najnastraniji	lemma
obelodanjivano	nadvisivaste	Tense
otpade	obmanjuj	Person
tutorstvo	zgađen	Number
vitrine	neurološku	Case
najrazgovorljivijima	najšarenijim	Comparison
vitrine	nezamenjivu	Case
neprimetnima	несигуран	Gender
ublažavana	zajahali	Tense
obrađivasmo	rastavila	Tense
nezgodnima	krhkome	Case
агогични	istraživačkoj	Number
najsenovitijima	najprisnijoj	Comparison
najfleksibilnija	nerođenima	Gender
poveravaše	prepiljena	Tense
razrađujmo	smještaj	Mood
uključimo	obuče	Tense
anđeoskim	šarmantne	Gender
obasjajmo	maštaj	Mood
abnormalne	najapatetičnijima	Gender
rodimo	hapsi	Mood
najverodostojnijima	najponosnijim	Comparison
prikladno	najprikladniji	lemma
vjerili	tmastu	Gender
prenela	istraživana	Tense
ugrejavaše	celivaj	Person
razvedenosti	najsumnjivija	Number
državljane	vata	Number
rastjeraše	sagore	Person
romantičnijih	probojnija	Comparison
evanđeoskome	najvrednijima	Case
uskih	najužih	lemma
osvetite	prigušiste	Person
koštamo	izgradimo	Person
fašističke	dodelila	Number
sablažnjena	upecala	Tense
bljujmo	traj	Mood
prozivaš	zabrzavamo	Tense
štemano	uklanjale	Tense
uvlačena	nagrdiste	Tense
razaznajmo	ogovaraj	Mood
teatri	težite	Number
nosimo	miješaj	Mood
oglobite	pravite	Person
drhtali	rasporedimo	Person
vojna	beskičmena	Number
jahača	aerobnim	Number
globljah	cementiram	Person
onanirahu	oklijevaju	Person
spelovasmo	izgrebemo	Person
tutorstvo	teatar	Number
huškao	slizana	Tense
najdalji	krasnorečivima	Number
prolomimo	istakni	Mood
uzvišeno	teškoće	Case
najniže	najširoj	Comparison
preskoči	uvažimo	Mood
gađaste	raskolilo	Tense
najdražesnijih	najegoističnijoj	Comparison
bogaćasmo	brzao	Tense
zauzetija	najzauzetiji	lemma
uzgajahu	prevaljivana	Tense
napomenimo	ujedini	Mood
ludnička	bezopasno	Number
centrifugalnih	neumerenima	Number
zgrozite	prigušiste	Person
najvoljnijima	kružna	Gender
svetliji	galantnija	Comparison
dugoročnijemu	asirskoga	Number
elastični	elastičnijima	lemma
neprijatni	neprijatna	lemma
položile	zvaše	Tense
najčujnije	najsuvislijima	Comparison
obasjah	spoznale	Tense
otporno	pljačkan	Number
sede	pljačkan	Number
bespovratan	institutska	Case
razdražena	kresala	Tense
proriči	studirajmo	Mood
obogati	prigovarala	Tense
neoštećene	izvršila	Gender
propovedajmo	presadi	Mood
hrkaše	hrkalo	lemma
razglašivali	zapisah	Tense
obučimo	ukori	Mood
krakovskima	najnegativnije	Number
sićušnije	mesa	Case
preruši	veštačimo	Mood
razodjeni	otpadajmo	Mood
najbednijoj	impresivne	Gender
sagori	uvežbajmo	Mood
ukopavate	uručujte	Person
razumij	sagrešimo	Mood
nejasnijoj	ceremonijála	Number
probdij	razagnajmo	Mood
pristanimo	smještaj	Mood
lekovita	najlekovitije	lemma
najkomičnije	komično	lemma
iskoristiše	zamerena	Tense
dosegnimo	miješaj	Mood
zajahan	budžetiraše	Tense
ustvrđen	tonula	Tense
separirahu	agitiraše	Mood
skvrči	ratoborna	Number
dozovemo	izluči	Tense
rascepljivasmo	sagledavao	Tense
svojstvenim	amajliji	Number
prostri	ispitajmo	Mood
razvezala	sračunavaše	Tense
naoblačujmo	pokrsti	Mood
proporcionalnoj	najneuobičajenijima	Gender
oglobiš	odvažimo	Tense
sirovo	sirovoj	lemma
prelamaše	spjevaj	Person
obdarimo	procenimo	Person
gorskih	sumnjive	Number
grimasi	apstrahirala	Number
važnom	važnih	lemma
razočarani	transportira	Tense
razvedena	madras	Case
zahvaljujem	obračunah	Person
združismo	proćućena	Tense
moćnici	parazitske	Number
najzaboravnijemu	šlampavo	Number
najneovisniji	isplativi	Gender
zamene	gramziva	Case
napomenimo	razdražuj	Mood
huškao	prikazivahu	Tense
jesnima	dodelila	Number
iregularnome	najnačitanijega	Number
najokretnijima	najbogohulnije	Comparison
najbarbarskijemu	verodostojnima	Case
najdjelotvornijega	najbolesnije	Comparison
najupadljivijima	najutješnijemu	Comparison
elementarna	burmu	Number
najbrojniji	olakšana	Number
bučnijima	osjetnija	Comparison
ustvrđen	prislanjasmo	Tense
dokazivasmo	opravdamo	Person
strastvene	daljnje	Gender
iščupa	zaraćeni	Tense
državljane	presenete	Number
zalijevajmo	odaberi	Mood
željeznima	kaubojski	Gender
snižavalo	nadvladavani	Tense
opeklo	prepolovismo	Tense
čeliči	priušćujmo	Mood
miru	elektromagnetskoga	Number
kratkovidne	adekvatna	Gender
najmanje	najdruštveniji	Comparison
prespavasmo	prisezalo	Tense
besnjeli	apsorbirah	Mood
pridobivala	zaplaši	Tense
razložimo	najblatnjaviji	Number
sapunastih	sapunastu	lemma
realnih	oficirima	Number
tugovao	pomicahu	Tense
dotiskaste	snebivate	Person
nagradimo	osiguraj	Mood
blatio	antisemitskima	Gender
malašnim	pozornost	Number
sramota	prethodnoga	Case
dahu	anketnima	Case
kongenijalnom	polikliničkima	Case
najčuvenijim	najočiglednijima	Comparison
muti	podsetimo	Mood
najzaslužnijima	турбулентни	Gender
posuđivan	srtasmo	Tense
najdragocjenijemu	najsočnijih	Comparison
ispuši	raspetljajmo	Mood
obećane	trošilo	Tense
shvataj	otpadajmo	Mood
naglašavaj	punimo	Mood
pobelila	pomicahu	Tense
najjarče	najrupičastije	Comparison
labavimo	potakni	Mood
razglašavaj	smažimo	Mood
brojniji	neaktivnijih	Comparison
razuzdanije	servisira	Number
obrisana	razumeo	Tense
najjadnije	najtemeljitijega	Comparison
najizrazitiju	najbrža	Comparison
radioaktivno	spominje	Number
golenjače	neumerenima	Number
zavladaj	miješajmo	Mood
posuđivan	sredismo	Tense
uviđaj	glasimo	Mood
najsavjesnijima	protečena	Number
najrustičnijemu	najglupavijima	Comparison
ovlašćuj	raznosimo	Mood
transmisionom	transmisionima	lemma
dosadi	množimo	Mood
pojavljivah	začarale	Tense
najbednijoj	intrigantnije	Gender
topivi	najmnogoljudniji	Gender
atraktivnije	najatraktivniji	lemma
svetionikom	nepoštenijima	Case
zaklinjimo	dodeljuj	Mood
ogledavaste	slušajte	Person
snizivala	saže	Tense
rascjepljivasmo	odlete	Tense
načina	tankih	Case
najbučnijima	kranjskoga	Gender
umišljene	sklonije	Gender
silno	bibera	Number
opeklo	opozivasmo	Tense
uvodimo	hapsi	Mood
ružniji	suvislijemu	Comparison
bestjelesnu	ceremonijála	Number
najmasovnije	masovnijim	lemma
raseče	ulovljeni	Tense
obrnute	drska	Gender
bučnijima	bistrijemu	Comparison
vjernijima	nerealnih	Number
maštu	dužne	Case
večite	vjerna	Gender
prisećajmo	karaj	Mood
laganijima	dugovječnije	Comparison
krojiocima	predsjednice	Number
viđa	prokle	Person
kraćaš	ljubakaj	Person
različitima	zvézdā	Number
proporcionalno	računovođe	Case
hotentotske	autorizirala	Number
base	korpulentniji	Case
sakupi	prikrivajmo	Mood
kantonskim	norveško	Number
leksičkomu	kompleksne	Gender
naberimo	čađi	Mood
mijenja	importira	Person
umiri	bezopasno	Number
istrijebi	najavila	Tense
kolokvijalni	najvremešniji	Gender
nailazi	studirajmo	Mood
protjerana	glasali	Tense
nasiti	balavila	Tense
najpresniji	najljubaznijoj	Comparison
kićena	antimaterijo	Number
zapadnjačkom	hektarima	Case
razbolijevaj	prepoznajmo	Mood
plati	miješajmo	Mood
levajmo	opovrgavaj	Mood
savremeno	najsavremenije	lemma
sramota	herojske	Case
severozapadna	parazitske	Number
piroksilínu	објективан	Number
svrstavao	uspavljivasmo	Tense
panamske	smetala	Gender
ćirilici	ustrojila	Number
izoštravaš	akcentira	Person
mnȍžino	najnačitanijega	Number
dosađivaše	oslobodila	Tense
najnebuloznijima	najmisterioznijoj	Comparison
redovita	redovitom	lemma
najpovjerljivija	najživopisniji	Comparison
prespavasmo	saže	Tense
ojačasmo	otapala	Tense
isceljivao	duvnute	Tense
čovječna	spektakularnu	Number
dugovječnima	prahistorijom	Case
proćelavo	kritičnija	Gender
komplicirah	duvnute	Tense
najelokventnijoj	najvještije	Comparison
osveta	blagonaklonoga	Number
rupičastijima	stroža	Comparison
obasjajmo	odnarođuj	Mood
intervale	vata	Number
rađalo	prozvaše	Tense
najaktuelnijih	pločice	Case
ponavljala	osušena	Tense
harfe	indisponiranima	Number
razdražena	podešavasmo	Tense
vrisnule	presoljavan	Tense
никакав	vunasti	Gender
ustvrđen	prigovarala	Tense
srcasta	karnevalskomu	Number
abecednih	obilazio	Gender
najzaslužnijima	kaubojski	Gender
podmažete	verite	Person
emocionalnima	autoritativnijima	Number
vriska	prokle	Person
isijecimo	pobij	Mood
prisnima	najodmjerenija	Gender
dosađivaše	zabeležila	Tense
somnabulizmima	zobenoj	Case
punašnija	zrnatijega	Comparison
lebdelo	pripadoste	Tense
tremovima	crvenkastima	Number
provjerena	obustavila	Tense
razglašavaj	prikrivajmo	Mood
euro	atrofije	Case
komplicirah	narođeni	Tense
odustaje	batinaše	Person
opljačkajmo	razlabavi	Mood
risao	duvnute	Tense
uspostavljane	tromjesečja	Number
sistematičnija	rečitijemu	Comparison
nadleti	priopćavajmo	Mood
nehotičnijih	prtljažnika	Case
zavidi	zataškajmo	Mood
razvodnjavah	lupam	Person
najkompaktnijima	patkica	Number
pčelinjemu	taksistom	Number
rubeško	neoprezna	Gender
zlovoljnijima	гојазнији	Comparison
mešala	štampa	Tense
umišljene	najproizvoljnijega	Gender
najšiljatijih	nepoverljivijega	Gender
ekscerptu	zgađen	Number
zlobnije	jasnija	Comparison
prodana	preotimala	Gender
odanije	jasnija	Comparison
pozivana	prebrodi	Tense
intervale	takozvana	Number
proizvodne	sklonije	Gender
nosimo	sadi	Mood
najčuvenijim	najuvređenije	Comparison
lagodnija	lagodno	lemma
najstrašnijemu	elektromagnetskoga	Number
negativni	medijskim	Gender
ohlađeno	glasali	Tense
topolama	najsumnjivija	Number
mirnijima	galantnija	Comparison
zapitaste	rascijepljen	Tense
nadahni	verimo	Mood
kretske	ždrala	Case
ocijenimo	zamijenismo	Person
okrade	učlanjivani	Tense
najnevernijemu	deljivoga	Number
rascjepljivasmo	bljuzgaše	Tense
razotkrivahu	versificirala	Tense
kolokvijalni	primitivnu	Gender
domislimo	pregradismo	Person
djelomične	dobročinstvo	Case
zabijana	zacementiraše	Tense
nečovečnijim	malicioznima	Case
samouprava	sistematska	Case
šljìvīk	spominje	Number
trojanskih	paucima	Number
pronalaženi	žudela	Tense
iskričavija	iskričavima	lemma
stiskajte	sumnjive	Number
izopačujete	izlučiste	Person
bodimo	potvrđuj	Mood
domet	teškoće	Case
svesrdnija	neočekivanijima	Comparison
aspekt	zlobne	Case
razočarani	suzdržalo	Tense
obilniju	nesretnijima	Comparison
tugaljivijih	bespravnijemu	Comparison
nedosljednomu	željezničkima	Gender
formiraste	aktiviziraše	Mood
pokunji	klikćeš	Person
ljigavu	glomaznome	Number
filantropija	spominje	Number
ostaviste	nadživljavan	Tense
izbeživi	najnormalniji	Gender
balzamiraše	smaknuli	Mood
livadska	fosilu	Number
laganije	sažalila	Gender
poznajmo	preštampavaj	Mood
kriminalizirasmo	učvršćujemo	Person
uključimo	izluči	Tense
upravljaste	šiljite	Person
zapovijedaj	usađuješ	Person
nikao	rješavahu	Tense
začnimo	urešavaj	Mood
cičahu	besne	Person
homogenu	paganizmu	Number
diftongizacije	netačnima	Number
stavi	branimo	Mood
nasiti	glasali	Tense
mljekarskoj	šugavima	Case
matorijima	izvodljiviji	Comparison
dodaj	promisli	Person
žalosnijega	masákrā	Case
politeizmom	inicijalu	Number
plaćate	uručujte	Person
čučni	preostanimo	Mood
vatrenije	golišavijemu	Comparison
sanjkamo	sanjkanja	Number
vlažniji	veselije	Comparison
pripremnih	zglobnu	Gender
zlostavljan	nežni	Gender
zovite	ponižavate	Person
tustih	pustinjskima	Number
inhalacijom	smotre	Number
najljubomornijom	najromantičnijima	Comparison
sajmišnome	piramidalna	Gender
želite	viđa	Tense
promišljeno	devalvacija	Number
najprotivnijima	најискренији	Comparison
oružaše	usađuješ	Person
obilniju	osvetoljubivijima	Comparison
najčastoljubivijemu	najsuvislijima	Comparison
flamanskomu	tromi	Gender
iskorjenjujmo	duguj	Mood
ćelava	ćelavijoj	lemma
sjekle	očara	Tense
punašnija	golišavijemu	Comparison
oživimo	beži	Mood
zlotvornijima	drastičniji	Comparison
razuvjeravaj	skupljajmo	Mood
istučemo	pobunjuješ	Tense
najbudnijih	zglobnu	Gender
najsušoj	najpotrebnijima	Comparison
nasljednih	nasljednu	lemma
nemaštovitima	podmitljiva	Gender
krȉčavosti	nenameran	Number
izgubljenim	popularizatorska	Gender
najjadnije	najotmenijim	Comparison
razvio	duvnute	Tense
indoeuropskim	azijskima	Gender
destruktivne	najodmjerenija	Gender
najsapunastije	krepkijom	Number
najrazložnije	najzavodljivija	Comparison
kompleksnijima	spasilačko	Gender
decembarski	antisemitskima	Gender
najpliće	plićim	lemma
objektivnija	bespravnijemu	Comparison
štemano	utvrdiše	Tense
razmišljaj	otpadajmo	Mood
akomodira	trabunjaš	Person
najnevernijom	najfunkcionalnijih	Comparison
srći	smažimo	Mood
vodili	izgradi	Tense
istoimenoga	slasnom	Number
prospavaj	kartajmo	Mood
barbarskijoj	osvetoljubivijima	Comparison
kulture	krljuštima	Number
mlohavije	vetrenjastijima	Comparison
svibanjski	traper	Case
gorskih	grabljivima	Number
miru	najprimjerenije	Number
obećane	prebrodi	Tense
proizvođaše	kresala	Tense
uvećah	nadvladavani	Tense
zaštićuj	natjerujmo	Mood
hitra	sklonije	Gender
hlapljaste	proćutela	Tense
rinete	uzmičem	Tense
preventivne	kružna	Gender
vitrine	oficirima	Number
zgurimo	ulizuj	Mood
govorljivije	spokojnijima	Comparison
najgnjusnijima	vremešnu	Gender
nerabljena	svečanu	Case
uzgojili	kranjskoga	Gender
ugušujmo	sadi	Mood
upravljaste	štujete	Person
slavljaste	snene	Number
avarskih	avarska	lemma
najotrovniji	otrovnoj	lemma
slepu	pljačkan	Number
shizofrenije	svijetlo	Case
prostre	izumemo	Tense
orala	otera	Tense
nađen	isplativi	Gender
istarskoga	prirodne	Case
prostirimo	odaberi	Mood
sadržajne	sadržajniji	lemma
uverljivija	ispraznija	Comparison
oživimo	odobrovoljuj	Mood
neodlučeno	ime	Number
krabulji	rješivi	Number
istoimenoga	prošaše	Number
nazvah	spoznale	Tense
postanimo	razjedinjavaj	Mood
priveži	posramljujmo	Mood
maštu	albanologijska	Case
huškao	trijebljene	Tense
ženke	tromjesečja	Number
nezamjenjivo	dostizala	Gender
raspravljan	razvalile	Tense
pregrejani	prigovori	Tense
nevernici	navalila	Number
najtrpeljivijemu	trpeljivijom	lemma
spljoštenih	najzavisnije	Case
poroznijima	samouverenijega	Comparison
zadubimo	odrađuj	Mood
korisnima	korisnija	lemma
najnesavjesnijega	najbodrijima	Comparison
sjašimo	probuši	Mood
uglovi	minimalna	Number
nemoralnija	trlo	Gender
nenametljivi	ukidao	Gender
najmnogostranijima	mnogostranih	lemma
oglobiš	istovarimo	Tense
golenjače	brzopletih	Number
najrazrokijega	najakustičniji	Comparison
agronomskima	detinjast	Gender
najekstremnijima	najiskoristivije	Comparison
zloglasnih	zloglasnu	lemma
zbunjujmo	vrijeđaj	Mood
odstreljena	srkah	Tense
mrači	smažimo	Mood
iskušavaše	pogibaš	Person
uspješnijemu	otrovnijih	Comparison
poteze	neurološku	Case
dugoročnijemu	najsumanutiji	Number
najnesavjesnijega	najzavodljivije	Comparison
najsmješnijemu	najimućnijima	Comparison
očiglednu	smotre	Number
najdetaljnijega	najužasnijima	Comparison
potocima	jabučna	Number
praznovernija	najpraznoverniji	lemma
kulture	tromjesečja	Number
izlječivu	izlječive	lemma
obrisana	pripremao	Tense
svrstavao	pozvana	Tense
giljotiniraše	predvodila	Tense
severozapadna	krljuštima	Number
zadubimo	karaj	Mood
lutèrān	ciglara	Number
jamči	obilujmo	Mood
najzapadnijega	najsvečanije	Comparison
šiljasto	bibera	Number
talasaj	nabijajmo	Mood
pojedosmo	oficirima	Number
spomenusmo	ojačavalo	Tense
treperavijemu	vidljivije	Comparison
stanični	fosilu	Number
proričete	tmaste	Number
nemogući	spljošteniji	Gender
plati	zgražavajmo	Mood
višnjama	nepristupačna	Number
rodimo	rvaj	Mood
usavrši	razagnajmo	Mood
glatka	najreprezentativnije	Gender
ljigavu	pokunji	Number
čovječniji	riskantnijima	Comparison
duhnu	diskreditira	Person
nekomunikativna	transplantacijskima	Gender
izjednačivane	igrivoj	Gender
iskoristiše	odmamljivana	Tense
oblačnije	karoserija	Case
tržištima	strmi	Number
najskladnijega	najarogantnijima	Comparison
žarčima	prominentnijega	Comparison
zalijevajmo	posti	Mood
brdovitiji	veselije	Comparison
kvantitativne	jednolične	Gender
lekovitu	prošaše	Number
vjernijima	inicijativa	Number
najotrcanijemu	ciglara	Number
preplivavajmo	obaveštavaj	Mood
povjerimo	guši	Mood
silno	ustrojila	Number
prelaznih	narodnom	Gender
politeizmom	smotre	Number
sprovodima	kletvi	Case
smokove	obliji	Case
ovladala	nastanjeni	Tense
opljačkajmo	načni	Mood
otapala	jednolične	Gender
imenjak	smotre	Number
zavladavaju	najkrakatijima	Number
morfeme	nakanu	Case
pratnju	zlobne	Case
najplesnivijim	najcenjenija	Comparison
ustvrđen	rascijepile	Tense
vlažniji	dugovječnije	Comparison
najmlađu	najnaseljeniji	Comparison
nepoderivih	pokorniji	Gender
najdetaljnijega	najmunjevitijima	Comparison
sigurnijima	materinskim	Case
autoritativnima	anglosaskomu	Gender
zauzdajmo	zađi	Mood
centrifugalnih	paucima	Number
sumornije	ekskluzivnijih	Comparison
letačima	inicijativa	Number
najvedriji	najdvoličnijima	Comparison
najdragocjenijima	najматоријi	Comparison
kreativnih	najkreativnijih	lemma
uglovi	dodelila	Number
najsmirenije	najmuljevitije	Comparison
riđu	petini	Number
lažnijom	ljuća	Comparison
despotske	svojevoljna	Gender
nepretencioznijih	префриганији	Comparison
podmažete	sudjelovaste	Person
ortodoksniji	ortodoksnu	lemma
bifurkacije	minimalna	Number
beznačajna	pokrenuto	Gender
najrustičnijom	najglupavijima	Comparison
razgovarasmo	iscrpljena	Tense
iskušavaše	trabunjaš	Person
makljaže	careve	Number
zaklinjimo	probuši	Mood
križno	zgađen	Number
realnih	arogantne	Number
najsramotnijom	sramotniji	lemma
podgrađujmo	tutnji	Mood
temperamentniji	smirenija	Comparison
kompleksnijima	nepismena	Gender
nepopustljivijima	sagibate	Number
istarskoga	tehnologije	Case
važnima	drska	Gender
isijecimo	cerekaj	Mood
proslavio	ime	Number
beseđasmo	rangiraše	Mood
najegzaktnijega	teistu	Number
napravimo	sklanjaj	Mood
rascijepi	habajmo	Mood
livadska	cedio	Number
harfe	baleta	Number
priveži	povrijedimo	Mood
iskašljavale	atašeima	Number
fosilne	smetala	Gender
najskrušenijega	pobjede	Case
proljetnom	proljetnima	lemma
najslabašnijima	najodanija	Comparison
kaspijskoga	samouvjereni	Gender
tragična	trošene	Number
diktiraše	naknadi	Person
cijepljasmo	ađustiraše	Mood
ciganite	dočarate	Person
radosnim	ciglara	Number
sugrađankama	pozornijemu	Case
najoholije	najoholijemu	lemma
sporazumijevaste	navoženo	Tense
ruska	arhitekture	Number
ukrasne	mekani	Case
preračunam	urezuju	Tense
samovaše	zadirkuje	Person
lipanjske	provokativna	Gender
otpisa	prigovarala	Tense
ogavnija	čovjekoljubivoga	Gender
križno	činjenična	Number
crtala	opozivasmo	Tense
tupljoj	ažurnija	Comparison
konkurencijom	izvedenicama	Case
vlastitu	radikalcima	Case
zgrozite	pridonesoste	Person
paljeni	formulira	Tense
državljane	platnima	Number
najparadoksalnija	paradoksalnije	lemma
podgrađujmo	uzrujavaj	Mood
tutorstvo	najprimjerenije	Number
obrisana	otpao	Tense
korasmo	otpao	Tense
oplemenjivano	spoznale	Tense
zavidljivima	milijarderu	Case
najiskoristivija	federalnima	Gender
razbjegoh	okruživane	Tense
najžarčega	najhranjivijima	Comparison
nišanjasmo	pribrajamo	Person
pretpostavljena	tajasmo	Tense
razmatrah	sazovem	Person
pojmiš	strahovaše	Person
plovnima	najrelevantnijemu	Case
pohvali	pojavljivala	Tense
ženke	sagibate	Number
avijacijo	andaluzijski	Number
ukradena	prijala	Tense
poseduju	namleše	Person
dojavljuj	sagrešimo	Mood
prestravljivahu	rastavila	Tense
jantarni	iscrpna	Number
gulila	razmisliše	Tense
svrati	povrijedimo	Mood
ljigavu	prošaše	Number
fosilne	izvršila	Gender
provjerena	pojavljivala	Tense
zapitaste	doznah	Tense
riješiš	posveti	Person
iregularnome	natmurenu	Number
elektronskih	elektronska	lemma
темпераментни	definitivnu	Number
svojstvenim	servisira	Number
iznenađivaše	pretplati	Person
топивији	neaktivnijih	Comparison
zlostavljan	žive	Gender
tumarajmo	maštaj	Mood
vijećaše	nastanjeni	Tense
mnȍžino	poduhvatu	Number
nikao	prisjetismo	Tense
samouprava	vremenski	Case
dosadi	raspetljajmo	Mood
faktori	kompilacijama	Number
ekipe	jabučna	Number
zgodno	palatalom	Number
decembarski	longitudinalne	Gender
venoznoga	nesložne	Case
horizontalnomu	cijenjenoj	Number
naglašavaj	udarajmo	Mood
strahovaše	doseže	Person
razdražujemo	umijmo	Person
opasna	rubnima	Gender
sijedimo	razlabavi	Mood
neplodnih	nahuškaste	Number
pismenima	najvatrenijom	Case
patkom	rupčagama	Case
usisao	slasnom	Number
dodaj	ugasi	Person
uvetnim	tamošnjih	Gender
cela	sušilo	Gender
vrpoljilo	meljasmo	Tense
cvetaj	raznosimo	Mood
pojmiš	napijaj	Person
prisegni	iznajmi	Person
najnestalnije	tamošnjih	Gender
kroatizacija	tvrdokornima	Number
ogledavao	železni	Gender
najposlušnije	proklinjana	Gender
najšarmantnijega	najčarobnije	Comparison
havajskih	pohlepna	Gender
najelokventnijoj	najalkoholiziranijima	Comparison
zacelimo	prodri	Mood
ненамеран	najgramzivije	Number
vijećaše	štipana	Tense
varasmo	vaseljenskih	Number
dosađivahu	spremilo	Tense
broji	postignimo	Mood
broji	granjavajmo	Mood
bočicu	angloamerička	Number
saznasmo	poštovalo	Tense
najlakomislenijom	najnatmurenijih	Comparison
lažnijom	složnija	Comparison
stradala	odlete	Tense
besvjesnim	lajk	Number
preostaj	srušimo	Mood
tribajte	refleksivnijima	Number
najljudskije	apsurdnima	Gender
kršnijom	rezonantnija	Comparison
kramara	krasnorečivima	Number
bezdušnijima	najštetnijemu	Gender
broji	gorčajmo	Mood
najprovokativnijemu	najprovokativnije	lemma
kratkovidne	katoličku	Gender
puhnimo	izbjegavaj	Mood
najegzaktnijega	spominje	Number
najumornijemu	karizmatičnima	Case
smrskavaste	sasijecan	Tense
jednooka	glomaznome	Number
najnesavjesnijega	najdvoličnijima	Comparison
deminutivi	povjerljivijih	Number
zabrljaj	frigajmo	Mood
iskorjenjujmo	gnjij	Mood
proćelavo	trivijalnima	Gender
ustavni	zdepast	Gender
zbližismo	prevladavala	Tense
miroljubiva	jestivi	Gender
sledećih	verao	Gender
dojašimo	vrijeđaj	Mood
pridruži	stavljeni	Tense
zgurimo	duguj	Mood
najanonimnijih	najrazuzdanijim	Comparison
začarali	nalomljena	Tense
neodgovornija	veća	Comparison
trijumvìrāt	servisira	Number
sjala	venčasmo	Tense
čupavijima	nerazumljivijega	Comparison
ciganite	poveravate	Person
restriktivnijima	spokojniji	Comparison
crvenjaše	rascijepile	Tense
važnima	bolja	Gender
događaste	proslavite	Person
otapala	problematičnih	Gender
mahni	porumenimo	Mood
gandži	najverojatnijim	Number
obogati	narođeni	Tense
razvodnimo	tali	Mood
nazvah	nadvladavani	Tense
najnepoverljivijima	najekonomičnija	Comparison
nasiti	ublažile	Tense
razdražujemo	plutajmo	Person
centrifugalnih	nepovezanima	Number
priklonimo	obuče	Tense
oliče	naslutiše	Person
odudaraj	utopimo	Mood
dojavile	onemogući	Tense
tumarajmo	naslućuj	Mood
tragična	poručnici	Number
baratani	prigovori	Tense
mekšaše	driblana	Tense
izgubi	borimo	Mood
sedlasta	igrači	Case
naslutila	besmrtnu	Gender
istoimenoga	olakšana	Number
ublaži	opčinimo	Mood
preplaćeni	obuzdavalo	Tense
kongenijalnom	nepoštenijima	Case
najaktuelnijih	mamurnije	Case
priznata	silazio	Tense
razastri	raspetljajmo	Mood
obuhvaćena	odjeli	Number
svibanjski	karoserija	Case
mlohaviji	živahnijima	Comparison
razastri	doživljavajmo	Mood
jaši	povrijedimo	Mood
hladnijima	drastičniji	Comparison
vijećaše	opozivasmo	Tense
krivljemu	krivima	lemma
ograničila	nastanjeni	Tense
kivnijim	bezopasnije	Comparison
naturalnom	amajliji	Number
ugodnijemu	najbanalnijima	Gender
silno	izjednačio	Number
kontrola	ispitivanja	Number
kompleksnima	divljačkoga	Gender
krvoločna	igrači	Case
nadleti	granjavajmo	Mood
nemaštovitima	ovlašćivao	Gender
nadijevamo	pretražismo	Person
gramatičkoga	muljavima	Gender
amputirate	okivaste	Person
analognim	dostizala	Gender
nikao	izložena	Tense
ojačava	svjedočimo	Tense
stječi	akcentira	Person
srcasta	neaktivnim	Number
dobacio	dobačena	lemma
vatrena	vatrenom	lemma
tumarajmo	uvaljuj	Mood
sjemena	savesno	Case
obilniju	sretnija	Comparison
izjasnih	obuzimam	Person
sramniji	razbludnija	Comparison
najlošiji	platnima	Number
najsusretljivijega	spljošteniji	Gender
lični	takozvana	Number
kontrola	horugvama	Number
umišljene	nenaseljen	Gender
spomenuti	dodatna	Number
ovjenčaste	dočarate	Person
srdžbe	dodelila	Number
razlikovala	mehaničke	Gender
stiskajte	netačnima	Number
sušu	suša	lemma
globljah	primamljujem	Person
podgrađujmo	javljaj	Mood
humanitarnima	jaja	Number
odvukli	мандарински	Gender
razjarujmo	nakalemismo	Person
shvataj	kokodačimo	Mood
mračno	najpričljivija	Gender
lekovitijima	neprocenjivoga	Gender
uzvišeno	igrači	Case
gȍvōre	dekadentno	Case
priračunaj	pobeđujmo	Mood
najkovrčaviji	najmlitavijima	Comparison
naglašavaj	pribrojimo	Mood
zgurimo	razlabavi	Mood
najsjenovitijima	najkonstruktivnijega	Comparison
srdžbe	najproduktivnije	Case
najpotišteniji	najsvadljivija	Comparison
poslužiš	opovrže	Person
neumerenijim	bezopasnije	Comparison
kompetentnijega	čunu	Number
prisegni	sklanjaš	Person
razastrte	nadlijetalo	Tense
smicalice	najstrmiju	Number
obrtničke	egipatskoj	Gender
kratkovidnosti	neizvjesnu	Number
zavarala	tovljahu	Tense
umjetničkih	umjetnička	lemma
jantarni	fotke	Number
najljubomornijom	najsediji	Comparison
najotrcaniji	otrcanoj	lemma
kratkometnome	najapolitičnija	Gender
slućah	alterniram	Person
nevinijoj	najnevinijemu	lemma
prostirimo	načni	Mood
prekidaj	trgnimo	Mood
centrifuge	nakanu	Case
šupljikave	dodelila	Number
nezgodnima	pȅtēljci	Case
carigradskih	carigradska	lemma
najpotištenijima	najpijanijemu	Comparison
zacelimo	zagrizi	Mood
pregrejani	ulizah	Tense
ovladala	polagani	Tense
verska	strašno	Gender
triangularna	filmskima	Gender
elementarna	definitivnu	Number
pregrijana	šaljivim	Gender
završi	podržani	Tense
dobaciš	pravdaše	Person
svemoćnome	ustrojila	Number
relevantnija	relevantnima	lemma
ukradena	očara	Tense
pribranije	amajliji	Number
obavija	ustvrđivaše	Person
obarao	anketiraste	Tense
umeren	izostavljeni	Gender
ometi	skupljajmo	Mood
najmodernija	najmisterioznijoj	Comparison
indijansko	strašnija	Gender
lekovitu	ime	Number
tiskaj	pobeđujmo	Mood
ometi	pristavimo	Mood
porozan	slamčice	Number
tešnje	energične	Gender
niskima	niži	lemma
izmišljate	obuče	Tense
nepovjerljivijima	golišavijemu	Comparison
nerazumljive	neurološku	Case
kvantitativne	zdravije	Gender
impertinentnima	najdarovitijim	Gender
najrazumljivije	najvještije	Comparison
onesposobljene	imitiraše	Tense
pošćaše	bivstvuje	Person
odgovarajte	ponižavate	Person
zapovijedaj	dopreš	Person
razdrobimo	hapsi	Mood
jahača	navalila	Number
dominaciji	gorama	Case
autoritarnijemu	lihvarila	Gender
barbarskijoj	apatičnija	Comparison
pretučeno	ukorjenjivahu	Tense
obećava	istupimo	Tense
propijaj	zamjenjujmo	Mood
sanjkamo	svilenima	Number
tijesne	veslanje	Case
zapali	rđaše	Person
utuci	opozivajmo	Mood
mutavija	rupičavijima	Comparison
bednome	najpišljivijih	Gender
ozljeđivana	stigao	Tense
bezosjećajnijoj	znojnijima	Comparison
vitrine	neukrotivi	Case
zapažaju	krparahu	Person
napomenimo	preslikavaj	Mood
ustvrdimo	beži	Mood
kroatizacija	autoritativnijima	Number
izumre	posveti	Person
najmamurnijega	mamurno	lemma
zaplove	sniježahu	Person
pokvarenijima	europskijega	Comparison
hrvatska	prozirno	Number
najmršaviji	najkvalitetnijima	Comparison
autoritarnih	najreprezentativnije	Gender
najbudnijih	neizlečiva	Gender
najbesavjesnije	krezavije	Case
razglasimo	potvrđuj	Mood
hihotaše	prisloniš	Person
lutèrān	akademičarskoj	Number
base	škrti	Case
ustvrdimo	preštampavaj	Mood
emotivno	najemotivnije	lemma
despotske	znojavim	Gender
parade	osamljenost	Number
ustavni	maorski	Gender
pobeljujem	pobjeljujete	Tense
staklenih	primernim	Gender
nosimo	beži	Mood
ažurne	crvenkasta	Number
proizvodne	preliminarne	Gender
neudobni	najsumnjivija	Number
neproduktivniji	porušiste	Number
svojstvenim	istraživačkoj	Number
uplovljavajmo	izbjegavaj	Mood
razvedenosti	autorizirala	Number
povjerimo	osudi	Mood
glatke	elokventno	Number
pitomije	posteljicu	Number
nezakonitim	posteljicu	Number
zauzdajmo	obaveštavaj	Mood
pomaže	osunča	Person
obarao	istraživana	Tense
razgovetne	samouvjerenijemu	Gender
hladnijima	nemarnijoj	Comparison
umjerenijoj	najapatetičnijima	Gender
vijećaše	obmanjivane	Tense
torzijskih	mirne	Case
razložimo	štitolikima	Number
propatimo	oporavljaj	Mood
razradili	sniženo	Tense
uvodimo	vozaj	Mood
neuvjerljiviju	sićušnija	Comparison
paradoksalno	najparadoksalnije	lemma
lekovitija	gnjilijega	Comparison
pripaja	gnevnomu	Number
spiralno	mesa	Case
nepotrebni	rodoljubivo	Case
ćirilici	navalila	Number
naizmjenična	transplantacijskima	Gender
koriš	nastupaj	Person
empirijskome	najbigotniji	Number
anđeoski	antireligioznu	Gender
crkavahu	sasijecan	Tense
zamene	rajski	Case
bezbolne	znojavim	Gender
najpribližnije	najsočnijih	Comparison
opljačkajmo	potrudi	Mood
proriči	starimo	Mood
lukavu	učinkovitije	Number
uzvikuj	zatražimo	Mood
lepši	nogometnih	Gender
prikupile	zauze	Tense
trojanskih	dokazima	Number
zaposlili	otera	Tense
nezamjenjivi	potencijalna	Case
kroatiziraše	ovjenčaju	Person
ubitačnu	rezultantama	Case
kraljuju	nesputana	Number
pridružuj	kovitlajmo	Mood
razvij	pošteđivaše	Person
preventivne	smetala	Gender
najznakovitija	najgrešnijim	Comparison
tržištima	buđavima	Number
zarudela	tendenciozne	Gender
separira	svjedočimo	Tense
odvežimo	podvostruči	Mood
koščatijega	savjesnije	Comparison
razgovarasmo	susretaše	Tense
namočen	odupresmo	Tense
horizontalnosti	nepunima	Case
nepoštenijoj	jednolične	Gender
intelektualne	tjestenine	Number
kidaj	hoćaše	Person
obrisana	čeprka	Tense
radosnim	glagolska	Number
zaštićuj	zataškajmo	Mood
podvaljivale	ždrijebah	Tense
sputajmo	prelistavaj	Mood
plodonosne	plodonosnih	lemma
razglobljivao	srtasmo	Tense
spretnim	ekonomičnija	Gender
taktilno	tehnologije	Case
najbezuspješnijih	najbržemu	Comparison
najbesavjesnije	stran	Case
sjemena	razroku	Case
najkovrčaviji	najuspravnijima	Comparison
očiglednu	tričavo	Number
kulturnije	nezavisnijima	Comparison
sječiva	karoserija	Case
religioznu	prdnule	Gender
obasjah	osušena	Tense
najmnogovrsnijih	najsamokritičnije	Comparison
sažaljevah	obijeni	Tense
zamrzimo	studira	Tense
sitnijim	neuništivima	Gender
kontrola	krstašima	Number
proračunali	odevana	Tense
nasiti	uklanjale	Tense
cjenjenije	proklinjana	Gender
razastri	zamjenjujmo	Mood
razrađujmo	ukori	Mood
priznata	žudela	Tense
andžarima	đavoljima	Number
besposleni	prozirno	Number
punašnija	beznačajniju	Comparison
travestija	najantipatičniji	Number
proizvede	zasloni	Person
najvedriji	najsamozadovoljnijima	Comparison
neoštećene	topljivoj	Gender
izdacima	inicijativa	Number
vodili	strizana	Tense
svrstavao	istraživana	Tense
nostalgičarima	minimalna	Number
razjedini	pribrojimo	Mood
frekventnijima	frekventnu	lemma
religioznu	impresivne	Gender
udavana	trgovao	Tense
isceljivao	tajasmo	Tense
pedagoga	notorna	Case
isprobajmo	gnjij	Mood
uzrujaj	zgražavajmo	Mood
razornu	razorne	lemma
svladavao	glomaznome	Number
sagore	pretraživala	Tense
dosetljiva	najdosetljivije	lemma
balzamiraše	kleknuli	Mood
razoružavahu	preotiman	Tense
doplovi	kokodačimo	Mood
odmjerene	nekažnjenu	Gender
lagodnoj	lagodni	lemma
ništavnoga	dostizala	Gender
pažljivoj	pažljiviji	lemma
najplašljivijima	najskladnije	Comparison
prisegni	abortiraš	Person
pritisneš	hoćaše	Person
mucaste	zadajte	Person
skalpiraše	besne	Person
crkavahu	poštovalo	Tense
postupalo	petini	Number
borile	rascijepljen	Tense
nadvisivaše	rješivi	Number
plemeniti	elitni	Gender
pismenima	glasnikom	Case
tvrdoću	zlobne	Case
obasjah	klađahu	Tense
imenjak	mikrofonom	Number
zbrinimo	svladavaj	Mood
saznasmo	razumeo	Tense
rasprodana	baleta	Number
dokučimo	zaboravi	Mood
šaraše	obustavila	Tense
naviknusmo	stigao	Tense
zlostavljan	jestivi	Gender
združujmo	opovrgavaj	Mood
postanimo	karaj	Mood
najfotogeničnijih	najdebilnijemu	Comparison
tumarajmo	zagrizi	Mood
brojniji	savjesnije	Comparison
penji	studirajmo	Mood
kompaktnima	pokorniji	Gender
isprobajmo	snimi	Mood
najranjivijom	najdruštveniji	Comparison
shizofrenije	neostvariva	Case
neprihvatljiva	preliminarne	Gender
kvantitativnu	glagolska	Number
decembarski	lapidarnima	Gender
najobilatije	najsediji	Comparison
sakupi	uvažimo	Mood
razglobljivao	zapuštahu	Tense
odnarođuju	sniježahu	Person
nemoćnima	sadržini	Case
posuđivan	zapuštahu	Tense
militantnoj	najsumanutijima	Case
zasjenjivaše	sagradiš	Person
bombastičnima	crvenkasta	Number
negativni	izbornoga	Gender
svari	komada	Person
nezasitni	horugvama	Number
nađen	dugovječne	Gender
silno	fosilu	Number
sadašnja	vremenski	Case
potkopaste	nadlijetalo	Tense
uvozila	napredovaše	Tense
uvlačeno	pripekoše	Tense
letačima	probirljivi	Number
iznajmite	krčmim	Tense
piroksilínu	dostižeš	Number
elementarna	mržnji	Number
osjećajnih	nostalgije	Case
prolomimo	načni	Mood
lajasmo	naslikamo	Person
preostanem	doje	Tense
federacijom	fosilu	Number
spoznaj	plašaše	Person
zlonamjernu	predvidljiviji	Number
djelomične	preventivan	Case
ljevoruke	besavesnom	Gender
šeći	preostanimo	Mood
najdarežljivijima	fotke	Number
osveta	neaktivnim	Number
havajskih	nekažnjenu	Gender
praktična	sušilo	Gender
trpi	branimo	Mood
cvetaj	proplivajmo	Mood
najsumnjiviji	sumnjivu	lemma
kongresima	glasnikom	Case
razastri	skrasimo	Mood
abnormalne	aromatične	Gender
točah	junačim	Person
sapinješ	celivaj	Person
čupavijima	stožere	Number
smeonih	nostalgije	Case
trodimenzionalno	narodnih	Gender
nezgodniji	neprijelazno	Number
simbolično	petini	Number
osjetljivih	nostalgije	Case
zavarala	gakasmo	Tense
najpapreniji	odijevani	Gender
oružaše	krikneš	Person
lekovitijom	lekovitoga	lemma
brbljalo	imuniziraše	Tense
intervale	krivi	Number
svetlijima	tmastije	Comparison
neumesnijih	prikladnije	Comparison
otapala	glinene	Gender
razuvjerile	zaplaši	Tense
raznolikija	najraznolikijih	lemma
tribajte	vaseljenskih	Number
kȑčmē	suicidalnosti	Number
paleontološki	nekomercijalna	Case
smjestimo	mnijasmo	Person
kvadratnim	katastrofalnima	Gender
serioznijemu	tamošnjih	Gender
zadubimo	truj	Mood
bazde	tesahu	Person
razlikujmo	ponašaj	Mood
najvjerojatnije	samozadovoljavana	Gender
spomeni	borimo	Mood
rodih	primaknuo	Person
okretno	najokretnije	lemma
debelu	debele	lemma
odmotavano	biglisale	Tense
razotkrih	tonula	Tense
napravimo	očisti	Mood
najslužbeniji	buđavima	Number
ruska	krljuštima	Number
emocionalnima	statìstičārkā	Number
tumarajmo	odledi	Mood
šljemahu	izbavljaju	Person
najupadljivije	najbodrijim	Comparison
kreći	punimo	Mood
oholjaše	fasciniraše	Person
najtoplokrvnijima	najprijemčivije	Comparison
kvadratnim	narodnih	Gender
poveravaše	štemovali	Tense
razjedinjavan	tradicionalnima	Gender
savitljiviji	progresivnijima	Comparison
udavana	osvajaše	Tense
broji	trebajmo	Mood
najbrojniji	količniku	Number
nazovi	uspava	Person
gorskih	ključnima	Number
skrasi	zagasimo	Mood
dragocjenijima	manji	Comparison
moćnici	arhitekture	Number
davno	neuvjerljiva	Gender
svrstavao	zacementiraše	Tense
nepogrešivih	adekvatna	Gender
najsamobitnijima	najneodlučnijemu	Comparison
bifurkacije	svetlih	Number
zbija	nastojimo	Tense
potpisivala	tajasmo	Tense
apsolutizmima	operativnijim	Case
ovjeriše	sporazumijevao	Tense
inspiriramo	umijmo	Person
tuci	skupljajmo	Mood
agronomskima	najvremešniji	Gender
krojimo	naiđosmo	Person
sagrešila	nadživljavan	Tense
svjesnijima	tmastije	Comparison
namočen	začarale	Tense
najužasnije	najdomišljatijima	Comparison
smotriste	razumeo	Tense
proćutjela	ulovljeni	Tense
golišavih	nametljivijima	Number
smirene	smireniji	lemma
ekscerptu	ustrojila	Number
obećane	kazivao	Tense
svrati	trebajmo	Mood
najzračniji	zračnoj	lemma
maknuo	odoli	Person
pomirismo	versificirala	Tense
imbecilnijom	imbecilnoga	lemma
iskači	gorčajmo	Mood
oružaše	dočaraj	Person
најмирољубивији	najdvoličnijima	Comparison
sagore	delale	Tense
praktična	majčino	Gender
odmotavano	spoznale	Tense
neumerenijim	nemilosrdnije	Comparison
sažaljevah	ždrijebali	Tense
apstrakcijama	buđavoj	Case
sirotoga	fatalista	Case
medveđe	računovođe	Case
satrvena	odjahivala	Tense
pismenima	pretvòrivosti	Case
iskači	nabrbljajmo	Mood
sintetskoga	kristaličnu	Number
ismijao	osiromašene	Tense
obodi	krivuljajmo	Mood
vjetrenjastijemu	vjetrenjastima	lemma
neodređenih	pojedinačna	Gender
kȑčmē	vremenitu	Number
uštinimo	ometaj	Mood
flamanskomu	odijevani	Gender
sjedinjavajmo	zarudimo	Person
potrebnije	manji	Comparison
strahovaše	pobunjuje	Person
obelodanjivano	rukovođasmo	Tense
apokrifnu	apokrifne	lemma
despotske	profitabilnu	Gender
oslabiš	gani	Person
najčudotvorniji	petini	Number
seksualne	polimorfizam	Case
najmodernija	najslobodoumnije	Comparison
bolnima	najbolnije	lemma
blebetao	prikazivahu	Tense
viđaju	asimiliraše	Person
sentimentalnih	dostižnijega	Case
svadljivu	najsvadljivijega	lemma
izoštri	uvažimo	Mood
zakrvarili	nekažnjenu	Gender
pretučeno	opasivale	Tense
nepopustljivijima	dokazima	Number
opominjimo	zabijaj	Mood
mnȍžino	islamiziraš	Number
gotičke	milja	Case
bičevaše	okruživane	Tense
dijete	frontalnih	Case
zavidi	natjerujmo	Mood
obogati	porođene	Tense
heterozigotnu	samoukima	Gender
najverodostojnijima	најсузнији	Comparison
fragilnijega	vjetrovitijima	Comparison
podriguj	začneš	Person
najmodernija	najkrvaviju	Comparison
učeni	bezvodnima	Gender
razočarani	spominjalo	Tense
svetliji	prikladnije	Comparison
najznakovitija	najkrvaviju	Comparison
krištanovečkih	krištanovečkima	lemma
uvodimo	potrudi	Mood
aerodinamičnije	krasnorečivima	Number
najdalji	osmijesima	Number
oplemenjivano	podešavasmo	Tense
jezivima	najodmjerenija	Gender
dosadi	priušćujmo	Mood
koturah	onemogućim	Person
kukah	privikla	Tense
srčite	cimnuste	Person
kićene	jaltske	Number
najbenevolentnijih	najbogohulnije	Comparison
neodlučni	paleontološki	Gender
bezbolne	certificirani	Gender
grijan	opasivale	Tense
nenavidelo	nastanjeni	Tense
popustljivija	popustljivijima	lemma
lepši	travnati	Gender
havajskih	освојив	Gender
obdari	dopreš	Person
cijeljena	izobliči	Tense
senzacionalnijih	lóvca	Case
radosnim	olakšana	Number
paljeni	prebrodi	Tense
uvozila	osušena	Tense
matorijima	ukočenijim	Comparison
probijajmo	ulizuj	Mood
najvitalnijega	trapavima	Gender
neukijemu	neukima	lemma
dugoročnijemu	dostižeš	Number
trunimo	budali	Mood
komičniju	najkomičnijima	lemma
istarskoga	dužne	Case
najdragocjenijemu	najsuznije	Comparison
plati	branimo	Mood
tumarajmo	karaj	Mood
pokrio	anketiraste	Tense
ogavnija	pokrenuto	Gender
dostavljaj	pravdaše	Person
odsutna	sklonije	Gender
košmarnima	nesložnije	Number
malašnim	najlicemjernijemu	Number
stradala	namnažala	Tense
proriči	kosnimo	Mood
paradoksi	šaroliko	Case
pripaja	besprimerna	Number
piroksilínu	pedantnije	Number
sintetskoga	beživotna	Number
neprovidnim	nabrusi	Number
raspodele	metropolisa	Case
gostoljubivijega	gostoljubivima	lemma
prekidaj	odmamljujmo	Mood
psalmu	protivnicama	Case
najбуђавијe	najblaže	Comparison
hotentotske	osmijesima	Number
popularnijih	nepokolebljiviju	Comparison
probitačnije	riskantnijima	Comparison
uvećah	kresala	Tense
glineno	narodnih	Gender
utuci	skupljajmo	Mood
brižljive	najbrižljivijima	lemma
najapsurdnijom	apsurdniji	lemma
zasjenjivaše	duši	Person
izjavimo	dogovori	Mood
kriminalizacija	autobiografiju	Number
dospevaše	neizvjesnu	Number
sanjate	ispostavljam	Tense
motkama	nemom	Case
neodlučena	sklonije	Gender
posuđivan	sintetiziraše	Tense
ispuši	raznosimo	Mood
rabote	izjednačio	Number
uplovljavajmo	razdražuj	Mood
posuđivao	najravnopravnijom	Number
najbrojniji	prošaše	Number
obećava	odenemo	Tense
osvježi	pribrojimo	Mood
krepavaše	vrgnuli	Tense
jantarni	gavrana	Number
najpribližnije	najiskusniji	Comparison
ortodoksnijemu	senovitijima	Comparison
mučnija	živahnijima	Comparison
razvodnimo	spazi	Mood
proporcionalno	tehnologije	Case
srpskih	srpska	lemma
potpuna	malima	Number
izjavimo	ometaj	Mood
umjerenijoj	impresivne	Gender
najotmenijega	najveštija	Comparison
uključimo	meće	Tense
sagori	novačimo	Mood
ravnomernima	ravnomerniji	lemma
anketira	provjeri	Person
isprobajmo	smještaj	Mood
domet	trorogi	Case
najtoplokrvnijima	najodanija	Comparison
izravnijemu	razbludnija	Comparison
upila	merljivima	Gender
podriguj	dopreš	Person
kontroverzije	otvorenije	Number
propih	biglisale	Tense
probdij	trebajmo	Mood
učeni	izostavljeni	Gender
zauzdavane	projahao	Tense
čađavljaste	kovitlajte	Person
inventivnijega	zelenilo	Number
nezavidnoj	nezavidnijemu	lemma
prisutnijim	lunarnu	Number
најинвентивнији	najoštrija	Comparison
suoči	muti	Person
najplašljivijima	najtečnija	Comparison
nezakonitim	mržnji	Number
kukah	nagrdiste	Tense
najodmornije	najharmoničnije	Comparison
prirodnijima	plovidbi	Case
trojke	pogubna	Case
prkosnih	asistiramo	Number
grijan	klađahu	Tense
uzbudljivih	tvrdokornima	Number
najsmješnijom	najprozirnijima	Comparison
imbecilnijima	korektnijoj	Comparison
invalidsko	bezdušniji	Case
anđeoskim	tromi	Gender
ružičnjak	zlobne	Case
dosljednije	žalosnijima	Comparison
jesnima	nametljivijima	Number
najfiniji	elitni	Gender
važite	izoravaste	Person
темељит	dužne	Case
iscijeliš	obrukaj	Person
najganutljivija	ganutljivije	lemma
vedriji	vedru	lemma
razbacujemo	dopunismo	Person
dodijelimo	pokaži	Mood
neumornim	duboka	Gender
severozapadna	najantipatičniji	Number
priklonite	prelistavam	Tense
najplesnivijim	najčudnija	Comparison
dokučuje	prokle	Person
preskoči	starimo	Mood
naoblačujmo	zađi	Mood
razgovjetnijemu	plahiji	Comparison
križa	umicaše	Person
najdetaljnijega	najtragikomičnijima	Comparison
teoretizira	norveško	Number
kratkovidnosti	pljačkan	Number
bistroa	najmelodioznijega	Case
kroatizacija	obrazovanima	Number
nemogući	tromi	Gender
sagradimo	smenjuj	Mood
verifikacije	poslana	Number
razmnožiš	doje	Tense
lebdelo	prostirasmo	Tense
zbija	rasplačete	Tense
obavještavane	ozbiljnijih	Number
ugušujmo	stari	Mood
preraspodelimo	smještaj	Mood
iscedite	kovitlajte	Person
proučavajmo	odrađuj	Mood
razrađivano	tovljahu	Tense
svezuj	prikupljaš	Person
šepavijima	spljoštenijemu	Comparison
zavladaj	raznežimo	Mood
arogantnim	lajk	Number
sjemena	ždrala	Case
značajna	značajnom	lemma
zapali	naknađivaše	Person
obranila	zaraćeni	Tense
otmei	najklimavija	Number
odvukli	pohlepna	Gender
savitljiviji	zavojitijih	Comparison
malašnim	besplatne	Number
talasaj	utopimo	Mood
bježiš	obrezivaše	Person
raspodele	verovanja	Case
krnjimo	odnarođuj	Mood
svemoćnome	izmigoljeno	Number
milo	najmiliji	lemma
nesložnijom	nesložnoga	lemma
prolomimo	sklanjaj	Mood
plemeniti	najhimbeniji	Gender
tugaljivijih	oporijemu	Comparison
ozljeđivana	učvrstio	Tense
istaknimo	odlamamo	Person
najingenioznijima	ingenioznije	lemma
ćirilici	izjednačio	Number
najvedriji	najopskurnijima	Comparison
atraktivnija	atraktivnu	lemma
sažaljevah	glasali	Tense
najsuženijoj	antimaterijo	Number
povećamo	bukćasmo	Person
vodili	štampa	Tense
združismo	poniženo	Tense
ubojitije	aleutskima	Gender
umorite	gnjiljasmo	Number
svadljive	metropolisa	Case
opominjimo	otimaj	Mood
pokrivana	transportira	Tense
mlohaviji	masnije	Comparison
svojstvenim	sijalice	Number
nastanjivani	agilan	Gender
spomenuti	češnjake	Number
hrvatska	ganutljivije	Number
tiskaj	zgražavajmo	Mood
zaboravnijemu	zaboravnima	lemma
najapstraktnijih	snizujte	Number
jeziva	najjezivije	lemma
špendirane	oivičivaše	Tense
logičkima	košarkaškoga	Gender
alpskoj	mržnji	Number
razglobljivao	uloviste	Tense
imenjak	besplatne	Number
hrvatska	fosilu	Number
mnogostruk	vješcu	Number
najsarkastičnijima	malima	Number
najšarenijemu	najdostižnijima	Comparison
trojke	nakanu	Case
neplodnih	bezobzirnijima	Number
kratkovidnosti	fosilu	Number
zgrozite	preminuste	Person
rascjepljivasmo	huljeno	Tense
najdefektnije	najalkoholiziranijima	Comparison
beznačajnijih	oporijemu	Comparison
preplivavajmo	zabijaj	Mood
hiljadama	glasnikom	Case
vodili	poštovalo	Tense
trunimo	preštampavaj	Mood
potkopaste	razneživalo	Tense
nasamarivaše	celivaj	Person
imun	astrološka	Case
ograničila	opozivasmo	Tense
najpripravnijoj	pripravnima	lemma
nacionalističku	solidarnoga	Number
utoli	vrgnu	Person
nedosljednomu	smrdljivijih	Gender
rožnica	najnesložnija	Number
srčite	izoravaste	Person
trijumvìrāt	neotesánca	Number
oglobih	povraćena	Tense
obezglavio	količniku	Number
glatka	nepismena	Gender
priračunaj	granjavajmo	Mood
torzijskih	jednosobne	Case
dražesnije	najbigotniji	Number
kognitivno	kognitivnoj	lemma
glosarima	krhkome	Case
nerazvodnjenim	izvršnima	Gender
nosimo	guši	Mood
bahate	najbahatijima	lemma
sagore	prerasla	Tense
prašnijima	pokrenuto	Gender
izgledaj	nastanjujmo	Mood
najalergičnijima	najponosnijim	Comparison
kvadranti	asimetričan	Case
susretljiva	odgrizalo	Gender
kraljuju	trošene	Number
rabote	slamčice	Number
avijacijo	količniku	Number
miru	aerobnim	Number
prokušavaš	pozornost	Number
najrazumljivije	najblatnijima	Comparison
pošumljuju	asimiliraše	Person
dražesnije	suptilnomu	Number
prisećasmo	očara	Tense
cičahu	zataškaju	Person
lipanjske	sažalila	Gender
kašljimo	prevladavaj	Mood
naoblačujmo	razlabavi	Mood
balzamiraše	abortirahu	Mood
razgovarasmo	skuvao	Tense
najraniji	frustrirani	Gender
golem	longitudinalne	Gender
razlikujmo	ogovaraj	Mood
kraćaš	dočaraj	Person
sagori	iskočimo	Mood
propih	uvila	Tense
uračunavaj	ispraznimo	Mood
pridruži	pretraživala	Tense
najvjerojatnije	narodnom	Gender
ustupismo	progonimo	Person
razvodnimo	razlabavi	Mood
centrifugalnim	andaluzijski	Number
galantnijima	izvodljiviji	Comparison
kulture	ključnima	Number
osveta	ime	Number
talentiranima	najtalentiranije	lemma
razoružavahu	kušala	Tense
najšiljatiji	lapidarnima	Gender
skučim	obavijah	Person
beznačajnijih	stroža	Comparison
naoblači	starimo	Mood
dežurnima	dežurna	lemma
povjerimo	zagrizi	Mood
saperu	naslutiše	Person
ledeniji	veća	Comparison
asfaltiraš	spriječe	Tense
gandži	tričavo	Number
kvadratnoj	pivarske	Gender
istoimenoga	devalvacija	Number
prepustimo	celivaj	Mood
težimo	beži	Mood
nasledi	fasciniraše	Person
naturalnom	suicidalnosti	Number
opskurnije	najopskurniji	lemma
ženke	poslana	Number
tržištima	krljuštima	Number
razrušiste	uvrebate	Person
učeni	železni	Gender
prospavaj	kalkulirajmo	Mood
vlažniji	prepredenijemu	Comparison
čežnjahu	jenjahu	Person
prvenstvenima	sušilo	Gender
preruši	podsetimo	Mood
lipanjske	očinsku	Gender
uzbudljivih	krivi	Number
razmicaše	poboljšaš	Person
zabunimo	iscjeđuj	Mood
karboksilna	teatar	Number
stradala	učvrstio	Tense
mešala	ulizah	Tense
zlonamernijima	uzornije	Comparison
procenjuj	prisloniš	Person
zgušnjavajmo	zaboravi	Mood
tešnje	lagodnima	Gender
krši	kartajmo	Mood
razotkrivahu	mlelo	Tense
penji	ocenjujmo	Mood
nadahneš	napijaj	Person
bičevaše	privikla	Tense
sabotiram	dopreme	Tense
najimpresioniranijim	najimpresioniranijima	lemma
riskantnijemu	osamljenost	Number
zavređujmo	pupaj	Mood
najodmornije	najposrednije	Comparison
najvalovitijima	valovitih	lemma
asimetrična	nepismena	Gender
zasađuj	iskašljavajmo	Mood
kompleksnijima	škodljivu	Gender
tvrdoću	nekomercijalna	Case
prenela	logorovaste	Tense
zlonamjernu	slamčice	Number
razvedenosti	abolicijska	Number
nedostaj	osjećajmo	Mood
razjarujmo	gibljemo	Person
neproduktivniji	asistiramo	Number
glibovitima	najizdržljivijim	Gender
najsusretljivijega	šumovite	Gender
base	trubadurska	Case
zlobnije	sićušnija	Comparison
nađen	trapavima	Gender
crvenjaše	preračunata	Tense
razložimo	jaltske	Number
najnepoverljivijima	najsvetlijemu	Comparison
srći	borimo	Mood
najmržiemu	najmržie	lemma
izganjala	srtasmo	Tense
ranjivima	ranjiva	lemma
najšarmantnijega	najtragikomičnijima	Comparison
nerazvodnjenim	željeznima	Gender
najotrcanijemu	neotesánca	Number
formiraste	apsorbirah	Mood
najtvrđima	najnestrpljiviju	Comparison
zaštićuj	skupljajmo	Mood
latismo	venčavana	Tense
nemoćna	ljuće	Gender
poštovanijoj	besprimerna	Number
empirijskome	mikrofonom	Number
krši	zataškajmo	Mood
neuredne	verovanja	Case
skočimiševima	apsurdna	Number
zapadnima	kompilacijama	Number
moćnici	nahuškaste	Number
saznasmo	zablejalo	Tense
šupljikave	nacrtajte	Number
bljujmo	uvaljuj	Mood
propatimo	prilagođuj	Mood
tustih	primjeri	Number
pristanimo	razlabavi	Mood
znamenit	znameniti	lemma
posuđivao	besplatne	Number
pitomih	ključnima	Number
jantarni	careve	Number
tragična	paucima	Number
cimnu	djelam	Tense
davno	dostizala	Gender
elementarna	količniku	Number
bubni	habajmo	Mood
čvrsti	prevodivome	Gender
smeđastoj	čitkoga	Number
milostivijim	normalnostima	Case
neoštećene	kružna	Gender
prelaznih	temporalna	Gender
divljaštva	pustinjskima	Number
staromodnima	najstaromodnije	lemma
simetričan	jestivi	Gender
adresirahu	faksiraše	Mood
čupavijima	puzimo	Number
темпераментни	antimaterijo	Number
sanjate	sažaljevam	Tense
glorificiraste	predvodila	Tense
mešan	razvalile	Tense
harfe	tenisačke	Number
imenovaste	apsorbirah	Mood
ovjenčaste	poveravate	Person
uvažene	uvaženih	lemma
učeni	najbanalnijima	Gender
svjesnijima	moralnijemu	Comparison
ohlađeno	optuživaste	Tense
uplovimo	celivaj	Mood
normalizirala	doseljenici	Number
spomenuti	oficirima	Number
predajmo	razjedinjavaj	Mood
tragična	primjeri	Number
obrisana	preporučivao	Tense
tutorstvo	rješivi	Number
snizivala	iscrpljena	Tense
paničnije	gnjilijega	Comparison
sagorimo	obaveštavaj	Mood
aerodinamičnije	najfrivolnijima	Number
postupalo	spominje	Number
šepa	osvojimo	Tense
najjalovijega	devalvacija	Number
zgrejavamo	otvarasmo	Person
našla	izgradi	Tense
vrelištima	dubokoumnim	Case
razastrte	sporazumijevao	Tense
poroznih	najporoznijih	lemma
sjala	pripekoše	Tense
kontroverzije	baleta	Number
vežbane	naoštri	Tense
oružanih	pločice	Case
liberalniji	liberalnu	lemma
uvećah	uporabila	Tense
baratani	ulizah	Tense
podgrejavajmo	tutnji	Mood
aprilske	nevelikima	Number
kvadratnoj	energične	Gender
otpili	prikrivajmo	Mood
vrludasmo	podrazumevajmo	Person
civiliziraniju	sićušnija	Comparison
destruktivne	kružna	Gender
sitnijim	osornih	Gender
bestjelesnih	najnegativnije	Number
napravimo	tutnji	Mood
priveži	otičimo	Mood
zasenjuj	razagnajmo	Mood
spiralno	tehnologije	Case
srdžbe	svirajte	Number
fosilne	nezakonitom	Gender
mačevaste	nadlijetalo	Tense
brojni	probudio	Gender
blagoslovimo	krvari	Mood
neutaživo	neutaživoj	lemma
napomenimo	posti	Mood
kozmetičarske	sićušnom	Gender
čađavljaste	zadajte	Person
pojedinačni	pregovarala	Number
elokventnima	vedskome	Gender
izračunavalo	popularizatorska	Gender
neophodnoj	prdnule	Gender
neodlučni	božićnima	Gender
zijevala	protjecan	Tense
skupocenih	blijeda	Case
smicalice	lunarnu	Number
priznata	prebrodi	Tense
državljane	vaseljenskih	Number
čekom	suvima	Case
otpisa	bljuzgale	Tense
intervale	apsurdna	Number
rezultiraste	ruinirah	Mood
skočimiševima	fotke	Number
dojavljuj	množimo	Mood
najbjednijima	najponosnijim	Comparison
postanimo	obaveštavaj	Mood
postupalo	teatar	Number
neuvjerljiviju	hermetičnijima	Comparison
populariziraste	germanizirah	Mood
brojni	osokolio	Gender
usuđuje	nastojimo	Tense
homogenu	enklitikom	Number
ludnička	najlicemjernijemu	Number
najuspješnije	najužasnijima	Comparison
spajale	zapisah	Tense
bolja	najbolji	lemma
začnimo	celivaj	Mood
tremovima	autorizirala	Number
troglavomu	troglavoj	lemma
obnavljaste	proslavite	Person
antiimperijalizme	pustinjskima	Number
proučavajmo	pobij	Mood
mnogostruk	pravovjernomu	Number
afirmativne	narodnom	Gender
čovječna	teatar	Number
grimasi	argentinski	Number
savršena	najkrupnije	Gender
razgrizao	venčasmo	Tense
sretnoj	sretne	lemma
lenčugama	buđavima	Number
krevetne	daljnje	Gender
svezuj	sklanjaš	Person
maloumnije	nečovečnije	Comparison
ljigava	gnjiljasmo	Number
odgovarajte	izoravaste	Person
štedimo	javljaj	Mood
uračunavaj	branimo	Mood
predlagan	prigovarala	Tense
napomenimo	čađi	Mood
nezahvalniju	najnezahvalnijima	lemma
sagrešila	iznudi	Tense
vedro	najprofinjenije	Case
čupavijima	takozvana	Number
uvezujmo	otimaj	Mood
podudari	pogledavaste	Tense
andžarima	apsurdna	Number
najobjesnijom	ominozne	Gender
sapunastih	dostižnijega	Case
najneuobičajenijima	neuobičajenije	lemma
najrazrokijega	najcelovitijima	Comparison
parade	asirskoga	Number
preraspodelimo	odaberi	Mood
snežimo	laštasmo	Person
bočicu	navalila	Number
pripremnih	očinsku	Gender
tuci	osvetimo	Mood
preskoči	opčinimo	Mood
zlotvornijima	zrnatijega	Comparison
prezalogajivah	burmu	Number
pristajasmo	gibljemo	Person
proučavajmo	najaši	Mood
rešene	zaplaši	Tense
iskušavaše	okrivljuj	Person
beskompromisnoj	srećnijima	Case
detinjastiju	riskantnijima	Comparison
kancerogene	ždrala	Case
ekstremniji	neistinitijih	Comparison
obećane	silazio	Tense
najapolitičnijemu	najprikladnijima	Comparison
razmijenio	neprijelazno	Number
gospodaraše	izbečismo	Tense
krulji	uvažimo	Mood
inozemnima	sintagmi	Case
autorskima	grabljivima	Number
sarkastičnije	префриганији	Comparison
prisjetiste	oivičivaše	Tense
filantropkinjama	predsjednice	Number
crvljivijom	crvljivoga	lemma
snižavalo	zapuštahu	Tense
difuznija	buđavijima	Comparison
neuspješnijemu	prošaše	Number
najkovrčavijim	najkvalitetnijima	Comparison
potocima	strmi	Number
razgoni	zadešavamo	Tense
najpozornijim	najozbiljnije	Comparison
nikao	ženjaste	Tense
najbrojniji	primjetnijoj	Number
najbezobrazniji	najčovečniju	Comparison
izbrisale	poštovalo	Tense
častohlepniji	rezonantnija	Comparison
aktuelnijima	tmastije	Comparison
odgodim	odmarate	Tense
panamske	narodnom	Gender
tupljoj	jestiviji	Comparison
mirila	najtromije	Gender
ključni	izostavljeni	Gender
susretljiva	anglosaskomu	Gender
najzaslužnijima	pustinjski	Gender
rasplamsavaj	golicaše	Person
sagorevana	kompetentnijima	Number
najekstremnijima	najkonstruktivnijega	Comparison
kompetentnijega	mlada	Number
trunimo	posti	Mood
mekšima	mlađe	Comparison
centrifuge	madras	Case
vozačima	drenu	Case
centrifuge	svečanu	Case
pojedosmo	ukočenih	Number
diskvalificirasmo	popraćivasmo	Person
najsolidarnijemu	najhisteričnije	Comparison
predajmo	vadi	Mood
poseduju	štićahu	Person
pregrejani	susretaše	Tense
crtala	jurcana	Tense
ugovorimo	osnivaj	Mood
angažiranih	donošasmo	Number
najnevernijom	najliberalnija	Comparison
nerazvodnjenim	najneukije	Gender
empirijskome	pregovarala	Number
lepši	pridevske	Gender
začarali	odlete	Tense
znatna	federalnima	Gender
korisnija	korisnima	lemma
sramota	jednosobne	Case
najbezuspješnijih	najzavojitiji	Comparison
poduzimajmo	preslikavaj	Mood
pitomije	najmukliji	Number
lični	iscjeđujemo	Number
lekovitu	basnoslovno	Number
militantna	neurološku	Case
arhaičnih	arhaičnijoj	lemma
uvećah	pohabane	Tense
seksualnom	jednolične	Gender
pripaja	mržnji	Number
zaračunaše	nadživljavan	Tense
odgovornijima	odgovornome	lemma
leksičkomu	nežni	Gender
večite	porobljivana	Gender
razjediniste	projahao	Tense
srčite	uhapsiste	Person
svetlijima	ubogijim	Comparison
prosjačkomu	biheviorističkima	Case
negostoljubiva	bezopasno	Number
uzeta	uzetoga	lemma
gaknuo	najpišljivijih	Gender
neumesnijih	nežnijemu	Comparison
simpatičnoga	oračkoj	Number
kaznile	otera	Tense
kriptičnijemu	vidljivije	Comparison
bubaj	otičimo	Mood
mudrih	najmudrijih	lemma
razrađivano	opasivale	Tense
razvedenosti	nerealnih	Number
plovnima	bubrežnome	Case
smanjiš	iznajmi	Person
najizrazitiju	najdvoličnijima	Comparison
najpresniji	najsamokritičnije	Comparison
osunčano	konveksnima	Gender
najbesavesnijemu	najsličnijih	Comparison
sjekle	izgradi	Tense
najpažljivija	krvožednomu	Gender
najrodoljubivija	rudlavomu	Number
sakupi	gorčajmo	Mood
podgrađujmo	razdražuj	Mood
sitnijim	trivijalnima	Gender
najbezvrednijima	najodanija	Comparison
grne	kroatizira	Person
kompaktnima	antireligioznu	Gender
najmasnijemu	najvještije	Comparison
znamenito	rješivi	Number
gandži	pljačkan	Number
industrijaliziraše	postigli	Mood
pljuni	raspetljajmo	Mood
probitačnije	smirenija	Comparison
dragocjenijima	svečanije	Comparison
žonglirao	grmljaste	Tense
nepretencioznijih	pišljivije	Comparison
najdokonija	najsamozadovoljnijima	Comparison
podržavaj	priušćujmo	Mood
neredovitima	najboljemu	Case
primjedbe	crepova	Case
ispuši	prikrivajmo	Mood
čovjekoljubivija	plačljiviji	Comparison
onanirahu	svlače	Person
obrnute	izvršila	Gender
osobne	osobna	lemma
bukureštansku	definitivnu	Number
najalarmantnijima	dokazima	Number
najkompaktniji	profitabilnu	Gender
najdestruktivnijima	destruktivnije	lemma
kvantitativna	ime	Number
jahača	andaluzijski	Number
kretske	neurološku	Case
metajezici	sveobuhvatna	Case
umiri	rješivi	Number
priračunaj	opredelimo	Mood
uplovimo	smaži	Mood
odrađivala	pogledan	Tense
razlikujmo	rvaj	Mood
nepoderivih	limeni	Gender
svrati	podsetimo	Mood
mahni	pristavimo	Mood
isceljivao	imuniziraše	Tense
neuvjerljiviju	živahnijima	Comparison
dočekivaše	najkakofoničnijega	Number
zabijana	ulagahu	Tense
neodređenih	sjedala	Gender
propišite	parazitske	Number
križišnima	doseljenici	Number
sagorevana	doseljenici	Number
namočen	polomila	Tense
tuberkuloznima	sujevjerni	Gender
hiljadama	srodnikom	Case
bubuljičaste	bubuljičastoj	lemma
obezglavio	islamiziraš	Number
najrazrokijega	najkooperativniji	Comparison
začarali	dopisa	Tense
oplemenjivano	uloviste	Tense
puhnimo	hapsi	Mood
zamenjivala	čovjekoljubivoga	Gender
dašćimo	obuhvati	Mood
grne	sotonizira	Person
razmišljaj	množimo	Mood
preferansima	bezakonitoj	Case
najdijaboličnijom	dostižeš	Number
kvadranti	uvredo	Case
nenavidelo	ženjaste	Tense
zažele	prisegneš	Tense
podlima	izvršila	Gender
izdržavajmo	olabavi	Mood
rijetko	najrjeđi	lemma
odgovarajte	osedlavate	Person
ekscerptu	veselim	Number
jednačim	kristijanizirah	Person
neobrijanu	proklinjana	Gender
uspostavljane	sumnjive	Number
rigoroznu	centralna	Gender
ružičnjak	mesa	Case
epohalnoj	epohalniji	lemma
trunimo	miješaj	Mood
izuj	isceđujmo	Mood
prenela	zapuštahu	Tense
stiskajte	jabučna	Number
pogreši	raspodeliš	Person
primjerenijih	префриганији	Comparison
paleontološki	mesa	Case
crtala	istraživana	Tense
pismohranama	bezakonitoj	Case
klonulosti	nerealnih	Number
kratkometnome	neuporabljivima	Gender
stradala	otpao	Tense
najciničnija	dotični	Case
ustvrđen	ukorjenjivahu	Tense
base	astrološka	Case
potopi	asimetričan	Case
dojašimo	pupaj	Mood
priklonite	sažaljevam	Tense
bičevaše	odupresmo	Tense
sažaljevah	podstrizale	Tense
bezočnomu	kreketavima	Gender
kozmetičarske	najsporednije	Gender
besramne	bolujmo	Number
medveđe	mesa	Case
napnu	pomakneš	Tense
nepogodnih	nepogodnijima	lemma
odnosim	ušetah	Person
nečovečna	ganutljivije	Number
hvalospjevima	predsjednice	Number
nasiti	trijebljene	Tense
mješovitoj	mješovite	lemma
obrađivasmo	hvaljena	Tense
vojna	alkoholizirana	Number
trpi	šećimo	Mood
vitrine	sagibate	Number
anarhičnih	neprijateljskome	Gender
basnoslovne	medijskim	Gender
projicirate	naviknem	Tense
pecan	prostirasmo	Tense
paradoksi	rudnički	Case
stradala	stigao	Tense
najsrodnijima	srodnije	lemma
muljatorima	najantipatičniji	Number
razgovarasmo	prigovori	Tense
trojke	proso	Case
najniže	najdrevnijemu	Comparison
centrifugalnim	medvedice	Number
izgubljenim	apokrifnih	Gender
bočicu	norveško	Number
eskimska	nagrdismo	Number
religioznu	rubnima	Gender
darovah	pozvana	Tense
vitrine	iscrpna	Number
neuvjerljiviju	rupičavijima	Comparison
alpskoj	neuspešnim	Number
uverljivija	bespravnijemu	Comparison
dunuli	zdepast	Gender
zrelomu	ptičja	Gender
valovitijima	djelotvornu	Gender
postojanija	postojanu	lemma
bolnoj	najhuđe	Gender
pitkoj	pitkijemu	lemma
srdžbe	neukrotivi	Case
najmoćnija	moćnije	lemma
najizrazitiju	najblažima	Comparison
otpili	novačimo	Mood
podrazumijevao	prepiljena	Tense
lični	puzimo	Number
havajskih	pustinjski	Gender
sukobljavaj	gužvajmo	Mood
poprže	iskopaše	Person
neprihvatljiva	aromatične	Gender
staklenih	bajato	Gender
ukrasne	polimorfizam	Case
divji	stožere	Number
obučimo	proslavi	Mood
okvirna	nepismena	Gender
najfiniji	agilan	Gender
nikao	osiromašene	Tense
najmasnijemu	najarogantnijima	Comparison
lutèrān	zbiljskome	Number
razdražujemo	dočarasmo	Person
najintrigantnijima	nesložnije	Number
ustavni	primitivnu	Gender
rađalo	nastanjeni	Tense
sagore	nastanjeni	Tense
dostižnima	dostižna	lemma
pripremana	besmrtnu	Gender
ustupi	sagrešimo	Mood
suoči	raspeš	Person
napravimo	hvali	Mood
sklopi	kartajmo	Mood
razrokijih	nečovečnije	Comparison
dugotrajan	ceremonijála	Number
znanije	pobeljena	Gender
krši	množimo	Mood
redovite	ždrala	Case
severnjacima	brzopletih	Number
amputirate	udomiste	Person
najpoželjnijim	poželjne	lemma
nerazumljive	varvarskiju	Case
neodgovorna	tronožni	Case
najnesavjesnijega	najneotesanije	Comparison
kakvu	basnoslovno	Number
ìzvor	vješcu	Number
preštampavana	obustavila	Tense
uzgojili	primitivnu	Gender
ključni	najmnogoljudniji	Gender
spljoštenih	pločice	Case
prirodnije	sažalila	Gender
neoprezne	izvršila	Gender
obasjajmo	istakni	Mood
zanemarivu	zanemarive	lemma
bivola	tehnologije	Case
kaznile	metaše	Tense
tankim	izvedenicama	Case
vrednovaste	prošećite	Person
sagore	unela	Tense
umiri	zelenilo	Number
kukah	pobegle	Tense
dalekovidnije	opojnu	Case
pregrejani	ojačavalo	Tense
feničke	aprilske	Gender
ковкији	najnedostižnija	Case
sagorevana	nervoznima	Number
obećane	otera	Tense
tugaljivijih	suvislijemu	Comparison
bednome	odijevani	Gender
lukavu	maloljetnička	Number
probijajmo	truj	Mood
društvenijima	najštetnijemu	Gender
velikodušnije	ruševnija	Comparison
nježnijima	ženstvenijega	Comparison
uspješnije	maštovita	Gender
dosađivaše	razjedinismo	Tense
strašiš	fasciniraše	Person
ekstaze	barokna	Number
razaznajmo	beži	Mood
opsjedaj	verificiraš	Person
naoblači	zurimo	Mood
onesposobljene	pizdeo	Tense
svladavao	bezopasno	Number
šepavijima	bespravnijemu	Comparison
obeščašćeno	napredovaše	Tense
obdarimo	loptasmo	Person
najtrapavijima	najматоријi	Comparison
separira	caklite	Tense
metni	udarajmo	Mood
potopi	stabilan	Case
dokažete	rasipavam	Tense
najmonotonijima	najneočekivanijoj	Comparison
hrvatskosrpskima	privrženim	Gender
lažljivijega	lažljivima	lemma
nacionalističku	beskičmena	Number
sledećih	strpljiviji	Gender
trianguliraš	pripremimo	Tense
civiliziraniju	vjetrovitijima	Comparison
nosimo	vadi	Mood
lutèrān	onečistiš	Number
znamenito	izjednačio	Number
fosilne	kružna	Gender
tužnijoj	složnija	Comparison
odanije	neočekivanijima	Comparison
nužnima	bubrežnome	Case
prosjačkomu	najdalekosežnijima	Case
najnametljivijemu	najdostižnijima	Comparison
sramotnijim	savjesnije	Comparison
pretuci	obilujmo	Mood
neotesanijoj	najlucidnije	Gender
jaši	podsetimo	Mood
najrepresivnijima	najnelojalnije	Comparison
nastanjivani	tankoćutan	Gender
suluda	pokrenuto	Gender
krȉčavosti	korjeniti	Number
najkompetentnijega	najepohalnijima	Comparison
najbližima	najkonstruktivnijega	Comparison
brojni	limeni	Gender
presudna	božićnima	Gender
ključaše	procenjuješ	Person
usavrši	pomnožimo	Mood
snimili	kaubojski	Gender
paradoksi	asimetričan	Case
studirate	sudjelovaste	Person
negiraše	postigli	Mood
vojna	tričavo	Number
prijatnija	prijatnu	lemma
ozljeđivana	bljuzgaše	Tense
davno	apokrifnih	Gender
otmei	upornijima	Number
jadnomu	jadnoj	lemma
odgovarajte	cimnuste	Person
očajnija	očajno	lemma
rupičavoga	slabokrvnija	Number
oblizivana	vrgnuli	Tense
nečovečna	enklitikom	Number
prelamaše	poboljšaš	Person
ključaše	klikćeš	Person
izjavimo	otimaj	Mood
stanični	petini	Number
krijumčaraste	posjedovala	Tense
štedimo	posti	Mood
najanonimnijih	najbrutalnije	Comparison
grješnijemu	neshvatljive	Gender
tužnijoj	ruševnija	Comparison
isceljivao	sredismo	Tense
najčudotvorniji	pozornost	Number
koagulirah	prekipim	Person
vitrine	portfeljima	Number
labavimo	ulizuj	Mood
rađalo	učlanjivani	Tense
sablazni	kostriješaše	Person
elastičnijima	najantipatičniji	Number
muti	zagasimo	Mood
nadijevamo	popraćivasmo	Person
ometi	raznežimo	Mood
sidrila	rascijepljen	Tense
uzrujaj	porumenimo	Mood
najupadljivijima	najprimjetljivijemu	Comparison
utoli	kostriješaše	Person
zadivljavah	osiromašene	Tense
obodi	podsetimo	Mood
dijete	milja	Case
najbesmislenijima	odmeravajmo	Number
topliju	najtoplijima	lemma
kongresima	kanceroznijom	Case
cijepljasmo	alkoholiziraše	Mood
zapadnjačkom	polikliničkima	Case
odstrijelismo	gladimo	Person
preskoči	habajmo	Mood
berlinskom	berlinskima	lemma
brijete	isteravajte	Person
posrednija	očevidnijemu	Comparison
sažaljevah	najavila	Tense
svari	pobunjuje	Person
prizvuku	besplatne	Number
bočicu	asirskoga	Number
najbezvrednijima	najintrigantnijoj	Comparison
nezasićenima	narodnom	Gender
vlažniji	opsežnije	Comparison
odstreljena	budaljaše	Tense
dočarljiva	dočarljivom	lemma
najskrušenijega	litoralne	Case
osuđuj	imitiraš	Person
srći	smijmo	Mood
nadimahu	svlače	Person
umrijeste	navoženo	Tense
мудрији	kolede	Case
razdražujmo	posti	Mood
hrvatska	zakopavam	Number
vrpoljilo	obijeni	Tense
pohvali	prigovarala	Tense
indoeuropskim	besposlenijima	Gender
trianguliraš	poližemo	Tense
ekipe	arhitekture	Number
preferira	janjimo	Tense
priznata	prigovori	Tense
kratkovidnim	marnijih	Gender
pastusima	vȃrci	Case
najciničnija	otmeniji	Case
dodaj	uspava	Person
čvrsti	obilazio	Gender
prodana	sentimentalna	Gender
iščupaj	hoćaše	Person
svesnija	spokojniji	Comparison
jasnija	jasne	lemma
rabote	karnevalskomu	Number
искусни	onečistiš	Number
šepavijima	europskijega	Comparison
odvukli	certificirani	Gender
umišljene	profitabilnu	Gender
ćirilici	cerom	Number
lični	paucima	Number
prenela	podržani	Tense
spaljujem	primaknuo	Person
podgrađujmo	duši	Mood
prisilim	posredovah	Person
signala	doseljenici	Number
izvršiše	doznah	Tense
vrludasmo	pometemo	Person
mešan	prozvaše	Tense
obasjajmo	razbijaj	Mood
čučni	doživljavajmo	Mood
nestalnije	ključnima	Number
završi	pripremane	Tense
otpustite	prošećite	Person
autoritarnijemu	konveksnima	Gender
kihnuše	pobude	Person
iskušajmo	snimi	Mood
predočavani	susretaše	Tense
vlažniji	korektnijoj	Comparison
kruljila	izobliči	Tense
ustvrđen	pretraživala	Tense
implicira	secira	Person
trpi	zurimo	Mood
razradili	stigao	Tense
sjekle	prebrodi	Tense
skupljajmo	pregradismo	Person
sladòkūsācā	donošasmo	Number
dijete	verovanja	Case
sledećih	ogorčeni	Gender
inhalacijom	bogat	Number
despotske	agilan	Gender
svrati	pribrojimo	Mood
najsenovitijima	najbrutalnije	Comparison
prisećajmo	ometaj	Mood
hvalospjevima	najklimavija	Number
ovjenčaste	prošećite	Person
skuvamo	progrizimo	Person
krhotinama	parazitske	Number
razastri	sagrešimo	Mood
trivijaliziraše	guštaju	Person
autoritativnima	najtromije	Gender
pitomije	najkakofoničnijega	Number
najzaslužnijima	elitni	Gender
humornijima	humornu	lemma
podvede	zadešavamo	Tense
najbogohulnijemu	bogohulniju	lemma
rezultiraste	anotirah	Mood
najkovrčavijim	najsediji	Comparison
najlepše	lepo	lemma
tremovima	jabučna	Number
skuvamo	objavljivasmo	Person
kriptičnim	najkriptičnijega	lemma
kićasmo	preporučivao	Tense
najčastoljubivijemu	najlakovernijima	Comparison
napomenimo	vadi	Mood
ustvrđen	tovljahu	Tense
litavskim	najrazornijima	Case
udavana	zaplaši	Tense
neopipljiva	potencijalni	Case
kidaj	obrezivaše	Person
zabrljalo	duvnute	Tense
uviđaj	branimo	Mood
uzvikuj	iskočimo	Mood
kriptičnijemu	pohlepnijima	Comparison
kašljimo	spazi	Mood
besposleni	neizvjesnu	Number
razvedenosti	rasformiraju	Number
dojašimo	traj	Mood
caklili	tromjesečja	Number
kantonskim	primjetnijoj	Number
kampanje	tankih	Case
ljuća	najljućih	lemma
kontrola	takozvana	Number
unitaristička	ljubaznije	Gender
andžarima	naga	Number
široka	čovjekoljubivoga	Gender
otapala	sporedne	Gender
zgrozite	uvrebate	Person
najobilatije	najljućima	Comparison
razrađujmo	proslavi	Mood
inicijalnomu	nogometnih	Gender
najneobičnije	čunu	Number
grešnija	krotka	Case
kongresima	srodnikom	Case
cijenjaše	zaraćeni	Tense
sklopi	opčinimo	Mood
hrvatskosrpsko	krvožednih	Gender
maštu	zlobne	Case
davno	lihvarila	Gender
sklopi	zapustimo	Mood
uštinimo	dodeljuj	Mood
tuci	kosnimo	Mood
čekana	anketiraste	Tense
beščasniji	krakatijim	Comparison
havajskih	zdepast	Gender
nadjačavaj	pobledimo	Mood
natkriljivalo	meljasmo	Tense
jahača	fosilu	Number
povećamo	uresismo	Person
utanačili	odevana	Tense
baždaraše	bunkerirasmo	Mood
razroka	glinene	Gender
stidljivi	stidljivija	lemma
neuvjerljiviju	neaktivnijih	Comparison
metežima	jaja	Number
isecaše	hoćaše	Person
predlagan	ublažile	Tense
spazi	odnarođujemo	Tense
prisnima	tenedskoj	Gender
prirodnije	ljekovitoj	Gender
najskladnijega	najcelovitijima	Comparison
miroljubiva	nežni	Gender
graničimo	nepreporna	Number
doplovi	priopćavajmo	Mood
najkomunikativnijih	osokolio	Gender
trajnijima	nepodobnijega	Comparison
aktivnu	lunarnu	Number
prelaznih	smetala	Gender
inicijalnomu	čvornate	Gender
poruši	zgruša	Person
bizantinskima	topljivoj	Gender
najpomodnijima	најбљештавији	Comparison
začarali	stigao	Tense
jantarni	težite	Number
napuštaj	pošteđivaše	Person
isuši	srušimo	Mood
ciganite	rovaraste	Person
faktori	ispitivanja	Number
signala	kompetentnijima	Number
prospavaj	ispitajmo	Mood
šljìvīk	slamčice	Number
laganije	dosljednoj	Gender
revolucionarnijima	obilatijega	Comparison
vijećaše	porobljavani	Tense
opominjimo	uzrujavaj	Mood
prevagni	povrijedimo	Mood
simpatičnoga	najdragocenije	Number
hadževe	crvenkastima	Number
najnepotrebnija	nepotrebnije	lemma
razmjerno	maternjima	Gender
razbjegoh	spoznale	Tense
najslinavijemu	najsediji	Comparison
skrilo	rješavahu	Tense
ljubaznijima	eruptivnijega	Comparison
grȗdnjāci	ispitivanja	Number
neobavezni	karoserija	Case
laganije	užasna	Gender
prospavaj	zatražimo	Mood
uspješnije	prozirnih	Gender
izumre	sklanjaš	Person
najdalji	kompetentnijima	Number
nadijevamo	pregradismo	Person
stradala	pripremao	Tense
raspravljan	prislanjasmo	Tense
racionalnoga	pridevske	Gender
opirasmo	ražalostimo	Person
ugovorimo	odrađuj	Mood
rabote	spektakularnu	Number
trunimo	klopaj	Mood
služaste	opčinjavan	Tense
proračunali	odlete	Tense
najčastoljubivijemu	najnestalnijima	Comparison
brižnijemu	brižnima	lemma
pripaja	cerom	Number
najtrjezniji	pridevske	Gender
hvalospjevima	dodelila	Number
zgrejavamo	umijmo	Person
obući	sposobnima	Case
lakomislenijima	dugovječnije	Comparison
proizvede	namenjuješ	Person
opljačkajmo	spazi	Mood
fosilne	egipatskoj	Gender
dalekovidnije	proso	Case
ledeniji	plodnije	Comparison
najčastoljubivija	најискренији	Comparison
nepovjerljivijima	krhkiji	Comparison
husarima	materinskim	Case
krhotinama	odjeli	Number
poželite	uhapsiste	Person
morfeme	иронични	Case
mnogovrsnijom	plahiji	Comparison
umrijeste	zapisah	Tense
labavimo	preštampavaj	Mood
pretpostavljena	oplovila	Tense
prokušavaš	umišljenijim	Number
anticipirasmo	koaliraše	Mood
preostanem	nauče	Tense
najnezgrapnijima	najbrojniji	Comparison
podgrizeš	opisivaše	Person
plastična	intrigantnije	Gender
uvredljivo	najuvredljivijemu	lemma
oglobih	pogledavaste	Tense
nabusite	naglo	Case
problematična	problematičnom	lemma
lažljiviji	apatičnija	Comparison
pripravno	apokrifnih	Gender
uzbunismo	raskolilo	Tense
zavređujmo	maštaj	Mood
osveta	kuci	Number
važnima	egipatskoj	Gender
pronalaženi	proćutela	Tense
bistroa	cenzusa	Case
pismenima	svetskim	Case
uvlačeno	oženiše	Tense
raznovrsnije	najraznovrsniji	lemma
šeći	kokodačimo	Mood
sramota	mirne	Case
teatri	patkica	Number
isprobajmo	duši	Mood
svesrdnija	rupičavijima	Comparison
arhaičnoga	maternjima	Gender
pogriješile	budaljaše	Tense
popularno	najpopularniji	lemma
zarudimo	seci	Mood
presudna	vunasti	Gender
trojke	rajski	Case
krnjimo	potrudi	Mood
napravimo	krvari	Mood
zacelimo	ponašaj	Mood
nedostaj	položimo	Mood
čestitiji	rezonantnija	Comparison
pokornijima	golišavijemu	Comparison
frekventnija	frekventnijima	lemma
najbistroumnije	narodnih	Gender
iščupa	osušena	Tense
praktična	trlo	Gender
galantnijima	izopačenijega	Comparison
parade	autobiografiju	Number
zadovoljava	nastojimo	Tense
najnametljivijemu	najuvređenije	Comparison
našla	prevaljivana	Tense
zborimo	karaj	Mood
neodlučeno	suptilnomu	Number
jednostavan	jednostavni	lemma
prozirniji	efemernijom	Comparison
podnošeni	žudela	Tense
најинвентивнији	najdostižnijima	Comparison
razjedini	zapregnimo	Mood
tesnih	osmijesima	Number
čovječna	najdragocenije	Number
slućah	onemogućim	Person
bucmastima	najilustrativnijim	Gender
kašljimo	pokaži	Mood
paljeni	silazilo	Tense
krepljahu	romane	Number
najtrjezniji	izvršnima	Gender
pripaja	najgramzivije	Number
udavana	pripremao	Tense
gosti	proplivajmo	Mood
impertinentnima	privrženim	Gender
špendirane	iznudi	Tense
istoimenoga	navalila	Number
svemoćnome	koprenu	Number
ksenofobija	fosilu	Number
trpi	množimo	Mood
nepoštenima	proticana	Gender
krevetne	mehaničke	Gender
uvrebane	spominjalo	Tense
šniraj	opčinimo	Mood
otputovah	navaljujem	Person
ustrajna	samoglasnička	Number
opsjedaj	sagradiš	Person
preraspodelimo	tali	Mood
suhe	fatalista	Case
popravili	ispitivanja	Number
akomodira	imitiraš	Person
nasmešimo	obaveštavaj	Mood
obliži	odmamljujmo	Mood
grȗdnjāci	nepogodne	Number
preštampavana	zapališe	Tense
zarudimo	ispitaj	Mood
najsapunastije	ustrojila	Number
uverljive	najuverljivija	lemma
junačnijega	slasnije	Comparison
različitima	patkica	Number
čovjekoljubivija	probojnija	Comparison
prikupile	zagrebe	Tense
ružičnjak	pobjede	Case
najčujnije	najšumovitiji	Comparison
umereni	mesa	Case
izljuti	natjerujmo	Mood
želite	nadjačava	Tense
zabunimo	dremni	Mood
umiri	argentinski	Number
najljudskijima	sjedala	Gender
ukradena	predvodila	Tense
samovaše	diskreditira	Person
umišljene	glavatijemu	Gender
stiša	vrpolji	Person
znaniji	eruptivnije	Comparison
pohvali	narođeni	Tense
zborimo	podvostruči	Mood
levajmo	ispitaj	Mood
kvadratnim	centralna	Gender
veseljakovićima	najeruptivniji	Number
naglašavaj	proplivajmo	Mood
obuhvaćena	svirajte	Number
zlostavljan	kompleksne	Gender
kontroverzije	nervoznima	Number
oženi	podsetimo	Mood
темпераментни	najravnopravnijom	Number
borile	zinu	Tense
verifikacije	baleta	Number
neprimjerenima	neprimjerenu	lemma
uklanjaj	trebajmo	Mood
prepolovilo	nastanjeni	Tense
ekstaze	najklizavijima	Number
najširega	najuvređenije	Comparison
prozvaste	šapućite	Person
križno	najtegobnijega	Number
dragocjenijima	očevidnijemu	Comparison
analognim	šugavija	Gender
povećavaj	raspeš	Person
ustrajna	pravovjernomu	Number
iskušajmo	zabijaj	Mood
anđeoski	zajahao	Gender
isključi	položimo	Mood
šljemahu	oklijevaju	Person
prolomimo	preslikavaj	Mood
sanjkamo	romane	Number
beznačajnijih	bestijalniji	Comparison
zračne	zračna	lemma
najkompetentnijega	najčarobnije	Comparison
zaposlili	odlete	Tense
izbegoše	jenjahu	Person
mirila	međusobno	Gender
srdžbe	nevelikima	Number
odmjerite	doprite	Person
bukvane	anaerobna	Case
realnih	paucima	Number
glineno	katastrofalnima	Gender
temperamentniji	sićušnija	Comparison
jednostavnije	vidljivije	Comparison
razrađujmo	razdražuj	Mood
progrizam	ulizao	Number
lični	statìstičārkā	Number
srndaća	sabotaži	Number
nezamjenjivi	svijetlo	Case
najdokonija	najčudnija	Comparison
zabrljaj	pristavimo	Mood
neodređenih	bezakonita	Gender
izuj	posramljujmo	Mood
osvetite	zacelite	Person
livadska	pleonastičan	Number
pčelinjemu	enklitikom	Number
spajale	poštovalo	Tense
najefektniju	sinonimnih	Gender
uzbudljivih	otvorenije	Number
bočicu	nenameran	Number
opeklo	pohabane	Tense
štucaše	svlada	Person
stanični	ekstravagantnijom	Number
najštetniji	najmiliju	Comparison
klonulosti	najubogijih	Number
senilnom	zemljoradnicima	Case
revolucionarnijima	ključnijemu	Comparison
panamske	užasna	Gender
svezuj	opisivaše	Person
intimnu	najprofesionalnijima	Gender
armenska	otmeniji	Case
izvožasmo	izražen	Tense
platnenu	sporne	Number
nesvesna	sabotaži	Number
razbacujemo	otvarasmo	Person
snimili	glavatijemu	Gender
nečovečna	ciglara	Number
isušivane	formulira	Tense
najglupavijega	najsamozadovoljnijima	Comparison
ništavnoga	duboka	Gender
zbunjujmo	zaboravi	Mood
shvataj	slavimo	Mood
kretske	dekadentno	Case
šašavijoj	složnija	Comparison
večite	nezakonitom	Gender
zadavalo	tragičnija	Gender
galantnijima	vrletniji	Comparison
slojevitima	slojevitijih	lemma
kukah	oženiše	Tense
najsuznijega	najglupavijima	Comparison
klonulosti	ozbiljnijih	Number
krabulji	zaoravaše	Number
metni	osjećajmo	Mood
tuberkuloznima	kaubojski	Gender
otarasismo	progonimo	Person
razdražujmo	razbijaj	Mood
razmnožiš	metu	Tense
искусни	ustrojila	Number
opljačkajmo	uživaj	Mood
најмирољубивији	najrečitijima	Comparison
besposleni	glagolska	Number
prikupile	izražen	Tense
nadahneš	pošteđivaše	Person
vredniji	jabučna	Number
krabuljnima	brakom	Case
otarasismo	učvršćujemo	Person
čulo	cedio	Number
uverljivija	efemernijom	Comparison
pogrešnome	gornja	Gender
najrjeđe	najrupičastije	Comparison
nesvesna	autobiografiju	Number
emotivna	najemotivnije	lemma
najšarmantnijim	najšarmantnijima	lemma
blatan	antisemitskima	Gender
bombastičnima	abolicijska	Number
prizvuku	elektromagnetskoga	Number
najmukliji	najpostupnijemu	Comparison
nezamjenjivo	ptičja	Gender
plastična	produktivnih	Gender
sagori	pokopajmo	Mood
jahača	čunu	Number
zaračunaše	doznah	Tense
vežbane	postavljaše	Tense
nazadnima	najnazadnije	lemma
pripremnih	proticana	Gender
hrvatskosrpsko	egocentričnima	Gender
sjemena	zgodni	Case
prognale	preotiman	Tense
tupoglavi	tupoglavijima	lemma
vredniji	fotke	Number
utrkuj	veštačimo	Mood
despotske	antireligioznu	Gender
strmo	najstrmiji	lemma
umišljene	najspremniji	Gender
najvjerojatnije	žestokoj	Gender
fosilne	katoličku	Gender
fosilne	uspešne	Gender
zabrljalo	sredismo	Tense
nagovešteni	prikrilo	Tense
korasmo	brzao	Tense
kušate	ispostavljam	Tense
umiri	vrludave	Number
najsolidarnijemu	najprodornijima	Comparison
anđeoskim	kričave	Gender
zacelimo	ašikuj	Mood
najljudskije	ekonomičnija	Gender
nepovjerljivima	najnepovjerljivije	lemma
žabinoj	najšarenijima	Gender
svladane	razdraživao	Tense
ksenofobija	neuspešnim	Number
poznatijih	poznatu	lemma
podučavajmo	raširujemo	Person
gospoštini	najdalekosežnijima	Case
iščupa	impresionirale	Tense
istovrsnima	najvatrenijom	Case
uspijevaše	imuniziraše	Tense
diftongizacije	obrubljivala	Number
istrijebi	opasivale	Tense
nečiste	probudio	Gender
ustvrdimo	razdražuj	Mood
puhnimo	sadržavaj	Mood
uplovljavajmo	gnjij	Mood
kaznile	onemogući	Tense
kvadratnim	dostizala	Gender
nagoveštavate	pobijaste	Person
tiskaj	razodjenimo	Mood
bočicu	petini	Number
zborimo	razbolevaj	Mood
zaposlili	prigovori	Tense
tajaše	prisloniš	Person
bučnija	najbučniji	lemma
morfeme	zgodni	Case
raspravljan	nagrdiste	Tense
najglasnijih	grabljivima	Number
izgubljenim	strašnija	Gender
znamenito	središne	Number
penji	raznežimo	Mood
porozan	sabotaži	Number
kratkovidnosti	pregovarala	Number
srnčadi	koščatijima	Number
istoimenoga	najdragocenije	Number
najekscentičniji	najbrža	Comparison
zadivljavah	učlanjivani	Tense
spiralno	nejednolike	Case
obezglavljivaste	iznuđujte	Person
stradala	rastavila	Tense
najodmornija	najfrekventnije	Comparison
suicidalno	količniku	Number
zagrebimo	podvostruči	Mood
proizvođaše	pobegle	Tense
kaznile	rascijepljen	Tense
zaštićuj	otičimo	Mood
mešala	doznah	Tense
ispuši	iznajmimo	Mood
zatvoriste	mobilnima	Number
naočitijoj	bubuljičavijima	Comparison
najbesavesnijemu	najusamljenijima	Comparison
neophodnoj	preliminarne	Gender
stiša	spjevaj	Person
uzgojili	neshvatljivim	Gender
skočimiševima	ispitivanja	Number
negostoljubiva	neaktivnim	Number
najizrazitiju	najdruštveniji	Comparison
iznajmite	ispostavljam	Tense
travnatije	diskretniji	Comparison
ulažu	krčmim	Tense
nepovoljnijima	sanjkanja	Number
sladòkūsācā	predsjednice	Number
čulo	spokojnim	Number
pljuni	upecajmo	Mood
najneustrašivije	najmutavije	Comparison
položile	izgradi	Tense
nostalgičarima	štitolikima	Number
zlonámērnosti	najpopularnijima	Case
najnezgrapnijima	najmiliju	Comparison
najmuljevitijih	najmuljevitiji	lemma
bakrena	prethodnoj	Number
najšiljatiji	žive	Gender
probavljivijima	prešni	Number
gore	egzorcista	Case
nenormalnima	strmi	Number
dugoročnijemu	kvarna	Number
harfe	najantipatičniji	Number
onesposobljene	duvnuo	Tense
uzrujaj	opozivajmo	Mood
tehnološko	škrti	Case
zgodno	ekstravagantnijom	Number
kroatizacija	entuzijastičnih	Number
pozivana	imitiraše	Tense
nepoderivih	agrotehnički	Gender
najsitnijemu	vrludave	Number
vjerili	medijskim	Gender
jantarni	atašeima	Number
avijacijo	vremenitu	Number
ustrajna	učinkovitije	Number
prepalo	pripojene	Tense
zgražate	izlučiste	Person
kontrola	nagrdismo	Number
borile	zapisah	Tense
odolele	španunzima	Number
obuhvaćena	miljei	Number
bočicu	glagolska	Number
najverodostojnijima	najnestrpljiviju	Comparison
razotkrih	rješavahu	Tense
razložimo	zavidni	Number
umiri	pljačkan	Number
istrijebi	porođene	Tense
ìzvor	asirskoga	Number
skuvamo	laštasmo	Person
poznajmo	uzrujavaj	Mood
abecednih	tankoćutan	Gender
oživimo	razjedinjavaj	Mood
najklizavija	najneposrednijima	Comparison
krepavaše	uporabila	Tense
ustavni	cevni	Gender
razotkrih	uporabila	Tense
vojna	ime	Number
aždaha	bačkomu	Number
otkrivajmo	duši	Mood
bocnula	pojačavani	Tense
redovite	zgodni	Case
monasima	važnom	Case
prisjetiste	naduto	Tense
najrazložnijih	najrazuzdanijim	Comparison
almanahu	ucenama	Case
spasih	primaknuo	Person
akumulirate	vrzma	Tense
obećane	onemogući	Tense
uzverasmo	zvaše	Tense
najneobičnije	pedantnije	Number
dočekuj	gorčajmo	Mood
odstupaše	provjeri	Person
pristajasmo	posvećujemo	Person
imenovaste	kromiraše	Mood
ponestajaste	smještate	Person
ojačasmo	uzrujala	Tense
popravili	tjestenine	Number
okvirna	monetarno	Gender
otpisa	sokolile	Tense
sirijsko	vešalice	Case
kvadratnoj	problematičnih	Gender
nadvišeni	arhitekture	Number
neodlučeno	клемпави	Number
buktimo	procenimo	Person
šepavijima	masovnijim	Comparison
nagovešteni	prevođaše	Tense
razočarani	žudela	Tense
večite	adekvatna	Gender
tutorstvo	smotre	Number
jahača	količniku	Number
ponesete	ponijele	lemma
združismo	izražen	Tense
izdacima	crvenkasta	Number
zevni	nabrusi	Number
letačima	koščatijima	Number
isušivane	zvaše	Tense
porozan	lajk	Number
razjedini	natjerujmo	Mood
beznačajnijih	iznenađenijemu	Comparison
najsnuždenije	snuždenijim	lemma
gađaste	skuvao	Tense
rascijepi	ocenjujmo	Mood
rubne	izvodljiv	Case
preferira	nastojimo	Tense
komplicirah	spoznale	Tense
sintetskoga	akademičarskoj	Number
lukavu	zaoravaše	Number
nenametljivi	profitabilnu	Gender
najkompetentnijega	najuspravnijima	Comparison
valovitijima	komplementarnom	Gender
mahni	isceđujmo	Mood
postupi	poboljšaš	Person
preferira	navozite	Tense
križarska	krvožednomu	Gender
bešćutnijemu	žive	Gender
najbezobrazniji	najintrigantnijoj	Comparison
užasnije	apsurdnima	Gender
himbenije	golišavijemu	Comparison
rjeđoj	neočekivanija	Comparison
kvantitativna	palatalom	Number
šljemaše	proširuješ	Person
propišite	poslednja	Number
uzvišeno	najbolesnije	Case
dražesnije	besplatne	Number
polaskani	agrotehnički	Gender
kontrola	oficirima	Number
napomenimo	seci	Mood
svestrana	fosilu	Number
sakupi	opazimo	Mood
nadahni	osvetimo	Mood
najradosnijim	najužasnijima	Comparison
nacionalističku	smotre	Number
rinete	svučem	Tense
podučavajmo	dočarasmo	Person
spoznajem	zabušavate	Tense
uzbudljivih	oficirima	Number
prisećasmo	onemogući	Tense
rezistentniji	najdragocenije	Number
krabuljnima	mùzikōm	Case
naiđu	zabubaste	Number
sječiva	izvrsna	Case
krevetne	nerođenima	Gender
sječiva	izvodljiv	Case
zmijina	najsposobnijima	Gender
intimnu	jednostavna	Gender
slavljaste	obrazovanima	Number
najrepresivnijima	najkolebljivijoj	Comparison
bezveznu	najneukije	Gender
heterozigotnu	bestelesnima	Gender
pecaste	opremite	Person
vrisnule	huljeno	Tense
najizrazitiju	najkooperativniji	Comparison
izoštravaš	plašaše	Person
pohvali	stavljeni	Tense
plastična	ljuće	Gender
uključimo	tepaš	Tense
imenjak	fantastičnu	Number
najimpresivnijih	krivi	Number
havajskih	ogorčeni	Gender
luetičare	snizujte	Number
crtala	zaraćeni	Tense
ometi	otičimo	Mood
nevjesti	biheviorističkima	Case
miroljubiv	miroljubivi	lemma
olabavimo	nastanismo	Person
najumjerenija	dremljivih	Gender
suhe	milja	Case
bocnula	ulagahu	Tense
harfe	ozlijeđena	Number
odvodimo	nakalemismo	Person
ometi	trebajmo	Mood
najverodostojnijima	najintrigantnijoj	Comparison
kroatizacija	nagrdismo	Number
iskači	natjerujmo	Mood
podbadalo	sniježaste	Tense
primjetnijim	jestiviji	Comparison
kreketavima	kletvi	Case
ujedini	posustale	Tense
muti	smažimo	Mood
aproksimirate	iznuđujte	Person
signala	ozlijeđena	Number
proučavajmo	utovi	Mood
svićete	savetujem	Tense
ovalnima	agrotehnički	Gender
umrijeste	spremilo	Tense
priveži	razagnajmo	Mood
izravnijemu	plodnije	Comparison
zadovoljnima	zadovoljna	lemma
rodoljubnijih	najdarovitijim	Gender
nadopunjeno	teatar	Number
fosilne	sputanija	Gender
havajskih	limeni	Gender
zavidljivima	svanuću	Case
razastrte	prikrilo	Tense
ćirilici	najsumanutiji	Number
razmijenio	norveško	Number
greza	glasovit	Case
neoprezne	egipatskoj	Gender
najkraće	procenjena	Gender
zreloj	lajk	Number
nerotkinju	zelenilo	Number
prvenstvenima	najtromije	Gender
sentimentalnih	Zemljina	Case
neprobojnima	paničarki	Case
najbrojniji	sijalice	Number
rađalo	zapuštahu	Tense
zacementiraj	nastanjujmo	Mood
zalijevajmo	potvrđuj	Mood
nezakonitim	lunarnu	Number
zauzdajmo	olabavi	Mood
glasovita	nagrdismo	Number
dugoročniji	najneukije	Gender
čvrsti	vedskome	Gender
obrisana	ojačavah	Tense
anđeoskim	muževnima	Gender
bestjelesnih	budžake	Number
glineno	dostizala	Gender
kontrola	malima	Number
ukradena	zauze	Tense
razuzdanije	vješcu	Number
lebdelo	uspavljivasmo	Tense
persirate	najeruptivniji	Number
otkrivajmo	izbjegavaj	Mood
malodušnijemu	malodušnima	lemma
krckane	skuvao	Tense
uspostavljane	apsurdna	Number
nečovečnijim	izvedenicama	Case
najtupoglaviji	najneposrednijima	Comparison
aktivnu	lajk	Number
smanjiš	ugasi	Person
nagrđuj	dopreš	Person
utanačili	čeprka	Tense
tukla	patkica	Number
bombastičnima	sledeća	Number
moralnima	kompetentnijima	Number
probitačnije	valovitijima	Comparison
nasiti	pobegle	Tense
srebren	onečistiš	Number
obranila	povraćena	Tense
zbrinimo	dodeljuj	Mood
punašnijih	najsjajnijoj	Gender
zaračunaše	sporazumijevao	Tense
nagradimo	sadi	Mood
šiljasto	olakšana	Number
dodjeljuj	branimo	Mood
baždaraše	smaknuli	Mood
svinjara	računovođe	Case
krucijalni	maorski	Gender
srčite	otuđujete	Person
pljuni	naslutimo	Mood
natjerujete	raznese	Tense
pokunji	gani	Person
hlapljaste	stigao	Tense
razbolijevaj	iskašljavajmo	Mood
intrigantnomu	najdalekosežnijima	Case
lepši	kompleksne	Gender
pristanimo	savij	Mood
akumulirate	studira	Tense
strašiš	pohaba	Person
potkopaste	odjahivala	Tense
prdnem	primaknuo	Person
opominjaše	naknadi	Person
abecednoga	najmnogoljudniji	Gender
šniraj	iskašljavajmo	Mood
radioaktivno	olakšana	Number
fosilne	zglobnu	Gender
civiliziraniju	trezvenijih	Comparison
razgoni	istovarimo	Tense
dokonijom	vjetrovitijima	Comparison
porozan	količniku	Number
razmicahu	pribodu	Person
federacijom	petini	Number
primitivnima	strašno	Gender
težimo	sadi	Mood
dokonijom	jasnija	Comparison
sede	raspodela	Number
brdovitiji	vjernije	Comparison
stiša	krikneš	Person
sjemena	limunov	Case
najlakomislenijoj	najsediji	Comparison
bezbolne	zajahao	Gender
ovenčavate	šapućite	Person
najkraće	katastrofalnima	Gender
proizvođaše	izložena	Tense
zablistajmo	razlabavi	Mood
obuzelo	utvrdiše	Tense
šeći	sagrešimo	Mood
najcenjeniju	najliberalnija	Comparison
bezobrazna	snishodljivije	Number
sušah	obuzimam	Person
sabotirasmo	odmaknuo	Mood
broji	kokodačimo	Mood
predajmo	dodeljuj	Mood
naiđu	gavrana	Number
homonimne	zglobnu	Gender
najbližima	najširoj	Comparison
najrustičnijemu	najoholijih	Comparison
najvjerojatnije	kritična	Gender
preskoči	nabrbljajmo	Mood
uzgojili	zdepast	Gender
nazvah	iskazala	Tense
sječiva	dotični	Case
hitra	ogromnima	Gender
jednooka	palatalom	Number
pogrešnome	najledenijima	Gender
hrvatska	umišljenijim	Number
najpribližnije	najfunkcionalnijih	Comparison
ultrazvučna	ultrazvučnima	lemma
prostre	nameravate	Tense
ekvinocij	olakšana	Number
bezgranična	potencijalna	Case
podgrejavajmo	presadi	Mood
miroljubiva	najmnogoljudniji	Gender
nesretnija	hermetičnijima	Comparison
obvezivaše	obmanjivane	Tense
neodlučeno	olakšana	Number
nevernici	poznata	Number
crvenjaše	prsnusmo	Tense
spasih	alterniram	Person
spriječiše	reminiscirahu	Person
ugodnima	zajahao	Gender
riđu	sporne	Number
zastreš	gani	Person
uplovimo	guši	Mood
isprala	energične	Gender
božjima	božji	lemma
umrijeste	hvaljena	Tense
hvalospjevima	porušiste	Number
oslabiš	pohaba	Person
smjestimo	podrignusmo	Person
štemasmo	nametljivijima	Number
rožnica	minimalna	Number
najmilitantnije	sićušnom	Gender
oženi	raznežimo	Mood
totalitarnomu	rezultantama	Case
tukla	nepogodne	Number
najneobičnijih	cenzusa	Case
bučnijima	eruptivnije	Comparison
sječiva	rodoljubivo	Case
sagori	osvetimo	Mood
postanimo	svladavaj	Mood
zapadnima	snizujte	Number
samouvjereniji	neumerenih	Gender
zadavljuj	iskašljavajmo	Mood
najpovjerljivija	najširoj	Comparison
najnepogodnijemu	najkvalitetnijima	Comparison
udaljenijih	udaljenu	lemma
asimetrična	neprijateljskome	Gender
prozovi	dodirnimo	Mood
sede	amajliji	Number
svrstavao	izložena	Tense
cijeljena	postavljaše	Tense
stiša	posveti	Person
izdašnih	izdašnijoj	lemma
neophodnoj	istaknute	Gender
intervale	dokazima	Number
besposleni	fosilu	Number
probavljivoj	najneupadljivijima	Case
kontinentalna	kontinentalnom	lemma
rešene	uvuklo	Tense
miroljubivijemu	miroljubive	lemma
predložio	balavljene	Tense
nečovečnijom	rizičnija	Comparison
ekipe	najfrivolnijima	Number
nacionalističku	šlampavo	Number
pripremana	najkrupnije	Gender
sablazni	importira	Person
спљоштен	nežni	Gender
proizvodne	jednolične	Gender
najdjelotvornijega	najoštrija	Comparison
promišljeno	skladnijemu	Number
dotiskaste	zacelite	Person
zavređujmo	osiromašuj	Mood
nasmijaše	obuzdavalo	Tense
oslanjam	posteljicu	Number
tijesne	traper	Case
nasmeje	svjedočimo	Tense
najrezonantniji	najužasnijima	Comparison
blatili	razdraživaše	Tense
državljane	dokazima	Number
najbogohulnijim	bogohulne	lemma
zbunjujmo	opovrgavaj	Mood
raspisivasmo	preplatimo	Person
svestrana	smotre	Number
potocima	školjkaste	Number
sede	zelenilo	Number
društvenijima	brzopletomu	Gender
bubuljičavijima	veselije	Comparison
spomeni	preostanimo	Mood
dešavaste	povećavate	Person
labavimo	čađi	Mood
dragocjenijima	lucidniji	Comparison
pozivana	razdraživao	Tense
ekstaze	severoistočnima	Number
bezočnomu	piramidalna	Gender
razglašeni	trošilo	Tense
pretuci	sagrađujmo	Mood
dodijelimo	čađi	Mood
kreći	raznosimo	Mood
prvorazredni	ustrojila	Number
proizvoljnijom	ljepši	Comparison
uspješnije	ptičja	Gender
srdžbe	pogubna	Case
oblačnija	beščasnijoj	Comparison
nevjerniji	stečajevi	Case
nehotičnijih	prekrasne	Case
neodređenih	katoličku	Gender
anticipirasmo	banaliziraše	Mood
kontrola	ozbiljne	Number
bezgranična	dobročinstvo	Case
zaredih	ždrijebali	Tense
dževajirima	ispitivanja	Number
ovsenoj	ovseni	lemma
pijanijima	bistrijemu	Comparison
potkrepiše	završavaju	Person
remećahu	ovjenčaju	Person
verifikacije	vaseljenskih	Number
najprćastiji	najhranjivijima	Comparison
filtrira	veseli	Person
kontinentalna	kontinentalnima	lemma
iščupa	pripremane	Tense
divji	platnima	Number
najdarežljivijima	vata	Number
strateška	kameni	Case
najbednijoj	retrofleksne	Gender
najvjernije	vjerno	lemma
ovladala	izoravahu	Tense
kašljimo	vozaj	Mood
podnošeni	zauze	Tense
razastri	opozivajmo	Mood
gojaznoj	najobzirnijih	Gender
častohlepniji	crvljivije	Comparison
istraživali	odmamljivana	Tense
najvedriji	najsvečanije	Comparison
tržištima	zavidni	Number
mračno	marnijih	Gender
bogohulili	zamerena	Tense
nosimo	tali	Mood
našla	imitiraše	Tense
podsjećaj	razagnajmo	Mood
ključaše	paradiraš	Person
banalnija	hermetičnijima	Comparison
punašnija	oporijemu	Comparison
najšašavijima	bajato	Gender
prekretaste	silazio	Tense
gȍvōre	leksikološko	Case
voštimo	pomakneš	Tense
najčujnije	najbrzopletijih	Comparison
ozljeđivana	ždrijebah	Tense
seksualnom	sklonije	Gender
čȍbānā	herojske	Case
homogenu	raspodela	Number
spomeni	ispraznimo	Mood
raspisivasmo	pridremamo	Person
poblijedje	servisiraš	Person
centrifugalnih	patkica	Number
neodređenih	adekvatna	Gender
najnapetija	najdetinjastiju	Comparison
mamurnije	pohlepnijima	Comparison
hlapljaste	uzrujala	Tense
paljeni	susretaše	Tense
potkopaste	spominjalo	Tense
istočnijoj	neaktivnim	Number
pridruži	oslobodila	Tense
zablistajmo	seci	Mood
klonulosti	platnima	Number
mešala	zauze	Tense
ksenofobija	definitivnu	Number
okusim	spriječe	Tense
autoritativnima	spasilačko	Gender
unitaristička	olakotnih	Gender
brojni	pustinjski	Gender
tribajte	brzopletih	Number
zavarala	opozivasmo	Tense
islamiziraše	postigli	Mood
indoeuropskim	ptičja	Gender
povlačimo	posti	Mood
razodevala	olabaviste	Tense
najtuplje	tupomu	lemma
otarasismo	suzbijemo	Person
udavana	formulira	Tense
šarmera	kolede	Case
razradili	izgradi	Tense
preferira	svjedočimo	Tense
ovalnima	najsublimnijemu	Gender
poveravaše	prerasla	Tense
ukrotivo	palatalom	Number
državljane	svetlih	Number
pridruži	prerasla	Tense
svićete	uzmičem	Tense
rascijepano	prikazivahu	Tense
doprinesene	postavljaše	Tense
najtanji	iznenađene	Case
zaposlenima	pȅtēljci	Case
savršena	zaposlenije	Gender
čitave	najlucidnije	Gender
najsapunastije	zelenilo	Number
prospavaj	zapustimo	Mood
plećata	procenjena	Gender
nerazgovetnoj	najhuđe	Gender
mučnija	bubuljičavijima	Comparison
laganije	narodnom	Gender
bocnula	logorovaste	Tense
naiđu	svilenima	Number
ružičnjak	albanologijska	Case
ekstaze	apsurdna	Number
crvenjaše	želeli	Tense
zreloj	izmigoljeno	Number
preračunavajmo	čađi	Mood
mirila	nepismena	Gender
pohvali	razlikovala	Tense
trebite	naslanjaste	Person
najgrandioznijemu	sadizmima	Case
pojedosmo	dodatna	Number
najvarljivijih	suptilnije	Case
pasivnima	težite	Number
kretske	lešnjak	Case
riskantnijemu	basnoslovno	Number
svibom	fetivima	Case
služaste	strizana	Tense
riđokosu	neprijateljstvima	Case
obodi	iskašljavajmo	Mood
prozvaste	saugajte	Person
svesnija	nestabilnijim	Comparison
najelegantnijemu	najelegantnije	lemma
razgrizao	razmisliše	Tense
kantonskim	glagolska	Number
aspekt	tehnologije	Case
obrađivasmo	presvlačena	Tense
istovrsnima	mùzikōm	Case
sentimentalnih	cenzusa	Case
najkompaktniji	najmaloumnijoj	Comparison
povećamo	nabavljajmo	Person
koturah	kopam	Person
predomišljalo	podržani	Tense
prdnem	stvarah	Person
odvodimo	penimo	Person
krvožednijima	uvereniji	Comparison
zasjenjivaše	procenjuješ	Person
maknuo	poremećuješ	Person
zastreš	ljubakaj	Person
mahni	množimo	Mood
oglođi	smijmo	Mood
sramniji	emocionalnije	Comparison
napravimo	dogovori	Mood
obećane	formulira	Tense
hvalospjevima	careve	Number
zasenjuj	gorčajmo	Mood
uzbudljivih	krljuštima	Number
dosežemo	obuče	Tense
ovjeriše	prijala	Tense
nosimo	obuhvati	Mood
pomešala	čovjekoljubivoga	Gender
sjao	tovljahu	Tense
kroatizacija	tmurnije	Number
krȉčavosti	apriornoga	Number
strateška	otmeniji	Case
uplovljavajmo	istakni	Mood
križarska	razvezivalo	Gender
arhaičnoga	šugavija	Gender
natjerujete	svučem	Tense
savitljivih	izrezao	Gender
najkompetentnijega	najsamozadovoljnijima	Comparison
napomenimo	pokrsti	Mood
izuj	otpadajmo	Mood
postupalo	ispitivački	Number
krši	borimo	Mood
najposlušnije	neoprezna	Gender
divljakušom	azijskima	Case
najbesmislenijima	ozbiljne	Number
kompleksnijima	anglosaskomu	Gender
najlošiji	neumerenima	Number
zreloj	čunu	Number
apstrakcijama	flegmatičnijemu	Case
kratkovidnosti	navalila	Number
sljedećima	bolujmo	Number
razmisle	molim	Tense
neočekivanija	neočekivanima	lemma
zgurimo	ceni	Mood
zasađuj	nabrbljajmo	Mood
nemirnom	nemirnih	lemma
razodevamo	zgrabi	Tense
zloupotrebljavate	naviknem	Tense
dojavljuj	smijmo	Mood
ujedini	obijeni	Tense
nepisanima	genitivnoj	Case
šištao	podešavasmo	Tense
usavrši	izganjajmo	Mood
mješoviti	mješovitih	lemma
postanimo	smještaj	Mood
najuspešnijega	uspešno	lemma
zornijemu	slabašnije	Comparison
gulila	prostirasmo	Tense
receptivne	fotke	Number
usavrši	otičimo	Mood
nemoćna	zdravije	Gender
zabijana	pripadoste	Tense
genetičkih	genetička	lemma
primjedbe	najšarmantnijih	Case
aprilske	baleta	Number
prekidaj	raznežimo	Mood
šepavijima	izopačenijega	Comparison
krivudala	zapuštahu	Tense
trpi	trgnimo	Mood
dugotrajan	bezopasno	Number
opaku	opake	lemma
najzaslužniji	najoštrija	Comparison
podriguj	poboljšaš	Person
neprijaznima	tvrdokornima	Number
zauzdavane	sporazumijevao	Tense
najimaginativnija	najegoističnijoj	Comparison
miru	deljivoga	Number
špijala	iscrpljena	Tense
najsmješnijemu	najsuznije	Comparison
najsedije	trivijalnima	Gender
tukla	vatrenijih	Number
isijecimo	obaveštavaj	Mood
dovožaše	gnevnomu	Number
našla	zagrebe	Tense
decembarski	šumovite	Gender
opljačkajmo	odledi	Mood
karboksilna	autobiografiju	Number
piroksilínu	elokventno	Number
zacementiraj	položimo	Mood
najdragocjenijima	најцјеловитији	Comparison
svrati	zanimajmo	Mood
prezalogajivah	količniku	Number
profitabilnih	najprofitabilnijih	lemma
načina	milja	Case
rigoroznu	autoritativnija	Gender
spriječiše	pulsiraju	Person
trivijaliziraše	polude	Person
sumornije	neiskusnijima	Comparison
srčite	transformirate	Person
prisutnijim	smotre	Number
izvožasmo	krepavala	Tense
predlagan	oslobodila	Tense
lekovitijima	bistroumnomu	Gender
primjenjivaste	dušete	Person
otpisa	porobljavani	Tense
kopnenih	najkrupnije	Gender
borile	bljuzgaše	Tense
šlampavijima	krstašima	Number
prvenstvenima	čovjekoljubivoga	Gender
teatri	torzijskih	Number
hiljadama	brakom	Case
zaklinjimo	miješaj	Mood
pismohranama	svanuću	Case
avijacijo	ratoborna	Number
ekstremniji	riskantnijima	Comparison
prvenstvene	prvenstvena	lemma
pretpostavljena	unela	Tense
krevetni	jestivi	Gender
najpotišteniji	najužasnijima	Comparison
kidaj	sapiraše	Person
pčelinjemu	najstrmiju	Number
najkažnjivijom	najsediji	Comparison
obuzelo	porobljavani	Tense
ljubaznijima	nesebičnijega	Comparison
uvodimo	karaj	Mood
anđeoski	štitasti	Gender
najsigurnija	sigurnije	lemma
udavana	razumeo	Tense
postupnijih	postupnijima	lemma
ukopavate	prošećite	Person
logičkima	titoističkoga	Gender
žonglirao	prisjetismo	Tense
filantropija	ustrojila	Number
rađalo	ulovljeni	Tense
nahuška	razvalile	Tense
metni	naslutimo	Mood
odvukli	profitabilnu	Gender
najmlađu	najbrža	Comparison
gorskih	svirajte	Number
vatrenima	vatrenija	lemma
povlačimo	vozaj	Mood
podvede	remetimo	Tense
proračunali	dopisa	Tense
doprinesene	metaše	Tense
mame	milja	Case
razmišljaj	dodirnimo	Mood
ujedini	zaraćeni	Tense
cvetaj	krpimo	Mood
sledećih	agilan	Gender
prašnijima	najplesnivije	Gender
udavana	predvodila	Tense
prizvuku	činjenična	Number
najdrastičniji	najprodornijima	Comparison
podesnija	smirenija	Comparison
najvjerojatnije	sažalila	Gender
instruktivnijega	spokojnijima	Comparison
svari	rasklopi	Person
plati	postignimo	Mood
popustljivijima	mudrija	Comparison
podesnija	bubuljičavijima	Comparison
združismo	posedovala	Tense
najponositijim	pokunji	Number
skrasi	zgražavajmo	Mood
zahvalnija	najzahvalniji	lemma
želite	studira	Tense
uzvikuj	razagnajmo	Mood
dugovječnijima	stroža	Comparison
vežbane	prisezalo	Tense
isuši	nastanjujmo	Mood
odstreljena	ulizah	Tense
trajnijima	nesebičnijega	Comparison
remećahu	osiromašuju	Person
najlošiji	takozvana	Number
odazivu	neparnima	Case
snižavalo	pojačavani	Tense
nadahni	prepoznajmo	Mood
napasti	sveobuhvatna	Case
najpažljivija	sjenovito	Gender
buktimo	rubricirasmo	Person
moraj	pribrojimo	Mood
indoeuropskim	najdrastičnija	Gender
faksiraše	rafiniraste	Mood
crkavahu	razdirano	Tense
dosađivahu	protjecan	Tense
tešila	odupresmo	Tense
pogibaše	uporabila	Tense
šeći	strahovaše	Person
sramim	zbližih	Person
najobilatijima	најискренији	Comparison
bocnula	tovljahu	Tense
skupocjenija	skupocjenu	lemma
bubaj	kartajmo	Mood
snizivala	sasijecan	Tense
sjekle	odlete	Tense
dvoličnija	dvoličnijima	lemma
pretuci	uzviknimo	Mood
vrednovaste	verite	Person
ćeretava	najhladnijih	Case
dosađivahu	podvaljeno	Tense
protjerana	trianguliraj	Tense
indolentnima	rȍgu	Case
iznenađeno	najosjetljivije	Case
razložimo	najrazumljivijima	Number
stječi	abortiraš	Person
najglupavijega	najsvečanije	Comparison
neprihvatljiva	omamljivih	Gender
kaznile	povređivaše	Tense
nasamarivaše	ogovaraš	Person
odvodimo	bukćasmo	Person
alarmantna	neuspešnim	Gender
rađalo	pripojene	Tense
prostirimo	ispitaj	Mood
podsjećaj	uvežbajmo	Mood
obrisana	očara	Tense
tešnje	impresivne	Gender
pišljiviji	kričave	Gender
gandži	indološkome	Number
neprijaznima	školjkaste	Number
plodonosno	bogat	Number
najspornije	najspornijemu	lemma
prestupile	onemogući	Tense
najzapadnijega	najtrpeljivijima	Comparison
slađa	najslađi	lemma
ugušujmo	ujedini	Mood
izravnijemu	pohlepnijima	Comparison
najsarkastičnijemu	sarkastičnijom	lemma
junačnijima	vratolomniji	Comparison
rabote	autobiografiju	Number
zasađuj	odmamljujmo	Mood
najtragičnijemu	tragičniju	lemma
karboksilna	ustrojila	Number
uvezujmo	gnjij	Mood
tribajte	careve	Number
bljujmo	osudi	Mood
zbližismo	budaljaše	Tense
najnevernijemu	andaluzijski	Number
abecednoga	izostavljeni	Gender
motrah	odrodim	Person
ìzvor	nabodeno	Number
prominentnije	najžilavijemu	Number
rasijavajmo	takozvana	Number
cijeljena	kazivao	Tense
greza	jednooka	Case
naglašavaj	povrijedimo	Mood
glorificiraste	pogledan	Tense
štedimo	oporiči	Mood
smrdljivcima	operativnijim	Case
smeđastoj	solidarnoga	Number
primjenjivaste	survavate	Person
naviknusmo	ojačavalo	Tense
najnevernijemu	rezidencijalnu	Number
sagorevana	najklizavijima	Number
rastjeraše	inovirahu	Person
namočen	oženiše	Tense
trpi	podsetimo	Mood
lipanjske	uspešne	Gender
raznovrsnija	najraznovrsniji	lemma
rascepljivasmo	opčinjavan	Tense
topolama	entuzijastičnih	Number
površna	površnijemu	lemma
popisivasmo	prokrvarimo	Person
graničimo	tmaste	Number
najsedije	popularizatorska	Gender
napravimo	beži	Mood
šarmera	nejednolike	Case
čovjekoljubivija	vrletniji	Comparison
nikao	pripremane	Tense
suhe	najozbiljnijih	Case
radosnu	rodovima	Case
najumišljenijih	narodnom	Gender
golenjače	krstašima	Number
vodili	zagrebe	Tense
inverzijo	iznenađene	Case
štemasmo	svetlih	Number
nedostaj	množimo	Mood
neprofesionalnu	najosjetljivije	Case
zablistajmo	vadi	Mood
uzgojili	турбулентни	Gender
izvožasmo	otapala	Tense
elokventnima	taktilnu	Gender
prisluškivali	formulira	Tense
izuj	probirimo	Mood
gorskih	miljei	Number
obećane	doznah	Tense
garantirasmo	cijepljaše	Mood
najzaslužnijima	ukidao	Gender
protjerana	polomila	Tense
panamske	ekvivalentnu	Gender
seksualne	nerazumno	Case
ljuštahu	guštaju	Person
mešala	iscrpljena	Tense
podrazumijevao	ukorjenjivahu	Tense
novija	novu	lemma
broji	krivuljajmo	Mood
kašljimo	razbolevaj	Mood
karboksilna	rješivi	Number
dokučimo	ponašaj	Mood
probirala	ženjaste	Tense
paradoksi	senzacionalna	Case
podgrejavajmo	truj	Mood
razotkrivahu	iskorenjen	Tense
dokučimo	očisti	Mood
čovječniji	čuvenijima	Comparison
vrećaste	najanakronističnijih	Case
iskušajmo	potrudi	Mood
sagrešila	presvlačena	Tense
aprilske	oficirima	Number
košmarnima	rasformiraju	Number
okrade	oplovila	Tense
mešala	hvaljena	Tense
svojstvenim	oračkoj	Number
neodlučeno	izjednačio	Number
nadvišeni	iscrpna	Number
otpisa	srtasmo	Tense
adverbnih	privrženim	Gender
najsmješnijom	najsablasnijima	Comparison
preplaćivala	nadživljavan	Tense
najsmirenije	najstrahotnije	Comparison
zadovoljnija	zadovoljnijima	lemma
potkopaste	naduto	Tense
najvrednijih	najvredniji	lemma
feničke	ljuće	Gender
najmanje	najsočnijih	Comparison
dojašimo	uživaj	Mood
preostaj	smijmo	Mood
melankoličnija	krivi	Number
zabunimo	načni	Mood
bivola	zlobne	Case
nesvesna	prethodnoj	Number
šljunčanim	zemljoradnicima	Case
raskošnijemu	ažurnija	Comparison
sustajao	utvrdiše	Tense
kvantitativne	sporedne	Gender
najanonimnijih	najegzotičnijega	Comparison
poroznija	spokojnijima	Comparison
jadikovala	najilustrativnijim	Gender
adijabatskim	fleksibilnijima	Case
