rantolo	First person Singular
vertono	Third person Plural
rifacesse	Third person Singular
spumeggiavi	Second person Singular
tratto	None
violasse	Third person Singular
scattarono	Third person Plural
rilasso	First person Singular
piaggiavate	Second person Plural
infiammò	Third person Singular
menerete	Second person Plural
popolarizzò	Third person Singular
partorirà	Third person Singular
capitanò	Third person Singular
simbolizzato	None
professo	First person Singular
asserragliano	Third person Plural
tuffassimo	First person Plural
finanziandosi	None
decimano	Third person Plural
unto	First person Singular
laceravano	Third person Plural
smussato	None
stabiliva	Third person Singular
rimescolato	None
occorreranno	Third person Plural
prospero	First person Singular
scappelliate	Second person Plural
personalizzò	Third person Singular
intronizzare	None
distruggono	Third person Plural
slanceresti	Second person Singular
risposò	Third person Singular
arrostendo	None
attrezzare	None
incamminò	Third person Singular
affisseremo	First person Plural
pretendendo	None
allineare	None
crollo	First person Singular
sollecitò	Third person Singular
designante	None
mantenessimo	First person Plural
assistevano	Third person Plural
tirarono	Third person Plural
distilleremmo	First person Plural
odorassimo	First person Plural
succhiava	Third person Singular
pongo	First person Singular
alienano	Third person Plural
fermò	Third person Singular
componendo	None
ricomperassimo	First person Plural
avvicinassero	Third person Plural
liquidava	Third person Singular
annoverano	Third person Plural
insaccherebbero	Third person Plural
seminato	None
impartiscono	Third person Plural
trascorrere	None
arguì	Third person Singular
influenzano	Third person Plural
giocare	None
accalcavano	Third person Plural
somiglierà	Third person Singular
penalizzare	None
pasturo	First person Singular
capito	First person Singular
decollerà	Third person Singular
riporterò	First person Singular
adiuvante	None
sfregato	None
rimpiazzeremo	First person Plural
riequipaggiassero	Third person Plural
stravolsero	Third person Plural
immergeva	Third person Singular
trastullammo	First person Plural
stendevano	Third person Plural
impastocchiante	None
frizzo	First person Singular
solfito	First person Singular
salvava	Third person Singular
decontestualizzando	None
perturbati	Second person Singular
sbizzarrisce	Third person Singular
ingualdrappo	First person Singular
datano	Third person Plural
divorano	Third person Plural
rincalzo	First person Singular
compaio	First person Singular
svolazzato	None
contraddistinguono	Third person Plural
incastrati	Second person Singular
collidere	None
riconsiderando	None
innalzarono	Third person Plural
ridicolizzato	None
spiccano	Third person Plural
involgarirsi	None
equivarrebbe	Third person Singular
coruscato	None
trasformava	Third person Singular
proporranno	Third person Plural
asseggiano	Third person Plural
ricollegante	None
travalicò	Third person Singular
avvicenderanno	Third person Plural
faticheresti	Second person Singular
numero	First person Singular
disinteresso	First person Singular
avvitati	Second person Singular
annotato	None
rinserrarsi	None
causare	None
gemicasse	Third person Singular
pitturerà	Third person Singular
seghetto	First person Singular
avvertirò	First person Singular
localizzano	Third person Plural
cadendo	None
accosterà	Third person Singular
masturbandosi	None
rinchiudendosi	None
perduro	First person Singular
rifermentare	None
rivolto	First person Singular
giudicherete	Second person Plural
inserirei	First person Singular
infistolire	None
mantennero	Third person Plural
bascio	First person Singular
germanizzare	None
scamparono	Third person Plural
cadrete	Second person Plural
dislocava	Third person Singular
motivarono	Third person Plural
asportare	None
villeggiante	None
inimicati	Second person Singular
avvicinai	First person Singular
proferisce	Third person Singular
tappezzeresti	Second person Singular
corresponsabilizzerei	First person Singular
imputano	Third person Plural
fidano	Third person Plural
stracciarsi	None
sprotesse	Third person Singular
abbittavo	First person Singular
sospingono	Third person Plural
scivolando	None
immobilizzava	Third person Singular
snodavano	Third person Plural
cavò	Third person Singular
stupiamoci	First person Plural
interagendo	None
impaurito	None
andammo	First person Plural
rigovernando	None
aggiogassimo	First person Plural
professava	Third person Singular
deviasse	Third person Singular
curiosavano	Third person Plural
preavvertire	None
rettifico	First person Singular
riarrangiò	Third person Singular
collocarono	Third person Plural
disgregava	Third person Singular
avviarono	Third person Plural
recapitato	None
darò	First person Singular
debello	First person Singular
livellati	Second person Singular
peregrinò	Third person Singular
emulato	None
vessante	None
abbraceremo	First person Plural
tornarono	Third person Plural
bascerei	First person Singular
rivitalizzare	None
bravammo	First person Plural
autorizzano	Third person Plural
arrisero	Third person Plural
palettizzante	None
distrassero	Third person Plural
stravaccato	None
stupefarsi	None
bazzico	First person Singular
salvarsi	None
inchiodano	Third person Plural
interromperanno	Third person Plural
specchiarsi	None
inserisce	Third person Singular
sfoderare	None
arcai	First person Singular
allettasse	Third person Singular
corsero	Third person Plural
soffocano	Third person Plural
valicavano	Third person Plural
risteso	None
suddivise	Third person Singular
circumnavigato	None
ammanettò	Third person Singular
corico	First person Singular
sciopero	First person Singular
affluirono	Third person Plural
prosperando	None
miticizzava	Third person Singular
consolarsi	None
andava	Third person Singular
infeudò	Third person Singular
eclissati	Second person Singular
infuso	None
coscritto	None
litografo	First person Singular
accollandosi	None
qualificarsi	None
disimpegnò	Third person Singular
tolleravano	Third person Plural
propagandava	Third person Singular
coordinandosi	None
allaccerebbe	Third person Singular
affliggere	None
laicizzò	Third person Singular
decespugliano	Third person Plural
addensarsi	None
digitava	Third person Singular
scrivevi	Second person Singular
scamiciati	Second person Singular
stipato	None
rappacificati	Second person Singular
guadagneremo	First person Plural
sanzionano	Third person Plural
concretizzeranno	Third person Plural
porto	First person Singular
lodavano	Third person Plural
rigenerava	Third person Singular
ammassano	Third person Plural
riaprì	Third person Singular
affondassero	Third person Plural
equipaggiano	Third person Plural
allineati	Second person Singular
precisò	Third person Singular
demandiate	Second person Plural
opterà	Third person Singular
dedicherò	First person Singular
sottendere	None
catechizzavate	Second person Plural
inquietava	Third person Singular
solcò	Third person Singular
oggettivizzato	None
stempiantesi	None
rispetterebbero	Third person Plural
cade	Third person Singular
adorare	None
sentenziava	Third person Singular
pulirsi	None
smantellarono	Third person Plural
brancolavano	Third person Plural
sedimentarono	Third person Plural
controvertere	None
trillò	Third person Singular
reinterpretarono	Third person Plural
arrotolavano	Third person Plural
transitò	Third person Singular
prolungo	First person Singular
bissare	None
gallonando	None
abbenderete	Second person Plural
rinascerò	First person Singular
votare	None
menato	None
constatarono	Third person Plural
andassero	Third person Plural
combinati	Second person Singular
cadremmo	First person Plural
scagionarsi	None
scostava	Third person Singular
ammorbidendo	None
portò	Third person Singular
decorrente	None
obbligati	Second person Singular
privilegiò	Third person Singular
totalizzarono	Third person Plural
occorrono	Third person Plural
riuscirà	Third person Singular
gassano	Third person Plural
spezzasse	Third person Singular
sogguardato	None
accovonato	None
rifarsi	None
democratizzato	None
affilettante	None
pare	Third person Singular
scritturarono	Third person Plural
visionano	Third person Plural
consorziati	Second person Singular
demorso	None
nasceranno	Third person Plural
rattrappendo	None
rielegge	Third person Singular
sussegue	Third person Singular
offrendosi	None
acquerello	First person Singular
sottoscriverai	Second person Singular
preparati	Second person Singular
sfai	Second person Singular
frizionarsi	None
staccasse	Third person Singular
festeggerà	Third person Singular
riceveranno	Third person Plural
nuoterà	Third person Singular
scoprivano	Third person Plural
scompaginava	Third person Singular
attirandosi	None
pungeranno	Third person Plural
perlustrano	Third person Plural
intestò	Third person Singular
reagiscono	Third person Plural
raffreddato	None
fermeremo	First person Plural
sperò	Third person Singular
evasero	Third person Plural
rimodernava	Third person Singular
rifornivano	Third person Plural
subentrava	Third person Singular
tirato	None
capotasti	Second person Singular
circondante	None
moriremo	First person Plural
corrispondevi	Second person Singular
deteriorati	Second person Singular
prefiggevano	Third person Plural
trasportare	None
indurisce	Third person Singular
ricomparso	None
rincarato	None
dato	First person Singular
noleggiò	Third person Singular
restringeva	Third person Singular
ricotto	None
assestarono	Third person Plural
intagliò	Third person Singular
affreneremmo	First person Plural
correggesse	Third person Singular
decideranno	Third person Plural
immettersi	None
preoccupati	Second person Singular
afferiva	Third person Singular
aiutante	None
inorgoglendo	None
bisognerebbe	Third person Singular
validato	None
incentrò	Third person Singular
noverante	None
attanagliano	Third person Plural
focalizzasse	Third person Singular
razziò	Third person Singular
frangono	Third person Plural
renderemmo	First person Plural
addolorassero	Third person Plural
dilettava	Third person Singular
allagava	Third person Singular
arrabbio	First person Singular
supereranno	Third person Plural
spostati	Second person Singular
congedò	Third person Singular
perforato	None
ridisegnarono	Third person Plural
durano	Third person Plural
falcidiavano	Third person Plural
bevessero	Third person Plural
fermarono	Third person Plural
linkavo	First person Singular
uccise	Third person Singular
muoiono	Third person Plural
spasimante	None
elevasse	Third person Singular
commissionava	Third person Singular
figurarono	Third person Plural
proteggere	None
bisbocceranno	Third person Plural
corrughereste	Second person Plural
testimoniare	None
sorvegliando	None
inglobando	None
vincerete	Second person Plural
condannassero	Third person Plural
intimidì	Third person Singular
galoppando	None
smorzando	None
copiaincollando	None
frapporrà	Third person Singular
postava	Third person Singular
acculturare	None
interdire	None
spicciolo	First person Singular
berrò	First person Singular
confitto	None
scornicereste	Second person Plural
agito	First person Singular
disubbidirà	Third person Singular
cenava	Third person Singular
svaghiate	Second person Plural
emulò	Third person Singular
blaterare	None
corsi	First person Singular
deossigenato	None
predice	Third person Singular
dissi	First person Singular
volantinare	None
ribellavi	Second person Singular
sfilando	None
scrissero	Third person Plural
monitorano	Third person Plural
brillo	First person Singular
localizzarono	Third person Plural
riaccende	Third person Singular
chiacchierato	None
arroventati	Second person Singular
cumulano	Third person Plural
presupponesse	Third person Singular
manleverai	Second person Singular
puzzando	None
implodono	Third person Plural
dotano	Third person Plural
impaniammo	First person Plural
erosero	Third person Plural
impoveriva	Third person Singular
spogliavano	Third person Plural
intersecava	Third person Singular
bianchirete	Second person Plural
scacciava	Third person Singular
osanneresti	Second person Singular
trascurando	None
aggangherare	None
raggomitolo	First person Singular
intrappolava	Third person Singular
fondevano	Third person Plural
insorgere	None
adattò	Third person Singular
seguiva	Third person Singular
regolarizzano	Third person Plural
disdegnare	None
riarrangiavate	Second person Plural
rigante	None
dicevate	Second person Plural
subentrando	None
commetteva	Third person Singular
attendevano	Third person Plural
proteggersi	None
statuisce	Third person Singular
congelava	Third person Singular
impedirà	Third person Singular
rimilitarizzeranno	Third person Plural
crolleranno	Third person Plural
inserivo	First person Singular
rimandassero	Third person Plural
rivelato	None
squagliare	None
esortato	None
caricherà	Third person Singular
arronzante	None
rieleggono	Third person Plural
esordente	None
desisteva	Third person Singular
partorisse	Third person Singular
squillano	Third person Plural
coniugare	None
abortire	None
ostacolare	None
dragherete	Second person Plural
capitozzeremmo	First person Plural
torturerò	First person Singular
congregati	Second person Singular
standosene	None
emerse	Third person Singular
pensiate	Second person Plural
gelatinizzerete	Second person Plural
ricostruì	Third person Singular
testimoniarono	Third person Plural
rapisco	First person Singular
ammosterò	First person Singular
cibassero	Third person Plural
fecondò	Third person Singular
cadono	Third person Plural
spiegava	Third person Singular
murerete	Second person Plural
offrirono	Third person Plural
repertante	None
raccordò	Third person Singular
toserei	First person Singular
ricongiungono	Third person Plural
espliciterà	Third person Singular
raggranellammo	First person Plural
trasferisciti	Second person Singular
baccaglio	First person Singular
sopravvissuto	None
chino	First person Singular
volgono	Third person Plural
venivo	First person Singular
mieteva	Third person Singular
sporcano	Third person Plural
regolamentano	Third person Plural
nuotava	Third person Singular
brandisce	Third person Singular
giacendo	None
riaffiorano	Third person Plural
convincendosi	None
collaborassero	Third person Plural
raggiungere	None
recupereremo	First person Plural
rotolarono	Third person Plural
disassemblare	None
convolato	None
spiato	None
accapigliarsi	None
rallentarono	Third person Plural
esponendo	None
concorsero	Third person Plural
acetiresti	Second person Singular
precorrevano	Third person Plural
singhiozzo	First person Singular
amministrava	Third person Singular
alternerà	Third person Singular
rinviava	Third person Singular
eliminerei	First person Singular
addormentantesi	None
brandivano	Third person Plural
rimembrando	None
sorreggente	None
ineriscono	Third person Plural
tubo	First person Singular
riguarderanno	Third person Plural
cilindro	First person Singular
premuro	First person Singular
prezzereste	Second person Plural
insiste	Third person Singular
intoppasti	Second person Singular
celebrassero	Third person Plural
borbotterei	First person Singular
dotasse	Third person Singular
cercando	None
ragghiò	Third person Singular
schiantasti	Second person Singular
omaggiando	None
miglioro	First person Singular
romperanno	Third person Plural
interrompeva	Third person Singular
accottimarono	Third person Plural
spaparacchiandosi	None
diffidati	Second person Singular
rappacificano	Third person Plural
riesumiate	Second person Plural
avvizziscono	Third person Plural
assentandosi	None
conciteremmo	First person Plural
preannunciano	Third person Plural
ringraziando	None
segregare	None
durarono	Third person Plural
emigrando	None
sbloccò	Third person Singular
cerchiai	First person Singular
troneggeresti	Second person Singular
idrato	First person Singular
recidivo	First person Singular
ravvivano	Third person Plural
aggregherete	Second person Plural
antepone	Third person Singular
arrangiatevi	Second person Plural
spadellare	None
interpretassero	Third person Plural
delineavano	Third person Plural
rioccupare	None
ingiungeva	Third person Singular
affievolisce	Third person Singular
mondializzeremmo	First person Plural
coprire	None
distogliersi	None
pentiti	Second person Singular
speronò	Third person Singular
fiorivano	Third person Plural
asfissiato	None
scorrazzo	First person Singular
prevenire	None
importarono	Third person Plural
rappresentavi	Second person Singular
rifondando	None
figurò	Third person Singular
liberante	None
sinterizzato	None
demoliva	Third person Singular
rinserrò	Third person Singular
ruotava	Third person Singular
approdano	Third person Plural
decadente	None
deresponsabilizzarsi	None
indicizzato	None
progetto	First person Singular
qualificato	None
rimpaginante	None
tamponato	None
pensantesi	None
scrollasse	Third person Singular
ottimerai	Second person Singular
sprinterà	Third person Singular
concorreva	Third person Singular
riconquistassero	Third person Plural
adeguavano	Third person Plural
immaginerebbe	Third person Singular
regneranno	Third person Plural
confederavi	Second person Singular
intiepidito	None
palpitarono	Third person Plural
forviasse	Third person Singular
possedendo	None
posano	Third person Plural
tamponare	None
ottemperato	None
raccolse	Third person Singular
riattraversarono	Third person Plural
deriveranno	Third person Plural
placcato	None
risolvesse	Third person Singular
aggricciassero	Third person Plural
ingarbugliato	None
dormirci	None
danzò	Third person Singular
reintrodussero	Third person Plural
predispongono	Third person Plural
svegliare	None
favoreggiava	Third person Singular
ardeva	Third person Singular
ricusavano	Third person Plural
stancante	None
riscattasse	Third person Singular
fortificavano	Third person Plural
rispondo	First person Singular
corse	Third person Singular
votavano	Third person Plural
rivedrò	First person Singular
smontavano	Third person Plural
associante	None
evocato	None
stringendosi	None
dividersi	None
riattraversò	Third person Singular
declamato	None
allinearsi	None
cristallizzare	None
unirei	First person Singular
sospettando	None
meritassero	Third person Plural
incidono	Third person Plural
azzarderebbe	Third person Singular
straberrebbe	Third person Singular
emigrammo	First person Plural
commerciarono	Third person Plural
arginava	Third person Singular
ringraziano	Third person Plural
trasportarono	Third person Plural
scoppiando	None
direste	Second person Plural
rovistava	Third person Singular
rimodellò	Third person Singular
accapottato	None
ricercasse	Third person Singular
consegnò	Third person Singular
addestrare	None
arricciare	None
difeso	None
significava	Third person Singular
sdentato	None
superò	Third person Singular
rinfrescato	None
divorzierà	Third person Singular
quantificasse	Third person Singular
sputtanare	None
gorgoglio	First person Singular
categorizzano	Third person Plural
confidato	None
scompaginati	Second person Singular
bottinerai	Second person Singular
colpevolizzare	None
guardò	Third person Singular
ferrai	First person Singular
disgustati	Second person Singular
assonnato	None
vagillo	First person Singular
immolando	None
rifluito	None
rizzerebbe	Third person Singular
erogò	Third person Singular
preannunciavate	Second person Plural
accentrarono	Third person Plural
composto	First person Singular
rappresenterebbero	Third person Plural
sopprimevano	Third person Plural
sfumeranno	Third person Plural
scavò	Third person Singular
alleggerito	None
reduce	Third person Singular
merlerai	Second person Singular
slogò	Third person Singular
costringerà	Third person Singular
meriterebbe	Third person Singular
rubo	First person Singular
intascava	Third person Singular
incappando	None
disattivo	First person Singular
volgesse	Third person Singular
annidò	Third person Singular
abbassavo	First person Singular
cazzano	Third person Plural
reclamasse	Third person Singular
mutuato	None
ossidano	Third person Plural
appassionarono	Third person Plural
violò	Third person Singular
vendette	Third person Singular
annovererà	Third person Singular
circonfluivate	Second person Plural
visualizzo	First person Singular
mancavo	First person Singular
omologò	Third person Singular
incidessero	Third person Plural
disconoscerebbe	Third person Singular
fermare	None
armarsi	None
arrapinerei	First person Singular
rassicuravamo	First person Plural
dimerizzeranno	Third person Plural
appigionasse	Third person Singular
sovrintendevano	Third person Plural
accedono	Third person Plural
toccava	Third person Singular
permetto	First person Singular
badò	Third person Singular
corteggiante	None
dedicassero	Third person Plural
reinciderà	Third person Singular
scrollerei	First person Singular
nascevano	Third person Plural
depravato	None
mitragliare	None
inaugurano	Third person Plural
menzioneranno	Third person Plural
svezzare	None
svernare	None
recludere	None
allergizzante	None
sposterebbe	Third person Singular
schedato	None
cioncare	None
alluderebbe	Third person Singular
vergo	First person Singular
conosciamoci	First person Plural
rivaleggiò	Third person Singular
attende	Third person Singular
rientrasse	Third person Singular
riprodusse	Third person Singular
convinceva	Third person Singular
ingioiellato	None
acchito	First person Singular
oscillo	First person Singular
ritrovavo	First person Singular
sgominano	Third person Plural
balzarono	Third person Plural
aggravava	Third person Singular
sprigionano	Third person Plural
avvizzivi	Second person Singular
storto	First person Singular
navero	First person Singular
gommato	None
rifiutandosi	None
tratteggiasse	Third person Singular
posò	Third person Singular
spalando	None
assicuravano	Third person Plural
materializzerà	Third person Singular
orlo	First person Singular
setto	First person Singular
verniciato	None
illuminava	Third person Singular
nascerà	Third person Singular
basasse	Third person Singular
sfrondando	None
stracciantesi	None
manterrebbe	Third person Singular
sterminano	Third person Plural
soggiacente	None
curava	Third person Singular
allocavate	Second person Plural
comportarono	Third person Plural
assediava	Third person Singular
concertante	None
impastano	Third person Plural
ometterebbero	Third person Plural
risparmiassero	Third person Plural
vinceremo	First person Plural
idealizzato	None
spargesse	Third person Singular
piroettato	None
cotonavano	Third person Plural
sprigionava	Third person Singular
dirottando	None
ruberò	First person Singular
interlineavamo	First person Plural
svegliando	None
frugherebbero	Third person Plural
mandrinavamo	First person Plural
conferirebbe	Third person Singular
bevve	Third person Singular
avvinghiò	Third person Singular
tuonava	Third person Singular
cautelarsi	None
rapinano	Third person Plural
duce	Third person Singular
bisognasse	Third person Singular
mancava	Third person Singular
taravo	First person Singular
inginocchiato	None
azoteremo	First person Plural
abbondo	First person Singular
invocarono	Third person Plural
doto	First person Singular
proliferava	Third person Singular
preparatevi	Second person Plural
presapiente	None
impomatantesi	None
saprà	Third person Singular
conciliati	Second person Singular
trascurò	Third person Singular
proseguì	Third person Singular
moriamocene	First person Plural
persuasi	First person Singular
insedierà	Third person Singular
ersi	First person Singular
agghiaieremmo	First person Plural
parteggiavano	Third person Plural
inondavano	Third person Plural
intrigo	First person Singular
millantano	Third person Plural
stipularono	Third person Plural
affacciasse	Third person Singular
pachereste	Second person Plural
morire	None
risospingere	None
rimarco	First person Singular
inattivo	First person Singular
riabbracciarsi	None
chiaritevi	Second person Plural
impiegherebbero	Third person Plural
affidava	Third person Singular
curo	First person Singular
tarlo	First person Singular
tranquillizzarsi	None
ripensati	Second person Singular
partiranno	Third person Plural
istituisce	Third person Singular
consistettero	Third person Plural
coniavano	Third person Plural
inserirò	First person Singular
fruttato	None
restrinsero	Third person Plural
compenetrarsi	None
erompono	Third person Plural
scalzano	Third person Plural
chiarirsi	None
sabbiato	None
ulolante	None
convive	Third person Singular
ragionerei	First person Singular
rispondessero	Third person Plural
dissuade	Third person Singular
amiate	Second person Plural
contribuì	Third person Singular
nobilitantesi	None
evidenziati	Second person Singular
usante	None
sviterai	Second person Singular
scarrocciavamo	First person Plural
accostavano	Third person Plural
suggellarono	Third person Plural
conservasse	Third person Singular
muovono	Third person Plural
cadrà	Third person Singular
coppello	First person Singular
stramazzo	First person Singular
ricombinare	None
destinarsi	None
ibernano	Third person Plural
incominciarono	Third person Plural
sciare	None
progetteranno	Third person Plural
esprimiti	Second person Singular
affiderei	First person Singular
caldeggiare	None
ricetrasmettente	None
firmassero	Third person Plural
ossessionò	Third person Singular
svelarono	Third person Plural
dopato	None
distaccherai	Second person Singular
scordiamoci	First person Plural
concimato	None
foraggiando	None
potuto	None
ramazzare	None
sparpaglierò	First person Singular
staccarono	Third person Plural
allampanavo	First person Singular
idratati	Second person Singular
ricompattantesi	None
aggrinzissimo	First person Plural
saldato	None
sclerotizzato	None
incorse	Third person Singular
sbarellato	None
impalmare	None
lamentano	Third person Plural
ghermivi	Second person Singular
inquietante	None
sospirare	None
maschiato	None
coricò	Third person Singular
allargare	None
lotto	First person Singular
spronare	None
addentrò	Third person Singular
indossano	Third person Plural
scherzavano	Third person Plural
placcare	None
incendiava	Third person Singular
prevedendo	None
presume	Third person Singular
disambiguato	None
intirizzii	First person Singular
rifa	Second person Singular
tesserò	Third person Singular
rispuntato	None
spronano	Third person Plural
disacidificando	None
distogliate	Second person Plural
sprimaccerebbe	Third person Singular
barravate	Second person Plural
individuati	Second person Singular
incorrevano	Third person Plural
mascherò	Third person Singular
dilettasse	Third person Singular
macererete	Second person Plural
travolgente	None
reclamerà	Third person Singular
riclassificavamo	First person Plural
nudricare	None
induceva	Third person Singular
puntavano	Third person Plural
rigirati	Second person Singular
caduco	First person Singular
datò	Third person Singular
insordirete	Second person Plural
rischierei	First person Singular
svolgerà	Third person Singular
avventurava	Third person Singular
rastrellarono	Third person Plural
ingraticcerebbe	Third person Singular
perorassimo	First person Plural
preferirebbe	Third person Singular
monopolizzano	Third person Plural
impomatati	Second person Singular
imponessero	Third person Plural
tasteggiasti	Second person Singular
spiegandosi	None
sforno	First person Singular
agghindati	Second person Singular
consistono	Third person Plural
equiparò	Third person Singular
sfilarsi	None
passassero	Third person Plural
decriptare	None
collegherebbe	Third person Singular
interferiranno	Third person Plural
curati	Second person Singular
indorare	None
propagandavano	Third person Plural
annunciati	Second person Singular
rispecchiarono	Third person Plural
reclamante	None
discalzando	None
devano	Third person Plural
riscatterà	Third person Singular
inclinavate	Second person Plural
idratato	None
avventò	Third person Singular
ricombinante	None
dissentivano	Third person Plural
avvicinato	None
discenderebbero	Third person Plural
imbussolante	None
storpiati	Second person Singular
sapessimo	First person Plural
commerciava	Third person Singular
cigolavo	First person Singular
pretermetteresti	Second person Singular
ricapitalizzeremmo	First person Plural
denigreranno	Third person Plural
dimoravano	Third person Plural
fluidificante	None
ricopiante	None
accincignante	None
deludo	First person Singular
spiegazzarsi	None
autorizziate	Second person Plural
instradare	None
stigmatizzò	Third person Singular
perdurante	None
mutilò	Third person Singular
impegnavano	Third person Plural
meridionalizzando	None
sviluppantesi	None
calarsi	None
giostrando	None
arruolarono	Third person Plural
celando	None
dobbiate	Second person Plural
immisero	Third person Plural
temprano	Third person Plural
giustificavamo	First person Plural
condizioneranno	Third person Plural
contesi	First person Singular
sproloquio	First person Singular
caratterizzarono	Third person Plural
enfatizzare	None
zoccolo	First person Singular
sopraffanno	Third person Plural
spacciano	Third person Plural
reperisce	Third person Singular
abbelliva	Third person Singular
intessereste	Second person Plural
appratisco	First person Singular
saliva	Third person Singular
svelando	None
aerosilurante	None
subordinano	Third person Plural
usavi	Second person Singular
fregherà	Third person Singular
annullassimo	First person Plural
incitarono	Third person Plural
raggranchissimo	First person Plural
finanziarono	Third person Plural
carbonizzando	None
rotolato	None
construirete	Second person Plural
impietosivamo	First person Plural
ruttato	None
scrocchio	First person Singular
conservava	Third person Singular
quantizzare	None
vegliò	Third person Singular
azionerà	Third person Singular
spidocchierà	Third person Singular
rimorchiando	None
spuntano	Third person Plural
totalizzavano	Third person Plural
piratare	None
trasmettono	Third person Plural
approfondirò	First person Singular
afferirei	First person Singular
distorciamoci	First person Plural
rispecchiavano	Third person Plural
confermava	Third person Singular
slinguerete	Second person Plural
vestisse	Third person Singular
alleavano	Third person Plural
rivelandosi	None
stagliato	None
guadagneresti	Second person Singular
reinterpretato	None
superasse	Third person Singular
sborsasse	Third person Singular
spollonare	None
ingrossando	None
dice	Third person Singular
saggiarono	Third person Plural
passai	First person Singular
condividere	None
impipato	None
perverrà	Third person Singular
cadrai	Second person Singular
scurissimo	First person Plural
tradirono	Third person Plural
travierebbero	Third person Plural
ricadrà	Third person Singular
sbilanciò	Third person Singular
somministrano	Third person Plural
mobilitò	Third person Singular
avvicineranno	Third person Plural
informassero	Third person Plural
intimava	Third person Singular
assalì	Third person Singular
riversavano	Third person Plural
preordinavano	Third person Plural
imbastendo	None
gallicizzasse	Third person Singular
redime	Third person Singular
apparissero	Third person Plural
funzionante	None
infortunantesi	None
trucidato	None
imbiaccarono	Third person Plural
ritornassero	Third person Plural
decespugliavano	Third person Plural
reincontrava	Third person Singular
deludevo	First person Singular
digitalizzando	None
benmeriteremo	First person Plural
insilando	None
rispettassero	Third person Plural
marchiato	None
appigionare	None
fossilizzando	None
accentrano	Third person Plural
assiderarsi	None
aggiunterà	Third person Singular
intrappolerà	Third person Singular
architettare	None
dispensare	None
secerne	Third person Singular
dializzato	None
affrancarono	Third person Plural
differiva	Third person Singular
sincerarsi	None
cavalcato	None
confondessero	Third person Plural
sbarazzò	Third person Singular
neutralizzerebbero	Third person Plural
scandirò	First person Singular
accomodato	None
carpire	None
succhielleremmo	First person Plural
levasse	Third person Singular
subappaltato	None
tanfavate	Second person Plural
evolversi	None
risolverò	First person Singular
sgridò	Third person Singular
manterranno	Third person Plural
offrirsi	None
ammonticellerete	Second person Plural
risolando	None
cimentavano	Third person Plural
bombiate	Second person Plural
cavalcava	Third person Singular
calmo	First person Singular
arrochiresti	Second person Singular
sbollentando	None
opponessero	Third person Plural
indizio	First person Singular
gemmato	None
illusi	First person Singular
risparmiano	Third person Plural
rimaneggiando	None
stagliati	Second person Singular
concelebrato	None
indottrinereste	Second person Plural
preconfezionante	None
sbilanciano	Third person Plural
riquadrano	Third person Plural
esporrà	Third person Singular
rafforzarono	Third person Plural
decolonizzare	None
confidò	Third person Singular
facendosene	None
organicato	None
acquartierò	Third person Singular
attanagliò	Third person Singular
obbedirà	Third person Singular
ripresentasse	Third person Singular
adoperò	Third person Singular
sterilizzato	None
attinsero	Third person Plural
buttiamoci	First person Plural
piantati	Second person Singular
significasse	Third person Singular
ascriveremo	First person Plural
reinterpretano	Third person Plural
scorsi	First person Singular
acconcio	First person Singular
ridurrei	First person Singular
indeboliranno	Third person Plural
mistificare	None
rincrudirò	First person Singular
confettando	None
proibente	None
conspargevo	First person Singular
risplendono	Third person Plural
radunando	None
spignorano	Third person Plural
sdazieremo	First person Plural
flambare	None
raddoppiare	None
levo	First person Singular
esiliava	Third person Singular
rimisurando	None
alò	Third person Singular
incorporasse	Third person Singular
affonderebbe	Third person Singular
fratturò	Third person Singular
svuotavano	Third person Plural
sollecitano	Third person Plural
intrecciantesi	None
insultati	Second person Singular
inorridirai	Second person Singular
avvisava	Third person Singular
visitando	None
avvicendavano	Third person Plural
caricare	None
trabevve	Third person Singular
incrociasse	Third person Singular
defluisce	Third person Singular
rabbrividisce	Third person Singular
disambiguati	Second person Singular
miglioreranno	Third person Plural
echeggiò	Third person Singular
promesso	None
annidava	Third person Singular
sincerato	None
intravedo	First person Singular
demetilante	None
liquidasti	Second person Singular
inchiederemo	First person Plural
ammattonavamo	First person Plural
decontestualizzare	None
informavano	Third person Plural
aggiornati	Second person Singular
sedano	Third person Plural
svolevo	First person Singular
carderebbe	Third person Singular
ammalterei	First person Singular
esprimerà	Third person Singular
tarò	Third person Singular
chiodo	First person Singular
noteremo	First person Plural
delimitando	None
risuscitò	Third person Singular
trebbio	First person Singular
scarrocciare	None
informare	None
subdelegante	None
ordineranno	Third person Plural
so	First person Singular
appuntare	None
soggiogare	None
ondeggerò	First person Singular
autogestirsi	None
recensì	Third person Singular
acquisisce	Third person Singular
temo	First person Singular
descriveranno	Third person Plural
redimerebbero	Third person Plural
scoppiettante	None
molestavano	Third person Plural
differenziati	Second person Singular
agirà	Third person Singular
emergessero	Third person Plural
trasmisero	Third person Plural
capovolgersi	None
discutendo	None
appassionò	Third person Singular
proliferarono	Third person Plural
pranzò	Third person Singular
imbestialire	None
sparò	Third person Singular
sostituiranno	Third person Plural
consentirebbero	Third person Plural
rintanantesi	None
confondevo	First person Singular
diserterebbero	Third person Plural
astraentesi	None
intarsiato	None
graziato	None
involgeva	Third person Singular
ammoniva	Third person Singular
brevettano	Third person Plural
erompevo	First person Singular
sperimenteranno	Third person Plural
elettrolizzato	None
tramortirebbe	Third person Singular
sedevano	Third person Plural
snerverebbero	Third person Plural
contraddistingue	Third person Singular
cumulante	None
interessato	None
tabulare	None
spadroneggiò	Third person Singular
sorvolato	None
accomunano	Third person Plural
brancolando	None
ammanettante	None
farneticante	None
formerebbe	Third person Singular
interrante	None
sollecitava	Third person Singular
approfondiva	Third person Singular
accadrebbe	Third person Singular
affascinano	Third person Plural
ronfo	First person Singular
straripava	Third person Singular
assordato	None
approfondano	Third person Plural
separerà	Third person Singular
proposi	First person Singular
basso	First person Singular
accostumantesi	None
addestrarsi	None
interessarono	Third person Plural
sposeremo	First person Plural
rilassò	Third person Singular
regatare	None
serpeggiando	None
contagerà	Third person Singular
guadagnò	Third person Singular
importasse	Third person Singular
offrivano	Third person Plural
integrò	Third person Singular
rifinì	Third person Singular
schianto	First person Singular
lasciantesi	None
catapultato	None
manifesterebbe	Third person Singular
domicilio	First person Singular
valgo	First person Singular
scaricava	Third person Singular
comminano	Third person Plural
importano	Third person Plural
influisce	Third person Singular
invalidando	None
attracco	First person Singular
visitano	Third person Plural
internarono	Third person Plural
crocifissi	First person Singular
vanificherà	Third person Singular
trafiggendosi	None
esporranno	Third person Plural
banchettato	None
scalcherà	Third person Singular
deciderete	Second person Plural
invasato	None
chilometro	First person Singular
ungono	Third person Plural
omologati	Second person Singular
provide	Third person Singular
infiltrarsi	None
stratificherete	Second person Plural
scopre	Third person Singular
musicando	None
complicano	Third person Plural
aggiungesse	Third person Singular
evolvere	None
intenderebbero	Third person Plural
simbolizzano	Third person Plural
ingraziò	Third person Singular
furoreggerei	First person Singular
pertengono	Third person Plural
imbastì	Third person Singular
imbolsireste	Second person Plural
schioccando	None
esserci	None
indovinato	None
dubitasse	Third person Singular
proseguire	None
pubblicizzava	Third person Singular
succhiare	None
montassero	Third person Plural
ammutinarsi	None
coltro	First person Singular
opponesse	Third person Singular
ripasserò	First person Singular
scandalizzando	None
baciasti	Second person Singular
dovevano	Third person Plural
videochiamerei	First person Singular
calò	Third person Singular
insinuarsi	None
zigzagare	None
funzionerebbero	Third person Plural
riunire	None
dirigersi	None
positivizzerete	Second person Plural
raschiammo	First person Plural
svagare	None
imitasse	Third person Singular
sdoppierete	Second person Plural
perpetuerei	First person Singular
vangelizzeremo	First person Plural
sceglierebbe	Third person Singular
scongelerà	Third person Singular
trapelare	None
ripristinerò	First person Singular
schiavizzato	None
sbiettiate	Second person Plural
aduso	First person Singular
richiedere	None
postillasse	Third person Singular
consumante	None
gassificato	None
cullare	None
clonato	None
nascondeva	Third person Singular
costellarono	Third person Plural
capovolgeva	Third person Singular
spazzerà	Third person Singular
liquefare	None
riscossero	Third person Plural
riservati	Second person Singular
immigrarono	Third person Plural
latro	First person Singular
resistevano	Third person Plural
accanendo	None
eliminarono	Third person Plural
preparasse	Third person Singular
commissionavano	Third person Plural
votavo	First person Singular
percuote	Third person Singular
bacai	First person Singular
immerso	None
omisero	Third person Plural
smussati	Second person Singular
indovinavano	Third person Plural
comparso	None
svincolò	Third person Singular
perseverare	None
scontenterebbero	Third person Plural
riassegnare	None
biluxare	None
rincalcando	None
intensificarsi	None
coltivare	None
accentuò	Third person Singular
legati	Second person Singular
appannante	None
smetterà	Third person Singular
avvisare	None
depurandosi	None
negava	Third person Singular
ringorgassimo	First person Plural
ammassavano	Third person Plural
notificando	None
disturbo	First person Singular
impreziosiscono	Third person Plural
beatificato	None
inventati	Second person Singular
depauperavano	Third person Plural
dovendo	None
insorgono	Third person Plural
cucinavano	Third person Plural
dipenderebbero	Third person Plural
memorizzò	Third person Singular
disterai	Second person Singular
riconvertito	None
presagirono	Third person Plural
allenati	Second person Singular
ripiantato	None
potabilizzando	None
cuoce	Third person Singular
elessero	Third person Plural
risorsero	Third person Plural
rimpiccioliscono	Third person Plural
ridefiniva	Third person Singular
illeggiadrendosi	None
sospendono	Third person Plural
esaltassero	Third person Plural
patisce	Third person Singular
annobilimmo	First person Plural
vigliano	Third person Plural
estremizzassimo	First person Plural
eterizzereste	Second person Plural
satireggiato	None
vaccinato	None
addolcirsi	None
attennero	Third person Plural
ravvisano	Third person Plural
emesso	None
aviotrasporto	First person Singular
biondeggereste	Second person Plural
reputava	Third person Singular
ribatte	Third person Singular
spoliticizzerebbero	Third person Plural
congelereste	Second person Plural
derivare	None
sbriciolando	None
assoggettato	None
biasimarsi	None
abbracciante	None
ammortante	None
sbagliavano	Third person Plural
chiusi	First person Singular
emanarono	Third person Plural
trasportassero	Third person Plural
bestemmio	First person Singular
sbavantesi	None
inspirerò	First person Singular
apprezzati	Second person Singular
arcaizzante	None
accavalciasti	Second person Singular
nascono	Third person Plural
rinsanissero	Third person Plural
vivandammo	First person Plural
tallonava	Third person Singular
trasmutati	Second person Singular
centinai	First person Singular
radiodiffuse	Third person Singular
dissuadono	Third person Plural
arraffare	None
dissociavano	Third person Plural
trasbordante	None
sacralizzavate	Second person Plural
sostituirebbe	Third person Singular
smentiscono	Third person Plural
cederà	Third person Singular
spargevano	Third person Plural
triennalizzavamo	First person Plural
incarnante	None
partoriva	Third person Singular
decodificheremmo	First person Plural
invitandosi	None
spunteranno	Third person Plural
invitasse	Third person Singular
seppero	Third person Plural
modificò	Third person Singular
mediterò	First person Singular
infranceseremmo	First person Plural
scambierà	Third person Singular
sopperito	None
integrarono	Third person Plural
ripercorreva	Third person Singular
ideare	None
correlano	Third person Plural
spiegare	None
aggiunsero	Third person Plural
azzuffarsi	None
pizzicotterò	First person Singular
suonai	First person Singular
arrugginire	None
convincono	Third person Plural
assolveva	Third person Singular
ibridano	Third person Plural
tenderebbero	Third person Plural
tinse	Third person Singular
pisciavamo	First person Plural
scaldato	None
biluxavo	First person Singular
defechiate	Second person Plural
accasciassero	Third person Plural
controbattevate	Second person Plural
insisto	First person Singular
rivangato	None
arresi	First person Singular
offrirò	First person Singular
automatizzano	Third person Plural
semicingeremmo	First person Plural
sviante	None
integrano	Third person Plural
cristianizzasse	Third person Singular
accompagnassero	Third person Plural
inasprirete	Second person Plural
ritrovati	Second person Singular
maltrattarono	Third person Plural
decorsi	First person Singular
insultando	None
attorcigliavo	First person Singular
disobbligando	None
emettesse	Third person Singular
imbroccante	None
attrezzati	Second person Singular
invischiato	None
trabuccherei	First person Singular
allungarono	Third person Plural
millimetro	First person Singular
espungendo	None
schivano	Third person Plural
coincidevano	Third person Plural
scurito	None
accentuarsi	None
allontanarono	Third person Plural
desinare	None
affiliandosi	None
agitarono	Third person Plural
minavano	Third person Plural
aggiungerai	Second person Singular
rimuoverà	Third person Singular
trainano	Third person Plural
incocciati	Second person Singular
smentivano	Third person Plural
oltrepassavano	Third person Plural
teserà	Third person Singular
accertarono	Third person Plural
incrociati	Second person Singular
sparati	Second person Singular
disfarsi	None
innervosivano	Third person Plural
argomentavano	Third person Plural
suonando	None
raccoglierai	Second person Singular
fabbrico	First person Singular
partirebbe	Third person Singular
abboccavamo	First person Plural
sposarono	Third person Plural
omologante	None
ricevesse	Third person Singular
cercassero	Third person Plural
allenisse	Third person Singular
posando	None
scorificherete	Second person Plural
turbato	None
colo	First person Singular
spodestare	None
suonerebbero	Third person Plural
intrappolò	Third person Singular
rivalutato	None
disobbedirono	Third person Plural
illustro	First person Singular
scriveremo	First person Plural
sormonto	First person Singular
esecrando	None
gassificando	None
accogliessero	Third person Plural
fissassero	Third person Plural
salissero	Third person Plural
addirei	First person Singular
grondava	Third person Singular
consacrarono	Third person Plural
archivierei	First person Singular
consociasse	Third person Singular
concederanno	Third person Plural
rialzato	None
calciarono	Third person Plural
schiumerete	Second person Plural
rompevano	Third person Plural
cazzeggiando	None
disponevano	Third person Plural
pattugliando	None
primeggiava	Third person Singular
inabilitato	None
riprendo	First person Singular
cedro	First person Singular
preriscaldo	First person Singular
scoraggio	First person Singular
scippato	None
tumultuerà	Third person Singular
manipolo	First person Singular
defezionò	Third person Singular
improvvisato	None
assegnano	Third person Plural
foggiare	None
ammezzato	None
manifestassero	Third person Plural
rimpieghereste	Second person Plural
lapidare	None
dissuadere	None
puniscono	Third person Plural
arrecassero	Third person Plural
solferemo	First person Plural
aggiunge	Third person Singular
inficiava	Third person Singular
immobilizzano	Third person Plural
aleggiare	None
aspirò	Third person Singular
intirizziremmo	First person Plural
spio	First person Singular
reprimersi	None
moltiplicandosi	None
ritrovarono	Third person Plural
travolverebbero	Third person Plural
sfociano	Third person Plural
affogato	None
reinserirò	First person Singular
feltro	First person Singular
sottende	Third person Singular
riarmerò	First person Singular
ugnano	Third person Plural
ascoltarsi	None
affiorarono	Third person Plural
interrompessero	Third person Plural
smurante	None
contribuivano	Third person Plural
rifulgerò	First person Singular
odiano	Third person Plural
rivaleggiavano	Third person Plural
confondeva	Third person Singular
filetto	First person Singular
cimato	None
canalizzare	None
insorgesse	Third person Singular
sbarazzati	Second person Singular
difenderemo	First person Plural
deregolamentato	None
sciacquare	None
scattava	Third person Singular
diffidano	Third person Plural
mettessero	Third person Plural
disordineremo	First person Plural
ritrasferì	Third person Singular
arricchì	Third person Singular
occupandosi	None
accluso	None
strutturarono	Third person Plural
alludesse	Third person Singular
rinnovarsi	None
diseredare	None
favorendo	None
allontanò	Third person Singular
traevano	Third person Plural
contattano	Third person Plural
condannato	None
avverrebbe	Third person Singular
intervistante	None
profanato	None
pesarono	Third person Plural
dimostrato	None
dilatava	Third person Singular
caricati	Second person Singular
imbellettò	Third person Singular
profondendo	None
danneggerebbe	Third person Singular
trascrivere	None
modificherebbero	Third person Plural
constavano	Third person Plural
risolverà	Third person Singular
anatematizzato	None
indietreggerete	Second person Plural
deflesse	Third person Singular
acidificasse	Third person Singular
pregherebbero	Third person Plural
alluzzarono	Third person Plural
indennizzato	None
leverà	Third person Singular
scassinavo	First person Singular
delineò	Third person Singular
stallai	First person Singular
diramò	Third person Singular
ormeggiantesi	None
dissimulò	Third person Singular
tento	First person Singular
trasporterete	Second person Plural
discendendo	None
spiccarono	Third person Plural
ristagnò	Third person Singular
spostando	None
proteggeva	Third person Singular
denudano	Third person Plural
destagionalizzato	None
imbracciava	Third person Singular
citarsi	None
dissiparsi	None
andrai	Second person Singular
chicchiriato	None
imbestiare	None
approfittasse	Third person Singular
equivocheresti	Second person Singular
circostanziare	None
torchierete	Second person Plural
prostituire	None
insulto	First person Singular
rimproverarono	Third person Plural
osteggiarono	Third person Plural
occuparsi	None
ricompare	Third person Singular
faticheranno	Third person Plural
allestivano	Third person Plural
rifugiati	Second person Singular
latrato	None
dissetò	Third person Singular
pacifico	First person Singular
incoronarono	Third person Plural
seccarono	Third person Plural
emergerà	Third person Singular
rispergente	None
ricade	Third person Singular
persistette	Third person Singular
inducesse	Third person Singular
impresciuttirò	First person Singular
suffragare	None
rovineranno	Third person Plural
indignò	Third person Singular
copiò	Third person Singular
devolvono	Third person Plural
ispanizzato	None
seminavano	Third person Plural
suggerivo	First person Singular
raccomodare	None
insanguinati	Second person Singular
banchetteresti	Second person Singular
embricati	Second person Singular
scuocesse	Third person Singular
atterrisce	Third person Singular
giocavo	First person Singular
innamorati	Second person Singular
compilerà	Third person Singular
tallonato	None
esaltandosi	None
maritato	None
pappo	First person Singular
dissuadendo	None
brucano	Third person Plural
concependo	None
regnarono	Third person Plural
imperniava	Third person Singular
sbeffeggiare	None
convogliano	Third person Plural
compenetrano	Third person Plural
comminare	None
ordinarono	Third person Plural
parte	Third person Singular
accese	Third person Singular
realizzando	None
offuscarono	Third person Plural
scalfirono	Third person Plural
cercarsi	None
calasse	Third person Singular
aderisco	First person Singular
sottovalutarono	Third person Plural
pianse	Third person Singular
spaventati	Second person Singular
disinteressarono	Third person Plural
frugano	Third person Plural
termino	First person Singular
rivoltasse	Third person Singular
inventò	Third person Singular
sposavano	Third person Plural
anonimizzassero	Third person Plural
rivelassero	Third person Plural
quotare	None
premeva	Third person Singular
degradarsi	None
quagliano	Third person Plural
gravitassero	Third person Plural
tosto	First person Singular
schierano	Third person Plural
incalcinò	Third person Singular
centuplicavo	First person Singular
gustati	Second person Singular
dedicava	Third person Singular
allenerà	Third person Singular
tagliuzzerò	First person Singular
registrano	Third person Plural
avvedersi	None
profumare	None
inzaccherante	None
crederai	Second person Singular
masturbava	Third person Singular
solidificò	Third person Singular
discriminerebbero	Third person Plural
vengono	Third person Plural
partirai	Second person Singular
sommosse	Third person Singular
concentrasse	Third person Singular
merio	First person Singular
rimanere	None
resuscitano	Third person Plural
sorgerebbe	Third person Singular
istituiva	Third person Singular
rappresentava	Third person Singular
ricorrono	Third person Plural
socchiuse	Third person Singular
glossare	None
ossidati	Second person Singular
forbito	None
ammonii	First person Singular
vestì	Third person Singular
ostacoleranno	Third person Plural
arride	Third person Singular
infliggono	Third person Plural
sovraintendono	Third person Plural
spaccio	First person Singular
demoralizzati	Second person Singular
raggirare	None
imbarchiamoci	First person Plural
pregherò	First person Singular
peggiorano	Third person Plural
improvvisavano	Third person Plural
trasferii	First person Singular
scappò	Third person Singular
atterrando	None
mascherati	Second person Singular
reclamo	First person Singular
invischiare	None
meditare	None
provenzaleggiante	None
spennare	None
esplicava	Third person Singular
accecano	Third person Plural
cibasse	Third person Singular
spazieggerebbero	Third person Plural
sorprenderei	First person Singular
scontentato	None
sclerotizzare	None
chiedersi	None
formulano	Third person Plural
accavallandosi	None
scoprirebbe	Third person Singular
localizzando	None
rinnegano	Third person Plural
rimbeccare	None
confortano	Third person Plural
ciampicando	None
pressurizzato	None
tentavi	Second person Singular
corrersi	None
terminasse	Third person Singular
eccitato	None
informo	First person Singular
moderantesi	None
sfavillante	None
ostando	None
lodo	First person Singular
assillano	Third person Plural
punisce	Third person Singular
ammettono	Third person Plural
strascicato	None
arredarono	Third person Plural
ingrassò	Third person Singular
salpava	Third person Singular
sopraintendente	None
abbruttivamo	First person Plural
virgolettare	None
decelerava	Third person Singular
nauseante	None
visitarono	Third person Plural
annetteva	Third person Singular
convocò	Third person Singular
mordeva	Third person Singular
incrinano	Third person Plural
ritenni	First person Singular
incalzava	Third person Singular
stenografo	First person Singular
documentati	Second person Singular
sussistendo	None
rifermentando	None
psicanalizzasti	Second person Singular
sterilizzerei	First person Singular
polverizzò	Third person Singular
fungendo	None
incarnano	Third person Plural
rassegnato	None
riformato	None
reagisco	First person Singular
rinvestiremmo	First person Plural
abbriccava	Third person Singular
rimetterebbe	Third person Singular
convocava	Third person Singular
azionare	None
tasto	First person Singular
confutando	None
dispiace	Third person Singular
innervosì	Third person Singular
sovramodulavi	Second person Singular
dottoreggiasse	Third person Singular
lucchettare	None
disacerberebbe	Third person Singular
rimise	Third person Singular
elencarono	Third person Plural
slanciò	Third person Singular
approfondisce	Third person Singular
scambiamoci	First person Plural
riguardasse	Third person Singular
sconvolgeranno	Third person Plural
condividevano	Third person Plural
capotterà	Third person Singular
rilasceranno	Third person Plural
giungeva	Third person Singular
voluminizzare	None
abbonati	Second person Singular
pacantesi	None
morii	First person Singular
agghindarsi	None
esternato	None
vorreste	Second person Plural
coagulò	Third person Singular
lamentassero	Third person Plural
confidandosi	None
insuperbireste	Second person Plural
patrocinarono	Third person Plural
anelare	None
radioguidare	None
offrirà	Third person Singular
guadagnare	None
sembrerò	First person Singular
bilanciava	Third person Singular
risoffiasse	Third person Singular
riferirono	Third person Plural
ritagliano	Third person Plural
contestarono	Third person Plural
promossero	Third person Plural
gemellati	Second person Singular
attecchisco	First person Singular
filosofeggiando	None
adibì	Third person Singular
sgangherati	Second person Singular
condivi	Second person Singular
specchiavi	Second person Singular
sinizzando	None
vanto	First person Singular
socchiudente	None
sterrato	None
sfitto	First person Singular
occorrere	None
beneficiarono	Third person Plural
attristerete	Second person Plural
assedio	First person Singular
devierà	Third person Singular
deducono	Third person Plural
cinsero	Third person Plural
remava	Third person Singular
sellare	None
lardello	First person Singular
continuava	Third person Singular
declamavano	Third person Plural
tornava	Third person Singular
indirizzarsi	None
stipulano	Third person Plural
circoncidere	None
irrigavano	Third person Plural
energizzante	None
incamiciato	None
precompresse	Third person Singular
adoperarono	Third person Plural
opprimevano	Third person Plural
rielaboravano	Third person Plural
soffriggente	None
osservare	None
ravvoltoleremo	First person Plural
sillabo	First person Singular
aderito	None
rapire	None
discingendo	None
reincarnarono	Third person Plural
saltellante	None
starnutano	Third person Plural
migliorare	None
modificasse	Third person Singular
pullulavano	Third person Plural
fregano	Third person Plural
smentiranno	Third person Plural
sprofondando	None
pertenesse	Third person Singular
mettere	None
prediligeva	Third person Singular
passava	Third person Singular
appellarsi	None
preserverà	Third person Singular
seminava	Third person Singular
calciò	Third person Singular
vinceva	Third person Singular
innamoreranno	Third person Plural
coadiuvando	None
consentivano	Third person Plural
andarono	Third person Plural
marinato	None
correrebbero	Third person Plural
acconsente	Third person Singular
radicato	None
addobberemo	First person Plural
divertiva	Third person Singular
drenai	First person Singular
affinava	Third person Singular
coacerveremmo	First person Plural
frugasti	Second person Singular
retto	None
attuati	Second person Singular
prescrivesse	Third person Singular
accampava	Third person Singular
rimanderebbe	Third person Singular
smarcante	None
puntualizzato	None
riattizzante	None
sgommando	None
consenziente	None
ripromise	Third person Singular
escluderebbe	Third person Singular
sabotato	None
circumnavigante	None
aggettivando	None
teletrasportarono	Third person Plural
rialzerà	Third person Singular
avvicinava	Third person Singular
scolorarsi	None
stipo	First person Singular
cozzavano	Third person Plural
disarcionassimo	First person Plural
pigliano	Third person Plural
seppellendo	None
sbilanciava	Third person Singular
rifarò	First person Singular
tecnologizzare	None
suscitando	None
pugnano	Third person Plural
ricredere	None
creò	Third person Singular
convocassimo	First person Plural
agghiadante	None
dilungato	None
comportasse	Third person Singular
innalzantesi	None
congiunge	Third person Singular
rintronerebbe	Third person Singular
indispettire	None
officerà	Third person Singular
eviterò	First person Singular
peggiorarono	Third person Plural
economizzato	None
proibirono	Third person Plural
italianizzò	Third person Singular
tenterà	Third person Singular
scoraggerà	Third person Singular
avvicino	First person Singular
accoglieresti	Second person Singular
marno	First person Singular
contrappesò	Third person Singular
ampio	First person Singular
sorprende	Third person Singular
addormentai	First person Singular
appianante	None
sbricioleranno	Third person Plural
accecante	None
ossidantesi	None
giudicò	Third person Singular
impegnerebbe	Third person Singular
reingaggiando	None
scriveresti	Second person Singular
rinverdendo	None
blocco	First person Singular
gravo	First person Singular
esilarante	None
delegano	Third person Plural
soggiornato	None
esploravano	Third person Plural
ostinarsi	None
fascerete	Second person Plural
dovrebbero	Third person Plural
ululo	First person Singular
annunciavi	Second person Singular
pervenne	Third person Singular
sprigionare	None
giudicherà	Third person Singular
azzererai	Second person Singular
divenni	First person Singular
restringerà	Third person Singular
quintessenziare	None
allevavano	Third person Plural
tingevano	Third person Plural
impagliato	None
plissettando	None
arrestarsi	None
mancherò	First person Singular
concitato	None
gradisco	First person Singular
duco	First person Singular
discriminerebbe	Third person Singular
saturato	None
retrarrebbe	Third person Singular
intercludiate	Second person Plural
emanerà	Third person Singular
somministrò	Third person Singular
cancellerebbe	Third person Singular
programmando	None
sconfinando	None
permeò	Third person Singular
sdottoreggerebbero	Third person Plural
rifriggendo	None
racchiuse	Third person Singular
preservava	Third person Singular
incanalò	Third person Singular
strangolati	Second person Singular
diventassero	Third person Plural
risiederanno	Third person Plural
affondò	Third person Singular
rincappavamo	First person Plural
millantato	None
smagrire	None
aborrisse	Third person Singular
adempiendo	None
rischierà	Third person Singular
fervevano	Third person Plural
somigliasse	Third person Singular
esultante	None
relegheremmo	First person Plural
disfece	Third person Singular
formasse	Third person Singular
prefigge	Third person Singular
comprendiate	Second person Plural
allude	Third person Singular
tendesse	Third person Singular
stimolo	First person Singular
azzurro	First person Singular
insistito	None
riprovano	Third person Plural
sconvenni	First person Singular
pedinò	Third person Singular
bugno	First person Singular
nasceva	Third person Singular
abbracciasti	Second person Singular
progredirà	Third person Singular
aulisce	Third person Singular
occupavo	First person Singular
convocante	None
sopravverresti	Second person Singular
infestare	None
ritrattarono	Third person Plural
esercitasse	Third person Singular
rovesciò	Third person Singular
ripresero	Third person Plural
approfondirono	Third person Plural
schizzano	Third person Plural
prescrivono	Third person Plural
succede	Third person Singular
rincontrarono	Third person Plural
graduato	None
rifinisce	Third person Singular
abbinano	Third person Plural
erpico	First person Singular
specializzavano	Third person Plural
ritardante	None
acquisirono	Third person Plural
solidificarsi	None
apparente	None
incasserà	Third person Singular
impromettente	None
rintracciare	None
risuonare	None
condizionando	None
garantendo	None
assise	Third person Singular
traboccava	Third person Singular
bottinerete	Second person Plural
gridarono	Third person Plural
decideva	Third person Singular
sgarbugliavate	Second person Plural
mettono	Third person Plural
addentro	First person Singular
paresse	Third person Singular
spererei	First person Singular
ripristinavano	Third person Plural
sorprendono	Third person Plural
diffameremo	First person Plural
tendo	First person Singular
tesserato	None
disintegrò	Third person Singular
mortificati	Second person Singular
annebbiandosi	None
mandante	None
attenderei	First person Singular
profumeremmo	First person Plural
tramutò	Third person Singular
rimbalzavamo	First person Plural
sfogano	Third person Plural
carburare	None
raddoppiante	None
zampano	Third person Plural
divinizzante	None
pubblicherò	First person Singular
coibentassero	Third person Plural
setacciare	None
intralciavano	Third person Plural
ripopolantesi	None
indorerebbero	Third person Plural
manterrei	First person Singular
sequenziare	None
friggono	Third person Plural
transcende	Third person Singular
mescolerà	Third person Singular
schiacciò	Third person Singular
spetterebbe	Third person Singular
sbando	First person Singular
tagliai	First person Singular
pendevano	Third person Plural
giocarono	Third person Plural
attiene	Third person Singular
schiarire	None
adonestare	None
installarono	Third person Plural
imboscati	Second person Singular
stentando	None
postano	Third person Plural
gradinai	First person Singular
animo	First person Singular
interlineassimo	First person Plural
emergevi	Second person Singular
rimodellerei	First person Singular
sfibreremmo	First person Plural
ometteva	Third person Singular
sommo	First person Singular
capovolsi	First person Singular
conficcare	None
rifuggiva	Third person Singular
potato	None
impattò	Third person Singular
affascinarono	Third person Plural
imbecchiate	Second person Plural
rispedisco	First person Singular
illudevano	Third person Plural
rispecchiò	Third person Singular
bendato	None
annunciamoci	First person Plural
migliorano	Third person Plural
deponente	None
schiudono	Third person Plural
elevare	None
individuare	None
daterebbero	Third person Plural
supplicano	Third person Plural
odorassero	Third person Plural
nascondevano	Third person Plural
sgominò	Third person Singular
esaltano	Third person Plural
trionfò	Third person Singular
ravanare	None
sentito	None
resistono	Third person Plural
sfrenati	Second person Singular
esasperante	None
zeppo	First person Singular
soverchiante	None
reinserisco	First person Singular
rappacificato	None
distorce	Third person Singular
bersaglio	First person Singular
imbizzarrito	None
voltandosi	None
ristampando	None
comparato	None
accondiscese	Third person Singular
rigurgito	First person Singular
insinuo	First person Singular
specificasse	Third person Singular
investente	None
spanciare	None
disidentificano	Third person Plural
astiene	Third person Singular
ingelosisce	Third person Singular
levavi	Second person Singular
avvantaggiando	None
allevano	Third person Plural
cooptare	None
scollato	None
leccare	None
divampano	Third person Plural
premiai	First person Singular
caricaturato	None
lancerò	First person Singular
custodiva	Third person Singular
segnalare	None
conterranno	Third person Plural
infuocheremo	First person Plural
ripetendosi	None
intersecano	Third person Plural
rivoltarono	Third person Plural
rotolava	Third person Singular
insidiando	None
cambierai	Second person Singular
traessero	Third person Plural
affaccendati	Second person Singular
disgregarsi	None
rivivificare	None
destreggiò	Third person Singular
incurvarsi	None
alleggerì	Third person Singular
disaccoppiante	None
schiaffammo	First person Plural
commemorante	None
scioccante	None
proclamano	Third person Plural
sfangavi	Second person Singular
contattati	Second person Singular
stravolgeranno	Third person Plural
incruschiate	Second person Plural
digitasse	Third person Singular
sprecherai	Second person Singular
immaginano	Third person Plural
delimitava	Third person Singular
comprare	None
emigrare	None
arraffavamo	First person Plural
formo	First person Singular
questionando	None
avvolgevano	Third person Plural
annitriate	Second person Plural
lanciavano	Third person Plural
rimbombano	Third person Plural
fronteggiava	Third person Singular
svolazzano	Third person Plural
traversando	None
fonassimo	First person Plural
dannati	Second person Singular
dissuggelleremmo	First person Plural
effigiò	Third person Singular
stano	First person Singular
specifico	First person Singular
intristire	None
premerebbe	Third person Singular
accumulandosi	None
disconcludesti	Second person Singular
perderesti	Second person Singular
poltrito	None
raffigurerebbero	Third person Plural
scelsi	First person Singular
ruotavano	Third person Plural
secolarizzai	First person Singular
sovescio	First person Singular
ripiegarono	Third person Plural
sospettarono	Third person Plural
performante	None
elargivano	Third person Plural
clivare	None
appongono	Third person Plural
lasciamoci	First person Plural
teniamoci	First person Plural
poppano	Third person Plural
daranno	Third person Plural
razzolare	None
capovolto	None
insaponato	None
conficcano	Third person Plural
legittimò	Third person Singular
impartire	None
devolvere	None
mieterà	Third person Singular
riferivano	Third person Plural
riproponevano	Third person Plural
mantenuto	None
attilleremo	First person Plural
attivarsi	None
strofinato	None
rinsaldò	Third person Singular
affievolirono	Third person Plural
circostanziai	First person Singular
costituente	None
approfittarono	Third person Plural
morirà	Third person Singular
esternerà	Third person Singular
insabbiando	None
arrunciglierò	First person Singular
fotografando	None
interpolano	Third person Plural
criticheranno	Third person Plural
partì	Third person Singular
acuire	None
ninfeggerà	Third person Singular
incrociano	Third person Plural
stonare	None
presunse	Third person Singular
tempestò	Third person Singular
vorrei	First person Singular
intinse	Third person Singular
catturano	Third person Plural
scontarono	Third person Plural
credevano	Third person Plural
imprimerà	Third person Singular
mordo	First person Singular
ottimizzato	None
attenuto	None
riscalato	None
scompagnammo	First person Plural
surriscaldando	None
arrotondò	Third person Singular
bindolavo	First person Singular
occasionato	None
lignificandosi	None
biasmai	First person Singular
tratteggiava	Third person Singular
reincontrare	None
ombreggiante	None
caricano	Third person Plural
ofiziato	None
analizzavano	Third person Plural
sferravano	Third person Plural
azionante	None
tramassimo	First person Plural
sposterò	First person Singular
tralasciai	First person Singular
annaserebbe	Third person Singular
racchiudessimo	First person Plural
facevo	First person Singular
contraesse	Third person Singular
fusero	Third person Plural
avvalorare	None
impressionava	Third person Singular
sorprendente	None
avocherò	First person Singular
spiazzato	None
prevalesse	Third person Singular
acetificavi	Second person Singular
assoggettarsi	None
motivo	First person Singular
congratularsi	None
espianto	First person Singular
occorresse	Third person Singular
fiaccato	None
lottare	None
risanò	Third person Singular
palpito	First person Singular
espansero	Third person Plural
sbriciolarsi	None
rafforzando	None
descriversi	None
choccato	None
flette	Third person Singular
rammodernando	None
trasudato	None
appiedo	First person Singular
proiettava	Third person Singular
impostava	Third person Singular
cedente	None
rincarai	First person Singular
scoppiava	Third person Singular
sconcio	First person Singular
eguagliare	None
riducendo	None
incolpati	Second person Singular
sfumare	None
brigare	None
sopraggiungere	None
assolverà	Third person Singular
formattereste	Second person Plural
rifulse	Third person Singular
sbafo	First person Singular
soggiornare	None
dimorato	None
riavventandosi	None
abbottonò	Third person Singular
consociasti	Second person Singular
raffredderà	Third person Singular
idoleggiano	Third person Plural
perderemmo	First person Plural
implicante	None
deducendo	None
sbugiardare	None
risi	First person Singular
cimentati	Second person Singular
vitalizio	First person Singular
impinzavate	Second person Plural
accecò	Third person Singular
centineremmo	First person Plural
straorzare	None
parso	None
arredo	First person Singular
suggerirebbero	Third person Plural
riponevano	Third person Plural
sbiellavano	Third person Plural
rischierebbero	Third person Plural
ricorderebbero	Third person Plural
benmeritavamo	First person Plural
acciacco	First person Singular
ornato	None
mescolava	Third person Singular
divorerà	Third person Singular
sbilanciamoci	First person Plural
suggerì	Third person Singular
ricolorati	Second person Singular
rigare	None
stravedeva	Third person Singular
eccellono	Third person Plural
demergere	None
intrattenuto	None
riaggiustarsi	None
generalizzo	First person Singular
ostruisce	Third person Singular
allenando	None
lavoro	First person Singular
attuerebbe	Third person Singular
sbancarono	Third person Plural
punendo	None
balenante	None
insorgendo	None
provando	None
ricercò	Third person Singular
estraniò	Third person Singular
scontrasse	Third person Singular
aggiustò	Third person Singular
distolgono	Third person Plural
sigillò	Third person Singular
riassorbono	Third person Plural
rivendicassero	Third person Plural
stimolano	Third person Plural
contuse	Third person Singular
sbicchiereremmo	First person Plural
chiamato	None
arruolò	Third person Singular
arrampicare	None
copulavano	Third person Plural
spiegò	Third person Singular
avviterei	First person Singular
riesaminò	Third person Singular
modificano	Third person Plural
riparlare	None
affrescare	None
odo	First person Singular
sorpasso	First person Singular
aggiudicavano	Third person Plural
arringare	None
riaggregati	Second person Singular
lotterà	Third person Singular
supportante	None
padreggiante	None
soggiornerà	Third person Singular
modificandosi	None
intentarono	Third person Plural
digradando	None
ricomparve	Third person Singular
graffiano	Third person Plural
estraeva	Third person Singular
instituisce	Third person Singular
vagheggiasse	Third person Singular
ricattò	Third person Singular
incolpato	None
rischiava	Third person Singular
sospesero	Third person Plural
intinge	Third person Singular
moriranno	Third person Plural
dovrò	First person Singular
sgomberato	None
convertendosi	None
sbaciucchiavate	Second person Plural
intrecciano	Third person Plural
scampanellereste	Second person Plural
previdi	First person Singular
intendevi	Second person Singular
riproducesse	Third person Singular
rivestì	Third person Singular
parcheggiante	None
progrediscono	Third person Plural
consumiate	Second person Plural
instaureranno	Third person Plural
puntualizzano	Third person Plural
tono	First person Singular
rivestiranno	Third person Plural
graziò	Third person Singular
orripilo	First person Singular
esulò	Third person Singular
collaboro	First person Singular
steccato	None
cospargo	First person Singular
coordinato	None
sbozzimeremmo	First person Plural
detiene	Third person Singular
colpirà	Third person Singular
indebolirsi	None
curiosare	None
ubbidito	None
culminando	None
manderebbe	Third person Singular
convergo	First person Singular
rincretinente	None
determinati	Second person Singular
altalenare	None
pensasse	Third person Singular
indicheranno	Third person Plural
bersagliarono	Third person Plural
sborsare	None
manifesteranno	Third person Plural
risarcendo	None
preaccennarono	Third person Plural
raspante	None
pertiene	Third person Singular
espresse	Third person Singular
cario	First person Singular
solidificandosi	None
olivo	First person Singular
scialò	Third person Singular
fregatene	Second person Singular
sgrassare	None
stravince	Third person Singular
tossire	None
suggellò	Third person Singular
olografo	First person Singular
ripotessimo	First person Plural
drammatizzato	None
compattarono	Third person Plural
volgere	None
pieghetterebbe	Third person Singular
compenetrati	Second person Singular
paganeggeranno	Third person Plural
allacciano	Third person Plural
temerò	First person Singular
scarseggiavano	Third person Plural
inserirai	Second person Singular
perfezionando	None
fallarsi	None
festeggio	First person Singular
marchiano	Third person Plural
riavviserai	Second person Singular
sfrattereste	Second person Plural
sfregiare	None
intingere	None
riconfigurò	Third person Singular
alimenterebbe	Third person Singular
incitando	None
borbottare	None
decostruire	None
esaltando	None
esultava	Third person Singular
restituirebbe	Third person Singular
fustellavate	Second person Plural
rispediscono	Third person Plural
vietato	None
dilagando	None
cuocendo	None
persistevano	Third person Plural
venni	First person Singular
celebreranno	Third person Plural
erogasse	Third person Singular
orchestrarono	Third person Plural
affrettarono	Third person Plural
salisse	Third person Singular
tacchettiate	Second person Plural
darebbero	Third person Plural
streghiate	Second person Plural
lamentiamoci	First person Plural
immergerà	Third person Singular
risultante	None
saziato	None
gatteggiare	None
pubblicheremo	First person Plural
avvelenare	None
cumulava	Third person Singular
vomitano	Third person Plural
conferisce	Third person Singular
fascereste	Second person Plural
prefigurato	None
pitturato	None
accoppierà	Third person Singular
perpetuare	None
dissipante	None
tramutavano	Third person Plural
alleo	First person Singular
premendo	None
allarmati	Second person Singular
attutito	None
musante	None
reincontrarono	Third person Plural
nullificare	None
aureolo	First person Singular
straniante	None
irrigheremo	First person Plural
appuntandosi	None
graffiò	Third person Singular
sollevava	Third person Singular
gaso	First person Singular
saccheggiavano	Third person Plural
unì	Third person Singular
pensati	Second person Singular
estrarrà	Third person Singular
sconvolgente	None
tentò	Third person Singular
sbancato	None
rintanato	None
sviene	Third person Singular
plasmando	None
risentisse	Third person Singular
ricostruire	None
erotizzeremmo	First person Plural
assomigliava	Third person Singular
concepisse	Third person Singular
scervellarsi	None
perlustrato	None
confortante	None
rise	Third person Singular
ripensano	Third person Plural
condividono	Third person Plural
allocante	None
influì	Third person Singular
coordinarsi	None
ibrido	First person Singular
wappo	First person Singular
stropicciantesene	None
cancelleresti	Second person Singular
seccato	None
addestravano	Third person Plural
ripagava	Third person Singular
bizantineggiante	None
ardere	None
alando	None
titubarono	Third person Plural
sprovincializzare	None
ammattonando	None
arrendesse	Third person Singular
annoterà	Third person Singular
serve	Third person Singular
espandendo	None
riscoprono	Third person Plural
profaniate	Second person Plural
sgamberemmo	First person Plural
sopraffare	None
concentrare	None
intrise	Third person Singular
rimase	Third person Singular
esordito	None
spianantesi	None
rammodernavamo	First person Plural
precludendosi	None
rimenando	None
morirei	First person Singular
alfabeto	First person Singular
assisterà	Third person Singular
discorrono	Third person Plural
ibridare	None
addusse	Third person Singular
spezzettare	None
soprassedere	None
offre	Third person Singular
totalizzava	Third person Singular
stuprava	Third person Singular
appallottolato	None
speso	First person Singular
incominciano	Third person Plural
rilassandosi	None
crucifiggemmo	First person Plural
stomacandosi	None
riscontrerà	Third person Singular
rimproverare	None
accudiva	Third person Singular
deattivando	None
sorvolava	Third person Singular
arrostito	None
permetterò	First person Singular
ricompongo	First person Singular
adattavano	Third person Plural
concretò	Third person Singular
copiarsi	None
valicano	Third person Plural
vide	Third person Singular
collocato	None
provedevate	Second person Plural
bloccano	Third person Plural
calamitando	None
articolò	Third person Singular
depauperati	Second person Singular
esercisco	First person Singular
arriccio	First person Singular
appropriati	Second person Singular
eleverei	First person Singular
rispolverare	None
otterrai	Second person Singular
ricapitalizzeresti	Second person Singular
morivano	Third person Plural
decontestualizzeranno	Third person Plural
arcaizzavo	First person Singular
innastai	First person Singular
scadette	Third person Singular
spopolarsi	None
spifferare	None
renderò	First person Singular
prolungano	Third person Plural
stratificati	Second person Singular
ristrutturavano	Third person Plural
impigliarsi	None
perplimo	First person Singular
realizzai	First person Singular
salirebbe	Third person Singular
fortificava	Third person Singular
formattano	Third person Plural
addrizzante	None
prenoto	First person Singular
schettino	First person Singular
sminuiva	Third person Singular
cazzeggio	First person Singular
contaminava	Third person Singular
coniugati	Second person Singular
sgretolati	Second person Singular
traspirante	None
verrai	Second person Singular
ammutinarono	Third person Plural
rigettati	Second person Singular
organizzarono	Third person Plural
numerava	Third person Singular
affiliano	Third person Plural
prosterno	First person Singular
attutisce	Third person Singular
nascerebbero	Third person Plural
detestavano	Third person Plural
stampato	None
memorante	None
lievitante	None
candeggiai	First person Singular
scommettevano	Third person Plural
potendosi	None
merito	First person Singular
ulcerandosi	None
raggiungevano	Third person Plural
rivaleggiando	None
frustano	Third person Plural
salai	First person Singular
adeguato	None
smetterei	First person Singular
acquartierare	None
dipanerà	Third person Singular
sgomberante	None
pongono	Third person Plural
acuivano	Third person Plural
affrettò	Third person Singular
dividendo	None
arare	None
eserciteranno	Third person Plural
favoriva	Third person Singular
riprenderei	First person Singular
ricreato	None
orientavano	Third person Plural
intenerito	None
annunciante	None
vieto	First person Singular
strafogato	None
rispettò	Third person Singular
rinverrà	Third person Singular
notammo	First person Plural
commentarono	Third person Plural
insistesse	Third person Singular
incentrava	Third person Singular
vendicherà	Third person Singular
sbloccando	None
armandosi	None
volendosi	None
rifriggente	None
mergerebbe	Third person Singular
sbranano	Third person Plural
svincolati	Second person Singular
sovvenzionava	Third person Singular
lascò	Third person Singular
velocizzarsi	None
inceppato	None
sconsacrante	None
irruppero	Third person Plural
diteggerebbero	Third person Plural
tacessero	Third person Plural
becchettavate	Second person Plural
rassicuro	First person Singular
posero	Third person Plural
responsabilizzarsi	None
elettrificare	None
emanava	Third person Singular
rilevati	Second person Singular
stazzando	None
ascoltatevi	Second person Plural
aggirando	None
ferisse	Third person Singular
reperì	Third person Singular
abbonante	None
brillarono	Third person Plural
specializzano	Third person Plural
feconderete	Second person Plural
incrementavano	Third person Plural
ricategorizzare	None
produsse	Third person Singular
poppare	None
desolò	Third person Singular
variava	Third person Singular
costituirà	Third person Singular
risciogliessero	Third person Plural
pensante	None
divorzieremo	First person Plural
deflagrante	None
arrivarono	Third person Plural
ordinai	First person Singular
riassorbe	Third person Singular
partoriscono	Third person Plural
ingombravano	Third person Plural
decrescendo	None
valorizzavano	Third person Plural
misconobbe	Third person Singular
chiarire	None
interiorizzato	None
sopravvivere	None
impaginiate	Second person Plural
dipanano	Third person Plural
esclamò	Third person Singular
scuocente	None
acido	First person Singular
cazzotto	First person Singular
lascerei	First person Singular
attirerò	First person Singular
esclusi	First person Singular
sfregio	First person Singular
accompagnasse	Third person Singular
manlevammo	First person Plural
trasfigurati	Second person Singular
convergono	Third person Plural
trascorrente	None
sacramento	First person Singular
guazzo	First person Singular
imbottisce	Third person Singular
travolgono	Third person Plural
simpatizzo	First person Singular
circondando	None
squilibrare	None
usolasti	Second person Singular
comportava	Third person Singular
godono	Third person Plural
tedescheggereste	Second person Plural
dirigerò	First person Singular
reidratato	None
allargano	Third person Plural
propendo	First person Singular
percuotere	None
reintroduce	Third person Singular
spareranno	Third person Plural
gronderete	Second person Plural
infilati	Second person Singular
complimentarsi	None
godo	First person Singular
tonante	None
ingelosiva	Third person Singular
quintuplicato	None
idratano	Third person Plural
rimanderei	First person Singular
bombo	First person Singular
arzigogolavo	First person Singular
scappavano	Third person Plural
tentennò	Third person Singular
rassomigliava	Third person Singular
subisce	Third person Singular
cremante	None
sistemante	None
infingerei	First person Singular
piagare	None
affaccendato	None
travolgiate	Second person Plural
ispezionare	None
pelare	None
accaparrandosi	None
penavo	First person Singular
spaventarono	Third person Plural
serpeggiavano	Third person Plural
ritornando	None
assomato	None
riprende	Third person Singular
qualificante	None
oziando	None
legittimerebbe	Third person Singular
suffondendo	None
ristabiliva	Third person Singular
ricambiato	None
diventerò	First person Singular
rivedremo	First person Plural
abusò	Third person Singular
spadroneggiammo	First person Plural
trasportante	None
commissionerà	Third person Singular
minarono	Third person Plural
temendo	None
rinfocolò	Third person Singular
inoculo	First person Singular
semplificherete	Second person Plural
svelava	Third person Singular
organarono	Third person Plural
disinnestavi	Second person Singular
divenivano	Third person Plural
regolarizzare	None
riabilitati	Second person Singular
sobbarcarsi	None
sopraintendo	First person Singular
dileguarsi	None
ristarò	First person Singular
sprecarono	Third person Plural
immedesimato	None
appiederebbero	Third person Plural
componendosi	None
propongono	Third person Plural
misero	Third person Plural
succhio	First person Singular
richiederebbero	Third person Plural
puntellare	None
partorire	None
vagò	Third person Singular
lenirei	First person Singular
congetturassimo	First person Plural
indisposto	None
rasai	First person Singular
pernottando	None
bloccandosi	None
positivizziate	Second person Plural
strasaputo	None
duetteranno	Third person Plural
gii	First person Singular
gettano	Third person Plural
indirigessero	Third person Plural
molestare	None
inquadrarono	Third person Plural
tentano	Third person Plural
contatto	First person Singular
setacciasse	Third person Singular
azzannerò	First person Singular
bullonare	None
disseminò	Third person Singular
volete	Second person Plural
decontaminava	Third person Singular
neutralizzato	None
annunciavano	Third person Plural
scivolarono	Third person Plural
congratulerebbe	Third person Singular
reclamavano	Third person Plural
confondesse	Third person Singular
avverano	Third person Plural
travierei	First person Singular
esborsai	First person Singular
autorizzava	Third person Singular
lasciavano	Third person Plural
coronerà	Third person Singular
spodestò	Third person Singular
broglio	First person Singular
danneggiava	Third person Singular
stentacchiai	First person Singular
rannicchierai	Second person Singular
eccellendo	None
solve	Third person Singular
spappoliate	Second person Plural
schierassero	Third person Plural
rimarcheremo	First person Plural
piazzato	None
sdentante	None
ovviò	Third person Singular
rapinavano	Third person Plural
commissionarono	Third person Plural
darà	Third person Singular
immalinconente	None
aggiudicano	Third person Plural
sforato	None
trucidano	Third person Plural
battibecco	First person Singular
becchettasti	Second person Singular
sfoderato	None
abdicare	None
associando	None
pastificai	First person Singular
gravitare	None
rincuorato	None
caricavano	Third person Plural
andremmo	First person Plural
diffamò	Third person Singular
portese	Third person Singular
coprirebbero	Third person Plural
eccitare	None
lesionati	Second person Singular
amerebbe	Third person Singular
impresse	Third person Singular
stanato	None
presiedesse	Third person Singular
approdarono	Third person Plural
guidò	Third person Singular
raccorciato	None
intersecarsi	None
effingere	None
contattare	None
irrompevano	Third person Plural
deformante	None
derubando	None
dividono	Third person Plural
giovandosi	None
distribuissero	Third person Plural
apprestasse	Third person Singular
perforare	None
laudano	Third person Plural
processò	Third person Singular
mimava	Third person Singular
scalcato	None
adoprante	None
incuteva	Third person Singular
retrocessero	Third person Plural
grocco	First person Singular
ricomprendono	Third person Plural
inabissò	Third person Singular
graffirebbe	Third person Singular
intirizzendo	None
rivaccinante	None
antologizzeresti	Second person Singular
disincantato	None
presenziato	None
denunzierei	First person Singular
spigolando	None
avverto	First person Singular
scotolava	Third person Singular
rifilano	Third person Plural
ravvisò	Third person Singular
immortalò	Third person Singular
occorsi	First person Singular
istruisse	Third person Singular
corrisposto	None
operò	Third person Singular
subodorare	None
avvicinò	Third person Singular
lignificati	Second person Singular
sbiadisce	Third person Singular
parificato	None
idealizzante	None
censurarono	Third person Plural
lanciando	None
rallegrano	Third person Plural
lampeggiante	None
ripudiare	None
ansimare	None
impossibilitando	None
influiva	Third person Singular
ricoprendo	None
riscalderemmo	First person Plural
coltivato	None
sterminando	None
annuvolarono	Third person Plural
patrocinare	None
intratteneva	Third person Singular
personificato	None
smascherarsi	None
scioglievano	Third person Plural
evolveranno	Third person Plural
rinserrano	Third person Plural
defilano	Third person Plural
boicottato	None
vangano	Third person Plural
infrangevano	Third person Plural
opporsi	None
domandati	Second person Singular
riscopre	Third person Singular
revisionando	None
varierà	Third person Singular
seminano	Third person Plural
sceverante	None
fruttarono	Third person Plural
apprestare	None
esaltare	None
difenderò	First person Singular
ricaccio	First person Singular
addossarono	Third person Plural
sopperisce	Third person Singular
capponato	None
corrono	Third person Plural
arrivare	None
guadagneremmo	First person Plural
descriverei	First person Singular
arrangiati	Second person Singular
valuteranno	Third person Plural
addensano	Third person Plural
giurato	None
corrompesse	Third person Singular
sagginerebbero	Third person Plural
emulano	Third person Plural
partorissero	Third person Plural
bamboleggiarono	Third person Plural
abolire	None
ritagliati	Second person Singular
reperto	First person Singular
fioriscono	Third person Plural
deformandosi	None
imbevuto	None
diplomarono	Third person Plural
toccherò	First person Singular
vedendoci	None
propagò	Third person Singular
riducessero	Third person Plural
sterminare	None
risollevandosi	None
trapelano	Third person Plural
riporterei	First person Singular
ripiegato	None
implementano	Third person Plural
affliggono	Third person Plural
acciambello	First person Singular
ridistribuì	Third person Singular
accade	Third person Singular
adattati	Second person Singular
fluidificavamo	First person Plural
sbraitassimo	First person Plural
galoppò	Third person Singular
orbitasse	Third person Singular
esasperati	Second person Singular
sfatti	Second person Singular
inglesizzeremo	First person Plural
aiutassero	Third person Plural
infuriando	None
erotizzassero	Third person Plural
spartiranno	Third person Plural
rintocco	First person Singular
calmatevi	Second person Plural
videoregistrerai	Second person Singular
dedicasti	Second person Singular
solletico	First person Singular
statizzato	None
impasto	First person Singular
gareggiano	Third person Plural
scaldiamoci	First person Plural
ucciderei	First person Singular
riconsacrare	None
overcloccasti	Second person Singular
legalizzava	Third person Singular
eguagliava	Third person Singular
idrolizzano	Third person Plural
lacerandosi	None
allattato	None
ferveva	Third person Singular
riottenere	None
verrino	First person Singular
conterrebbero	Third person Plural
immigrato	None
sbarrano	Third person Plural
riemergono	Third person Plural
coso	First person Singular
separare	None
divertivo	First person Singular
sovrapponendosi	None
regredisce	Third person Singular
addolcirono	Third person Plural
sollevassero	Third person Plural
idrolizzante	None
dimenticatevi	Second person Plural
smeriglierete	Second person Plural
spiccicarsi	None
gelava	Third person Singular
segnavano	Third person Plural
prodursi	None
pregiato	None
infilo	First person Singular
rimandava	Third person Singular
maltrattò	Third person Singular
deprimevo	First person Singular
veniate	Second person Plural
cassato	None
arruffati	Second person Singular
cazzeggiare	None
salpano	Third person Plural
incappano	Third person Plural
guastato	None
ricapitare	None
simbolizzare	None
maritati	Second person Singular
infisse	Third person Singular
popolarizzare	None
ridiscendono	Third person Plural
impegnava	Third person Singular
scorticare	None
abbacato	None
accavallati	Second person Singular
spingeranno	Third person Plural
invogliò	Third person Singular
indietreggiando	None
riposizionati	Second person Singular
portando	None
universalizzantesi	None
guadagnava	Third person Singular
avvedentesi	None
decapitò	Third person Singular
ricrescere	None
cancellereste	Second person Plural
sbloccati	Second person Singular
accalappiare	None
immersi	First person Singular
calavano	Third person Plural
riponendo	None
splendono	Third person Plural
ergeva	Third person Singular
raffiguro	First person Singular
ridigitai	First person Singular
discendono	Third person Plural
voterò	First person Singular
regateranno	Third person Plural
affascinava	Third person Singular
disapprovando	None
irruppe	Third person Singular
continuassimo	First person Plural
ventagliato	None
conformarono	Third person Plural
aggiungerei	First person Singular
nitro	First person Singular
brigando	None
consistesse	Third person Singular
cantilenando	None
telegrafare	None
maschietto	First person Singular
stimato	None
contrapponesse	Third person Singular
decapiterà	Third person Singular
implorando	None
pernottante	None
cartonato	None
erodendo	None
riservavano	Third person Plural
intesse	Third person Singular
condizionai	First person Singular
difesero	Third person Plural
sforano	Third person Plural
muggire	None
cambierà	Third person Singular
disaccentasti	Second person Singular
costringe	Third person Singular
esaltante	None
coagulano	Third person Plural
rimescolando	None
smaterializzano	Third person Plural
plange	Third person Singular
imbarilerà	Third person Singular
sminuivano	Third person Plural
ricostruirono	Third person Plural
valcavi	Second person Singular
teme	Third person Singular
disorganizzò	Third person Singular
stabilito	None
rintonacassero	Third person Plural
animati	Second person Singular
annebbiavamo	First person Plural
affiorava	Third person Singular
accertando	None
rivengono	Third person Plural
situato	None
espatriare	None
specularono	Third person Plural
sorteggio	First person Singular
avvelenava	Third person Singular
verseggiato	None
razziato	None
notarono	Third person Plural
rimotiveranno	Third person Plural
riuscendo	None
sbriciolerà	Third person Singular
piovuto	None
arzigogolo	First person Singular
innevai	First person Singular
abbreviava	Third person Singular
zampillano	Third person Plural
distare	None
fracassandosi	None
rappresentato	None
riottimizzo	First person Singular
ridefinirono	Third person Plural
sbudellerò	First person Singular
scrollantesi	None
annodano	Third person Plural
evocarono	Third person Plural
dimetteresti	Second person Singular
basiamoci	First person Plural
riacquistò	Third person Singular
denudato	None
piantandosi	None
sbiadiscono	Third person Plural
sgarbuglierai	Second person Singular
tollerano	Third person Plural
affiancati	Second person Singular
tagliuzzammo	First person Plural
acetilare	None
scomunicando	None
ispirarsi	None
relegarono	Third person Plural
sbucciati	Second person Singular
politicizzavo	First person Singular
accentuato	None
abbruscasti	Second person Singular
costeggiando	None
sosterà	Third person Singular
schiacciare	None
adoperandosi	None
mordente	None
rimbambentesi	None
addestrava	Third person Singular
perpetuarono	Third person Plural
scaldarsi	None
fuggì	Third person Singular
frodare	None
rievocando	None
ravviso	First person Singular
riguadagnato	None
astenesse	Third person Singular
abbattono	Third person Plural
fissero	Third person Plural
normava	Third person Singular
catapultati	Second person Singular
sorpassò	Third person Singular
trucidarono	Third person Plural
dissociammo	First person Plural
separassero	Third person Plural
attenessero	Third person Plural
naufragarono	Third person Plural
disarmo	First person Singular
vangelizzeresti	Second person Singular
varcava	Third person Singular
tesserandosi	None
annuncerà	Third person Singular
imporranno	Third person Plural
giustificherebbero	Third person Plural
ammoscendo	None
suicidati	Second person Singular
manovrò	Third person Singular
credo	First person Singular
diminuissero	Third person Plural
sbattezzo	First person Singular
confido	First person Singular
precedere	None
stroppo	First person Singular
steccasti	Second person Singular
imbottano	Third person Plural
fluirà	Third person Singular
battaglio	First person Singular
ricollocati	Second person Singular
fluorurerò	First person Singular
disistimante	None
riavviati	Second person Singular
instradò	Third person Singular
rilevarono	Third person Plural
smembrando	None
contrappuntasse	Third person Singular
abusasse	Third person Singular
inverto	First person Singular
terrorizzando	None
favorissero	Third person Plural
vomitante	None
celebrarono	Third person Plural
sommò	Third person Singular
abbrivierete	Second person Plural
illustrato	None
isso	First person Singular
particolareggiato	None
condannano	Third person Plural
esemplificare	None
emise	Third person Singular
sovrappongo	First person Singular
creare	None
varante	None
congetturano	Third person Plural
spezzava	Third person Singular
attirano	Third person Plural
rimarrà	Third person Singular
esorterà	Third person Singular
riappropriantesi	None
introducessero	Third person Plural
zeppassimo	First person Plural
sottolineasse	Third person Singular
ridotto	None
fondessero	Third person Plural
abbasso	First person Singular
ricorderà	Third person Singular
definisse	Third person Singular
disinquinante	None
preparano	Third person Plural
indovinano	Third person Plural
circoncidersi	None
stuferà	Third person Singular
acconsentisse	Third person Singular
barbicavo	First person Singular
serpeggiava	Third person Singular
sgroppasti	Second person Singular
differiscono	Third person Plural
abbreviato	None
detronizzassimo	First person Plural
sopimmo	First person Plural
ricongiungeva	Third person Singular
dilaverete	Second person Plural
pulente	None
prodigavano	Third person Plural
traboccò	Third person Singular
disgregando	None
sorprendeva	Third person Singular
bomberai	Second person Singular
sapere	None
giovarono	Third person Plural
accorressero	Third person Plural
intensificano	Third person Plural
provocarono	Third person Plural
albero	First person Singular
distrutto	None
sdraiò	Third person Singular
voltarsi	None
cascano	Third person Plural
immischiando	None
ingoiava	Third person Singular
rincoglioniscono	Third person Plural
rivestiva	Third person Singular
accesi	First person Singular
accomandare	None
ranzo	First person Singular
arrivavano	Third person Plural
contrattaccarono	Third person Plural
assommarono	Third person Plural
proviene	Third person Singular
compromettono	Third person Plural
impolperesti	Second person Singular
compenetrerebbe	Third person Singular
svago	First person Singular
incastrare	None
ciucciarsi	None
beo	First person Singular
caverà	Third person Singular
ridursi	None
preciserei	First person Singular
inquisiresti	Second person Singular
molleggio	First person Singular
dissentono	Third person Plural
monumentalizzai	First person Singular
solleticato	None
opterei	First person Singular
rischiato	None
discordano	Third person Plural
ricreantesi	None
tassare	None
incaricasse	Third person Singular
merse	Third person Singular
posteggiasse	Third person Singular
furoreggiavano	Third person Plural
laminando	None
sanato	None
memorizzano	Third person Plural
tornavo	First person Singular
pattino	First person Singular
assunsero	Third person Plural
smettiamola	First person Plural
gioverebbe	Third person Singular
disprezzava	Third person Singular
simboleggiano	Third person Plural
esplicito	First person Singular
ricambiano	Third person Plural
svolgerebbe	Third person Singular
scorge	Third person Singular
concede	Third person Singular
ricopiò	Third person Singular
orripilando	None
anchilosante	None
oliato	None
rinuncerei	First person Singular
infetterà	Third person Singular
rinvenivano	Third person Plural
attentarono	Third person Plural
imposero	Third person Plural
pendendo	None
ottuplicò	Third person Singular
martellava	Third person Singular
raggentilirebbe	Third person Singular
instituire	None
bloccasse	Third person Singular
intonavano	Third person Plural
addicesti	Second person Singular
spacciò	Third person Singular
curioso	First person Singular
ripercotente	None
intuisco	First person Singular
ciondolare	None
infestante	None
incasinantesi	None
rigenerare	None
incorreva	Third person Singular
dedicheranno	Third person Plural
sorprenderebbe	Third person Singular
salvaguardò	Third person Singular
deregolamentare	None
usurpasti	Second person Singular
decidersi	None
completarono	Third person Plural
drizzerebbero	Third person Plural
godettero	Third person Plural
confluiranno	Third person Plural
gocciare	None
serviranno	Third person Plural
effeminato	None
medicano	Third person Plural
grondano	Third person Plural
concessi	First person Singular
inventariava	Third person Singular
facilitano	Third person Plural
costellato	None
incitasse	Third person Singular
sublimerai	Second person Singular
aspirasse	Third person Singular
approcciava	Third person Singular
andassimo	First person Plural
complottava	Third person Singular
detennero	Third person Plural
intendeva	Third person Singular
creerei	First person Singular
gestivate	Second person Plural
depellerebbe	Third person Singular
risorgono	Third person Plural
perdonarono	Third person Plural
certificò	Third person Singular
sentiti	Second person Singular
spingono	Third person Plural
accorciare	None
forzarono	Third person Plural
consigliassero	Third person Plural
sterzare	None
riconciliano	Third person Plural
detonarono	Third person Plural
quadruplicarono	Third person Plural
attraccò	Third person Singular
sventolava	Third person Singular
solere	None
spendono	Third person Plural
umiliò	Third person Singular
contraddistinse	Third person Singular
insultante	None
riappiccichereste	Second person Plural
pazientavamo	First person Plural
precisava	Third person Singular
incarnando	None
descolarizzare	None
pastorizzassero	Third person Plural
scopriranno	Third person Plural
mantenessero	Third person Plural
avariereste	Second person Plural
pensammo	First person Plural
assoggettava	Third person Singular
bramavano	Third person Plural
spalcasse	Third person Singular
striscio	First person Singular
rombiate	Second person Plural
sminuito	None
prepararono	Third person Plural
acquisì	Third person Singular
equipaggiavano	Third person Plural
provenne	Third person Singular
reintroduceva	Third person Singular
risentiranno	Third person Plural
cerò	Third person Singular
assettato	None
annettono	Third person Plural
inchiodai	First person Singular
discettare	None
movimentano	Third person Plural
desse	Third person Singular
sezioneranno	Third person Plural
premiava	Third person Singular
scappare	None
spiccare	None
premiarono	Third person Plural
retribuirebbero	Third person Plural
vacante	None
rimbombante	None
movimentato	None
sbalordirebbero	Third person Plural
lucido	First person Singular
sospinge	Third person Singular
levandosi	None
bastò	Third person Singular
succiano	Third person Plural
disinibente	None
desquamato	None
periziassero	Third person Plural
investito	None
estrinsecano	Third person Plural
rinzaffo	First person Singular
debilitare	None
accontano	Third person Plural
spumato	None
cospargendosi	None
umanizzante	None
alimentare	None
spingevano	Third person Plural
saggio	First person Singular
rivendicherà	Third person Singular
lasciassimo	First person Plural
reimmette	Third person Singular
verrei	First person Singular
legittimano	Third person Plural
configurarsi	None
supererebbe	Third person Singular
linko	First person Singular
suonavano	Third person Plural
omettevano	Third person Plural
correggeremo	First person Plural
derivo	First person Singular
incoraggiarono	Third person Plural
gradendo	None
rabbuffo	First person Singular
reinserendo	None
siglato	None
pilotarono	Third person Plural
apprestando	None
sistemare	None
sacrificheranno	Third person Plural
dribblare	None
scioglieva	Third person Singular
corrisponderà	Third person Singular
oscillano	Third person Plural
soccombeva	Third person Singular
derubato	None
affiseranno	Third person Plural
venerano	Third person Plural
infettarsi	None
impegnano	Third person Plural
attendere	None
vagillando	None
destando	None
rasò	Third person Singular
aggiudicando	None
incrociò	Third person Singular
pestando	None
brevettò	Third person Singular
ammortente	None
spilluzzicherebbero	Third person Plural
psicoanalizzante	None
confermeranno	Third person Plural
rientrante	None
attivati	Second person Singular
suggestionare	None
negarsi	None
indagano	Third person Plural
stilizzare	None
riclassificando	None
rifecero	Third person Plural
conguaglio	First person Singular
ingrandiscono	Third person Plural
giovato	None
trattato	None
disattiverà	Third person Singular
infreddolivi	Second person Singular
sovrappopolante	None
adivamo	First person Plural
diffondente	None
puzzano	Third person Plural
allergizzeremo	First person Plural
insacco	First person Singular
ripercorsero	Third person Plural
macchiò	Third person Singular
chinati	Second person Singular
reingaggiato	None
attenevano	Third person Plural
attesterebbe	Third person Singular
consiglio	First person Singular
stemperato	None
scattò	Third person Singular
accludo	First person Singular
riportasse	Third person Singular
migliorando	None
sostantivo	First person Singular
inoltrarsi	None
suddivideva	Third person Singular
contornavano	Third person Plural
svegliava	Third person Singular
sfrondati	Second person Singular
ritraendo	None
lotteranno	Third person Plural
dirompere	None
stuccavate	Second person Plural
estasiati	Second person Singular
privano	Third person Plural
comporteranno	Third person Plural
raccomandante	None
paupulare	None
vengerai	Second person Singular
abbinando	None
approfondisse	Third person Singular
scorporerei	First person Singular
legnano	Third person Plural
alonando	None
diversificarono	Third person Plural
sembrava	Third person Singular
festeggeremo	First person Plural
perdonerò	First person Singular
accorperemo	First person Plural
recupereranno	Third person Plural
dissociò	Third person Singular
traviati	Second person Singular
sbrigliare	None
careno	First person Singular
tralasciano	Third person Plural
rincorrono	Third person Plural
incanalati	Second person Singular
sedai	First person Singular
rinarreremo	First person Plural
annettendosi	None
cospirò	Third person Singular
ribadì	Third person Singular
scivolare	None
affluente	None
cerco	First person Singular
rispecchierà	Third person Singular
localizzava	Third person Singular
esibente	None
persistesse	Third person Singular
sdraiarono	Third person Plural
rasati	Second person Singular
raggiungerà	Third person Singular
stazzonasse	Third person Singular
baserei	First person Singular
velarsi	None
intrapresero	Third person Plural
rimarrebbero	Third person Plural
costituirebbero	Third person Plural
beccherò	First person Singular
fenderemo	First person Plural
ambiare	None
riutilizzarono	Third person Plural
evincesse	Third person Singular
annidarsi	None
erotizzavi	Second person Singular
rinserro	First person Singular
volante	None
invitare	None
dissomiglierai	Second person Singular
magnetizzai	First person Singular
riadattò	Third person Singular
illudendo	None
catalizzante	None
rimproverava	Third person Singular
dedotto	None
sghignazzo	First person Singular
interferisse	Third person Singular
rappresentarono	Third person Plural
riscuoto	First person Singular
supponendo	None
disgiungesse	Third person Singular
percepivano	Third person Plural
sudati	Second person Singular
svettante	None
sceglieva	Third person Singular
amputare	None
coruscare	None
dialogano	Third person Plural
aggrovigliati	Second person Singular
infrangono	Third person Plural
discuto	First person Singular
privilegerà	Third person Singular
incitato	None
raggiungersi	None
perforò	Third person Singular
astenevate	Second person Plural
scioperato	None
sbloccano	Third person Plural
confermarsi	None
risolvevano	Third person Plural
spariscono	Third person Plural
macchinammo	First person Plural
varcavano	Third person Plural
rimbacuccasse	Third person Singular
precinto	None
pretesero	Third person Plural
giocassero	Third person Plural
ascenderà	Third person Singular
mimavano	Third person Plural
risolverei	First person Singular
rispondersi	None
colorava	Third person Singular
constretto	None
dovevamo	First person Plural
imperversò	Third person Singular
progetterà	Third person Singular
funestano	Third person Plural
giustiziare	None
razionalizzando	None
consumo	First person Singular
sobbarcati	Second person Singular
peliate	Second person Plural
ungente	None
complicò	Third person Singular
trainare	None
interesserebbero	Third person Plural
condiviso	None
cerchio	First person Singular
fingendo	None
pubblicare	None
remixano	Third person Plural
ridimensionando	None
adopererà	Third person Singular
rivolere	None
sventolavano	Third person Plural
relazionano	Third person Plural
redento	None
focalizzandosi	None
ordinante	None
agurerei	First person Singular
fraintenderemo	First person Plural
moralizzerete	Second person Plural
reclutavano	Third person Plural
avvicinerebbe	Third person Singular
sciò	Third person Singular
impastando	None
contrapporrà	Third person Singular
contraccambiato	None
maturassero	Third person Plural
ancorarono	Third person Plural
ricadrebbe	Third person Singular
sovraggiungeresti	Second person Singular
comprendente	None
calesse	Third person Singular
assumessero	Third person Plural
rovinasse	Third person Singular
ponzassimo	First person Plural
infieriva	Third person Singular
volerà	Third person Singular
copre	Third person Singular
disvolto	None
festeggiante	None
scritturano	Third person Plural
capitombolare	None
predominava	Third person Singular
istigando	None
arronziate	Second person Plural
fiocco	First person Singular
trapponendo	None
sveglieranno	Third person Plural
stufarsi	None
accercinato	None
massimizzare	None
proseguissero	Third person Plural
minano	Third person Plural
telefono	First person Singular
ridiviene	Third person Singular
increspati	Second person Singular
riconquistasse	Third person Singular
colonizzando	None
trattiene	Third person Singular
immucidire	None
ristrutturare	None
attuffavano	Third person Plural
plastificante	None
vagheggiò	Third person Singular
peserebbe	Third person Singular
contraffa	Second person Singular
incazzato	None
autogovernati	Second person Singular
imprigionavo	First person Singular
approdò	Third person Singular
deprecò	Third person Singular
pranzano	Third person Plural
dilatarsi	None
rivendicato	None
richiedeva	Third person Singular
ardendo	None
peseranno	Third person Plural
pulisco	First person Singular
mitigò	Third person Singular
innestato	None
strutturalizzante	None
risolsero	Third person Plural
identificheranno	Third person Plural
evidenziarono	Third person Plural
strozzare	None
spaziato	None
compensati	Second person Singular
rubasse	Third person Singular
insediati	Second person Singular
conglobato	None
torchiato	None
scaturente	None
scalfissimo	First person Plural
invertivano	Third person Plural
reinseriscono	Third person Plural
nuoceva	Third person Singular
solfo	First person Singular
nascondessero	Third person Plural
scommettendo	None
pogo	First person Singular
garbano	Third person Plural
apponendo	None
passano	Third person Plural
rintoccare	None
stozzavo	First person Singular
affluivano	Third person Plural
avvantaggiano	Third person Plural
accentuare	None
avviava	Third person Singular
coltivo	First person Singular
esplicando	None
cambiarono	Third person Plural
ristagno	First person Singular
congiurare	None
risorgendo	None
rivenderà	Third person Singular
allagavano	Third person Plural
riapparire	None
traviavate	Second person Plural
sgomberano	Third person Plural
giunsi	First person Singular
radicheremmo	First person Plural
raggrupparsi	None
dislocante	None
atterrassero	Third person Plural
taglieggiare	None
riattaccò	Third person Singular
gemmeresti	Second person Singular
soffusi	First person Singular
pregiudicarono	Third person Plural
estremizzando	None
ciabatterete	Second person Plural
crescendo	None
consegnerà	Third person Singular
partirò	First person Singular
appianato	None
sciorinassero	Third person Plural
opzionassero	Third person Plural
meno	First person Singular
zigano	Third person Plural
espiava	Third person Singular
peggioravano	Third person Plural
osto	First person Singular
finitela	Second person Plural
pagherai	Second person Singular
gratificò	Third person Singular
confondo	First person Singular
sorprenderà	Third person Singular
valorizzante	None
limitò	Third person Singular
ripubblicò	Third person Singular
emulando	None
mulineremmo	First person Plural
soprannominano	Third person Plural
spiegherà	Third person Singular
formalizzano	Third person Plural
disgregare	None
rivolgerei	First person Singular
medicarsi	None
vidimato	None
tarante	None
arabizzante	None
affibbiano	Third person Plural
trasducono	Third person Plural
aggiornarono	Third person Plural
esemplificato	None
abbordò	Third person Singular
sopraelevati	Second person Singular
esercitarsi	None
inclinava	Third person Singular
deploro	First person Singular
ballare	None
tramanderà	Third person Singular
campionava	Third person Singular
designano	Third person Plural
fronteggiati	Second person Singular
sopravvalutando	None
ridiedero	Third person Plural
disinflazionai	First person Singular
ideologizzare	None
orchestrano	Third person Plural
decolorante	None
anonimizzasse	Third person Singular
rispecchiati	Second person Singular
escogitarono	Third person Plural
contrassegnò	Third person Singular
mozzereste	Second person Plural
zummiate	Second person Plural
scagionarono	Third person Plural
disintegrando	None
burocratizzato	None
assicurano	Third person Plural
iscriveranno	Third person Plural
chiarirà	Third person Singular
riallacciano	Third person Plural
addebitano	Third person Plural
denotava	Third person Singular
inchiostrare	None
riottenendo	None
cofirmante	None
ricandidarsi	None
alleati	Second person Singular
vantando	None
risparmiati	Second person Singular
meritano	Third person Plural
godendo	None
requisire	None
sorteggiando	None
guiderà	Third person Singular
addolcito	None
compaginerete	Second person Plural
registrammo	First person Plural
favorire	None
intese	Third person Singular
rassottigliandosi	None
sfalsai	First person Singular
transcorso	None
abbindolavo	First person Singular
penalizzava	Third person Singular
spaventò	Third person Singular
autorizzò	Third person Singular
sfottere	None
indorato	None
sovrapponeva	Third person Singular
comprovare	None
rivettato	None
imperversato	None
sciacquarsi	None
appellò	Third person Singular
criticato	None
incuriosiscono	Third person Plural
informatevi	Second person Plural
urlando	None
richiuso	None
sviscererai	Second person Singular
rimpinzarsi	None
identificarono	Third person Plural
affinando	None
riterrà	Third person Singular
trotterelliate	Second person Plural
ricolorito	None
riporgente	None
crocifiggono	Third person Plural
forfettizzai	First person Singular
dimettesse	Third person Singular
asserragliò	Third person Singular
strumento	First person Singular
pretende	Third person Singular
facciamoci	First person Plural
uccidessero	Third person Plural
arroccarono	Third person Plural
siglerà	Third person Singular
evadere	None
risemino	First person Singular
picchierellare	None
emergesse	Third person Singular
rallentano	Third person Plural
estrasse	Third person Singular
risposati	Second person Singular
sgrugnerebbero	Third person Plural
presunsero	Third person Plural
esportare	None
congedano	Third person Plural
sconforto	First person Singular
riesumano	Third person Plural
assodato	None
videochiamare	None
recarono	Third person Plural
idolatrare	None
guadagnerebbe	Third person Singular
grippo	First person Singular
avvertì	Third person Singular
riarmarsi	None
imponente	None
disinganno	First person Singular
aiutava	Third person Singular
conierà	Third person Singular
sbloccava	Third person Singular
contrassegnato	None
trafficai	First person Singular
valuto	First person Singular
epurato	None
ripiegati	Second person Singular
criminalizzando	None
rigermogliai	First person Singular
guarderebbe	Third person Singular
riscrissero	Third person Plural
soffermerei	First person Singular
affluiscono	Third person Plural
risuscitato	None
svecchiare	None
lavoricchiato	None
legiferavi	Second person Singular
effettuò	Third person Singular
editava	Third person Singular
normare	None
aggredirà	Third person Singular
riversati	Second person Singular
scongiuro	First person Singular
esperì	Third person Singular
spigolò	Third person Singular
erigesse	Third person Singular
ossedessero	Third person Plural
evolveremo	First person Plural
ripercossero	Third person Plural
ristampano	Third person Plural
bravo	First person Singular
stemperassimo	First person Plural
spunterà	Third person Singular
xerocopiante	None
sconfessò	Third person Singular
vattene	Second person Singular
rassegnava	Third person Singular
contenetevi	Second person Plural
stonerebbe	Third person Singular
gonfiando	None
pretendeva	Third person Singular
ringiovanisce	Third person Singular
precedevano	Third person Plural
emigrano	Third person Plural
poggiasse	Third person Singular
paginante	None
morirò	First person Singular
annuvolando	None
ciclostilando	None
attorcigliano	Third person Plural
toccai	First person Singular
distraessero	Third person Plural
sveglierò	First person Singular
esplicitava	Third person Singular
scavassero	Third person Plural
ammannirebbero	Third person Plural
scherzasse	Third person Singular
pronosticando	None
cozzava	Third person Singular
raffigurando	None
inoculano	Third person Plural
rovinerebbero	Third person Plural
penalizzò	Third person Singular
concordante	None
varò	Third person Singular
stringerò	First person Singular
rilevavano	Third person Plural
tartassasti	Second person Singular
pugnalereste	Second person Plural
stecco	First person Singular
ingranato	None
aggiungente	None
confluì	Third person Singular
riassumendosi	None
pregerei	First person Singular
tenendosi	None
trascorsero	Third person Plural
echeggiava	Third person Singular
aggiornerà	Third person Singular
firmo	First person Singular
penalizzando	None
rovinarono	Third person Plural
incanalava	Third person Singular
chiudessimo	First person Plural
dimagrisce	Third person Singular
smacco	First person Singular
rinascente	None
sfigurando	None
affligge	Third person Singular
complimentarono	Third person Plural
dialogò	Third person Singular
accerchiando	None
benavente	None
inzigheranno	Third person Plural
avvolgersi	None
stroppiarono	Third person Plural
disindustrializzo	First person Singular
supporterebbe	Third person Singular
compilando	None
surrogati	Second person Singular
dichiarerà	Third person Singular
scrivevamo	First person Plural
raddoppierebbe	Third person Singular
dipingere	None
addomesticati	Second person Singular
allevava	Third person Singular
meritasse	Third person Singular
discolpante	None
seguirete	Second person Plural
renderete	Second person Plural
inceneriscono	Third person Plural
reprime	Third person Singular
riaffermare	None
spalleggiarsi	None
proporre	None
inscatolavate	Second person Plural
contrapponendo	None
ingrandì	Third person Singular
riforniva	Third person Singular
insudiceremmo	First person Plural
arrendessero	Third person Plural
apostrofarsi	None
nazionalizzato	None
condensare	None
contrarre	None
condividesse	Third person Singular
rappresenterai	Second person Singular
fronteggiare	None
vaporizzano	Third person Plural
riceverete	Second person Plural
insorse	Third person Singular
cammino	First person Singular
talento	First person Singular
rinnegherà	Third person Singular
occultava	Third person Singular
alleggerirebbe	Third person Singular
amante	None
aggrinzante	None
rifuse	Third person Singular
soggiornò	Third person Singular
stimolante	None
predispose	Third person Singular
osserveranno	Third person Plural
iscrivendosi	None
interloquendo	None
contrarremo	First person Plural
metodizzerei	First person Singular
abbassano	Third person Plural
incrementerebbe	Third person Singular
eleggono	Third person Plural
realizzerà	Third person Singular
vaticinò	Third person Singular
allegorizzerai	Second person Singular
formati	Second person Singular
meriterà	Third person Singular
espanse	Third person Singular
avvisato	None
gareggiante	None
mescevate	Second person Plural
fingono	Third person Plural
occludono	Third person Plural
fasciare	None
deglobalizziate	Second person Plural
collocavano	Third person Plural
racchiudente	None
caldeggiavano	Third person Plural
annunzio	First person Singular
esprimente	None
riappropriò	Third person Singular
scurisce	Third person Singular
rammemorò	Third person Singular
inanellato	None
risaltavano	Third person Plural
libererò	First person Singular
interrogava	Third person Singular
accovacciati	Second person Singular
voterebbe	Third person Singular
alterco	First person Singular
retribuirai	Second person Singular
dissociato	None
contravvenire	None
quoto	First person Singular
abrase	Third person Singular
ledono	Third person Plural
restringevano	Third person Plural
imbarcati	Second person Singular
cancelleranno	Third person Plural
torreggiante	None
imitando	None
forzati	Second person Singular
latitano	Third person Plural
contribuiscono	Third person Plural
pappano	Third person Plural
moderare	None
abortiate	Second person Plural
affliggeva	Third person Singular
movimento	First person Singular
sottopasso	First person Singular
sequestrò	Third person Singular
rullato	None
accrescersi	None
infranceseresti	Second person Singular
tartufavano	Third person Plural
illudiamoci	First person Plural
disperderanno	Third person Plural
pranzo	First person Singular
rombassimo	First person Plural
crederebbe	Third person Singular
filo	First person Singular
spaparacchiarsi	None
rielaborare	None
meditava	Third person Singular
risveglierà	Third person Singular
vomitando	None
immagazzinava	Third person Singular
motivano	Third person Plural
allenerei	First person Singular
oltrapasserò	First person Singular
ossidassimo	First person Plural
attraverso	First person Singular
perpetrarono	Third person Plural
taglierà	Third person Singular
armonizzano	Third person Plural
rifluirono	Third person Plural
rimontarono	Third person Plural
ironizzano	Third person Plural
infastidì	Third person Singular
rovescio	First person Singular
completassero	Third person Plural
investigando	None
perpetrano	Third person Plural
riorganizzò	Third person Singular
ripudiavano	Third person Plural
privato	None
guidano	Third person Plural
spaccandosi	None
meravigliarsi	None
coinvolse	Third person Singular
escogitai	First person Singular
ridiventiate	Second person Plural
annichilato	None
sguainò	Third person Singular
saltellato	None
ingannano	Third person Plural
precedeva	Third person Singular
praticarono	Third person Plural
dipende	Third person Singular
platinare	None
colorano	Third person Plural
rettificando	None
clivassero	Third person Plural
elegge	Third person Singular
finanziasse	Third person Singular
requisiremo	First person Plural
precompilato	None
richiudono	Third person Plural
appressammo	First person Plural
scanneravano	Third person Plural
fidandosi	None
rischiavo	First person Singular
sgretoliate	Second person Plural
rispondesse	Third person Singular
cazzo	First person Singular
accamparono	Third person Plural
veneravano	Third person Plural
beccarsi	None
raggranchieranno	Third person Plural
profilo	First person Singular
determinare	None
pietrificante	None
seguitavano	Third person Plural
rifacentesi	None
trascurerei	First person Singular
scivolò	Third person Singular
badava	Third person Singular
risponderete	Second person Plural
aggiucchirai	Second person Singular
assottigliando	None
distanzierà	Third person Singular
basterebbe	Third person Singular
sigillano	Third person Plural
abbracciando	None
fluttuano	Third person Plural
provvedendo	None
profittando	None
tassano	Third person Plural
erigeva	Third person Singular
perforano	Third person Plural
apposero	Third person Plural
colmavano	Third person Plural
inseguendo	None
cariano	Third person Plural
comprasse	Third person Singular
informatizzare	None
aulendo	None
incrementano	Third person Plural
raddobbo	First person Singular
ingraticcio	First person Singular
tracciarono	Third person Plural
specializzava	Third person Singular
lattai	First person Singular
abdicarono	Third person Plural
ossidereste	Second person Plural
busco	First person Singular
emendasti	Second person Singular
equivalgono	Third person Plural
accudivano	Third person Plural
osteggiando	None
gesticolare	None
riscoprirà	Third person Singular
inseriranno	Third person Plural
vedremmo	First person Plural
sintonizzarsi	None
iniettò	Third person Singular
processo	First person Singular
rimpicciolire	None
assumersi	None
abrasi	First person Singular
silurando	None
escogitano	Third person Plural
convergere	None
arrovellerai	Second person Singular
avvicinavano	Third person Plural
redigeva	Third person Singular
insabbiò	Third person Singular
montasse	Third person Singular
debuttasse	Third person Singular
occultare	None
solvente	None
assicurati	Second person Singular
referenziare	None
dispiegarsi	None
implicando	None
nascessero	Third person Plural
annichilisce	Third person Singular
estraendo	None
disosserò	First person Singular
rubai	First person Singular
fracassando	None
stigmatizzando	None
ingrandirei	First person Singular
forare	None
riscriverà	Third person Singular
involato	None
montando	None
issai	First person Singular
inneggiato	None
allenii	First person Singular
espettorante	None
tranquillizzati	Second person Singular
incluse	Third person Singular
riscontrarsi	None
brillavano	Third person Plural
riprenderanno	Third person Plural
sfaldarono	Third person Plural
testifichereste	Second person Plural
infiocchettarono	Third person Plural
prefiguravano	Third person Plural
ciucciato	None
assalgono	Third person Plural
devolvendo	None
volò	Third person Singular
fabbricherà	Third person Singular
chiariva	Third person Singular
valcante	None
spiccato	None
citeremo	First person Plural
discordante	None
stranissimo	First person Plural
specificheranno	Third person Plural
annasò	Third person Singular
disboscato	None
risanando	None
elimino	First person Singular
inasprì	Third person Singular
suadente	None
olezzo	First person Singular
consolidando	None
compilavamo	First person Plural
sbrigandosi	None
dubiterà	Third person Singular
goffrante	None
scricchiolante	None
afferravamo	First person Plural
scotomizzerete	Second person Plural
ricaddero	Third person Plural
attruppammo	First person Plural
fregarsi	None
prediligesse	Third person Singular
ramificato	None
abortivo	First person Singular
cappotto	First person Singular
burocratizzare	None
sprizzerebbero	Third person Plural
perlustravano	Third person Plural
radiodiffuso	None
relegherai	Second person Singular
contemplati	Second person Singular
allearono	Third person Plural
dissento	First person Singular
dovei	First person Singular
esposero	Third person Plural
anticipano	Third person Plural
demoltiplicato	None
assassino	First person Singular
trascrivevano	Third person Plural
descrivevo	First person Singular
ribaltarono	Third person Plural
distringendo	None
scopriva	Third person Singular
appende	Third person Singular
scassato	None
allenato	None
plagiando	None
assorgerete	Second person Plural
vincolerò	First person Singular
pronunciati	Second person Singular
torturano	Third person Plural
rappacificarsi	None
osteggiò	Third person Singular
accentato	None
operarono	Third person Plural
ricomprante	None
rovesciavano	Third person Plural
armonizzati	Second person Singular
destabilizzando	None
invitato	None
ordirono	Third person Plural
caddi	First person Singular
appinzò	Third person Singular
sfinì	Third person Singular
fallisce	Third person Singular
constatante	None
innervano	Third person Plural
troneggiano	Third person Plural
subentrare	None
mediava	Third person Singular
suppuro	First person Singular
interromperei	First person Singular
duplicando	None
blandì	Third person Singular
rioccupò	Third person Singular
intonarono	Third person Plural
comportati	Second person Singular
sguanciavamo	First person Plural
alcalinizzai	First person Singular
impazzisco	First person Singular
rapirà	Third person Singular
condanneranno	Third person Plural
degenerare	None
ricomporre	None
scoprono	Third person Plural
frutteranno	Third person Plural
coserete	Second person Plural
compire	None
modano	First person Singular
gettarono	Third person Plural
mangiarsi	None
attentando	None
definivano	Third person Plural
immobilizzando	None
fondeva	Third person Singular
proteggevano	Third person Plural
sostiate	Second person Plural
piastrellando	None
trascurasse	Third person Singular
spiritualizzeranno	Third person Plural
risolvo	First person Singular
prestabiliva	Third person Singular
avvalorava	Third person Singular
destinavano	Third person Plural
smuovono	Third person Plural
arbitrò	Third person Singular
internerai	Second person Singular
tutelano	Third person Plural
parcheggio	First person Singular
sedammo	First person Plural
radicalizzare	None
seccandosi	None
accalorato	None
riporterebbero	Third person Plural
asteggiando	None
discenderà	Third person Singular
schianterà	Third person Singular
linciare	None
scatenando	None
rimpiazzarono	Third person Plural
stanno	Third person Plural
ritroveremo	First person Plural
collocherà	Third person Singular
preferivano	Third person Plural
incalzano	Third person Plural
inceppavano	Third person Plural
divenissero	Third person Plural
inneggiarono	Third person Plural
consumandosi	None
trotterellerei	First person Singular
sdrucciolo	First person Singular
attirato	None
susseguirsi	None
spazientirsi	None
archiviare	None
acconciando	None
giocherellavano	Third person Plural
rigiudicassimo	First person Plural
simboleggiante	None
sparirò	First person Singular
terrorizzano	Third person Plural
incasinati	Second person Singular
adeguerò	First person Singular
farfugliare	None
schiavizzò	Third person Singular
svenendo	None
imbrogliano	Third person Plural
frazionare	None
istruirono	Third person Plural
giocherellando	None
rassegnati	Second person Singular
reputò	Third person Singular
fiutando	None
imbarcarsi	None
vendemmiare	None
logorò	Third person Singular
tesero	Third person Plural
choccherà	Third person Singular
rincontrerà	Third person Singular
vegliante	None
frodo	First person Singular
elettrizzerebbero	Third person Plural
grafico	First person Singular
riprenderò	First person Singular
divorasse	Third person Singular
sbalzò	Third person Singular
accostarono	Third person Plural
stentano	Third person Plural
sospendevano	Third person Plural
capovolse	Third person Singular
profilare	None
ricuperare	None
rispecchiato	None
rivolgevo	First person Singular
inorridito	None
linkando	None
iscrivetevi	Second person Plural
ritrasmise	Third person Singular
pazziò	Third person Singular
zampettare	None
sbarazzandosene	None
rafforzassero	Third person Plural
inglobavano	Third person Plural
coltivassero	Third person Plural
gridando	None
ricredo	First person Singular
arredano	Third person Plural
confessano	Third person Plural
inalante	None
trasferirono	Third person Plural
useresti	Second person Singular
concepivano	Third person Plural
transcritto	None
evocherà	Third person Singular
venderò	First person Singular
crollare	None
frammentò	Third person Singular
appassionerà	Third person Singular
smembrati	Second person Singular
perdonando	None
prezzato	None
schernirono	Third person Plural
soffermarsi	None
espose	Third person Singular
subirebbero	Third person Plural
decreterà	Third person Singular
graffiati	Second person Singular
ricorsi	First person Singular
fiorirono	Third person Plural
sbirbante	None
udirà	Third person Singular
dismesso	None
riconvertì	Third person Singular
intravvedeva	Third person Singular
ostentando	None
quadruplicantesi	None
murante	None
impasteremmo	First person Plural
fuso	None
focalizzerei	First person Singular
arrapperò	First person Singular
allocato	None
schiamazzante	None
invocano	Third person Plural
spannocchiando	None
gasseremo	First person Plural
rivogliono	Third person Plural
tradisse	Third person Singular
comprenderei	First person Singular
nazionalizzarono	Third person Plural
respingevano	Third person Plural
impietrivano	Third person Plural
stimolarono	Third person Plural
investigavano	Third person Plural
sfegatati	Second person Singular
umiliante	None
condente	None
traversava	Third person Singular
attrezzò	Third person Singular
mollo	First person Singular
aggiro	First person Singular
ammalerà	Third person Singular
girovagò	Third person Singular
figliare	None
intitolandosi	None
toccassero	Third person Plural
ricorse	Third person Singular
bolliva	Third person Singular
disincaglio	First person Singular
sovramodulare	None
frizionerai	Second person Singular
razziare	None
avvolgente	None
candidati	Second person Singular
immedesimarono	Third person Plural
quintuplicò	Third person Singular
cederebbe	Third person Singular
rifermento	First person Singular
suppose	Third person Singular
evase	Third person Singular
rinchiudersi	None
ricambiò	Third person Singular
travalicato	None
servirà	Third person Singular
congetturarono	Third person Plural
acciecando	None
gattonato	None
trasformasse	Third person Singular
ingabbieremmo	First person Plural
espropriarono	Third person Plural
concettualizzassimo	First person Plural
gioisce	Third person Singular
rinchiudevano	Third person Plural
bisserà	Third person Singular
balzello	First person Singular
calciando	None
riverniciato	None
anello	First person Singular
estendessero	Third person Plural
infiammando	None
dovranno	Third person Plural
ricristallizzeremmo	First person Plural
regnava	Third person Singular
introducono	Third person Plural
ruotò	Third person Singular
adorassero	Third person Plural
temevo	First person Singular
ledo	First person Singular
reinterpretando	None
schierarono	Third person Plural
condensava	Third person Singular
appesantì	Third person Singular
schiantandosi	None
rivolgevano	Third person Plural
saldò	Third person Singular
rinfrancare	None
covare	None
attorto	None
fregandosene	None
accarezzati	Second person Singular
simboleggerebbe	Third person Singular
pompante	None
settorializzavano	Third person Plural
ritento	First person Singular
espirare	None
seguitò	Third person Singular
covavano	Third person Plural
sopprimeva	Third person Singular
descrivevano	Third person Plural
imbudellavi	Second person Singular
sorgerà	Third person Singular
ostato	None
moccicato	None
disinvolto	None
vagabondare	None
assistente	None
partiva	Third person Singular
scampo	First person Singular
procacciò	Third person Singular
prevede	Third person Singular
vegetando	None
rattristato	None
fottendosi	None
agguerriresti	Second person Singular
sgarro	First person Singular
sorpassarono	Third person Plural
contraddicendo	None
aboliscono	Third person Plural
affliggerà	Third person Singular
calzavano	Third person Plural
dileguò	Third person Singular
abbrivo	First person Singular
sigillare	None
disturbarsi	None
venerasse	Third person Singular
installavano	Third person Plural
adunarsi	None
piantala	Second person Singular
storpiare	None
legiferare	None
tramutano	Third person Plural
festeggeranno	Third person Plural
ribadirono	Third person Plural
rosseggiare	None
sopravviene	Third person Singular
proverrebbe	Third person Singular
martellinare	None
intrufolano	Third person Plural
credesse	Third person Singular
prevedente	None
sostituirono	Third person Plural
rientrato	None
accederà	Third person Singular
scapocchiare	None
pavimentato	None
riprendendosi	None
rimedio	First person Singular
avviano	Third person Plural
capitombolo	First person Singular
insospettire	None
dimenantesi	None
accalcherai	Second person Singular
bestemmiava	Third person Singular
condannava	Third person Singular
sforzando	None
sporcava	Third person Singular
attorniati	Second person Singular
agghiadai	First person Singular
utilizzassero	Third person Plural
interpretano	Third person Plural
replicava	Third person Singular
riutilizzano	Third person Plural
coronarono	Third person Plural
vomitò	Third person Singular
polimerizzato	None
stagliarsi	None
raggiunsero	Third person Plural
protocollare	None
arruolassero	Third person Plural
fondando	None
includerei	First person Singular
lottò	Third person Singular
colpissero	Third person Plural
carrozzare	None
trasmetto	First person Singular
sfocato	None
lascerebbero	Third person Plural
evidenziano	Third person Plural
pizzicavate	Second person Plural
profilano	Third person Plural
incoronò	Third person Singular
spicco	First person Singular
noleggiarono	Third person Plural
piatissero	Third person Plural
commosso	None
tappezzano	Third person Plural
vivificante	None
sventolano	Third person Plural
protendersi	None
commemorato	None
condivise	Third person Singular
surriscaldare	None
riposizionantesi	None
impinzantesi	None
queto	First person Singular
sottotitolerai	Second person Singular
infatuerà	Third person Singular
tribolato	None
cavarono	Third person Plural
tracciò	Third person Singular
trarranno	Third person Plural
vocalizzare	None
attribuivano	Third person Plural
innestandosi	None
accoglierebbe	Third person Singular
rinsaldare	None
caboto	First person Singular
escoriarsi	None
salterello	First person Singular
pilotava	Third person Singular
rifermentato	None
falcidiassero	Third person Plural
obbedissero	Third person Plural
devolve	Third person Singular
barricano	Third person Plural
sfiorivano	Third person Plural
ledeva	Third person Singular
incolpò	Third person Singular
assoldarono	Third person Plural
svegliano	Third person Plural
certificavano	Third person Plural
gettonato	None
brutalizzato	None
scatenano	Third person Plural
cavata	None
condividessero	Third person Plural
brontolavamo	First person Plural
solto	None
vergognano	Third person Plural
alimento	First person Singular
forgiò	Third person Singular
reimparante	None
investirono	Third person Plural
discanterei	First person Singular
allarmano	Third person Plural
opposero	Third person Plural
beneficeranno	Third person Plural
distaccava	Third person Singular
interfacciati	Second person Singular
riappacificarono	Third person Plural
sceglierai	Second person Singular
prosciugando	None
segnaleranno	Third person Plural
cintarono	Third person Plural
ritenesse	Third person Singular
sconfessando	None
oso	First person Singular
stillo	First person Singular
precludeva	Third person Singular
castigo	First person Singular
fruttavano	Third person Plural
ubbidisce	Third person Singular
complicarsi	None
romanticizzato	None
trasse	Third person Singular
rimpatriato	None
naturaleggeremmo	First person Plural
avventuratevi	Second person Plural
prevennero	Third person Plural
inamidato	None
rifoderare	None
galleggiato	None
stipavano	Third person Plural
suppliscono	Third person Plural
costatato	None
ritmato	None
sostituisco	First person Singular
preaccennavo	First person Singular
strusciato	None
divertì	Third person Singular
discrescereste	Second person Plural
equiparare	None
spostassimo	First person Plural
emancipandosi	None
rase	Third person Singular
padreggerebbe	Third person Singular
frugare	None
intasano	Third person Plural
fissò	Third person Singular
affrettandosi	None
impersonavano	Third person Plural
promozionato	None
approccio	First person Singular
smezzavo	First person Singular
snobbando	None
reincarnandosi	None
alleviano	Third person Plural
inclusero	Third person Plural
inarcato	None
beviamocela	First person Plural
sussurrano	Third person Plural
inflesse	Third person Singular
bandì	Third person Singular
avversato	None
tradendo	None
sconvolgevano	Third person Plural
sgrassava	Third person Singular
cadmiereste	Second person Plural
rifugiano	Third person Plural
breviando	None
dimetteva	Third person Singular
complimentare	None
qualificava	Third person Singular
trotterellò	Third person Singular
aggiudicò	Third person Singular
sforbiciavamo	First person Plural
imperversavano	Third person Plural
portava	Third person Singular
collezionarono	Third person Plural
preservati	Second person Singular
smanetterebbero	Third person Plural
turati	Second person Singular
soprannominerà	Third person Singular
offende	Third person Singular
copriva	Third person Singular
ionizzare	None
decorerà	Third person Singular
emergente	None
ricalato	None
eclissano	Third person Plural
renderesti	Second person Singular
disattendeva	Third person Singular
funestai	First person Singular
dilagano	Third person Plural
fiorissimo	First person Plural
placcò	Third person Singular
innervosito	None
ridivenire	None
trafugato	None
ridefinendo	None
celano	Third person Plural
sopravvivendo	None
conversavano	Third person Plural
pingo	First person Singular
ondulare	None
atterrito	None
premescolare	None
approfittiate	Second person Plural
infossati	Second person Singular
incupisce	Third person Singular
bagnante	None
flettevano	Third person Plural
tagliarsi	None
informarono	Third person Plural
crogiolo	First person Singular
combaciava	Third person Singular
ripongono	Third person Plural
tagliano	Third person Plural
voluminizzeremmo	First person Plural
attesteranno	Third person Plural
accoltellò	Third person Singular
priviamoci	First person Plural
aerotraineremmo	First person Plural
ingiallisce	Third person Singular
vagabondò	Third person Singular
erudendosi	None
decolorerebbe	Third person Singular
proverrebbero	Third person Plural
linkasse	Third person Singular
asserendo	None
controbattere	None
sorvolo	First person Singular
decadesse	Third person Singular
dinoccare	None
fortificano	Third person Plural
ostacolavano	Third person Plural
sputo	First person Singular
pagheremo	First person Plural
spiegasse	Third person Singular
confonderà	Third person Singular
devasterà	Third person Singular
codificava	Third person Singular
inoltrò	Third person Singular
rientrassero	Third person Plural
opererei	First person Singular
abbeveravamo	First person Plural
deponessero	Third person Plural
definirei	First person Singular
sopravvivranno	Third person Plural
pavimento	First person Singular
stagnare	None
intascare	None
depauperano	Third person Plural
attardo	First person Singular
dissetato	None
mobilizzando	None
clivo	First person Singular
ricavano	Third person Plural
decappotto	First person Singular
squalificano	Third person Plural
bivacco	First person Singular
lavorasse	Third person Singular
stagionati	Second person Singular
interpreto	First person Singular
coverchiarono	Third person Plural
riparleremo	First person Plural
caramellato	None
contendo	First person Singular
raduno	First person Singular
schermograferai	Second person Singular
riavvincevi	Second person Singular
riotterresti	Second person Singular
ritornasse	Third person Singular
riguarderebbe	Third person Singular
sporgevano	Third person Plural
afferrati	Second person Singular
iscriversi	None
decedettero	Third person Plural
istruì	Third person Singular
chiudono	Third person Plural
infilerà	Third person Singular
immesso	None
muoio	First person Singular
inscenò	Third person Singular
capitolò	Third person Singular
necessiterebbero	Third person Plural
verbalizzassimo	First person Plural
appiglierò	First person Singular
udii	First person Singular
vetrificarsi	None
approssimati	Second person Singular
direzionando	None
ripitturassero	Third person Plural
afforcante	None
scannerizzato	None
lottano	Third person Plural
linearizzare	None
giganteggiava	Third person Singular
possedevano	Third person Plural
cuciranno	Third person Plural
allargavano	Third person Plural
adibisce	Third person Singular
custodì	Third person Singular
aggricciavi	Second person Singular
soffregammo	First person Plural
mormorava	Third person Singular
decompartimentavamo	First person Plural
appalesò	Third person Singular
intricati	Second person Singular
anneriscono	Third person Plural
strafaceva	Third person Singular
destalinizzerebbe	Third person Singular
sollecitavano	Third person Plural
richiederanno	Third person Plural
riarmato	None
rimetterò	First person Singular
vestivano	Third person Plural
erogava	Third person Singular
infastidirono	Third person Plural
lamentarsi	None
vedendosela	None
lodarono	Third person Plural
eguagliò	Third person Singular
abbigliati	Second person Singular
brunirete	Second person Plural
raddoppierà	Third person Singular
determinassero	Third person Plural
necrotizzando	None
smentire	None
righerebbero	Third person Plural
praticava	Third person Singular
discriminano	Third person Plural
cementano	Third person Plural
fioretto	First person Singular
corricchiando	None
inchinano	Third person Plural
sincereremmo	First person Plural
becco	First person Singular
licenziarono	Third person Plural
dissolvere	None
sconvolgeva	Third person Singular
pretratterai	Second person Singular
serberà	Third person Singular
lucrare	None
istoriassero	Third person Plural
manifestava	Third person Singular
sfoltito	None
pervertendo	None
strutturati	Second person Singular
origliano	Third person Plural
promulgherà	Third person Singular
narro	First person Singular
staresti	Second person Singular
effondere	None
colpiscono	Third person Plural
indurato	None
ammollo	First person Singular
equivalente	None
maritare	None
ridenominò	Third person Singular
reprimerei	First person Singular
sovrappose	Third person Singular
accappiettano	Third person Plural
correndo	None
correggerei	First person Singular
ingiunse	Third person Singular
inzepperebbero	Third person Plural
gettati	Second person Singular
dovremo	First person Plural
giungevano	Third person Plural
sfoggiassero	Third person Plural
temeva	Third person Singular
innaffiato	None
reincarnando	None
certificarono	Third person Plural
scomunicarono	Third person Plural
acchetavo	First person Singular
duellano	Third person Plural
inasprirsi	None
unito	None
insinuò	Third person Singular
spiegheresti	Second person Singular
sceneggiante	None
stupefatti	Second person Singular
scribacchieranno	Third person Plural
filosofante	None
vicino	First person Singular
espanderà	Third person Singular
battezzarono	Third person Plural
fritto	None
quadruplicare	None
sbalordendo	None
intercambiavo	First person Singular
emettente	None
stogliendo	None
laudare	None
ingracilire	None
distendono	Third person Plural
risparmierò	First person Singular
sottoutilizzo	First person Singular
spartirsi	None
confessantesi	None
sbaglierà	Third person Singular
segregano	Third person Plural
questuò	Third person Singular
celasse	Third person Singular
rialzò	Third person Singular
compiangendosi	None
divinizzato	None
ammutolì	Third person Singular
scintillano	Third person Plural
manualizzavo	First person Singular
sopporterebbe	Third person Singular
coletto	First person Singular
accorciandosi	None
organizzeranno	Third person Plural
rammollire	None
inimicò	Third person Singular
rubavano	Third person Plural
consacravano	Third person Plural
agglutinereste	Second person Plural
saltò	Third person Singular
onesto	First person Singular
coinvolgo	First person Singular
suonò	Third person Singular
accadono	Third person Plural
vincerai	Second person Singular
farai	Second person Singular
persuaderà	Third person Singular
ravvisavano	Third person Plural
evacuava	Third person Singular
ascoltantesi	None
estinguerà	Third person Singular
parve	Third person Singular
fremono	Third person Plural
incassò	Third person Singular
arrapinerebbe	Third person Singular
regalava	Third person Singular
delocalizzando	None
stinto	None
sottopongono	Third person Plural
dissociantesi	None
librarsi	None
scandalizzati	Second person Singular
equipaggiati	Second person Singular
identificassero	Third person Plural
standardizzo	First person Singular
facendosi	None
presidio	First person Singular
traforato	None
esulava	Third person Singular
svergognato	None
osteggiato	None
secolarizzò	Third person Singular
dirigerà	Third person Singular
esagerarono	Third person Plural
discusse	Third person Singular
riproduco	First person Singular
drammatizzando	None
consentirà	Third person Singular
tassava	Third person Singular
aspettavate	Second person Plural
posponendo	None
giungerebbe	Third person Singular
accentare	None
disorientare	None
imbastardendo	None
mapparono	Third person Plural
imputarono	Third person Plural
paniate	Second person Plural
borseggeranno	Third person Plural
concionare	None
demanializzare	None
citava	Third person Singular
incrociandosi	None
imbrillantinavi	Second person Singular
caratterizzano	Third person Plural
apparvero	Third person Plural
meditavano	Third person Plural
scivoleremo	First person Plural
standardizzato	None
ballo	First person Singular
sposiamoci	First person Plural
perorando	None
scoppiarono	Third person Plural
porremo	First person Plural
reclinarsi	None
coesistono	Third person Plural
aromatizzassimo	First person Plural
migliorerebbe	Third person Singular
rincontrato	None
ondulato	None
stango	First person Singular
includente	None
oberavamo	First person Plural
guardavamo	First person Plural
firmò	Third person Singular
erpicano	Third person Plural
incardinarsi	None
palafittò	Third person Singular
formato	None
quintuplicandosi	None
inzuppavano	Third person Plural
simmetrizzerò	First person Singular
stanare	None
trinciante	None
esordì	Third person Singular
prevalsero	Third person Plural
tuffarsi	None
provocassero	Third person Plural
rischierò	First person Singular
inoltrati	Second person Singular
recuperarono	Third person Plural
monitorerà	Third person Singular
annichilerei	First person Singular
produco	First person Singular
diffonde	Third person Singular
destasse	Third person Singular
puntassero	Third person Plural
digrignare	None
profanarono	Third person Plural
risalendo	None
coagulato	None
imbrattano	Third person Plural
diminuiscono	Third person Plural
convoco	First person Singular
contenne	Third person Singular
mischiandosi	None
ignorassero	Third person Plural
smarginante	None
articolano	Third person Plural
godente	None
convertire	None
ricresciuto	None
riattaccarsi	None
spassando	None
riusare	None
comprende	Third person Singular
ingrandisco	First person Singular
abbisognano	Third person Plural
analizzano	Third person Plural
rilanciano	Third person Plural
custodissero	Third person Plural
sanciremmo	First person Plural
barrante	None
giudicassero	Third person Plural
assumerà	Third person Singular
schiaffeggiare	None
incarnavano	Third person Plural
interagirà	Third person Singular
flettersi	None
rendesse	Third person Singular
degustiate	Second person Plural
promanano	Third person Plural
vantiamoci	First person Plural
collaborò	Third person Singular
necessitavano	Third person Plural
vibrava	Third person Singular
rincontro	First person Singular
aggiustava	Third person Singular
ferisce	Third person Singular
perverresti	Second person Singular
estruso	None
penalizzerà	Third person Singular
ricreerà	Third person Singular
spiegando	None
disquisire	None
scaldò	Third person Singular
disobbedendo	None
rifulge	Third person Singular
sussurrava	Third person Singular
ricreasse	Third person Singular
tratteggio	First person Singular
contrariare	None
riserbarsi	None
agghindano	Third person Plural
arrangiavano	Third person Plural
scolerebbe	Third person Singular
esordisce	Third person Singular
percepisse	Third person Singular
riosservato	None
sclerotizzante	None
scorgendo	None
scolpisce	Third person Singular
mutuarono	Third person Plural
qualificati	Second person Singular
finanziavano	Third person Plural
sottoponendosi	None
concresciuto	None
vincolò	Third person Singular
molo	First person Singular
scaccolantesi	None
insultare	None
coinvolgerebbero	Third person Plural
patente	None
edificava	Third person Singular
incatenando	None
imperava	Third person Singular
mitigandosi	None
intrigò	Third person Singular
raffigurato	None
bevesse	Third person Singular
immobilizzarono	Third person Plural
svolgevano	Third person Plural
energizzato	None
dissotterrò	Third person Singular
indignato	None
complottavano	Third person Plural
limeresti	Second person Singular
mappare	None
aletto	First person Singular
remixassero	Third person Plural
saggiando	None
irrigidì	Third person Singular
rifluire	None
rispuntare	None
transricevo	First person Singular
reimpianto	First person Singular
rievocherà	Third person Singular
prediligere	None
capitavano	Third person Plural
stentò	Third person Singular
dattilograferemo	First person Plural
premevano	Third person Plural
espressi	First person Singular
flottava	Third person Singular
percorrevano	Third person Plural
contrarono	Third person Plural
accoppiò	Third person Singular
percorrono	Third person Plural
scegliere	None
coincidessero	Third person Plural
maturavano	Third person Plural
rannicchiarsi	None
uniformandosi	None
costicchierà	Third person Singular
ravvalorammo	First person Plural
duplicandosi	None
azzeccano	Third person Plural
quadruplicò	Third person Singular
ingeriva	Third person Singular
difenderanno	Third person Plural
allattavano	Third person Plural
intercalare	None
aviolancio	First person Singular
rinchiudere	None
esisterà	Third person Singular
respingono	Third person Plural
debuttato	None
maggiorano	Third person Plural
depredavano	Third person Plural
sgusciante	None
distinse	Third person Singular
intravedeva	Third person Singular
confidavano	Third person Plural
sorseggiando	None
constatava	Third person Singular
scagionerà	Third person Singular
carambolò	Third person Singular
sparleranno	Third person Plural
creato	None
preavviso	First person Singular
incendiavano	Third person Plural
turbinare	None
graffiava	Third person Singular
delegante	None
acquartierarono	Third person Plural
accatarrai	First person Singular
culminante	None
chinava	Third person Singular
instaurava	Third person Singular
impegneremo	First person Plural
affascinando	None
commercializzarono	Third person Plural
ripescato	None
accivettassimo	First person Plural
ricomporrà	Third person Singular
infiltrasse	Third person Singular
rompendo	None
rollò	Third person Singular
elogiavano	Third person Plural
assecurare	None
curvavano	Third person Plural
aggiungessero	Third person Plural
ultimò	Third person Singular
pasticciando	None
sottoutilizzavi	Second person Singular
elenco	First person Singular
baseranno	Third person Plural
rivestirono	Third person Plural
terrorizzarono	Third person Plural
inflazionato	None
darei	First person Singular
cosparge	Third person Singular
sbracarono	Third person Plural
rinnestava	Third person Singular
amavi	Second person Singular
cooperando	None
riciclando	None
desonorizzò	Third person Singular
scioglierà	Third person Singular
deceduto	None
imbragammo	First person Plural
rimuteremmo	First person Plural
cozzarono	Third person Plural
commissariare	None
provvede	Third person Singular
bucherebbero	Third person Plural
archiviereste	Second person Plural
abbrutendosi	None
sclerotizzantesi	None
cristianizzano	Third person Plural
ipotecato	None
romanzato	None
azionavano	Third person Plural
alare	None
liquefarsi	None
abbellendo	None
rimpinguando	None
tarderanno	Third person Plural
descrivendosi	None
affascinare	None
riattacchereste	Second person Plural
radendo	None
scapparono	Third person Plural
attenendosi	None
risultava	Third person Singular
solleverò	First person Singular
trapuntare	None
ostracizzerai	Second person Singular
instaurò	Third person Singular
incastrerà	Third person Singular
diramato	None
minimizzando	None
lodava	Third person Singular
scoprirà	Third person Singular
diluvi	Third person Singular
gotto	First person Singular
riconfermato	None
indirizzerà	Third person Singular
ossessionato	None
accartocciato	None
clamare	None
chiarificante	None
altero	First person Singular
preclusero	Third person Plural
bucherellante	None
crollerebbe	Third person Singular
intercettando	None
sopraelevare	None
sdraiano	Third person Plural
dicesse	Third person Singular
interrompe	Third person Singular
sgranellando	None
elusi	First person Singular
riscalderemo	First person Plural
alimentavano	Third person Plural
infrango	First person Singular
caracollavo	First person Singular
includerebbero	Third person Plural
falciare	None
smuoversi	None
sfavorirei	First person Singular
sgranocchiare	None
lardo	First person Singular
interromperebbe	Third person Singular
sfilato	None
calcolati	Second person Singular
incamminandosi	None
ricuciono	Third person Plural
detestandosi	None
ringraziare	None
ammeterà	Third person Singular
ritirava	Third person Singular
divengono	Third person Plural
eccepisce	Third person Singular
indurerete	Second person Plural
irradiati	Second person Singular
vagheggiava	Third person Singular
convinceranno	Third person Plural
incamiciante	None
umanando	None
prosperò	Third person Singular
avvincere	None
venerare	None
ibernai	First person Singular
devastò	Third person Singular
vagava	Third person Singular
godremo	First person Plural
collegherebbero	Third person Plural
fessurati	Second person Singular
abilitato	None
mormorando	None
mischiava	Third person Singular
alavi	Second person Singular
rivolgeranno	Third person Plural
sfumava	Third person Singular
struscerebbero	Third person Plural
culminerete	Second person Plural
riadattante	None
urinò	Third person Singular
domare	None
appiattì	Third person Singular
abbellivano	Third person Plural
ustionato	None
coordinavano	Third person Plural
reimpasteranno	Third person Plural
proferì	Third person Singular
zuccherato	None
corrotto	None
decrescere	None
fidanzeranno	Third person Plural
scanalato	None
concreto	First person Singular
attestati	Second person Singular
otteneva	Third person Singular
abbiscerà	Third person Singular
specchiante	None
convergerà	Third person Singular
inscenavano	Third person Plural
esatto	None
dolcificavo	First person Singular
solcassero	Third person Plural
decodificando	None
abbatterà	Third person Singular
questionare	None
soffiano	Third person Plural
rimanderà	Third person Singular
utilizzano	Third person Plural
badavano	Third person Plural
disormeggiava	Third person Singular
consistette	Third person Singular
arco	First person Singular
nobilitati	Second person Singular
romanzo	First person Singular
adoperati	Second person Singular
affumigheranno	Third person Plural
delegificato	None
montante	None
agendo	None
riottimizzare	None
propiziare	None
salvasse	Third person Singular
battiti	Second person Singular
complottò	Third person Singular
sospettò	Third person Singular
confonderebbe	Third person Singular
riconcilierà	Third person Singular
ripresentandosi	None
ridenominarono	Third person Plural
completo	First person Singular
tannarono	Third person Plural
digradava	Third person Singular
cauterizzare	None
risaltando	None
risorgerà	Third person Singular
spegnano	Third person Plural
esperisce	Third person Singular
sussultarono	Third person Plural
sottoscriveva	Third person Singular
arrampicò	Third person Singular
riaccesero	Third person Plural
desistendo	None
vietasse	Third person Singular
ricoprirsi	None
succedendo	None
gustavo	First person Singular
deporranno	Third person Plural
defenestrano	Third person Plural
spogliarono	Third person Plural
sopperirono	Third person Plural
rosi	First person Singular
attrezzando	None
vincolano	Third person Plural
siglarono	Third person Plural
pareggiare	None
puntello	First person Singular
scuriosasti	Second person Singular
locò	Third person Singular
lacerando	None
spassano	Third person Plural
guidassero	Third person Plural
trascinò	Third person Singular
esercitavano	Third person Plural
commercializzerà	Third person Singular
mulciva	Third person Singular
elogiare	None
riverbero	First person Singular
ammodernare	None
arrischio	First person Singular
aleggiante	None
arrosto	First person Singular
ostacolo	First person Singular
rimorire	None
bucarsi	None
cozzo	First person Singular
allibrerò	First person Singular
osservarsi	None
agglomerati	Second person Singular
richiesero	Third person Plural
parteggiò	Third person Singular
emigravano	Third person Plural
predicevano	Third person Plural
zono	First person Singular
trasdurranno	Third person Plural
addolcire	None
corrode	Third person Singular
rimborsato	None
riannodare	None
opponevano	Third person Plural
assordante	None
escutendo	None
inventarsi	None
criticasse	Third person Singular
accappietterebbe	Third person Singular
arroccati	Second person Singular
intrigando	None
imparentassero	Third person Plural
scomodato	None
vincevano	Third person Plural
fornicare	None
arrabbiarsi	None
irradiava	Third person Singular
ruppi	First person Singular
contesto	First person Singular
scombussolare	None
riemergendo	None
conformano	Third person Plural
chiariranno	Third person Plural
parlucchierei	First person Singular
alimentati	Second person Singular
biasimarono	Third person Plural
ultimano	Third person Plural
illuminerà	Third person Singular
connesso	None
inframettendo	None
immagazzinavano	Third person Plural
inflisse	Third person Singular
dragare	None
rifai	Second person Singular
riutilizzante	None
serbava	Third person Singular
frazionerai	Second person Singular
abbarrando	None
raggiungo	First person Singular
inseriresti	Second person Singular
accompagnano	Third person Plural
imbruniscono	Third person Plural
odiato	None
ruotassero	Third person Plural
rifiorire	None
oltrepassarono	Third person Plural
seccati	Second person Singular
scaturivano	Third person Plural
inabissati	Second person Singular
coincideranno	Third person Plural
vieterei	First person Singular
sillogizzando	None
giocai	First person Singular
sussistevano	Third person Plural
annichilì	Third person Singular
rinnesterete	Second person Plural
orbitato	None
divertirà	Third person Singular
rado	First person Singular
impossessati	Second person Singular
eliminassimo	First person Plural
ricalcando	None
trainarono	Third person Plural
coltivavano	Third person Plural
precorrendo	None
incomodo	First person Singular
privatizzato	None
disvalgo	First person Singular
prevaricante	None
inventariato	None
rigurgitato	None
rassicurarono	Third person Plural
interferirebbe	Third person Singular
sfogo	First person Singular
decade	Third person Singular
pratico	First person Singular
lisciati	Second person Singular
grecizzato	None
dubitò	Third person Singular
sfibravano	Third person Plural
rimungendo	None
decorano	Third person Plural
equivalere	None
seguirebbe	Third person Singular
disciplinasse	Third person Singular
scoccò	Third person Singular
simboleggiato	None
arrosavo	First person Singular
rileggetevi	Second person Plural
antergai	First person Singular
sprangammo	First person Plural
risalito	None
urge	Third person Singular
augurano	Third person Plural
erasi	First person Singular
incassarono	Third person Plural
interesso	First person Singular
unciniate	Second person Plural
discongiungeva	Third person Singular
diradati	Second person Singular
perpetuo	First person Singular
affioreremo	First person Plural
formalizzato	None
unificherà	Third person Singular
riconoscevano	Third person Plural
dilaniavano	Third person Plural
lesionarsi	None
schiarirono	Third person Plural
sinistro	First person Singular
mobiliterà	Third person Singular
talliranno	Third person Plural
rammemorereste	Second person Plural
sdraiando	None
subconcedente	None
persisteva	Third person Singular
emendava	Third person Singular
pagare	None
concernevano	Third person Plural
scucisti	Second person Singular
inventandosi	None
acuendosi	None
scompartire	None
merso	None
predasse	Third person Singular
irromperà	Third person Singular
confluirà	Third person Singular
allargarono	Third person Plural
ammetterà	Third person Singular
schermerei	First person Singular
concordo	First person Singular
escluderà	Third person Singular
consumarsi	None
eterificasti	Second person Singular
recuperavano	Third person Plural
compensavano	Third person Plural
ammassato	None
immettendosi	None
tagliuzzerai	Second person Singular
compromettesse	Third person Singular
secretato	None
allontanassero	Third person Plural
arrivai	First person Singular
bloggo	First person Singular
riacquistando	None
contaminatevi	Second person Plural
plagiano	Third person Plural
passito	None
incombono	Third person Plural
incastrarono	Third person Plural
curerete	Second person Plural
convogliando	None
fruì	Third person Singular
ubbidivano	Third person Plural
evacuò	Third person Singular
premesse	Third person Singular
postare	None
attendo	First person Singular
accarezzava	Third person Singular
vilificante	None
semplificano	Third person Plural
impatterà	Third person Singular
contornarono	Third person Plural
tappando	None
aggravante	None
spaventava	Third person Singular
servì	Third person Singular
transiteranno	Third person Plural
categorizzo	First person Singular
abiurerai	Second person Singular
logorati	Second person Singular
riproporranno	Third person Plural
susseguiti	Second person Singular
ricambiavano	Third person Plural
alienato	None
sferzante	None
usufruiscono	Third person Plural
cronometrare	None
altalenavate	Second person Plural
spingessero	Third person Plural
riadattarono	Third person Plural
poppando	None
ampliare	None
cosparsi	First person Singular
erogato	None
reperiscono	Third person Plural
invase	Third person Singular
chiappo	First person Singular
circonderanno	Third person Plural
intralciano	Third person Plural
attenuarono	Third person Plural
provassero	Third person Plural
volteggiavano	Third person Plural
cronometrati	Second person Singular
venderanno	Third person Plural
stillare	None
deviarono	Third person Plural
precipitati	Second person Singular
esponevano	Third person Plural
caveranno	Third person Plural
caratterizzerà	Third person Singular
odierà	Third person Singular
ragionano	Third person Plural
subiscono	Third person Plural
modernizzarsi	None
sbaciucchiando	None
spartisce	Third person Singular
imbrattati	Second person Singular
acquadernerei	First person Singular
spargono	Third person Plural
enfatizzando	None
eliminiate	Second person Plural
rendiamoci	First person Plural
prodotto	None
scemava	Third person Singular
acuirsi	None
cartavetrò	Third person Singular
autogestirebbero	Third person Plural
innalzato	None
derattizzante	None
imploravano	Third person Plural
prolificavo	First person Singular
contestano	Third person Plural
consentiva	Third person Singular
ammattonassero	Third person Plural
riappariranno	Third person Plural
aggiudicarsi	None
zanno	First person Singular
torturarsi	None
compartimento	First person Singular
tanfo	First person Singular
riparlerò	First person Singular
teorizzare	None
soffermava	Third person Singular
congelatevi	Second person Plural
entusiasmandosi	None
cresceva	Third person Singular
sovrintende	Third person Singular
osservati	Second person Singular
sostanziano	Third person Plural
propagano	Third person Plural
incuriosisce	Third person Singular
decollarono	Third person Plural
previde	Third person Singular
diventando	None
legnammo	First person Plural
denotò	Third person Singular
cooberesti	Second person Singular
inframmezzato	None
schierasse	Third person Singular
medicati	Second person Singular
dilungo	First person Singular
modulare	None
spetterà	Third person Singular
ampliava	Third person Singular
spalancarsi	None
cacare	None
accanito	None
liberalizzare	None
introdotto	None
addolcendosi	None
ingannare	None
trasformano	Third person Plural
ribellati	Second person Singular
ammetto	First person Singular
approfondendo	None
pietrificarsi	None
riotturare	None
sbaragliando	None
intruglio	First person Singular
affitterà	Third person Singular
corrispondo	First person Singular
contattasse	Third person Singular
trapelò	Third person Singular
riproduciamoci	First person Plural
assiemerete	Second person Plural
profittato	None
circoscrivendo	None
moltiplicare	None
ubriacato	None
assegnerebbe	Third person Singular
alcolizzati	Second person Singular
esercitano	Third person Plural
connotò	Third person Singular
sopravvivo	First person Singular
escogitando	None
riconfermandosi	None
carbossilai	First person Singular
nascondevo	First person Singular
oscillerà	Third person Singular
inficiato	None
silenziante	None
filtravano	Third person Plural
ingombrarono	Third person Plural
sparpagliò	Third person Singular
sfidavano	Third person Plural
arrabbierei	First person Singular
consegnato	None
recepireste	Second person Plural
dissotterrando	None
editavo	First person Singular
immergiti	Second person Singular
ospitavano	Third person Plural
consentisse	Third person Singular
egemonizzerai	Second person Singular
morimmo	First person Plural
rispuntando	None
biscotto	First person Singular
stilizzavano	Third person Plural
sistemati	Second person Singular
selezionato	None
imprime	Third person Singular
ravvivati	Second person Singular
riassorbivano	Third person Plural
slegasti	Second person Singular
deliberava	Third person Singular
concederebbe	Third person Singular
disvarresti	Second person Singular
tralasciato	None
impiegammo	First person Plural
contrò	Third person Singular
ammaestrando	None
riaggregare	None
interruppe	Third person Singular
risponde	Third person Singular
impietosito	None
rauno	First person Singular
precaricheremo	First person Plural
registrati	Second person Singular
aderirà	Third person Singular
rafforzerebbe	Third person Singular
scoraggiavano	Third person Plural
dividerebbe	Third person Singular
coalizzavo	First person Singular
originava	Third person Singular
intraprendesse	Third person Singular
precisati	Second person Singular
citavi	Second person Singular
borderò	First person Singular
overcloccheremmo	First person Plural
scandalizzava	Third person Singular
spandono	Third person Plural
immunizzarsi	None
limito	First person Singular
rullano	Third person Plural
mitragliarono	Third person Plural
smaliziati	Second person Singular
eclissarono	Third person Plural
esploderebbe	Third person Singular
ricollegava	Third person Singular
bastendo	None
banchettare	None
smossero	Third person Plural
riuniremo	First person Plural
condizionano	Third person Plural
poeticizzeranno	Third person Plural
postulano	Third person Plural
lavoravi	Second person Singular
distolse	Third person Singular
someggio	First person Singular
palettato	None
disperderebbe	Third person Singular
schizzeranno	Third person Plural
piegare	None
passerà	Third person Singular
placati	Second person Singular
proseguirò	First person Singular
informò	Third person Singular
atomizzare	None
balzava	Third person Singular
spezzettato	None
cangiai	First person Singular
esultavate	Second person Plural
cerante	None
usasse	Third person Singular
esasperare	None
scappo	First person Singular
pedaleggiare	None
azionava	Third person Singular
allibreranno	Third person Plural
inacidito	None
professarono	Third person Plural
accampionavi	Second person Singular
destinarono	Third person Plural
contendendo	None
masticavano	Third person Plural
organizzo	First person Singular
trapuntato	None
scostato	None
riscontrò	Third person Singular
imbalsamato	None
rimedierò	First person Singular
invento	First person Singular
disallineante	None
sussunto	None
spararsi	None
tabaccai	First person Singular
spennato	None
picco	First person Singular
satinare	None
discorreva	Third person Singular
piombano	Third person Plural
ricuce	Third person Singular
gravarono	Third person Plural
rifulgiate	Second person Plural
diligente	None
salverò	First person Singular
accodò	Third person Singular
investigano	Third person Plural
scoperto	None
stigmatizzo	First person Singular
compatibilizzasse	Third person Singular
insaporendosi	None
riaffitterete	Second person Plural
ristucchereste	Second person Plural
cresce	Third person Singular
affrettassero	Third person Plural
frustrava	Third person Singular
provincializzare	None
scriventesi	None
prepotemmo	First person Plural
dimissionavo	First person Singular
ricolorato	None
basassero	Third person Plural
rivaluterà	Third person Singular
innamorava	Third person Singular
denunciano	Third person Plural
coopererei	First person Singular
accompagnandosi	None
godrebbe	Third person Singular
attieniti	Second person Singular
sconcerto	First person Singular
sorreggeva	Third person Singular
astengo	First person Singular
sgualciresti	Second person Singular
cavalcarono	Third person Plural
difendesse	Third person Singular
benà	Third person Singular
autoriparantesi	None
sgualcito	None
marcherà	Third person Singular
redimersi	None
appurato	None
ridovuto	None
avvelenò	Third person Singular
segmentato	None
dissodare	None
tingeva	Third person Singular
userai	Second person Singular
irride	Third person Singular
vanificava	Third person Singular
palesava	Third person Singular
sprometteva	Third person Singular
slattava	Third person Singular
spedisce	Third person Singular
sferzare	None
sostituito	None
farei	First person Singular
tornerei	First person Singular
rioffrire	None
trasloco	First person Singular
rivolgendosi	None
proverebbe	Third person Singular
ripristineresti	Second person Singular
frammentava	Third person Singular
soddisfatti	Second person Singular
istituirà	Third person Singular
imbizzarrirono	Third person Plural
incartato	None
rimorchiano	Third person Plural
bassare	None
parametreresti	Second person Singular
esplorarono	Third person Plural
trasecolo	First person Singular
smise	Third person Singular
distruggerebbe	Third person Singular
stravolse	Third person Singular
caldeggiava	Third person Singular
disseminare	None
esordire	None
ritardando	None
vomitavate	Second person Plural
aggrovigliato	None
verbalizzarono	Third person Plural
altererebbe	Third person Singular
organicò	Third person Singular
alienò	Third person Singular
ossificati	Second person Singular
mineralizzassimo	First person Plural
abrogarono	Third person Plural
testato	None
brillano	Third person Plural
cavillato	None
vigilante	None
chinarsi	None
tirerà	Third person Singular
rigiacereste	Second person Plural
disamorante	None
rinculare	None
indietreggiano	Third person Plural
interpose	Third person Singular
sottovalutando	None
sorpassano	Third person Plural
tremerà	Third person Singular
sintetizzò	Third person Singular
avvicinatevi	Second person Plural
editando	None
regolamentò	Third person Singular
cospargentesi	None
impiccando	None
conservandosi	None
osculerete	Second person Plural
estraniati	Second person Singular
rientrare	None
annaspicherei	First person Singular
gradirebbero	Third person Plural
neutralizzavo	First person Singular
decidetevi	Second person Plural
perdere	None
credevi	Second person Singular
infliggerà	Third person Singular
peristi	Second person Singular
ammassicciante	None
combinasse	Third person Singular
scinde	Third person Singular
disprezzano	Third person Plural
interlacciato	None
parafavano	Third person Plural
dissacrato	None
infiammarono	Third person Plural
scacazziate	Second person Plural
marceranno	Third person Plural
scatenerà	Third person Singular
defilo	First person Singular
raccomandò	Third person Singular
provvedeva	Third person Singular
partono	Third person Plural
incatenarono	Third person Plural
videocomunicando	None
diminuire	None
addrizzare	None
alleluiante	None
cingere	None
dileguandosi	None
adatterà	Third person Singular
introdurranno	Third person Plural
fluttuavano	Third person Plural
inzuppato	None
ingelosì	Third person Singular
esplodesse	Third person Singular
assomigliante	None
accede	Third person Singular
ruberei	First person Singular
equipaggio	First person Singular
oltrepassava	Third person Singular
accasano	Third person Plural
rastremante	None
picchiettato	None
consigliò	Third person Singular
segnalassero	Third person Plural
perderà	Third person Singular
areo	First person Singular
scacciasse	Third person Singular
fregiò	Third person Singular
attaccato	None
collezionare	None
riscontrano	Third person Plural
fondasse	Third person Singular
spedì	Third person Singular
intessiate	Second person Plural
abbonato	None
esterno	First person Singular
accattivante	None
suonava	Third person Singular
incavigliando	None
asserì	Third person Singular
anticipava	Third person Singular
infeltriate	Second person Plural
acconciato	None
cenano	Third person Plural
filosofato	None
padroneggiando	None
subbiano	Third person Plural
sminuire	None
bandivano	Third person Plural
assaltò	Third person Singular
pascolavano	Third person Plural
rassegnare	None
allignavi	Second person Singular
fumarono	Third person Plural
rimuovendo	None
esibiscono	Third person Plural
tasso	First person Singular
accoltellando	None
contrarrà	Third person Singular
cancellerà	Third person Singular
imperversava	Third person Singular
trapungono	Third person Plural
rimano	Third person Plural
appartano	Third person Plural
transfluito	None
favoriscono	Third person Plural
limitare	None
commissionando	None
appontare	None
smarriscono	Third person Plural
adempiuto	None
esordiscono	Third person Plural
regionalizzo	First person Singular
scannano	Third person Plural
scorcio	First person Singular
stipendio	First person Singular
aleggiavamo	First person Plural
arai	First person Singular
scalpellerai	Second person Singular
destabilizzato	None
riderò	First person Singular
scarno	First person Singular
tieniti	Second person Singular
sfociava	Third person Singular
annotare	None
consentirebbe	Third person Singular
cedono	Third person Plural
gloriano	Third person Plural
sacrificava	Third person Singular
sovrascritto	None
determino	First person Singular
delegò	Third person Singular
svendendo	None
estenderebbe	Third person Singular
pranzando	None
ballano	Third person Plural
garantisti	Second person Singular
snifferanno	Third person Plural
sosterremo	First person Plural
documentò	Third person Singular
unguento	First person Singular
equiparava	Third person Singular
intasatevi	Second person Plural
incombente	None
fruisce	Third person Singular
detenuto	None
costringendo	None
rosero	Third person Plural
necessitante	None
impressionare	None
rivendeva	Third person Singular
dovettero	Third person Plural
fuggito	None
valendo	None
impedissero	Third person Plural
affrontarsi	None
peggiorassero	Third person Plural
bisello	First person Singular
schincerete	Second person Plural
schiererà	Third person Singular
vilificavi	Second person Singular
suggeriranno	Third person Plural
preesistevano	Third person Plural
bruscare	None
individuò	Third person Singular
basteranno	Third person Plural
aggattonato	None
solvatavano	Third person Plural
reimbarcare	None
esaurire	None
investigante	None
putrefatti	Second person Singular
conveniva	Third person Singular
osavo	First person Singular
sgomitolano	Third person Plural
volente	None
resteranno	Third person Plural
uscirsene	None
colto	None
saggiare	None
dipinto	None
divido	First person Singular
rassicurantesi	None
sfioro	First person Singular
azotato	None
reinterpretò	Third person Singular
riallinearsi	None
invalidante	None
riporrà	Third person Singular
vagavano	Third person Plural
aito	First person Singular
fonasti	Second person Singular
riarse	Third person Singular
drizzano	Third person Plural
alimentò	Third person Singular
reciproco	First person Singular
scioccò	Third person Singular
riciclerà	Third person Singular
attuò	Third person Singular
movimentare	None
attaccasti	Second person Singular
consolidano	Third person Plural
unirebbe	Third person Singular
confronterà	Third person Singular
ritrattato	None
impugnato	None
adeguerei	First person Singular
interagisco	First person Singular
parcherebbero	Third person Plural
aggarberemmo	First person Plural
rieducare	None
signoreggerebbe	Third person Singular
disinformando	None
rassicurava	Third person Singular
confrontandosi	None
baciò	Third person Singular
principiante	None
proponesse	Third person Singular
complicando	None
raccomodando	None
favorirebbe	Third person Singular
biasimava	Third person Singular
ritelefonato	None
constare	None
barato	None
stereotipo	First person Singular
chiuderò	First person Singular
accluse	Third person Singular
deglobalizzammo	First person Plural
diventasse	Third person Singular
raccolgo	First person Singular
sfascio	First person Singular
collaudo	First person Singular
arroventato	None
arreggimentante	None
riqualificare	None
necrotizzavate	Second person Plural
unendo	None
incupito	None
avvelenavano	Third person Plural
inserentesi	None
ungere	None
burocratizzando	None
moderò	Third person Singular
avvolgerà	Third person Singular
identificati	Second person Singular
orientarono	Third person Plural
scingerò	First person Singular
rifornissero	Third person Plural
useremo	First person Plural
sterminò	Third person Singular
soppressi	First person Singular
spaventavano	Third person Plural
seduce	Third person Singular
abbiosciavamo	First person Plural
definirà	Third person Singular
coinvolgeva	Third person Singular
padroneggiano	Third person Plural
basito	None
privilegiasse	Third person Singular
immedesimare	None
echeggiano	Third person Plural
combinarsi	None
converto	First person Singular
metteremo	First person Plural
videochiamano	Third person Plural
umano	First person Singular
imbiancati	Second person Singular
attuffava	Third person Singular
arenò	Third person Singular
fido	First person Singular
dettagliano	Third person Plural
ammassellando	None
mondializzai	First person Singular
piratato	None
adducono	Third person Plural
alava	Third person Singular
cesserebbe	Third person Singular
interrò	Third person Singular
esalano	Third person Plural
impugnare	None
depurarsi	None
tranquillizzando	None
evaporerà	Third person Singular
maggesando	None
impauriremmo	First person Plural
ricontrattavo	First person Singular
spezzonavamo	First person Plural
riservò	Third person Singular
perfezionerà	Third person Singular
calmiamoci	First person Plural
sostenne	Third person Singular
intrigante	None
parteggiando	None
rovino	First person Singular
riterresti	Second person Singular
sfidò	Third person Singular
astenetevi	Second person Plural
simulano	Third person Plural
scriviamoci	First person Plural
commissionare	None
frizionare	None
appostavi	Second person Singular
abbindolare	None
trasumanavi	Second person Singular
spezzo	First person Singular
veggio	First person Singular
monottongo	First person Singular
partizionare	None
trotto	First person Singular
rammentati	Second person Singular
scatterà	Third person Singular
ripresentarono	Third person Plural
durerebbe	Third person Singular
sbizzarrirono	Third person Plural
inoltrerà	Third person Singular
beneficerà	Third person Singular
tossirò	First person Singular
rifluivano	Third person Plural
vinto	None
disimballasti	Second person Singular
slinguassimo	First person Plural
contrassegno	First person Singular
mutilante	None
pedaleggeranno	Third person Plural
svolge	Third person Singular
impressionati	Second person Singular
evitassero	Third person Plural
accontentarono	Third person Plural
ristrusse	Third person Singular
gallicizzerebbero	Third person Plural
avvantaggiò	Third person Singular
rabbrividisco	First person Singular
fregiarono	Third person Plural
starnutisti	Second person Singular
sfidare	None
umiliavano	Third person Plural
disorientarsi	None
limiteranno	Third person Plural
capitolo	First person Singular
associava	Third person Singular
ricevevo	First person Singular
tacciò	Third person Singular
riscalderà	Third person Singular
ammontò	Third person Singular
ravvisava	Third person Singular
soppressero	Third person Plural
potenziavano	Third person Plural
scartato	None
intitolarono	Third person Plural
busserete	Second person Plural
affittante	None
strinse	Third person Singular
sottopone	Third person Singular
ciancerai	Second person Singular
elevarsi	None
balzando	None
scalarono	Third person Plural
abbondavano	Third person Plural
stipare	None
umanizzato	None
rifornì	Third person Singular
oltraggio	First person Singular
replico	First person Singular
accoravate	Second person Plural
coronava	Third person Singular
convincerebbe	Third person Singular
infeudarono	Third person Plural
incriminante	None
approfittava	Third person Singular
tombolare	None
renderanno	Third person Plural
mormorò	Third person Singular
ossificato	None
corroso	None
dissentire	None
ripristinarono	Third person Plural
tutelasse	Third person Singular
divampò	Third person Singular
ingerì	Third person Singular
ricarico	First person Singular
sghignazzare	None
brucava	Third person Singular
esaltavano	Third person Plural
adocchiavamo	First person Plural
datevi	Second person Plural
impiegati	Second person Singular
adibito	None
graverà	Third person Singular
risultasse	Third person Singular
recensirai	Second person Singular
sbilanceremo	First person Plural
bramire	None
attaccammo	First person Plural
parificando	None
rubasti	Second person Singular
telegrafava	Third person Singular
biennalizzeremo	First person Plural
designerà	Third person Singular
peregrinato	None
predicato	None
immischiati	Second person Singular
rapare	None
stringersi	None
indosseranno	Third person Plural
piastrelleranno	Third person Plural
innamorano	Third person Plural
anagrammare	None
preferiremmo	First person Plural
rinutrire	None
accudì	Third person Singular
cercasse	Third person Singular
imprecare	None
avviluppano	Third person Plural
raggio	First person Singular
impiego	First person Singular
riordinano	Third person Plural
interpreterei	First person Singular
allegando	None
filammo	First person Plural
etossilammo	First person Plural
dissipano	Third person Plural
premurerò	First person Singular
anglicizzato	None
sbugiardavate	Second person Plural
spirantizzammo	First person Plural
plasmò	Third person Singular
sgommano	Third person Plural
gettandosi	None
concepirà	Third person Singular
incontrandosi	None
sommesso	None
preleverà	Third person Singular
odorato	None
analizzati	Second person Singular
incurvati	Second person Singular
pilotano	Third person Plural
infiggere	None
censurò	Third person Singular
porteranno	Third person Plural
ingraneranno	Third person Plural
subaffitto	First person Singular
riunendo	None
liberava	Third person Singular
sgorgarono	Third person Plural
restituirono	Third person Plural
mitigati	Second person Singular
incastrante	None
riutilizzerà	Third person Singular
dirigessero	Third person Plural
abbinavano	Third person Plural
drizzavate	Second person Plural
pacificò	Third person Singular
configurano	Third person Plural
contrattaccherà	Third person Singular
umidificavi	Second person Singular
rimuginando	None
coadiuvarono	Third person Plural
nericante	None
dotarsi	None
guarderà	Third person Singular
dissesterò	First person Singular
rimuteremo	First person Plural
rovesciarsi	None
abdicava	Third person Singular
qualificherà	Third person Singular
soffermare	None
deferisce	Third person Singular
reinseriva	Third person Singular
capeggiava	Third person Singular
issato	None
flangiando	None
voterai	Second person Singular
aprendosi	None
radunato	None
passerebbe	Third person Singular
allineo	First person Singular
riattato	None
annientavi	Second person Singular
siglò	Third person Singular
regalasse	Third person Singular
sanitizzando	None
custodirono	Third person Plural
sedo	First person Singular
attendato	None
infiorante	None
disciolgono	Third person Plural
bocciarono	Third person Plural
sforzano	Third person Plural
infrattasse	Third person Singular
contravvalevate	Second person Plural
adonai	First person Singular
secretare	None
difendendosi	None
spalleggiati	Second person Singular
osservarono	Third person Plural
raggirava	Third person Singular
sopraelevato	None
macinano	Third person Plural
spezzerà	Third person Singular
nascondiamoci	First person Plural
alleverà	Third person Singular
risaltano	Third person Plural
mitro	First person Singular
statalizzerò	First person Singular
spiegai	First person Singular
assicurerà	Third person Singular
fantasticando	None
accopperà	Third person Singular
abortirono	Third person Plural
sgusciò	Third person Singular
circonfulsero	Third person Plural
considerarsi	None
incarcerarono	Third person Plural
destabilizzante	None
accanisce	Third person Singular
pigliare	None
ricollegandosi	None
bisso	First person Singular
duellerà	Third person Singular
coesistettero	Third person Plural
agguantano	Third person Plural
arrosteresti	Second person Singular
scarcereresti	Second person Singular
stilò	Third person Singular
vertevano	Third person Plural
ricadevano	Third person Plural
intimidendosi	None
piagnucolare	None
decuplicante	None
orientare	None
incorrerebbe	Third person Singular
infiltrante	None
infusi	First person Singular
insospettiscono	Third person Plural
padroneggiasse	Third person Singular
intingono	Third person Plural
desquamereste	Second person Plural
sfogandosi	None
meritarono	Third person Plural
iterare	None
vergognava	Third person Singular
maltrattava	Third person Singular
congiurò	Third person Singular
concorderà	Third person Singular
camerato	None
danneggiasti	Second person Singular
saltasse	Third person Singular
prostendendo	None
arruffando	None
fermo	First person Singular
normalizzare	None
piangerò	First person Singular
scarabocchio	First person Singular
origineranno	Third person Plural
quietare	None
ristrutturarono	Third person Plural
dilungano	Third person Plural
arrivando	None
incidevano	Third person Plural
supplico	First person Singular
resisterà	Third person Singular
dissestato	None
solcando	None
macellare	None
commenterò	First person Singular
liberandosi	None
riacquistare	None
travedendo	None
mesce	Third person Singular
sobillarono	Third person Plural
qualificando	None
documenterò	First person Singular
attribuirei	First person Singular
riadattai	First person Singular
comparano	Third person Plural
rimuovesse	Third person Singular
riproducevano	Third person Plural
avvicendavate	Second person Plural
disparve	Third person Singular
espandeva	Third person Singular
adopravate	Second person Plural
sprofondavano	Third person Plural
soccomberà	Third person Singular
soggiunge	Third person Singular
cumulo	First person Singular
rigenererà	Third person Singular
calciava	Third person Singular
assolvono	Third person Plural
flettente	None
insabbiare	None
ravvedersi	None
trafficando	None
sostenessero	Third person Plural
disdegnato	None
rientrò	Third person Singular
conquistò	Third person Singular
riprendiamoci	First person Plural
rarefaremo	First person Plural
trafficano	Third person Plural
abbraccerà	Third person Singular
intrinsecato	None
chiaristi	Second person Singular
espugnare	None
mersi	First person Singular
impedirebbe	Third person Singular
affrontati	Second person Singular
soffocandosi	None
riusciate	Second person Plural
allineandosi	None
vantasse	Third person Singular
sfavoriscono	Third person Plural
scagionereste	Second person Plural
affluì	Third person Singular
adeguerà	Third person Singular
smobiliante	None
importò	Third person Singular
ovviato	None
seguisse	Third person Singular
alimentasse	Third person Singular
rannicchiato	None
stralunato	None
diviene	Third person Singular
destinati	Second person Singular
delusero	Third person Plural
beneficeresti	Second person Singular
massellando	None
riappacificandosi	None
confezionare	None
inoltrato	None
scongiurato	None
anticipavate	Second person Plural
mappo	First person Singular
pattinano	Third person Plural
spiegassero	Third person Plural
manipolano	Third person Plural
rifioriscono	Third person Plural
discendeva	Third person Singular
passeremo	First person Plural
surclassato	None
sfatato	None
guarderò	First person Singular
rista	Second person Singular
costringo	First person Singular
assomigliano	Third person Plural
proseguirà	Third person Singular
discesi	First person Singular
sosterrò	First person Singular
disdegnerei	First person Singular
rintroneranno	Third person Plural
ingoio	First person Singular
armonizzò	Third person Singular
millimetravate	Second person Plural
graticolando	None
affollarono	Third person Plural
affrescherà	Third person Singular
radicalizzò	Third person Singular
campeggiante	None
accorrerà	Third person Singular
raschiando	None
sovraintesi	First person Singular
baciamoci	First person Plural
accentuati	Second person Singular
catapulterà	Third person Singular
lemmatizzerà	Third person Singular
pranzavano	Third person Plural
migrava	Third person Singular
scavalcando	None
sdrammatizzerete	Second person Plural
lodatevi	Second person Plural
germogliò	Third person Singular
assisteva	Third person Singular
falliranno	Third person Plural
adduarono	Third person Plural
