intrigama	None
dopalo	Active
prisegnuti	Passive
privremeni	None
integralno	None
prekinuto	Passive
lišili	Active
čuvali	Active
zaboravnost	None
sarađivali	Active
ozlijedio	Active
lopti	None
održiva	None
obuče	None
mletačkom	None
nemirnih	None
ukrcan	Passive
svakodnevno	None
nudilo	Active
tupljeni	Passive
postojale	Active
stručnoga	None
otvorimo	None
prikazivan	Passive
izbegao	Active
stadu	None
izgorio	Active
hoću	None
zavezivane	Passive
transponirahu	None
gèrīlče	None
gađale	Active
najavljivan	Passive
povjereno	Passive
naseljavan	Passive
proglašavane	Passive
pripojilo	Active
presudama	None
očistili	Active
prolistale	Active
plodovima	None
razrušili	Active
presudio	Active
proklete	Passive
postavljale	Active
osušen	Passive
kucnuo	Active
done	None
pokolja	None
odvojio	Active
kompozicijama	None
razotkrivale	Active
trojke	None
bombardiralo	Passive
zapamćen	Passive
komercijalnu	None
zabeležene	Passive
češka	None
krepao	Active
mljele	Active
zasađeno	Passive
izlagane	Passive
mišić	None
zaključeni	Passive
pobjeđivali	Active
krvare	None
hranio	Active
pitalo	Active
mljeven	Passive
izvodili	Active
skrstili	Active
uvezao	Active
podržavane	Passive
puštane	Passive
ukazali	Active
opsednuti	Passive
liznuti	Passive
završen	Passive
jezuita	None
amfiteatralno	None
zelota	None
otrovali	Active
odsječen	Passive
plišu	None
otkopali	Active
aparatima	None
otkazale	Active
pješačilo	Active
klicao	Active
prevodili	Active
održalo	Active
razmaknute	Passive
statično	None
sastavnice	None
apsurdnijima	None
daleke	None
gradio	Active
cilindra	None
verovalo	Active
razdijelio	Active
albanološkima	None
pridonosile	Active
slupano	Passive
šlagerima	None
prevoženi	Passive
iskrcale	Active
memorijom	None
obješeni	Passive
poprimali	Active
odrastali	Active
slušali	Active
glasale	Active
izganjao	Active
poremećuje	None
agnostičaru	None
ispušteni	Passive
nastupalo	Active
susjedni	None
razbora	None
kuhane	Passive
okupljalo	Active
sakupljalo	Active
neiskusni	None
zbunjeni	Passive
držane	Passive
zabrinut	Passive
informativan	None
pogođeni	Passive
rovarile	Active
simplificirali	Passive
sporna	None
predsednika	None
ohrabrivan	Passive
sokoljeni	Passive
poleteo	Active
ukleti	Passive
otkazane	Passive
utrkivao	Active
poželjelo	Active
čitali	Active
obećan	Passive
promjenjivalo	Active
skakao	Active
izvođeni	Passive
набожнији	None
krokodile	None
opaženi	Passive
kudio	Active
otvorili	Active
usađivalo	Active
pretpostavljeno	Passive
sačuvaju	None
uznemirava	None
popustio	Active
mučen	Passive
raspisani	Passive
isključeni	Passive
izbrisale	Active
pigmentima	None
aterirale	Passive
umetnu	None
pokvarene	Passive
sušilo	Active
grdili	Active
robovao	Active
svećenicima	None
заједнички	None
plutao	Active
nadvladali	Active
spadale	Active
pomognut	Passive
sahranjivalo	Active
zaliveni	Passive
predvideli	Active
urođena	None
nadmašivao	Active
špikamo	None
abake	None
upravljani	Passive
silovali	Passive
modelirao	Passive
najoštriji	None
tinjalo	Active
zaplovio	Active
zmijolóvci	None
olakšane	Passive
nadmašili	Active
izmišljotina	None
vozio	Active
apoteka	None
odnarođeno	Passive
davalo	Active
isteravan	Passive
kovak	None
iskušavaj	None
nepodmitljivih	None
nailazili	Active
opsedao	Active
pošumljeno	Passive
proverene	Passive
uznemiren	Passive
najbespomoćnijoj	None
pevale	Active
uzajamni	None
obitavale	Active
podeljeno	Passive
suočile	Active
posolile	Active
apsolvirale	Passive
smjenjivale	Active
označavale	Active
udružio	Active
krovari	None
ispili	Active
preponama	None
podgrejalo	Active
izboru	None
čestitao	Passive
anketirao	Passive
planirani	Passive
šunjale	Active
tajnika	None
štavljeno	Passive
opsele	Active
proglasile	Active
udruženo	Passive
mirovale	Active
premašili	Active
kupali	Active
raščlanjivano	Passive
spašavale	Active
mišiću	None
sumnjičili	Active
šake	None
oporavljali	Active
prevođeni	Passive
povratilo	Active
umirovljene	Passive
aplicirao	Passive
zapostavljeni	Passive
istrebili	Active
začeli	Active
ubirao	Active
segnuo	Active
naišli	Active
nabavljao	Active
pevani	Passive
sluti	None
naljutio	Active
osnivale	Active
potkopavalo	Active
približavalo	Active
doktorirao	Passive
nasledilo	Active
uzbunjivao	Active
okreti	None
pomognute	Passive
razmatrali	Active
oživlen	Passive
suprotstavljen	Passive
zasenjen	Passive
tovljene	Passive
ukorilo	Active
popilo	Active
pribavljeno	Passive
mislilaca	None
pritiskivano	Passive
pričvršćeno	Passive
uništavali	Active
skočio	Active
određene	Passive
represivne	None
gašeno	Passive
dangubili	Active
održani	Passive
stupile	Active
zaleđene	Passive
napravljene	Passive
raspravio	Active
posramljeno	Passive
udvostručene	Passive
prilagođen	Passive
kićen	Passive
pismenijim	None
zaokruženo	Passive
oplodni	None
uznemirilo	Active
nasukao	Active
obećavale	Active
podsećale	Active
oblikovali	Passive
šumovi	None
rascijepalo	Active
razlomile	Active
najprobirljivijemu	None
sačuvano	Passive
smišljen	Passive
štipani	Passive
nadahnuli	Active
bistrili	Active
uvećao	Active
ukopali	Active
predvodio	Active
ovlašteni	Passive
ustali	Active
izboli	Active
zemljoradnicima	None
postelju	None
lipanj	None
kozmopolitsko	None
ispraznili	Active
probuđeno	Passive
obasut	Passive
srpskome	None
uvećali	Active
vodeći	None
njegovali	Active
otkrivali	Active
iznio	Active
profinjeno	Passive
očišćeno	Passive
carevo	None
kazivali	Active
okupljeni	Passive
bubani	Passive
perzijsku	None
raspodeljene	Passive
povjerile	Active
praznovali	Active
bazirali	Passive
izlagali	Active
smešten	Passive
potrošeni	Passive
povezivalo	Active
brisan	Passive
oštetilo	Active
iskrčivan	Passive
uvođeni	Passive
hulio	Active
prikazano	Passive
prekinuli	Active
svrstavane	Passive
doštampavale	Active
uskraćeno	Passive
gradilo	Active
lomna	None
ostalo	Active
raširio	Active
hipotetične	None
izgovoren	Passive
bezosjećajnim	None
otpisan	Passive
vošteno	Passive
uklinji	None
rasprodani	Passive
smjeli	Active
cisterni	None
međusobnu	None
japanskoj	None
brusio	Active
progonjeno	Passive
isušivan	Passive
usudio	Active
diskreditiraj	Active
odsečeni	Passive
pashalne	None
petkom	None
beleženi	Passive
izvestio	Active
zalevan	Passive
orkestar	None
rečeni	Passive
ovisilo	Active
glasovi	None
štovani	Passive
iseljeno	Passive
nasamarivani	Passive
opisao	Active
prikupljalo	Active
kidnapiraš	None
davani	Passive
primorane	Passive
savjetovao	Passive
ugrađivao	Active
opisivan	Passive
prevožene	Passive
izbavio	Active
inercije	None
stapane	Passive
sviralo	Active
sahranjivale	Active
mlak	None
prisiljavalo	Active
osušene	Passive
namjeravao	Active
poveznicom	None
stizale	Active
sekli	Active
izopačeni	Passive
centu	None
zrelinama	None
kvadratno	None
pratili	Active
ambijentalnih	None
sabijeno	Passive
posetilo	Active
razvrstano	Passive
jesenju	None
važnoj	None
zapisivano	Passive
uhapsili	Active
pomešali	Active
kanjone	None
presječen	Passive
odazoveš	None
dobivani	Passive
natječaju	None
fosforom	None
nagnuo	Active
ulazi	None
zamišljali	Active
odškrinute	Passive
nadletano	Passive
junačan	None
zapažene	Passive
germanizirali	Passive
obrađivale	Active
iskorištavao	Active
snižen	Passive
smeniše	None
zgrijale	Active
završile	Active
usmerene	Passive
napunio	Active
sapunicu	None
rezidenciju	None
ljekara	None
osnivačkom	None
radilo	Active
uselilo	Active
pripitomljeni	Passive
plašen	Passive
nadogradio	Active
prolistavale	Active
ostvaren	Passive
zableštile	Active
odstrelio	Active
remećeno	Passive
izdanjem	None
podrazumevalo	Active
kuhalo	Active
zapovijedali	Active
iritirao	Active
spominjano	Passive
uzvišene	Passive
nadjenuli	Active
ukrštale	Active
govorio	Active
zabeležen	Passive
obrazložen	Passive
gostionicama	None
pljuje	None
obustavljeno	Passive
ismejao	Active
upošljavali	Active
kočeni	Passive
srušilo	Active
kazivale	Active
bivali	Active
izmišljeni	Passive
naklanjali	Active
urađene	Passive
poplavilo	Active
nadahnut	Passive
skrivan	Passive
podjarmljene	Passive
kronološku	None
odstupali	Active
dirnut	Passive
tvrde	None
podloga	None
statistikom	None
kljusetu	None
podržavalo	Active
upadali	Active
sejalo	Active
predvodile	Active
inertnih	None
srići	None
svrstavano	Passive
otklonilo	Active
motrio	Active
govedima	None
sledeća	None
nahrupio	Active
plasirale	Passive
držao	Active
telegrame	None
sjeverozapadnih	None
izdvajani	Passive
osramotio	Active
nominirao	Passive
obavljane	Passive
obavljale	Active
složeni	Passive
primani	Passive
svodio	Active
ohlađene	Passive
usmjerio	Active
porekao	Active
kanalu	None
pripremane	Passive
slatkovodno	None
najobimniji	None
teplo	Active
prepisano	Passive
mirnim	None
začuđivali	Active
zaspe	None
prodale	Active
profinjeni	Passive
omogućen	Passive
povređuje	None
časovnika	None
rastjerivale	Active
bambusovih	None
gledali	Active
gubili	Active
prodavale	Active
nasljednicama	None
venčao	Passive
zarekao	Active
hùsīt	None
oprao	Active
dosadilo	Active
pretvoreni	Passive
banči	None
dodirnuo	Active
vikalo	Active
spljošteno	Passive
ostvareno	Passive
razvijan	Passive
doživeo	Active
sleđivani	Passive
navikavan	Passive
gospa	None
obilovalo	Active
okrivljene	Passive
merilo	Active
osigurane	Passive
umorio	Active
nadživlen	Passive
obasjane	Passive
podešavalo	Active
vodovima	None
održavani	Passive
mahali	Active
doselio	Active
čaja	None
tercijarnoj	None
brisale	Active
zatvoren	Passive
opsesivnima	None
noći	Active
odolio	Active
istaknuli	Active
nakanio	Active
prorađivani	Passive
začeo	Active
graničio	Active
vrijednošću	None
lipsali	Active
nabubale	Active
odvijalo	Active
osiromašivano	Passive
nadzirane	Passive
nesretnim	None
isušivao	Active
povređeni	Passive
napadnuti	Passive
srčanu	None
posredovano	Passive
pokorile	Active
namjeravali	Active
utjecao	Active
usađen	Passive
bezvodni	None
odeljen	Passive
ukrali	Active
određeno	Passive
zavele	Active
improvizirali	Passive
zahvaćeni	Passive
prezirao	Active
zarađene	Passive
isekao	Active
rasplamsale	Active
raselile	Active
raspodeljen	Passive
nagle	None
primicane	Passive
prognostičar	None
turizmu	None
zatalasavale	Active
prosvjedovali	Passive
preživjele	Active
onemogućili	Active
promišljene	Passive
tragali	Active
pritvoreno	Passive
poticao	Active
odaberete	None
organe	None
odmjeravao	Active
uticao	Active
kocka	None
korelaciji	None
prekriveni	Passive
ciklonom	None
podmićen	Passive
prišle	Active
točak	None
uočavamo	None
nadvladan	Passive
prete	None
subotom	None
odavao	Active
indoktrinacije	None
astrološkom	None
kidali	Active
iskopane	Passive
sanjane	Passive
izjednačeno	Passive
sabrale	Active
udaralo	Active
nalazili	Active
utrošen	Passive
nadvladavajmo	None
izvješćivane	Passive
nalazile	Active
iskrvarili	Active
mračnija	None
kaljeni	Passive
ustrojio	Active
razuvjerili	Active
najhitrijima	None
kroatizirali	Passive
promicali	Active
podizane	Passive
jamčevinu	None
carinom	None
španovi	None
laburisti	None
nabrani	Passive
komunicirao	Passive
raznijeli	Active
anulira	None
obožavale	Active
presuđivalo	Active
odijeljeni	Passive
oporavio	Active
sklonili	Active
simplificirale	Passive
snimkama	None
urod	None
parabolične	None
svrstaste	None
spriječili	Active
ožujak	None
kosnuli	Active
dodirivani	Passive
proćutjeh	None
labirintu	None
ponose	None
čárī	None
poraslo	Active
namijenjeni	Passive
odalo	Active
formirao	Passive
čoporom	None
леви	None
pomagan	Passive
poželio	Active
tražen	Passive
cepalo	Active
krstaš	None
papučom	None
poželjeli	Active
poremetio	Active
rezani	Passive
izmamile	Active
omotali	Active
pitali	Active
osunčano	Passive
sapleo	Active
nastajalo	Active
izdajicama	None
šire	None
izmišljao	Active
nuđen	Passive
dokazivali	Active
cijenjenu	None
obaveštavali	Active
zgražavalo	Active
cjepnulo	Active
tračale	Active
upotrebljavao	Active
trikom	None
odabirali	Active
zlatile	Active
oštetile	Active
artističke	None
razdeljivalo	Active
brošem	None
svrbeli	Active
prosvjed	None
prisluškivao	Active
zasjenjeni	Passive
spekulacije	None
gangsteru	None
šipka	None
globalnom	None
odvoje	None
trgovalo	Active
nastanile	Active
nasljeđivanju	None
nepoželjne	None
oslabljeni	Passive
odbranili	Active
pozivan	Passive
nejednakim	None
obuzda	None
jedrenje	None
муљевити	None
odvodilo	Active
uračunavali	Active
kreditora	None
potpisane	Passive
skupili	Active
stvaran	Passive
odnosile	Active
iskopavalo	Active
propuštano	Passive
supstanca	None
isključivalo	Active
ublažavao	Active
skratili	Active
trijebljene	Passive
vrtio	Active
smirile	Active
aspirin	None
najsloženiji	None
kišobranom	None
ispravljene	Passive
muzejskom	None
podbole	Active
naudilo	Active
sjedio	Active
apsorbiralo	Passive
garantirali	Passive
ustrojene	Passive
srebrenu	None
smestio	Active
promišljali	Active
uvjereni	Passive
ohladio	Active
zamijenio	Active
vino	None
fotko	None
poklonjen	Passive
avijacija	None
gricnuli	Active
tješile	Active
jahao	Active
hijena	None
odvrnut	Passive
najstrožim	None
stanovale	Active
oštetili	Active
propalo	Active
snabde	None
odeljku	None
posuđivao	Active
podvalio	Active
istupili	Active
polagalo	Active
pokoreno	Passive
istaknutije	None
podmitile	Active
obavezao	Active
odrađivan	Passive
doživljavao	Active
slomilo	Active
žurili	Active
kraljeviću	None
napunjeno	Passive
obavijestili	Active
ciljan	Passive
stanovali	Active
bosiljak	None
zadirkuje	None
pritužbi	None
postao	Active
propadale	Active
prenoćili	Active
pojednostavljeno	Passive
zagađivane	Passive
lokacijom	None
ovčarstvo	None
kondukcije	None
identifikacijom	None
zasluženo	Passive
vrludale	Active
izuo	Active
smijenilo	Active
neman	None
jasniju	None
bojili	Active
zanimale	Active
početi	Passive
naočare	None
krao	Active
belorusku	None
prigovarao	Active
plodonosni	None
regrutirao	Passive
talentom	None
zakopao	Active
prokušavano	Passive
prestajalo	Active
pristajali	Active
garantovao	Passive
isključivi	None
isecale	Active
snimljene	Passive
izdajice	None
gonjen	Passive
preuzimao	Active
poklonjeno	Passive
pčelarstvom	None
podržavao	Active
naslanjano	Passive
osuđivali	Active
zabadan	Passive
pravoslavlje	None
pretpostavljao	Active
suočilo	Active
liberali	None
стрми	None
potezan	Passive
ambicioznom	None
sašili	Active
probijen	Passive
gravitacije	None
dopisao	Active
svjetlucamo	None
fisije	None
pridoda	None
izbljuvano	Passive
izuzeto	Passive
besparica	None
naoružani	Passive
postupalo	Active
donošeni	Passive
poplavljeno	Passive
propustili	Active
permanentnim	None
probijeni	Passive
učinilo	Active
hronologija	None
popularni	None
grobove	None
posuđeno	Passive
raskidale	Active
doživjeli	Active
priuštilo	Active
pripitomljivane	Passive
gramatika	None
nauči	None
uvrštene	Passive
krak	None
pobudile	Active
udruživane	Passive
rešetkasta	None
sušili	Active
savet	None
izvozile	Active
izdatak	None
opero	None
ispravljao	Active
raspoređene	Passive
kozju	None
uvjeravao	Active
zapostavljen	Passive
rezano	Passive
utešio	Active
neprobojnu	None
slanosti	None
oprošteni	Passive
izdato	Passive
potaknuto	Passive
rasformirao	Active
prepoznali	Active
ponuđeni	Passive
uradili	Active
govoreno	Passive
vilo	Active
predložile	Active
zidali	Active
udavale	Active
imanentno	None
naricao	Active
proračunate	Passive
ponio	Passive
dostojni	None
vršeno	Passive
turcizme	None
žerav	None
prolamano	Passive
primorani	Passive
nizali	Active
velaran	None
obrezivale	Active
priljubljivali	Active
resio	Active
ukrcani	Passive
naterivan	Passive
živciran	Passive
pokvaren	Passive
posredovao	Active
uvećan	Passive
ohlađivali	Active
suparnike	None
bežale	Active
istrebljeni	Passive
prepričane	Passive
povređeno	Passive
preambuli	None
postavljeni	Passive
održali	Active
otplovio	Active
pristavljeno	Passive
titoizam	None
dizao	Active
potkrepile	Active
oživjeli	Active
udruživale	Active
opsjeo	Active
ždrebetom	None
podstrizane	Passive
gurnut	Passive
zalagao	Active
zadužene	Passive
poleteli	Active
koracaj	None
otpočivale	Active
navođen	Passive
prevladane	Passive
pregrađen	Passive
figura	None
zaokružio	Active
trgalo	Active
pružalo	Active
zadržavale	Active
sjenke	None
obogatili	Active
naselilo	Active
sveticama	None
samoupravljao	Active
uzvišen	Passive
pozirali	Passive
zvijerima	None
metalnoj	None
raspodijeljeni	Passive
napadano	Passive
sprudovima	None
poslužili	Active
umirovljen	Passive
elegiji	None
sudjeluju	None
popravljali	Active
spojeno	Passive
nalazio	Active
fotoćelije	None
potvrdio	Active
nabili	Active
dodijeljene	Passive
odvojilo	Active
zatražilo	Active
urotili	Active
bajan	Passive
rasute	Passive
nadmašio	Active
presjekli	Active
zakonitih	None
preterana	None
opijen	Passive
animalnijima	None
merili	Active
ispran	Passive
zaglavljeni	Passive
zakazan	Passive
završavalo	Active
ugrabili	Active
mar	None
provaljen	Passive
probušeni	Passive
koliko	None
odrađeni	Passive
oplođeno	Passive
ostali	Active
posijedio	Active
poslušan	Passive
gaknuo	Active
zaratili	Active
istražile	Active
opadao	Active
ponavljaj	None
četu	None
pripovijedano	Passive
angolskomu	None
pojavljivalo	Active
carice	None
dopunjeni	Passive
slušao	Active
blesuru	None
skrivali	Active
najkvalitetnije	None
udvostručen	Passive
računarstvom	None
repetitor	None
dijeljeni	Passive
spomenom	None
revolucionaran	None
otpisivane	Passive
bubnjare	None
spremljeno	Passive
napravismo	None
poprimilo	Active
utvrđivao	Active
sabijeni	Passive
neprelazna	None
pomiren	Passive
opstali	Active
prekrili	Active
topilo	Active
djelomični	None
bibliotekarskoga	None
uljepšavale	Active
najspekulativnija	None
федерални	None
poboljšan	Passive
zaboljeli	Active
iskakao	Active
izviješteni	Passive
škripio	Active
prijeđeni	Passive
smiješnom	None
rođeni	Passive
posredovale	Active
razboriti	None
usavršavan	Passive
razbuđivano	Passive
jamačnu	None
osetile	Active
izmišljeno	Passive
odoljelo	Active
lansiraj	Active
ohrabrivali	Active
raspravljalo	Active
razgovaralo	Active
istupljen	Passive
točilo	Active
dosadili	Active
jednostranom	None
sadržalo	Passive
razdirali	Active
cijenjeni	Passive
sirovom	None
žare	None
popravkom	None
savile	Active
crijevo	None
obrisane	Passive
odbile	Active
frigan	Passive
očišćene	Passive
vješao	Active
vodili	Active
prvenstvenomu	None
zastupalo	Active
napomenuli	Active
nasleđivali	Active
sastalo	Active
proračunalo	Active
oružano	Passive
makedonsko	None
pobjegli	Active
maloprodajnim	None
elektronskih	None
probavljen	Passive
pokusima	None
griža	None
zaokružili	Active
besciljnomu	None
vjenčao	Passive
izobličene	Passive
pregibale	Active
pogodio	Active
izbegli	Active
savjetovali	Passive
stavljan	Passive
zaostajale	Active
administrativnom	None
boravili	Active
uputilo	Active
impulse	None
ispadao	Active
razglobio	Active
bankarskih	None
napadnut	Passive
udvostručio	Active
oprah	None
presjekao	Active
krpile	Active
instruktivnijoj	None
rastopljen	Passive
rastavljeno	Passive
bezvremensku	None
začaraš	None
biljna	None
sličio	Active
izazivalo	Active
izjurilo	Active
talasne	None
podučio	Active
cvjetovima	None
priveden	Passive
značili	Active
obogaćivao	Active
ravnomerne	None
natapaste	None
nasleđivao	Active
posedovale	Active
sadržavao	Active
pridonijeli	Active
doprinosilo	Active
nadvisivali	Active
umjeli	Active
tjerao	Active
objasnio	Active
boli	Active
izbegnuti	Passive
imitirao	Active
privezan	Passive
tekući	None
bezbolno	None
testirale	Passive
ponuđene	Passive
речитији	None
nagovorio	Active
ugovorio	Active
gurnuli	Active
nabasao	Active
birale	Active
treptaja	None
napustio	Active
razlabavljeni	Passive
antiteza	None
ugledao	Active
ubacili	Active
odgrizano	Passive
preotele	Active
sidrili	Active
pismenima	None
praistorijama	None
odlazilo	Active
uvjeren	Passive
prijavilo	Active
nadgledale	Active
dodelilo	Active
živa	None
gaja	None
sastavljene	Passive
sporazumu	None
metro	None
preskočio	Active
naiđoste	None
snabdeo	Active
grudnjakom	None
dopuštene	Passive
popušili	Active
režale	Active
cerio	Active
levajte	None
zasenio	Active
crtani	Passive
oblikovale	Passive
istrebljeno	Passive
opčinjen	Passive
ljubljen	Passive
mitološka	None
razrušeno	Passive
popratili	Active
razmičite	None
atrofije	None
procjenama	None
dopusta	None
otkidano	Passive
koloseka	None
dosetljiva	None
pojačalo	Active
poklanjali	Active
kolonija	None
angažiralo	Passive
štamparije	None
magnetitom	None
pokretale	Active
ćirilski	None
naseljene	Passive
osetilo	Active
gnjili	Active
prosperirao	Passive
prepoznavani	Passive
stalnoga	None
organizirao	Passive
potplatio	Active
spomenule	Active
rasuto	Passive
aranžirao	Passive
opljačkalo	Active
grozan	None
činjeno	Passive
nošene	Passive
mereni	Passive
trošili	Active
osramoćivani	Passive
zadano	Passive
bilježe	None
rekreacije	None
razbijali	Active
злонамеран	None
rečenični	None
umivale	Active
branjen	Passive
usidren	Passive
obaviješten	Passive
sastojali	Active
dokuči	None
iznjedrio	Active
nagrnulo	Active
sjenci	None
uloženo	Passive
podrazumevale	Active
nagađalo	Active
uzimani	Passive
štampi	None
primljeno	Passive
položilo	Active
sračunavani	Passive
maraste	None
razdvajale	Active
lihvarasmo	None
zbunjen	Passive
stranicom	None
plaćeno	Passive
zarobljenika	None
punile	Active
odmarali	Active
praskalo	Active
zapazio	Active
sušeno	Passive
ilustrativan	None
zanemareni	Passive
raspravljali	Active
javljali	Active
pregrijavane	Passive
nabacivao	Active
podnosili	Active
reinkarnacijama	None
kraćalo	Active
raspustilo	Active
smio	Active
amaterizam	None
savlađivali	Active
pozvale	Active
presekle	Active
sastavio	Active
izricani	Passive
zavoleo	Active
promašio	Active
sumorne	None
preporučivalo	Active
crnjelo	Active
oporavili	Active
teoretičari	None
sagnjili	Active
bezuspešnu	None
slabijih	None
iskazivalo	Active
zaslužili	Active
deteline	None
otvorilo	Active
mitologiji	None
uzgojene	Passive
spriječeni	Passive
vejano	Passive
udove	None
корелативни	None
zarađen	Passive
utovljen	Passive
dedukciju	None
spušten	Passive
pojačale	Active
ocijenilo	Active
konstruirali	Passive
labav	None
aktivnosti	None
ometalo	Active
ograničeno	Passive
svršene	Passive
regrutirali	Passive
pozivali	Active
uručeno	Passive
iznjedrili	Active
tonske	None
čeličeno	Passive
izmjereni	Passive
ustanovljivani	Passive
mješovitijom	None
obrubljuju	None
vraćali	Active
preračunato	Passive
zapovedili	Active
odolijevali	Active
upozoravao	Active
zastupao	Active
javljao	Active
studirao	Active
izjurile	Active
prestrašeni	Passive
iluzionista	None
govedinu	None
budan	None
zabrinuo	Active
džihadu	None
traktate	None
brdovitoj	None
napravilo	Active
galamio	Active
pretvarali	Active
odbačeni	Passive
suglasničke	None
razjedinjeni	Passive
sporazumjeli	Active
opasnim	None
paradirao	Active
obrađeni	Passive
otočić	None
čeono	None
piva	None
ugrozio	Active
usredotočio	Active
uspavani	Passive
strepite	None
loptom	None
tikane	Passive
uvriježio	Active
iskrale	Active
nastupilo	Active
pritvoreni	Passive
smišljali	Active
sjećao	Active
razočarao	Active
zlostavljan	Passive
krivotvoriteljskih	None
krnjio	Active
izgnao	Active
pramen	None
tvorile	Active
gađao	Active
hranili	Active
zapazili	Active
zaštitili	Active
skretale	Active
prepoznati	Passive
nedostatak	None
prokleli	Active
šahovskom	None
apelirao	Passive
ispitao	Active
sporazumeli	Active
lansirale	Passive
kelvina	None
planirale	Active
uništavane	Passive
postavile	Active
zapovedali	Active
upotrebile	Active
upućivalo	Active
olakšalo	Active
kvantnim	None
slavljeno	Passive
spriječio	Active
trgao	Active
šumjele	Active
prikrivene	Passive
najdostojniji	None
revizija	None
osiromašili	Active
posudile	Active
prenio	Active
smišljao	Active
računalo	Active
proban	Passive
ždrijebane	Passive
pobuda	None
šiba	None
obavljalo	Active
pobijen	Passive
apokrifna	None
januaru	None
hapšeni	Passive
slične	None
tukli	Active
otjeran	Passive
ispravile	Active
nastanjivao	Active
smeštalo	Active
odradio	Active
polaskani	Passive
ustrojavan	Passive
pevaj	None
vozile	Active
odolijevao	Active
hladili	Active
prorađivalo	Active
odvodili	Active
onemogućio	Active
siječanj	None
razotkrivali	Active
uvriježilo	Active
opljačkali	Active
odoleo	Active
voštilo	Active
nadoknađivali	Active
putovao	Active
dosegnuto	Passive
proterani	Passive
glagolskim	None
razljutili	Active
rastvarane	Passive
trepnimo	None
inventivno	None
omekšavani	Passive
utvrđivan	Passive
simulirali	Active
utvrdile	Active
posjekli	Active
držan	Passive
sinova	None
povele	Active
teran	Passive
izgrađivali	Active
potpisano	Passive
sazreli	Active
suzbijene	Passive
autoritarni	None
nedeljne	None
predviđale	Active
tratinčicom	None
dječju	None
ćeralo	Active
smjestile	Active
zabuljeno	Passive
pričane	Passive
okeanu	None
investiralo	Passive
galama	None
zacementirao	Active
naselile	Active
bjelasnuli	Active
odmerili	Active
osuđivani	Passive
pozivalo	Active
prekršeni	Passive
dimilo	Active
dostizao	Active
nagovori	None
istaknuti	Passive
sporazumeo	Active
zapaženo	Passive
razrađivali	Active
primijećeno	Passive
zamjenik	None
ulagalo	Active
cvrkutale	Active
picajzlom	None
odbacio	Active
uvažili	Active
asocijaciju	None
blijedio	Active
hapsili	Active
penetriralo	Active
zaleđivani	Passive
sastavljeno	Passive
bočni	None
ventilacijskih	None
lansirali	Passive
organiziralo	Passive
korijenima	None
sabirali	Active
ručne	None
hladio	Active
ispituje	None
kotirao	Passive
uzeo	Active
onemogućavali	Active
učenicama	None
sretan	Passive
zahtevano	Passive
zabranjivane	Passive
nadmoćnoj	None
nisku	None
kanalizirate	None
krunisali	Passive
nametali	Active
bezrazložno	None
osiguran	Passive
uzgojilo	Active
primamljeno	Passive
ispunjavah	None
uselio	Active
udišu	None
zjapite	None
usvajan	Passive
cvao	Active
smetali	Active
omotan	Passive
oslobođeni	Passive
komentirao	Passive
prao	Active
hvaljeni	Passive
plast	None
pojednostavljeni	Passive
originalnome	None
ujahalo	Active
nasrnuli	Active
trajali	Active
ekonomske	None
izdajom	None
protekle	Active
počinjao	Active
mnogobrojne	None
naručeni	Passive
dvojbeno	None
oblike	None
imaocu	None
posjetili	Active
mijenjani	Passive
mijenjano	Passive
opteretio	Active
odmjeren	Passive
blagoslovljeno	Passive
provođen	Passive
oduzimano	Passive
svarene	Passive
revolucijama	None
morale	Active
odbranjeni	Passive
ukusima	None
istrebio	Active
obezglavljeni	Passive
iskrčene	Passive
objelodanjivane	Passive
чешки	None
ocenili	Active
prethodio	Active
svrstani	Passive
razvezivale	Active
prisilile	Active
proučavalo	Active
odmjeravale	Active
dojavio	Active
dizajni	None
okrenut	Passive
zadao	Active
obrijao	Active
mrzeo	Active
aromatičan	None
shvaćeni	Passive
pobunili	Active
nazorom	None
darovali	Active
opstanete	None
protivile	Active
borbenosti	None
iskopan	Passive
ćorsokacima	None
mračilo	Active
dijeljen	Passive
ostao	Active
nastali	Active
trenirao	Active
smrtnom	None
opipane	Passive
kumarinima	None
funkcionirali	Passive
редовни	None
kruno	None
zgusnuti	Passive
slomljeni	Passive
fokusirale	Passive
utjecalo	Active
istrenirani	Passive
defektni	None
smaknuto	Passive
održavali	Active
nepovezanom	None
izrekli	Active
blagosiljano	Passive
trpeli	Active
najekstremnije	None
izveštavao	Active
nacizmom	None
složile	Active
podešavao	Active
šodere	None
vitrine	None
pripremljen	Passive
ograničavao	Active
svidjele	Active
odjahale	Active
dopunjeno	Passive
zadavan	Passive
tragikomičnije	None
slučaju	None
nasmijali	Active
uticale	Active
neprovidnoj	None
odmamili	Active
rastjeruje	None
krijepljeni	Passive
praunuka	None
pokršteni	Passive
zabilježen	Passive
naručen	Passive
izgledali	Active
ispisivan	Passive
paćenici	None
razbilo	Active
ukrašen	Passive
osumnjičen	Passive
kartografska	None
zabeležili	Active
dopadao	Active
neudata	None
sedlom	None
divova	None
upoznalo	Active
proglašavan	Passive
početnoj	None
pošumljeni	Passive
nicale	Active
jurišale	Active
zastrašeni	Passive
slavljen	Passive
polinezijske	None
proveravano	Passive
preskakane	Passive
plaćene	Passive
smotalo	Active
primenjivano	Passive
obavještavali	Active
isterale	Active
sakupljali	Active
plohe	None
skočile	Active
izmerili	Active
istrošeno	Passive
raskinule	Active
obveznike	None
obustavili	Active
pravljaše	None
predsjednicom	None
pokorilo	Active
odsečen	Passive
kapsuli	None
krhotina	None
ocenjeno	Passive
изузетан	None
identificirao	Passive
bockano	Passive
blasfemijama	None
pripisivan	Passive
recesija	None
osuđivale	Active
ispisivali	Active
nabacio	Active
ugođaji	None
ograničili	Active
vrele	Active
razdvojeni	Passive
odobrovoljio	Active
strahovali	Active
zaposleno	Passive
pokušao	Active
goda	None
koaliciji	None
pokorio	Active
ustanovile	Active
uništavano	Passive
spremali	Active
eksplodiralo	Passive
hladilo	Active
kretskih	None
sistematski	None
drastični	None
uspravnu	None
pravilo	Active
raširi	None
smatrale	Active
uzdisale	Active
metale	Active
prikazivano	Passive
publika	None
proglašen	Passive
hranjeno	Passive
turkijskih	None
predsjednikom	None
poželeli	Active
izgovarano	Passive
priklanjao	Active
poslušao	Active
zaostajali	Active
praćeni	Passive
prepoznao	Active
oivičeno	Passive
sputavao	Active
porušeni	Passive
urugvajska	None
provalio	Active
predstavljan	Passive
izdržali	Active
austrougarska	None
rasprodane	Passive
ponašalo	Active
proglašeni	Passive
tkani	Passive
narodilo	Active
školovale	Active
okrug	None
prosio	Active
rođenju	None
nudile	Active
sišlo	Active
smirih	None
zaorano	Passive
primio	Active
propovijedao	Active
svršeno	Passive
ambivalentnost	None
umirovljeni	Passive
sumnjao	Active
naterani	Passive
zapaženi	Passive
tukle	Active
široj	None
ispunjavale	Active
zamišljeno	Passive
puščani	None
pȍslōvā	None
lisnice	None
ludoj	None
učinjeni	Passive
pomazano	Passive
ložen	Passive
istjerao	Active
ganjali	Active
poništen	Passive
presreo	Active
dolar	None
snabdevali	Active
pokloni	None
snalazile	Active
ciganjene	Passive
izbalansiran	Passive
žaga	None
ispečeno	Passive
izrečeno	Passive
vilica	None
rešeno	Passive
digresijama	None
funkcioniralo	Passive
nestabilnost	None
ostavile	Active
odbranilo	Active
razblaženi	Passive
prikrio	Active
zatajivalo	Active
isključivome	None
klobuku	None
brušene	Passive
rašireno	Passive
oborilo	Active
dano	Passive
izlagano	Passive
blistav	None
dresirale	Passive
hljeb	None
slovom	None
posuđenice	None
podržane	Passive
upućene	Passive
skladao	Active
provjerio	Active
pripremno	None
boravile	Active
potvrđivali	Active
spektakli	None
razlabavilo	Active
dočaravah	None
odobrovoljivalo	Active
zapostavilo	Active
incidenti	None
ključale	Active
dokazale	Active
barjaci	None
uspijevali	Active
lođama	None
krijesnice	None
rasplamsaj	None
isporuke	None
dobitniku	None
osvojeni	Passive
zamišljao	Active
štucani	Passive
propisane	Passive
obilježili	Active
doštampavani	Passive
zagrli	None
ispravi	None
vrgnule	Active
livadskim	None
posjetio	Active
uplovio	Active
poslušne	None
zaselak	None
nominalan	None
starešine	None
rušio	Active
porasli	Active
raspršeno	Passive
prepiljen	Passive
katapultirao	Passive
preuzet	Passive
izdao	Active
izbačeno	Passive
kapali	Active
ganuti	Passive
dopustili	Active
prisiljavane	Passive
zalijevalo	Active
usvojilo	Active
pokoreni	Passive
skupljeni	Passive
javio	Active
isporučio	Active
kafani	None
okruglih	None
varvarskim	None
stopljene	Passive
kokodakale	Active
uobičajenoj	None
postignute	Passive
obnoviš	None
biološkima	None
namljeven	Passive
ciklična	None
ozleđivano	Passive
lošu	None
aparate	None
pristavilo	Active
prut	None
plesačima	None
donošaše	None
štucnut	Passive
oglasa	None
očevidno	None
izvršio	Active
ovisile	Active
zavođeno	Passive
osporio	Active
dobivali	Active
obnovilo	Active
gorskim	None
zabilježene	Passive
razvijene	Passive
úvoznīk	None
opstale	Active
tendenciji	None
slomljen	Passive
proglašavali	Active
pojedene	Passive
posluživali	Active
obuhvate	None
porezano	Passive
bijedi	None
uštedio	Active
nadama	None
odustao	Active
poboljšanjima	None
razvio	Active
isteran	Passive
septembarski	None
hortikulturom	None
podmitili	Active
procurio	Active
salaš	None
posluživani	Passive
omogućeni	Passive
osuđene	Passive
tiskan	Passive
okretno	None
ovjereno	Passive
poprištu	None
osvojene	Passive
rasformirane	Passive
trošio	Active
filmska	None
uništilo	Active
doprinijele	Active
vješale	Active
zadovoljio	Active
grđene	Passive
blamiralo	Passive
saznali	Active
podučeni	Passive
najinteresantnijemu	None
eksternu	None
snimane	Passive
razrađivani	Passive
suštinom	None
ustvrdili	Active
posvećeni	Passive
zastalo	Active
suseda	None
izdržavalo	Active
opisale	Active
izrazilo	Active
izgled	None
hude	None
obelodanjeno	Passive
razgalio	Active
proizvodnu	None
brano	Passive
očekivane	Passive
dodjeljivane	Passive
razmijenile	Active
opozvao	Active
najopćenitijih	None
rasterao	Active
diskriminirali	Passive
pojavljivale	Active
prskalo	Active
puklo	Active
majmuni	None
spasili	Active
presnome	None
raskinuli	Active
evidentnijom	None
kaljen	Passive
šarama	None
crtao	Active
golubica	None
aristokratkinju	None
Zemljine	None
asa	None
procjenjivalo	Active
zataškano	Passive
razjarili	Active
venčavano	Passive
uvežbavali	Active
poslovao	Active
nastanio	Active
najčitkija	None
spoji	None
starao	Active
naglasili	Active
budnima	None
nagovješćivale	Active
nasledile	Active
hijacinta	None
preprane	Passive
hagiografskoga	None
sukobljeni	Passive
premašio	Active
dosađivalo	Active
posećivale	Active
slizalo	Active
postignuti	Passive
koštale	Active
uložilo	Active
sadist	None
nadovezivali	Active
zavezane	Passive
polazili	Active
sahranjeni	Passive
uvaljivao	Active
prepisan	Passive
bivšim	None
presečen	Passive
kročili	Active
sakuplja	None
nađu	None
krojene	Passive
autorskih	None
najzaposlenijih	None
potkopao	Active
norveških	None
izbegavale	Active
ublažio	Active
prilagodio	Active
krovnoj	None
progrese	None
pozvalo	Active
broji	None
najelegantnijim	None
mirili	Active
utučeno	Passive
saviti	Passive
oružan	Passive
povezivane	Passive
zastupale	Active
spriječen	Passive
simboliziralo	Passive
objavljivan	Passive
čeljade	None
sastavili	Active
izgrađivao	Active
obmanulo	Active
povezan	Passive
upozorile	Active
pretpostavljalo	Active
sazrevalo	Active
naručili	Active
stišavale	Active
otkinut	Passive
kritiziraju	None
užurbali	Active
zaboravim	None
pepeljara	None
istrijebljen	Passive
izostavljano	Passive
hipotetičnih	None
poludeli	Active
ponovili	Active
mjerilo	Active
skinuti	Passive
nabadani	Passive
razmenjivan	Passive
krivio	Active
opisali	Active
prosperirali	Passive
proučavan	Passive
nasmiju	None
promaknut	Passive
regulirao	Passive
čvoru	None
skrivalo	Active
svratio	Active
ustanovi	None
lične	None
približavao	Active
naljutilo	Active
dubili	Active
uvjerljiviju	None
krajiška	None
osnovao	Active
izbušene	Passive
cijenio	Active
posuđujmo	None
kićeni	Passive
vezeni	Passive
pripadao	Active
čistioce	None
pročitane	Passive
pokretano	Passive
aromatičniju	None
laboratorijske	None
pristali	Active
naglasile	Active
pripisani	Passive
renovirate	None
skrivane	Passive
ometan	Passive
propisano	Passive
preferirali	Passive
stvarane	Passive
iselilo	Active
smanjen	Passive
pravio	Active
kampirali	Active
jenjavale	Active
smestile	Active
kilobajta	None
dorađivao	Active
pojeli	Active
optimizam	None
snabdjeli	Active
iznosio	Active
udarene	Passive
egzistirale	Active
dešnjakinji	None
treslo	Active
mišu	None
sagrađeno	Passive
prestravljivan	Passive
ispisivao	Active
zaslonu	None
skinuo	Active
ratovale	Active
promatran	Passive
eura	None
udan	Passive
potkupljen	Passive
salitre	None
ispravljeno	Passive
lupao	Active
odbijani	Passive
filmskoj	None
usmjerilo	Active
udaljavali	Active
zapovedalo	Active
sredili	Active
otišlo	Active
natopljene	Passive
opominjao	Active
ocjenu	None
granite	None
kartalo	Active
rangirao	Passive
zbrajani	Passive
rešili	Active
stišavao	Active
kotarevima	None
privikli	Active
implicirao	Passive
primljeni	Passive
gazo	None
sušen	Passive
tragalo	Active
prikazan	Passive
zanemarivane	Passive
uništavao	Active
sabijen	Passive
propuštao	Active
obaveštavani	Passive
skratile	Active
razmotavane	Passive
nadovezani	Passive
izlagale	Active
programe	None
povjerene	Passive
mekih	None
zaželio	Active
specijalnom	None
prisećao	Active
rađale	Active
suho	None
zapovedi	None
dočekalo	Active
izrađivao	Active
primedbama	None
kolevku	None
zadimljeni	Passive
prenošene	Passive
procenili	Active
jamčili	Active
narkomana	None
smerale	Active
presvučen	Passive
sadržali	Passive
pomiješani	Passive
nestajalo	Active
doseljeno	Passive
pročitao	Active
krepan	Passive
rastapao	Active
iznenadile	Active
prilagođavao	Active
vario	Active
pokvarenost	None
rabe	None
atičkoj	None
zaštićivano	Passive
sokolu	None
isporučivalo	Active
strukturi	None
zaklonjeno	Passive
izbrisano	Passive
svratišta	None
gorsku	None
vedro	None
pošumljen	Passive
odgođeno	Passive
moskovskom	None
oživile	Active
grub	None
najekstremnija	None
spašene	Passive
birane	Passive
palačinkom	None
biologe	None
sklanjao	Active
preokrenuli	Active
sečen	Passive
miniralo	Passive
svemirska	None
teoretizirao	Passive
natkriljivani	Passive
kivnje	None
zauzdani	Passive
prasnuli	Active
neupadljivo	None
najuobičajeniji	None
upozoren	Passive
odgođeni	Passive
gasa	None
odbijan	Passive
marljivom	None
prorečen	Passive
poduhvatom	None
albanizirali	Active
pošle	Active
napravili	Active
svetlucao	Active
prihvatljivosti	None
poštovanja	None
zakočio	Active
naišle	Active
dovodio	Active
izgubljen	Passive
ponudile	Active
sjedinjavali	Active
ugovarao	Active
izračene	Passive
prokleto	Passive
krompirom	None
predstavljani	Passive
prepuštali	Active
uskraćen	Passive
abaka	None
uključivane	Passive
dragan	Passive
gotičkom	None
nazadna	None
baza	None
ciglom	None
micao	Active
izgrađeno	Passive
naglašene	Passive
pobjegao	Active
izgnani	Passive
saveznoga	None
pozdravljali	Active
izuzeo	Active
osnivane	Passive
duvan	Passive
budnijoj	None
gnevnome	None
očekivalo	Active
udahnuli	Active
otkrilo	Active
prigovarali	Active
ublažili	Active
opalo	Active
skandalizirale	Passive
ubilo	Active
vjerili	Active
ispražnjene	Passive
biračkih	None
činovnicima	None
uvećano	Passive
različitom	None
kožuhe	None
duhni	None
strašan	None
potegnute	Passive
prošao	Active
trudnice	None
zasluži	None
skraćeni	Passive
podrazumeva	None
sitnjaše	None
курански	None
izdati	Passive
nastavljalo	Active
ranjavan	Passive
kušali	Passive
napišemo	None
povezane	Passive
oduzeli	Active
bezvrijednim	None
najlažniji	None
okončano	Passive
procenjeni	Passive
ružmarina	None
uračunato	Passive
poricao	Active
stavljeni	Passive
obzora	None
kasnijim	None
preporučivale	Active
izgubljeni	Passive
zamenu	None
oživotvoravalo	Active
pogodilo	Active
lučeni	Passive
savremenim	None
odabrali	Active
prevratom	None
napeti	Passive
anatomske	None
stiglo	Active
udruženjima	None
izdvojeni	Passive
industrijalizirao	Passive
razlikovano	Passive
nestale	Active
nalomio	Active
srušen	Passive
prebacile	Active
otpiljene	Passive
značajnijim	None
trivijalni	None
izrodio	Active
naslanjali	Active
aukciju	None
elipsi	None
močilo	Active
doprinijeli	Active
zidom	None
polijetali	Active
povoljnom	None
zapošljavalo	Active
dovozili	Active
uneli	Active
kazani	Passive
sklopljen	Passive
vagnuli	Active
pobudili	Active
zagorčavali	Active
nagovješćivan	Passive
naslijedilo	Active
uslov	None
simulirane	Passive
mele	Active
nadopunjen	Passive
promenjivan	Passive
predani	Passive
utopljene	Passive
otpustio	Active
preplovljen	Passive
domoroče	None
jeftino	None
zasadili	Active
blažih	None
punilo	Active
isplaćen	Passive
reprezentativca	None
vodònoša	None
napuštene	Passive
razdelili	Active
omogućavale	Active
sećamo	None
najavljivano	Passive
pečeni	None
molekulu	None
novce	None
uvažavali	Active
naterale	Active
levo	None
koturao	Active
истакнути	None
obnovljeno	Passive
zadani	Passive
izbjegao	Active
rastavili	Active
ugrijane	Passive
odlomio	Active
robovasmo	None
koštali	Active
presudilo	Active
gatan	Passive
štokavska	None
ćutio	Active
obnovili	Active
obezglavljen	Passive
uzbudljiva	None
optuživao	Active
olabavljeni	Passive
zamislili	Active
isticane	Passive
podizao	Active
aranžirali	Passive
autonomije	None
spazio	Active
droge	None
odjurile	Active
mimare	None
opipano	Passive
zgađen	Passive
potkopano	Passive
mezopotamsko	None
prikupljene	Passive
unosile	Active
pranja	None
nadopunili	Active
nabijao	Active
raspao	Active
odbijen	Passive
suprotstavio	Active
refren	None
popravile	Active
nadenuli	Active
zaokružile	Active
povukle	Active
otpušteni	Passive
popunjen	Passive
trebao	Active
uvio	Active
utrošite	None
drogirao	Passive
lečeni	Passive
bečim	None
bugarin	Passive
stvarale	Active
nade	None
dosegnuti	Passive
brzine	None
gravitirali	Active
prepoznat	Passive
šapnuo	Active
kubìzma	None
statičkim	None
tronošcu	None
častan	None
zavladali	Active
razorile	Active
pomogle	Active
obnovljen	Passive
nelagodom	None
prozvane	Passive
izmišljene	Passive
sahnuo	Active
našao	Active
impresionirale	Passive
pridruživale	Active
nadahnulo	Active
zbunjeno	Passive
islamiziralo	Passive
preselile	Active
nadahnute	Passive
oivičivali	Active
biljojed	None
odmamljivane	Passive
ograničen	Passive
sudjelovalo	Active
potrudio	Active
zloupotrebljavao	Active
nadživljene	Passive
uništavan	Passive
progonjen	Passive
obilježeno	Passive
atomskih	None
razdao	Active
otklonile	Active
privlačili	Active
utvrđeno	Passive
sustaje	None
kopan	Passive
nabrajao	Active
opao	Active
kriveni	Passive
striptizéra	None
odbijale	Active
uvidjeli	Active
ostavljan	Passive
imperijalizam	None
kristalizirane	Passive
rasplakale	Active
dočekan	Passive
despotstvo	None
osmanska	None
zobano	Passive
bretonska	None
pokretali	Active
kȏbācā	None
privikavano	Passive
ukinule	Active
novembarskih	None
obrisano	Passive
prideva	None
pronicalo	Active
rigoroznim	None
bodrijega	None
prevareni	Passive
muškarce	None
salvadorsko	None
talasali	Active
pričvrstio	Active
temeljeni	Passive
grebali	Active
zidan	Passive
preštampan	Passive
odbijali	Active
detaljnu	None
potrošene	Passive
smestiste	None
sagradilo	Active
разговорни	None
širile	Active
podudarano	Passive
spoznati	Passive
primjećivane	Passive
rumunjsko	None
skijaškim	None
posoljen	Passive
spretne	None
kristologijskih	None
obline	None
potrudile	Active
ponestalo	Active
sklapao	Active
raselio	Active
spone	None
plašile	Active
kapetana	None
okeanima	None
otuđivani	Passive
zijali	Active
elitno	None
obrazovale	Passive
popunjeno	Passive
ispitivao	Active
krčevine	None
prijavite	None
slabilo	Active
poveznica	None
izgorelo	Active
osobitih	None
ponovljeno	Passive
usuti	Passive
bezazlenome	None
organizira	None
sezao	Active
ostaje	None
tonskom	None
prerađen	Passive
razglaban	Passive
otputovale	Active
zabrinuli	Active
promišljao	Active
trovao	Active
trofej	None
špikah	None
inspekciji	None
mudru	None
gospodarica	None
sadržao	Passive
odletjeli	Active
rasplelo	Active
sodomiziralo	Active
sumnjičavost	None
izmere	None
tiranskim	None
vodećega	None
ustvrdilo	Active
poverene	Passive
zabuban	Passive
pomoćnicu	None
bombardiram	None
utrke	None
akcija	None
naslonjen	Passive
okruživali	Active
lakom	None
koncentričan	None
stagniralo	Passive
sljubljivano	Passive
uzeli	Active
spaljivali	Active
upadljivi	None
pretvaralo	Active
zadužili	Active
neprocjenjivi	None
primoralo	Active
zamijenilo	Active
pristupio	Active
zlostavljani	Passive
izljubljivale	Active
usneniče	None
probušio	Active
spoznao	Active
rastopio	Active
spadali	Active
držali	Active
nikao	Active
naselio	Active
azorskih	None
oteli	Active
filtri	None
ukrcavali	Active
paljene	Passive
prolazio	Active
platili	Active
znamenkama	None
urođenu	None
ublaženi	Passive
istovetnih	None
nagrdile	Active
pokrenuli	Active
grebene	Passive
dozvoljavao	Active
razišle	Active
raskidahu	None
trend	None
svrbele	Active
obezglavljeno	Passive
pisane	Passive
usmerite	None
oživotvorile	Active
anortita	None
državi	None
uključivani	Passive
obuzeo	Active
ȍsīpā	None
nevjericom	None
punomoćnika	None
seosko	None
proučeno	Passive
promjenjivano	Passive
dokazivani	Passive
snimam	None
odlučivale	Active
dodavao	Active
čistoćo	None
zamijenjene	Passive
oduzet	Passive
nabujale	Active
slutili	Active
uvažene	Passive
obuvan	Passive
iznude	None
uručene	Passive
pripojene	Passive
razlomio	Active
predstavnici	None
stražari	None
animirali	Active
ublažilo	Active
oslanjalo	Active
izdvojili	Active
opale	Active
primjenjivao	Active
održavao	Active
privukle	Active
sabio	Active
košarkaških	None
humanitarno	None
urešeni	Passive
povjerio	Active
slomljeno	Passive
izazvao	Active
nagovješćivano	Passive
odneli	Active
kočili	Active
usađene	Passive
pljačkali	Active
nasukan	Passive
jaganjcu	None
pridobiti	Passive
sirotišta	None
zaustavile	Active
pronalazio	Active
znamenitost	None
odelili	Active
usidreni	Passive
čujnome	None
haićansko	None
inovativni	None
ispustili	Active
zabilježilo	Active
muzo	None
podnelo	Active
kladilo	Active
onečišćen	Passive
oštreni	Passive
namijenjeno	Passive
zabili	Active
zakleli	Active
mjerio	Active
slavilo	Active
ugrađivani	Passive
obogaćen	Passive
odobravalo	Active
zapamćeni	Passive
poremećen	Passive
ukoren	Passive
obrađene	Passive
lio	Active
zgrušani	Passive
temporalnoj	None
prisilio	Active
prihvatljivim	None
licitirali	Passive
hvalisavi	None
neprimjereno	None
začeto	Passive
obroci	None
dražoj	None
ispravnih	None
turbulentan	None
pljuvačica	None
suzbile	Active
prevario	Active
hinjen	Passive
iscedak	None
podizan	Passive
splavari	None
solvatacije	None
sasecano	Passive
katoda	None
primećivao	Active
prenijeli	Active
iskvario	Active
kobile	None
ciganski	None
aktivnijih	None
pregovarao	Active
pitani	Passive
povukli	Active
kadili	Passive
žudeo	Active
realizirali	Passive
poznatom	None
zaključio	Active
štetili	Active
simbolizirale	Passive
naknađivani	Passive
letve	None
zmijske	None
alarme	None
dozivao	Active
romaniziralo	Passive
pojedinca	None
rasipao	Active
sačinjavale	Active
okruživalo	Active
bambusov	None
nomadske	None
brojene	Passive
usporen	Passive
ljuštio	Active
prikupljeni	Passive
isticale	Active
zatvorene	Passive
razvrstao	Active
naljutili	Active
sabili	Active
rezultiraše	None
napali	Active
dočekali	Active
filom	None
ćelava	None
povučeni	Passive
kiptjelo	Active
osvetili	Active
tumačeni	Passive
striptizetu	None
posvećene	Passive
najraskošnijih	None
potpisivali	Active
privoleo	Active
punjeno	Passive
odmaknuti	Passive
prevarili	Active
bogohulno	None
ručao	Passive
pojavili	Active
krčili	Active
kulama	None
okusio	Active
ispisao	Active
brojniji	None
uništio	Active
luftirajmo	None
nametalo	Active
pridobivalo	Active
hoteli	None
rešio	Active
protjecan	Passive
utemeljene	Passive
opsjedan	Passive
htelo	Passive
ovjenčao	Active
pelìkān	None
farbali	Active
prestravljeni	Passive
premlaćivani	Passive
pričao	Active
najsvesniji	None
sačinjene	Passive
strašnu	None
govorili	Active
podmićivane	Passive
opozvan	Passive
neefikasnim	None
školstvu	None
prepuštene	Passive
sjevernoameričkom	None
rabljene	Passive
sprovođene	Passive
nadživjeli	Active
mjestu	None
iscrpljeni	Passive
rođen	Passive
računalima	None
posadu	None
republičkom	None
uzbudio	Active
prisiljavani	Passive
nacionalnom	None
luksuznih	None
nagovorile	Active
zahvaćen	Passive
mladunčeta	None
oporezivano	Passive
paranoičnim	None
dopunjavan	Passive
školovao	Active
talasi	None
brinuli	Active
izdavalo	Active
speleolozi	None
dȃrom	None
umetnute	Passive
saveznici	None
ukinuo	Active
nastavljeni	Passive
sproveo	Active
prepodneva	None
podobnijih	None
prolamalo	Active
naslutio	Active
riješili	Active
prošireni	Passive
popratnih	None
nalomile	Active
predstavljen	Passive
zadrugari	None
poboljšalo	Active
obrnute	Passive
potkupljivali	Active
stavile	Active
domišljatim	None
prebačeno	Passive
utemeljeno	Passive
savetovao	Passive
sagradile	Active
opisan	Passive
spajali	Active
svileni	None
uživale	Active
unosilo	Active
učinjeno	Passive
opovrgao	Active
zaključeno	Passive
prekršili	Active
eksplozivna	None
zaostao	Active
umovale	Active
najškodljivijemu	None
potopile	Active
ceđeno	Passive
namenjene	Passive
podeljene	Passive
prepisivao	Active
zavezali	Active
posjedovalo	Active
potrčale	Active
škopljen	Passive
vlažnom	None
skraćivao	Active
iskali	Active
porasle	Active
sačuvan	Passive
odrezani	Passive
pomirio	Active
raniji	None
naseljavani	Passive
аљкавији	None
vjerio	Active
braka	None
gađalo	Active
ulagivalo	Active
prelijetano	Passive
otputovali	Active
gradili	Active
konzervativnim	None
ostvarene	Passive
slavljeni	Passive
spaljivale	Active
progutane	Passive
polomili	Active
hercegovačkom	None
protjeran	Passive
popularizirao	Passive
napuštale	Active
klan	Passive
zavarao	Active
opteretili	Active
situacije	None
posećen	Passive
otopljen	Passive
mirisao	Active
obeštećivane	Passive
završavano	Passive
obješen	Passive
miješani	Passive
kvartalnu	None
nastanjivale	Active
isplaćivan	Passive
izračunavane	Passive
posjetilo	Active
gnjije	None
klicali	Active
osnovale	Active
uklonilo	Active
lile	Active
nadahnuo	Active
nastojalo	Active
rukovodili	Active
ionosferom	None
smanjivao	Active
promašili	Active
pojurio	Active
prelomljeno	Passive
izvađen	Passive
sumnjičeni	Passive
izbačeni	Passive
vjerovníka	None
vezene	Passive
animirane	Passive
opovrgli	Active
ubrzale	Active
artiljerijska	None
prevladavale	Active
smanjili	Active
poslan	Passive
useljeni	Passive
razdvojeno	Passive
priznali	Active
težilo	Active
sazrelo	Active
tiskani	Passive
izobličen	Passive
pronalaženi	Passive
oličene	Passive
zastali	Active
opljačkani	Passive
podrazumijevao	Active
navikavane	Passive
sinteze	None
dendrokronologija	None
tipka	None
borio	Active
otpuštene	Passive
papirusi	None
najnezahvalnijemu	None
postizalo	Active
zaspale	Active
razveseli	None
toplinom	None
dospjelo	Active
kromirao	Passive
razorene	Passive
zapreminom	None
pogođene	Passive
određeni	Passive
popratilo	Active
zaredavalo	Active
prezimenu	None
plodio	Active
odazvalo	Active
primijenjene	Passive
izvukle	Active
halucinira	None
isporučeni	Passive
sasečene	Passive
zadesili	Active
potpredsjedniku	None
dospeo	Active
isporučivao	Active
obuhvatili	Active
svrstavale	Active
onečišćene	Passive
prenijelo	Active
obilježavan	Passive
fetišizmom	None
inspirirali	Passive
zamenio	Active
prekršen	Passive
uskraćeni	Passive
otrovao	Active
financirani	Passive
verižnoj	None
isplatio	Active
pratilo	Active
rascijepio	Active
poludio	Active
ispravljalo	Active
raseljen	Passive
stizani	Passive
биљоједски	None
zaustavljali	Active
dosegnule	Active
uračunati	Passive
podije	None
bogatije	None
ubojico	None
najeo	Active
pregrijane	Passive
preminule	Active
posvećivani	Passive
punoj	None
naricale	Active
primarni	None
ocjenjivao	Active
pojednostavnjivane	Passive
krstarili	Active
omogućavane	Passive
naslagama	None
nacrtano	Passive
hrabrio	Active
isječen	Passive
eksplodirao	Passive
cvetalo	Active
prebrodili	Active
nasukane	Passive
odgodilo	Active
kaligrafija	None
kamenuj	Active
poboljšani	Passive
turbinska	None
podčinio	Active
računaju	None
osnovali	Active
hranile	Active
vlaže	None
osiromašeni	Passive
ttvene	Passive
temeljene	Passive
prekrivalo	Active
pomicao	Active
predstavljano	Passive
laćao	Active
plaćane	Passive
davan	Passive
najsavremenije	None
vješalima	None
porumenjeste	None
zaštićeno	Passive
odvilo	Active
nahrane	None
glasilo	Active
potpredsednice	None
raspali	Active
isticao	Active
razumele	Active
odjahivao	Active
odazvao	Active
nemalo	Active
jednosmjerni	None
javljale	Active
raspite	None
šalvara	None
zaustavljao	Active
regionima	None
raspoređeni	Passive
normaliziraj	Active
odrođene	Passive
urešen	Passive
izbacivao	Active
zgušnjavalo	Active
potrošile	Active
zlostavljano	Passive
žalbi	None
ostacima	None
provodile	Active
apsolviraj	Active
dokazan	Passive
претходни	None
dopušteni	Passive
pljačkaškome	None
izgledalo	Active
zabeležile	Active
skraćen	Passive
zloglasnu	None
zadesilo	Active
nenormalnom	None
odnošen	Passive
pomaknute	Passive
najsvrhovitija	None
detektirao	Passive
nadživeli	Active
otvoreni	Passive
bubnjao	Active
uspostavljane	Passive
ohrabrilo	Active
zalazak	None
tòksīn	None
primetili	Active
obziran	None
besavesni	None
klizilo	Active
popisivao	Active
izbegavali	Active
slobodoumnim	None
izgradnji	None
bojile	Active
bankrotiralo	Passive
ustanovilo	Active
sjedinile	Active
počinjete	None
pomaknule	Active
usmjereno	Passive
hoćemo	None
primoravao	Active
sjedinio	Active
guske	None
brkaj	None
gurnulo	Active
astrobiologije	None
sazvali	Active
koherentnim	None
dijalozima	None
nedostajalo	Active
kucam	None
promaknulo	Active
polazio	Active
kesilo	Active
raširivali	Active
odabrao	Active
priznavao	Active
uspijevalo	Active
istraženo	Passive
zubima	None
podražajem	None
uručivao	Active
zanimalo	Active
novozelandskom	None
kopačice	None
razvodnjavao	Active
pratnji	None
saksofonista	None
svijest	None
ocijenjeno	Passive
dospio	Active
zabilježio	Active
utajeno	Passive
ulagale	Active
polagano	Passive
pojačane	Passive
habale	Active
eparhijskih	None
upućeni	Passive
letka	None
srebrenoj	None
preneli	Active
vađen	Passive
silovale	Passive
najkorenitijima	None
upravljan	Passive
plodnoga	None
topao	None
uvežbavao	Active
šokirali	Passive
prikrivani	Passive
zloupotrijebio	Active
otkazani	Passive
branile	Active
šiljen	Passive
slomljene	Passive
ostajao	Active
prevrnuti	Passive
haram	None
porušili	Active
brinule	Active
nacionalnoj	None
novogrčki	None
usele	None
izazvale	Active
mliječnih	None
napravljeni	Passive
izlučio	Active
izgubljene	Passive
paradirali	Active
podčinjen	Passive
ulomci	None
obilazio	Active
zaljubljivano	Passive
brijali	Active
sastali	Active
restaurator	None
orgiju	None
nahvalio	Active
izolirao	Passive
parnoga	None
izbrisao	Active
plovno	None
nadograđene	Passive
dočekivali	Active
sprečeni	Passive
uvaženi	Passive
prekrivane	Passive
uzgajao	Active
pokrenuo	Active
oslobodili	Active
ugrizete	None
usporavale	Active
točnijim	None
smiruju	None
opredijelio	Active
iskopalo	Active
diskordijanizma	None
uvježban	Passive
zatvoreno	Passive
pobijeno	Passive
pomiješaj	None
posvetili	Active
skidalo	Active
prikazivale	Active
prozirnim	None
obdareni	Passive
zagorčavano	Passive
izlaske	None
zlobno	None
iskrcavan	Passive
strašilo	Active
sklerozom	None
nabrane	Passive
приватни	None
prevladavano	Passive
profitirao	Passive
dostavio	Active
ispunjen	Passive
odjeljenju	None
podržan	Passive
tiskom	None
neodgovornih	None
odnesu	None
istokrvnoj	None
smatrao	Active
riskantne	None
romanska	None
ispao	Active
izračili	Active
enigmatičnoj	None
otuđivao	Active
savetodavno	None
rezu	None
iskale	Active
kreirale	Passive
rasterali	Active
razmotrili	Active
prsnulo	Active
prijelaznoga	None
jeftine	None
koalicijama	None
preplovile	Active
mošnje	None
angažirao	Passive
usvajali	Active
mače	None
papuče	None
odmerilo	Active
meo	Active
izbjegavao	Active
propagandnoj	None
mljevene	Passive
žitom	None
pileta	None
godovima	None
prekidao	Active
zbivao	Active
egzistencijom	None
prisustvovao	Active
izbrisalo	Active
zetovi	None
zloćudne	None
delovanje	None
deljeni	Passive
taksama	None
raspolovljen	Passive
slušane	Passive
prevagnuli	Active
gađan	Passive
prevladavao	Active
izuzimalo	Active
знаменити	None
sjebao	Active
bočna	None
raseljene	Passive
protjerivani	Passive
ometani	Passive
klupske	None
rešeni	Passive
device	None
pripovijedao	Active
plasirali	Passive
poništene	Passive
ponižavali	Active
visokom	None
ozonski	None
pokrili	Active
objedinjavalo	Active
bošnjački	None
pretukle	Active
žeto	Passive
izopačeno	Passive
osudili	Active
izišlo	Active
dopunio	Active
popravljeni	Passive
pobjegnite	None
presretali	Active
probojne	None
ostvarivale	Active
poslednji	None
sabrani	Passive
brežuljke	None
visio	Active
kvalitetnoj	None
okivane	Passive
sumnjičio	Active
nacionalne	None
čitan	Passive
zakazale	Active
nadahnuto	Passive
šizofrenije	None
testirali	Passive
brodogradilišta	None
sastavnome	None
tražio	Active
zaostalo	Active
nastavljali	Active
odbačene	Passive
strogu	None
ciljano	Passive
izazivali	Active
koristile	Active
predjelu	None
kalupi	None
opovrgnuto	Passive
stampedo	None
obračune	None
spadalo	Active
nagnuto	Passive
izbacivale	Active
smirene	Passive
ustupili	Active
izmicao	Active
doplovio	Active
preplivao	Active
glagoljale	Active
cepnut	Passive
sklopilo	Active
uništile	Active
zapošljavani	Passive
glasovalo	Active
izvršeno	Passive
izgorele	Active
pomagao	Active
izda	None
heroína	None
njušci	None
otopljene	Passive
izložile	Active
gramatičar	None
podsjetili	Active
zabranjeno	Passive
bukirasmo	None
pritisnuti	Passive
figurativno	None
kucu	None
bubnjari	None
ostavljale	Active
melodičnijih	None
posvećivale	Active
brecale	Active
hlađen	Passive
prozvani	Passive
zaključili	Active
opseo	Active
naseljavale	Active
monopoli	None
kobni	None
gledalo	Active
probijale	Active
kultno	None
htjele	Passive
poklonilo	Active
zarađivalo	Active
ugušilo	Active
pređeni	Passive
prepadali	Active
obradovani	Passive
najzloglasniji	None
oduzeti	Passive
prošetali	Active
vijetnamskomu	None
slabljah	None
šuman	None
zakasnili	Active
nagnuti	Passive
prdjeli	Active
garantovalo	Passive
pretrpjeli	Active
ostavljali	Active
ružom	None
apsolvirao	Passive
pobedili	Active
oduzelo	Active
moralni	None
ciknute	Passive
fascinirale	Passive
otkriveni	Passive
posjetile	Active
izdavao	Active
slale	Active
mile	Active
ujedinile	Active
obogatilo	Active
spol	None
dostigli	Active
bjesne	None
molitvi	None
nevještome	None
sapinjan	Passive
dodijeljeni	Passive
ciljane	Passive
rasuo	Active
lepljivim	None
naklonjen	Passive
iznenađeno	Passive
shvaćeno	Passive
nasleđene	Passive
nagovoren	Passive
grebli	Active
levice	None
opredjeljivane	Passive
realističkom	None
remećen	Passive
kovertirao	Passive
zapamćene	Passive
suzbijen	Passive
zavodio	Active
prodavano	Passive
nadvisio	Active
prepisane	Passive
mućeni	Passive
predale	Active
ometali	Active
nastavile	Active
zastrašen	Passive
narativnu	None
usisivača	None
samopouzdanjem	None
borile	Active
zapitali	Active
plašljivi	None
priznavalo	Active
odbilo	Active
razvili	Active
nagovijestio	Active
blagostanjem	None
dozvoljene	Passive
ždrijebom	None
smrzotina	None
visinske	None
prikupio	Active
osvanuli	Active
polaskale	Active
odobrili	Active
pobedilo	Active
abolicijskoj	None
planirali	Active
objavile	Active
ponovio	Active
patrolom	None
lateralno	None
kònjem	None
federacije	None
kočijama	None
postupnijih	None
najsuvremenijim	None
odobrio	Active
prepoznavali	Active
izvađeno	Passive
krojeno	Passive
mehaničke	None
počinjalo	Active
sužavan	Passive
povratili	Active
krolavani	Passive
postali	Active
spaljeno	Passive
celovitu	None
dogodile	Active
delovima	None
nošeno	Passive
mučilo	Active
tačne	None
horoskopski	None
dizalica	None
drznuo	Active
dida	None
zaposlenicima	None
sukobljavalo	Active
dopremali	Active
šipci	None
otpusti	None
zabrinute	Passive
promijenio	Active
cvalo	Active
odbranile	Active
izabirali	Active
najrezistentnijemu	None
ukradene	Passive
krojio	Active
povezali	Active
ohlađeno	Passive
izbegavao	Active
zalazio	Active
ponašali	Active
donosile	Active
traktat	None
iskoristile	Active
stupili	Active
golim	None
tapeta	None
posredovani	Passive
razasipani	Passive
odbijao	Active
razlikovali	Active
rezultirali	Passive
pružali	Active
mirimo	None
arhitekturi	None
izostavljene	Passive
dosadno	None
odijelili	Active
zaredali	Active
proverili	Active
kazneno	None
odškrinulo	Active
obilo	Active
odabrale	Active
glazbenikom	None
zacaklilo	Active
dodaju	None
predvođeno	Passive
rekonstruirao	Passive
popunili	Active
semafori	None
napominjemo	None
privikavamo	None
razlikovalo	Active
prijavljene	Passive
rekonstruirali	Passive
ujedinio	Active
neaktivnijom	None
ugroženosti	None
razuverilo	Active
korelacije	None
bičeve	None
razaslane	Passive
izložen	Passive
vežbani	Passive
vezivalo	Active
zvezdicom	None
elegantnim	None
apsorbirao	Passive
teološke	None
sidra	None
rojalisti	None
zaštićeni	Passive
obilazile	Active
određivalo	Active
posjekao	Active
konceptualne	None
bugarskim	None
pritisnute	Passive
medvedi	None
nasledih	None
usidrene	Passive
serijskim	None
odijeljene	Passive
upravljane	Passive
križevačkom	None
dostigao	Active
izbalansirale	Active
razmijenjeni	Passive
carinika	None
lovljeni	Passive
populaciju	None
dorade	None
ikavski	None
tamnoputim	None
sagibano	Passive
pokoravali	Active
stopili	Active
sačinjeno	Passive
umetan	Passive
podrignuli	Active
izgledale	Active
nosače	None
obuhvaća	None
uvučeni	Passive
uočene	Passive
rtu	None
najnižoj	None
izvađeni	Passive
obasuto	Passive
usmjeravani	Passive
izrodili	Active
odlaska	None
pomislili	Active
suhu	None
dirao	Active
leči	None
rascepio	Active
adventistu	None
pobio	Active
pečalbu	None
porušeno	Passive
dekreta	None
prikupili	Active
prikupljale	Active
polijeći	None
usložnjavale	Active
pričvršćivao	Active
ratobornosti	None
progonjene	Passive
spira	None
vrijeđaju	None
nadoknadilo	Active
istosmjerno	None
iskalile	Active
označen	Passive
zaljubljene	Passive
priljubljeni	Passive
napeo	Active
preuzimaju	None
pristizao	Active
razmijenio	Active
odseca	None
dresirao	Passive
svodilo	Active
vezle	Active
iseljavani	Passive
puštali	Active
pozdravili	Active
vratima	None
potezane	Passive
razilazili	Active
psiholoških	None
najintimniji	None
sahranjene	Passive
skandiji	None
participirao	Active
uvredim	None
načinjen	Passive
prisustvovale	Active
osunčane	Passive
obgrlile	Active
srpskohrvatskim	None
potpuniji	None
obešeni	Passive
prevalio	Active
ženevski	None
sukobili	Active
ispisano	Passive
uzgojili	Active
zaveo	Active
prekinut	Passive
odveže	None
prerušeni	Passive
nehumani	None
sklapani	Passive
oduzeo	Active
polomio	Active
razlikovale	Active
rastvoreno	Passive
useljen	Passive
diplomatima	None
konveksno	None
plašilom	None
redatelja	None
procijenjen	Passive
ugrožavalo	Active
poveden	Passive
obilježavalo	Active
odazvani	Passive
svekrove	None
dodjeljivao	Active
zableštili	Active
razbacan	Passive
rastaju	None
magijsku	None
ponovljeni	Passive
poludjeli	Active
sagiban	Passive
režimom	None
jarbole	None
kopali	Active
uzdržavao	Active
navodile	Active
iskusili	Active
arapskima	None
digle	Active
privrženi	None
dražen	Passive
usvajane	Passive
prasnule	Active
lečio	Active
razmišljao	Active
ozlijeđeno	Passive
opozivao	Active
ribarile	Active
zbrinjavan	Passive
podnijelo	Active
začuđen	Passive
administracijom	None
istopljeni	Passive
poboljšale	Active
pripojili	Active
očistilo	Active
osiromašivali	Active
plašilo	Active
teizmu	None
propadao	Active
uvježbava	None
pepeljarom	None
dugovali	Active
šematizmu	None
žvakao	Active
krčkom	None
zbrinuti	Passive
uklonjen	Passive
zagrize	None
glasovao	Active
zaplovili	Active
promijenjene	Passive
konveksnim	None
razočarenjem	None
proširivane	Passive
štitilo	Active
skandalizira	None
sklopili	Active
ubrizgavan	Passive
uspostavili	Active
kovrčavijima	None
snimili	Active
primenili	Active
čekao	Active
blažilo	Active
piscu	None
proizvoljni	None
savinut	Passive
tonule	Active
smrznuo	Active
dočekaju	None
pozicije	None
pretukli	Active
proklinje	None
proizvođačima	None
otopio	Active
zapisao	Active
metaforama	None
sekretar	None
otuđen	Passive
trzajem	None
verene	Passive
začuđeni	Passive
završene	Passive
modernijim	None
koristili	Active
inču	None
morfologija	None
preporučeni	Passive
uočio	Active
mešali	Active
suočeni	Passive
nabavljene	Passive
najoperativnijom	None
rastane	None
tarifni	None
ugasile	Active
nagodio	Active
zadržale	Active
učvršćeno	Passive
diplomatske	None
nametljivo	None
izbjegle	Active
pridobio	Active
širene	Passive
астрономијски	None
labavu	None
ismijavali	Active
pričaš	None
salvadorske	None
obmanut	Passive
žargon	None
sramotne	None
prijateljevao	Active
osnivao	Active
jamčilo	Active
razoružale	Active
parlamenta	None
bežali	Active
proučavale	Active
zabadani	Passive
kovitlale	Active
pobunjeni	Passive
krasile	Active
ilegalnosti	None
osvećivan	Passive
pokretni	None
ugasilo	Active
porađali	Active
školjkama	None
podeljeni	Passive
špotale	Active
bolovali	Active
celine	None
pozdravljeni	Passive
dobročinstva	None
pripravljale	Active
skršili	Active
točnih	None
svlačeno	Passive
naoštrilo	Active
najoblačniji	None
primijetili	Active
ironiji	None
uresim	None
prevladali	Active
menjali	Active
razmjenjivao	Active
mučeni	Passive
zahtijevalo	Active
prekidamo	None
zagrijane	Passive
uspavljivale	Active
kitio	Active
utrošeno	Passive
slijedio	Active
činiocima	None
odjurili	Active
kurio	Active
pokušavalo	Active
osjetili	Active
krumpirom	None
ispitali	Active
alfa	None
neadekvatni	None
uspevale	Active
odvajani	Passive
spajamo	None
istopljene	Passive
zatočili	Active
zatekli	Active
kovale	Active
opstao	Active
salonske	None
popisani	Passive
radioaktivnu	None
pobeđuje	None
grobovima	None
napeto	Passive
odlučio	Active
zrnastu	None
grubi	None
pripremani	Passive
čarali	Active
doseljeni	Passive
nasrnuo	Active
cvjetao	Active
rezonantna	None
iznajmljene	Passive
shvaćane	Passive
načinile	Active
varavijom	None
zavlačen	Passive
zapekle	Active
procenjene	Passive
okruženi	Passive
izbjegli	Active
postavljeno	Passive
glavicom	None
zalazili	Active
okončale	Active
kreativne	None
posječen	Passive
bocnulo	Active
odrađeno	Passive
krvilo	Active
duga	None
rasulo	Active
promišljale	Active
rasprodao	Active
smanjivale	Active
uložili	Active
oštrih	None
sanaciji	None
pohabane	Passive
odvučen	Passive
sređivani	Passive
promenio	Active
prenošen	Passive
rješavao	Active
prosili	Active
razmijenjen	Passive
bolovale	Active
pročitani	Passive
namnažan	Passive
repovi	None
spremaju	None
podgrejavalo	Active
trpelo	Active
istrijebili	Active
osiromašene	Passive
preuzeo	Active
pojačano	Passive
ubacivani	Passive
zvali	Active
prenijele	Active
razoružavali	Active
stradavale	Active
zanemareno	Passive
iskradosmo	None
vodile	Active
predočile	Active
lojalne	None
obnovljene	Passive
katodi	None
oslobodilo	Active
zatalasani	Passive
hijerarhiji	None
zapalio	Active
uvodili	Active
patnje	None
vozilo	Active
upropastili	Active
belkinju	None
intimnosti	None
popunile	Active
okruženo	Passive
neznatnim	None
razumeo	Active
uzbuđen	Passive
umirovio	Active
inženjerima	None
preseljen	Passive
hrsuz	None
brstili	Active
sačinjavao	Active
zaboravljene	Passive
iznenađen	Passive
raščlanjen	Passive
apstrakcijom	None
zasjenjen	Passive
pljusku	None
dvojim	None
zadužio	Active
zvao	Active
proplakivao	Active
noževe	None
utvrđivalo	Active
uplašio	Active
kršio	Active
romanizirali	Passive
zatajiš	None
brisano	Passive
upijao	Active
cjepidlačaste	None
ograđeno	Passive
useljeno	Passive
vršile	Active
utrošili	Active
ruševina	None
peskom	None
raspolagali	Active
nadmašilo	Active
kositar	None
kvantitativna	None
neprecizna	None
obrezano	Passive
iskazani	Passive
zidane	Passive
odgađao	Active
ranjavale	Active
sastajali	Active
naginjao	Active
pobjegle	Active
naoblačio	Active
sanjiv	None
ljekarom	None
primenio	Active
ostavljen	Passive
pokvašeni	Passive
zagospodarili	Active
potvrđeni	Passive
objasnile	Active
vrelo	Active
utopljenika	None
smanjile	Active
koncesije	None
utajivan	Passive
urezan	Passive
zapamtio	Active
šili	Active
rastajalo	Active
pokazalo	Active
uvježbani	Passive
izdavani	Passive
pripisali	Active
zamijenjeni	Passive
večerašnjim	None
proboden	Passive
oličeno	Passive
sažaljevali	Active
prislonjeni	Passive
obavljano	Passive
batinalo	Active
oduzete	Passive
proračunali	Active
ubrzavane	Passive
mislio	Active
prisegnuo	Active
obuhvaćene	Passive
promijenilo	Active
prepucij	None
prognale	Active
primile	Active
smjestili	Active
skandalizirao	Passive
pogođen	Passive
potpuniju	None
monolit	None
mirisnom	None
zvale	Active
preplašen	Passive
planuo	Active
pokazivao	Active
duralo	Active
odgađan	Passive
huškalo	Active
beskompromisno	None
kaznile	Active
ojačale	Active
zatočen	Passive
krepio	Active
monstrum	None
odnosilo	Active
razrušeni	Passive
kaznenoj	None
teglili	Active
razložen	Passive
zatomljivalo	Active
izračunato	Passive
posredovan	Passive
ohrabrivalo	Active
nagrizano	Passive
ufali	Active
radovali	Active
osudilo	Active
prelomilo	Active
školovane	Passive
kenjam	None
potkrijepljen	Passive
kurili	Active
snabdeven	Passive
unakazio	Active
maknuti	Passive
uklinjano	Passive
prestravljivane	Passive
divljanu	None
dao	Active
obukao	Active
uvažavane	Passive
venule	Active
uvučeno	Passive
blagovale	Active
istojezičnoga	None
reagirao	Passive
približile	Active
ambasadu	None
odstranjen	Passive
razneživale	Active
posećivalo	Active
namnožio	Active
štoke	None
postojali	Active
označavao	Active
pridruživao	Active
zakleti	Passive
zahvatilo	Active
pretpostavljene	Passive
zapovedano	Passive
napušteni	Passive
skalpela	None
okrenuti	Passive
prebacuju	None
ponavljano	Passive
ratovali	Active
mestu	None
stradavali	Active
bliskih	None
označavali	Active
združeno	Passive
iskrcane	Passive
naklanjalo	Active
ispostavio	Active
pokorene	Passive
zaustavio	Active
razvaljivan	Passive
raspodjeljivane	Passive
produktivnije	None
zloupotrebio	Active
prevođeno	Passive
osramotilo	Active
lijen	None
utemeljilo	Active
svijećnjak	None
zamjenjivano	Passive
uverili	Active
fleksibilan	None
okupljene	Passive
isticani	Passive
burne	None
pokazivale	Active
rizikom	None
tvoraca	None
pojmio	Active
pokazani	Passive
jednolične	None
istučen	Passive
zarečene	Passive
diktatora	None
procenjivano	Passive
surađivale	Active
naoružavale	Active
izrezan	Passive
svidjelo	Active
razvezivalo	Active
nagovarali	Active
tumarali	Active
liječili	Active
cenjene	Passive
pridonijele	Active
brži	None
preuzimale	Active
vrućinom	None
hapšen	Passive
procurili	Active
vezivao	Active
obeshrabren	Passive
unakažen	Passive
prepisivali	Active
usavršavao	Active
pljuvali	Active
uvriježeni	Passive
služilo	Active
tapiserijama	None
ubrzao	Active
otjera	None
plaše	None
bočica	None
zaglavio	Active
povezivale	Active
izbile	Active
ulazile	Active
vlak	None
pritiskao	Active
rasformirano	Passive
bičevane	Passive
kvantna	None
osjetljivi	None
prikupljane	Passive
okončao	Active
opomenemo	None
procijenili	Active
izrađivale	Active
izvlačili	Active
izrađivane	Passive
crvenili	Active
lovilo	Active
niklo	Active
pričekao	Active
sprovedeni	Passive
udovčevu	None
zaorale	Active
podržalo	Active
otarasi	None
ismijavao	Active
plaćan	Passive
cepnuto	Passive
pobadan	Passive
rasuli	Active
zaleđen	Passive
razgrizlo	Active
okruživale	Active
popisivani	Passive
suočavao	Active
uzrokovao	Passive
tačnom	None
drveće	None
prouzrokovao	Passive
sklanjalo	Active
bȉčāci	None
odjurio	Active
opasnima	None
odeljene	Passive
novembarske	None
privezano	Passive
zaraćeni	Passive
dodavan	Passive
trijumfalna	None
potopljeni	Passive
sitnicu	None
okončali	Active
popravljao	Active
mušterije	None
strizane	Passive
raširili	Active
izvođeno	Passive
ispalo	Active
oborile	Active
kazališno	None
dodirivao	Active
upisan	Passive
iskvareno	Passive
zakasnio	Active
otpadani	Passive
oran	Passive
poticali	Active
strašnom	None
stjecao	Active
zračilo	Active
najneznatnije	None
prepoznate	Passive
mišićima	None
implikaciju	None
gutan	Passive
sramio	Active
ograničavalo	Active
okupljen	Passive
povlačio	Active
analiza	None
nadvožnjaka	None
ohlađeni	Passive
patrola	None
proterali	Active
janjetine	None
borbenijim	None
poslali	Active
napravljeno	Passive
krapinski	None
sanjano	Passive
uvozili	Active
morali	Active
očiglednija	None
učinjen	Passive
veslao	Active
upriličilo	Active
ocenom	None
smanjilo	Active
pokopano	Passive
otklanjane	Passive
štovalo	Active
mučenički	None
većao	Active
venčale	Passive
cijenilo	Active
spojile	Active
prepričao	Active
umetnuo	Active
dominirale	Passive
kakvoću	None
telesni	None
postizao	Active
procenio	Active
pobeđivali	Active
izborili	Active
germanskoj	None
prelistavano	Passive
šivan	Passive
kompromitirano	None
obješeno	Passive
razastrh	None
blažen	Passive
pljačkale	Active
urešene	Passive
zauzeto	Passive
uturan	Passive
zadovoljen	Passive
okrivile	Active
kontrasti	None
pristupali	Active
preprano	Passive
potkopalo	Active
daunloudalo	Active
usredotočismo	None
uzeto	Passive
strmim	None
želi	Active
zagađeno	Passive
izbjegnuti	Passive
namjernu	None
klanjali	Active
najskupocjenijemu	None
senilan	None
usporeni	Passive
priopćeno	Passive
opsedale	Active
napučen	Passive
podizalo	Active
upisivali	Active
štovale	Active
nadao	Active
uporabio	Active
spuštali	Active
pogrbiše	None
ovladali	Active
verovao	Active
krijumčari	None
okrutni	None
ružicom	None
varano	Passive
raširilo	Active
osloniše	None
usmeravao	Active
umito	Passive
beležilo	Active
bran	Passive
mirovalo	Active
nastupili	Active
smjeste	None
korpulentni	None
osporavao	Active
pokrenuto	Passive
ženskom	None
smilovao	Active
krdom	None
punjen	Passive
bacale	Active
deljen	Passive
svjetska	None
žurkama	None
celio	Active
objašnjavale	Active
izgrebli	Active
isteravale	Active
pripadalo	Active
ugođaj	None
skladbe	None
istjeralo	Active
razgaženi	Passive
napadao	Active
pregrejavalo	Active
povećalo	Active
odvojene	Passive
ilustrativnije	None
kažnjeni	Passive
pobedivi	None
angolske	None
najnužnijega	None
četverokuta	None
suncobranom	None
sječen	Passive
odvezao	Active
sastao	Active
harale	Active
uznemiravali	Active
borili	Active
svestrani	None
obavljan	Passive
pokunjen	Passive
osvitom	None
najspecifičnijega	None
stepena	None
spomenute	Passive
prigovoriš	None
brojani	Passive
mekšan	Passive
ropski	None
rasporedile	Active
ugrožen	Passive
svjedoče	None
levoruk	None
autonomnoga	None
odijeljeno	Passive
zbunjivao	Active
odvlačene	Passive
povratio	Active
strašio	Active
isječeni	Passive
ozlijeđen	Passive
govedina	None
dalekòsežnosti	None
prekinute	Passive
popustilo	Active
robo	None
izgledao	Active
procedurama	None
stizalo	Active
objesile	Active
nizak	None
pržene	Passive
primijenjeni	Passive
ispustilo	Active
željeznici	None
izgoreo	Active
uzoravan	Passive
održavano	Passive
nemali	Active
naglašavali	Active
izračunali	Active
nizao	Active
poravnan	Passive
ograničavani	Passive
anakondu	None
vijku	None
upio	Active
darovao	Active
mjesnu	None
istrošeni	Passive
gmizali	Active
projicirao	Passive
nesebičan	None
divovskih	None
diplome	None
progonio	Active
dodijelili	Active
opasan	Passive
zapadnjački	None
izjurio	Active
podrezivalo	Active
suvenira	None
unižene	Passive
upale	Active
osjećale	Active
baljezgale	Active
sakupljen	Passive
uskratili	Active
očinska	None
pojedeni	Passive
nužnike	None
koštao	Active
obrubljeni	Passive
sušeni	Passive
nacionalizmi	None
zadržali	Active
svrstane	Passive
usredotočene	Passive
zameren	Passive
regiji	None
odvijali	Active
odbojniče	None
svrstava	None
predlagale	Active
ćoravile	Active
prošeni	Passive
pridonijelo	Active
okretao	Active
međunarodnoga	None
razglobljivale	Active
razvilo	Active
rođene	Passive
najnepristupačnija	None
spelovao	Passive
ubačen	Passive
svezivao	Active
proslavili	Active
objasnilo	Active
učvrstio	Active
posječene	Passive
spornim	None
samelje	None
izrezali	Active
pretrpele	Active
istjeravale	Active
postavljen	Passive
oduzimale	Active
sređene	Passive
odustajalo	Active
ispravljali	Active
opremile	Active
širilo	Active
zadesio	Active
afroazijska	None
tamnim	None
grebeni	Passive
uplašene	Passive
izrađene	Passive
skvrčile	Active
okupacijom	None
snimalo	Active
zbijali	Active
uzvikuju	None
naumio	Active
efikasnije	None
tucano	Passive
izgubili	Active
preuzelo	Active
liptalo	Active
trenutnu	None
kritiziralo	Active
asteroidu	None
zalagali	Active
licitirao	Passive
trudimo	None
higijeničarko	None
okrenute	Passive
služile	Active
centurija	None
sablasniji	None
označìvāč	None
odsekli	Active
srušile	Active
spuštao	Active
presreli	Active
oterao	Active
tvrdilo	Active
osigurani	Passive
pregled	None
obuhvaćao	Active
povezani	Passive
imenima	None
sreli	Active
tribao	Active
darovani	Passive
osnovano	Passive
ulica	None
opčinjavalo	Active
oplovili	Active
junaka	None
probirljivomu	None
malicioznija	None
opsjednute	Passive
suprotstavili	Active
mleveno	Passive
utemeljen	Passive
dospijevale	Active
ostajali	Active
iznajmljeni	Passive
rizičnu	None
odlikovali	Passive
dopušteno	Passive
istraživao	Active
pomagali	Active
smireno	Passive
prigušeni	Passive
doktor	None
preživjeli	Active
podržale	Active
kiselu	None
uzeti	Passive
zamenili	Active
nadoknadili	Active
vođen	Passive
nosili	Active
otvarali	Active
longitudinalnim	None
budžetirao	Passive
odredili	Active
krili	Active
obrijane	Passive
igre	None
nastavljale	Active
dokučeni	Passive
prožderani	Passive
najtugaljivijom	None
grijao	Active
otkazali	Active
verujete	None
snimljen	Passive
sanduku	None
neolitičkima	None
kapitala	None
obraćali	Active
izručeni	Passive
objedinili	Active
nadimali	Active
postignuto	Passive
martovske	None
zagorčaše	None
trapera	None
sačinjeni	Passive
bližile	Active
pobeđene	Passive
progovarale	Active
izneli	Active
prozirnom	None
zaboravio	Active
otvorio	Active
opisivao	Active
zablejao	Active
pređeno	Passive
višeznačnih	None
održavalo	Active
higijeničaru	None
nakupljeni	Passive
oponašao	Active
ticalo	Active
krijumčarene	Passive
prouzrokovale	Passive
teleskopska	None
zavaravale	Active
propisivani	Passive
pristajalo	Active
omogućene	Passive
ubrzalo	Active
prodani	Passive
obavljao	Active
proučili	Active
izvidio	Active
nepokolebljivom	None
pokušali	Active
upućivane	Passive
sazivao	Active
rezultirale	Passive
pričvrstili	Active
iščupao	Active
ovenčavao	Active
prožet	Passive
zamenjen	Passive
promenjene	Passive
raspravili	Active
pera	None
zadubli	Active
najmnogoljudniji	None
održan	Passive
ulepšalo	Active
pravopisnih	None
podijelili	Active
hvalio	Active
oklevali	Active
pridodali	Active
jurtama	None
potražene	Passive
plasiralo	Passive
gazi	None
raščlanjivane	Passive
sačinjavali	Active
sekle	Active
utješna	None
porekli	Active
objašnjeni	Passive
zgužvalo	Active
doživotnu	None
inherentne	None
otpisivale	Active
korištene	Passive
bježali	Active
lupan	Passive
veslaj	None
proizveden	Passive
čekalo	Active
glasile	Active
otopljeno	Passive
pokazan	Passive
pamtili	Active
prognanici	None
zaštitile	Active
sklopile	Active
brukalo	Active
navođene	Passive
zvane	Passive
cenzurirali	Passive
ispraznio	Active
zabavljačima	None
ogrejavani	Passive
izmjereno	Passive
huligani	None
dostavljao	Active
planiran	Passive
dopunjavali	Active
iskašljane	Passive
prekinulo	Active
otimate	None
smirio	Active
upotrebljen	Passive
stroži	None
civilu	None
pokušavali	Active
obrnuti	Passive
zanemarene	Passive
slavile	Active
opisani	Passive
minimuma	None
rezidencijama	None
nepristrano	None
aerobnom	None
ispitivali	Active
pružao	Active
ograničile	Active
naglašavan	Passive
milu	None
pisano	Passive
željeli	Active
najnadmoćniji	None
miroljubiva	None
slikali	Active
posvećen	Passive
naučio	Active
negovao	Active
pravljeni	Passive
trpjeli	Active
kanalski	None
drobljeni	Passive
nogo	None
pripravniji	None
prosudbama	None
prestajao	Active
autorskim	None
naglaske	None
jezička	None
položile	Active
obimni	None
napadane	Passive
oslabljen	Passive
štedio	Active
sprovedeno	Passive
piti	Passive
viđali	Active
šišan	Passive
osporavani	Passive
izdavali	Active
prerušivani	Passive
sejan	Passive
ponestajao	Active
pripale	Active
proizvodnoj	None
veznika	None
razodjenule	Active
zavolljene	Passive
krležijanski	None
proširene	Passive
jačale	Active
police	None
geologiji	None
umorili	Active
krimićima	None
ponavljao	Active
preporučene	Passive
usredotočen	Passive
složili	Active
suprotstavljale	Active
reciklirao	Passive
doličile	Active
elitnoj	None
napustile	Active
pušteno	Passive
preplašeni	Passive
zabilježili	Active
propisani	Passive
uposlen	Passive
okićeni	Passive
hvalili	Active
izdržane	Passive
udaren	Passive
izdvojio	Active
arogantan	None
usavršen	Passive
personalnih	None
nazdravljali	Active
константан	None
prikazalo	Active
tumačen	Passive
epilepsiju	None
uvežbane	Passive
skraćene	Passive
razrušio	Active
raspona	None
umišljen	Passive
razočarali	Active
zibali	Active
iscurilo	Active
večernje	None
suvremeno	None
podelile	Active
vidike	None
pristiglo	Active
sudelovali	Active
afirmirali	Passive
predočen	Passive
nudili	Active
smeštao	Active
nabavljen	Passive
zabavili	Active
vapio	Active
omogućavali	Active
fante	None
smaknuo	Active
zenica	None
obavešteno	Passive
zavaran	Passive
gledatelju	None
sunule	Active
razdružen	Passive
upoznali	Active
istaknut	Passive
incident	None
razneživao	Active
potpredsjednica	None
nagovešten	Passive
peraju	None
mitraljeze	None
ljepilom	None
slađah	None
pritisnut	Passive
primenjivali	Active
upotrijebio	Active
sredio	Active
opredelili	Active
približnu	None
nepoželjnom	None
triciklom	None
napale	Active
jajovode	None
ujedinjen	Passive
počinili	Active
smaknut	Passive
setio	Active
nadovezao	Active
zaudarali	Active
trujte	None
obmanjujte	None
tjeralo	Active
odgovarale	Active
rezultiraju	None
prostitutku	None
ložnici	None
zakopano	Passive
eshatologija	None
trovali	Active
gladno	None
donosio	Active
torpediraj	Active
upao	Active
poduzele	Active
paljbe	None
oborili	Active
trajale	Active
opravdale	Active
objedinjen	Passive
staklenom	None
renomea	None
seljen	Passive
zanemarivan	Passive
prokrijumčaren	Passive
dominirao	Passive
skijali	Active
izmaknuo	Active
otuđeno	Passive
najnelojalnijima	None
uporišta	None
zauzda	None
ublaženo	Passive
prodavani	Passive
preskočeni	Passive
dodijeljeno	Passive
presuđeno	Passive
razlučivan	Passive
unutrašnjim	None
rubno	None
najpogodnijih	None
popisane	Passive
pretplaćivalo	Active
punio	Active
ponelo	Passive
uvjerio	Active
proširivali	Active
došli	Active
protjerane	Passive
padu	None
bubrezima	None
patogene	None
ideološko	None
šljunkom	None
nepraktičnim	None
mirne	None
grecìzam	None
enigmatično	None
indeks	None
prodirao	Active
pritiskale	Active
smiren	Passive
dolazilo	Active
postupili	Active
osporavano	Passive
demokratijom	None
bledi	None
natjerani	Passive
posudilo	Active
poslužile	Active
odnarođen	Passive
vežbali	Active
spiskovi	None
beknulo	Active
gubio	Active
otjerano	Passive
iskorijenio	Active
kini	None
naišao	Active
smeteno	Passive
objavljen	Passive
nanišanjen	Passive
pretvorene	Passive
joga	None
stvorene	Passive
pozdravile	Active
porekne	None
proricao	Active
srao	Active
spaljene	Passive
savio	Active
udahnute	Passive
uništava	None
dobacivani	Passive
dizale	Active
nadopunjeno	Passive
preživeli	Active
potrebovali	Active
jalovost	None
čuvalo	Active
zadržavan	Passive
podučavaju	None
iskorijenjen	Passive
upravljale	Active
apstraktno	None
bogatašima	None
odrađivani	Passive
označio	Active
uvijali	Active
poduzimale	Active
rastao	Active
sumnjičilo	Active
logorovao	Active
doseljavali	Active
napisao	Active
brane	Passive
proučene	Passive
sviđao	Active
prebacivalo	Active
kraćih	None
primorao	Active
muškom	None
inercijom	None
transformirali	Passive
suprotnih	None
satirički	None
približilo	Active
nasilju	None
suncem	None
očekivano	Passive
učvršćene	Passive
krčkasmo	None
prigovaraj	None
garantirale	Passive
pribavili	Active
ograničio	Active
izašli	Active
lebđah	None
prethodne	None
inertnije	None
prepustilo	Active
dualizam	None
pokrenuti	Passive
pustolovi	None
vijetnamskoj	None
dozvoljavali	Active
razdeo	None
označili	Active
jazbine	None
zamrznuti	Passive
pipe	None
dobivao	Active
objavljivano	Passive
dopustio	Active
zamaknulo	Active
obojeni	Passive
klizali	Active
pògača	None
izmicani	Passive
pokrštavali	Active
odvodio	Active
odlučile	Active
propadalo	Active
raspušteni	Passive
talismanima	None
najudaljeniji	None
bilježene	Passive
pripovedalo	Active
optuživani	Passive
načitani	None
tacne	None
prevremeno	None
dogovaralo	Active
usadio	Active
bazale	Active
izjasnili	Active
izdanje	None
romskoj	None
bilježio	Active
zloupotrebljavan	Passive
razrađivao	Active
poznat	Passive
štavljene	Passive
presekao	Active
uživalo	Active
branjene	Passive
realizam	None
zalijevale	Active
utopili	Active
menjalo	Active
ukrašavani	Passive
obuvali	Active
primenjivale	Active
uvećavao	Active
lekovitomu	None
pristalo	Active
pokidao	Active
crpio	Active
proverio	Active
bilingvalan	None
obmanjuju	None
dodeljivan	Passive
preliminarnom	None
uživao	Active
pobuđeno	Passive
juni	None
tečnost	None
zacementiralo	Active
namočen	Passive
usno	None
epileptične	None
grešnika	None
pripoveđeno	Passive
neustrašive	None
sahranjeno	Passive
pjesmama	None
groznicama	None
predao	Active
rotora	None
posvećivao	Active
nasleđeno	Passive
predočili	Active
iskrenomu	None
kapelana	None
odsijecali	Active
presretan	Passive
sažimale	Active
istjerivalo	Active
razoružao	Active
birani	Passive
odvojen	Passive
sifilisom	None
plaćale	Active
ismejane	Passive
prijema	None
nošeni	Passive
analeptika	None
uništeni	Passive
izdajnikom	None
pȁše	None
otpočivali	Active
biseksualnost	None
slabiji	None
bombardirali	Passive
odricali	Active
snizile	Active
odgođene	Passive
stavio	Active
ponavljali	Active
dočarale	Active
budimpeštanske	None
haramija	None
javili	Active
razoružaju	None
naslikali	Active
odelile	Active
otjeraju	None
unijeli	Active
jačalo	Active
zasmetalo	Active
abecedna	None
odsečene	Passive
ponašao	Active
napredniju	None
ispitivalo	Active
nadjenuto	Passive
smatrate	None
feminizmom	None
opisivali	Active
obuzdavale	Active
štitio	Active
poštovale	Passive
hercegovačku	None
balansiraj	Active
odvojenost	None
dopisivali	Active
zurili	Active
sklonio	Active
ginekologiji	None
ždrijebe	None
buljio	Active
nastajao	Active
delovale	Active
izlagani	Passive
zadate	None
stvorio	Active
krhaj	None
okrivili	Active
učinile	Active
zbližava	None
objašnjen	Passive
podudaralo	Active
potkrepljen	Passive
disidentski	None
humoreskama	None
sunčao	Active
štovao	Active
lopticu	None
sjenica	None
ukazan	Passive
suprotstavljao	Active
obišli	Active
nagovešteno	Passive
podmazan	Passive
usmjereni	Passive
raseda	None
zapustili	Active
izrezbareno	Passive
digli	Active
najplastičnijoj	None
zauzeli	Active
atentatorima	None
sređeni	Passive
odrasli	Active
prerasle	Active
očuvani	Passive
kataloga	None
pretvorili	Active
uručen	Passive
srebrni	None
omogućio	Active
mješovitim	None
bijelilo	Active
izračunat	Passive
bambusi	None
probilo	Active
uhvaćen	Passive
suzdržane	Passive
drmao	Active
smaknuti	Passive
otputovao	Active
bunkerirali	Passive
vršilo	Active
poplašio	Active
podoficire	None
naučili	Active
proglasi	None
grabu	None
miješali	Active
zatražili	Active
bankari	None
ugrožavali	Active
zbivali	Active
poletjeli	Active
kuvalo	Active
kapima	None
ugušeno	Passive
aveti	None
primijećen	Passive
pretpostavljeni	Passive
brojali	Active
razmaženo	Passive
prepisivan	Passive
oboli	Active
sređen	Passive
njujorški	None
preventivnim	None
zabrinuti	Passive
posvetile	Active
zgrnuti	Passive
primijetile	Active
smještao	Active
vojnicima	None
autokraciju	None
proizvedeni	Passive
skinule	Active
desetku	None
zakonicima	None
podsjećao	Active
otrovano	Passive
prisjećao	Active
pakivan	Passive
lišilo	Active
iskušao	Active
zavjet	None
tjerano	Passive
potrajale	Active
plaćen	Passive
isključene	Passive
protjerani	Passive
tvorci	None
istopio	Active
obijali	Active
gojaznih	None
zrako	None
vođeni	Passive
sabrano	Passive
izvještavao	Active
primijenjen	Passive
zatalasavani	Passive
selektivno	None
tučeni	Passive
nadjačani	Passive
dobivalo	Active
povremeno	None
plazile	Active
srnulo	Active
mjerene	Passive
šetačkom	None
obrnutim	None
prkosio	Active
armenskih	None
neredovitoga	None
urezalo	Active
putovali	Active
tragao	Active
ganja	None
spustio	Active
poduzimali	Active
pretučeno	Passive
tribali	Active
primećeno	Passive
ismijavale	Active
naviknut	Passive
raznosio	Active
slutilo	Active
stapali	Active
oduzimani	Passive
artefakt	None
živci	None
okovan	Passive
obrezane	Passive
stabilizacija	None
prenosilo	Active
kreirao	Passive
preporučilo	Active
uroćene	Passive
rađalo	Active
nužnikom	None
kričke	None
rabio	Active
dubene	Passive
ulovljen	Passive
učlanjeno	Passive
preštampano	Passive
zabunom	None
sumnjalo	Active
zavredelo	Active
negacije	None
obrnuo	Active
tvrdokornijima	None
kružio	Active
smočilo	Active
skandalom	None
dorađen	Passive
odobrene	Passive
otklanjao	Active
miješale	Active
suđeno	Passive
namleli	Active
kiselinu	None
dugovao	Active
obuze	None
proglasili	Active
katalizatorima	None
razblaživale	Active
izbušeno	Passive
rezonantno	None
latinskoj	None
globite	None
razotkrili	Active
utešnoga	None
učvršćivale	Active
grozni	None
sabotirao	Passive
ojačan	Passive
pretraživano	Passive
plenom	None
pošao	Active
punomoćje	None
primećen	Passive
upotrebljavalo	Active
izraženo	Passive
delilo	Active
taji	None
opredijeljeni	Passive
utonuli	Active
poduzimajte	None
iskrcali	Active
istraženi	Passive
trojstva	None
asimilirali	Passive
raspisale	Active
držale	Active
podgrijan	Passive
spašeni	Passive
spremao	Active
prepolovljeni	Passive
titlovima	None
sloganu	None
debeljku	None
zašiljeni	Passive
protivio	Active
promenili	Active
branioci	None
snalazili	Active
zamenjivao	Active
kolekcije	None
ostvario	Active
poverio	Active
pripojen	Passive
omotane	Passive
izračunao	Active
zubiću	None
iznuđen	Passive
štampali	Passive
popunjavale	Active
odjevene	Passive
rodnih	None
kročio	Active
prestonice	None
izostalo	Active
prodan	Passive
postavio	Active
dalekozora	None
zbrišu	None
upotrebljavani	Passive
zavlačene	Passive
odlazio	Active
kneževo	None
gramòfōn	None
oduzimao	Active
vježbali	Active
spaljen	Passive
nadogradili	Active
nabreknuto	Passive
podijeljeno	Passive
slavili	Active
imenovale	Passive
čudnim	None
prepušteni	Passive
trbušnim	None
zaustavljano	Passive
jèdinākā	None
rukovali	Active
brojan	Passive
stupljeno	Passive
izračunati	Passive
urađen	Passive
načuo	Active
zatražile	Active
rashodovali	Passive
daljinu	None
pobijedio	Active
razilazio	Active
izručen	Passive
testiralo	Passive
otkrivene	Passive
nateralo	Active
lišio	Active
delili	Active
proračunati	Passive
nadamo	None
simpatizeri	None
proširen	Passive
protjeravani	Passive
probleme	None
izbodeni	Passive
dezertirali	Passive
kinuli	Active
kontekstima	None
otuđili	Active
namenjeni	Passive
naručeno	Passive
pjevalo	Active
dopuštali	Active
sastojale	Active
dogovoreni	Passive
režimi	None
lociraste	None
predstavile	Active
slao	Active
razvijale	Active
prevaljuje	None
stolica	None
buncalo	Active
nesagoriv	None
nalikovali	Active
izgnan	Passive
utapano	Passive
povjerovali	Active
ispuhale	Active
zadovoljene	Passive
nastupale	Active
izbavljan	Passive
obrezivali	Active
prebacio	Active
hvatale	Active
neprijateljski	None
zastrašivali	Active
sisan	Passive
najfotogeničnijom	None
odabrane	Passive
asistirale	Active
pripovetku	None
upotrijebljeni	Passive
pokažimo	None
persirano	Passive
duhovita	None
pokradene	Passive
prigodnih	None
kvalitativnih	None
aglomeracije	None
obrijali	Active
posedovalo	Active
eksplozivnom	None
prikazujemo	None
zadržavao	Active
shvatili	Active
zahtevalo	Active
protečeni	Passive
akademije	None
sjetio	Active
zeki	None
ispražnjen	Passive
probile	Active
snajperisti	None
napio	Active
srbijanskim	None
zaredale	Active
čvorom	None
čestitali	Passive
zasjenilo	Active
osigurale	Active
ekumenizam	None
razoružane	Passive
izvukli	Active
majstori	None
kauzalno	None
istrebe	None
zaustavljani	Passive
ratara	None
pribavlja	None
zasluživao	Active
podijeljen	Passive
odjele	None
sjevernijih	None
nemaštovite	None
ostavljeno	Passive
presađivani	Passive
uvaženo	Passive
uzvisio	Active
isporučeno	Passive
patrone	None
spirano	Passive
ispravna	None
inicijála	None
posađene	Passive
bježao	Active
podudarne	None
složeno	Passive
kolovozu	None
obustavio	Active
pometeno	Passive
usisale	Active
važio	Active
opća	None
isključen	Passive
pojeo	Active
marihuana	None
preračunavane	Passive
vidik	None
spoznalo	Active
prastaroj	None
spasio	Active
nabubrile	Active
kritizirao	Active
ujake	None
halucinogena	None
uvređeni	Passive
pakleno	None
upravljali	Active
pretio	Active
nepoverljivijih	None
oštrile	Active
potrošio	Active
počinio	Active
svojinu	None
milionu	None
osigurava	None
takmaca	None
razuvjeravalo	Active
izgovorio	Active
vezivan	Passive
aludirao	Passive
obukli	Active
polomljen	Passive
pokoravao	Active
popisano	Passive
preprali	Active
otrovan	Passive
prigovorili	Active
neizvesna	None
tematska	None
izazvano	Passive
ubacivali	Active
nestaj	None
odrasle	Active
antički	None
uvideli	Active
sviračima	None
povredili	Active
njakao	Active
pogađalo	Active
zahtevao	Active
proklele	Active
permanentna	None
antilopa	None
izvršnu	None
najnejasnijega	None
sastale	Active
mazalo	Active
pripremio	Active
australijska	None
decembarski	None
sudionika	None
opsesijom	None
izbjegavalo	Active
prethodnim	None
obnovile	Active
srpanjske	None
suprotstavljeni	Passive
izmereni	Passive
zaostajalo	Active
razorio	Active
financirao	Active
otvoreno	Passive
doseljen	Passive
prethodnom	None
prognozirao	Passive
mirah	None
sačekali	Active
udao	Active
bleštah	None
posjećeno	Passive
pomagale	Active
križalo	Active
izvučeno	Passive
izvršili	Active
smese	None
osnovani	Passive
onemogućene	Passive
primećene	Passive
predali	Active
najodsutnije	None
osvežili	Active
pruža	None
povećavalo	Active
poklonio	Active
prekidali	Active
onemogućavao	Active
postidele	Active
snabdeveni	Passive
vraćeni	Passive
potrčali	Active
smazale	Active
otele	Active
ispirali	Active
popraćeno	Passive
ostvarivan	Passive
spalile	Active
nađeno	Passive
zaboravljen	Passive
tendencija	None
utapane	Passive
grešnica	None
nadmašen	Passive
istražen	Passive
sređivale	Active
poljupce	None
optuživale	Active
nabrajalo	Active
zagrlio	Active
doplovili	Active
povezao	Active
pedantno	None
načinili	Active
krijumčario	Active
pridonio	Active
uselili	Active
istrenirane	Passive
shvaćao	Active
premotan	Passive
glavešini	None
otkazao	Active
potapano	Passive
сласнији	None
anđelića	None
ograničilo	Active
saopćivan	Passive
raspodijeljene	Passive
podrazumijevale	Active
primitivni	None
dopuni	None
starici	None
svedòci	None
učile	Active
simulirani	Passive
zagrijani	Passive
odmamljivalo	Active
utoljivani	Passive
ravnao	Active
zadržano	Passive
izoliran	None
prevrtalo	Active
baro	None
odabiran	Passive
nagrdili	Active
lopatu	None
ispatili	Active
posečene	Passive
krugova	None
kopalo	Active
doštampani	Passive
gledano	Passive
premašile	Active
razbijao	Active
zadivljavan	Passive
sirovina	None
smišljene	Passive
spomenuo	Active
najakustičnijom	None
poduzet	Passive
izlečio	Active
raspršeni	Passive
primenjene	Passive
pretvorilo	Active
otvoren	Passive
svirao	Active
ponavljale	Active
pojeden	Passive
biografsku	None
obrisan	Passive
ostavljao	Active
izrazili	Active
diskutirao	Passive
prosperira	None
kompaktnijima	None
ježio	Active
preliminarnoj	None
dovoljnom	None
sumnjivijoj	None
uzrokovalo	Passive
shvaćen	Passive
uspešni	None
drȅk	None
čamotinjom	None
stavljali	Active
realna	None
bivale	Active
umnim	None
poprskavali	Active
učestalost	None
kupovale	Active
zaključile	Active
poseduju	None
teozofskoj	None
uzora	None
ornitolozi	None
skrpljene	Passive
umirovili	Active
pobeljene	Passive
izrečen	Passive
forinti	None
besvijesti	None
pragmatike	None
uvrstilo	Active
napuštalo	Active
zahvaćene	Passive
prognozirali	Passive
zamijenjen	Passive
čuvano	Passive
uhapšen	Passive
klecani	Passive
okružile	Active
zapalilo	Active
uplašili	Active
logorovali	Active
ostvarivani	Passive
prisiljene	Passive
razbio	Active
pronalazili	Active
poduzete	Passive
prikazani	Passive
pandurom	None
podrazumevao	Active
asistirao	Active
ogledao	Active
izbadale	Active
stvoreno	Passive
mučenicom	None
olakšavalo	Active
istoimena	None
izvučene	Passive
združio	Active
oslobađao	Active
trpjelo	Active
zadremale	Active
testa	None
uvažen	Passive
zečevima	None
simbolima	None
uspio	Active
obeshrabrio	Active
cenjeno	Passive
sahranile	Active
babilonska	None
digitalna	None
utrošeni	Passive
pridružene	Passive
nostalgičan	None
smešteno	Passive
neregularnim	None
crtali	Active
neuverljiviju	None
posvetilo	Active
apologeta	None
spremljene	Passive
porušio	Active
probirljiviju	None
prevoženo	Passive
bubalo	Active
popraćivali	Active
usmjeravali	Active
vonjale	Active
odbijalo	Active
atletičarku	None
profesionalce	None
napravio	Active
galerije	None
kriknulo	Active
podijeljene	Passive
štos	None
mišljen	Passive
dopadale	Active
zalevale	Active
mrtvoga	None
zbližili	Active
nateran	Passive
vernih	None
naselili	Active
introspektivni	None
prekidale	Active
prestižnima	None
očekivali	Active
kovane	Passive
najuvjerenijima	None
gospodario	Active
povređene	Passive
snabdevene	Passive
otkrio	Active
naslijeđeni	Passive
upadima	None
jare	None
ispijeni	Passive
smislio	Active
gotovim	None
sirene	Passive
izvozio	Active
žudnjama	None
upotreba	None
akumulirali	Passive
pomazao	Active
novotarijom	None
upućen	Passive
nagradili	Active
davao	Active
motivacijama	None
blizánac	None
sadržavali	Active
venama	None
kriptička	None
losa	None
paljeni	Passive
sagriješili	Active
prénosnīče	None
poboljšanju	None
nemarne	None
javile	Active
izostavljeni	Passive
sušile	Active
nadmašile	Active
odnijele	Active
dodirnuti	Passive
razdraživani	Passive
preoteti	Passive
temeljen	Passive
upadao	Active
broševi	None
predavalo	Active
približavali	Active
apstrakciji	None
otklonio	Active
temeljiti	None
ispatio	Active
apelirali	Passive
ugrizale	Active
životnoga	None
pršut	None
ispisali	Active
tjednima	None
izvedenica	None
iskorenjivan	Passive
anglosaksonskih	None
zaklonjene	Passive
opazili	Active
izdržao	Active
punktualna	None
priliku	None
čeznule	Active
ubijane	Passive
suzdržavani	Passive
paradiraste	None
proširilo	Active
malu	None
mezima	None
stizao	Active
opredeljeni	Passive
gušenju	None
dostupni	None
istjeran	Passive
oponaša	None
rezultirao	Passive
nabiran	Passive
gospodarsko	None
razvojima	None
sunčan	Passive
odgovorile	Active
lečene	Passive
frendicama	None
primetni	None
hranjene	Passive
propovedaonicu	None
prekrivale	Active
незамислив	None
linčovali	Passive
obavezna	None
zevao	Active
trebali	Active
izdali	Active
nerođene	None
potražilo	Active
stabilizacije	None
okitio	Active
poverili	Active
faktično	None
slabima	None
prolistavani	Passive
zabio	Active
angažirali	Passive
podelio	Active
okrenuli	Active
pojačavani	Passive
pruženi	Passive
odbranjene	Passive
poverovao	Active
sjemenku	None
umirovilo	Active
iznuđeno	Passive
predloženi	Passive
nabit	Passive
zaštićen	Passive
overene	Passive
akumulirale	Passive
ispustio	Active
udarale	Active
uspostavljali	Active
odsečeno	Passive
osvanuo	Active
uozbiljeno	Passive
ugašeni	Passive
odljutilo	Active
zamenjivalo	Active
poreklo	Active
premašilo	Active
služeno	Passive
sipali	Active
zahvalio	Active
cenili	Active
odmaknuo	Active
posekli	Active
kličite	None
povezivani	Passive
dostignute	Passive
pretrpeo	Active
uputio	Active
svećama	None
kreveljah	None
pripovedali	Active
izazivale	Active
uloženi	Passive
trven	Passive
opravdane	Passive
prošlogodišnji	None
središnjim	None
ikavske	None
svrstavan	Passive
polagao	Active
dičile	Active
podmukli	None
otkazivali	Active
detaljem	None
obrađivani	Passive
raspoloženi	Passive
naseljen	Passive
životnim	None
sustigao	Active
namicao	Active
potkrijepio	Active
jada	None
malinu	None
proučavao	Active
susretali	Active
kavkaske	None
dijagonalnu	None
podržali	Active
poslužen	Passive
ocijenjeni	Passive
impregnirali	Passive
osigurali	Active
predavani	Passive
kukce	None
hranjive	None
filmu	None
uvjeravam	None
млади	None
osiguravao	Active
uzletio	Active
katom	None
pokopao	Active
preoteo	Active
fokusu	None
protjerivali	Active
oponašali	Active
diktirao	Passive
pokazivane	Passive
izgovorili	Active
zamislio	Active
isplivale	Active
izbečeni	Passive
profitom	None
uvojak	None
svršetak	None
nezadovoljni	None
poštovao	Passive
pogodile	Active
povrijeđene	Passive
izmišljaš	None
otkopavani	Passive
očarao	Active
zaceljivao	Active
treniralo	Active
ulagali	Active
planirao	Active
pripišu	None
sanducima	None
obogate	None
preseljavali	Active
vodio	Active
propijalo	Active
zapošljavale	Active
nominiralo	Passive
delovali	Active
pripisivani	Passive
zvučnoga	None
spekulirali	Active
usredotočeno	Passive
unele	Active
udarili	Active
unio	Active
lutalice	None
unakaženo	Passive
razmatrano	Passive
počeli	Active
cjepidlačilo	Active
snižavani	Passive
zamišljeni	Passive
dočekani	Passive
izradile	Active
udružene	Passive
ugradili	Active
nagrađivan	Passive
izumio	Active
zaslužio	Active
završavali	Active
naturalna	None
pravljen	Passive
posjećivalo	Active
položaju	None
odan	Passive
bdije	Active
preseljavaju	None
dičili	Active
kuko	None
iskušavao	Active
zaprezane	Passive
ukrašavao	Active
proslavile	Active
svezani	Passive
uklonjene	Passive
prevladalo	Active
križarskoj	None
pogrešili	Active
razdražen	Passive
kritizirani	Passive
izgrađivan	Passive
neodoljivom	None
zacelile	Active
razdražili	Active
očuvali	Active
raspletalo	Active
skrasili	Active
smislili	Active
srušili	Active
osumnjičeni	Passive
posadio	Active
smeš	None
skijao	Active
bilateralnim	None
kaznilo	Active
objelodanjeno	Passive
lokale	Active
pjevane	Passive
voskove	None
zidao	Active
porušene	Passive
nadjenut	Passive
obešeno	Passive
papak	None
isušio	Active
angažirale	Passive
komuniciralo	Passive
naslijedili	Active
studenta	None
ocjena	None
crpljeni	Passive
priljubljivano	Passive
napunili	Active
doradio	Active
iselili	Active
separiralo	Passive
rukavičari	None
progovorilo	Active
fizičarom	None
odbijeno	Passive
glomazno	None
derasmo	None
otkopao	Active
predavale	Active
prokopali	Active
strože	None
distorzije	None
visili	Active
odlikuj	Active
dijelile	Active
lavinom	None
nautičkim	None
iseljene	Passive
odlazile	Active
spremili	Active
prosvjedovao	Passive
krvožedni	None
promašivalo	Active
svidelo	Active
provokativniji	None
podrezivali	Active
najkomfornijima	None
izostavljen	Passive
ministara	None
namijenio	Active
sukobljavao	Active
polomljene	Passive
označavalo	Active
trgovao	Active
proučavali	Active
zatečeno	Passive
pazarnoga	None
osvećen	Passive
starijega	None
izrodilo	Active
poznavali	Active
lili	Active
približio	Active
radovao	Active
zaostajao	Active
raspodjela	None
šuplja	None
seoca	None
rastjerao	Active
pogledao	Active
kontrasta	None
suptilna	None
obećali	Active
zapisivao	Active
uklanjali	Active
sastavljali	Active
test	None
naslanjao	Active
primedbom	None
uvozio	Active
gramofonskim	None
klikeru	None
važili	Active
suprotstavilo	Active
iskrvario	Active
predavao	Active
zagrljene	Passive
zatekle	Active
ocenjen	Passive
tražile	Active
uticalo	Active
upotrebili	Active
pilio	Active
htjelo	Passive
kontrarevolucija	None
ispunio	Active
pridonosili	Active
proizvodili	Active
sreo	Active
kulta	None
pobunjeniku	None
brisani	Passive
univerzitéta	None
doznale	Active
povećane	Passive
raspuštene	Passive
militantnim	None
osvježio	Active
kapitulirale	Passive
proticani	Passive
kričale	Active
povlačilo	Active
doživio	Active
izvučeni	Passive
sinapsa	None
ujedinjavan	Passive
dostavljali	Active
dodalo	Active
bralo	Active
svetina	None
rešetane	Passive
dešavale	Active
zamenjeni	Passive
proradio	Active
uprljalo	Active
gorskih	None
ciganilo	Active
objasniš	None
raščlanjeni	Passive
jutrio	Active
riješeni	Passive
skrenut	Passive
odsjekoste	None
preokreta	None
šetao	Active
proterivani	Passive
batinani	Passive
epidemijski	None
utvrđene	Passive
upropastile	Active
sličili	Active
urađeno	Passive
smotrilo	Active
snabdevajmo	None
stupio	Active
oživelo	Active
odleteli	Active
obličjima	None
usporilo	Active
dirali	Active
hvaljen	Passive
idolopokloniče	None
podgrizali	Active
crtano	Passive
prozvali	Active
najprofesionalnije	None
silnija	None
zaplivale	Active
silazak	None
prisjetili	Active
uključili	Active
kažnjene	Passive
uzvikivali	Active
opčinjene	Passive
nailazile	Active
razdijeljene	Passive
izostali	Active
uzbuđeni	Passive
osakaćeni	Passive
poboljšao	Active
sporazumijevale	Active
vjetrobrana	None
objesio	Active
transverzalne	None
porobljene	Passive
pigmentu	None
oživljavao	Active
raspom	None
prenošeno	Passive
podsećali	Active
sladoledu	None
kućnu	None
armiji	None
napadnute	Passive
tro	Active
zbirci	None
bajnim	None
odvijale	Active
pomešan	Passive
preotimani	Passive
bacače	None
oružali	Active
viđao	Active
okružili	Active
projiciralo	Passive
mozaika	None
gladile	Active
đavlom	None
spadao	Active
gradile	Active
obrnuto	Passive
rabili	Active
poprimale	Active
pobornik	None
obustavilo	Active
kalili	Active
istjeravao	Active
veselu	None
građen	Passive
pristojno	None
depopulacijo	None
zaprošeno	Passive
takmičilo	Active
dokazivalo	Active
opozvali	Active
varane	Passive
safera	None
zakonskih	None
klečali	Active
iznajmile	Active
asu	None
himeru	None
pokušavao	Active
birokracija	None
optužilo	Active
pite	Passive
najsevernijemu	None
zadan	Passive
zakopane	Passive
poštovali	Passive
privelo	Active
uklonjeni	Passive
iskazali	Active
uputili	Active
ščepavano	Passive
uvrstile	Active
rušili	Active
zgusnut	Passive
krikom	None
proizvele	Active
prepadnuto	Passive
snimale	Active
obuveni	Passive
obuzet	Passive
zalagale	Active
zgrejavane	Passive
sprečavalo	Active
nadimani	Passive
promijenjen	Passive
iznijeli	Active
telefonirale	Passive
održavale	Active
izostale	Active
ubijale	Active
neutralizirao	Passive
ustane	None
dodano	Passive
inaugurirale	Passive
poručnik	None
preduzeća	None
vezivane	Passive
uspješne	None
razrušene	Passive
blaženi	Passive
propovedani	Passive
slovu	None
prozivali	Active
poštedjeli	Active
usvojili	Active
uporabile	Active
nepropusne	None
zatvarao	Active
gubilo	Active
neopravdana	None
pričinjeno	Passive
pritiskali	Active
iskopavao	Active
flertuju	None
lilo	Active
izbečio	Active
svučeno	Passive
smišljeno	Passive
rukotvorinama	None
propovijeđu	None
poremećuju	None
ublažene	Passive
osporili	Active
prenošeni	Passive
plasmana	None
sjede	None
osvojeno	Passive
obrazlagao	Active
prisutni	None
razdvojili	Active
pozdravljane	Passive
gostioničara	None
spaljivani	Passive
medicinski	None
konobarice	None
riđobrade	None
izbacivalo	Active
pripremljeni	Passive
svečanoga	None
uznemireni	Passive
pristupe	None
prekršio	Active
kućicama	None
zatečen	Passive
trgovali	Active
sputavalo	Active
preformulirah	None
sastavljane	Passive
iseljavalo	Active
izlomljene	Passive
palio	Active
unutarnje	None
ganjao	Active
uvijan	Passive
svršeni	Passive
činjeni	Passive
određivali	Active
prožimao	Active
mehuriće	None
isplovile	Active
srpski	None
sažalim	None
skvrčeni	Passive
militantni	None
očiste	None
tešilo	Active
sklopiš	None
vrteli	Active
osjetilo	Active
zauzeti	Passive
anamnezu	None
otvorile	Active
učvrstili	Active
anektirao	Passive
ukrao	Active
dojile	Active
ustrojeni	Passive
štovane	Passive
nadležnom	None
smješteno	Passive
doselile	Active
sanjao	Active
meteorografi	None
preradile	Active
najinteresantniji	None
caričinom	None
dijelio	Active
nostalgije	None
topić	None
tiskano	Passive
pohvalio	Active
poravnavalo	Active
maknut	Passive
uličicama	None
postavljane	Passive
protekli	Active
ubo	Active
verovale	Active
razasuti	Passive
intuiciju	None
slutio	Active
vidljivu	None
doživele	Active
uzoru	None
hrvatskih	None
naučnici	None
radoznalost	None
škrti	None
dodeljivali	Active
usporene	Passive
oženio	Active
nacionalizam	None
stenjali	Active
prorekao	Active
dekontaminacijama	None
nastanili	Active
utovara	None
smrznute	Passive
embrijima	None
najbogatija	None
mljeveni	Passive
sjedinili	Active
humane	None
cvrkutalo	Active
gaj	None
artikulirao	Passive
regrutirale	Passive
obitelji	None
rascijepljen	Passive
administratorima	None
rešetani	Passive
poručili	Active
utekle	Active
prepisao	Active
čudesnoj	None
amaterskim	None
mlitavce	None
zaklinjao	Active
predočeno	Passive
konvencionalnijemu	None
paraboličnim	None
uzorimo	None
dlanu	None
naoružan	Passive
izgradile	Active
najznačajniji	None
povećani	Passive
bolovalo	Active
ismijan	Passive
ogorčenost	None
rastopljene	Passive
janjio	Active
potakao	Active
pazarile	Passive
obračunavao	Active
higijeničare	None
ruho	None
jadnika	None
odbranjen	Passive
nagađali	Active
menjale	Active
razmaku	None
okanili	Active
neuspelu	None
pjenile	Active
pisalo	Active
nastao	Active
naseljeni	Passive
ljekovitim	None
ratovao	Active
дражи	None
ispio	Active
povučeno	Passive
kapke	None
cimano	Passive
izjednačio	Active
navozilo	Active
opstalo	Active
udružilo	Active
nadničarku	None
zaokruživali	Active
obilježavao	Active
izveštavalo	Active
hitne	None
brojilo	Active
osiromašeno	Passive
presrele	Active
nizale	Active
proteraju	None
iscrpio	Active
pribijan	Passive
razdijeljeni	Passive
širokim	None
gejevima	None
prikazivali	Active
progonile	Active
smisli	None
obrazložio	Active
umorni	None
preživljavale	Active
sabijene	Passive
izobličile	Active
usmerio	Active
osvježeno	Passive
rukovodilo	Active
tipična	None
izrezano	Passive
kosmonauti	None
oslabili	Active
solidne	None
dokučene	Passive
naklonjeni	Passive
snabdio	Active
proslavom	None
zajedništva	None
nereda	None
isticano	Passive
tvorili	Active
isušen	Passive
praslovenskim	None
žderani	Passive
kritičnim	None
obvezuju	None
plinovitih	None
izbolo	Active
mozaike	None
preslikali	Active
nadjenuti	Passive
neophodnom	None
lociralo	Passive
zahtevani	Passive
prošli	Active
despotu	None
iziskuje	None
shvaćene	Passive
probili	Active
autentičnim	None
singlici	None
dosezali	Active
dostojnu	None
prestigao	Active
uticali	Active
odvojeni	Passive
nasmijao	Active
sucima	None
mnogostrukosti	None
obuhvaćeni	Passive
dokazalo	Active
kolekciji	None
stipendijom	None
obuhvaćalo	Active
dogodio	Active
iziđi	None
uzgajani	Passive
naslikan	Passive
publicirao	Passive
širen	Passive
čekali	Active
bubnjevi	None
porodi	None
tajvansku	None
podrazumevano	Passive
oživjelo	Active
zatrujemo	None
izvodio	Active
predmetak	None
iznosilo	Active
skinu	None
ovlašten	Passive
poplavljen	Passive
proveri	None
ukorijenjeno	Passive
obustavljeni	Passive
izrasle	Active
prikrili	Active
vizama	None
lečili	Active
nalazilo	Active
skrbilo	Active
најсуморнији	None
nagovješćivao	Active
sprovodili	Active
rabljeni	Passive
mramorom	None
preštampavani	Passive
sahranili	Active
odali	Active
špijunirale	Active
pripisao	Active
prestali	Active
antikomunistička	None
preživjelo	Active
sporta	None
procjenjivao	Active
lokalnim	None
uložene	Passive
probdeo	Active
perajama	None
zaboravljeno	Passive
razljućen	Passive
rađene	Passive
porastao	Active
doseljavale	Active
iskazale	Active
ograđeni	Passive
učili	Active
rukopisno	None
umiju	None
melje	None
povećali	Active
transformirale	Passive
osvetio	Active
kažnjavao	Active
rasplamsali	Active
poređenjem	None
crijeva	None
profinjen	Passive
oteran	Passive
mešale	Active
ulepšavao	Active
oblikovalo	Passive
poštuj	Active
proćerdalo	Active
sprijateljivani	Passive
utrošio	Active
čudili	Active
raspoređivao	Active
obradio	Active
katran	None
evra	None
zapušten	Passive
cviljelo	Active
motrili	Active
doživeli	Active
sačinio	Active
opisivani	Passive
podmićeni	Passive
obavijestio	Active
afirmiramo	None
najstrmiji	None
služben	None
uračunaš	None
opredijeljene	Passive
zadržane	Passive
zlostavljane	Passive
micah	None
posramljen	Passive
autopsija	None
cijenjeno	Passive
dobili	Active
odlikova	None
laktom	None
trudile	Active
zver	None
neprijateljskom	None
smatrali	Active
obuzele	Active
nižima	None
rađen	Passive
obesna	None
gospodarili	Active
ograđivao	Active
transformiraše	None
proticale	Active
nadarenijim	None
dane	Passive
razdijeljen	Passive
prigušen	Passive
goveđih	None
prelomljeni	Passive
vodomjer	None
rasprodano	Passive
optužile	Active
prikazivao	Active
foruma	None
dometak	None
potpisao	Active
pomišljane	Passive
bečku	None
prele	Active
izbacile	Active
povredio	Active
zabranjeni	Passive
fiskalnoj	None
pretplatio	Active
borilo	Active
upoznavao	Active
očekivao	Active
topile	Active
proračunao	Active
podrezivane	Passive
koljeno	None
razmenjivali	Active
pravoslavnih	None
preli	Active
intimnom	None
uveren	Passive
navođeno	Passive
blažene	Passive
događao	Active
preprao	Active
obitavalo	Active
indikacija	None
lepota	None
kaspijski	None
izborima	None
istupilo	Active
najshvatljivija	None
obitavali	Active
ugrozile	Active
blažile	Active
potrajalo	Active
pojačao	Active
sudac	None
pitomim	None
дивовски	None
razorili	Active
srpstvo	None
ublažen	Passive
šahovska	None
uvjerile	Active
nepobedivo	None
specifikaciji	None
egzistencijalnu	None
комерцијалан	None
suhim	None
oslobođene	Passive
razmotani	Passive
defekt	None
takmičili	Active
pohlepnijega	None
opsjedale	Active
negirali	Passive
primljene	Passive
služili	Active
curio	Active
prezalogajio	Active
beskrupuloznu	None
savetovali	Passive
modelu	None
primamljene	Passive
pregrejani	Passive
maršalom	None
sagrađen	Passive
suzdržao	Active
poduzeti	Passive
elementarnom	None
bleštili	Active
odvajao	Active
zbrinuo	Active
andorskima	None
režiserima	None
sastavljeni	Passive
odobrovoljivale	Active
sunčani	Passive
napao	Active
predan	Passive
biciklističkim	None
prepričan	Passive
lišen	Passive
telefonirao	Passive
svrstavao	Active
iskazivali	Active
spojilo	Active
neupadljiviji	None
objedinile	Active
bubali	Active
prekršeno	Passive
spojeni	Passive
odnosio	Active
nastupile	Active
ocijenjen	Passive
постојећи	None
traljavima	None
izvođen	Passive
javno	None
zatočeno	Passive
okovano	Passive
poprimljeno	Passive
izvršen	Passive
proizvedene	Passive
ocenjene	Passive
zloćudni	None
čelično	None
dostizali	Active
pridodao	Active
strahovao	Active
uputile	Active
ponovile	Active
razvezivani	Passive
zaradili	Active
primili	Active
izručio	Active
prihvaćale	Active
uplašeno	Passive
razvijen	Passive
obli	None
vježbe	None
pomišljalo	Active
animirao	Active
sažimao	Active
koturani	Passive
istraživali	Active
milostioga	None
oličen	Passive
osnovan	Passive
kružilo	Active
žurio	Active
temeljilo	Active
kamenuju	None
ega	None
plinu	None
najosjetljiviji	None
privedeni	Passive
ismejan	Passive
izrađeni	Passive
sumnjali	Active
ulazio	Active
prebacivale	Active
pridržavao	Active
rodove	None
delio	Active
deobu	None
istukao	Active
arabijskom	None
talijanskim	None
poljubio	Active
propadali	Active
vraćale	Active
pripisano	Passive
akademijama	None
impotentan	None
pile	Active
preskakao	Active
točnom	None
usvojene	Passive
dugovale	Active
snizio	Active
stavilo	Active
erekciji	None
financiran	Passive
rafinirao	Passive
odvukli	Active
turcizmima	None
samljevene	Passive
utovarivano	Passive
krèmšnita	None
vite	Passive
pripremiše	None
iskopao	Active
oklevao	Active
dosegnut	Passive
tepen	Passive
sastajao	Active
skladali	Active
poticano	Passive
nehotičnijom	None
otjeralo	Active
otuđeni	Passive
izvadili	Active
zamerali	Active
otomansko	None
ometeni	Passive
privuklo	Active
legendom	None
osiguravali	Active
nabodeni	Passive
oporavljeni	Passive
obeshrabrile	Active
ocjenjivali	Active
uračunat	Passive
amerikanìzma	None
nametnuli	Active
otopljeni	Passive
ugasili	Active
onemogućen	Passive
rigali	Active
oživeo	Active
vile	Active
pretnja	None
hvalisaše	None
prihvaćali	Active
iznuđivane	Passive
odviti	Passive
ravnateljica	None
okupljali	Active
popunjavaš	None
opsednute	Passive
stegnuli	Active
monotonijoj	None
primilo	Active
trijumfirale	Passive
tranzistora	None
štimano	Passive
odijevao	Active
zahvatio	Active
ječali	Active
pristaše	None
urezano	Passive
najanonimnije	None
breskve	None
koridor	None
čalabrcnuto	Passive
ugroženo	Passive
natjerivani	Passive
pritiskuj	None
lansiralo	Passive
sprečen	Passive
smijenio	Active
dekorativnim	None
koristio	Active
vragovi	None
kaputima	None
izazvani	Passive
naseobinama	None
skucani	Passive
dostavljene	Passive
hvatali	Active
izostajale	Active
presahnuo	Active
raspravljane	Passive
pecan	Passive
zatražene	Passive
označeno	Passive
zabavljao	Active
jednosoban	None
zadivio	Active
vrgnuli	Active
doprinijelo	Active
zagađene	Passive
dospevale	Active
pokvareno	Passive
ozljeđivan	Passive
nacrtani	Passive
zapaljeni	Passive
zanatima	None
sadržaje	None
koherentnom	None
ušli	Active
potomstvu	None
nezakonit	None
upotrebljavan	Passive
potpredsednik	None
lijevane	Passive
raznosiocima	None
zakrvarilo	Active
počinjeno	Passive
preplivavali	Active
pojelo	Active
detinjstvima	None
izobličio	Active
umetnut	Passive
načinjeno	Passive
satelitima	None
obeshrabrivan	Passive
najtoplija	None
prelistavao	Active
izlučile	Active
spljoštili	Active
katoličanstvo	None
objelodanjen	Passive
melo	Active
šarani	Passive
ulazilo	Active
uključeno	Passive
