entenderei	Future
protagonizaria	None
contemplaria	None
fuzilaríeis	None
correi	None
pesaria	None
cresci	Past
eliminem	Present
designou	Past
agouro	Present
clamada	Past
alastrarias	None
sofismardes	Future
liquefazer	None
suborno	Present
supriria	None
liquidas	Present
luzi	Past
murmuradas	Past
postulavam	Past
restringem	Present
chegaríamos	None
aprontada	Past
consultado	Past
instituído	Past
cotam	Present
distorcida	Past
contribuiriam	None
cessaríamos	None
teres	None
reformulemos	Present
melhoraria	None
entrevistará	Future
resvalai	None
sobressaíam	Past
orientaliza	Present
associamos	Present
disputariam	None
nasceriam	None
bombas	Present
nomeiam	Present
elucidando	Present
restariam	None
estarreces	Present
falados	Past
arrancarás	Future
instigariam	None
amalgamados	Past
desonrariam	None
ousa	Present
dessulfurará	Future
ruborizavam	Past
ensombrariam	None
ribombou	Past
recorreis	Present
alentou	Past
acastanharias	None
desativo	Present
estrangulados	Past
pedirem	Future
montaria	None
enchei	None
aguardaria	None
guerreado	Past
careciam	Past
nivela	Present
comendassem	Past
ondulados	Past
salvarmos	Future
acompanharíamos	None
clarifiquem	Present
faria	None
redefinem	Present
derrocados	Past
ladearias	None
sano	Present
rabisca	Present
originaríeis	None
visitou	Past
continuam	Present
penalizaríeis	None
doeríeis	None
transcenderíeis	None
alegavas	Past
saborearás	Future
encontravam	Past
torro	Present
enferrujados	Past
estolou	Past
arrebentado	Past
supõe	Present
julgo	Present
arpoadas	Past
manobremos	Present
misturarmos	Future
defendida	Past
pescada	Past
fizermos	Future
filia	Present
compõem	Present
açacaláramos	Past
deitada	Past
pruiria	None
voaria	None
pronunciam	Present
lutaria	None
debochem	Present
sentirá	Future
divertiriam	None
munirias	None
emparelhada	Past
romperia	None
atingiriam	None
suspiro	Present
violariam	None
trucidada	Past
arroxeadas	Past
vasteis	Present
irradiadas	Past
protegeriam	None
podíamos	Past
rotarmos	Future
reconcilia	Present
reverem	None
hibridizada	Past
preservadas	Past
bendito	Past
engrandecido	Past
apartando	Present
regularizavam	Past
hesitarão	Future
reconvocados	Past
desafoga	Present
refrigerando	Present
relacionai	None
boicotassem	Past
perdem	Present
ganhavam	Past
encontro	Present
comentaríamos	None
abaixou	Past
apetecêreis	Past
sobressairíamos	None
aprazais	Present
falai	None
apatetai	None
emigra	Present
terminarmos	Future
intercalando	Present
quitaria	None
desrespeitam	Present
finalizarias	None
ofereceriam	None
deteriorando	Present
corresponderiam	None
capturaria	None
veda	Present
patines	Present
situa	Present
fantasiando	Present
comboiarão	Future
congelados	Past
notei	Past
envolveriam	None
guiaria	None
reduziriam	None
naufragaria	None
incomodassem	Past
arrependeria	None
grampeiem	Present
adulamos	Present
roí	Past
conversados	Past
conseguiste	Past
condizer	None
reembolso	Present
adormeceu	Past
arbitrada	Past
largavam	Past
despejada	Past
obteria	None
inspiraria	None
vetaria	None
demandaria	None
alardeará	Future
providenciavam	Past
manifestando	Present
livrarmos	Future
desceriam	None
libertando	Present
testada	Past
alisado	Past
listarem	Future
estouraria	None
zeremos	Present
pesquisei	Past
analisamos	Present
maquinarias	None
sumariada	Past
abstraístes	Past
sofisma	Present
actuaria	None
estranhado	Past
pensariam	None
desaparacidas	Past
estrangularemos	Future
preverá	Future
transplantando	Present
pontuadas	Past
fluídas	Past
emboscaria	None
flanqueada	Past
deslogarei	Future
apavorados	Past
coagulada	Past
optimizando	Present
decresciam	Past
honraria	None
rega	Present
pararia	None
contes	Present
encarem	Present
escarnamos	Present
bainharia	None
decolam	Present
dizerem	None
leves	Present
patrocinada	Past
consumido	Past
profanada	Past
repensou	Past
cruzei	Past
colocaríamos	None
copiavam	Past
arribando	Present
conheci	Past
ofereceria	None
prorrogueis	Present
acusais	Present
empurraria	None
polvilhada	Past
segurados	Past
ensejaria	None
suscitaria	None
refleti	Past
obstruirá	Future
elucidaríeis	None
editarmos	Future
poupadas	Past
embelezados	Past
propagaria	None
adquirirá	Future
inactivo	Present
chantada	Past
plantares	Future
desmaiariam	None
contrapor	None
ficou	Past
reorganizaremos	Future
destoam	Present
ditaria	None
desenhados	Past
agachássemos	Past
enviam	Present
discaria	None
atentou	Past
sentiriam	None
endureces	Present
precisares	Future
assistiu	Past
boiando	Present
cotada	Past
conjuga	Present
implementou	Past
janelaríeis	None
encalhadas	Past
focará	Future
descreveríamos	None
ramifica	Present
empachavas	Past
detectarem	Future
englobaria	None
ensaiaria	None
discorrerá	Future
bateria	None
dividiria	None
comandaria	None
fecharias	None
somariam	None
alijeis	Present
armados	Past
picotes	Present
nadarem	Future
rebentares	Future
reestruturaríamos	None
canalizáramos	Past
arrependidos	Past
pontuais	Present
firmaria	None
ajoelhadas	Past
tramou	Past
interessam	Present
terminemos	Present
exterminando	Present
assoprassem	Past
porta	Present
coseriam	None
acederem	Future
levantai	None
submergida	Past
prezada	Past
tostas	Present
electrocutáramos	Past
alegras	Present
abrangidas	Past
freqüentados	Past
convertidos	Past
buzinas	Present
vislumbra	Present
vingada	Past
descascavam	Past
atrevessem	Past
imbuirás	Future
perpetuamos	Present
repetiriam	None
derrapa	Present
continuada	Past
deixa	Present
menstruarias	None
taparíamos	None
consolida	Present
puxado	Past
botam	Present
destelháramos	Past
permitirmos	Future
atreladas	Past
manjares	Future
escaramuçai	None
vitrificarias	None
rebolaste	Past
formuladas	Past
edita	Present
turbas	Present
associando	Present
liquida	Present
barraria	None
relacionei	Past
representariam	None
trovoadas	Past
cismo	Present
introduziriam	None
difundam	Present
solucionadas	Past
arquitetando	Present
troveja	Present
fallai	None
salvem	Present
chamada	Past
furtam	Present
sinalizareis	Future
retornou	Past
remontarem	Future
indicando	Present
defraudados	Past
sabotando	Present
disponibilizaria	None
delimitadas	Past
pesa	Present
interessa	Present
libertariam	None
acataria	None
iluminai	None
presumam	Present
navegam	Present
desafiariam	None
corrigissem	Past
lutariam	None
arbitrarias	None
descascados	Past
maceráramos	Past
manifestariam	None
privatizai	None
pegariam	None
assustei	Past
rangi	Past
regulam	Present
suou	Past
mergulharia	None
tensionados	Past
selecionaste	Past
coalhariam	None
sintam	Present
pagou	Past
livrarias	None
delongará	Future
denunciariam	None
fabricaria	None
bastavam	Past
estolarmos	Future
gozo	Present
valeriam	None
designam	Present
desempenhavam	Past
impossibilitais	Present
hibridizaríamos	None
agaloariam	None
rangaríamos	None
pescaria	None
estabilizaria	None
dilaceradas	Past
conflitou	Past
aconselhamos	Present
bisbilhota	Present
alegam	Present
abuses	Present
dependeriam	None
alfinetaríeis	None
clareada	Past
charquearia	None
kickai	None
desvirginásseis	Past
remetida	Past
cornearias	None
encaminhavam	Past
volverei	Future
estuprados	Past
circulassem	Past
laváreis	Past
deparareis	Future
arrenegai	None
corrigiria	None
poderemos	Future
negligenciavam	Past
folheada	Past
comercializadas	Past
denunciadas	Past
compactai	None
absolvido	Past
falei	Past
narrada	Past
classificarão	Future
topai	None
devotam	Present
aceleraria	None
cobrariam	None
plantem	Present
estratificarás	Future
ores	Present
nocautearia	None
revitalizarei	Future
deslastrarias	None
concedido	Past
ingeridas	Past
diluídas	Past
inclinavam	Past
esgueira	Present
desencorajado	Past
praticardes	Future
comentaria	None
abarcadas	Past
transmitiu	Past
arrebentareis	Future
trapaceariam	None
suguemos	Present
decretadas	Past
vadiáreis	Past
submetido	Past
mereceria	None
iodai	None
desprezei	Past
seletaste	Past
treinará	Future
agravaria	None
volatilizarmos	Future
transplantáreis	Past
disparastes	Past
picaria	None
percebida	Past
ministra	Present
aconteceríamos	None
contaminadas	Past
apreciaria	None
encantastes	Past
enfardelarias	None
arpejados	Past
intrincares	Future
despedindo	Present
enfiaremos	Future
desabafámos	Past
arquiva	Present
compensavam	Past
magnifico	Present
arrastaria	None
ocorressem	Past
associo	Present
interpostos	Past
desempenhei	Past
despejarem	Future
cantados	Past
prognosticariam	None
hospedaria	None
compensaria	None
grassitáreis	Past
contaminados	Past
sangram	Present
aparelhaste	Past
jorram	Present
olhai	None
predico	Present
salvai	None
rateadas	Past
tipado	Past
convulsionada	Past
aligeirada	Past
avançai	None
atribuirão	Future
expressada	Past
furámos	Past
subtraído	Past
apadrinha	Present
retarctes	Present
esmurraria	None
decuplicados	Past
pesados	Past
perguntamos	Present
pastores	Present
orientado	Past
cachai	None
desenhada	Past
mixes	Present
resmungardes	Future
cogitam	Present
espelhariam	None
correrá	Future
custearias	None
pronuncias	Present
previam	Past
constam	Present
grafitadas	Past
sentais	Present
cumprimentou	Past
fizestes	Past
discorressem	Past
antagoniza	Present
cuidariam	None
arriscaria	None
forjados	Past
ficaríamos	None
ondeadas	Past
liberamos	Present
pioraria	None
incriminaria	None
aproximem	Present
engarrafada	Past
cobririam	None
duraríeis	None
copiei	Past
caduco	Present
classificas	Present
dormissem	Past
despediria	None
encalhado	Past
rodaria	None
perpassaria	None
deixaria	None
grampearia	None
coibiria	None
traídos	Past
adaptados	Past
acamparia	None
desflorestado	Past
abordaríeis	None
cortaríamos	None
pastoreando	Present
ajusta	Present
carimbado	Past
zelavam	Past
rebelando	Present
deterem	None
brando	Present
violentarmos	Future
notados	Past
privaria	None
oferecerão	Future
amontoa	Present
contrapuséramos	Past
almoceis	Present
amolaríeis	None
atiraria	None
reformulo	Present
financiavam	Past
magoas	Present
satisfariam	None
erodo	Present
afastado	Past
desativaria	None
zonarei	Future
gerenciais	Present
iram	Present
superando	Present
humilhando	Present
impetrou	Past
bloqueio	Present
quicai	None
minimizes	Present
concluiriam	None
transpor	None
uniam	Past
abstrairiam	None
angustias	Present
deponde	None
ordenai	None
rangei	None
refinarias	None
duplicaria	None
consentidas	Past
enriquecerem	Future
aliarias	None
auferida	Past
dês	Present
rapado	Past
demitam	Present
organizada	Past
colonizado	Past
dispersado	Past
bicas	Present
adiantastes	Past
coordenai	None
sentirei	Future
desarmado	Past
obedeceriam	None
flutuam	Present
combateriam	None
popularizai	None
desfigurares	Future
refrigeradas	Past
operaria	None
esfolados	Past
incorreria	None
formigas	Present
nivelou	Past
lascou	Past
vinculada	Past
anabolizado	Past
findado	Past
tolerariam	None
aconteceu	Past
partirei	Future
abasto	Present
optarmos	Future
sobracei	Past
esqueço	Present
zombarás	Future
relacionarmos	Future
desacompanháramos	Past
negociaria	None
calandrareis	Future
envolverá	Future
esmagardes	Future
passou	Past
inspiravam	Past
leva	Present
resfriando	Present
notarão	Future
editam	Present
dispersadas	Past
encarregadas	Past
cadastro	Present
cercados	Past
prossigo	Present
diríamos	None
colavas	Past
batei	None
lixo	Present
levantadas	Past
vesgueias	Present
depusessem	Past
tormentai	None
inferi	Past
omitidas	Past
manejado	Past
trina	Present
acabavas	Past
gerenciáveis	Past
habitaria	None
freqüenta	Present
costuram	Present
golpearemos	Future
comino	Present
parafraseávamos	Past
raptados	Past
desviará	Future
imitaria	None
surgiam	Past
gamadas	Past
assinariam	None
afiliou	Past
mobiliadas	Past
aprisionando	Present
chimarroneastes	Past
esmaltado	Past
dilacerareis	Future
domada	Past
desmembraríamos	None
tomaste	Past
cristianizados	Past
colaborariam	None
digerida	Past
ofenderia	None
rugidos	Past
contivessem	Past
retomariam	None
esquivemos	Present
deletadas	Past
enviarei	Future
pulamos	Present
refratam	Present
ponde	None
gaseificada	Past
giraria	None
interditados	Past
avaliarmos	Future
mencionaria	None
clarificadas	Past
fritávamos	Past
respeitaria	None
cortaria	None
predomina	Present
criptografariam	None
chamaria	None
enforcando	Present
alastrado	Past
influiria	None
assenhoreou	Past
rascavam	Past
abroquelarmos	Future
minguou	Past
tangestes	Past
sobrestimaria	None
catalogado	Past
profetizaria	None
reverterem	Future
zelada	Past
patrocinaria	None
abainháreis	Past
mostrai	None
desintegrarmos	Future
detonaria	None
chamou	Past
tatuou	Past
unas	Present
advir	None
forjadas	Past
sequestra	Present
abandonaria	None
perderíamos	None
sobraria	None
aporias	None
relvados	Past
viveriam	None
afamaríamos	None
aprovou	Past
demarcam	Present
incidindo	Present
nomeai	None
condenáveis	Past
arbitrados	Past
exortariam	None
urbanizado	Past
obedecido	Past
delatasses	Past
afetaria	None
desatinaríeis	None
eliminaria	None
chutaria	None
desceria	None
bebes	Present
ostracizei	Past
apontará	Future
consolidaria	None
afirmariam	None
tornai	None
tentarão	Future
constatariam	None
debita	Present
hibridizadas	Past
engraçadas	Past
afazer	None
erigi	Past
aconselhavam	Past
aqueceríeis	None
comparado	Past
esmagadas	Past
descoles	Present
aplacou	Past
intrigaríamos	None
ouviríeis	None
pretendido	Past
desmotivais	Present
envelhecidas	Past
gostam	Present
anglicizaríeis	None
hispanizaríeis	None
parcelarias	None
concebas	Present
averiguou	Past
dedicará	Future
enferrujariam	None
implantaria	None
subiria	None
retocai	None
cotou	Past
endurecei	None
delegaras	Past
segmentado	Past
albergaria	None
serei	Future
fracassaríamos	None
bailados	Past
coevoluiria	None
reconquistado	Past
verdes	None
assentaríeis	None
mereceriam	None
exonerou	Past
luta	Present
cegam	Present
introduziríeis	None
ajustadas	Past
atrairíamos	None
infestaras	Past
configurando	Present
convidam	Present
caducaríeis	None
restringiria	None
reforçariam	None
hispanizando	Present
trançados	Past
questionáramos	Past
estrupidariam	None
anda	Present
lesmai	None
estereotipados	Past
violaria	None
lustrado	Past
arranjo	Present
concluído	Past
civilizados	Past
anularíamos	None
inferida	Past
convocaria	None
demandada	Past
mirrada	Past
reinstalarias	None
creditadas	Past
opinassem	Past
contrasta	Present
paparíeis	None
doto	Present
adiantada	Past
optei	Past
proporciona	Present
pulsa	Present
presumes	Present
detalhai	None
entorpeceríeis	None
iráramos	Past
urinavam	Past
percebam	Present
acrescentariam	None
olharia	None
sexaríamos	None
negativado	Past
intrigou	Past
explanou	Past
penetram	Present
amplificadas	Past
aventuro	Present
engaioleis	Present
pertenceria	None
viraria	None
alentada	Past
ponharíamos	None
atenuarem	Future
activas	Present
pagai	None
glosada	Past
percas	Present
validando	Present
mantive	Past
destruída	Past
sairia	None
quelatáramos	Past
acresceu	Past
coletou	Past
derreteria	None
encaixassem	Past
murai	None
falado	Past
tolerando	Present
trucidei	Past
franquiaria	None
arribado	Past
cifra	Present
roeu	Past
redigindo	Present
apaixonadas	Past
gatunaste	Past
batuquei	Past
descairíeis	None
emendaria	None
liquidaria	None
consignadas	Past
tarraxaras	Past
concederíamos	None
atola	Present
fechariam	None
calculada	Past
catalogados	Past
reformularia	None
estrelai	None
atarefaríamos	None
trauteavas	Past
saliva	Present
condensou	Past
demitem	Present
dizer	None
mostrariam	None
fofocando	Present
surjam	Present
invadiam	Past
exibido	Past
ensinadas	Past
comprometeria	None
procria	Present
alçadas	Past
conduziam	Past
acessassem	Past
incomodaria	None
desabai	None
significará	Future
optam	Present
adorassem	Past
explica	Present
automatizam	Present
arrazoados	Past
atenderia	None
atendei	None
inferidas	Past
atestada	Past
avaliariam	None
bastará	Future
imaginado	Past
ferveu	Past
oitavarias	None
seguradas	Past
arrecadaria	None
perfilassem	Past
comunicariam	None
desmatará	Future
abastecida	Past
agoiro	Present
renovada	Past
agrupadas	Past
marcando	Present
cometidos	Past
deparo	Present
sobre-estimaria	None
batalhado	Past
transmitindo	Present
abunda	Present
opinam	Present
sussurram	Present
martirizaríamos	None
pouso	Present
suprimido	Past
antagonizado	Past
conter	None
concatenaríeis	None
traindo	Present
aparentadas	Past
portarem	Future
despertarmos	Future
distam	Present
fixou	Past
reiterou	Past
fatores	Present
casadas	Past
escolheriam	None
simplifico	Present
regressariam	None
digeririas	None
semelha	Present
soletrou	Past
adaptassem	Past
tens	Present
carimbando	Present
aliciados	Past
sobrevir	None
bailaras	Past
zonais	Present
descontado	Past
encapsulam	Present
opusessem	Past
apregoam	Present
meditaras	Past
atingidos	Past
posicionaria	None
molha	Present
revistaria	None
direcionei	Past
urinou	Past
extendamos	Present
pescam	Present
acabando	Present
destaquemos	Present
feridos	Past
redireccionado	Past
hackeariam	None
apodrecido	Past
atropelam	Present
diversificados	Past
freqüentadas	Past
moendo	Present
balançardes	Future
movimentem	Present
compensadas	Past
induziria	None
cabido	Past
desabrochemos	Present
jactarias	None
aproveitariam	None
cunhará	Future
intrigo	Present
problematizado	Past
desmoralizadas	Past
convocando	Present
engastada	Past
pernoita	Present
dizermos	None
portáveis	Past
passeavam	Past
maquinaria	None
escapados	Past
restituídos	Past
desenhado	Past
zicados	Past
louvavam	Past
causarem	Future
escutaria	None
venerando	Present
trazermos	None
refutávamos	Past
invocassem	Past
caracterizem	Present
espoliados	Past
penhorariam	None
declarariam	None
necessitam	Present
questionado	Past
rasgai	None
alardearemos	Future
googlearia	None
aturdíamos	Past
datilografada	Past
enfronhamos	Present
contratam	Present
denotavam	Past
apalpado	Past
derramaríamos	None
procedessem	Past
delineado	Past
tardes	Present
pôr	None
eliminam	Present
erradicada	Past
cansaria	None
endurecidos	Past
soluçavas	Past
timbres	Present
visarem	Future
blogado	Past
incrustaríeis	None
notarmos	Future
conquistaria	None
tributados	Past
alçado	Past
chiavam	Past
molestada	Past
apodreciam	Past
dependeria	None
lembrariam	None
comutei	Past
tosquiássemos	Past
cosas	Present
arterializou	Past
garantiriam	None
duvidasses	Past
miscrarem	Future
pautados	Past
frustrarmos	Future
temam	Present
portas	Present
brigassem	Past
precisariam	None
acabariam	None
trabalhadas	Past
reorganizaríamos	None
treinares	Future
alçaria	None
sustardes	Future
maldizer	None
abirritaria	None
refogavas	Past
sumulávamos	Past
causando	Present
chegaria	None
parodiarias	None
portarias	None
derrabáveis	Past
voltaria	None
carreguem	Present
pastoras	Present
pulas	Present
abordaria	None
escapada	Past
desavergonharão	Future
cobertas	Past
omitidos	Past
chamaríamos	None
perfilando	Present
concorreriam	None
pigmentares	Future
suplementaste	Past
pousarem	Future
mastiga	Present
reduziria	None
acasalai	None
filmei	Past
duchando	Present
julgará	Future
desterrado	Past
incentivaria	None
apoiai	None
entenderia	None
adaptáveis	Past
inculcou	Past
difundiríeis	None
magoei	Past
ensaiavas	Past
predominásseis	Past
cadastrou	Past
quebraria	None
bronzeia	Present
avisando	Present
discuti	Past
restarias	None
trissecaríeis	None
pareceria	None
industrializaríamos	None
seguiriam	None
cisarmos	Future
borbulhai	None
circulará	Future
emprenhávamos	Past
percorrendo	Present
concluírem	Future
administra	Present
comparamos	Present
prescreverias	None
residindo	Present
conferirem	Future
alertaria	None
ressuscitarão	Future
cotovelassem	Past
terminaria	None
examina	Present
cintarão	Future
alegaria	None
escolheria	None
incomodas	Present
construiriam	None
atrevendo	Present
cotai	None
amaynaríamos	None
cagas	Present
juraríamos	None
albergarias	None
coagindo	Present
inauguraria	None
arruinadas	Past
afectará	Future
acontecerão	Future
discriminarias	None
confeririam	None
desenvolveriam	None
revistadas	Past
encerraria	None
rezei	Past
adquiri	Past
consagrariam	None
extraditado	Past
provi	Past
adjetivas	Present
formatada	Past
confessada	Past
remediares	Future
desistiam	Past
encoberta	Past
esquecerei	Future
imunizados	Past
afectadas	Past
reescreveria	None
vem	Present
desandáramos	Past
esquilasses	Past
peças	Present
articula	Present
desacelerado	Past
compões	Present
instituíam	Past
preservaria	None
podido	Past
revistados	Past
detectados	Past
quere	None
recompensado	Past
atuariam	None
procriados	Past
escavai	None
abster	None
congracei	Past
dissiparia	None
cotaríamos	None
espancada	Past
reabilitai	None
cunhas	Present
coassináramos	Past
secaremos	Future
fizéssemos	Past
espancando	Present
desligaria	None
solidifiques	Present
comeríeis	None
reconstituiriam	None
acariciado	Past
pecassem	Past
ficaste	Past
rastreada	Past
expostos	Past
restabelecestes	Past
atiçaríamos	None
denigriria	None
sisa	Present
acena	Present
terdes	None
acarretando	Present
baseassem	Past
inseri	Past
levitaríeis	None
trapaceando	Present
pescarem	Future
encontrado	Past
regulemos	Present
tutelares	Future
coalharias	None
embalsamariam	None
remedia	Present
sibilas	Present
distrairiam	None
deseuropeizando	Present
fracassavam	Past
ilegalizarei	Future
sabendo	Present
estamparia	None
ideariam	None
maquinado	Past
sermos	None
seguras	Present
consagrados	Past
repetiam	Past
desintegraria	None
agravada	Past
engolirem	Future
expurgariam	None
dignaria	None
correm	Present
queimados	Past
engravidam	Present
excelerias	None
citem	Present
cedeu	Past
marcaria	None
pelai	None
menstruadas	Past
misturei	Past
suplementam	Present
convalidaríamos	None
fruíam	Past
saberia	None
partiriam	None
explodiriam	None
bisa	Present
conseguiriam	None
decorada	Past
expropriando	Present
dominarias	None
relacionam	Present
revoltavam	Past
superarem	Future
costumada	Past
deparam	Present
surge	Present
confrontaria	None
preocupada	Past
aspiramos	Present
redobrai	None
danças	Present
formatado	Past
morgado	Past
poluiríeis	None
resumidos	Past
aviamos	Present
dificulta	Present
credito	Present
abespinhares	Future
consolais	Present
condimentada	Past
multada	Past
contornavam	Past
valham	Present
dardejarias	None
calcaria	None
controlassem	Past
amanteigado	Past
aludido	Past
perpassam	Present
procurariam	None
oscilado	Past
aparelhassem	Past
requere	None
constituiriam	None
gostaria	None
aprenderia	None
incomoda	Present
imponho	Present
banalizarem	Future
refazerem	None
apoteotizáreis	Past
cardaria	None
bruno	Present
apóie	None
decepcionarão	Future
optariam	None
deliciai	None
raspassem	Past
amassado	Past
surtem	Present
contrariáramos	Past
descarrilhei	Past
assentada	Past
airai	None
rejeitariam	None
minimizaria	None
ricocheteados	Past
cravado	Past
sagrariam	None
expandido	Past
informaria	None
devotados	Past
apodera	Present
reteria	None
massacrarás	Future
resolverem	Future
vagaria	None
oleado	Past
listam	Present
madurai	None
redescobririam	None
concruiríeis	None
gerirá	Future
reportarem	Future
correriam	None
machucarem	Future
brigo	Present
lembrei	Past
aguentaria	None
aberraríamos	None
degenerado	Past
ofrece	Present
cumulou	Past
distanciada	Past
comunicado	Past
migrada	Past
impugnaria	None
amortalhai	None
estatizaria	None
caluniada	Past
editamos	Present
afastados	Past
ab-reagiria	None
vellejeis	Present
cantarias	None
sanai	None
caberia	None
agaloarão	Future
bastarias	None
lambuzasses	Past
agruparia	None
serraria	None
demonstram	Present
freiai	None
apronta	Present
temereis	Future
soai	None
chamariam	None
consultáveis	Past
virariam	None
assumam	Present
continuariam	None
legalizando	Present
declarará	Future
esguichareis	Future
editarão	Future
atrapalharem	Future
afundaria	None
chapados	Past
subsistiria	None
assam	Present
encontres	Present
testemunhada	Past
culparíamos	None
relembraria	None
sufixarias	None
usurpados	Past
autorizados	Past
recontaríamos	None
predizer	None
afligireis	Future
retocado	Past
estendeu	Past
desenterrai	None
conformaras	Past
governaria	None
fraudai	None
revoltado	Past
tirariam	None
apreciam	Present
franzíeis	Past
decorreria	None
supro	Present
inserissem	Past
infestaria	None
conceituadas	Past
acromatizáreis	Past
deixadas	Past
interessadas	Past
ausenta	Present
coagida	Past
andem	Present
faríamos	None
derivem	Present
violarmos	Future
mascarado	Past
produzindo	Present
impulsionariam	None
estrearem	Future
assinalaria	None
estorvaria	None
cassam	Present
supervisada	Past
tocarão	Future
deliberaria	None
encarcera	Present
apurados	Past
nevaria	None
colonizasses	Past
legitimaria	None
massificado	Past
ampliamos	Present
aninhais	Present
interpreto	Present
chifrarmos	Future
livraria	None
desarma	Present
ajudados	Past
pregai	None
abolíeis	Past
relatassem	Past
entretendo	Present
progredis	Present
cunháreis	Past
maturarem	Future
seguidas	Past
acata	Present
trancados	Past
tensiona	Present
intimando	Present
confortou	Past
quitadas	Past
originam	Present
gasificaríeis	None
ajoelham	Present
guindais	Present
tripulando	Present
embalando	Present
provir	None
subscrito	Past
eliminado	Past
corrigirá	Future
apontem	Present
seqüestrado	Past
empoleirando	Present
sucumbindo	Present
vitrificassem	Past
identificariam	None
cavaria	None
antolharias	None
arruinaria	None
tentaria	None
engrossados	Past
talharíeis	None
fluírem	Future
lapidais	Present
arrancada	Past
entramos	Present
romperiam	None
gostarei	Future
assimilada	Past
dilata	Present
enfileirarei	Future
sacrifiquem	Present
remontou	Past
requisestes	Past
concederes	Future
arremedeis	Present
circulados	Past
refletido	Past
breques	Present
desarmássemos	Past
embalsamou	Past
dividirem	Future
exerço	Present
anatemizou	Past
colheu	Past
predizem	Present
harmonizou	Past
responsabiliza	Present
sugerirem	Future
supuráramos	Past
compunham	Past
inibem	Present
desencadearia	None
exala	Present
desalentarias	None
guarnecendo	Present
candidato	Present
exterminarem	Future
autorizaria	None
embainhai	None
dizeres	None
despertamos	Present
aduzindo	Present
chutam	Present
clareado	Past
assemelhavam	Past
caberem	None
escreveriam	None
partilhando	Present
regenera	Present
batas	Present
surdiríamos	None
devastado	Past
bisai	None
esterilizámos	Past
aglomerastes	Past
vaiasses	Past
sobrecarregaria	None
secundaria	None
contentaria	None
denominarem	Future
triplicadas	Past
treinastes	Past
achai	None
chocaria	None
retornados	Past
delatado	Past
geriu	Past
corneardes	Future
sepultou	Past
imporia	None
metas	Present
anulassem	Past
vendada	Past
regurgitaríamos	None
requererem	None
permitamos	Present
quebra	Present
detalhavam	Past
proviria	None
acirrais	Present
apressou	Past
estacaríeis	None
cerrados	Past
reordenaríamos	None
incorporadas	Past
atribuístes	Past
evitaria	None
magnetizarias	None
acessam	Present
capitaneadas	Past
marcai	None
metabolizadas	Past
aleitas	Present
aromatizáramos	Past
centrará	Future
decompor	None
desfocariam	None
perpetravam	Past
eletrolisásseis	Past
cortejando	Present
destacado	Past
trabalharia	None
insinuavam	Past
versaríamos	None
admoestarias	None
impossibilitaria	None
inauguram	Present
perderei	Future
concede	Present
amadurecerei	Future
engrenaste	Past
comprometeriam	None
atuam	Present
alistada	Past
fumegaríamos	None
coletando	Present
possibilitam	Present
baralhásseis	Past
sonhamos	Present
anoto	Present
engrenaríamos	None
arrefecem	Present
supor	None
transbordavam	Past
invejavam	Past
versavam	Past
homenagearia	None
desvairariam	None
fretaremos	Future
peregrinassem	Past
visitará	Future
exhortas	Present
halogenado	Past
sujeitará	Future
evidenciariam	None
deificado	Past
brotou	Past
destinem	Present
sufixes	Present
caçando	Present
agasalhai	None
canalizados	Past
matriculando	Present
treinaria	None
imantaria	None
descolaras	Past
investigados	Past
preparariam	None
narraria	None
vesgueáreis	Past
perseguirá	Future
prospecto	Present
proporei	Future
assariam	None
equipado	Past
tutelados	Past
travarem	Future
adicionarem	Future
atanazaria	None
expliquem	Present
removida	Past
partidos	Past
festejada	Past
respeitarias	None
dormitariam	None
motivados	Past
possibilitavam	Past
cambiais	Present
tico	Present
crucificado	Past
emparedaria	None
abrirmos	Future
hispanizo	Present
sorteei	Past
atermos	None
jogamos	Present
perdoai	None
depor	None
experimentarão	Future
blasonariam	None
cego	Present
alcalinizes	Present
evoluído	Past
segregado	Past
excederia	None
comicha	Present
releu	Past
perdida	Past
banham	Present
estreito	Present
aterrorizavam	Past
migrariam	None
prosperavam	Past
consolados	Past
levaria	None
acolheu	Past
rompeu	Past
despertou	Past
vilipendiado	Past
limpado	Past
observaria	None
desmoralizarei	Future
poda	Present
desempenhem	Present
lubrifiquemos	Present
prosperarem	Future
olvido	Present
encarregaria	None
deitado	Past
segregados	Past
aliviam	Present
ferrarias	None
contarem	Future
porfiarias	None
replica	Present
machucaria	None
mostravam	Past
encontrassem	Past
engrenadas	Past
casaria	None
adivinhas	Present
verem	None
viajados	Past
emparedarão	Future
fumam	Present
ocultávamos	Past
esforçou	Past
satisfeitas	Past
rescindiria	None
queimaria	None
cortará	Future
disponibiliza	Present
supre	Present
comporia	None
alteariam	None
alinham	Present
encararia	None
abraçou	Past
reinaria	None
marteladas	Past
gostarmos	Future
acirra	Present
recaíam	Past
restaurada	Past
atanazaríeis	None
solemos	Present
adiantaria	None
recortou	Past
estufados	Past
inibiria	None
flertam	Present
atordoam	Present
entristeceu	Past
desprendas	Present
estimeis	Present
fotografa	Present
quererem	None
ostentarem	Future
perecerias	None
deyxes	Present
desligado	Past
colhiam	Past
requererão	Future
operadas	Past
classificáveis	Past
ruminados	Past
invectiva	Present
pausada	Past
destroçou	Past
libertada	Past
orbitando	Present
segurarem	Future
pergunta	Present
recusas	Present
discernires	Future
impressionada	Past
disponham	Present
descartaria	None
ilustra	Present
beneficiariam	None
separará	Future
verificaremos	Future
redobrassem	Past
adicionou	Past
pretendidas	Past
distanciou	Past
machucai	None
logando	Present
dignou	Past
atormentando	Present
calharemos	Future
desdizer	None
rodei	Past
herdavam	Past
carregamos	Present
atapetará	Future
estenderiam	None
consideraríamos	None
economizei	Past
despedaçadas	Past
preceituaras	Past
povoadas	Past
taxada	Past
integrado	Past
deflorai	None
verificássemos	Past
parodies	Present
rarefazei	None
ceariam	None
bastem	Present
guarneciam	Past
arrasaríeis	None
apreciariam	None
viveremos	Future
espanta	Present
embalsamareis	Future
caiu	Past
curai	None
obrigaria	None
guardai	None
amostras	Present
acionaria	None
perseguiriam	None
hispanizarás	Future
embonecassem	Past
esqueceriam	None
reassistíreis	Past
escorriam	Past
clareia	Present
estilhaçados	Past
encriptada	Past
goza	Present
condirão	Future
catequizada	Past
chupa	Present
curei	Past
discordo	Present
adquiram	Present
kickou	Past
empaladas	Past
desterrada	Past
doutrinadas	Past
remetei	None
cancelam	Present
blogarei	Future
ganharia	None
negligencia	Present
ostentaria	None
rotacionada	Past
definheis	Present
estabelecermos	Future
ameaçará	Future
apostemaríeis	None
selam	Present
olearia	None
recorressem	Past
atrelas	Present
compor	None
deportada	Past
oneraremos	Future
otimizarias	None
tirardes	Future
romanizada	Past
arranco	Present
experimentei	Past
calados	Past
airada	Past
pulsaste	Past
desaponta	Present
escarafuncharias	None
especificam	Present
careceria	None
reconstituiu	Past
chuta	Present
encarnaria	None
decotado	Past
providencias	Present
referirem	Future
invadissem	Past
violaríamos	None
arrebenta	Present
afirmaríamos	None
enfrentam	Present
assanhada	Past
missa	Present
emendo	Present
cotejávamos	Past
observei	Past
amamentado	Past
receio	Present
banquetearíeis	None
denomino	Present
asseguraria	None
autuados	Past
magnetizado	Past
separaria	None
prosseguissem	Past
convulsarias	None
esbanjou	Past
complementaríeis	None
apor	None
recolhem	Present
projetaria	None
igualaria	None
estampando	Present
enquadráveis	Past
raspas	Present
puxaria	None
unificaríamos	None
desembrulhássemos	Past
direccionariam	None
lotarias	None
aniversario	Present
expandidas	Past
escorrido	Past
violados	Past
apanhem	Present
voltaríamos	None
ignorado	Past
incomodavam	Past
negado	Past
poluiria	None
amostram	Present
pressagiariam	None
prometiam	Past
entregariam	None
arquejaria	None
pestanejei	Past
acanhem	Present
investigavam	Past
recordaria	None
elaborado	Past
dilatou	Past
acentuáreis	Past
desconfiada	Past
estrelam	Present
enamorarias	None
alucinarias	None
graduaria	None
aparece	Present
deitassem	Past
absolvidas	Past
cambados	Past
recolhidos	Past
acupunturaria	None
decorridos	Past
exercerá	Future
suporia	None
britarmos	Future
comunica	Present
murcharíeis	None
resumiriam	None
afastam	Present
verificaria	None
cozo	Present
refutavam	Past
correrias	None
demora	Present
manufaturado	Past
machucam	Present
replicavam	Past
mudarão	Future
peneirados	Past
atarraxado	Past
pontuarem	Future
embarcaria	None
vislumbradas	Past
quintais	Present
capitaneávamos	Past
respirasses	Past
veraneámos	Past
habituarias	None
cumprimentaríamos	None
alongado	Past
reabilita	Present
aplaudidas	Past
variando	Present
fotografados	Past
arroubarias	None
entendida	Past
avaliado	Past
comparem	Present
descenderia	None
gerando	Present
familiarizei	Past
sucedam	Present
acometida	Past
encaro	Present
ouviria	None
suprida	Past
detido	Past
aproximou	Past
solidificaria	None
sucederei	Future
nacionalizando	Present
efectuo	Present
recusará	Future
deixariam	None
lembremos	Present
dançado	Past
disfarçando	Present
prepararia	None
torneio	Present
sumidos	Past
empenhavas	Past
retratou	Past
trepam	Present
movimentariam	None
refletiria	None
imaginaria	None
solapas	Present
adaptaria	None
bruxuleei	Past
abriria	None
contais	Present
lucram	Present
retrocedendo	Present
minimizadas	Past
prosseguiu	Past
petisco	Present
pacificaria	None
prorrogassem	Past
gerarem	Future
entrelaçarias	None
rugido	Past
degeneraria	None
arrebanhai	None
nacionaliza	Present
enfeitiçada	Past
concordada	Past
devas	Present
castrastes	Past
multiplica	Present
enoja	Present
sosseguei	Past
emancipáreis	Past
chamavam	Past
cavalgam	Present
reúne	Present
abaixado	Past
jogará	Future
aninham	Present
intercalado	Past
amassadas	Past
acontecida	Past
buscaríeis	None
rebateríeis	None
arvorescei	None
desconfiavam	Past
randomizada	Past
aureoles	Present
fisgariam	None
peregrina	Present
asada	Past
peregrinas	Present
escorrendo	Present
desfeita	Past
ousada	Past
atribuirá	Future
guiarem	Future
deviam	Past
topa	Present
endossamos	Present
massacrado	Past
atingiria	None
enfurecendo	Present
veranearmos	Future
desenrolaria	None
administraria	None
cresceria	None
notado	Past
vinificáveis	Past
implantando	Present
concedi	Past
seguindo	Present
disputados	Past
provocada	Past
alcaguetásseis	Past
brandiria	None
capitalizada	Past
racham	Present
sucedido	Past
socorriam	Past
transformaria	None
escachoarmos	Future
canceladas	Past
garantirão	Future
decidiria	None
machucarão	Future
critiquem	Present
filiado	Past
transferísseis	Past
atrasaria	None
acompanhas	Present
contagiou	Past
ficariam	None
amuo	Present
alheado	Past
prefaciadas	Past
legendadas	Past
conduzam	Present
vínhamos	Past
prognosticam	Present
carimbadas	Past
explicou	Past
incumbidos	Past
debatiam	Past
distando	Present
copiarem	Future
descarrilei	Past
peneiraríamos	None
fali	Past
dadivariam	None
amedorentai	None
pretenderia	None
emanciparíamos	None
teríamos	None
ganharíamos	None
maturados	Past
entrecortados	Past
assassinaria	None
proporem	None
juro	Present
transponham	Present
dedicarão	Future
iniciado	Past
assustavam	Past
modernizáreis	Past
enferrujáreis	Past
reterem	None
atarefai	None
louvai	None
aludida	Past
proferirem	Future
convocavam	Past
aconselhadas	Past
denotaria	None
abalaria	None
subjetivaria	None
alcunhou	Past
obstruindo	Present
junta	Present
atada	Past
credenciada	Past
amortecendo	Present
denunciam	Present
monitora	Present
encomendados	Past
brinquei	Past
danifica	Present
bronzeadas	Past
tiraria	None
adorna	Present
desmentindo	Present
jantou	Past
pertenço	Present
dilaceravas	Past
abreviando	Present
orienta	Present
auferidas	Past
cautelares	Future
dançada	Past
fissuraria	None
querer	None
expulsado	Past
nobilitassem	Past
traçam	Present
analogizaria	None
oras	Present
harmoniza	Present
agregarias	None
aparai	None
reclamarmos	Future
comportaria	None
evitaríamos	None
precisamos	Present
adiando	Present
desagregai	None
permaneceriam	None
implementariam	None
esperariam	None
editariam	None
rivalizado	Past
destruiria	None
indica	Present
pereceria	None
sentaria	None
variados	Past
premiadas	Past
sacarias	None
começássemos	Past
culminariam	None
estagnado	Past
gradua	Present
aterrissado	Past
orquestraríamos	None
falaria	None
esmagados	Past
acharão	Future
mantêm	Present
refinaria	None
predica	Present
chegares	Future
perfurada	Past
excluiria	None
facetada	Past
consignávamos	Past
domes	Present
artilhadas	Past
presidirão	Future
baldastes	Past
definiriam	None
perguntai	None
penhoreis	Present
abordou	Past
entretêm	Present
descobririas	None
transcrevamos	Present
recarregáveis	Past
divulgaria	None
tentas	Present
afetando	Present
perpetuaria	None
desmontaríeis	None
deixarão	Future
navegáveis	Past
ostentarias	None
esterelizai	None
vincularia	None
sairá	Future
pensaria	None
comungados	Past
encarnareis	Future
elevariam	None
descartada	Past
reputou	Past
descongelando	Present
preocuparíeis	None
dormiria	None
instituiria	None
promoveria	None
aceitarei	Future
opõem	Present
misturastes	Past
prestaria	None
derreterem	Future
devotará	Future
reprocessadas	Past
transferissem	Past
exclamam	Present
valorizamos	Present
desembarcaria	None
cometiam	Past
povoada	Past
comprometerem	Future
pautavam	Past
treinarias	None
vislumbrai	None
degustarias	None
arrepiado	Past
aditásseis	Past
endireitassem	Past
contariam	None
retomaria	None
zelou	Past
tingíeis	Past
libertado	Past
desoxigenada	Past
culpas	Present
aumenta	Present
substituiria	None
recairá	Future
influenciarão	Future
alam	Present
manuseávamos	Past
coalescendo	Present
sediando	Present
encorparíeis	None
rescaldarias	None
ribombai	None
vazam	Present
usas	Present
reconfirmada	Past
uniformizadas	Past
explodiria	None
plantado	Past
vaticinardes	Future
interpondo	Present
despertai	None
tramámos	Past
hipertrofiáreis	Past
combinassem	Past
perderiam	None
negligenciáveis	Past
diferenciou	Past
entrou	Past
cozinharem	Future
barbearia	None
fomentam	Present
remexido	Past
pressionadas	Past
trataremos	Future
relincharias	None
realçassem	Past
oferecidos	Past
alcancem	Present
contracenaria	None
aconselhem	Present
acostumarem	Future
atribuindo	Present
genufletirem	Future
aniquilando	Present
aloiraremos	Future
acomodaria	None
enojado	Past
fechados	Past
experimentariam	None
habitado	Past
rechaçavam	Past
lisonjas	Present
assedia	Present
entusiasmam	Present
maquinares	Future
apertado	Past
minimizáreis	Past
negociadas	Past
provam	Present
esvaziavam	Past
destrincharíeis	None
ter	None
evolverão	Future
locada	Past
mergulhas	Present
raiai	None
levantado	Past
espeto	Present
emaranhes	Present
agrava	Present
especulando	Present
travaria	None
desapareceria	None
exporem	None
abririam	None
circularão	Future
gostarias	None
defino	Present
relatavam	Past
expostas	Past
estraçalhando	Present
rida	Past
dispensai	None
reencontrado	Past
debochado	Past
estraçalharias	None
amolgariam	None
babai	None
cobraria	None
zerai	None
selarem	Future
confortam	Present
proferindo	Present
revitalizou	Past
abalávamos	Past
mandai	None
vilipendiada	Past
desenharia	None
excretando	Present
exercido	Past
desbloquearias	None
choravam	Past
superestimaríamos	None
alimentada	Past
interessariam	None
reclamariam	None
teletransporta	Present
padeceriam	None
desactivado	Past
rearranjaríamos	None
adoraria	None
prejudicarias	None
telefono	Present
grampeados	Past
fosforiladas	Past
estripariam	None
obedeceu	Past
montarias	None
irrigadas	Past
penetramos	Present
teorizou	Past
cinzelado	Past
fugiriam	None
utilizará	Future
convencionados	Past
demonstrado	Past
refrearias	None
amenizada	Past
mures	Present
escoltando	Present
somamos	Present
dançaria	None
estimularíeis	None
apegando	Present
anotavam	Past
remontando	Present
protestou	Past
ungindo	Present
equipararão	Future
enxotarão	Future
subornam	Present
quedam	Present
terias	None
manufaturariam	None
prefere	Present
anotadas	Past
indicariam	None
estolarias	None
distinguiria	None
sorriu	Past
ranga	Present
terminavam	Past
papo	Present
respirando	Present
acredito	Present
realizados	Past
desarticulemos	Present
reagiria	None
balanceando	Present
penhoradas	Past
destruiriam	None
frustram	Present
tomai	None
hipertrofiariam	None
conversamos	Present
instituídas	Past
modificando	Present
charquearas	Past
extinguiam	Past
espaçada	Past
adheríeis	Past
aumentariam	None
amordaçados	Past
extenderíamos	None
expandissem	Past
cobiçada	Past
reconhecem	Present
decolaria	None
magoa	Present
escaneásseis	Past
intermediarias	None
obrigo	Present
atacados	Past
raptadas	Past
impressionaria	None
derrotaria	None
filmariam	None
esclareço	Present
estacionada	Past
chilrearão	Future
mascavado	Past
atuaria	None
cozinho	Present
triturado	Past
recusada	Past
coordenou	Past
concordariam	None
recompensam	Present
finalizaria	None
batucavam	Past
cozam	Present
denominariam	None
publicas	Present
desativado	Past
invernou	Past
frito	Present
compareceria	None
arruadas	Past
sentarem	Future
conceituariam	None
vocalizaria	None
monologada	Past
vinga	Present
justifica	Present
reclamaria	None
abolido	Past
martirizarás	Future
conjuraria	None
repassa	Present
escolhessem	Past
punidas	Past
perpetrámos	Past
marchariam	None
apagarão	Future
invalidado	Past
vigiaria	None
emergiria	None
devolvam	Present
sepultaria	None
pastorado	Past
isolaria	None
espalham	Present
centravam	Past
gatunada	Past
reconheceriam	None
adquiririam	None
surgiríamos	None
desalentado	Past
tacarei	Future
questionem	Present
argentai	None
carregassem	Past
privilegiada	Past
atritarás	Future
deliberaríamos	None
inverto	Present
pousaria	None
reprimiriam	None
sentou	Past
economizaria	None
ateou	Past
mergulhou	Past
legendaria	None
decairia	None
rivalizavam	Past
floris	Present
suspires	Present
tencionado	Past
lançarão	Future
engolido	Past
fotografam	Present
olhei	Past
trouxésseis	Past
equiparia	None
assinamos	Present
verifiques	Present
escarneço	Present
desmembrada	Past
cessares	Future
guerreio	Present
renderizada	Past
zuniríeis	None
fortaleceria	None
desfaziam	Past
curaria	None
personalizada	Past
injuriando	Present
datariam	None
indicaste	Past
engolfado	Past
fraseias	Present
aguentariam	None
estagnariam	None
xeretaríeis	None
encantavam	Past
registaria	None
qualificariam	None
privadas	Past
malhou	Past
refugia	Present
orlo	Present
providenciariam	None
estaciona	Present
refratada	Past
aprontai	None
improvisada	Past
pousai	None
achariam	None
devastam	Present
penalizada	Past
mandariam	None
direccionavam	Past
cumuladas	Past
cooperados	Past
enjoem	Present
fissurariam	None
encera	Present
encadernáveis	Past
minuciáveis	Past
reiniciaria	None
examinadas	Past
manteria	None
aliviaria	None
atapetado	Past
revisaria	None
ocorreriam	None
reformados	Past
liberavam	Past
financiará	Future
enviaria	None
vaziareis	Future
organizará	Future
gemeriam	None
compulsaria	None
telhado	Past
usados	Past
interligado	Past
exercidos	Past
influenciariam	None
filtrado	Past
defenestrarás	Future
organizem	Present
enfraqueceria	None
erodiriam	None
luctáramos	Past
apegam	Present
encurtam	Present
brilhavam	Past
carregará	Future
curaríeis	None
acertei	Past
relutando	Present
reparais	Present
invalidares	Future
desatariam	None
entabuaria	None
ficamos	Present
coagules	Present
capes	Present
rebolaria	None
batizei	Past
reproduzem	Present
efetivávamos	Past
pulicaria	None
cabem	Present
enegrecidos	Past
padejardes	Future
traficam	Present
farfalhais	Present
perdeste	Past
ratearíeis	None
contraporem	None
tombei	Past
subscrevíamos	Past
concorridos	Past
acobardai	None
comprometo	Present
forneci	Past
escalonada	Past
desafogasses	Past
anotaria	None
estatuiu	Past
hipnotizaríeis	None
jantarem	Future
amedrontai	None
remeteria	None
desenterrariam	None
molesteis	Present
tosquiados	Past
desvalorizavam	Past
espancastes	Past
desanimasses	Past
incitam	Present
reprisam	Present
emersos	Past
facturarmos	Future
rascariam	None
poderia	None
lancei	Past
discutiriam	None
associaria	None
interceptados	Past
ladrilhado	Past
secretaria	None
solucionando	Present
gorgolejas	Present
desfaleceu	Past
alimentarem	Future
arquitetados	Past
influenciaria	None
rivalizaria	None
contrapesai	None
recristalizardes	Future
hibernaríamos	None
avariávamos	Past
tabulas	Present
manchada	Past
escreveríamos	None
resgataria	None
ajunta	Present
enterravam	Past
cintassem	Past
opina	Present
teorizam	Present
macereis	Present
ajuizarei	Future
extirpariam	None
atravessarem	Future
confessa	Present
descolastes	Past
implanta	Present
vidrarias	None
retrucarias	None
ponderai	None
queimará	Future
relinchásseis	Past
assaltadas	Past
registrados	Past
dano	Present
civilizeis	Present
arruaríamos	None
desapareceríeis	None
imputavam	Past
tosquia	Present
flertando	Present
emperrada	Past
superem	Present
convidassem	Past
cadastraríeis	None
participes	Present
visariam	None
despercebido	Past
frequento	Present
acuminaria	None
adocicaríeis	None
flutuaria	None
programados	Past
combateria	None
fugidas	Past
atribuiria	None
digeridos	Past
commetei	None
offereceríeis	None
cerro	Present
mixtura	Present
vislumbrado	Past
detectávamos	Past
acendeu	Past
admitiria	None
irrigando	Present
apodizaras	Past
entrecortai	None
mamai	None
aniversariado	Past
anularia	None
fruiríamos	None
aufere	Present
retino	Present
batizavas	Past
estarmos	None
satisfazer	None
degustada	Past
negoceiam	Present
amuro	Present
impor	None
recusaria	None
sodomizaria	None
afligiu	Past
necessitaria	None
aventurei	Past
crucificados	Past
interessaria	None
rachei	Past
violado	Past
confirmarem	Future
esticadas	Past
gravariam	None
ampliariam	None
veria	None
alterados	Past
elucido	Present
lembrada	Past
desvaloriza	Present
acrescenta	Present
deduzidas	Past
poupado	Past
mourejaria	None
rodeado	Past
determinaria	None
perfolheamos	Present
estrelareis	Future
imaginamos	Present
atraíssem	Past
tamponado	Past
hesitam	Present
arroubo	Present
apoderáveis	Past
subiriam	None
portaria	None
enmendaríeis	None
transitavam	Past
validarem	Future
freqüentes	Present
forçariam	None
investigará	Future
facturou	Past
trabalhei	Past
atrapalhamos	Present
imiscuiriam	None
nocauteiam	Present
sobressalto	Present
analisaria	None
rangeria	None
afundardes	Future
detivessem	Past
questionas	Present
disfarçadas	Past
revelarias	None
formulamos	Present
ataviaste	Past
amigas	Present
distorceria	None
estupraria	None
aventariam	None
reocorríeis	Past
solucionaria	None
estampado	Past
olvidando	Present
azulejaria	None
apercebida	Past
adoptarem	Future
intitularia	None
sufixo	Present
salvaguardada	Past
arvoresceríamos	None
interferindo	Present
ousariam	None
desobstruam	Present
divulgarei	Future
curveteariam	None
zombarias	None
dispormos	None
remontassem	Past
argumentaria	None
locupletai	None
rilharia	None
escachoaríamos	None
mascarará	Future
articularíeis	None
acoplarias	None
instalado	Past
alcunharias	None
tenho	Present
maltratariam	None
encerrariam	None
revigoradas	Past
comprehenderias	None
voltássemos	Past
clareou	Past
garantiria	None
identifiquei	Past
dialogou	Past
desgosta	Present
alagado	Past
homenageado	Past
ajustada	Past
repugneis	Present
ruborizaríamos	None
terás	Future
coincidiriam	None
engordado	Past
descarrega	Present
vibravam	Past
intensificaria	None
cancelaria	None
apetecido	Past
irradiam	Present
sossegando	Present
bloquearia	None
russificarão	Future
terminei	Past
encorajaria	None
guardou	Past
congestionado	Past
retirei	Past
reinventaríeis	None
classificareis	Future
lede	None
pensionares	Future
tipificou	Past
amputariam	None
saberíamos	None
será	Future
significai	None
laminaria	None
banaliza	Present
contados	Past
repassaria	None
teletransportarem	Future
escuitai	None
importunada	Past
trissecarias	None
amarrada	Past
acero	Present
surgido	Past
asarem	Future
representaria	None
arterializaríamos	None
manifestaria	None
dissimulado	Past
brilharia	None
economizando	Present
interrompido	Past
agasalhasses	Past
fumando	Present
regozijai	None
pagariam	None
desamarrai	None
diriam	None
sussurrados	Past
ensejou	Past
queríamos	Past
descansarem	Future
fusionada	Past
oprimirão	Future
desorientes	Present
rogai	None
desistirem	Future
invadidos	Past
biotransformareis	Future
blogarão	Future
confessarias	None
faturarei	Future
trovoaríeis	None
escravizavam	Past
assombraria	None
praticarás	Future
susteres	None
diferenciem	Present
prenderia	None
fazer	None
acreditaria	None
compreenderá	Future
caem	Present
ajustou	Past
viveria	None
alcunhados	Past
escarro	Present
honrarias	None
arrecadarmos	Future
jogarem	Future
ocasionaria	None
dirigiria	None
habituados	Past
curvaria	None
amarelas	Present
temes	Present
queimarem	Future
dizimaria	None
afastaríamos	None
olhada	Past
torneásseis	Past
aplicarias	None
ultimaríeis	None
brincarias	None
capacitáramos	Past
finalizando	Present
empregaria	None
jogarmos	Future
remeteriam	None
extraiu	Past
desmanchada	Past
apaixonaria	None
amplificada	Past
incendiada	Past
comparáveis	Past
oraria	None
empilharas	Past
gargalharias	None
falhariam	None
piai	None
ornejamos	Present
cruzados	Past
atuo	Present
louvou	Past
teleportados	Past
adiáramos	Past
atordoavas	Past
detalhada	Past
cantarola	Present
fomentadas	Past
consideraremos	Future
rotem	Present
missai	None
resolve	Present
dividido	Past
restado	Past
endossaria	None
flanqueado	Past
impossibilitem	Present
classificarei	Future
perfilha	Present
espaceavam	Past
lutem	Present
separariam	None
cometeriam	None
negativaria	None
mortificarei	Future
acinzentadas	Past
interdito	Present
vara	Present
precisarei	Future
curtirias	None
desmintam	Present
cruzavam	Past
ressalvadas	Past
admitirmos	Future
bancaria	None
nasço	Present
mimetizavam	Past
ameaço	Present
aproximariam	None
arremata	Present
causa	Present
silenciado	Past
publicitaria	None
agrilhoado	Past
aterrorizariam	None
selado	Past
discriminadas	Past
devi	Past
sanando	Present
assumiriam	None
lesmais	Present
equilibrarem	Future
homenageadas	Past
homenageemos	Present
escapariam	None
recuperado	Past
cozido	Past
acarretaria	None
reencontrando	Present
apressam	Present
viveríamos	None
balançáveis	Past
arma	Present
rabiscará	Future
cometessem	Past
arai	None
dedica	Present
pensavam	Past
seriamos	Present
levai	None
engrenada	Past
nasci	Past
desvendada	Past
estar	None
pilotes	Present
viajamos	Present
errarei	Future
abirritaríeis	None
baseia	Present
alunáramos	Past
orai	None
seguiu	Past
guia	Present
palráramos	Past
licitou	Past
cancelei	Past
desabilitou	Past
arabizamos	Present
asseguramos	Present
intervir	None
atrasariam	None
rilharás	Future
pressionando	Present
examinando	Present
bifurcariam	None
oleada	Past
utilizássemos	Past
entregou	Past
borbulham	Present
arruinando	Present
desertai	None
raptaria	None
desonrou	Past
amoleceu	Past
recurvadas	Past
branquearão	Future
alia	Present
orientamos	Present
traduzirem	Future
obtende	None
desmembraria	None
dinamizáreis	Past
perguntaste	Past
sarai	None
remanescermos	Future
saquearias	None
exibiriam	None
rachados	Past
desmitificai	None
suplantado	Past
teríeis	None
molharias	None
negociada	Past
fatigada	Past
latina	Present
chamam	Present
resume	Present
rendará	Future
dirigindo	Present
resolvidas	Past
propagarias	None
intervirem	None
arrancadas	Past
caçados	Past
caçaria	None
suprimiria	None
deceparíeis	None
impactaria	None
mencionemos	Present
cozinhada	Past
desculpou	Past
ascenderiam	None
debilitassem	Past
gerariam	None
ampliaria	None
culpa	Present
agita	Present
gozariam	None
soavam	Past
dai	None
descarrilam	Present
acelerando	Present
estares	None
subordinou	Past
supondo	Present
franja	Present
aporia	None
impossibilitando	Present
originarão	Future
nacionalizados	Past
deslocando	Present
pairai	None
durariam	None
assada	Past
depositei	Past
cursada	Past
sugeriste	Past
versou	Past
colaboraria	None
consistam	Present
triunfaria	None
alastraria	None
compulsou	Past
circunscreve	Present
atrapalhariam	None
pré-datariam	None
fosforilariam	None
logrou	Past
finaríamos	None
assaria	None
destilarias	None
vitimaria	None
tritura	Present
desabilitares	Future
calibro	Present
trazida	Past
afectando	Present
incentivam	Present
interceptando	Present
clarificando	Present
originaria	None
conjeturou	Past
perfumarias	None
humilham	Present
aturo	Present
acrescido	Past
crescessem	Past
objetou	Past
investiria	None
objetei	Past
truncará	Future
calásseis	Past
escusai	None
procurassem	Past
validem	Present
metabolizásseis	Past
apitai	None
desabilitado	Past
abrangeria	None
desapontado	Past
compondo	Present
exultareis	Future
alçou	Past
quereres	None
vicejo	Present
soletradas	Past
retraem	Present
filiavas	Past
lixiviaríamos	None
infirmariam	None
estalou	Past
penso	Present
lambeu	Past
alfinetadas	Past
valho	Present
grelha	Present
orientarias	None
estamparias	None
desfrutaria	None
salpicados	Past
ampliando	Present
popularizou	Past
configuraríamos	None
repreendidas	Past
repassarem	Future
regateiam	Present
silenciados	Past
reformei	Past
avançando	Present
destrinçamos	Present
avermelhada	Past
levei	Past
sucederia	None
suspirando	Present
anunciarem	Future
optarem	Future
cadastram	Present
rebuscada	Past
apontaria	None
alcoolizássemos	Past
emocionei	Past
agradeceria	None
exercitares	Future
emprestem	Present
ascenderia	None
pressagiou	Past
funcionaria	None
poder	None
sugai	None
temendo	Present
dosados	Past
esgotaria	None
desrespeitado	Past
entendendo	Present
prestariam	None
forçáramos	Past
agiria	None
vaporizam	Present
etiquetadas	Past
abdiquei	Past
aguçado	Past
firmadas	Past
sossega	Present
atiçou	Past
moveriam	None
desistiriam	None
encosta	Present
copiou	Past
causariam	None
usariam	None
grudada	Past
resistiriam	None
jantavam	Past
atapetaríeis	None
abortado	Past
botavam	Past
mescladas	Past
convencionas	Present
aclara	Present
aguará	Future
melhoro	Present
serás	Future
aceitariam	None
elabora	Present
metam	Present
rotacionarás	Future
pilotando	Present
corrigirem	Future
pertenças	Present
reduziu	Past
amáveis	Past
insinuariam	None
embasou	Past
esclareceria	None
havidos	Past
estacionarias	None
assustarem	Future
reconquistas	Present
rearrumem	Present
emendada	Past
circularia	None
gozaria	None
energizeis	Present
coordenam	Present
resfriados	Past
despertam	Present
incrimina	Present
governariam	None
atracais	Present
verses	Present
embotelhai	None
previ	Past
ganhariam	None
solto	Present
apego	Present
retemos	Present
alugou	Past
favoreceriam	None
negada	Past
casariam	None
interessaríamos	None
casada	Past
subsistem	Present
domesticada	Past
digitalizada	Past
poriam	None
sibilo	Present
trasladada	Past
uniria	None
attentarmos	Future
gorou	Past
aterro	Present
transferidas	Past
tombados	Past
misturaria	None
negai	None
defenderia	None
jogo	Present
massacram	Present
ensejo	Present
passai	None
impulsionaria	None
contradizer	None
decorando	Present
circulariam	None
juras	Present
louva	Present
trovoarão	Future
acidifica	Present
cagadas	Past
explicamos	Present
transcrevi	Past
prejudicariam	None
toleramos	Present
apostatavam	Past
falhas	Present
construírem	None
processada	Past
estudarmos	Future
contradiriam	None
frequentará	Future
escalpaste	Past
estrelaria	None
retardaria	None
calandrámos	Past
agraciada	Past
ensinaria	None
abusando	Present
aprenderiam	None
abalroou	Past
punireis	Future
cimentaste	Past
fumaria	None
testemunharias	None
outorgavam	Past
engolirias	None
precisará	Future
vestirem	Future
orarem	Future
arredondáramos	Past
precedem	Present
acumula	Present
desalojados	Past
levantarem	Future
conheces	Present
tremo	Present
imigrarem	Future
gravitaria	None
acedido	Past
pruríramos	Past
fumegariam	None
derramámos	Past
vetou	Past
industrializaríeis	None
faturadas	Past
gane	Present
renderizaria	None
nomeamos	Present
andada	Past
reservado	Past
melhorarem	Future
escava	Present
sintonizados	Past
desferindo	Present
traduzi	Past
subirei	Future
aproveitaria	None
festeja	Present
apertavam	Past
verbalizaríeis	None
propor	None
encharcará	Future
lisonjeado	Past
sairiam	None
diferenciaríeis	None
posiciono	Present
cumpriria	None
empenharem	Future
renegaria	None
tramaria	None
privando	Present
reclamavam	Past
obrigueis	Present
pruíam	Past
adoptaria	None
redigitáreis	Past
ocorre	Present
obtemperarás	Future
rescindido	Past
planejemos	Present
adiantou	Past
capo	Present
seda	Present
numeram	Present
proferiu	Past
elogio	Present
antropizadas	Past
artilhado	Past
loteando	Present
democratizarem	Future
modifiquem	Present
recusariam	None
bradam	Present
dormes	Present
forneceria	None
batem	Present
surpreendiam	Past
magoaremos	Future
acabarão	Future
convencida	Past
suportariam	None
surdas	Present
revolvendo	Present
detestados	Past
estimuladas	Past
comprovará	Future
varies	Present
registo	Present
ocorreria	None
colorida	Past
submergidas	Past
investissem	Past
orientei	Past
modularíeis	None
recuou	Past
namora	Present
reguladas	Past
traíssem	Past
vacarias	None
acoplados	Past
executem	Present
antagonizássemos	Past
alteres	Present
garantirá	Future
espremam	Present
alicerçada	Past
interessas	Present
aconteceria	None
acessados	Past
cativado	Past
crucifiquem	Present
acicatareis	Future
secarias	None
pasmem	Present
aguilhoais	Present
acartaríeis	None
assaltarem	Future
fiquemos	Present
virão	Future
cunhadas	Past
sincretizadas	Past
tentou	Past
rechaçado	Past
conserto	Present
enfeitadas	Past
improvisavam	Past
discriminando	Present
jejuou	Past
damnávamos	Past
ficaria	None
cambado	Past
inclinam	Present
atiçarias	None
providenciarem	Future
sê	None
desinflaríeis	None
procederia	None
ultrapassaria	None
refrigerou	Past
aciduleis	Present
destituiriam	None
enegrecidas	Past
examines	Present
rebuscai	None
buscaria	None
perturbou	Past
proviriam	None
moveria	None
desappareceríeis	None
anteciparia	None
diferenciaria	None
arriscamos	Present
contaminaríeis	None
estreitado	Past
agires	Future
multado	Past
obstruiu	Past
convenceria	None
entenderes	Future
endereço	Present
coo	Present
lançariam	None
libertaríamos	None
encaminhávamos	Past
escreveria	None
anunciaria	None
anota	Present
aromatiza	Present
entraríeis	None
calcularia	None
possuam	Present
demonstraria	None
contactei	Past
largaria	None
gargalharem	Future
difundiria	None
classificassem	Past
troarmos	Future
empatarem	Future
diminuiria	None
afluis	Present
recomeçaríamos	None
removestes	Past
adsorvido	Past
intrometido	Past
alternaria	None
hidratado	Past
persuadidas	Past
provariam	None
formariam	None
ramificando	Present
entreto	Present
engajam	Present
mandassem	Past
suscita	Present
dispôs	Past
informei	Past
cotejei	Past
baratearíeis	None
avivarem	Future
ratificaria	None
consistiria	None
dei	Past
conferíamos	Past
telha	Present
acenariam	None
pediria	None
criariam	None
apoderado	Past
controlarem	Future
escuitámos	Past
bicávamos	Past
amalgamaríamos	None
assobiaria	None
lideraria	None
residiria	None
estreiariam	None
testei	Past
contamines	Present
arrematados	Past
retrocederias	None
demitiriam	None
apavoram	Present
equipando	Present
digitei	Past
popularizaria	None
acionavam	Past
ativaria	None
rescindida	Past
deverás	Future
recomendei	Past
livrarem	Future
tutearias	None
visassem	Past
condenaria	None
situou	Past
esfriaríamos	None
presenciavam	Past
escoltada	Past
mitigavam	Past
permeadas	Past
abarrotadas	Past
minariam	None
protejo	Present
coagido	Past
sofismo	Present
juntariam	None
fecharia	None
interrompidas	Past
emergiam	Past
foderiam	None
recordes	Present
veres	None
pingaste	Past
cagada	Past
aproveitarem	Future
mixarei	Future
saudai	None
largarem	Future
cumpririam	None
cercarem	Future
suporto	Present
ressuscitou	Past
apurei	Past
caíam	Past
brindam	Present
instrui	Present
acerbaremos	Future
adiastes	Past
tomará	Future
defendeu	Past
flertes	Present
exclamaríamos	None
revoltaríeis	None
recarreguei	Past
rachada	Past
arromba	Present
incapacitaríeis	None
encaracolássemos	Past
intervinham	Past
resguardada	Past
bateras	Past
apelidaria	None
lançarem	Future
atai	None
vetásseis	Past
salientes	Present
facilito	Present
apatetada	Past
criticada	Past
quedavam	Past
assa	Present
desvendadas	Past
terceirizado	Past
usufruiria	None
introduzida	Past
reciclada	Past
consumiria	None
descambavas	Past
fatigaríamos	None
produzirão	Future
encherá	Future
rachastes	Past
resumiria	None
explicam	Present
iniciaria	None
desabafarei	Future
seriavas	Past
inventam	Present
reprisou	Past
deixais	Present
recalculada	Past
educavam	Past
aposentaria	None
joeiravas	Past
dizimou	Past
balado	Past
ronronam	Present
vedam	Present
expropriássemos	Past
modificam	Present
colocaria	None
encaixam	Present
significou	Past
suportes	Present
harmonizado	Past
renomearia	None
arrotareis	Future
alunei	Past
improvisado	Past
tacharia	None
compadecido	Past
gabes	Present
falsifiqueis	Present
apeles	Present
constaria	None
sublimada	Past
receberemos	Future
rescindirdes	Future
forrados	Past
incharia	None
especulada	Past
morando	Present
recomendaria	None
contrariados	Past
abnegados	Past
manai	None
reforcem	Present
sepultavam	Past
derrubando	Present
devastaria	None
arrebanháramos	Past
encaroças	Present
referirá	Future
marcharia	None
destoavam	Past
discerniu	Past
carimbo	Present
diagnosticada	Past
adicionastes	Past
gerenciado	Past
cinzelais	Present
desvinculados	Past
complementai	None
registrarei	Future
estratificam	Present
analisei	Past
vesti	Past
deveu	Past
prefabricarias	None
desperdiçada	Past
removerei	Future
atravancaríamos	None
embaixariam	None
sento	Present
estranharíeis	None
integravam	Past
resmunga	Present
usaria	None
trairia	None
abolirem	Future
estupeficai	None
imaginarem	Future
banharias	None
argentaria	None
fechavam	Past
reprovo	Present
atendiam	Past
escavando	Present
artilhada	Past
poderíamos	None
confortada	Past
aleguem	Present
auxiliaria	None
dramatizados	Past
realizaria	None
reoxidaríamos	None
grugulejei	Past
sexareis	Future
desanimei	Past
adquiriria	None
espoliaríeis	None
acompanharia	None
grunho	Present
enruga	Present
evidenciaria	None
continuaríamos	None
intermediada	Past
avaliou	Past
carrearíamos	None
desconsidero	Present
portou	Past
praticam	Present
comunicadas	Past
livra	Present
misturou	Past
desapegáramos	Past
chuviscardes	Future
aceras	Present
absorveria	None
escancearíamos	None
gerou	Past
feri	Past
suster	None
cultuarei	Future
interpretassem	Past
ostentada	Past
resgatarem	Future
ignorando	Present
rotacionávamos	Past
prefeririam	None
louvarmos	Future
podado	Past
demolirá	Future
apreciadas	Past
citaste	Past
atritas	Present
estranharíamos	None
minerados	Past
pichai	None
descamba	Present
colmo	Present
auxiliem	Present
deformando	Present
projetou	Past
falsificando	Present
expor	None
conduzi	Past
complicou	Past
tomem	Present
pensassem	Past
governem	Present
concordaria	None
virarem	Future
regeriam	None
adjetiva	Present
passeia	Present
brecarias	None
concorreria	None
inicializados	Past
manobra	Present
comporiam	None
jogáveis	Past
saída	Past
abomino	Present
voltados	Past
quedado	Past
emprestaria	None
contrastai	None
implementamos	Present
atirariam	None
reaqueceria	None
fecheis	Present
delatou	Past
provarei	Future
interpretada	Past
calandrardes	Future
ajudem	Present
inspecionei	Past
infringiria	None
balcanizámos	Past
liberados	Past
balanceado	Past
direcionaria	None
selecionamos	Present
fingiam	Past
fertilizaríamos	None
enviuvando	Present
bioacumulará	Future
amuramos	Present
artilharia	None
agasalharíeis	None
estimáveis	Past
comercializarias	None
morarmos	Future
cotámos	Past
modificarem	Future
imunizada	Past
discorrei	None
admoestando	Present
monopolizadas	Past
tremíeis	Past
zombam	Present
chouveria	None
empeçonhai	None
desaceleram	Present
recristalizaríamos	None
obrigassem	Past
beirávamos	Past
tunasses	Past
reivindico	Present
fraudado	Past
violaríeis	None
abastaremos	Future
demitidas	Past
encarnavam	Past
filmaria	None
detectada	Past
deferido	Past
vislumbraria	None
associes	Present
desafiada	Past
caracterizaria	None
avaliaria	None
dissentirias	None
domesticando	Present
ladeadas	Past
realçáramos	Past
malharias	None
desfivelariam	None
desbloqueadas	Past
criticando	Present
clarificarias	None
arranjou	Past
demorariam	None
commetteste	Past
secretarias	None
coloniza	Present
instanciai	None
dispensaria	None
piscariam	None
poderiam	None
auxiliariam	None
mixou	Past
abrigados	Past
divertiam	Past
assentis	Present
emboneco	Present
ressaltando	Present
saquearíamos	None
levanto	Present
entabulastes	Past
alhearíamos	None
colocarão	Future
guisares	Future
altearíamos	None
acolheria	None
enlatado	Past
desposaria	None
recusa	Present
damnáveis	Past
corrompido	Past
escapulistes	Past
existiria	None
acertavam	Past
ferra	Present
rastelo	Present
zerados	Past
faturados	Past
privilegio	Present
pesca	Present
esfaquearíeis	None
herdariam	None
floresceriam	None
dessulfurizastes	Past
recurvo	Present
serviria	None
inebria	Present
sistematiza	Present
atingi	Past
fena	Present
dessalinizeis	Present
prefaciou	Past
desprezásseis	Past
destacarmos	Future
avaliadas	Past
limai	None
deseja	Present
protege	Present
repensarem	Future
invernarem	Future
intervirá	Future
empenharia	None
desaprovou	Past
parariam	None
suspeitaria	None
vendidos	Past
pinduraria	None
paginariam	None
reavivai	None
tampando	Present
intrometem	Present
fechas	Present
aforismasses	Past
arfa	Present
revigora	Present
parecessem	Past
soaria	None
sagraria	None
papam	Present
comettei	None
sepultada	Past
falsificados	Past
soçobrarias	None
cambiou	Past
elevaria	None
simplificam	Present
gerada	Past
desorganizareis	Future
admitiam	Past
abramos	Present
adultizásseis	Past
conectas	Present
acusarem	Future
camuflaremos	Future
fia	Present
driblando	Present
converteriam	None
regozijando	Present
energizemos	Present
perceberes	Future
guisassem	Past
acabado	Past
intimidadas	Past
abandou	Past
desvinculada	Past
falharia	None
aloca	Present
temei	None
interpor	None
sobrecarregamos	Present
colidirá	Future
continuamos	Present
revisei	Past
priva	Present
imprecarias	None
ressuscitáreis	Past
supridas	Past
flexiona	Present
commeçando	Present
adiaria	None
derrotarão	Future
inseriam	Past
deprimido	Past
hospedaríeis	None
confundiriam	None
simplificada	Past
resistiria	None
resumiu	Past
gelou	Past
segmentem	Present
ensinai	None
mencionando	Present
depenado	Past
iradas	Past
lembrarmos	Future
abusardes	Future
estarei	Future
embandeirassem	Past
aproximaria	None
borda	Present
inventado	Past
aguadas	Past
refugiaríamos	None
partiria	None
observados	Past
habitarei	Future
questionaria	None
fodêreis	Past
retirou	Past
avassaláreis	Past
diplomam	Present
incapacitaríamos	None
desafiam	Present
despejaremos	Future
berrai	None
competiriam	None
notifico	Present
aconchegado	Past
prefaciada	Past
auscultaríamos	None
revoltada	Past
mixa	Present
triunfais	Present
esperem	Present
esculpirão	Future
pressagia	Present
fluiria	None
aconselharia	None
forçou	Past
aleatorizássemos	Past
falhassem	Past
criticaria	None
deliria	None
arrotai	None
triangularíamos	None
reportada	Past
alcançaria	None
repetissem	Past
preocupes	Present
revelariam	None
açucararíeis	None
liquefazeres	None
parabenizarás	Future
sondada	Past
caracterizariam	None
divulgo	Present
desfocaremos	Future
actuariam	None
souberas	Past
auxiliavam	Past
registraria	None
nanavam	Past
encarceremos	Present
alimentaria	None
segmento	Present
gelaríamos	None
accuseis	Present
especializavam	Past
batizavam	Past
acaricia	Present
providencia	Present
anexaria	None
afazermos	None
acreditarem	Future
aviaríamos	None
venderia	None
derroto	Present
encorpássemos	Past
eletrocutados	Past
invalides	Present
bancas	Present
infrinjam	Present
entrecortadas	Past
lançada	Past
perceberia	None
lanceei	Past
acelerou	Past
petrificada	Past
despedidos	Past
nadai	None
abraçaria	None
metabolizará	Future
impostos	Past
rugem	Present
digitaria	None
cortam	Present
testemunhou	Past
implicariam	None
atolarias	None
torneados	Past
retratadas	Past
relaxada	Past
melou	Past
sopra	Present
tributadas	Past
comettas	Present
fraturaríeis	None
sitiou	Past
apelidando	Present
trançadas	Past
perdoaria	None
homologado	Past
indicas	Present
lixiviaríeis	None
oporia	None
aclimatemos	Present
mutilam	Present
resignados	Past
centrados	Past
confessem	Present
caberiam	None
detecto	Present
aprofundando	Present
entronizou	Past
deprimem	Present
obras	Present
visaria	None
exploraria	None
legendeis	Present
azotados	Past
aumentarem	Future
esvaziaríeis	None
usará	Future
enfeitiçando	Present
pisoteadas	Past
molhados	Past
confiamos	Present
tabulado	Past
perfilhado	Past
blasfemarão	Future
pertenceriam	None
conheceremos	Future
gostará	Future
brocarão	Future
obteve	Past
nasceste	Past
abasteceria	None
consumando	Present
marinai	None
acirram	Present
candidatando	Present
chegarem	Future
contrairiam	None
podaria	None
pulada	Past
rever	None
decepcionadas	Past
avisaria	None
transportarem	Future
apoderarias	None
calibradas	Past
toparia	None
iluminas	Present
enterro	Present
interrompe	Present
pruriria	None
instalares	Future
assistirmos	Future
metilaria	None
kickavam	Past
filiam	Present
rechaçaríamos	None
carreia	Present
retomada	Past
decapita	Present
aira	Present
fallaste	Past
digitando	Present
intitularias	None
providenciará	Future
andadas	Past
traduzida	Past
escarnecido	Past
abacinarias	None
auxilia	Present
badalastes	Past
tiranizamos	Present
agua	None
travado	Past
relembrado	Past
mastigássemos	Past
fraqueámos	Past
centelhariam	None
decapitada	Past
valorais	Present
treinando	Present
exigirmos	Future
redobradas	Past
acanharíamos	None
atrasavam	Past
gorai	None
adotados	Past
supplantas	Present
regressarias	None
ousai	None
ensaiamos	Present
infestam	Present
transmitiria	None
exerceria	None
afinam	Present
lastimariam	None
contaminou	Past
partis	Present
fixaria	None
rejuvenescida	Past
sagram	Present
saltavam	Past
retarctaríamos	None
brilhariam	None
caíeis	Past
adoecerias	None
importunado	Past
deu	Past
atacado	Past
lavarem	Future
espantou	Past
vertida	Past
evoluiria	None
debutaria	None
mugiria	None
caberes	None
pisavam	Past
exclamado	Past
tostavas	Past
apossando	Present
bendizer	None
fumegavam	Past
incentivado	Past
utilizariam	None
renovavam	Past
exilaria	None
herdaria	None
lançarei	Future
importunando	Present
aclimatará	Future
recontariam	None
taxai	None
adsorverias	None
aceitaríamos	None
obter	None
cursadas	Past
maltratado	Past
redigidos	Past
berrados	Past
humedecido	Past
calcificado	Past
aconselhados	Past
figures	Present
urbanizadas	Past
oblitero	Present
melhorariam	None
aborrecidos	Past
trauteai	None
atormentado	Past
vacada	Past
mio	Present
abanariam	None
apoiado	Past
falando	Present
alcoolizastes	Past
chamai	None
idolatrada	Past
tira	Present
limitou	Past
dissuadidos	Past
agiríeis	None
tirassem	Past
degenerando	Present
baixam	Present
dizíamos	Past
financiem	Present
intima	Present
cantarão	Future
alapáveis	Past
competiria	None
esquila	Present
pedes	Present
configurariam	None
decepcionado	Past
presidiam	Past
puxadas	Past
finais	Present
apresentaria	None
identificou	Past
romaniza	Present
reter	None
acirrados	Past
revogada	Past
adorai	None
ensopáreis	Past
instigados	Past
herdem	Present
apearíeis	None
decepando	Present
contrafazerdes	None
fazerem	None
renunciará	Future
sujeitados	Past
víamos	Past
douraria	None
marcariam	None
acupunturarei	Future
provisionais	Present
obterem	None
subirão	Future
chicoteia	Present
fies	Present
digerido	Past
guio	Present
escoltadas	Past
persuadamos	Present
responsabilizada	Past
esterrares	Future
realizaremos	Future
tormento	Present
melhorem	Present
martirizados	Past
atenderiam	None
oporiam	None
atiçadas	Past
bordadas	Past
cobiçadas	Past
saibam	Present
decretarão	Future
qualificado	Past
ponhásseis	Past
hospedados	Past
ides	Present
provindas	Past
calcificasses	Past
reconsiderarem	Future
criptografaríamos	None
justapõem	Present
acabarei	Future
implementaria	None
reformulados	Past
implantadas	Past
obrigou	Past
localizamos	Present
reencontraria	None
sincretizarias	None
dormirem	Future
exsecutem	Present
abandonai	None
colocaremos	Future
lapidarias	None
ministrasses	Past
entregaria	None
fecharei	Future
esperassem	Past
prometem	Present
ajudai	None
personalizado	Past
envelhecei	None
frisarei	Future
torrei	Past
minero	Present
tratariam	None
rastreio	Present
apeados	Past
deificaria	None
enfileiraríeis	None
desfazerem	None
realizariam	None
saberiam	None
silva	Present
divulgará	Future
reconhecidos	Past
escoando	Present
reconsiderem	Present
encontras	Present
rodaras	Past
surgem	Present
falhem	Present
congregando	Present
coletáveis	Past
encarregando	Present
desejariam	None
atazanadas	Past
demandará	Future
alavancarão	Future
alteada	Past
testam	Present
cortariam	None
extenderiam	None
ardendo	Present
dardejaria	None
encoleirareis	Future
titulado	Past
tunou	Past
apontamos	Present
declines	Present
existiriam	None
arrombada	Past
obcequei	Past
voou	Past
vedas	Present
alavancados	Past
desprezando	Present
tributaria	None
lavaria	None
boicotariam	None
capitulado	Past
suprimidos	Past
escreveríeis	None
exumada	Past
lastada	Past
maldisséreis	Past
pifados	Past
tensionado	Past
acabem	Present
salvaguardares	Future
depararei	Future
aprisionassem	Past
começou	Past
anatomizáramos	Past
abafardes	Future
procediam	Past
significaria	None
esguichais	Present
possuiriam	None
apimentais	Present
convalescerias	None
pensa	Present
sintetizariam	None
aboliam	Past
ajudariam	None
consolo	Present
desasassem	Past
esmagaria	None
formes	Present
chefiou	Past
actuará	Future
pouparia	None
interdita	Present
assassinou	Past
correlatamos	Present
clamam	Present
interpretavam	Past
sumindo	Present
sentiria	None
postam	Present
anunciariam	None
habitou	Past
supervisou	Past
flanqueiam	Present
conversassem	Past
roçando	Present
substantivariam	None
entusiasma	Present
escalfamos	Present
penais	Present
subscritos	Past
promulgaria	None
domesticai	None
define	Present
enviados	Past
lacei	Past
colecionando	Present
reproduz	Present
financiaria	None
registrada	Past
resolvam	Present
amai	None
ide	None
desgostado	Past
estranhei	Past
acrescentou	Past
invertida	Past
marreteis	Present
disporia	None
gazeteámos	Past
ocultadas	Past
simbolizado	Past
diria	None
descarrilado	Past
mantivessem	Past
custaria	None
retornado	Past
integrariam	None
demonstrados	Past
esquiando	Present
orbitem	Present
conceituai	None
correria	None
castiga	Present
suplantarias	None
troquei	Past
transportou	Past
povoassem	Past
subsidiaria	None
remontavam	Past
fraqueei	Past
participarão	Future
desprendidos	Past
olvidado	Past
testaríeis	None
adotariam	None
comprimo	Present
reutilizássemos	Past
acreditado	Past
endeusados	Past
sabermos	None
casa	Present
violo	Present
suplicavam	Past
tardaria	None
pediriam	None
commete	Present
contribuído	Past
desagravados	Past
eructaras	Past
agachadas	Past
rogariam	None
assombro	Present
desmantelando	Present
registarem	Future
atanazarmos	Future
esboçado	Past
mecanizáveis	Past
escamaríamos	None
tachando	Present
debuxáveis	Past
postarias	None
redirecionai	None
coalharíamos	None
derretidos	Past
filosofo	Present
validaras	Past
efetiva	Present
passa	Present
humidecem	Present
vulneráveis	Past
efectuassem	Past
trazer	None
indenizaria	None
casamos	Present
suicidaria	None
designaria	None
mandas	Present
vocalizarem	Future
saltarem	Future
concentraria	None
bombeado	Past
croma	Present
ilustraria	None
descobririam	None
haveria	None
estreladas	Past
conduziria	None
processaria	None
choraria	None
pegaria	None
pirai	None
revogando	Present
candidatariam	None
aperfeiçoará	Future
apoiariam	None
quadruplicáramos	Past
ajuizados	Past
contratada	Past
mateardes	Future
reverteriam	None
dominado	Past
sobejaríamos	None
odeiem	Present
veriam	None
pincelásseis	Past
negariam	None
consumiam	Past
nevados	Past
respeitariam	None
puni	Past
galvanizado	Past
ecoando	Present
erode	Present
antecedendo	Present
contradiria	None
perturbarem	Future
auxiliado	Past
calibrassem	Past
cobriria	None
aparelho	Present
armazenado	Past
pilotaria	None
publicitam	Present
fluirá	Future
esguicha	Present
restavam	Past
acerta	Present
pedalou	Past
transliterados	Past
abotoarias	None
rematásseis	Past
degradados	Past
destruírem	None
responderiam	None
repartiam	Past
originarias	None
condimentadas	Past
reinariam	None
ferve	Present
iniciavam	Past
forcem	Present
bombardeassem	Past
esforcei	Past
desanimado	Past
tomares	Future
aluno	Present
venero	Present
situaria	None
aras	Present
girou	Past
estipula	Present
perdidos	Past
existindo	Present
precederem	Future
capacitardes	Future
arrebatais	Present
implementado	Past
funcionem	Present
afligiria	None
decretaria	None
revendo	Present
cindirei	Future
exigiria	None
esterelizariam	None
obedecerá	Future
usa	Present
transcreve	Present
profetizariam	None
cindissem	Past
contrataríeis	None
creditado	Past
aplicariam	None
dançadas	Past
soessem	Past
efetivados	Past
desanimou	Past
reformam	Present
entorpece	Present
precisa	Present
acelerávamos	Past
disputassem	Past
adquiridos	Past
modernizem	Present
acobertam	Present
endeusaste	Past
economizarias	None
perdoamos	Present
constataríeis	None
suprirem	Future
renegados	Past
reciclou	Past
panaria	None
observavam	Past
reencontrarem	Future
presos	Past
conformavam	Past
crescidos	Past
descansados	Past
digitará	Future
interferiu	Past
constariam	None
chio	Present
retínheis	Past
curas	Present
incorporam	Present
conseguiríamos	None
reservassem	Past
ouso	Present
soariam	None
utilizem	Present
vedado	Past
pulinhes	Present
resmunguei	Past
pretendem	Present
classificarmos	Future
alargueis	Present
contém	Present
aninhas	Present
enfrentarão	Future
destilaria	None
incorporaria	None
sobreviveria	None
ridicularizam	Present
firmou	Past
agachámos	Past
soerias	None
ajudarem	Future
comentei	Past
denominado	Past
pulses	Present
adoptados	Past
ingeríreis	Past
arrancou	Past
capitalizando	Present
confiscou	Past
estacionam	Present
brande	Present
urdido	Past
pressionados	Past
acovardam	Present
dispensas	Present
simpatizeis	Present
cativando	Present
limita	Present
empilharemos	Future
encheriam	None
concluiria	None
lamentamos	Present
singrássemos	Past
generalizarás	Future
estiolassem	Past
resultando	Present
debulha	Present
ronca	Present
poderias	None
cooperado	Past
apostrofáveis	Past
emocionando	Present
sofrida	Past
exerceriam	None
implicassem	Past
buscai	None
capitaneai	None
difiram	Present
começarei	Future
interpretados	Past
veríamos	None
iniciada	Past
alargaria	None
endossa	Present
lati	Past
retomavam	Past
permeavam	Past
implicavam	Past
cabida	Past
metais	Present
censurarem	Future
discutam	Present
curtindo	Present
admirarás	Future
funcionarão	Future
aconselham	Present
quebrantarem	Future
invadiria	None
empobrecida	Past
raia	Present
rotam	Present
liberarem	Future
haverem	None
recuperará	Future
ajeitei	Past
presumi	Past
fusionadas	Past
baleou	Past
conterão	Future
mosco	Present
espalharia	None
enriquecidas	Past
cavoucavas	Past
atribuiu	Past
emprehendidas	Past
vinde	None
renuncieis	Present
duelou	Past
lustrardes	Future
desculpada	Past
configurará	Future
fosforilada	Past
aninhariam	None
doendo	Present
eliminariam	None
desejaria	None
desobrigando	Present
sentidos	Past
sagrarem	Future
enlouqueceu	Past
abordariam	None
delineados	Past
metei	None
estruturas	Present
perguntaria	None
denuncia	Present
recrutando	Present
apostemavas	Past
debateria	None
representaríeis	None
expiraria	None
administrariam	None
namoraria	None
assemelham	Present
culminaria	None
recorridos	Past
lastimada	Past
chumbada	Past
pico	Present
meditam	Present
motivas	Present
compararia	None
salvado	Past
residissem	Past
tarda	Present
arquivaria	None
prediquei	Past
emendando	Present
acharias	None
pedalada	Past
libertarias	None
assemelharia	None
randomizas	Present
ordenaria	None
povoas	Present
photographo	Present
recompensariam	None
abduzido	Past
encostado	Past
conseguirá	Future
mascando	Present
desappareceres	Future
espalhariam	None
danificando	Present
preocupa	Present
decantavam	Past
afeganizasses	Past
perdidas	Past
seguram	Present
adaptarmos	Future
invadido	Past
afligirias	None
reproduziria	None
vivenciem	Present
zumbiria	None
resolveria	None
azaradas	Past
zanzáreis	Past
bordassem	Past
pulsareis	Future
viestes	Past
disseminado	Past
congregam	Present
traduzem	Present
abalados	Past
abasteceu	Past
emocionaras	Past
salvaguardarias	None
compreendido	Past
beijai	None
exhortáramos	Past
dispus	Past
actualizei	Past
ensinem	Present
obrigariam	None
aluna	Present
plantes	Present
crede	None
delegando	Present
entrei	Past
simulados	Past
unhado	Past
soldada	Past
denominavam	Past
estoirareis	Future
rotulados	Past
concluirá	Future
poliste	Past
dobra	Present
servissem	Past
vitrificarem	Future
pescou	Past
opomos	Present
deterá	Future
apega	Present
multariam	None
analisarias	None
oferecerem	Future
explodiam	Past
entro	Present
realizou	Past
engraçassem	Past
evitarem	Future
perfilariam	None
atrapalharia	None
compreenderiam	None
desobstrui	Present
resultariam	None
simpatizo	Present
alteraria	None
bocejo	Present
acabamos	Present
falharíeis	None
cederiam	None
arrendaríeis	None
utilizaria	None
arrematou	Past
guglaríeis	None
devolvi	Past
digere	Present
desleixavam	Past
custeados	Past
aráveis	Past
acessando	Present
descamando	Present
inchando	Present
afastada	Past
lutamos	Present
ressoáreis	Past
promulgai	None
selecionou	Past
atrelarão	Future
prives	Present
compartilharia	None
implicaria	None
embebido	Past
desniveladas	Past
pereceriam	None
odiando	Present
orbitou	Past
reiterada	Past
ranges	Present
buscado	Past
cuidavam	Past
afazeres	None
alfaiataria	None
dominarem	Future
tivessem	Past
cancelassem	Past
prosperaria	None
simplificámos	Past
lambem	Present
marcam	Present
alcançavam	Past
expressado	Past
resguardaríeis	None
coadjuva	Present
empresto	Present
chibataríamos	None
copularíamos	None
exposto	Past
assentaria	None
pendiam	Past
conferiria	None
distanciavam	Past
retrocederia	None
correspondido	Past
vinca	Present
vidradas	Past
quantificam	Present
retouçam	Present
envia	Present
desseguíeis	Past
infiltradas	Past
ateríamos	None
calibrai	None
alegariam	None
secando	Present
filiaria	None
agregassem	Past
evidenciem	Present
delonga	Present
distinguirem	Future
candidatarias	None
contemplado	Past
dispostos	Past
interceptado	Past
finlandizados	Past
caraterizada	Past
listaria	None
falsificada	Past
apoiaria	None
compreendidas	Past
opinei	Past
pré-comprado	Past
exortavam	Past
antecederiam	None
loteada	Past
desconcertado	Past
proporcionarão	Future
imaginávamos	Past
reduz	Present
sufocando	Present
desflorestemos	Present
ajustam	Present
transladando	Present
chiastes	Past
estorvaremos	Future
lavrada	Past
coadjuvará	Future
especificado	Past
lavráramos	Past
tenderia	None
encurtado	Past
exilarem	Future
acerba	Present
votásseis	Past
subestimada	Past
insinuado	Past
prorroga	Present
irradiaremos	Future
hipertrofiado	Past
ressuscitados	Past
detalharia	None
cobravam	Past
usardes	Future
manejados	Past
dirias	None
pressurizais	Present
propusessem	Past
emmolduraríamos	None
escusa	Present
testemunharem	Future
decidamos	Present
salvará	Future
sairei	Future
efectuado	Past
misturassem	Past
concretizem	Present
transportaria	None
publicitados	Past
aniquilada	Past
detestarias	None
lascados	Past
emagrecerão	Future
visitem	Present
pré-datam	Present
concretizariam	None
desconversado	Past
chegássemos	Past
arrastando	Present
estimulávamos	Past
vestidas	Past
entenderás	Future
fomentaria	None
viajariam	None
encharcasses	Past
dotes	Present
ministraria	None
apreciai	None
distorçam	Present
responsabilizo	Present
extrato	Present
afastaria	None
divagaste	Past
caraterizam	Present
alvejou	Past
alardeiam	Present
postarei	Future
toleraria	None
depositarem	Future
antolhados	Past
grafitariam	None
espancados	Past
avaliados	Past
dissolves	Present
cometerás	Future
livravam	Past
observai	None
estariam	None
apelidados	Past
pressinto	Present
faltaria	None
flutuáveis	Past
condicionavam	Past
aleijariam	None
retrocederas	Past
resolvessem	Past
desviassem	Past
escachoarão	Future
ensejam	Present
entelhai	None
gazeteada	Past
transmutada	Past
aderiria	None
amputai	None
prováveis	Past
datai	None
clicam	Present
rebatêreis	Past
reli	Past
queixaríamos	None
preferiria	None
esclarecerá	Future
ataviará	Future
arrependei	None
efetuaríeis	None
decretando	Present
planejada	Past
escachoavam	Past
ergueria	None
poderei	Future
domesticásseis	Past
distribuiria	None
teimas	Present
decifraríamos	None
rumaria	None
expurgarei	Future
escorre	Present
leria	None
figurarão	Future
nomearia	None
ornamento	Present
lingotes	Present
tenderiam	None
doavam	Past
encareciam	Past
dotavam	Past
gesticulou	Past
modulares	Future
assegurando	Present
opor	None
pensei	Past
estudou	Past
licitadas	Past
desfiguraríamos	None
equipam	Present
profanas	Present
paginas	Present
photographares	Future
manipulam	Present
deli	Past
defenderiam	None
corrigiríeis	None
fartas	Present
desses	Past
zoas	Present
contesto	Present
recordará	Future
reescrevíeis	Past
acharei	Future
aguilhoariam	None
pesquisaria	None
rendada	Past
guiado	Past
bajularia	None
ataviadas	Past
riria	None
atrelado	Past
neutraliza	Present
alfaiatado	Past
permitissem	Past
entorpecêramos	Past
fingirem	Future
idealizando	Present
importa	Present
descamardes	Future
apóio	Present
regularia	None
barravas	Past
distribuiriam	None
marchai	None
entrego	Present
serrado	Past
choveríamos	None
movo	Present
refaze	None
espediriam	None
contornou	Past
maltarias	None
dramatizadas	Past
enriqueceria	None
desagradecei	None
precipitarem	Future
reprimiam	Past
endossando	Present
solicitaria	None
deixaríamos	None
olharem	Future
zelai	None
devastais	Present
empenhado	Past
encampando	Present
outorgados	Past
buzinaria	None
recontaras	Past
sombreados	Past
dispondo	Present
consentido	Past
ocultaríamos	None
enfrentaria	None
vivenciais	Present
rodo	Present
apoderarem	Future
acelerai	None
caracterizou	Past
buscariam	None
alardeada	Past
testadas	Past
manteríamos	None
anexas	Present
variariam	None
raiadas	Past
danados	Past
visados	Past
aconteceriam	None
possuírem	Future
acumulariam	None
estendiam	Past
escrutinizavam	Past
reproduziam	Past
succederás	Future
comemorada	Past
levares	Future
inebriemos	Present
aromatizados	Past
sobressaindo	Present
cevada	Past
expandirmos	Future
apostrofai	None
escarnecerias	None
estudaria	None
redirecionem	Present
retrataria	None
compenetrada	Past
empatam	Present
desapareceriam	None
impunham	Past
acessamos	Present
maldizerdes	None
assentou	Past
obliterada	Past
sorteio	Present
montariam	None
moves	Present
reorganizam	Present
libertaria	None
arredondaria	None
pratico	Present
alfaiatarão	Future
decresce	Present
batizados	Past
entregamos	Present
apenso	Present
criarmos	Future
aureolaria	None
rogam	Present
adjudicada	Past
recurvaria	None
parcela	Present
invalidados	Past
selectastes	Past
denotaríamos	None
classificariam	None
emitiriam	None
aplicarão	Future
responderia	None
quarentena	Present
delineou	Past
atea	Present
esforçarem	Future
jurai	None
colori	Past
condimentaria	None
disponibilizemos	Present
surgiu	Past
moradas	Past
argumenta	Present
protegei	None
preocupados	Past
proporcionariam	None
interrompem	Present
olvidarás	Future
alertado	Past
socorrem	Present
lidaria	None
incapacitadas	Past
assemelhado	Past
copiáveis	Past
implementando	Present
apegada	Past
forçaria	None
colidiu	Past
tremem	Present
arquivarão	Future
eclipses	Present
amortizando	Present
contestaria	None
ventilado	Past
anularei	Future
instituiriam	None
tida	Past
prenderem	Future
desperdiçarias	None
traduziam	Past
olháramos	Past
acercaríeis	None
beatificaremos	Future
dormidas	Past
aterem	None
inventavam	Past
deserdou	Past
rufai	None
andarmos	Future
lavei	Past
assisti	Past
acertaria	None
livrai	None
encolherão	Future
estouro	Present
apartados	Past
noticiado	Past
gerenciou	Past
centrifugado	Past
exibiria	None
inutilizado	Past
aviso	Present
patrulhando	Present
angariando	Present
caminharia	None
adequaria	None
recolocou	Past
zico	Present
hospitalizastes	Past
concretássemos	Past
elogiadas	Past
velleja	Present
conhece	Present
cedes	Present
obtém	Present
dedicaria	None
habita	Present
confiro	Present
priorizou	Past
apiedando	Present
agrado	Present
consumiu	Past
valoradas	Past
anquilosaras	Past
curavam	Past
abrigariam	None
lisonjearíeis	None
arrendado	Past
uniformizareis	Future
beirariam	None
sofreriam	None
surpreendida	Past
lesmo	Present
procederiam	None
armo	Present
acionadas	Past
escurece	Present
balanças	Present
entronados	Past
avisada	Past
prejudiquei	Past
coaxo	Present
ponderando	Present
bateriam	None
prosseguiam	Past
basearia	None
fretes	Present
incidem	Present
votados	Past
plugados	Past
recebei	None
filtra	Present
vedada	Past
trovejando	Present
entenderiam	None
declarando	Present
acedi	Past
manifestastes	Past
lembrará	Future
ecoavam	Past
prosseguiriam	None
precipitaria	None
rimam	Present
obedeceria	None
trabalhando	Present
auferido	Past
drapejei	Past
treináreis	Past
celebrai	None
interceptavam	Past
tresanda	Present
administrassem	Past
escrevam	Present
aquecidos	Past
caceteaste	Past
elaborando	Present
exagerarem	Future
pino	Present
destroçado	Past
congregada	Past
revermos	None
escondiam	Past
reembolsada	Past
atalhando	Present
substituídos	Past
estereotipamos	Present
outorgas	Present
duvidaria	None
coroado	Past
arrebentadas	Past
controlaria	None
contataria	None
albergues	Present
expiravam	Past
saltearíamos	None
possuído	Past
anuláveis	Past
surras	Present
abstraindo	Present
magnificado	Past
franjam	Present
confraternizaríamos	None
grasnou	Past
quedas	Present
apostaria	None
adorariam	None
segmenta	Present
habitassem	Past
actuando	Present
seguiria	None
aproveitou	Past
assumidas	Past
pintando	Present
responderá	Future
incorridas	Past
criticaríeis	None
desmantela	Present
trariam	None
diplomado	Past
pulso	Present
ater	None
nutriríeis	None
oxigenas	Present
vandalizaria	None
florescido	Past
surgiria	None
varáveis	Past
divulga	Present
calculado	Past
fluorarias	None
germina	Present
carrego	Present
suplantadas	Past
avançou	Past
divorciaria	None
desmatarias	None
correspondida	Past
revertidas	Past
produziria	None
idearíeis	None
compra	Present
estimularia	None
amputaríeis	None
fingiremos	Future
cifrando	Present
acarditarias	None
transladai	None
honra	Present
assegurariam	None
mencionariam	None
acrescentaria	None
requisitou	Past
gorado	Past
legendado	Past
conjecturavam	Past
desterrou	Past
voariam	None
restabelecida	Past
datam	Present
sincronizaríeis	None
amuralhado	Past
colaborado	Past
montando	Present
contaria	None
distribuí	Past
diferindo	Present
agradecias	Past
exibe	Present
termos	None
farfalhai	None
florestada	Past
queixam	Present
fazermos	None
permaneceria	None
herdou	Past
abocanhado	Past
violou	Past
espuma	Present
fisgado	Past
estabeleceriam	None
confinavas	Past
nasceu	Past
tereis	Future
complementou	Past
reproduzida	Past
renderia	None
acometem	Present
pretendeu	Past
protegiam	Past
igualem	Present
ativarás	Future
conhecereis	Future
sangraríamos	None
escalfaríeis	None
moverão	Future
estacionado	Past
sustariam	None
constituiria	None
tuitaria	None
transcorridos	Past
supormos	None
apitarias	None
noticiavam	Past
facultai	None
vitima	Present
parodiou	Past
enegrecida	Past
apontarão	Future
vestirá	Future
bombeareis	Future
benzidas	Past
escuta	Present
monitorando	Present
engomados	Past
apagará	Future
travariam	None
vingará	Future
tostadas	Past
descomplicaríamos	None
jogariam	None
dificultaria	None
vivessem	Past
concorram	Present
zeravam	Past
relaxados	Past
seco	Present
queima	Present
introduziria	None
capotaria	None
apresenta	Present
salvavam	Past
sentai	None
ditadas	Past
comprovavam	Past
aprofundaria	None
mosqueis	Present
enumero	Present
angariado	Past
computáveis	Past
ateve	Past
apoiadas	Past
aforada	Past
desataríamos	None
passaria	None
antecederem	Future
vigorando	Present
bico	Present
atacaria	None
garantindo	Present
promulgueis	Present
arredaríamos	None
superariam	None
sobrariam	None
acusassem	Past
fotografadas	Past
esquilares	Future
tragou	Past
reforçaria	None
convoquem	Present
beneficiarão	Future
enriquecem	Present
interpretariam	None
sujeitareis	Future
moldaria	None
cunha	Present
folgaria	None
continuaria	None
meditarem	Future
apinhados	Past
insinem	Present
suássemos	Past
florestadas	Past
reboco	Present
remontarias	None
respondeu	Past
motivaria	None
contrairia	None
elogiei	Past
ceifaria	None
articulariam	None
embaralhados	Past
assemelhadas	Past
disporem	None
gelam	Present
penduraria	None
triunfado	Past
printareis	Future
facilita	Present
vilificarás	Future
comerá	Future
aproximando	Present
codificados	Past
fariam	None
ultrapassáreis	Past
alienados	Past
adormecem	Present
boiei	Past
descreverás	Future
desbotáreis	Past
chateada	Past
arrancarem	Future
passariam	None
semeadas	Past
emitem	Present
cindi	Past
transcendido	Past
lucravam	Past
numero	Present
tocas	Present
baldas	Present
regidos	Past
luzes	Present
ressalvado	Past
adjetivo	Present
argentastes	Past
datilografado	Past
mijas	Present
aparentaríamos	None
relacionas	Present
rapelaríamos	None
fumem	Present
tatuaríamos	None
escaramuças	Present
mostra	Present
plasmardes	Future
descansaria	None
esmaguem	Present
rebelou	Past
dar	None
acompanhará	Future
alem	Present
suportou	Past
brincando	Present
contrabalançada	Past
varreria	None
frises	Present
roei	None
enxergaria	None
fantasia	Present
realizamos	Present
homenageavam	Past
atirarem	Future
traças	Present
encorajamos	Present
geraria	None
demitiria	None
tramam	Present
lesando	Present
testemunhásseis	Past
empanturrarias	None
excelerei	Future
devo	Present
dissipadas	Past
homenageiam	Present
orientaria	None
percebeste	Past
integremos	Present
desgastei	Past
brigaria	None
candidataríeis	None
ouviriam	None
comida	Past
preocuparia	None
repetiria	None
adviriam	None
argumentem	Present
transbordariam	None
modificariam	None
anunciemos	Present
ameaçaria	None
cardada	Past
anafes	Present
entumesças	Present
acumularia	None
designariam	None
mina	Present
dirijo	Present
afrouxou	Past
combatiam	Past
comprariam	None
tranças	Present
predominam	Present
codificando	Present
voltai	None
romanizadas	Past
sancionou	Past
semelham	Present
postais	Present
concreto	Present
aparentou	Past
penduravam	Past
colecionaria	None
acertas	Present
reservarás	Future
isco	Present
hipotecáreis	Past
creria	None
zonaria	None
desintegrávamos	Past
precisássemos	Past
provocariam	None
enguiço	Present
miscrariam	None
celebramos	Present
enfeitiçadas	Past
escanceada	Past
gozei	Past
realçam	Present
possuo	Present
justificaria	None
minaria	None
numerado	Past
recomendado	Past
custado	Past
contatado	Past
torpedeada	Past
afrancesarmos	Future
manter	None
pincelai	None
precederia	None
devotavam	Past
apóiem	None
manches	Present
construiria	None
incidiria	None
antojavam	Past
atracaste	Past
permeamos	Present
desafiaria	None
adviria	None
derramarem	Future
desprotegessem	Past
consentirias	None
vazas	Present
comprometeu	Past
comparecido	Past
sobressaem	Present
explicaria	None
mentem	Present
mateai	None
ouvirá	Future
compilaria	None
impulsionados	Past
destinaria	None
cambastes	Past
bronzeai	None
disporiam	None
recolherem	Future
gemido	Past
recordemos	Present
distanciaria	None
imigra	Present
tentemos	Present
divertida	Past
decifrado	Past
plagiaríamos	None
contatais	Present
falariam	None
socorro	Present
atribuirmos	Future
ressaltavam	Past
pegou	Past
desonerado	Past
epitomizaríamos	None
perfariam	None
precisaríeis	None
sibilaria	None
reafirmados	Past
emprestarem	Future
valorizaria	None
livras	Present
recitado	Past
comercializou	Past
couberes	Future
reunida	Past
fornecerá	Future
padeciam	Past
animaria	None
escuitei	Past
doirada	Past
pularia	None
aviaria	None
injuriou	Past
refletiu	Past
badalo	Present
clicado	Past
servi	Past
ver	None
interpretem	Present
silvo	Present
poria	None
dada	Past
zombares	Future
livro	Present
permitiriam	None
aguardado	Past
hackeia	Present
conjugando	Present
formulei	Past
envernizada	Past
importaria	None
serres	Present
possibilitados	Past
impulsionais	Present
adoçarás	Future
acompanhai	None
emendou	Past
pegas	Present
bombes	Present
proliferem	Present
escutai	None
amarrei	Past
moviam	Past
aproveitada	Past
busco	Present
seriados	Past
deserda	Present
conteria	None
envergonhariam	None
casso	Present
desmaiaria	None
irradiardes	Future
sola	Present
contesta	Present
confinam	Present
prolongando	Present
personalizando	Present
revelai	None
anuncia	Present
miscraria	None
sondou	Past
acariciaríamos	None
variarmos	Future
insiste	Present
finalizadas	Past
aprumáramos	Past
danai	None
ornamentais	Present
bastaria	None
elevarem	Future
crescei	None
enforcardes	Future
sobressaístes	Past
ocorrido	Past
transes	Present
pilotado	Past
aprumarem	Future
envolverão	Future
predicariam	None
arruarem	Future
enxergaremos	Future
postulam	Present
enriqueceriam	None
sumíreis	Past
cristalizaria	None
dessulfuraria	None
traficada	Past
incha	Present
compreendermos	Future
designaríeis	None
enerva	Present
encolerizáveis	Past
baterias	None
botemos	Present
manterdes	None
misturado	Past
alego	Present
tangida	Past
afagáveis	Past
lastimado	Past
abobadado	Past
dublam	Present
ditariam	None
invectivai	None
molhavam	Past
acopláramos	Past
atravessaria	None
resgatando	Present
afinaríamos	None
checassem	Past
emprestavam	Past
santificaria	None
descreveriam	None
encantaria	None
acuminamos	Present
abrigadas	Past
ponderou	Past
freqüentada	Past
salvaria	None
entendeu	Past
modernizaríeis	None
cruzariam	None
emergissem	Past
hospitalizada	Past
decepcionam	Present
surpreenderia	None
incendiaria	None
irritados	Past
obriga	Present
desacelera	Present
restabelecidos	Past
prestadas	Past
desabilitando	Present
enxertardes	Future
alegassem	Past
sintetizado	Past
comparada	Past
derrogaríeis	None
ousei	Past
contactando	Present
sucedeu	Past
russificados	Past
energizem	Present
controlariam	None
desinflariam	None
bancarias	None
esculachardes	Future
dediquei	Past
identificaria	None
atravessou	Past
esperarei	Future
alcançado	Past
apressa	Present
tunes	Present
tratados	Past
absorviam	Past
iras	Present
descolam	Present
endereçáveis	Past
areia	Present
protegermos	Future
usaríamos	None
antidoto	Present
ululai	None
urgiu	Past
balançaríeis	None
contrariaríamos	None
bamboleei	Past
endireitaríeis	None
confirmaria	None
imporem	None
doídas	Past
defequei	Past
ordenhariam	None
exigem	Present
estagiaríeis	None
traves	Present
desterraste	Past
mencionas	Present
negligenciados	Past
cumprimentarem	Future
assumiria	None
desvendam	Present
dataria	None
iríamos	None
vigoraria	None
engomáreis	Past
culminam	Present
beneficio	Present
opinem	Present
prever	None
refrigerada	Past
calhou	Past
mantende	None
agoirentávamos	Past
baixarias	None
perdoada	Past
vilipendiaria	None
bloquearmos	Future
fatigaria	None
sedimento	Present
escrituramos	Present
aportuguesados	Past
encaixo	Present
solda	Present
costurada	Past
alicerçou	Past
regulares	Future
acumulavam	Past
sanciono	Present
tapai	None
enviai	None
deveríamos	None
rebaixaria	None
sufocado	Past
sonambularão	Future
partindo	Present
fotografou	Past
duplicou	Past
afiladas	Past
expandiriam	None
absorvidas	Past
mexido	Past
racha	Present
benditos	Past
introduzam	Present
comandariam	None
branqueio	Present
arquearia	None
protegessem	Past
saibas	Present
sobrepor	None
varre	Present
amaciarmos	Future
vermelhejando	Present
furai	None
decorreriam	None
labutariam	None
civilizadas	Past
investirem	Future
emmoldurais	Present
aconchega	Present
desonerai	None
isolem	Present
ungisses	Past
defendidas	Past
parafraseadas	Past
publicamos	Present
ditados	Past
armarias	None
discados	Past
embalo	Present
investigo	Present
restaurado	Past
solando	Present
solaria	None
encomendada	Past
desmanchadas	Past
aborrecida	Past
aconselharem	Future
seriado	Past
purgarias	None
recomendo	Present
venceriam	None
monitorizaremos	Future
indicarmos	Future
distorcem	Present
regurgitada	Past
conturbai	None
ouve	Present
devolveria	None
assoviaria	None
referenciarei	Future
retiraria	None
fecho	Present
alimentando	Present
telhaste	Past
estou	Present
recrudesceriam	None
levantariam	None
isolam	Present
refugiavam	Past
imperando	Present
começados	Past
praticaria	None
calcularíamos	None
duro	Present
devisares	Future
devido	Past
fosfato	Present
afloraríamos	None
contornam	Present
contaminaria	None
tocaria	None
minerando	Present
cronometrada	Past
chutando	Present
desancorarias	None
enviaremos	Future
enxergado	Past
intermediaria	None
relacionais	Present
implantarem	Future
maldisseres	Future
juntavam	Past
chefiaria	None
fluem	Present
incubo	Present
regulamentáramos	Past
redigiriam	None
requerendo	Present
contornando	Present
estanca	Present
incitem	Present
jaziam	Past
evaporados	Past
esvoaçariam	None
influiriam	None
alegarem	Future
condecorou	Past
facilitariam	None
haveríamos	None
assobiadas	Past
acirrando	Present
aprumas	Present
fraseado	Past
qualificaria	None
instigada	Past
especulado	Past
fraccionados	Past
congregaria	None
arrastado	Past
arrasáramos	Past
aplaudiu	Past
atingirá	Future
amamentou	Past
obteríamos	None
acharia	None
antepomos	Present
facturaríeis	None
ativado	Past
relaxando	Present
experienciando	Present
resenhámos	Past
gabai	None
fraccionada	Past
arrendas	Present
danificaria	None
almejando	Present
encaminhado	Past
assistiriam	None
esbanjado	Past
polimeriza	Present
metabolizado	Past
surtam	Present
topei	Past
reencontrariam	None
cederá	Future
reprovados	Past
manteriam	None
injetavam	Past
communicada	Past
rodam	Present
funcionamos	Present
incorrem	Present
voltaremos	Future
prefabricado	Past
adequou	Past
fluíam	Past
americanizado	Past
ameaçávamos	Past
focaliza	Present
maltratados	Past
atas	Present
asai	None
resolveriam	None
cinde	Present
querermos	None
deis	Present
aperfeiçoarias	None
restaurassem	Past
apura	Present
alambiquemos	Present
comungam	Present
afagada	Past
recomeçando	Present
amaria	None
liderariam	None
intercetou	Past
investigadas	Past
trazei	None
escrevei	None
judiaria	None
graduarem	Future
incisaria	None
abandonariam	None
urjas	Present
aromatizadas	Past
percamos	Present
visitarei	Future
pulará	Future
secretados	Past
reenviem	Present
arranjarem	Future
gerias	Past
pretenderem	Future
estragam	Present
habituei	Past
fornecidas	Past
recolheu	Past
estarem	None
trancasses	Past
abnegado	Past
reafirmariam	None
aleito	Present
estacaria	None
adjetiváramos	Past
participará	Future
desmobilizáveis	Past
subjetivaríeis	None
beatificares	Future
chuviscaríamos	None
dobraria	None
discutiu	Past
inventados	Past
vellejada	Past
arriscou	Past
fornicariam	None
ensombrada	Past
reuniria	None
publicitai	None
inclino	Present
riparia	None
fechando	Present
exibirá	Future
ultrapassariam	None
flagelará	Future
rolo	Present
entrariam	None
decepada	Past
reinventando	Present
significada	Past
encaminhando	Present
contradizerem	None
beneficiaria	None
empenhados	Past
consolidariam	None
acrescentei	Past
riscado	Past
vasculhada	Past
raparias	None
descendem	Present
odeiam	Present
admite	Present
confraternizavas	Past
desprezaria	None
compartilhariam	None
surdida	Past
prestas	Present
acumularem	Future
decidiriam	None
papai	None
beneficiam	Present
causarás	Future
veraneavam	Past
destinarem	Future
existiam	Past
conquistariam	None
julgariam	None
divulgou	Past
aclimatais	Present
esgueirando	Present
executado	Past
surtámos	Past
parodia	Present
dissolveria	None
colmasses	Past
girado	Past
desprotegido	Past
mirai	None
olham	Present
favoreceria	None
descidas	Past
faturaria	None
comprovariam	None
desfarçarias	None
aventada	Past
falta	Present
referencia	Present
secundarias	None
quiserem	Future
atrasadas	Past
cultuam	Present
permitiria	None
gaseificado	Past
gazeadas	Past
alternam	Present
chegadas	Past
precisavam	Past
interromperia	None
pré-datai	None
posicionando	Present
citados	Past
amavas	Past
divirto	Present
panados	Past
consentiria	None
interceptadas	Past
objetarias	None
sobreviveu	Past
dadas	Past
dessulfuraríamos	None
originariam	None
surfam	Present
lamina	Present
cederia	None
estraçalhais	Present
plange	Present
alicatearíamos	None
especializaríeis	None
tocariam	None
emancipou	Past
festai	None
oferecido	Past
arrebanhou	Past
amarelou	Past
preceitues	Present
preparei	Past
afirmaste	Past
nasalariam	None
pines	Present
prediz	Present
secará	Future
implicados	Past
afoga	Present
apodrecida	Past
descri	Past
subsidia	Present
criticariam	None
abarcaria	None
distorciam	Past
pruridos	Past
redirecionaria	None
nasceria	None
contestai	None
untariam	None
anteponde	None
pacificámos	Past
trabalharei	Future
acusaria	None
folheia	Present
zero	Present
transladada	Past
publicará	Future
aparato	Present
clonando	Present
prenderá	Future
alterem	Present
proporcionada	Past
enganadas	Past
advinham	Past
providenciei	Past
atemparem	Future
solado	Past
acasalam	Present
conceituados	Past
derroga	Present
dobrada	Past
bronzeasses	Past
cumula	Present
rearrumaria	None
orientará	Future
bombearias	None
desproporciona	Present
projetavam	Past
sublimando	Present
desasariam	None
escavarias	None
macerados	Past
emprehenderias	None
inventamos	Present
assimilemos	Present
esfriando	Present
derrotavam	Past
negativariam	None
lavados	Past
beliscas	Present
africanizada	Past
ascendíeis	Past
invocaria	None
reunissem	Past
peleja	Present
seduziremos	Future
rectificariam	None
denominaria	None
estragaria	None
tutelada	Past
aproprias	Present
desfraldado	Past
brincaras	Past
sussurrando	Present
tampada	Past
empestearás	Future
fantasiados	Past
selectei	Past
interviriam	None
interrompi	Past
divertirem	Future
salivarão	Future
sediou	Past
reconquistariam	None
espremido	Past
lotam	Present
emigraria	None
repetido	Past
salivásseis	Past
apreciei	Past
carregaria	None
cerrou	Past
apagaríeis	None
sobreposta	Past
modules	Present
ferido	Past
transcrevas	Present
perdoados	Past
sorvêreis	Past
fino	Present
apadrinhada	Past
arrependam	Present
revelaria	None
injustiças	Present
enfardelemos	Present
emana	Present
morariam	None
frequentou	Past
alarmasses	Past
protegeríeis	None
recorreria	None
repeti	Past
plugamos	Present
desarrumaremos	Future
desimpedisses	Past
adoptavam	Past
abalroaríeis	None
entrarem	Future
adjudicai	None
terceirizaria	None
ministrarias	None
abstivessem	Past
rangeríeis	None
somaria	None
saltitando	Present
oporei	Future
carpais	Present
alcalinizarias	None
pontuaríamos	None
prestada	Past
subscrevam	Present
libertas	Present
fluoreto	Present
griparia	None
transformei	Past
espiando	Present
prensam	Present
sugerido	Past
expurgados	Past
zerado	Past
deletai	None
aviarmos	Future
ocultarás	Future
registramos	Present
reuniriam	None
treinarem	Future
dominassem	Past
desatou	Past
impediriam	None
dedicariam	None
determinamos	Present
encolerizado	Past
fusionado	Past
coligidas	Past
candidataria	None
engrena	Present
impregnados	Past
estacada	Past
ofenderes	Future
dás	Present
compensou	Past
eliminamos	Present
explodirá	Future
modeladas	Past
cortem	Present
invernado	Past
regressarem	Future
geradas	Past
ajustaria	None
escavares	Future
decepariam	None
reconhecêreis	Past
insinarás	Future
gesticularia	None
esquecêreis	Past
surjais	Present
balai	None
criaste	Past
suavizariam	None
revisarem	Future
impugnados	Past
silencia	Present
ejaculavam	Past
inundadas	Past
desabrocha	Present
incapacitado	Past
oriento	Present
antepor	None
celebraria	None
contrataria	None
honrando	Present
perguntando	Present
virai	None
dourados	Past
consultará	Future
adotaria	None
reclamou	Past
desvairadas	Past
pastai	None
contactada	Past
davam	Past
retornaria	None
engasgarás	Future
delegavam	Past
desmistificaríamos	None
seguro	Present
incisaríeis	None
batizaria	None
doaria	None
espirraríeis	None
transmitido	Past
justificariam	None
descoladas	Past
descascais	Present
punido	Past
abarcaríeis	None
ferraria	None
desmitificavam	Past
fracionam	Present
afiáveis	Past
abastadas	Past
residiu	Past
algoritmizariam	None
louvada	Past
consideras	Present
sitiaríamos	None
uniriam	None
moderando	Present
prantearíeis	None
ancorassem	Past
distribuíam	Past
reconstitui	Present
varridos	Past
suai	None
privada	Past
respeitadas	Past
atacariam	None
pressurizastes	Past
admitiu	Past
dinamizado	Past
exortou	Past
loteado	Past
independe	Present
elogiávamos	Past
alistadas	Past
graduam	Present
conversavam	Past
colonizados	Past
visualizadas	Past
considerais	Present
pensará	Future
danei	Past
dividiriam	None
desatarraxarias	None
tornariam	None
arrefece	Present
viu	Past
apregoando	Present
assumirá	Future
opinaria	None
declararia	None
conheceriam	None
obliterastes	Past
evacuávamos	Past
relaciones	Present
conseguida	Past
santifica	Present
informes	Present
aturdido	Past
erodirias	None
estaca	Present
propagando	Present
predáramos	Past
reconheço	Present
perfumaria	None
posicionou	Past
desmaiados	Past
conheceria	None
imitavam	Past
priváveis	Past
sondaríeis	None
recuperariam	None
xerocassem	Past
atolaras	Past
efetivas	Present
desintegrados	Past
desconsiderou	Past
inflama	Present
debatem	Present
irritada	Past
figurarem	Future
possibilitem	Present
disseminou	Past
facultadas	Past
levarmos	Future
telefonou	Past
esquentando	Present
extinguiria	None
ratificassem	Past
elaboraria	None
adicionardes	Future
encaminhariam	None
diferenciado	Past
atendida	Past
embasai	None
chia	Present
tornaria	None
decantaria	None
concretizaria	None
transpirai	None
seriareis	Future
substituirias	None
fascinavam	Past
concebiam	Past
pacificadas	Past
mandareis	Future
parou	Past
chutastes	Past
criaríamos	None
agraciasses	Past
inclinou	Past
aglutina	Present
enredo	Present
derrubará	Future
respondes	Present
agradada	Past
autorizou	Past
trataria	None
possuída	Past
encaixaria	None
cavavam	Past
refletiriam	None
empunha	Present
confundido	Past
destina	Present
abandeirarás	Future
choramingámos	Past
visitarão	Future
esclarecido	Past
quitariam	None
comentados	Past
cessariam	None
legendada	Past
cobrirei	Future
configuraria	None
calques	Present
recairia	None
restes	Present
vencerão	Future
lamentavam	Past
saturariam	None
restarem	Future
diminuiu	Past
tropeço	Present
liquido	Present
estalamos	Present
aflige	Present
caído	Past
acomodando	Present
amuralhada	Past
desregulados	Past
devolve	Present
direccionáramos	Past
lobrigaria	None
queimariam	None
aceitaria	None
restituiríeis	None
jejuarás	Future
paginada	Past
nada	Present
fundindo	Present
desci	Past
instalem	Present
cotes	Present
fermentáveis	Past
querelas	Present
ladras	Present
fundiriam	None
fortificou	Past
rompem	Present
descenderiam	None
vandalizou	Past
interviria	None
agitam	Present
muniu	Past
deambulavam	Past
desabilitadas	Past
estrangulam	Present
pronunciaríeis	None
honravam	Past
dourais	Present
sofreria	None
datilografando	Present
realizarmos	Future
monitorada	Past
mateássemos	Past
estatizada	Past
pontuavam	Past
desmanchávamos	Past
dribla	Present
defenestra	Present
investiam	Past
asilou	Past
escorrem	Present
secundai	None
metteríamos	None
embaralharem	Future
apinharei	Future
aprazerem	None
transitam	Present
escorregarem	Future
acanhámos	Past
enredaria	None
destillaríeis	None
cegando	Present
condenariam	None
inscreve	Present
explorariam	None
lançaria	None
incubado	Past
desencantados	Past
joeirarias	None
desencanta	Present
condimentares	Future
retenham	Present
concorrais	Present
comeria	None
precisaríamos	None
adverbializados	Past
pintareis	Future
puxou	Past
mostraríeis	None
coroou	Past
hibridizados	Past
questionam	Present
brecariam	None
desenvolveria	None
destinavam	Past
originada	Past
simboliza	Present
sujeitaria	None
organizaria	None
beijavam	Past
penetra	Present
envelhecerias	None
demarcado	Past
desesperou	Past
untaríamos	None
migradas	Past
confisca	Present
educam	Present
detectando	Present
estreitando	Present
ralada	Past
preferirias	None
regêsseis	Past
entraria	None
rubricaras	Past
alcançada	Past
escondessem	Past
traduziria	None
condecorámos	Past
desperdiçássemos	Past
piches	Present
beatificados	Past
liberaria	None
transubstanciarmos	Future
interrogam	Present
raciocinando	Present
estreadas	Past
estigmatizado	Past
canonizada	Past
telarás	Future
aviventaria	None
salvariam	None
estabelecido	Past
desleixaríeis	None
cometeria	None
registrassem	Past
adulteraríamos	None
amostra	Present
engancharia	None
põe	Present
reiniciado	Past
acordaria	None
manifestarão	Future
revelado	Past
carateriza	Present
revelada	Past
tornam	Present
estivares	Future
estragáramos	Past
plainaríeis	None
mortificada	Past
inquiririam	None
ultrapassarmos	Future
furam	Present
revertiam	Past
negarmos	Future
apostemarias	None
meteria	None
elogiaria	None
revoga	Present
regulariam	None
desperdiça	Present
estilizou	Past
fusionarias	None
encamparíamos	None
poderão	Future
devises	Present
afiançassem	Past
expulsaria	None
costumas	Present
rebatem	Present
desmagnetizarei	Future
babaríeis	None
enfarruscaríamos	None
encontráveis	Past
passaríamos	None
manjam	Present
trazidas	Past
excomungarias	None
remodelado	Past
assustaria	None
adorarem	Future
evitassem	Past
rezai	None
aventais	Present
anunciavam	Past
diplomada	Past
temessem	Past
dedurai	None
especializados	Past
coloradas	Past
quereria	None
obviarão	Future
possuiria	None
espiam	Present
consta	Present
obtivermos	Future
animadas	Past
ab-reajamos	Present
calcificaríeis	None
varais	Present
votarias	None
rogo	Present
enterraríamos	None
chamará	Future
algoritmizávamos	Past
sublinhando	Present
amotinou	Past
perceberem	Future
detectaria	None
fritado	Past
parabenizando	Present
tentariam	None
inspirado	Past
bradariam	None
castigáreis	Past
planou	Past
suando	Present
instalaria	None
empobreceríamos	None
aflora	Present
desarticulares	Future
formado	Past
executariam	None
tombarmos	Future
voaríeis	None
enlaçam	Present
partiríeis	None
usarei	Future
pastavam	Past
prejudicaria	None
editei	Past
convencionadas	Past
hidrogenarias	None
ramificada	Past
aludidas	Past
avivado	Past
ir	None
inocentado	Past
repararem	Future
permitíreis	Past
cravaria	None
projeta	Present
humilhará	Future
justificáreis	Past
preparam	Present
penetraria	None
elogiaríeis	None
veneravam	Past
recrutarás	Future
contactam	Present
impregnai	None
trançamos	Present
efectuaria	None
inaugurássemos	Past
rastejam	Present
compreenderei	Future
lamentáveis	Past
conspiraria	None
migrarem	Future
citaria	None
haveres	None
abarbo	Present
revela	Present
orgulhamos	Present
impetrados	Past
atropeladas	Past
balbuciais	Present
desenvolveis	Present
haveriam	None
daria	None
ricocheteia	Present
reorganizadas	Past
dispõe	Present
acometeríeis	None
pactariam	None
diferiria	None
injetarei	Future
penduram	Present
abateria	None
operai	None
aperfeiçoaria	None
esbofeteai	None
descarto	Present
manterem	None
industrializa	Present
empalharem	Future
firmariam	None
amei	Past
deparamos	Present
violei	Past
trocariam	None
dotaria	None
ajeitassem	Past
dará	Future
apitando	Present
apressaria	None
grafitai	None
cultuaremos	Future
justificados	Past
entregarei	Future
publicariam	None
admitiriam	None
conseguirei	Future
reconfirmai	None
percorreria	None
salteado	Past
determinarem	Future
melhorei	Past
concretizados	Past
destruí	Past
pesariam	None
assombrado	Past
manejou	Past
interpretei	Past
mutila	Present
macularia	None
adsorvida	Past
supervisaríeis	None
suplica	Present
alegraríamos	None
nocauteou	Past
duvidem	Present
