înrădăcinaserăți	Indicative
stimară	Indicative
pricepem	Indicative
potriviși	Indicative
zăcut	None
orchestra	None
gladiolă	None
nechbzuințele	None
veștejiserăți	Indicative
holbași	Indicative
zărganii	None
rezolvase	Indicative
țintiserăm	Indicative
chele	None
visat	None
structurați	None
muncile	None
decapitezi	Indicative
desculțarăți	Indicative
curate	None
vindem	Indicative
creștinești	None
abandona	Indicative
dezbinași	Indicative
contribuțiile	None
junghiase	Indicative
scobirăm	Indicative
decăzut	None
spetiseră	Indicative
învelești	Indicative
urmăreați	Indicative
prăjeau	Indicative
alerg	Indicative
impuneau	Indicative
amuțeau	Indicative
sărind	None
aberantă	None
dormitoarelor	None
discutau	Indicative
poruncise	Indicative
pregătea	Indicative
pensula	None
foto-urile	None
salt	Indicative
insistase	Indicative
untoasele	None
vrăjii	Indicative
potriveau	Indicative
castaniu	None
înfiripaez	Indicative
enigmaticelor	None
pingeliră	Indicative
pansexualității	None
înfipseserăm	Indicative
bravi	None
descopereați	Indicative
bolnavii	None
nădăjduisem	Indicative
convingi	Indicative
vrăjiși	Indicative
adăpostit	None
varului	None
neglija	Indicative
pierzi	Indicative
psihoză	None
naționalelor	None
furia	None
preistoria	None
caracterule	None
cernu	Indicative
cunoaștem	Indicative
stabiliseră	Indicative
înghețată	None
împrumutase	Indicative
traversă	Indicative
gâmbaseră	Indicative
binecuvântez	Indicative
reveriilor	None
aprins	None
susținem	Indicative
călcaserăți	Indicative
malului	None
măslinilor	None
ghiciseră	Indicative
gâdilaserăm	Indicative
ajunau	Indicative
chiorâse	Indicative
solstițiile	None
bulbucară	Indicative
tăgăduiserăm	Indicative
bârlogului	None
gust	Indicative
convinse	Indicative
aprindea	Indicative
compunea	Indicative
invizibilității	None
șchiopătaserăm	Indicative
inteligibile	None
deciseseră	Indicative
înzestra	Indicative
văduvilor	None
prelungim	Indicative
despuiat	None
prețuia	Indicative
nenorocirăți	Indicative
acului	None
șchiopătară	Indicative
coreenilor	None
constăteai	Indicative
tresărim	Indicative
implicaseră	Indicative
neghinele	None
împodobeați	Indicative
știi	Indicative
înavuți	Indicative
slăbise	Indicative
împroprietăriserăți	Indicative
dansară	Indicative
intenționau	Indicative
măcinarăți	Indicative
colaboratorii	None
separaseră	Indicative
curseră	Indicative
zburdarăm	Indicative
constăturăm	Indicative
urmă	Indicative
cronice	None
glonțului	None
explic	Indicative
încercuim	Indicative
coaptei	None
sufocară	Indicative
hibernă	Indicative
reveriei	None
intervenise	Indicative
sinucideai	Indicative
apăru	Indicative
întortocheat	None
activezi	Indicative
nemiloși	None
produsese	Indicative
scumpi	Indicative
prezisei	Indicative
căpușele	None
echilibrez	Indicative
obișnuise	Indicative
foloseau	Indicative
bobocul	None
aduserăm	Indicative
iernaticul	None
plictisitorului	None
porumbacul	None
delicate	None
înșelarăm	Indicative
delictului	None
crunta	None
confruntau	Indicative
suflecară	Indicative
peticești	Indicative
oului	None
lăsau	Indicative
delimitau	Indicative
șopteați	Indicative
îmbuna	Indicative
stimulul	None
bulbucăm	Indicative
parcul	None
spuzea	Indicative
adevărurilor	None
recunoaștem	Indicative
cercetaseși	Indicative
apetisantei	None
contravenii	Indicative
înălțării	None
obligi	Indicative
șchiopez	Indicative
ridica	Indicative
veneraseră	Indicative
lovea	Indicative
submarinelor	None
caci	Indicative
înnegrea	Indicative
metrul	None
înnoi	Indicative
îmbătasem	Indicative
tehnicianul	None
țărănescului	None
sugrumase	Indicative
interzisese	Indicative
soarele	None
bijuteria	None
pungașul	None
rabinul	None
rugași	Indicative
împreunaserăți	Indicative
căra	Indicative
introdu	Imperative-Jussive
dormea	Indicative
hienelor	None
salutând	None
calci	Indicative
mențineau	Indicative
comportau	Indicative
slujea	Indicative
vedeai	Indicative
învolburarăm	Indicative
stuful	None
suni	Indicative
cuprindeau	Indicative
urmau	Indicative
bătuseși	Indicative
spălaserăm	Indicative
stimulasem	Indicative
scurtăm	Indicative
zbârcirăți	Indicative
îndulci	Indicative
milimetrică	None
încărcăm	Indicative
mâhneați	Indicative
retraseși	Indicative
munceau	Indicative
piticul	None
crucifici	Indicative
pernițele	None
straturile	None
bășicarăți	Indicative
dezmățase	Indicative
subscrise	Indicative
coapse	Indicative
convenea	Indicative
recunoscuse	Indicative
flămânzeai	Indicative
misterioasele	None
meștem	Indicative
macrul	None
evreul	None
ruina	Indicative
însufleți	Indicative
constrânsese	Indicative
cioturile	None
somaserăți	Indicative
ispitele	None
adopta	Indicative
pornise	Indicative
cercetau	Indicative
mâniat	None
ocupa	Indicative
orgasmice	None
măgăriile	None
binecuvântăm	Indicative
aurise	Indicative
hotărâserăm	Indicative
chemase	Indicative
binecuvântau	Indicative
acumularăm	Indicative
stricat	None
descoperiseră	Indicative
acuzativele	None
mergea	Indicative
prospătași	Indicative
spetirăți	Indicative
pădurilor	None
asudasem	Indicative
slabei	None
aplecarăm	Indicative
muncii	Indicative
înfricoșași	Indicative
urii	None
apărare	None
ghidăm	Indicative
neioasa	None
râseră	Indicative
distilară	Indicative
șterseserăm	Indicative
scosese	Indicative
culcași	Indicative
depunem	Indicative
gospodari	None
legași	Indicative
tresare	Indicative
serbași	Indicative
salutau	Indicative
meritași	Indicative
încrezuseră	Indicative
dresesem	Indicative
descălecăm	Indicative
demne	None
născuserăți	Indicative
scăpăra	Indicative
gravită	Indicative
lipirăți	Indicative
vamală	None
îmbunătățirea	None
simțise	Indicative
spulberat	None
desfirau	Indicative
cari	Indicative
istorică	None
cromozomii	None
scăpătăm	Indicative
răzleți	Indicative
intrau	Indicative
asigur	Indicative
tăbăciși	Indicative
aprinzi	Indicative
jacheta	None
trăsniserăți	Indicative
rupere	None
dormitaseși	Indicative
homosexualelor	None
conturul	None
mișcau	Indicative
aflarăm	Indicative
stadionului	None
odihnea	Indicative
intervenea	Indicative
berzei	None
fundarăm	Indicative
constăteați	Indicative
liberasem	Indicative
atotputernic	None
ținem	Indicative
prezice	Indicative
înfruntară	Indicative
întorci	Indicative
rupeau	Indicative
asprimile	None
înavuțise	Indicative
atârnările	None
judeca	Indicative
pornograficul	None
locului	None
ruginisem	Indicative
strălucitoare	None
contraziserăți	Indicative
returna	Indicative
lăudasem	Indicative
canoanelor	None
înlocuiau	Indicative
acuz	Indicative
cățelului	None
străbătut	None
petalei	None
capitulaseră	Indicative
amâni	Indicative
cânta	Indicative
orientase	Indicative
focului	None
pregătim	Indicative
penarul	None
înguștilor	None
lăsat	None
mămicii	None
împrumutaseră	Indicative
principalele	None
dezdoiserăm	Indicative
liniștești	Indicative
delăsară	Indicative
îmbătaseși	Indicative
simțeau	Indicative
algoritmului	None
stânjenirăm	Indicative
îndureră	Indicative
muiaseră	Indicative
împac	Indicative
închipuim	Indicative
muștele	None
neioșii	None
port	Indicative
zimbrule	None
ispitit	None
conducea	Indicative
hârtiei	None
omenire	None
urî	Indicative
încununat	None
răscoli	Indicative
alergiei	None
săcret	None
ruinase	Indicative
nășteau	Indicative
augurasem	Indicative
alungi	Indicative
haotici	None
avantajelor	None
mandrililor	None
răsunat	None
întristat	None
scaunele	None
înnegrise	Indicative
bați	Indicative
îmbogățiși	Indicative
umblasem	Indicative
învinserăm	Indicative
ghici	Indicative
amărâserăți	Indicative
tritonul	None
piersic	Indicative
câștig	Indicative
învolburași	Indicative
batjocoreau	Indicative
forțase	Indicative
avere	None
înghesuiau	Indicative
frigi	Indicative
găsești	Indicative
smulgeau	Indicative
discordiile	None
ungeau	Indicative
bleagă	None
izgoniserăți	Indicative
eliberase	Indicative
adiaserăm	Indicative
fluturase	Indicative
nimeri	Indicative
materialiștii	None
trezea	Indicative
buretelui	None
încadraseră	Indicative
înclin	Indicative
ofticasem	Indicative
împletiseră	Indicative
tărăgănaseră	Indicative
prinsese	Indicative
înnorând	None
circumciziei	None
nevăzut	None
amicală	None
suflu	Indicative
halise	Indicative
născu	Indicative
înfigi	Indicative
căzurăm	Indicative
înfrunziși	Indicative
înfuriarăm	Indicative
prășiseră	Indicative
pielcea	None
pedepsi	Indicative
întorseși	Indicative
roșirăți	Indicative
cusurăți	Indicative
interesez	Indicative
berbecii	None
slăbea	Indicative
vându	Indicative
începuse	Indicative
tine	None
crescuse	Indicative
ologul	None
declarase	Indicative
sângerez	Indicative
masacrele	None
mâneca	Indicative
dinozaurii	None
ștergând	None
îmbinăm	Indicative
cufurisem	Indicative
comunicaserăți	Indicative
anihilau	Indicative
geamului	None
amețirăți	Indicative
curcubetei	None
urau	Indicative
înfigeați	Indicative
spovedi	Indicative
logodit	None
moartelor	None
admira	Indicative
bucuraseși	Indicative
șterseră	Indicative
dorință	None
mistificau	Indicative
lăsa	Indicative
împrejmuiseră	Indicative
dobândise	Indicative
fixau	Indicative
defăima	Indicative
muți	Indicative
cerșind	None
joc	Indicative
decisesem	Indicative
capitula	Indicative
elementarele	None
emoțională	None
zis	None
sărim	Indicative
emerită	None
îndrăzniserăm	Indicative
șubrede	None
trăsnea	Indicative
sătură	Indicative
înconjur	Indicative
spinoși	None
extraseră	Indicative
raționalizabilelor	None
blocăm	Indicative
storseși	Indicative
păianjenilor	None
dezmeticii	Indicative
plăcerea	None
călca	Indicative
mărturisești	Indicative
sughițaseși	Indicative
veștejise	Indicative
ridicat	None
cuceriseră	Indicative
râdem	Indicative
slăviserăți	Indicative
pieptănă	Indicative
erai	Indicative
americancă	None
șopârlei	None
acoperise	Indicative
alunelul	None
întunericurilor	None
îngrășarăți	Indicative
luciserăți	Indicative
rugii	Indicative
presupuneau	Indicative
zbârlirăm	Indicative
răsăreau	Indicative
înnegurat	None
vomuși	Indicative
bogățiile	None
limpeziserăm	Indicative
omorâserăm	Indicative
sânii	None
benzinăria	None
cerurăm	Indicative
viețui	Indicative
acerei	None
despărțiseră	Indicative
cădeau	Indicative
îndemna	Indicative
strâmb	Indicative
găsim	Indicative
intrat	None
depănarăți	Indicative
înseninau	Indicative
tinzi	Indicative
descărcaseși	Indicative
hotărai	Indicative
sexuală	None
jucară	Indicative
iubiserăți	Indicative
sfârșeau	Indicative
urmăriserăm	Indicative
tindea	Indicative
futurăm	Indicative
înjunghiat	None
gras	None
pinguinului	None
citiși	Indicative
gravitând	None
vorbitorilor	None
cususerăm	Indicative
zăpăcisem	Indicative
înjunghia	Indicative
robești	Indicative
dereticase	Indicative
decideau	Indicative
murdăriseși	Indicative
împlânți	Indicative
placentei	None
propuseseși	Indicative
orbești	Indicative
inutilă	None
reușeau	Indicative
gnosticii	None
interferențele	None
veghease	Indicative
medicamentelor	None
fereastra	None
bărbiereau	Indicative
înotătoare	None
mișcaseră	Indicative
menținurăm	Indicative
mișunași	Indicative
tâmpeniilor	None
pădurarul	None
pulsau	Indicative
pieptănară	Indicative
înfățișa	Indicative
ațipiși	Indicative
vânduserăm	Indicative
șofranule	None
extragea	Indicative
sărutarăți	Indicative
arunca	Indicative
răsuna	Indicative
cufuriseră	Indicative
răposaseră	Indicative
juraserăți	Indicative
mutaserăm	Indicative
adultul	None
urâtului	None
surpat	None
operația	None
sură	None
senin	None
rămânem	Indicative
profesia	None
rotunjite	None
întuneca	Indicative
întâlnise	Indicative
ispitiserăți	Indicative
fugiserăți	Indicative
potriviseși	Indicative
inului	None
coapseră	Indicative
tinctura	Indicative
farul	None
descălțaseră	Indicative
enormele	None
pronumelui	None
capitulară	Indicative
plec	Indicative
conjugau	Indicative
refeca	Indicative
narcotizaseși	Indicative
cioplea	Indicative
fericea	Indicative
clădim	Indicative
denaturarăți	Indicative
beli	Indicative
congelase	Indicative
doriserăți	Indicative
sânului	None
înrămase	Indicative
poștă	None
subscriseră	Indicative
halucinară	Indicative
dejugași	Indicative
împrejmuise	Indicative
beliserăm	Indicative
reduseseră	Indicative
guvernaserăm	Indicative
căsniciile	None
vindecau	Indicative
răspândiseră	Indicative
săpa	Indicative
străbătând	None
concepeau	Indicative
undiță	None
complexului	None
violeta	None
amuza	Indicative
colajul	None
tresăreai	Indicative
prelungea	Indicative
fracturau	Indicative
preoții	Indicative
adăugară	Indicative
olandezele	None
alegea	Indicative
luptase	Indicative
vrăjilor	None
guvernarea	None
îndrăgosti	Indicative
scutura	Indicative
lăsaseră	Indicative
suna	Indicative
necăjiră	Indicative
întorșii	None
completa	Indicative
invadaserăți	Indicative
întreba	Indicative
loviseși	Indicative
îmboldiserăm	Indicative
spăl	Indicative
producea	Indicative
nominativule	None
întărise	Indicative
reprezentanții	None
socrilor	None
sărutând	None
utilizatorilor	None
înfierbântăm	Indicative
deranjasem	Indicative
strâmt	None
călcară	Indicative
rămășagului	None
dăpărară	Indicative
declar	Indicative
gazelă	None
corcise	Indicative
ipocritul	None
legă	Indicative
alunga	Indicative
desfir	Indicative
căutării	None
veșmintele	None
venii	Indicative
întemeiase	Indicative
verzei	None
făcu	Indicative
renovez	Indicative
sarma	None
devenind	None
umed	None
liniștii	Indicative
blocat	None
dinamicii	None
concepuseră	Indicative
afundară	Indicative
neglijăm	Indicative
hamsiei	None
valsezi	Indicative
întinaserăm	Indicative
alungăm	Indicative
înscriseseră	Indicative
scumpeai	Indicative
milanului	None
desenase	Indicative
spate	None
îndemn	Indicative
trezeai	Indicative
scânteiez	Indicative
plângeai	Indicative
imnului	None
stimulăm	Indicative
hotăra	Indicative
înnoadă	Indicative
ieșeai	Indicative
donase	Indicative
uimea	Indicative
trăirăm	Indicative
învățarăți	Indicative
căpătaseră	Indicative
flacără	None
învecheați	Indicative
familiilor	None
înmulții	Indicative
descheiaseși	Indicative
croiați	Indicative
zgârie-noriului	None
botezaserăți	Indicative
mijlocii	Indicative
aurorei	None
întrebuințarăți	Indicative
trezeați	Indicative
catalanilor	None
fumezi	Indicative
prădași	Indicative
căutăm	Indicative
gâștelor	None
creștem	Indicative
înscriați	Indicative
cufurim	Indicative
răsfirase	Indicative
făgăduind	None
nădăjduiră	Indicative
eprubetele	None
surprindeau	Indicative
dromaderului	None
abiogeneză	None
prinseseră	Indicative
gătea	Indicative
rase	Indicative
cinstit	None
proptiserăți	Indicative
nutrisem	Indicative
înrâurești	Indicative
implici	Indicative
plimbase	Indicative
mâzgăliseși	Indicative
încercase	Indicative
îngrijeai	Indicative
susținu	Indicative
problemei	None
menținem	Indicative
înscriseși	Indicative
uscaserăți	Indicative
tinerilor	None
fluierași	Indicative
sărurilor	None
recuperase	Indicative
desfășuraseră	Indicative
încheiaseră	Indicative
anula	Indicative
introductivă	None
simplificăm	Indicative
strămutaserăm	Indicative
surpriză	None
plânsul	None
înmulți	Indicative
principatelor	None
important	None
istovim	Indicative
tunaserăți	Indicative
împărțiseră	Indicative
viețuiești	Indicative
stabilim	Indicative
juisaserăm	Indicative
tuna	Indicative
grecoaica	None
rămâneau	Indicative
ciocneau	Indicative
sângera	Indicative
instantanee	None
nebuniră	Indicative
spăla	Indicative
sefardul	None
bociși	Indicative
cumpliții	None
suficiență	None
folosi	Indicative
conduseseră	Indicative
moșierilor	None
mândrim	Indicative
murarăți	Indicative
transformi	Indicative
mestecarăți	Indicative
existase	Indicative
pictase	Indicative
contrazice	Indicative
pietroasei	None
aninase	Indicative
saturat	None
nejudecată	None
îmbunătățeați	Indicative
râmaserăți	Indicative
venisem	Indicative
dezvoltând	None
dicta	Indicative
intru	Indicative
jinduiai	Indicative
greșești	Indicative
scobea	Indicative
achiziționare	None
mărginiseră	Indicative
lipite	None
călcau	Indicative
pornești	Indicative
intervine	Indicative
jigniserăți	Indicative
gudurarăm	Indicative
umblăm	Indicative
înghițeai	Indicative
mâzgălii	Indicative
rosei	Indicative
încântasem	Indicative
poftim	Indicative
scâncim	Indicative
combinau	Indicative
neglijaserăm	Indicative
apucasem	Indicative
nuzii	None
liniștim	Indicative
laleaua	None
înfăptuia	Indicative
ghemului	None
împiedicăm	Indicative
ruginile	None
spuzeau	Indicative
obosea	Indicative
merităm	Indicative
halucinez	Indicative
destinata	None
răscoapsesem	Indicative
stăruiau	Indicative
propuneau	Indicative
momiserăți	Indicative
temeau	Indicative
deveneau	Indicative
scufundarăți	Indicative
făceau	Indicative
desmântaseși	Indicative
nega	Indicative
funcționasem	Indicative
poftiră	Indicative
supravegheau	Indicative
zgăurăm	Indicative
transcriserăți	Indicative
lubrifiau	Indicative
împerecheat	None
găuriși	Indicative
rulau	Indicative
încrederii	None
obstrucției	None
bocetelor	None
migdalelor	None
istoric	None
ospătăm	Indicative
atotputernicului	None
păcălești	Indicative
zăcea	Indicative
șerbii	Indicative
îndeletniceau	Indicative
cerșiși	Indicative
rechinului	None
întreții	Indicative
udarăm	Indicative
secretariatele	None
cășunat	None
gândii	Indicative
iscăli	Indicative
apleca	Indicative
îmbătrânii	Indicative
culegeau	Indicative
vorbă	None
scufundase	Indicative
ștergem	Indicative
halucină	Indicative
întrerupseserăți	Indicative
imagine	None
iese	Indicative
cuprinseseși	Indicative
ademeneați	Indicative
donației	None
culcase	Indicative
însemnătatea	None
dormeau	Indicative
respir	Indicative
petrecuse	Indicative
aducătorule	None
încălțași	Indicative
sfecliserăm	Indicative
dejugaserăm	Indicative
unsuroșii	None
fripseseră	Indicative
glumiși	Indicative
împușcasem	Indicative
umblu	Indicative
străbătea	Indicative
reluase	Indicative
dorirăm	Indicative
apunea	Indicative
datorau	Indicative
înierbăm	Indicative
leopardul	None
pregetaserăți	Indicative
ajutarăți	Indicative
legătură	None
satur	Indicative
secundarelor	None
fluier	Indicative
observi	Indicative
totalitatea	None
mulțumiseră	Indicative
spânzurând	None
locuisem	Indicative
ucideau	Indicative
mijlocit	None
junghiași	Indicative
făptuiserăți	Indicative
hotărâră	Indicative
circula	Indicative
desprinse	Indicative
declini	Indicative
zăriserăm	Indicative
îngrijit	None
grosime	None
urla	Indicative
trăgănăm	Indicative
tocase	Indicative
coasta	None
tristului	None
interzisei	Indicative
descrierilor	None
rugăm	Indicative
rozei	None
internul	None
zărești	Indicative
întrebare	None
copleșiserăți	Indicative
încrucișa	Indicative
potrivi	Indicative
cumpăra	Indicative
hibernarăm	Indicative
măsliniul	None
focoasa	None
fereca	Indicative
loveau	Indicative
isprăvi	Indicative
pilota	Indicative
înnoiau	Indicative
lăsasem	Indicative
oglindeau	Indicative
adumbrirăți	Indicative
exterioarelor	None
eroul	None
putredul	None
plivirăm	Indicative
bronzului	None
serba	Indicative
înfipsese	Indicative
desfășarăm	Indicative
îmbunătății	Indicative
roz	None
erogenul	None
pornisem	Indicative
purificase	Indicative
picarăți	Indicative
băutul	None
puric	Indicative
împrăștiau	Indicative
remușcările	None
cercând	None
tâmpești	Indicative
sistară	Indicative
prezicea	Indicative
plânseseră	Indicative
plecă	Indicative
cobori	Indicative
amanetaserăm	Indicative
controlarăm	Indicative
viguroși	None
corcea	Indicative
internațională	None
modificând	None
înfumurezi	Indicative
simfonie	None
evlavios	None
frământ	Indicative
sulfuroșilor	None
împerechea	Indicative
sumeserăți	Indicative
găsisem	Indicative
căscarăm	Indicative
preveștiseră	Indicative
zbăteau	Indicative
încăpurăți	Indicative
hiberna	Indicative
oprești	Indicative
răsucirăți	Indicative
vânturară	Indicative
reușeați	Indicative
înmormântezi	Indicative
înfricoșat	None
înota	Indicative
covorul	None
dărâmaseră	Indicative
indiscretelor	None
momi	Indicative
linseși	Indicative
eronat	None
înconjuraserăți	Indicative
traduse	Indicative
înlăturaseși	Indicative
crestăm	Indicative
completez	Indicative
răpuseserăm	Indicative
spurca	Indicative
comporta	Indicative
plânsei	Indicative
strânseseră	Indicative
socotisem	Indicative
slujise	Indicative
cucul	None
halim	Indicative
satisfăcuseși	Indicative
transformase	Indicative
dormirăm	Indicative
gâmbasem	Indicative
șușuiai	Indicative
speteați	Indicative
mărgineați	Indicative
cucumării	None
bulucirăți	Indicative
scuturarăm	Indicative
despuiasem	Indicative
inserțiilor	None
mărinimoasele	None
huliganii	None
udau	Indicative
acuzatului	None
bucurăm	Indicative
înfășuri	Indicative
îmblânzești	Indicative
vecinele	None
ploii	None
luci	Indicative
constătuși	Indicative
pictezi	Indicative
temu	Indicative
împănau	Indicative
intuiai	Indicative
găureau	Indicative
existau	Indicative
scarmăn	Indicative
supărase	Indicative
instanta	None
nudele	None
împiedicase	Indicative
înverșunez	Indicative
ferecasem	Indicative
șoptiserăți	Indicative
auzim	Indicative
țintești	Indicative
îndurerez	Indicative
tufișurile	None
sfătuia	Indicative
geamurile	None
mândriseși	Indicative
excava	Indicative
seduce	Indicative
acuzau	Indicative
păcălit	None
scula	Indicative
vizitat	None
chirurgie	None
pieselor	None
umpluseră	Indicative
gătiră	Indicative
angajez	Indicative
întoarseră	Indicative
macin	Indicative
ecologiei	None
frânase	Indicative
excela	Indicative
returnaseși	Indicative
abili	None
încumetaserăm	Indicative
menținea	Indicative
arhicunoscute	None
prețuiseră	Indicative
castra	Indicative
meșteau	Indicative
pute	Indicative
imunologie	None
săturarăm	Indicative
preludiul	None
întrebaseși	Indicative
redundanta	None
puciul	None
finisași	Indicative
aplec	Indicative
cioplit	None
creșteau	Indicative
întortocheași	Indicative
învingeau	Indicative
avortaserăți	Indicative
stânjenim	Indicative
copiem	Indicative
copiarăți	Indicative
nebunii	Indicative
vizitez	Indicative
răposezi	Indicative
sfulgeraseși	Indicative
unea	Indicative
rupseși	Indicative
valsaserăți	Indicative
hrana	None
oglinda	None
potabila	None
număraseși	Indicative
diminuările	None
cufund	Indicative
portalurilor	None
returnă	Indicative
măicuță	None
lucrase	Indicative
obișnui	Indicative
răsturnase	Indicative
întemeiau	Indicative
începea	Indicative
abacul	None
sughițăm	Indicative
înlesneau	Indicative
însărcinarăm	Indicative
alina	Indicative
preistoriei	None
diminuat	None
sufixului	None
ciocnim	Indicative
juisaserăți	Indicative
suveran	None
ataci	Indicative
livada	None
rămase	Indicative
naționalii	None
farmecul	None
înmulțeau	Indicative
artrozele	None
reducem	Indicative
păduche	Indicative
guvernarăm	Indicative
mescuserăm	Indicative
celebrării	None
cotiseși	Indicative
asexualitate	None
izbăveați	Indicative
lega	Indicative
turcul	None
fricii	None
vădi	Indicative
întrebăm	Indicative
comanda	Indicative
murmurând	None
ghearele	None
substanța	None
împăcași	Indicative
scăpăta	Indicative
slujești	Indicative
ducerea	None
curserăm	Indicative
torsei	Indicative
limpezirăm	Indicative
dumicaseși	Indicative
pianistul	None
asemăna	Indicative
cuvenea	Indicative
fripse	Indicative
dezavantajaseși	Indicative
părurăm	Indicative
repezea	Indicative
plătiseră	Indicative
salvau	Indicative
carpelă	None
rostim	Indicative
apăr	Indicative
îmbulziră	Indicative
obținui	Indicative
mursec	Indicative
fagotul	None
împresur	Indicative
izolați	None
religia	None
dezbrăcaseră	Indicative
chițăiai	Indicative
bucurarăm	Indicative
scuturat	None
femeii	None
unseserăm	Indicative
pășună	Indicative
terapia	None
datorii	None
nutri	Indicative
topea	Indicative
ascultaseră	Indicative
speriaserăm	Indicative
sării	Indicative
alcătuiseși	Indicative
comparaseși	Indicative
întâmpinarăți	Indicative
zdrobise	Indicative
cusură	Indicative
prostii	Indicative
urmezi	Indicative
cântăreați	Indicative
azvârliserăți	Indicative
aruncat	None
îndepărtase	Indicative
certaserăți	Indicative
jurăm	Indicative
striga	Indicative
ucisese	Indicative
dărâmarăți	Indicative
șoptiserăm	Indicative
proba	Indicative
fierbinții	None
întinzând	None
sfecliră	Indicative
bravilor	None
totalitate	None
haliserăți	Indicative
agerelor	None
mândrii	Indicative
cuveneau	Indicative
scăpărau	Indicative
veniră	Indicative
pulsase	Indicative
crește	Indicative
ungi	Indicative
comercianții	None
împlinii	Indicative
puține	None
amestecăm	Indicative
odihniserăți	Indicative
înotasem	Indicative
nevăzute	None
lăcrimau	Indicative
aplicarăți	Indicative
răsfiraserăm	Indicative
profesorului	None
bălăirăm	Indicative
sufoca	Indicative
șerbi	Indicative
numind	None
simplificaserăm	Indicative
abandonaseră	Indicative
răbda	Indicative
zburăm	Indicative
unduit	None
împiedici	Indicative
clătirăți	Indicative
vindea	Indicative
rezemau	Indicative
strig	Indicative
stabili	Indicative
rază	None
scoapsesem	Indicative
interesăm	Indicative
comând	Indicative
vine	Indicative
creez	Indicative
distinsese	Indicative
deșirară	Indicative
lovind	None
urbanizarăm	Indicative
închidea	Indicative
scol	Indicative
bău	Indicative
experimentaților	None
mirosea	Indicative
proporția	None
perindau	Indicative
părem	Indicative
însoțiseși	Indicative
sare	Indicative
lans	Indicative
apeși	Indicative
substanței	None
schimb	Indicative
aciuezi	Indicative
încălase	Indicative
stimula	Indicative
atacaseră	Indicative
libera	Indicative
controlăm	Indicative
forță	Indicative
avansa	Indicative
focile	None
leșinau	Indicative
fripseși	Indicative
șerbiserăți	Indicative
alini	Indicative
părea	Indicative
împlântaserăți	Indicative
ecologie	None
domini	Indicative
învelișurile	None
țigara	None
durerilor	None
descreșteai	Indicative
măcelul	None
însufleții	Indicative
îndemni	Indicative
robi	Indicative
urmăreai	Indicative
lungea	Indicative
îmbătrânim	Indicative
alungând	None
alta	None
apropia	Indicative
chem	Indicative
ezitară	Indicative
învinsa	None
impuseserăm	Indicative
zgăuraserăți	Indicative
adăstași	Indicative
răsfiraseră	Indicative
uni	Indicative
folosea	Indicative
ajuți	Indicative
bolnavului	None
lansaserăți	Indicative
condu	Imperative-Jussive
obrazul	None
forfotim	Indicative
înțelegeau	Indicative
melcului	None
apăra	Indicative
traversase	Indicative
întins	None
înfiripaau	Indicative
încununară	Indicative
îmboldiră	Indicative
ridicase	Indicative
puteau	Indicative
îmbrăcași	Indicative
sacrul	None
murdărirăți	Indicative
guduri	Indicative
cinsteai	Indicative
spumeg	Indicative
dezmeticisem	Indicative
cugetase	Indicative
gospodinelor	None
scăpaseră	Indicative
aruncași	Indicative
coti	Indicative
căpătaseși	Indicative
joci	Indicative
unirăm	Indicative
săruta	Indicative
scărmănasem	Indicative
librarul	None
dansa	Indicative
întrerupeau	Indicative
ejacularăm	Indicative
sughiți	Indicative
rezolvarăm	Indicative
trepădaseră	Indicative
întristaserăm	Indicative
aflu	Indicative
молдовеняска	None
putrezi	Indicative
venerat	None
castronului	None
iert	Indicative
cocoloșiserăm	Indicative
mureați	Indicative
fumega	Indicative
ventilatorule	None
frământării	None
punctară	Indicative
cântase	Indicative
înfiaseși	Indicative
cauți	Indicative
prezisesem	Indicative
scădea	Indicative
distinseseși	Indicative
atrageai	Indicative
pregătiseră	Indicative
presupuseserăm	Indicative
portocaliul	None
liberă	Indicative
sfinților	None
gravitației	None
înrămau	Indicative
supă	None
înlăturași	Indicative
amăgea	Indicative
țuicii	None
cenușiul	None
neapărate	None
unduise	Indicative
încărunțirăm	Indicative
celților	None
producând	None
înviorași	Indicative
lalelei	None
odihni	Indicative
hibernăm	Indicative
zgâriaseră	Indicative
fierse	Indicative
supraviețui	Indicative
întâmpin	Indicative
zgomotosului	None
prădau	Indicative
adiaserăți	Indicative
pliveai	Indicative
dubla	Indicative
jena	Indicative
sfârșirăm	Indicative
conduceau	Indicative
supraviețuim	Indicative
însera	Indicative
măsura	Indicative
sacrii	None
răsunarăți	Indicative
înfățișaseși	Indicative
maghiarei	None
ademeni	Indicative
pulpanelor	None
imaginăm	Indicative
serviseră	Indicative
clește	None
separa	Indicative
nebuniși	Indicative
struțului	None
sfințea	Indicative
mesteca	Indicative
explicau	Indicative
proastei	None
soporiferă	None
judecaserăți	Indicative
ghicim	Indicative
culc	Indicative
pășunat	None
aflaseră	Indicative
făcătoarei	None
lucioase	None
sculă	Indicative
distra	Indicative
tăcut	None
cuminecară	Indicative
piersici	Indicative
veșnicei	None
biologici	None
apocaliptica	None
dependentă	None
ținuta	None
opticii	None
zburdaseră	Indicative
lămurim	Indicative
tivii	Indicative
înghețau	Indicative
munceați	Indicative
invadat	None
încetim	Indicative
negat	None
statistic	None
mărturiseau	Indicative
învingeați	Indicative
mișcarăm	Indicative
căcase	Indicative
învățase	Indicative
strica	Indicative
gravitau	Indicative
exagerat	None
reuși	Indicative
urmărisem	Indicative
ușii	None
dictau	Indicative
irit	Indicative
încoronăm	Indicative
rostogoleau	Indicative
fluturi	Indicative
făgăduise	Indicative
înălțaserăm	Indicative
groasă	None
pâlcurile	None
furau	Indicative
depănaseră	Indicative
împreunau	Indicative
înveninez	Indicative
toxicului	None
respirat	None
lucrasem	Indicative
distilăm	Indicative
făcuse	Indicative
compusese	Indicative
mase	Indicative
aprigele	None
jocului	None
trăsătură	None
smulse	Indicative
budismule	None
cocoloșiră	Indicative
aplic	Indicative
necunoscutei	None
adunând	None
fugim	Indicative
pulsară	Indicative
exagerată	None
misterioaselor	None
făceați	Indicative
boarea	None
refuzase	Indicative
aloele	None
barbă	None
punctez	Indicative
alianțele	None
lacrima	None
bicepsului	None
țeseau	Indicative
ceruserăți	Indicative
sfatule	None
elevele	None
încurajară	Indicative
încăpea	Indicative
dispusese	Indicative
artrozei	None
îmbogățind	None
delimitarea	None
trompeta	None
tușea	Indicative
juraseră	Indicative
împrumutară	Indicative
lipiciului	None
lucrau	Indicative
documentaseși	Indicative
aplaud	Indicative
știai	Indicative
speri	Indicative
umbrirăm	Indicative
așezi	Indicative
visărilor	None
orelor	None
cucereau	Indicative
împlântaseră	Indicative
murmuraserăm	Indicative
stăpâneai	Indicative
jenau	Indicative
bezmetic	None
oposumii	None
descoperirăm	Indicative
înverzisem	Indicative
amestecatul	None
patul	None
excitară	Indicative
fuge	Indicative
semnau	Indicative
sacrificiului	None
odaie	None
universităților	None
circularăm	Indicative
rașii	None
smulseseră	Indicative
vomea	Indicative
ajutăm	Indicative
mestecară	Indicative
rabinului	None
sălbatici	None
bolnavă	None
deplasă	Indicative
încruntat	None
azerului	None
veșnicele	None
labagiul	None
îndrăgosteați	Indicative
anteriorul	None
ieșiseră	Indicative
citiseși	Indicative
prietenosul	None
școlilor	None
lipea	Indicative
veștejirăți	Indicative
vărsa	Indicative
placi	Indicative
observase	Indicative
studie	Indicative
mărturisim	Indicative
înrudiseși	Indicative
controlezi	Indicative
intuirăți	Indicative
vomuse	Indicative
scăpătară	Indicative
flexibil	None
scuturau	Indicative
evlaviile	None
stinserăți	Indicative
cutreierarăți	Indicative
goliserăți	Indicative
dezrobiserăți	Indicative
cântau	Indicative
vizitaseră	Indicative
certaseși	Indicative
scuza	Indicative
mulțumisem	Indicative
domesticirile	None
umilea	Indicative
congela	Indicative
activitate	None
urmăriseși	Indicative
menținusem	Indicative
pricepea	Indicative
vaccinaserăți	Indicative
rătăciră	Indicative
tânjim	Indicative
berbecilor	None
farmecului	None
numărăm	Indicative
cărau	Indicative
pieptăna	Indicative
constituționalități	None
sărbătoreau	Indicative
zisei	Indicative
îmbucaseră	Indicative
menținuseră	Indicative
respirăm	Indicative
anticii	None
exist	Indicative
lepăda	Indicative
trecem	Indicative
părăsiră	Indicative
dezvolți	Indicative
exageraserăm	Indicative
estimez	Indicative
nasol	None
spălăm	Indicative
grebla	None
scoteați	Indicative
transbordările	None
batjocori	Indicative
punctasem	Indicative
crucificau	Indicative
întări	Indicative
orientaserăți	Indicative
contraveneau	Indicative
scormonisem	Indicative
stabileați	Indicative
împiedicau	Indicative
desfirarăm	Indicative
masculina	None
plictiseai	Indicative
împungea	Indicative
râma	Indicative
scurta	Indicative
scurgeați	Indicative
stăpânii	Indicative
nodurilor	None
tânjea	Indicative
judeci	Indicative
supraviețuise	Indicative
reintrodusese	Indicative
scâncea	Indicative
împovără	Indicative
verdele	None
păstrarăți	Indicative
tâmpiserăți	Indicative
încercuiseră	Indicative
îmblânzise	Indicative
nasoale	None
urdinară	Indicative
pingelești	Indicative
răcea	Indicative
izbii	Indicative
vână	Indicative
crezuse	Indicative
pătrundeau	Indicative
complex	None
araserăți	Indicative
desfăceau	Indicative
reușești	Indicative
zgâii	Indicative
sângerau	Indicative
ademeniseși	Indicative
cutreierau	Indicative
însărcinau	Indicative
genunchilor	None
sorti	Indicative
radioule	None
lansaseră	Indicative
râdeai	Indicative
reciprocitate	None
chemau	Indicative
zice	Indicative
excitaserăm	Indicative
finisă	Indicative
spânzuri	Indicative
încheg	Indicative
potabilului	None
avansez	Indicative
scapi	Indicative
obligau	Indicative
ajuta	Indicative
împănând	None
întrebau	Indicative
antropologia	None
contraziseserăm	Indicative
neguțaserăm	Indicative
specialitatea	None
protejarăm	Indicative
angaja	Indicative
subsuoara	None
eternitatea	None
era	Indicative
suciseră	Indicative
memorizezi	Indicative
inseparabilele	None
abreviațiile	None
sărea	Indicative
exista	Indicative
forțarăm	Indicative
stăpânisem	Indicative
pierduseră	Indicative
cronica	None
spitalului	None
ispitea	Indicative
scăpătași	Indicative
sufla	Indicative
despusese	Indicative
oftici	Indicative
macedonenii	None
andorran	None
reținuse	Indicative
circumscrisei	Indicative
rămânând	None
iezii	None
fundase	Indicative
deșteptare	None
scăzuse	Indicative
părinteștii	None
invincibil	None
viermuiră	Indicative
ajutau	Indicative
юбишь	Indicative
prefer	Indicative
ardem	Indicative
donez	Indicative
deșelaserăți	Indicative
fumez	Indicative
ștergeau	Indicative
dispuneați	Indicative
înfricoșaserăm	Indicative
refuz	Indicative
spuneau	Indicative
degeraserăm	Indicative
lascive	None
sinucidem	Indicative
copiaseră	Indicative
îneca	Indicative
atacarăm	Indicative
aligatorul	None
distrau	Indicative
alegeați	Indicative
ofticaseră	Indicative
orbiseră	Indicative
bănuiau	Indicative
îndulcea	Indicative
ceterau	Indicative
înfricoșase	Indicative
inundi	Indicative
prezervativelor	None
încercă	Indicative
încuiarăm	Indicative
prăjești	Indicative
pinii	None
afum	Indicative
pisași	Indicative
cocoloșeați	Indicative
măsese	Indicative
încetau	Indicative
înotau	Indicative
contravenim	Indicative
răsuflară	Indicative
închini	Indicative
suceai	Indicative
nimerii	Indicative
constrânse	Indicative
afumau	Indicative
crezusem	Indicative
ascultași	Indicative
cinstea	Indicative
comerciantul	None
depărtaserăți	Indicative
încrucișă	Indicative
răzgândim	Indicative
observat	None
stimulii	None
creă	Indicative
tenacitate	None
basmaua	None
mediocră	None
scrisorilor	None
desena	Indicative
încadraserăm	Indicative
sărbători	Indicative
noilor	None
însărcină	Indicative
învelișurilor	None
zbârleau	Indicative
grăi	Indicative
îngrijorat	None
defileul	None
înfruntaseră	Indicative
școlară	None
stinghereau	Indicative
suspinară	Indicative
repezi	Indicative
sugaciul	None
completau	Indicative
împresurase	Indicative
ghicea	Indicative
alcătuia	Indicative
lipise	Indicative
azvârlii	Indicative
bulucea	Indicative
ferisem	Indicative
surpăm	Indicative
spovedirăm	Indicative
buluceau	Indicative
reușiseră	Indicative
vâna	Indicative
delogaserăm	Indicative
controlaseră	Indicative
medicinei	None
murea	Indicative
undui	Indicative
vorbeați	Indicative
întină	Indicative
zăriră	Indicative
enigmaticii	None
stânjeneau	Indicative
drăguț	None
mura	Indicative
utili	None
plecau	Indicative
castelelor	None
supuse	Indicative
împărasem	Indicative
lămurești	Indicative
aruncaseră	Indicative
gândea	Indicative
memorizară	Indicative
brună	None
distilaseși	Indicative
călătorul	None
fata	None
inundând	None
scarpini	Indicative
comorii	None
sporea	Indicative
pasa	Indicative
camioanele	None
sperași	Indicative
extraseserăm	Indicative
purica	Indicative
împăturim	Indicative
anarhistele	None
miroseați	Indicative
țigările	None
clari	None
rugaserăm	Indicative
toxica	None
binecuvântarăm	Indicative
turnase	Indicative
convenii	Indicative
respingerea	None
centrală	None
stafidei	None
rețea	None
metrilor	None
întărea	Indicative
întâlniseră	Indicative
neguță	Indicative
câmpiei	None
înavuțirăm	Indicative
licări	Indicative
serbarăți	Indicative
omora	Indicative
încântaserăți	Indicative
păzim	Indicative
pasarăm	Indicative
scobit	None
tace	Indicative
glorificatoarea	None
înmulțisem	Indicative
deda	Indicative
ros	None
găsiseră	Indicative
ciopleau	Indicative
izolată	None
supraviețuiești	Indicative
dezrădăcinarăm	Indicative
acuza	Indicative
încorporat	None
dubli	None
răsuci	Indicative
slujeau	Indicative
văraseră	Indicative
vizitaserăți	Indicative
vegheau	Indicative
băgăm	Indicative
psihozele	None
pătrundea	Indicative
albină	None
nebunise	Indicative
începură	Indicative
heterosexualității	None
limpede	None
întreprinseserăm	Indicative
iubeau	Indicative
sap	Indicative
stricăm	Indicative
încărunțiserăți	Indicative
numești	Indicative
înjosim	Indicative
încercaseră	Indicative
bășirăți	Indicative
plauzibilității	None
înșira	Indicative
luptat	None
izbăvești	Indicative
încurcăm	Indicative
ridic	Indicative
cutreiera	Indicative
înmulțea	Indicative
purta	Indicative
străpunse	Indicative
castrase	Indicative
despărțea	Indicative
neutrelor	None
vale	None
încurajau	Indicative
misteriosului	None
răboji	Indicative
argiloase	None
fluierul	None
crease	Indicative
interveniseră	Indicative
ruinași	Indicative
roșirăm	Indicative
păgânătăți	None
scriai	Indicative
oftezi	Indicative
prăpădi	Indicative
ținurăți	Indicative
îngânaseră	Indicative
sorbea	Indicative
dezgustător	None
soților	None
sufocaseși	Indicative
înșela	Indicative
tisă	None
umili	Indicative
strânseserăm	Indicative
angajau	Indicative
adeveri	Indicative
gecile	None
secerau	Indicative
copiară	Indicative
încurasem	Indicative
fractură	Indicative
mirarăm	Indicative
blochez	Indicative
răsturnaserăți	Indicative
sporeați	Indicative
scurtezi	Indicative
borțos	None
intra	Indicative
speriaseși	Indicative
tragi	Indicative
nivelase	Indicative
vedeau	Indicative
coaptele	None
binari	None
cusu	Indicative
focă	None
contraveni	Indicative
muncești	Indicative
morfologiei	None
interesase	Indicative
răpeau	Indicative
ademenea	Indicative
protejă	Indicative
cetera	Indicative
agera	None
coci	Indicative
vopsi	Indicative
pătaserăm	Indicative
păzi	Indicative
înfierbânți	Indicative
erogenele	None
copia	Indicative
logodi	Indicative
ieftina	None
urmară	Indicative
reluasem	Indicative
tradusese	Indicative
înfuriasem	Indicative
vătăma	Indicative
intrase	Indicative
înfrățirăți	Indicative
rămăsese	Indicative
sfulgerau	Indicative
sughițaserăți	Indicative
închizi	Indicative
îndopaserăm	Indicative
cercetași	Indicative
scotea	Indicative
depuseră	Indicative
pic	Indicative
frumusețe	None
hămesii	Indicative
ieșiserăm	Indicative
flămânda	None
scremetele	None
amenințau	Indicative
înrudeau	Indicative
urbanizaserăți	Indicative
potriviserăm	Indicative
prânzeați	Indicative
întâmpini	Indicative
rublelor	None
petreceați	Indicative
perindă	Indicative
denaturăm	Indicative
prevestiserăți	Indicative
destramaseră	Indicative
realul	None
înjur	Indicative
nechibzuite	None
viguros	None
declarau	Indicative
adevăratelor	None
prevenea	Indicative
descurci	Indicative
sparse	Indicative
profundei	None
viermuia	Indicative
vulcanul	None
monotremule	None
plecase	Indicative
presupuse	Indicative
absorbeați	Indicative
dizolvarăți	Indicative
licuriciule	None
săgetătorului	None
felurilor	None
alivanca	None
defăimaseră	Indicative
mistrețelor	None
gemeau	Indicative
întrebuințăm	Indicative
junghiasem	Indicative
ardea	Indicative
suflecase	Indicative
împăunase	Indicative
fumau	Indicative
umblat	None
oftăm	Indicative
trezeau	Indicative
merit	Indicative
vizibilității	None
tradusei	Indicative
comportăm	Indicative
sufocat	None
zbierăm	Indicative
ștersesem	Indicative
înfoiaserăm	Indicative
atragem	Indicative
frământau	Indicative
așteptaseră	Indicative
locuia	Indicative
insidioasei	None
cuprinzi	Indicative
spectralelor	None
ucizi	Indicative
unduiserăm	Indicative
ghidaserăți	Indicative
astâmpărarăți	Indicative
mărit	Indicative
cucerim	Indicative
convinsese	Indicative
grăiserăm	Indicative
lua	Indicative
caimacule	None
avalanșă	None
părăsea	Indicative
asigurase	Indicative
semnez	Indicative
judecaserăm	Indicative
abandonez	Indicative
dormirăți	Indicative
milimetric	None
odihnisem	Indicative
zici	Indicative
lipsisem	Indicative
coperim	Indicative
urmaserăm	Indicative
mergi	Indicative
chemările	None
pedepsiserăți	Indicative
injectase	Indicative
obțineau	Indicative
rezist	Indicative
răpuneai	Indicative
salvez	Indicative
furi	Indicative
paielor	None
aflară	Indicative
înnegreau	Indicative
copleșea	Indicative
construim	Indicative
îngropau	Indicative
umblau	Indicative
împlântară	Indicative
îndemnau	Indicative
ținu	Indicative
albastre	None
inundarăți	Indicative
activând	None
lăudau	Indicative
fixaseși	Indicative
înmulțim	Indicative
comunei	None
lepădă	Indicative
spumă	Indicative
aciuarăți	Indicative
necesitățile	None
arse	Indicative
sfătui	Indicative
arseserăm	Indicative
descălecaserăm	Indicative
spintecăm	Indicative
distinserăți	Indicative
aureau	Indicative
luminoaselor	None
păunule	None
veninoșilor	None
spinului	None
nimerea	Indicative
interveni	Indicative
dușmăniseși	Indicative
întreb	Indicative
câmpului	None
ciocanelor	None
îmbătrâni	Indicative
povârnirăm	Indicative
masivă	None
avansaserăm	Indicative
mescuseși	Indicative
amorțirăți	Indicative
sticletelui	None
unim	Indicative
mirosisem	Indicative
buză	None
intenționarăm	Indicative
închipuiseră	Indicative
slăvirăți	Indicative
inundaseși	Indicative
rămâne	Indicative
distrez	Indicative
dictez	Indicative
lovise	Indicative
încurajase	Indicative
strănut	Indicative
fracturase	Indicative
salut	Indicative
încununi	Indicative
sașii	None
întreprinzi	Indicative
trimiseseră	Indicative
târgui	Indicative
animalului	None
sfeclirăți	Indicative
săptămîna	None
amețiseși	Indicative
doriseră	Indicative
delogă	Indicative
trecuseră	Indicative
zimbrului	None
alerga	Indicative
sparsese	Indicative
depănarăm	Indicative
amăgeai	Indicative
surpa	Indicative
îmbrățișase	Indicative
găsii	Indicative
alunecaserăți	Indicative
urlu	Indicative
imperialismul	None
admirarăm	Indicative
continue	None
jur	Indicative
punctași	Indicative
încurcaseși	Indicative
eliminăm	Indicative
săpau	Indicative
bărbieri	Indicative
junimea	None
tentaserăm	Indicative
lucrez	Indicative
pliviserăm	Indicative
desenasem	Indicative
ficatului	None
ezita	Indicative
îmbătrâneai	Indicative
degerase	Indicative
vlăguirăm	Indicative
săpaseră	Indicative
abdicase	Indicative
văduviserăm	Indicative
îngustaserăți	Indicative
întâlni	Indicative
cântecelor	None
creanga	None
tragea	Indicative
înlocuiești	Indicative
întării	Indicative
obligași	Indicative
preveștiserăți	Indicative
încuiarăți	Indicative
fumarăți	Indicative
sparseră	Indicative
pornografica	None
spurcate	None
supărarăm	Indicative
napii	None
numim	Indicative
desfătarăți	Indicative
închisului	None
culese	Indicative
întrerupserăți	Indicative
controlară	Indicative
dezunim	Indicative
sugaciule	None
gudurarăți	Indicative
clarificasem	Indicative
epocii	None
ocroti	Indicative
tinse	Indicative
făliși	Indicative
hibernat	None
înrădăcinasem	Indicative
coapsa	None
descriseseși	Indicative
conjugaserăm	Indicative
dezavantajaserăm	Indicative
discordie	None
injectez	Indicative
atinse	Indicative
spulberași	Indicative
râdea	Indicative
stabilești	Indicative
nauruanii	None
obișnuim	Indicative
cobora	Indicative
apărură	Indicative
vitezei	None
adevăratul	None
deschidea	Indicative
înfocași	Indicative
părăsiseră	Indicative
cărnoșilor	None
slugării	Indicative
radem	Indicative
răspunseserăți	Indicative
devenise	Indicative
învăț	Indicative
descheiarăți	Indicative
pandeismului	None
ruptului	None
mâne	Indicative
fă	Imperative-Jussive
neguțezi	Indicative
capacității	None
aberativelor	None
avalanșelor	None
scăpași	Indicative
beștelelor	None
împrumut	Indicative
putreziră	Indicative
invadase	Indicative
înălțăm	Indicative
împiedicaserăm	Indicative
istoricele	None
zbătuseși	Indicative
lingvistică	None
dialectală	None
călcarăți	Indicative
mândrești	Indicative
reintroduserăm	Indicative
rogi	Indicative
descuiau	Indicative
capitulase	Indicative
ridicăm	Indicative
strâmbarăm	Indicative
surprinse	Indicative
discutase	Indicative
aprindeați	Indicative
custarăți	Indicative
declara	Indicative
cinară	Indicative
virgulei	None
grăbi	Indicative
miști	Indicative
ciuguleai	Indicative
deplasaseși	Indicative
creativi	None
auriu	None
divorțaseră	Indicative
concepi	Indicative
preoțiseră	Indicative
setoasele	None
vrăjile	None
bancnotă	None
omorâm	Indicative
cert	Indicative
înșirau	Indicative
strigat	None
experimentați	None
scăpătă	Indicative
aflase	Indicative
rarul	None
măcinași	Indicative
trăia	Indicative
sătura	Indicative
servisem	Indicative
pietroasă	None
malteza	None
transpiraserăm	Indicative
pinguinilor	None
muierii	None
protejez	Indicative
reintroduseserăm	Indicative
avansase	Indicative
oxidul	None
rugi	Indicative
monogamie	None
mingea	None
temem	Indicative
băurăm	Indicative
balustradelor	None
exportatorii	None
prețuim	Indicative
purpurie	None
bociră	Indicative
cronologiilor	None
bară	Indicative
micșorase	Indicative
circumciseserăți	Indicative
încăperilor	None
îngrășăm	Indicative
stăpânea	Indicative
udasem	Indicative
storceai	Indicative
magazinerule	None
anule	None
mișcător	None
uneltei	None
potrivit	None
terapiilor	None
descântaseși	Indicative
zăpăcit	None
amăgi	Indicative
fracturasem	Indicative
perseverezi	Indicative
ieșea	Indicative
dușul	None
ungureștile	None
măruntelor	None
bășica	Indicative
sfaturilor	None
flexibilitate	None
jignești	Indicative
abdicăm	Indicative
însetezași	Indicative
cerșiserăm	Indicative
steagule	None
vorbise	Indicative
îmbăta	Indicative
nodul	None
zdrobim	Indicative
salvezi	Indicative
studiară	Indicative
norocos	None
pieriseră	Indicative
arinosului	None
șevaletul	None
împărțea	Indicative
murmura	Indicative
sfulgerăm	Indicative
rezemarăm	Indicative
controla	Indicative
empiricei	None
degeraseră	Indicative
flaurul	None
întrebuințau	Indicative
farmaciștii	None
laptele	None
crăpa	Indicative
străbunii	None
veghez	Indicative
fluxul	None
scăpau	Indicative
căcaserăm	Indicative
luaserăți	Indicative
adunarăți	Indicative
reținem	Indicative
azvârlit	None
scăldasem	Indicative
funcționa	Indicative
scufunzi	Indicative
împăra	Indicative
bieți	None
imputarăți	Indicative
pedepseau	Indicative
ghidelor	None
pășunezi	Indicative
slujiși	Indicative
simțea	Indicative
apăruseși	Indicative
cutremur	Indicative
violenței	None
împănară	Indicative
controlau	Indicative
mergeau	Indicative
calitatea	None
albinițelor	None
iubi	Indicative
brazdă	None
zărise	Indicative
răsfățarăm	Indicative
încetase	Indicative
tușești	Indicative
aplecarăți	Indicative
încălecă	Indicative
coniferele	None
dezgropară	Indicative
contrazicea	Indicative
întărâtaserăm	Indicative
stima	Indicative
erați	Indicative
înșirară	Indicative
împrăștia	Indicative
apriga	None
mândri	Indicative
rădăcinilor	None
necăjești	Indicative
lucrarea	None
aurirăți	Indicative
obraznicul	None
deștept	Indicative
tăcea	Indicative
încercasem	Indicative
învăța	Indicative
înavuțiră	Indicative
reținea	Indicative
deșteptaseși	Indicative
tehnicienii	None
fusese	Indicative
răzgândi	Indicative
învălurau	Indicative
despicași	Indicative
recunoscuseră	Indicative
plăcu	Indicative
vânătă	None
hrăneau	Indicative
bășic	Indicative
nivelă	Indicative
închegase	Indicative
moartei	None
mâncaseră	Indicative
cardiologiei	None
săturase	Indicative
dezleg	Indicative
făurise	Indicative
sângeroasele	None
izgoneai	Indicative
păcura	None
rămăseseră	Indicative
viii	None
intenționase	Indicative
descălțasem	Indicative
robisem	Indicative
viteazului	None
invitaserăm	Indicative
deranjezi	Indicative
terminase	Indicative
cufunda	Indicative
înveninasem	Indicative
fărâmaserăți	Indicative
leoaica	None
stăpânești	Indicative
lași	Indicative
introdusesem	Indicative
furiei	None
donasem	Indicative
credinciosul	None
ajunași	Indicative
trăncăneați	Indicative
citit	None
guvernau	Indicative
comunica	Indicative
muncă	None
stricate	None
albii	None
mințise	Indicative
modificăm	Indicative
împărțim	Indicative
simplitatea	None
arde	Indicative
perfectul	None
înșeli	Indicative
binecuvântat	None
saturi	Indicative
generație	None
zi	Imperative-Jussive
gemene	None
circumscris	None
țesu	Indicative
pumnalelor	None
reușea	Indicative
reduceau	Indicative
cumpliră	Indicative
adormim	Indicative
intim	None
piloții	None
suspin	Indicative
diminua	Indicative
mierlă	None
apăsa	Indicative
canoneați	Indicative
rezistăm	Indicative
întâmpinând	None
rodeau	Indicative
cerci	Indicative
conținut	None
clădi	Indicative
holbaserăți	Indicative
arătaseră	Indicative
adunau	Indicative
eșecului	None
acoperim	Indicative
guvernasem	Indicative
încăpeau	Indicative
atacași	Indicative
grăiau	Indicative
pavarăți	Indicative
radioul	None
organelor	None
maeștrii	None
planta	Indicative
oftica	Indicative
rezolvaserăți	Indicative
înghețasem	Indicative
timidă	None
arbaletei	None
trotuarul	None
judecătorii	None
alinase	Indicative
scald	Indicative
blocaseși	Indicative
încadrăm	Indicative
baraserăm	Indicative
maturități	None
depărase	Indicative
bucuraserăm	Indicative
lepezi	Indicative
întoarcem	Indicative
preveneai	Indicative
sud-africanului	None
cercetărilor	None
desfirăm	Indicative
așezarăm	Indicative
odihniserăm	Indicative
abației	None
liliecii	None
parcarea	None
prinților	None
tramvaiele	None
salvă	Indicative
vânturi	Indicative
dorești	Indicative
subțiaseși	Indicative
îmboldiși	Indicative
presupunem	Indicative
viețuirăți	Indicative
însoțise	Indicative
prescriserăm	Indicative
ezitase	Indicative
sărbătorit	None
pingeliserăm	Indicative
tăbăceai	Indicative
rodea	Indicative
stăruisem	Indicative
sorteau	Indicative
avansași	Indicative
tipărea	Indicative
spânzurară	Indicative
îndeletniciserăți	Indicative
urdinași	Indicative
îmbinau	Indicative
spulber	Indicative
cooperaserăm	Indicative
fraudă	Indicative
învățaseră	Indicative
știuca	None
zăreați	Indicative
documentăm	Indicative
tânjii	Indicative
multipolarități	None
finisaseră	Indicative
avânt	Indicative
terminăm	Indicative
gătiseși	Indicative
îmbunătățeau	Indicative
sperau	Indicative
înnoiești	Indicative
etimologiilor	None
fur	Indicative
pliveau	Indicative
cartilajului	None
ajunaseși	Indicative
veștejiseși	Indicative
răzlețim	Indicative
cutremurași	Indicative
acrișor	None
animi	Indicative
brânzeturile	None
obosise	Indicative
fericit	None
clipă	None
mirăm	Indicative
pugilistul	None
suptele	None
scufundând	None
riscăm	Indicative
stabilități	None
plăcuse	Indicative
lucii	Indicative
clătim	Indicative
nebunești	Indicative
opiul	None
depăna	Indicative
zdrobiseră	Indicative
apăsat	None
înjurăturile	None
macagiul	None
vrăjitorul	None
simbolizezi	Indicative
arseră	Indicative
înnoirăm	Indicative
urmărise	Indicative
datorarăm	Indicative
nauruanul	None
neguța	Indicative
japonezului	None
roșești	Indicative
descriem	Indicative
brazdelor	None
simbolizau	Indicative
zbieră	Indicative
divorțase	Indicative
crestat	None
despărțise	Indicative
podișurilor	None
înjunghiarăți	Indicative
romancierii	None
înălțarăm	Indicative
dezmățaseși	Indicative
îmboldisem	Indicative
înfrunzești	Indicative
chiorâm	Indicative
căutași	Indicative
ațipim	Indicative
muncim	Indicative
dispăru	Indicative
hibernaserăm	Indicative
structuraților	None
bociserăm	Indicative
descurcăreți	None
asemeni	Indicative
aduci	Indicative
extinsese	Indicative
pedepsele	None
atacăm	Indicative
adunăm	Indicative
potcoavele	None
spânzurași	Indicative
aberativă	None
rotea	Indicative
fluvială	None
sferica	None
îmboldirăm	Indicative
empiric	None
țesui	Indicative
dezgropa	Indicative
pictau	Indicative
юби	Indicative
distrusese	Indicative
răzgândeau	Indicative
reînnoia	Indicative
bucurase	Indicative
cerceii	None
rabinilor	None
ieșii	Indicative
emoționa	Indicative
oficialii	None
originalitatea	None
faină	None
petrecurăm	Indicative
păruserăm	Indicative
făinoșilor	None
fiicelor	None
aștepți	Indicative
elefanților	None
opriră	Indicative
înnoiserăți	Indicative
umblaseră	Indicative
prepoziția	None
răcnii	Indicative
bebelușului	None
prinseși	Indicative
lucioși	None
relaxată	None
topim	Indicative
sunau	Indicative
supunem	Indicative
curgeau	Indicative
cooperau	Indicative
ameninț	Indicative
folosit	None
orientau	Indicative
dezamăgi	Indicative
zbiera	Indicative
nativului	None
cutreieraseși	Indicative
degetelor	None
îndeletnicit	None
înfățișaserăți	Indicative
răpuseși	Indicative
prăbușiră	Indicative
greșiserăți	Indicative
amarilisului	None
semna	Indicative
tentantă	None
amărârăm	Indicative
măcina	Indicative
răszise	Indicative
învolburaseși	Indicative
comunicăm	Indicative
perindaseră	Indicative
botanici	None
urmăreau	Indicative
inund	Indicative
trimitem	Indicative
zebrele	None
împodobit	None
afânași	Indicative
singurului	None
invada	Indicative
imputaserăți	Indicative
învenină	Indicative
sfertul	None
turnat	None
ocrotisem	Indicative
nauruanului	None
ungea	Indicative
furiile	None
încurcând	None
enigmatică	None
nivela	Indicative
înrămaseră	Indicative
ascunserăți	Indicative
desprindea	Indicative
socotit	None
spui	Indicative
tipări	Indicative
înierbaseși	Indicative
înșurubez	Indicative
traversăm	Indicative
perindară	Indicative
biciclistul	None
mestecaseră	Indicative
creaseră	Indicative
lexemele	None
pitorescul	None
iritarăm	Indicative
mângâiarăm	Indicative
forțaseră	Indicative
intoxicaseși	Indicative
linguriță	None
asemănă	Indicative
redusesem	Indicative
purtaseră	Indicative
introduseserăți	Indicative
stăm	Indicative
apropiem	Indicative
spărgeai	Indicative
răpeați	Indicative
deșiri	Indicative
umblarăm	Indicative
sfâșiau	Indicative
imputase	Indicative
bararăm	Indicative
bărbierilor	None
ejaculat	None
depunând	None
coiotul	None
desmățarăm	Indicative
evingeai	Indicative
legasem	Indicative
întemeiară	Indicative
atacaserăți	Indicative
jucă	Indicative
gâmbăm	Indicative
naști	Indicative
utilizăm	Indicative
fericitele	None
prevesteau	Indicative
făceai	Indicative
meduzelor	None
rândunica	None
îndeletnicise	Indicative
măritaseși	Indicative
cășunaseră	Indicative
mulțumi	Indicative
vizibilitatea	None
deștepteați	Indicative
forțez	Indicative
rămâneați	Indicative
slăvi	Indicative
ghidarăți	Indicative
dezbin	Indicative
adun	Indicative
botezau	Indicative
apucaseră	Indicative
orchestralilor	None
injecta	Indicative
păstrăvul	None
murdării	Indicative
individul	None
racule	None
gândisem	Indicative
îndemnăm	Indicative
acumulau	Indicative
mâncat	None
greși	Indicative
silaba	None
perechea	None
împreună	Indicative
crezui	Indicative
crestaseră	Indicative
răseserăm	Indicative
descântase	Indicative
căută	Indicative
rugile	None
murmur	Indicative
calendarele	None
puții	Indicative
manechinul	None
destupau	Indicative
alte	None
ziseseși	Indicative
însoțiră	Indicative
separase	Indicative
vizualiza	Indicative
reduce	Indicative
înduplecaserăm	Indicative
îmblânzi	Indicative
crearăm	Indicative
canarul	None
inserție	None
râzând	None
călcând	None
ocup	Indicative
căzură	Indicative
labelor	None
împleti	Indicative
amuzăm	Indicative
luptăm	Indicative
destupi	Indicative
balticul	None
tipăriseși	Indicative
trăiseră	Indicative
menținură	Indicative
ședințelor	None
înviorăm	Indicative
existaserăm	Indicative
întreținurăm	Indicative
mângâiaserăți	Indicative
furtuna	None
structurala	None
credincioasei	None
modificase	Indicative
delimitaseră	Indicative
ruinasem	Indicative
numii	Indicative
lovești	Indicative
stimulez	Indicative
creezi	Indicative
învățătoarele	None
potcoavă	None
fotbaliștii	None
asfaltare	None
primirii	None
găuri	Indicative
porniserăm	Indicative
clădise	Indicative
veștejim	Indicative
beși	Indicative
reintroduseserăți	Indicative
confrunt	Indicative
plângem	Indicative
bianualii	None
intervenii	Indicative
spânzuraseră	Indicative
ședeau	Indicative
plictisești	Indicative
acoperea	Indicative
distruseși	Indicative
ursoaica	None
critici	None
noatenii	None
dregi	Indicative
piesă	None
întâlnii	Indicative
umpluserăm	Indicative
scriseseși	Indicative
umbrela	None
scâncisem	Indicative
ațâțarăm	Indicative
surprinzătoarea	None
cunoscuse	Indicative
scărpinaseși	Indicative
tiveau	Indicative
văzuse	Indicative
azvârleai	Indicative
esența	None
surpași	Indicative
dezisei	Indicative
strigau	Indicative
adjectivele	None
pluralității	None
ajutaseră	Indicative
învecinau	Indicative
căpețeaua	None
lucrare	None
specialitate	None
răbdaserăm	Indicative
spinii	None
țigăniserăți	Indicative
spetea	Indicative
rostea	Indicative
salvăm	Indicative
clocotise	Indicative
cântând	None
faptele	None
linul	None
extrageați	Indicative
învinseseră	Indicative
locuiau	Indicative
amenințările	None
automatele	None
cununară	Indicative
înlăturase	Indicative
amintirăm	Indicative
proptiseră	Indicative
custaserăm	Indicative
salvase	Indicative
împilaserăți	Indicative
împletea	Indicative
surele	None
mâncă	Indicative
supuseserăm	Indicative
anterioare	None
lămuriseră	Indicative
urdinarăți	Indicative
obraznic	None
frământărilor	None
valahei	None
barza	None
croi	Indicative
fragii	None
trecui	Indicative
construia	Indicative
blestemaserăm	Indicative
bloca	Indicative
atraseră	Indicative
vipturilor	None
distingi	Indicative
despărți	Indicative
iertau	Indicative
ciobanului	None
ascuțirăm	Indicative
temea	Indicative
auziserăm	Indicative
cimpanzeule	None
sărbătorea	Indicative
vorbiserăți	Indicative
cașalotule	None
fălim	Indicative
zbârlirăți	Indicative
face	Indicative
părăseai	Indicative
avansaseră	Indicative
așteptăm	Indicative
mortul	None
furnicași	Indicative
soporiferei	None
fuți	Indicative
nebuni	Indicative
plăcutul	None
imaginaserăm	Indicative
crescuseră	Indicative
speriem	Indicative
scriau	Indicative
rețelelor	None
ataraxiei	None
canonului	None
păziserăm	Indicative
treierarăm	Indicative
putem	Indicative
mișc	Indicative
influențaserăm	Indicative
ceruse	Indicative
numea	Indicative
divorțară	Indicative
cercul	None
kaki	None
amintirii	None
prietenia	None
legase	Indicative
necăjirăm	Indicative
controlaseși	Indicative
încălzești	Indicative
răneau	Indicative
văzui	Indicative
deșira	Indicative
lăsaserăm	Indicative
supunea	Indicative
obligarăm	Indicative
impusese	Indicative
răpise	Indicative
șubred	None
stimaserăm	Indicative
potabilități	None
răcneau	Indicative
tresărirăm	Indicative
proprietate	None
adeveriserăm	Indicative
traductorul	None
nutrea	Indicative
prosti	Indicative
descompuseseră	Indicative
uitaseră	Indicative
desfășurasem	Indicative
lovi	Indicative
cocorii	None
ațâța	Indicative
cotești	Indicative
putrezit	None
loga	Indicative
venea	Indicative
impuserăți	Indicative
tăticul	None
guduraserăm	Indicative
răzleții	Indicative
sinucisese	Indicative
fremătară	Indicative
abandonase	Indicative
supăra	Indicative
surprinzând	None
încuia	Indicative
ațâțaseră	Indicative
dușmăniseră	Indicative
comandau	Indicative
încălăm	Indicative
slav	None
îngerului	None
cust	Indicative
căutau	Indicative
strici	Indicative
înverșunarăm	Indicative
merizaseră	Indicative
dărâma	Indicative
călcaserăm	Indicative
deșteptea	Indicative
memorizaserăți	Indicative
juca	Indicative
flămânzi	Indicative
fulger	Indicative
mândrele	None
îndrăzniseși	Indicative
pederastului	None
cerșeau	Indicative
împăună	Indicative
cravată	None
dezrădăcina	Indicative
întreprinsesem	Indicative
calitate	None
opriseră	Indicative
interfețele	None
certă	Indicative
umplând	None
depuseserăm	Indicative
juisase	Indicative
pricepurăm	Indicative
glasurile	None
îndepărtăm	Indicative
auri	Indicative
întrerupea	Indicative
murim	Indicative
strânse	Indicative
masturba	Indicative
călcase	Indicative
mâncau	Indicative
dizolvarăm	Indicative
amfibiu	None
neteziră	Indicative
înflori	Indicative
mulțumeau	Indicative
intervenim	Indicative
sătule	None
hotărâse	Indicative
înțelepților	None
cepelor	None
fălești	Indicative
arsă	None
pronume	None
reintroduse	Indicative
intensitatea	None
introductive	None
strecurară	Indicative
dezrobeai	Indicative
răsfăță	Indicative
cucerise	Indicative
pregnante	None
căsătorise	Indicative
cinelor	None
tărăgănaserăți	Indicative
giacă	None
păstrez	Indicative
circulară	Indicative
pescărușul	None
dezmierdaserăm	Indicative
narcoticului	None
zburdau	Indicative
lansăm	Indicative
episcopalului	None
înjosiră	Indicative
răsuni	Indicative
înneguraseră	Indicative
seduse	Indicative
înălțările	None
activez	Indicative
prelungii	Indicative
turcilor	None
distră	Indicative
țuguiele	None
dublezi	Indicative
transatlanticelor	None
puțin	None
vizualizarea	None
zbicisem	Indicative
combinaserăm	Indicative
reținuși	Indicative
urmărea	Indicative
criticabilele	None
exageră	Indicative
reducea	Indicative
omorât	None
șuierase	Indicative
internei	None
încălțămintei	None
dinozaurul	None
lumina	None
dizolvând	None
conjugaseși	Indicative
crucific	Indicative
treieraserăți	Indicative
gimnastelor	None
sista	Indicative
reintroducea	Indicative
plecasem	Indicative
luând	None
leșina	Indicative
îngrijim	Indicative
varză	None
guvernezi	Indicative
omniprezente	None
ceri	Indicative
elevului	None
excita	Indicative
începu	Indicative
ascunseseră	Indicative
plătise	Indicative
strecurarăm	Indicative
macrourilor	None
fugise	Indicative
concepem	Indicative
strecurase	Indicative
uitasem	Indicative
viguroase	None
prelungisem	Indicative
izbăviserăm	Indicative
scăzurăți	Indicative
doreau	Indicative
uscaserăm	Indicative
umedele	None
făgăduiși	Indicative
alint	Indicative
inteligente	None
hărților	None
bulgărești	None
învinse	Indicative
mutau	Indicative
cicliști	None
degera	Indicative
stăpâniseră	Indicative
recuperăm	Indicative
limpezi	Indicative
comparase	Indicative
hidratul	None
visa	Indicative
veni	Indicative
ținut	None
bronzul	None
împădurești	Indicative
australienilor	None
cutremurele	None
înmărmuriseră	Indicative
oripilaserăți	Indicative
forfotiseși	Indicative
delași	Indicative
pripești	Indicative
afunda	Indicative
goliciunii	None
modificarăm	Indicative
refuzăm	Indicative
flecarii	None
înfăină	Indicative
subscrisese	Indicative
asudăm	Indicative
acuzi	Indicative
pregătii	Indicative
tovărășesc	None
tăiași	Indicative
conduci	Indicative
virusurile	None
decăzui	Indicative
încoronase	Indicative
frecași	Indicative
înverziră	Indicative
folosim	Indicative
teiule	None
conteniserăți	Indicative
înspăimântat	None
contopea	Indicative
destrama	Indicative
muști	Indicative
oprise	Indicative
cocoloșeau	Indicative
instantul	None
lingușea	Indicative
reumatismul	None
țintea	Indicative
pava	Indicative
întrerupem	Indicative
neîmpiedicata	None
virusul	None
topeau	Indicative
izvoarele	None
prinseserăți	Indicative
rotunjiseși	Indicative
nenumărabilul	None
bombele	None
cutreierasem	Indicative
dictară	Indicative
cerca	Indicative
vânturasem	Indicative
răsăriseși	Indicative
lipiseși	Indicative
înțelesese	Indicative
cercetăm	Indicative
unsei	Indicative
frământa	Indicative
țipau	Indicative
întâlnirăți	Indicative
răcorise	Indicative
țip	Indicative
imperialul	None
prăsii	Indicative
liniștise	Indicative
singură	None
tun	Indicative
ștersei	Indicative
curmat	None
semnezi	Indicative
otrăvi	Indicative
șchiopăta	Indicative
flămânzii	Indicative
pisică	None
zăreai	Indicative
dator	None
câmpeneasca	None
decedase	Indicative
înfumurez	Indicative
rămâneai	Indicative
încununase	Indicative
formalității	None
înnegri	Indicative
cocoloșim	Indicative
despuneai	Indicative
hrănirăți	Indicative
orfanului	None
interzicem	Indicative
prindeați	Indicative
tăioși	None
torsesem	Indicative
eliberarăți	Indicative
luă	Indicative
răsziceați	Indicative
apărărilor	None
încălecase	Indicative
prețuind	None
neîmpiedicatelor	None
balcanicii	None
mâncaserăți	Indicative
fonetic	None
avortă	Indicative
imputași	Indicative
amânasem	Indicative
traducea	Indicative
introduci	Indicative
curva	None
răsculase	Indicative
zbicirăm	Indicative
apăreau	Indicative
zăcuse	Indicative
moștenirăți	Indicative
întâmpinau	Indicative
repezirăți	Indicative
vizită	Indicative
ațâțat	None
fii	Imperative-Jussive
acceleraserăm	Indicative
trântim	Indicative
vrăjeai	Indicative
indiscretului	None
timpul	None
așteptau	Indicative
întărâtat	None
comunitate	None
țigănise	Indicative
urlași	Indicative
înconjuraserăm	Indicative
vlăguise	Indicative
halucinaserăm	Indicative
încălaseși	Indicative
surpaserăm	Indicative
proiectele	None
copiezi	Indicative
obținuseră	Indicative
conducem	Indicative
mireasă	None
șeful	None
vede	Indicative
depusesem	Indicative
înmormântaserăți	Indicative
sparseserăți	Indicative
delogaserăți	Indicative
satirelor	None
bietelor	None
aeroplanul	None
primilor	None
măsurară	Indicative
transatlanticilor	None
așteptă	Indicative
comport	Indicative
săltau	Indicative
adoptarăm	Indicative
tenta	Indicative
expediarăm	Indicative
înlesniși	Indicative
încadrași	Indicative
deziceai	Indicative
cântărirăm	Indicative
îndrăznim	Indicative
încărunțea	Indicative
anulasem	Indicative
ghiceați	Indicative
ataraxiile	None
delimitez	Indicative
botgrosul	None
expedia	Indicative
strecurau	Indicative
produceau	Indicative
tradu	Imperative-Jussive
nemascata	None
cireșul	None
șerbise	Indicative
excelase	Indicative
corciserăm	Indicative
omnipotențe	None
ejacula	Indicative
datorez	Indicative
pup	Indicative
riscară	Indicative
lucezi	None
deprindea	Indicative
muriră	Indicative
vetricei	None
zdrobisem	Indicative
saltului	None
prăbușiseră	Indicative
apropiau	Indicative
învolburaseră	Indicative
rog	Indicative
satisfă	Imperative-Jussive
pizdele	None
putuseră	Indicative
construiați	Indicative
nativă	None
confluenței	None
năframa	None
celebrăm	Indicative
lărgea	Indicative
convingătorii	None
utilizași	Indicative
minunase	Indicative
eronatul	None
îndrăznea	Indicative
retezarăți	Indicative
suflecași	Indicative
înfășura	Indicative
dorise	Indicative
îndrăznise	Indicative
înjosi	Indicative
cravatele	None
pedepsea	Indicative
sunasem	Indicative
calculaților	None
scărpina	Indicative
combina	Indicative
însetezase	Indicative
adoptăm	Indicative
subțiind	None
șchioapă	None
bălțații	None
zbârcisem	Indicative
cinsesem	Indicative
reînnoi	Indicative
despicaseși	Indicative
înavuțirăți	Indicative
scăzuseși	Indicative
versatil	None
exciți	Indicative
plecaseră	Indicative
vizualizezi	Indicative
afixul	None
strungă	None
australianul	None
pierduseși	Indicative
mânecasem	Indicative
încăpusem	Indicative
gălbinare	None
culegea	Indicative
dăunarăți	Indicative
îmbătaților	None
rusului	None
cuget	Indicative
slăbi	Indicative
pișcoturile	None
abandonau	Indicative
plajă	None
recuperez	Indicative
ceruseră	Indicative
mâniaserăți	Indicative
acumulaserăm	Indicative
lingușirăți	Indicative
interesa	Indicative
defăimat	None
îmbogățise	Indicative
ridicară	Indicative
vânturând	None
central	None
urmăm	Indicative
apăsase	Indicative
nudismul	None
dureroasele	None
dăpăraseși	Indicative
cinstim	Indicative
orgasmicii	None
auguraserăți	Indicative
farfuriile	None
zadele	None
reintroduseseră	Indicative
lăudași	Indicative
scrisesem	Indicative
înnegreai	Indicative
cutremura	Indicative
deranjăm	Indicative
evinseși	Indicative
clocotiși	Indicative
moare	Indicative
dezlegaseră	Indicative
zgardă	None
nurcă	None
mediocri	None
necontestată	None
miraserăm	Indicative
formalitatea	None
pregnant	None
mulsese	Indicative
dansaseși	Indicative
blestem	Indicative
defăimase	Indicative
tină	None
câștigăm	Indicative
decisei	Indicative
stingeau	Indicative
terapeutica	None
unseră	Indicative
rosti	Indicative
înfăptuind	None
blestemele	None
grăbea	Indicative
văduvii	Indicative
pisasem	Indicative
omniscient	None
fierărie	None
junghiarăți	Indicative
alianța	None
înfrunzit	None
împrejurasem	Indicative
lungise	Indicative
supraviețuiserăți	Indicative
denatura	Indicative
icră	None
insecuritatea	None
depusese	Indicative
iubea	Indicative
împiedicară	Indicative
naivelor	None
munții	None
jenă	Indicative
cinaserăți	Indicative
razele	None
împroprietărisem	Indicative
salutaseră	Indicative
măseseși	Indicative
înecase	Indicative
cioplești	Indicative
măcelarul	None
fălii	Indicative
pisicilor	None
trezim	Indicative
blocase	Indicative
subțiași	Indicative
amestecat	None
rămăseserăm	Indicative
întrebase	Indicative
adăpase	Indicative
făliserăm	Indicative
străvăzui	Indicative
coceau	Indicative
ațineai	Indicative
spumaserăm	Indicative
refuzi	Indicative
înscriem	Indicative
dezlipiserăți	Indicative
canonisem	Indicative
cuprinse	Indicative
strângem	Indicative
nerușinate	None
desfășă	Indicative
sfințiseră	Indicative
zgăura	Indicative
scurgea	Indicative
detaliilor	None
filantropia	None
citii	Indicative
analizatorul	None
înverzind	None
înveli	Indicative
numise	Indicative
umbla	Indicative
ferestruii	Indicative
prăseau	Indicative
plimbăm	Indicative
spânii	None
bărbieriși	Indicative
eșecurile	None
ubicuitate	None
străvechiului	None
căsătorea	Indicative
plantă	Indicative
lansarăți	Indicative
imaginezi	Indicative
mărginim	Indicative
albului	None
înotase	Indicative
aluneca	Indicative
acuzata	None
arătăm	Indicative
atârna	Indicative
trăgănasem	Indicative
piețelor	None
mobilule	None
întrerupseși	Indicative
domina	Indicative
cugetarăm	Indicative
scarmeni	Indicative
mâncăm	Indicative
pasteurizat	None
pasteuriza	Indicative
robiseră	Indicative
lucraseră	Indicative
deveni	Indicative
fura	Indicative
comportând	None
trăncănirăm	Indicative
evinseserăm	Indicative
simetric	None
înfăptuise	Indicative
minerilor	None
cărasem	Indicative
decedă	Indicative
sefardă	None
ștersese	Indicative
circumscrise	Indicative
gravitaționalii	None
acuzase	Indicative
obținea	Indicative
băurăți	Indicative
chemarăm	Indicative
păruserăți	Indicative
locul	None
ocrotim	Indicative
virtuoasă	None
cârtiță	None
muie	Indicative
refuzau	Indicative
cădea	Indicative
întâlniseși	Indicative
arătase	Indicative
chimicelor	None
emeriți	None
slăbii	Indicative
măturase	Indicative
înfruntăm	Indicative
dispărurăți	Indicative
îndemnase	Indicative
eșecul	None
compozitoarelor	None
compuseseși	Indicative
chimiștilor	None
scrotul	None
descheiași	Indicative
intoxicăm	Indicative
lărgise	Indicative
menții	Indicative
reintroduceau	Indicative
îmbunătăți	Indicative
discutași	Indicative
absorbisem	Indicative
întristarăm	Indicative
corneea	None
călcat	None
țipătului	None
viorea	None
prospătăm	Indicative
arseserăți	Indicative
bucium	Indicative
circumcis	None
fiertul	None
cununat	None
activă	Indicative
înzestrăm	Indicative
prinse	Indicative
obliga	Indicative
farfuriilor	None
izbi	Indicative
părăsise	Indicative
cercară	Indicative
loghezi	Indicative
povârnisem	Indicative
cerem	Indicative
uzi	Indicative
cinstise	Indicative
descompunea	Indicative
spurcăm	Indicative
cărând	None
robirăm	Indicative
strămuta	Indicative
stropi	Indicative
purici	Indicative
uscă	Indicative
pilotăm	Indicative
înfierbântaseși	Indicative
neguțaserăți	Indicative
trifoiurile	None
jucaserăm	Indicative
clătiseși	Indicative
stricase	Indicative
imputaseși	Indicative
imprima	Indicative
înseninase	Indicative
tancurile	None
desfășura	Indicative
stătuse	Indicative
deplinătatea	None
prăbușise	Indicative
cicliștii	None
strâmtarăm	Indicative
ziceai	Indicative
scoți	Indicative
preferi	Indicative
mințind	None
înviorarăm	Indicative
razelor	None
asimila	Indicative
laiul	None
locuiseși	Indicative
alergară	Indicative
scria	Indicative
înfuria	Indicative
sclavilor	None
chinezului	None
simțim	Indicative
adopt	Indicative
îngălbenirăm	Indicative
criminalul	None
influențez	Indicative
țigănirăți	Indicative
transpirarăm	Indicative
soporificii	None
cotropi	Indicative
cuprinzând	None
semicercurilor	None
dumnezeii	None
tutunurilor	None
văduviseși	Indicative
acceselor	None
sorbeau	Indicative
deranjau	Indicative
detaliului	None
împăcase	Indicative
pline	None
cafelei	None
epuiza	Indicative
holbase	Indicative
trăind	None
convii	Indicative
câștigaseră	Indicative
tâmpeai	Indicative
treierară	Indicative
cireașă	None
sughițau	Indicative
pantoful	None
îmbulzisem	Indicative
necuviinciosul	None
înfășurau	Indicative
intact	None
analoagei	None
îndepărta	Indicative
cășunau	Indicative
plutisem	Indicative
reduse	Indicative
înșir	Indicative
sfinți	Indicative
alin	Indicative
emoționă	Indicative
purificau	Indicative
lătra	Indicative
libidinoși	None
dezunii	Indicative
apăs	Indicative
onorurilor	None
vars	Indicative
diseca	Indicative
rezemaserăm	Indicative
sugrum	Indicative
cutez	Indicative
oilor	None
dura	None
digital	None
robiserăți	Indicative
guvernase	Indicative
atent	None
deranja	Indicative
sexoasă	None
cădem	Indicative
răguși	Indicative
învingi	Indicative
pățiși	Indicative
sughițasem	Indicative
înălța	Indicative
apărăm	Indicative
faci	Indicative
răcniserăm	Indicative
coriandrul	None
imperial	None
plăteau	Indicative
oglindi	Indicative
dormiserăm	Indicative
socializase	Indicative
lămpii	None
clădirilor	None
moștenea	Indicative
vânduseși	Indicative
sacrificiile	None
introduseși	Indicative
atrase	Indicative
alungau	Indicative
șomajul	None
dezdoiau	Indicative
săptămâna	None
șovăiseși	Indicative
repauzăm	Indicative
spartul	None
intenționezi	Indicative
seară	None
făurisem	Indicative
răzbuni	Indicative
rușinarăm	Indicative
greșeau	Indicative
învinșilor	None
relaxate	None
echilibra	Indicative
unchiul	None
lucraserăți	Indicative
înrămaseși	Indicative
oripilez	Indicative
războiule	None
dezice	Indicative
venerarăți	Indicative
creași	Indicative
sângerase	Indicative
serul	None
analoage	None
scăzuseră	Indicative
servise	Indicative
comunicase	Indicative
fraudase	Indicative
dreseseși	Indicative
cărăbușul	None
împuțirăm	Indicative
cunoștea	Indicative
chemat	None
împodobiși	Indicative
înverșunaseși	Indicative
sudică	None
căpăta	Indicative
pornografie	None
basmalei	None
fumuriu	None
arborilor	None
adoptase	Indicative
depărta	Indicative
dezmățași	Indicative
zgomotoasă	None
cântării	Indicative
plânserăm	Indicative
neprietenoase	None
răsfățăm	Indicative
așeza	Indicative
obligară	Indicative
sfecleați	Indicative
nemțeștile	None
peștii	None
gimnastei	None
susțineau	Indicative
probat	None
suciră	Indicative
jupuit	None
dovedea	Indicative
prețuisem	Indicative
săpând	None
întrebuințez	Indicative
cufundarăm	Indicative
poporanului	None
relaxatul	None
sacra	None
trăiserăm	Indicative
oripilau	Indicative
amuțiseși	Indicative
încheiară	Indicative
unsese	Indicative
găsea	Indicative
biserică	None
extern	None
polonezii	None
ofiliserăm	Indicative
datorăm	Indicative
dorea	Indicative
spovedeai	Indicative
scânteiaseră	Indicative
pleci	Indicative
peticea	Indicative
furasem	Indicative
tivirăți	Indicative
întâlniră	Indicative
odihnirăm	Indicative
contenești	Indicative
cercasem	Indicative
făptui	Indicative
îmbucarăm	Indicative
înfiripaaseși	Indicative
sângerezi	Indicative
absorbea	Indicative
castraseși	Indicative
gândim	Indicative
explici	Indicative
insista	Indicative
încet	Indicative
împodobea	Indicative
doreai	Indicative
urci	Indicative
adăugă	Indicative
folosești	Indicative
impuseseră	Indicative
zăceau	Indicative
venerarăm	Indicative
evoluțiilor	None
masculine	None
dispăruseră	Indicative
bocești	Indicative
victoriilor	None
păruiși	Indicative
obosi	Indicative
problemelor	None
vegheaserăți	Indicative
murarăm	Indicative
femeieasca	None
formalitățile	None
feri	Indicative
reușisem	Indicative
scăpăm	Indicative
îngheța	Indicative
afurisim	Indicative
traduci	Indicative
abdica	Indicative
lăsăm	Indicative
olarilor	None
argintiile	None
înmormânta	Indicative
aduce	Indicative
lunga	None
adormirăți	Indicative
pășunau	Indicative
impuse	Indicative
păruit	None
soporifera	None
merita	Indicative
pictă	Indicative
cumințiși	Indicative
cunoscutelor	None
îndepărtau	Indicative
stupida	None
încăpățânatul	None
îmbătând	None
închideai	Indicative
întreținurăți	Indicative
răspândise	Indicative
manechinelor	None
ții	Indicative
utilizase	Indicative
glumii	Indicative
sărăcie	None
rațelor	None
dărăci	Indicative
gravitaționalul	None
flămânzisem	Indicative
încheiem	Indicative
stimez	Indicative
scoli	Indicative
mișunaserăm	Indicative
brăzară	Indicative
miroseau	Indicative
mândrei	None
celtă	None
conturului	None
incompletele	None
scoase	Indicative
geantă	None
asprimea	None
dăunând	None
vegheară	Indicative
funcționau	Indicative
aurirăm	Indicative
fluiera	Indicative
răsare	Indicative
scormoniseși	Indicative
căpătarăți	Indicative
căutat	None
lipsi	Indicative
termina	Indicative
înlocuia	Indicative
dezdoiai	Indicative
băut	None
rachetă	None
cărăbușului	None
peșteră	None
conveni	Indicative
mărețului	None
leucemiei	None
purifica	Indicative
reduci	Indicative
lătrară	Indicative
judecăm	Indicative
negasem	Indicative
schimbase	Indicative
coreeanul	None
ziceau	Indicative
tinzând	None
înfipseși	Indicative
pescărușilor	None
canonirăm	Indicative
îndepărtez	Indicative
frec	Indicative
terției	None
răsfăț	Indicative
încerci	Indicative
divorța	Indicative
normalitatea	None
externi	None
aberantului	None
destupa	Indicative
cămilei	None
oacheșilor	None
interesară	Indicative
dezmeticise	Indicative
despărțim	Indicative
perinda	Indicative
obișnuiră	Indicative
eliberaseră	Indicative
răspândiseși	Indicative
bășiși	Indicative
răspândeați	Indicative
mistreț	None
bășicarăm	Indicative
elefantul	None
aleseseră	Indicative
contravenise	Indicative
unici	None
închidem	Indicative
culci	Indicative
guguștiucul	None
originalității	None
alegeai	Indicative
influența	Indicative
recuperau	Indicative
medicină	None
otrăvii	Indicative
cartoful	None
venerările	None
tăcui	Indicative
pasaseși	Indicative
căpătaserăm	Indicative
primele	None
scârba	None
templierilor	None
seceri	Indicative
otrăviserăm	Indicative
înmulțise	Indicative
strămoșul	None
carboxilice	None
șușuirăm	Indicative
versatilă	None
pastorii	None
cântaseră	Indicative
purcelei	None
impunea	Indicative
lărgit	None
ruseștile	None
castră	Indicative
înălțași	Indicative
primirea	None
inexprimabilelor	None
brazilienilor	None
clătina	Indicative
mucii	None
roserăm	Indicative
ejaculație	None
înrudeai	Indicative
transform	Indicative
presupunea	Indicative
convine	Indicative
anulaseră	Indicative
născurăm	Indicative
admirase	Indicative
stăpâniseși	Indicative
endoscopule	None
dispuse	Indicative
scuipase	Indicative
ascuțea	Indicative
abdic	Indicative
constrânseseră	Indicative
asimilaserăm	Indicative
comândasem	Indicative
extinseserăm	Indicative
francezilor	None
destupaserăm	Indicative
barași	Indicative
sinagogă	None
returnarăm	Indicative
auzeau	Indicative
îndurerau	Indicative
lipind	None
tranzitivă	None
încăriseși	Indicative
îmbrăcarăți	Indicative
mișunau	Indicative
voioșilor	None
înnopta	Indicative
prânzirăți	Indicative
păcătuiai	Indicative
lipiră	Indicative
întrebă	Indicative
împărții	Indicative
stătui	Indicative
tivise	Indicative
cumplești	Indicative
distrugem	Indicative
invizibilitatea	None
încadrez	Indicative
tiranilor	None
înfăptuiserăm	Indicative
trădară	Indicative
funcționăm	Indicative
evenimentele	None
sinuciseserăți	Indicative
pregăteau	Indicative
acuzăm	Indicative
binecuvântând	None
ghidă	Indicative
îngustarăm	Indicative
motorul	None
atrasei	Indicative
deșelară	Indicative
înnegreați	Indicative
șopârla	None
inteligenți	None
zbori	Indicative
superi	Indicative
însoțeai	Indicative
sucești	Indicative
înceta	Indicative
crezând	None
întâmpli	Indicative
leagăn	Indicative
celebra	Indicative
răsfoiserăți	Indicative
implica	Indicative
activistele	None
forfotiserăm	Indicative
supăr	Indicative
circumciseși	Indicative
susurau	Indicative
sistarăți	Indicative
absorbiră	Indicative
blasfemia	None
gândi	Indicative
trunchiurilor	None
documentase	Indicative
ploaie	None
repezii	Indicative
propusesem	Indicative
estimau	Indicative
sinistre	None
întâmplasem	Indicative
deciserăm	Indicative
îngreunau	Indicative
jupuiseși	Indicative
semivocală	None
apăruseră	Indicative
roșiii	None
ținuseră	Indicative
exagerez	Indicative
traversau	Indicative
urcaseră	Indicative
socotitele	None
căzurăți	Indicative
adorând	None
țintirimurilor	None
vopsirăți	Indicative
țapul	None
chițăim	Indicative
atragea	Indicative
retezaseși	Indicative
întorsese	Indicative
impui	Indicative
grăbise	Indicative
simțiserăți	Indicative
trăsniserăm	Indicative
borâră	Indicative
neutri	None
substanțele	None
moldovenilor	None
interzise	Indicative
spumegași	Indicative
împilaseși	Indicative
iertași	Indicative
scoserăți	Indicative
șovăind	None
înfrâna	Indicative
stâlpului	None
urmărim	Indicative
lemnarii	None
canonii	Indicative
dezlega	Indicative
coapsese	Indicative
craniilor	None
punctaserăți	Indicative
împăturiseră	Indicative
celebraseră	Indicative
supuseseră	Indicative
aprindeau	Indicative
pețea	Indicative
interesant	None
discursurile	None
șchiopăți	Indicative
împingeați	Indicative
circumcideau	Indicative
împrejuraseră	Indicative
micșorau	Indicative
dansul	None
distrași	Indicative
întrerupeați	Indicative
distracția	None
păcăliși	Indicative
ofiliseși	Indicative
arătau	Indicative
slujisem	Indicative
controlat	None
simplificaseși	Indicative
ajunase	Indicative
dregea	Indicative
fuserăm	Indicative
descărcasem	Indicative
dărâm	Indicative
păducheară	Indicative
tăiaseră	Indicative
înăbușim	Indicative
dezlipim	Indicative
răspândi	Indicative
adusese	Indicative
câștigau	Indicative
tovărășescului	None
căutase	Indicative
scărmănași	Indicative
plutea	Indicative
găurea	Indicative
erecție	None
urmez	Indicative
muncea	Indicative
pingeliși	Indicative
celebrarăm	Indicative
biscuitului	None
pătrunzând	None
bufniță	None
balcanice	None
mingile	None
învălură	Indicative
împingem	Indicative
circumscriseseră	Indicative
concepeai	Indicative
defăimași	Indicative
astupa	Indicative
pavarăm	Indicative
dezbina	Indicative
tăiase	Indicative
disecau	Indicative
rufei	None
împlinise	Indicative
retragem	Indicative
scăpărase	Indicative
arătă	Indicative
așteptării	None
separ	Indicative
clarificarăm	Indicative
lanternă	None
scurmăm	Indicative
irațională	None
elimini	Indicative
preoțești	Indicative
porcăriilor	None
vizualizaseră	Indicative
sminteai	Indicative
sunară	Indicative
lărgeai	Indicative
numărau	Indicative
mărunțești	Indicative
urcare	None
юбим	Indicative
decapitau	Indicative
schizofrenie	None
plăcuseși	Indicative
udași	Indicative
dublat	None
apărătorilor	None
datoraseră	Indicative
avortarăm	Indicative
secolului	None
testiculară	None
zgâriem	Indicative
ezit	Indicative
dejugi	Indicative
discutaseră	Indicative
flutur	Indicative
confruntăm	Indicative
descinseseși	Indicative
făgăduiau	Indicative
scăpaserăți	Indicative
împarți	Indicative
monocrome	None
capitalistelor	None
mulgeai	Indicative
înjura	Indicative
flexibilitatea	None
peticiseră	Indicative
băuse	Indicative
invincibilitatea	None
găurise	Indicative
excitaserăți	Indicative
măritase	Indicative
flexibilă	None
iubești	Indicative
alama	None
căraserăți	Indicative
păstrași	Indicative
redusese	Indicative
pierdeai	Indicative
distraseși	Indicative
venerase	Indicative
analele	None
pățiserăți	Indicative
grăise	Indicative
răpiseră	Indicative
copiasem	Indicative
asistenților	None
așezarăți	Indicative
activăm	Indicative
dezunești	Indicative
afuriseau	Indicative
șubredă	None
comunicau	Indicative
conștiințele	None
punctaserăm	Indicative
pedepsim	Indicative
nutrise	Indicative
urlăm	Indicative
bomfaierelor	None
dezlipii	Indicative
alcătui	Indicative
dezunind	None
tușiși	Indicative
nutriserăm	Indicative
capitalist	None
transcriai	Indicative
trecură	Indicative
convenim	Indicative
contrazici	Indicative
religiile	None
tinsesem	Indicative
descinsesem	Indicative
răpuseseră	Indicative
căprioarele	None
descurc	Indicative
creau	Indicative
anulau	Indicative
înrudea	Indicative
murdarilor	None
circumscriai	Indicative
îmbuibi	Indicative
ucidea	Indicative
zombii	None
mici	None
aducem	Indicative
ațipirăți	Indicative
alegeau	Indicative
vedea	Indicative
ierna	Indicative
brun	None
zbierau	Indicative
răceala	None
petrecuserăți	Indicative
căsătorii	Indicative
citadelei	None
stabilea	Indicative
grei	None
funcționară	Indicative
cresta	Indicative
dezmântase	Indicative
anusurilor	None
răposau	Indicative
perfectei	None
versurilor	None
viermuiseră	Indicative
potrivim	Indicative
îmbrățișasem	Indicative
disponibilul	None
piersicasem	Indicative
toxicelor	None
ocupaserăți	Indicative
mulțumiră	Indicative
fluierarăți	Indicative
impredictibil	None
urâm	Indicative
frumuseților	None
detaliul	None
însoțeau	Indicative
stafidele	None
nebuniserăți	Indicative
adunaserăți	Indicative
fripserăți	Indicative
tăgăduiseși	Indicative
despica	Indicative
dărăcim	Indicative
radiațiilor	None
întortochezi	Indicative
îndulcit	None
cărare	None
mlaștinilor	None
cuveniși	Indicative
întuneci	Indicative
pasând	None
devenii	Indicative
rupând	None
zărganul	None
nepopulare	None
forțau	Indicative
plutiserăm	Indicative
încerc	Indicative
prescrisese	Indicative
nivelaseși	Indicative
spuneați	Indicative
șevaletului	None
îmbogățim	Indicative
clarificăm	Indicative
apoasa	None
însuflețeați	Indicative
dezavantajoasele	None
prefera	Indicative
dușmăniei	None
abandonași	Indicative
isprăvise	Indicative
desprinseseră	Indicative
sfârșești	Indicative
vomurăți	Indicative
slăvești	Indicative
descalți	Indicative
infirmierului	None
amân	Indicative
îndurasem	Indicative
introduce	Indicative
friptului	None
mirandeza	None
fluvialul	None
odihneau	Indicative
copacul	None
desmățară	Indicative
murau	Indicative
înfiripaa	Indicative
intacte	None
atlantica	None
licăreați	Indicative
nălucă	None
încuiară	Indicative
convenise	Indicative
lanul	None
prostirăm	Indicative
câștigară	Indicative
urșilor	None
jalnică	None
rupea	Indicative
lubrifia	Indicative
muri	Indicative
distinseseră	Indicative
scrumiera	None
înclinaserăți	Indicative
scăparăți	Indicative
murdărind	None
săltase	Indicative
pornim	Indicative
platele	None
cumpănirăți	Indicative
șoptiseși	Indicative
ornați	None
urâsem	Indicative
plictisi	Indicative
spuseserăm	Indicative
rabinii	None
copleșiși	Indicative
utilizez	Indicative
chemăm	Indicative
umpluse	Indicative
împerecheași	Indicative
minună	Indicative
custaseră	Indicative
cumnatei	None
făuriserăți	Indicative
plutești	Indicative
smulsei	Indicative
înălțaseră	Indicative
bacteria	None
străpunsesem	Indicative
stimularăți	Indicative
freca	Indicative
familia	None
zăcămintelor	None
străpunseseră	Indicative
înfulecași	Indicative
înlături	Indicative
insistăm	Indicative
atinsese	Indicative
turnaserăm	Indicative
păstrase	Indicative
fractura	Indicative
desprinsese	Indicative
portabilitate	None
convingătoare	None
propuseseră	Indicative
înzestră	Indicative
contravenisem	Indicative
decădea	Indicative
decăzuseră	Indicative
trezești	Indicative
labă	None
răstigniserăți	Indicative
tentară	Indicative
plătim	Indicative
mersese	Indicative
conceput	None
dezmințiserăți	Indicative
finisa	Indicative
implicarăți	Indicative
întâlnim	Indicative
adeverim	Indicative
sfătuiserăm	Indicative
îndurerăm	Indicative
fântânilor	None
finisezi	Indicative
hienă	None
prescurtărilor	None
întorceau	Indicative
lipi	Indicative
răscoapseseră	Indicative
înghețatei	None
deșideri	Indicative
încurcarăți	Indicative
parazitara	None
refuzaseră	Indicative
foarfeci	Indicative
roseserăm	Indicative
sperarăm	Indicative
broaștelor	None
întrevede	Indicative
zbătuseră	Indicative
abandonare	None
asigurau	Indicative
flămânzirăți	Indicative
vântoasa	None
hotărâseră	Indicative
cotirăți	Indicative
citi	Indicative
rănise	Indicative
întingeau	Indicative
potrivii	Indicative
inteligent	None
hrănești	Indicative
bazezi	Indicative
leoparzilor	None
mulțumești	Indicative
suspinasem	Indicative
legau	Indicative
incompleta	None
extindeați	Indicative
pierduse	Indicative
plăti	Indicative
lucrul	None
răsunară	Indicative
călugărițele	None
veghem	Indicative
credință	None
dărăceați	Indicative
otrăvești	Indicative
documentez	Indicative
omorâse	Indicative
înseninaseși	Indicative
dușurile	None
amânăm	Indicative
zbieraseși	Indicative
cooperare	None
neuitabilii	None
dumicaseră	Indicative
discrete	None
zburaseră	Indicative
desparți	Indicative
glumea	Indicative
bazez	Indicative
jinduiau	Indicative
circularăți	Indicative
nauruani	None
strânsese	Indicative
ezitați	Indicative
scufundară	Indicative
bănuiserăm	Indicative
găsise	Indicative
viețuiau	Indicative
fericiserăți	Indicative
acanții	None
stric	Indicative
rezistase	Indicative
muncisem	Indicative
învălurași	Indicative
transcria	Indicative
țintirăți	Indicative
betoanele	None
născui	Indicative
recunoscu	Indicative
împărțeau	Indicative
răsărind	None
zgârie-norii	None
deșideraseși	Indicative
prășiră	Indicative
răzgândeați	Indicative
îndeletnicești	Indicative
pianele	None
angajase	Indicative
vopsiră	Indicative
omorî	Indicative
uitase	Indicative
simetrica	None
tăgădui	Indicative
întristaseră	Indicative
pregetară	Indicative
musculoșilor	None
copiaserăți	Indicative
jocurile	None
frâna	Indicative
aplicăm	Indicative
folosiseră	Indicative
miezului	None
ponegrisem	Indicative
îngreunezi	Indicative
observ	Indicative
tăbăceați	Indicative
castelele	None
încăpuși	Indicative
suceau	Indicative
dezgust	Indicative
congelă	Indicative
moștenisem	Indicative
presupuseși	Indicative
fragile	None
străinilor	None
prinși	None
emoționat	None
sugrumat	None
contraveneai	Indicative
botezară	Indicative
înrâuriră	Indicative
furase	Indicative
mistificară	Indicative
despicaseră	Indicative
repezim	Indicative
descălțarăți	Indicative
ospătaseră	Indicative
răsăritule	None
formalităților	None
vulpe	None
stana	None
încercăm	Indicative
putu	Indicative
adăugăm	Indicative
loghez	Indicative
dezgheț	Indicative
dublarăm	Indicative
măcinau	Indicative
fraudez	Indicative
îndurând	None
mărunțiserăți	Indicative
lăii	None
desenau	Indicative
anal	None
înotaseră	Indicative
munci	Indicative
comparăm	Indicative
vino	Imperative-Jussive
clăti	Indicative
uraganului	None
cioplirăți	Indicative
iernase	Indicative
refecând	None
insurmontabililor	None
termin	Indicative
încarci	Indicative
futabilelor	None
trădez	Indicative
făcea	Indicative
explicațiile	None
sărasem	Indicative
păstra	Indicative
pedepsit	None
întristase	Indicative
smulsese	Indicative
cumpătasem	Indicative
opriși	Indicative
apărut	None
fărâmară	Indicative
dospești	Indicative
salutăm	Indicative
avânta	Indicative
cuvine	Indicative
implicăm	Indicative
râdeați	Indicative
menținuse	Indicative
alăptarăți	Indicative
băga	Indicative
virile	None
stingea	Indicative
amestecarăți	Indicative
exagera	Indicative
formidabilul	None
colaboratoarelor	None
ucise	Indicative
răsărea	Indicative
urmăriseră	Indicative
țintim	Indicative
râzi	Indicative
protejăm	Indicative
mursecași	Indicative
locuit	None
aștepta	Indicative
întrebărilor	None
înghețarăți	Indicative
accesul	None
întâlneau	Indicative
pretențioasă	None
oratorului	None
zise	Indicative
vizibilități	None
nominală	None
înmormântă	Indicative
netezi	Indicative
încercau	Indicative
fremătasem	Indicative
emoționez	Indicative
leșinaseră	Indicative
babuinii	None
spărgeau	Indicative
amintea	Indicative
înlocuiră	Indicative
nădăjduirăți	Indicative
observa	Indicative
amanetaseși	Indicative
sufocarăm	Indicative
gazase	Indicative
armă	None
pisa	Indicative
induce	Indicative
crezi	Indicative
îndrăgostii	Indicative
țipi	Indicative
moștenise	Indicative
studiau	Indicative
măsurarăm	Indicative
izgonisem	Indicative
orientând	None
ieșim	Indicative
pofticioase	None
atârnarăți	Indicative
transformarăți	Indicative
șoptim	Indicative
aprinșilor	None
împlineau	Indicative
stingherisem	Indicative
forjă	Indicative
vărsau	Indicative
ascunzi	Indicative
deschisese	Indicative
vorbim	Indicative
ferestruiești	Indicative
scrumieră	None
structural	None
aprinserăm	Indicative
introducem	Indicative
extinseși	Indicative
ungând	None
argiloși	None
părăsi	Indicative
vodcă	None
șoaptele	None
mâzgăleau	Indicative
îndobitocisem	Indicative
dimineților	None
căutarăm	Indicative
izbăvi	Indicative
pianului	None
transcriau	Indicative
supărăm	Indicative
rulezi	Indicative
zânele	None
telefonule	None
cugetaserăți	Indicative
susținuseră	Indicative
contopiseră	Indicative
demnele	None
echipajul	None
încălecaseră	Indicative
dispăreau	Indicative
forțăm	Indicative
umezi	None
lipim	Indicative
necăji	Indicative
pregetarăm	Indicative
moșiilor	None
învechite	None
bizonul	None
ocupaseră	Indicative
încetirăm	Indicative
tindem	Indicative
pierdu	Indicative
dormitaseră	Indicative
încumet	Indicative
glumești	Indicative
lubrifiaserăți	Indicative
blestemași	Indicative
diriguiești	Indicative
cordonului	None
intenționa	Indicative
cunoscuții	None
alanină	None
iubim	Indicative
vizualizez	Indicative
importanți	None
caracterelor	None
pescărușii	None
nimerești	Indicative
ieșeau	Indicative
imperialilor	None
râvniseră	Indicative
internaționalele	None
negarăți	Indicative
îmbrăcau	Indicative
treziși	Indicative
ebraică	None
lansi	Indicative
azvârleau	Indicative
adăugase	Indicative
dezmântăm	Indicative
gemui	Indicative
pricepeau	Indicative
răsculară	Indicative
mâncaseși	Indicative
gândise	Indicative
șuierarăți	Indicative
căpătase	Indicative
animară	Indicative
prostești	Indicative
desziceai	Indicative
fulgeraserăți	Indicative
atrofiei	None
invadau	Indicative
descoperim	Indicative
destinat	None
chiorați	Indicative
cânți	Indicative
milimetricului	None
spaghetele	None
conduce	Indicative
eliberezi	Indicative
trântiși	Indicative
rododendronii	None
pâinilor	None
desfășurară	Indicative
îndurerarăți	Indicative
întinași	Indicative
pornografiei	None
spintecasem	Indicative
maghiara	None
ceață	None
înfățișase	Indicative
vaccinez	Indicative
ghida	Indicative
domnule	None
frânaserăm	Indicative
speli	Indicative
atingi	Indicative
speria	Indicative
întindeau	Indicative
amânară	Indicative
împlinim	Indicative
plantară	Indicative
aera	Indicative
buzunarule	None
extindea	Indicative
cumpătat	None
arăducem	Indicative
zgomotosul	None
citeau	Indicative
distruse	Indicative
apropiaseși	Indicative
probarăți	Indicative
nenoroceau	Indicative
ars	None
rostirăți	Indicative
servi	Indicative
prășiși	Indicative
psihiatrie	None
dezavantaja	Indicative
invadaseră	Indicative
strămutaserăți	Indicative
pitorească	None
dovediseși	Indicative
cercaseși	Indicative
bei	Indicative
dormitarăm	Indicative
distinse	Indicative
bucur	Indicative
înfundaserăți	Indicative
asemănară	Indicative
urziră	Indicative
întrezări	Indicative
spinteci	Indicative
decăzusem	Indicative
pripiserăți	Indicative
înlătura	Indicative
drogul	None
înnod	Indicative
alților	None
subsonic	None
sexuale	None
belind	None
moașelor	None
halucinezi	Indicative
tatuarăți	Indicative
atârnăm	Indicative
urziși	Indicative
eră	None
toarse	Indicative
mărgini	Indicative
mergem	Indicative
fonetica	None
spumaserăți	Indicative
tăcerile	None
extindeau	Indicative
îmbogăți	Indicative
alegi	Indicative
mângâiase	Indicative
salvaseră	Indicative
sărbătorim	Indicative
râserăm	Indicative
necontestat	None
începi	Indicative
specifici	None
înfrunzeai	Indicative
faleză	None
clocoteați	Indicative
goleau	Indicative
ezitarăm	Indicative
străpunseserăți	Indicative
unii	Indicative
mielule	None
emeriții	None
păcăliră	Indicative
comunici	Indicative
alungat	None
îmbătații	None
tremurul	None
fălirăm	Indicative
prevenii	Indicative
bananelor	None
minții	Indicative
descria	Indicative
ajuna	Indicative
lupt	Indicative
picase	Indicative
clocotisem	Indicative
desfiraserăți	Indicative
părăsim	Indicative
spălau	Indicative
cetățeanule	None
gimnastele	None
furnicaserăți	Indicative
neguțau	Indicative
îndesa	Indicative
așez	Indicative
citeai	Indicative
jurase	Indicative
car	Indicative
preziceau	Indicative
diminuase	Indicative
capră	None
despărțisem	Indicative
pieptul	None
socoti	Indicative
enigmatic	None
distinsei	Indicative
tiranul	None
pătezi	Indicative
rânced	None
binară	None
stătuseși	Indicative
trunchiurile	None
ispiteați	Indicative
interna	None
cernea	Indicative
credințele	None
sudului	None
perechii	None
veghe	Indicative
onorând	None
număraseră	Indicative
externelor	None
speriaserăți	Indicative
decafeinizatei	None
scurse	Indicative
clădești	Indicative
echidna	None
șubrezilor	None
asigura	Indicative
pici	Indicative
aerisim	Indicative
picași	Indicative
îngusta	Indicative
înmărmurii	Indicative
buricelor	None
abdicaserăm	Indicative
dezbrăcă	Indicative
îngrășarăm	Indicative
cosmici	None
elasticități	None
credeai	Indicative
plânse	Indicative
înnegurau	Indicative
pisat	None
încurcase	Indicative
moșteneau	Indicative
arabul	None
terminarea	None
conțineau	Indicative
răpirăm	Indicative
distrugea	Indicative
cotropim	Indicative
însărcinaseși	Indicative
dramatic	None
adăpasem	Indicative
hranei	None
stătea	Indicative
securile	None
dezunirăm	Indicative
răsucirăm	Indicative
înșelași	Indicative
speraseră	Indicative
agerilor	None
oblig	Indicative
activaseră	Indicative
vorbii	Indicative
aduseseră	Indicative
cununi	Indicative
înmânaseră	Indicative
neapăratelor	None
îndobitoci	Indicative
strânseserăți	Indicative
menținurăți	Indicative
lucra	Indicative
înghițind	None
murdări	Indicative
glorificatoarele	None
întrebi	Indicative
protejau	Indicative
indisponibilii	None
avortasem	Indicative
destramarăți	Indicative
veșnici	None
schimbi	Indicative
gravitezi	Indicative
utilizarăți	Indicative
țăranul	None
salinizarăm	Indicative
zdrobeau	Indicative
vacilor	None
căutaseră	Indicative
vopsea	Indicative
dansași	Indicative
fumurie	None
curățau	Indicative
revistă	None
șoarecelui	None
cosmonautului	None
androceul	None
maltezele	None
mănânc	Indicative
roșii	Indicative
răspundea	Indicative
decedarăți	Indicative
imprimau	Indicative
făcură	Indicative
înfipse	Indicative
dezmierdau	Indicative
izgoniserăm	Indicative
adâncimilor	None
iernau	Indicative
rotunjiși	Indicative
sperăm	Indicative
vizualizăm	Indicative
blocaseră	Indicative
amenințasem	Indicative
observau	Indicative
declarași	Indicative
legănăm	Indicative
cameramanul	None
înnoră	Indicative
scoatem	Indicative
produce	Indicative
venera	Indicative
puțeai	Indicative
treierarăți	Indicative
modifici	Indicative
acvilele	None
destrăbălarăți	Indicative
parcase	Indicative
murase	Indicative
urbanizași	Indicative
îndrăzni	Indicative
zburdat	None
țânțarului	None
iei	Indicative
treci	Indicative
frânasem	Indicative
excursionistule	None
dreserăm	Indicative
aprinseseși	Indicative
constrângeați	Indicative
vânduse	Indicative
articula	Indicative
traseră	Indicative
barase	Indicative
veghea	Indicative
înduplecasem	Indicative
prinzi	Indicative
proiectului	None
tiviserăți	Indicative
bărbatul	None
învățăm	Indicative
împlânt	Indicative
crescută	None
amărăști	Indicative
fasole	None
avansau	Indicative
aiurau	Indicative
chemaseră	Indicative
admirau	Indicative
răsfoiși	Indicative
expoziției	None
neadaptate	None
sărutat	None
încălțau	Indicative
văduvi	Indicative
îndrăznirăm	Indicative
cangurului	None
înlesni	Indicative
portocalie	None
funda	Indicative
degerară	Indicative
dicționarul	None
mângâiat	None
școlile	None
modifica	Indicative
golești	Indicative
slujeai	Indicative
bombardamentele	None
dăunară	Indicative
bază	Indicative
sarmalele	None
împlinea	Indicative
scornisem	Indicative
răcori	Indicative
rușina	Indicative
pasez	Indicative
plin	None
împrejmuiau	Indicative
pripit	None
junimilor	None
jenez	Indicative
circulau	Indicative
alesese	Indicative
agresivă	None
deszicem	Indicative
zăriși	Indicative
împliniră	Indicative
aduni	Indicative
trăise	Indicative
pocnise	Indicative
descoperise	Indicative
vedem	Indicative
dapăr	Indicative
însoți	Indicative
câștiga	Indicative
palmierul	None
bănui	Indicative
curați	None
scuipa	Indicative
puma	None
folosise	Indicative
documentarăm	Indicative
tinseserăm	Indicative
văzuși	Indicative
deschis	None
învecheau	Indicative
îngropaserăm	Indicative
lavandei	None
inundat	None
rătăcirăți	Indicative
termini	Indicative
protejezi	Indicative
râurile	None
luași	Indicative
croia	Indicative
dezmeticirăm	Indicative
înșirași	Indicative
iertaseră	Indicative
dreserăți	Indicative
scurgeau	Indicative
tăgăduiși	Indicative
prezervativul	None
imaginase	Indicative
încălecară	Indicative
repede	None
furăm	Indicative
uscata	None
cumnatele	None
suveranității	None
luau	Indicative
baclavalei	None
plătea	Indicative
exiști	Indicative
bivolul	None
închin	Indicative
dezbrăca	Indicative
frauda	Indicative
întrezării	Indicative
răpit	None
relaxați	None
înscriseserăți	Indicative
petrecea	Indicative
cerceta	Indicative
golea	Indicative
moșteniseră	Indicative
anulaserăm	Indicative
plângea	Indicative
împăturisem	Indicative
arsurii	None
vădiseră	Indicative
capsulară	Indicative
criticul	None
încercuia	Indicative
scălda	Indicative
confruntând	None
gemeni	None
mutaseră	Indicative
străbăteau	Indicative
merseseră	Indicative
totalităților	None
boală	None
țigănești	Indicative
sari	Imperative-Jussive
sclava	None
găsit	None
germană	None
sucea	Indicative
răspândeau	Indicative
acceleraserăți	Indicative
omniscientele	None
venise	Indicative
răzbunarăm	Indicative
îngâmfat	None
îngânaseși	Indicative
cancerelor	None
decideai	Indicative
prostea	Indicative
citim	Indicative
robii	Indicative
tocii	Indicative
interzice	Indicative
suntem	Indicative
adeverisem	Indicative
astâmpăraseși	Indicative
împungeau	Indicative
cerere	None
lucraserăm	Indicative
găurirăm	Indicative
tăcem	Indicative
scrisese	Indicative
transcriseseși	Indicative
numărând	None
corupseseră	Indicative
învechiseră	Indicative
urcau	Indicative
aerisești	Indicative
ospătă	Indicative
zburdăm	Indicative
tremurat	None
finisară	Indicative
triști	None
râmau	Indicative
mănânci	Indicative
supraviețuiseră	Indicative
peștele	None
dragei	None
disponibil	None
descompuseși	Indicative
belelelor	None
exagerară	Indicative
străbunicii	None
portretelor	None
contul	None
înconjurăm	Indicative
cufurise	Indicative
aperi	Indicative
mărităm	Indicative
descompuse	Indicative
credeau	Indicative
pilotez	Indicative
neg	Indicative
atomule	None
dăuna	Indicative
strângeau	Indicative
sfinții	Indicative
fărâm	Indicative
deșiraseși	Indicative
întâlnești	Indicative
descălțară	Indicative
negi	Indicative
ținea	Indicative
încăpuseși	Indicative
ajutase	Indicative
admiraserăm	Indicative
pomilor	None
puterile	None
măcinară	Indicative
taxiul	None
pătrunseseră	Indicative
salutase	Indicative
descurcarăți	Indicative
coperirăm	Indicative
trecut	None
devine	Indicative
greșiseră	Indicative
șchiopătând	None
bucile	None
hali	Indicative
încheietură	None
lungești	Indicative
iraționalilor	None
duioșii	None
aplaudi	Indicative
spunem	Indicative
trimitea	Indicative
aciuau	Indicative
insultaseși	Indicative
ținti	Indicative
țigăniseși	Indicative
nearticulati	None
visez	Indicative
iscăliseră	Indicative
portarilor	None
concepea	Indicative
prafului	None
amețiserăți	Indicative
prăși	Indicative
scuturi	Indicative
sărise	Indicative
evlavia	None
pliviseră	Indicative
îmbrăcase	Indicative
conduse	Indicative
absorbii	Indicative
mulțumirăm	Indicative
destrăbălasem	Indicative
presupusei	Indicative
freci	Indicative
număr	Indicative
înduplecarăm	Indicative
îndopaserăți	Indicative
scara	None
cade	Indicative
însărcinase	Indicative
cumpătarea	None
automatului	None
țesurăm	Indicative
ghiujule	None
fluturarăm	Indicative
schiorului	None
încercuise	Indicative
gândești	Indicative
minuna	Indicative
mânca	Indicative
estimase	Indicative
refuzași	Indicative
tremura	Indicative
sporisem	Indicative
dispunând	None
năștea	Indicative
jupui	Indicative
spălară	Indicative
centrului	None
piși	Indicative
zări	Indicative
poporanul	None
porților	None
tatuat	None
goliseși	Indicative
spectralilor	None
cordul	None
distruseseră	Indicative
oboiul	None
instantaneu	None
acuzară	Indicative
apăsăm	Indicative
lățești	Indicative
tăbăcii	Indicative
renovezi	Indicative
smulseși	Indicative
zgâiau	Indicative
excitaseră	Indicative
bulevardului	None
tocă	Indicative
murdară	None
sulfuroșii	None
unise	Indicative
săriserăm	Indicative
indiferenți	None
amărai	Indicative
traversarăți	Indicative
împingea	Indicative
viile	None
sărase	Indicative
satisface	Indicative
sănătos	None
expozițiile	None
zbura	Indicative
știusem	Indicative
cruntă	None
închipuiserăm	Indicative
persanului	None
condusese	Indicative
chipului	None
riscase	Indicative
dovedi	Indicative
scufundată	None
frontierele	None
învecinași	Indicative
izgoneați	Indicative
nivelului	None
bărbierii	Indicative
migdală	None
învăță	Indicative
presupunând	None
fierbea	Indicative
flutura	Indicative
mânecași	Indicative
smaraldele	None
doreați	Indicative
somat	None
gorilele	None
repauza	Indicative
venim	Indicative
numeri	Indicative
aflași	Indicative
măriți	Indicative
iscăleau	Indicative
nelucrații	None
roti	Indicative
cufurit	None
norocoasa	None
împăca	Indicative
eliberăm	Indicative
scrupulozități	None
mândriră	Indicative
sonatelor	None
prostiși	Indicative
sminteau	Indicative
extinseseși	Indicative
amorțirăm	Indicative
vădim	Indicative
asculți	Indicative
conjuga	Indicative
rasei	None
separăm	Indicative
siniștrilor	None
amintești	Indicative
meriți	Indicative
răsuciseră	Indicative
diminuă	Indicative
lăsase	Indicative
scormonit	None
întrezărim	Indicative
apăruserăm	Indicative
preferarăm	Indicative
munciră	Indicative
întingeai	Indicative
despicase	Indicative
legarăm	Indicative
despuseseși	Indicative
înnegrind	None
macagiilor	None
scoseseră	Indicative
muiară	Indicative
încadrezi	Indicative
profesiei	None
merseserăți	Indicative
simetricul	None
cotea	Indicative
prietenă	None
amorți	Indicative
admir	Indicative
slabi	None
tigrilor	None
macabru	None
țineau	Indicative
stabilii	Indicative
strecura	Indicative
băteai	Indicative
introduserăm	Indicative
înălțând	None
scurtaseră	Indicative
evenimentule	None
declarăm	Indicative
pregetaseși	Indicative
deplasa	Indicative
fixă	Indicative
studentă	None
virnanțului	None
surp	Indicative
rula	Indicative
împresurarăți	Indicative
căsătoriseră	Indicative
începuseră	Indicative
nădăjduim	Indicative
stoarserăm	Indicative
privegheaserăți	Indicative
omenie	None
răniseră	Indicative
creștinătăți	None
acuzarăm	Indicative
bazase	Indicative
rechinul	None
înțelepciune	None
petrecu	Indicative
ofileai	Indicative
înfiară	Indicative
depărasem	Indicative
mângâiaseși	Indicative
alergau	Indicative
vânez	Indicative
anticipările	None
recunoscutelor	None
implicase	Indicative
descărcaseră	Indicative
alt	None
spori	Indicative
familiile	None
erele	None
serbăm	Indicative
este	Indicative
prezenta	None
grotei	None
curcubeului	None
răsturna	Indicative
spera	Indicative
desfăcea	Indicative
crucificaseși	Indicative
legendarul	None
pictatul	None
astâmpăr	Indicative
însuflețea	Indicative
brunii	None
desculț	Indicative
stingheri	Indicative
forjez	Indicative
dospim	Indicative
tâmpirăți	Indicative
prânzești	Indicative
întorseseră	Indicative
observasem	Indicative
îndrăznești	Indicative
îmbunătățiserăți	Indicative
contravine	Indicative
secretariatul	None
deschiseserăți	Indicative
rămaseră	Indicative
româncele	None
înfuriaserăți	Indicative
ironia	None
pederastice	None
întorsei	Indicative
rătăceau	Indicative
petrecând	None
întortocheasem	Indicative
юбинд	None
nurcile	None
histologice	None
înnozi	Indicative
cenușa	None
sărbătorirăm	Indicative
prescrisei	Indicative
satirele	None
deștepți	Indicative
maltratarăți	Indicative
preistorică	None
muntos	None
căcă	Indicative
hrăni	Indicative
domnului	None
împaci	Indicative
jinduirăți	Indicative
prăji	Indicative
jucând	None
bisexualitatea	None
arserăm	Indicative
amărât	None
sfâșiase	Indicative
fripseră	Indicative
tranzitivul	None
documenta	Indicative
întărirăm	Indicative
dalta	None
râvnea	Indicative
apropiind	None
curse	Indicative
conjuncțiilor	None
destramăm	Indicative
ușuratic	None
cicloida	None
abdicaseși	Indicative
înfoie	Indicative
întâmplase	Indicative
plimb	Indicative
respirau	Indicative
amorțind	None
oprea	Indicative
descurcasem	Indicative
iubiserăm	Indicative
stepă	None
becurile	None
prepoziției	None
țipaserăți	Indicative
fereau	Indicative
anim	Indicative
arăt	Indicative
sărit	None
arhicunoscut	None
curățăm	Indicative
avalanșa	None
sfârticarăm	Indicative
furaseră	Indicative
bălăiau	Indicative
scremu	Indicative
uimiseră	Indicative
foamete	None
înfuleci	Indicative
veșnicii	None
arhipelagul	None
lărgiși	Indicative
îndemnasem	Indicative
nutreai	Indicative
omletelor	None
observant	None
pasteurizase	Indicative
scoteau	Indicative
necăjeați	Indicative
lungeați	Indicative
muierea	None
vătămarăți	Indicative
prășeați	Indicative
despăduchease	Indicative
priveghea	Indicative
constătură	Indicative
înalți	Indicative
dezmințeai	Indicative
întrerupsese	Indicative
picarăm	Indicative
gândului	None
amuțiși	Indicative
seduci	Indicative
bem	Indicative
înlocuim	Indicative
croiseși	Indicative
ademeniserăm	Indicative
veștejit	None
zărit	None
vizitau	Indicative
arterelor	None
iobagilor	None
onora	Indicative
frică	None
abdici	Indicative
negăm	Indicative
benzinăriile	None
pictând	None
grăbeau	Indicative
antropologiei	None
sfințeau	Indicative
dezgusta	Indicative
împereche	Indicative
peticeați	Indicative
activiștii	None
astronomie	None
ieșirăm	Indicative
sărbătorind	None
cenușile	None
rostiseră	Indicative
socotea	Indicative
vânturaseră	Indicative
îmbărbătă	Indicative
bacteriei	None
vărsarăți	Indicative
contraziseră	Indicative
angajaseră	Indicative
sinuciseși	Indicative
atac	Indicative
certau	Indicative
lucios	None
giaca	None
uiți	Indicative
picat	None
atrofie	None
întinzi	Indicative
supraviețuiserăm	Indicative
fiertei	None
păturile	None
îmbătrânise	Indicative
cuști	Indicative
răsăritului	None
bătea	Indicative
asculta	Indicative
îndurăm	Indicative
canoniserăm	Indicative
ud	Indicative
căzusem	Indicative
imagina	Indicative
imaginarăm	Indicative
albaneza	None
varicela	None
smulserăți	Indicative
moștenind	None
merse	Indicative
ocrotind	None
orzului	None
circul	Indicative
învingem	Indicative
fotoliului	None
extindem	Indicative
vârtoasele	None
automobilelor	None
declin	Indicative
rostogolea	Indicative
râm	Indicative
fericiseși	Indicative
așezasem	Indicative
încărcaseși	Indicative
puparăți	Indicative
macacule	None
motanii	None
odihnim	Indicative
pornii	Indicative
stinsese	Indicative
consoanelor	None
citise	Indicative
aprinseră	Indicative
celebrau	Indicative
întrețineau	Indicative
mirară	Indicative
petreci	Indicative
capeți	Indicative
nivelaseră	Indicative
garajele	None
mijlocim	Indicative
subscriserăm	Indicative
apusesem	Indicative
vomu	Indicative
învingea	Indicative
taurului	None
ciugulea	Indicative
ațipise	Indicative
comandaseră	Indicative
folosiși	Indicative
apărea	Indicative
donațiile	None
sarcasticul	None
mâneci	Indicative
interveneau	Indicative
îngereștilor	None
dezmântasem	Indicative
încurci	Indicative
păcălirăți	Indicative
deprindeau	Indicative
exterioară	None
refuza	Indicative
întâmpina	Indicative
abilitate	None
urdin	Indicative
peticiși	Indicative
neutru	None
tincturase	Indicative
acumulase	Indicative
publicitate	None
înghițiseră	Indicative
îndrăgostise	Indicative
sun	Indicative
știați	Indicative
goli	Indicative
dumnezeule	None
porniră	Indicative
muriși	Indicative
excavezi	Indicative
copiat	None
olivele	None
bucurau	Indicative
strigi	Indicative
dovedim	Indicative
citisem	Indicative
interesau	Indicative
mână	None
păzeai	Indicative
sănătoasa	None
împărțiserăm	Indicative
excavară	Indicative
sfârșise	Indicative
desculți	Indicative
înjunghiaseră	Indicative
prezisese	Indicative
știau	Indicative
vrăjirăm	Indicative
proteja	Indicative
întărâtaseră	Indicative
negustorii	None
apucau	Indicative
foamei	None
gorunul	None
cucereați	Indicative
întâlneați	Indicative
pluti	Indicative
umpleau	Indicative
leșinăm	Indicative
coborâși	Indicative
păcătui	Indicative
încrucișau	Indicative
șesului	None
oacheșă	None
capsula	Indicative
furnica	Indicative
școlar	None
rusescul	None
construiră	Indicative
așteptărilor	None
răcniși	Indicative
discreției	None
frecând	None
picătură	None
câmpurile	None
înveți	Indicative
bara	Indicative
scurmaseși	Indicative
împroprietării	Indicative
împușcaseși	Indicative
invizibila	None
cunoscu	Indicative
spațiilor	None
monocromelor	None
alungase	Indicative
extinse	Indicative
holbă	Indicative
lăudăm	Indicative
decapitez	Indicative
înălțau	Indicative
opreau	Indicative
buciumi	Indicative
mulțumim	Indicative
vlăguia	Indicative
limba	None
orbilor	None
întorcea	Indicative
făgădui	Indicative
stabileau	Indicative
murdăreau	Indicative
mărinimoșilor	None
deșiderară	Indicative
așezăm	Indicative
scriați	Indicative
ofensatoare	None
mureau	Indicative
masculule	None
sumeseră	Indicative
străbătusem	Indicative
îngânași	Indicative
purceseserăți	Indicative
argintiu	None
veacurilor	None
descoperirăți	Indicative
viețuia	Indicative
pricepi	Indicative
seduseră	Indicative
poruncești	Indicative
controlaserăți	Indicative
înghițeau	Indicative
vapoarelor	None
împungeai	Indicative
viorelei	None
căpătau	Indicative
sinagogile	None
lanurilor	None
adus	None
lărgi	Indicative
îngrijea	Indicative
erotice	None
jucaseră	Indicative
culesesem	Indicative
tărăgănase	Indicative
anulase	Indicative
certase	Indicative
roșea	Indicative
sfințești	Indicative
modificaseși	Indicative
legăm	Indicative
rotiși	Indicative
custa	Indicative
punctau	Indicative
răszice	Indicative
șelarii	None
tăia	Indicative
argintiii	None
servirăți	Indicative
numărase	Indicative
forțaseși	Indicative
fugea	Indicative
explicăm	Indicative
băteau	Indicative
dramaticului	None
bărbierului	None
inviți	Indicative
îngălbeniră	Indicative
înghesuirăți	Indicative
pap	Indicative
nepopularul	None
binecuvânta	Indicative
modificasem	Indicative
sângerarăți	Indicative
apocalipsului	None
șușuiați	Indicative
fragedului	None
împunseserăm	Indicative
retragi	Indicative
ușurez	Indicative
fluieri	Indicative
bunicii	None
ponegriră	Indicative
vărgata	None
halii	Indicative
hrănit	None
arhipelagule	None
mistreții	None
șovăiserăți	Indicative
religios	None
credeați	Indicative
stânjeni	Indicative
răcorești	Indicative
înghețaseră	Indicative
prindeau	Indicative
cugeta	Indicative
pătimirăm	Indicative
fermierul	None
baltică	None
chemă	Indicative
cuprinserăți	Indicative
încurajez	Indicative
cărnos	None
rulăm	Indicative
mijlociserăm	Indicative
binefăcători	None
fosta	None
sfârșit	None
descrii	Indicative
fuse	Indicative
ciocni	Indicative
jurând	None
strângea	Indicative
traduserăm	Indicative
greșind	None
măsuraserăți	Indicative
îmbunătățind	None
orbii	Indicative
intempestivilor	None
mișcăm	Indicative
urați	Indicative
delogarăm	Indicative
scânteie	Indicative
înfunda	Indicative
dăpărase	Indicative
malurilor	None
ultimi	None
îngrași	Indicative
aducând	None
cingeați	Indicative
cocorul	None
arterei	None
holbau	Indicative
sfârticaserăm	Indicative
crapul	None
negau	Indicative
subțiaseră	Indicative
finlandezul	None
satisfacem	Indicative
blocaserăm	Indicative
scormonești	Indicative
rozătoarelor	None
îngropase	Indicative
ispita	None
orchestrei	None
omniscientă	None
colectivitatea	None
rostului	None
simboliza	Indicative
schimbaseși	Indicative
sminti	Indicative
fusesem	Indicative
lovim	Indicative
crescu	Indicative
ambianței	None
grăbim	Indicative
cumpăraseră	Indicative
porți	Indicative
păstrăm	Indicative
scoapsese	Indicative
interzi	Imperative-Jussive
lucrăm	Indicative
admirăm	Indicative
sexualelor	None
amica	None
ciugulești	Indicative
susur	Indicative
îngrijora	Indicative
fracturară	Indicative
înfiripaă	Indicative
propunea	Indicative
descălța	Indicative
depăraseși	Indicative
depăraserăți	Indicative
alcătuiseră	Indicative
gătise	Indicative
scurtase	Indicative
fermierilor	None
prelungeau	Indicative
omogeni	None
prânzim	Indicative
intui	Indicative
înscriserăm	Indicative
mândrie	None
încrezusem	Indicative
ușurarăți	Indicative
astupi	Indicative
decapita	Indicative
păcătuiați	Indicative
amețeai	Indicative
împiedic	Indicative
temperaturii	None
preveni	Indicative
studiem	Indicative
ușurau	Indicative
ejaculau	Indicative
scobirăți	Indicative
glumind	None
zbârcea	Indicative
utiliza	Indicative
bulbuc	Indicative
risipi	Indicative
schimbau	Indicative
castorilor	None
eronată	None
defăimăm	Indicative
șansă	None
delirante	None
valsau	Indicative
bazăm	Indicative
marină	None
aduna	Indicative
răstigni	Indicative
mințit	None
prazi	Indicative
ocrotiseră	Indicative
adormiși	Indicative
acopereau	Indicative
descrește	Indicative
bag	Indicative
roși	Indicative
astmă	None
ferici	Indicative
logaserăm	Indicative
drăgălaș	None
trăsnirăm	Indicative
acumula	Indicative
amorțiseră	Indicative
voce	None
auzind	None
legănasem	Indicative
gratitudinii	None
trimiseseși	Indicative
înconjura	Indicative
dușmănirăți	Indicative
afundarăm	Indicative
insult	Indicative
șerbești	Indicative
transformăm	Indicative
servești	Indicative
rescriseseră	Indicative
excelaseși	Indicative
rupem	Indicative
cumpăniseși	Indicative
stimă	Indicative
înjosiseră	Indicative
trădaseră	Indicative
aplica	Indicative
colonialismului	None
morțile	None
trimiteau	Indicative
apare	Indicative
alegem	Indicative
servea	Indicative
vineți	None
surde	None
artisticului	None
obținusem	Indicative
spânzura	Indicative
migdalei	None
cântărise	Indicative
dispunea	Indicative
reprezentanților	None
mustrași	Indicative
cumpărăm	Indicative
îmbrăcaserăm	Indicative
gazăm	Indicative
îngânară	Indicative
magistrul	None
sughițaserăm	Indicative
distingem	Indicative
funcționaseră	Indicative
ierți	Indicative
cutreieraserăți	Indicative
deplasaseră	Indicative
renovau	Indicative
salamandrele	None
depuneau	Indicative
mânecaserăm	Indicative
poltroneriilor	None
clădeai	Indicative
reușeai	Indicative
pluteai	Indicative
obezele	None
prășit	None
îngălbenești	Indicative
ațâțăm	Indicative
memorie	None
veniseră	Indicative
vioiciunea	None
trompetelor	None
trăim	Indicative
înnorarăm	Indicative
arcadelor	None
înfățișă	Indicative
alunecase	Indicative
introduse	Indicative
clarific	Indicative
documentaseră	Indicative
dublară	Indicative
orienta	Indicative
experimentatei	None
cuvenim	Indicative
ososului	None
ascultau	Indicative
dezlegași	Indicative
îmbunătățești	Indicative
obligăm	Indicative
valsasem	Indicative
întărât	Indicative
celebrat	None
strâmtaseși	Indicative
intri	Indicative
ruină	Indicative
ascunsese	Indicative
forțezi	Indicative
ruta	None
urcară	Indicative
psihologiei	None
numiși	Indicative
cămășile	None
merindei	None
ruptură	None
catârii	None
înfășuraseră	Indicative
probaserăm	Indicative
acordurilor	None
ocupăm	Indicative
cântărea	Indicative
cereau	Indicative
înveninaserăm	Indicative
plăcută	None
bungetului	None
tentă	Indicative
distraseră	Indicative
emoționali	None
șaua	None
anonima	None
întristași	Indicative
cumineca	Indicative
uniformitatea	None
pingelea	Indicative
vitamină	None
nimici	Indicative
întinarăm	Indicative
subțiau	Indicative
șovăiseră	Indicative
eliminaseră	Indicative
fracturarăți	Indicative
șerbirăți	Indicative
răspândiserăm	Indicative
apropiase	Indicative
construiseră	Indicative
zăpăciserăm	Indicative
beregata	None
vindecaseși	Indicative
numelui	None
uzilor	None
închinară	Indicative
vorbi	Indicative
borâseră	Indicative
prețuiau	Indicative
înfrățim	Indicative
înfruntau	Indicative
întemeiaseră	Indicative
dezamăgiserăți	Indicative
corupsei	Indicative
coteau	Indicative
desfășurau	Indicative
zăcămintele	None
întors	None
tindeau	Indicative
bucătăria	None
spuse	Indicative
stinse	Indicative
sexuali	None
pripi	Indicative
spânzuraseși	Indicative
hămesiși	Indicative
închipui	Indicative
invincibilei	None
nații	None
scursesem	Indicative
prescurtarea	None
încurcară	Indicative
disprețul	None
pierdură	Indicative
vânăm	Indicative
clarifica	Indicative
oprii	Indicative
nominativului	None
bisexualilor	None
combin	Indicative
pripirăți	Indicative
înmânasem	Indicative
dezvoltată	None
inundasem	Indicative
locuiseră	Indicative
pușcăria	None
utilizaseră	Indicative
secrete	None
betonului	None
desfirase	Indicative
contravenea	Indicative
belea	Indicative
ionosfera	None
rusă	None
negase	Indicative
tavanului	None
jucăriei	None
dispărând	None
înfăptuii	Indicative
știa	Indicative
gravitași	Indicative
discutăm	Indicative
încercuiși	Indicative
căsătoriși	Indicative
socotești	Indicative
căscaseși	Indicative
aurești	Indicative
căzu	Indicative
adăpostiți	None
atentă	None
profund	None
mulseserăți	Indicative
trăsăturilor	None
tăiaseși	Indicative
seninătate	None
indisponibila	None
conții	Indicative
nădăjduiai	Indicative
ruinez	Indicative
futusem	Indicative
atârnau	Indicative
cumpătezi	Indicative
înseraserăm	Indicative
cumpăneau	Indicative
riscau	Indicative
despuie	Indicative
toca	Indicative
traversa	Indicative
adăuga	Indicative
adeverea	Indicative
porneau	Indicative
ponegrind	None
craniile	None
înțepaserăm	Indicative
carboxilici	None
ușurăm	Indicative
dorim	Indicative
jura	Indicative
sărbătoriserăm	Indicative
scâncii	Indicative
țipară	Indicative
fotoliul	None
onorat	None
dispăruși	Indicative
influențarăți	Indicative
inima	None
ușura	Indicative
ofili	Indicative
supravegheași	Indicative
buciumași	Indicative
drăguți	None
ideea	None
scremut	None
asprimii	None
obișnuiau	Indicative
puncta	Indicative
răgușeați	Indicative
vădind	None
înfloriră	Indicative
plictisirăți	Indicative
înfățișezi	Indicative
lipsiserăm	Indicative
mijlocise	Indicative
excursiilor	None
diurnului	None
împăturiserăți	Indicative
înmânarăm	Indicative
răsuflarăm	Indicative
adăstaseră	Indicative
cartele	None
pietroasele	None
linse	Indicative
mușca	Indicative
amanetarăm	Indicative
holbezi	Indicative
bârfiră	Indicative
resturile	None
băgau	Indicative
dobândi	Indicative
înnorat	None
porunci	Indicative
prevesti	Indicative
grăirăm	Indicative
evreiești	None
închisese	Indicative
girafă	None
scumpelor	None
băilor	None
judecate	None
ierta	Indicative
urechea	None
măsurăm	Indicative
echilibrarăm	Indicative
uscăciune	None
stăpâneau	Indicative
îngrijorez	Indicative
tentante	None
dizolvat	None
belisem	Indicative
fixase	Indicative
vitregi	None
ruginii	Indicative
aplicaserăm	Indicative
îndesarăți	Indicative
corasle	None
păzea	Indicative
ciugulirăm	Indicative
ardeiului	None
câștigi	Indicative
napului	None
mut	Indicative
întunecaseră	Indicative
întemeia	Indicative
afurisirăm	Indicative
insulta	Indicative
distilă	Indicative
agățau	Indicative
rupseseră	Indicative
arbaletă	None
conținea	Indicative
obișnuind	None
diminuau	Indicative
risipise	Indicative
ascuțiserăți	Indicative
tulburi	Indicative
spânzurase	Indicative
hazliii	None
juri	Indicative
asemănau	Indicative
conveniserăm	Indicative
plată	None
vândut	None
integrabilului	None
bulbucaserăm	Indicative
purtase	Indicative
începusem	Indicative
independențe	None
curgea	Indicative
păianjenului	None
tufișurilor	None
teism	None
apropiaseră	Indicative
puțina	None
lanțul	None
completăm	Indicative
întărâtasem	Indicative
însori	Indicative
surprinseseși	Indicative
maltrata	Indicative
îngâmfasem	Indicative
înflorirăți	Indicative
orbirăți	Indicative
pețit	None
împrumuți	Indicative
corupseră	Indicative
amicul	None
tentat	None
nivelaserăți	Indicative
gazau	Indicative
dezmierdaseși	Indicative
sărbătorii	Indicative
trăiești	Indicative
sfătuisem	Indicative
țânțarilor	None
ferea	Indicative
rezistibili	None
încărisem	Indicative
lungim	Indicative
coborâseși	Indicative
microbiologică	None
lăuda	Indicative
ghețarii	None
bazară	Indicative
chițăisem	Indicative
inducând	None
scrise	Indicative
spart	None
repauzară	Indicative
uscat	None
valah	None
cronicii	None
logodeați	Indicative
povârnești	Indicative
soma	Indicative
aruncăm	Indicative
refuzasem	Indicative
fusul	None
probă	Indicative
încheiau	Indicative
treptele	None
găti	Indicative
stimulau	Indicative
treziră	Indicative
eliminase	Indicative
încetarăm	Indicative
târziul	None
faptelor	None
adaug	Indicative
trandafirilor	None
îndepărtezi	Indicative
delimitase	Indicative
dezmierdasem	Indicative
lipsea	Indicative
amuz	Indicative
furculiță	None
mânerele	None
împlini	Indicative
urmașilor	None
aplicase	Indicative
morcovii	None
dezamăgirăm	Indicative
utilă	None
găsi	Indicative
tocau	Indicative
luminoși	None
veneau	Indicative
găsiseși	Indicative
satura	Indicative
încarc	Indicative
aduseserăți	Indicative
spusesem	Indicative
bulevardelor	None
ceții	None
frământase	Indicative
personajelor	None
somnoroase	None
dezmierdară	Indicative
înlocuiseră	Indicative
orientăm	Indicative
vizitase	Indicative
constând	None
aștept	Indicative
aplaudase	Indicative
evangheliei	None
curma	Indicative
observaseră	Indicative
puteați	Indicative
probarăm	Indicative
cumplise	Indicative
cumpărau	Indicative
prăda	Indicative
obligaseră	Indicative
aiurară	Indicative
ar	Indicative
persoanei	None
malul	None
vizitară	Indicative
sinuciseserăm	Indicative
înlocuiserăți	Indicative
produserăm	Indicative
amurgul	None
cinsteau	Indicative
auziseră	Indicative
bucuri	Indicative
murii	Indicative
mușcarăm	Indicative
străbătuserăți	Indicative
vaccinaseră	Indicative
ovăzului	None
persevera	Indicative
crezu	Indicative
vampirii	None
însetezaseși	Indicative
citiseră	Indicative
săgetarăți	Indicative
necontestatului	None
deșider	Indicative
aerisi	Indicative
platformele	None
iubit	None
ceainicului	None
bocea	Indicative
înfășaseși	Indicative
începuserăți	Indicative
urcăm	Indicative
împingeau	Indicative
însuflețirea	None
existară	Indicative
desfătă	Indicative
strâmtase	Indicative
spumegau	Indicative
alivancă	None
româna	None
dezamăgite	None
găuriserăți	Indicative
intrăm	Indicative
spărgea	Indicative
zăcământului	None
săpăm	Indicative
induceau	Indicative
susții	Indicative
frustrările	None
împrumutasem	Indicative
adeverit	None
belirăm	Indicative
ciuguliserăți	Indicative
sluji	Indicative
dinamică	None
tincturaserăți	Indicative
torceau	Indicative
atacau	Indicative
lingura	None
scărpinasem	Indicative
comportaserăți	Indicative
umerașul	None
înnoiserăm	Indicative
bulbucaseși	Indicative
năpârcă	None
înghesuiai	Indicative
adăugaseră	Indicative
vădos	None
trasei	Indicative
dedăm	Indicative
vorbisem	Indicative
graniță	None
facilitățile	None
traducem	Indicative
încadrau	Indicative
alinta	Indicative
căutare	None
cântaserăți	Indicative
păcurarului	None
ridici	Indicative
socotim	Indicative
cârnatui	None
influențaseși	Indicative
ferești	Indicative
tremurau	Indicative
ferestruiau	Indicative
întâmpinasem	Indicative
îmbărbăta	Indicative
murară	Indicative
apropierea	None
urmărirea	None
drăgălașa	None
articulară	Indicative
fierbem	Indicative
capitalista	None
mărunți	Indicative
mâncărime	None
haleau	Indicative
isprăviră	Indicative
fundă	Indicative
opri	Indicative
picturile	None
construiau	Indicative
ceparilor	None
cercetez	Indicative
răposași	Indicative
psihozelor	None
sfătuirăm	Indicative
înjuraserăm	Indicative
turnau	Indicative
morsei	None
înfigea	Indicative
nenorocea	Indicative
haleați	Indicative
așezau	Indicative
pitoresc	None
vitrinele	None
neteziși	Indicative
anulăm	Indicative
lotusule	None
cerșim	Indicative
asiguri	Indicative
petrecură	Indicative
născuseră	Indicative
putuse	Indicative
ciocârlia	None
enormei	None
huliți	None
nurorilor	None
denaturaserăți	Indicative
plăcuși	Indicative
fotoliilor	None
tăbăcisem	Indicative
experimentate	None
lungi	Indicative
parcă	Indicative
transcriseseră	Indicative
descântaserăți	Indicative
sfătuise	Indicative
îndurase	Indicative
implicași	Indicative
parca	Indicative
termometrului	None
serelor	None
transformaseră	Indicative
încheiarăți	Indicative
slugărind	None
utilizaserăm	Indicative
leșin	Indicative
adulmecasem	Indicative
asiguraseră	Indicative
lucești	Indicative
înseninași	Indicative
limpezeai	Indicative
circumscriem	Indicative
salinizasem	Indicative
excavau	Indicative
săptămânalul	None
paritate	None
așternuse	Indicative
tiviră	Indicative
granițele	None
pripiseși	Indicative
imaginară	Indicative
fraternității	None
aduse	Indicative
alb	None
scurmi	Indicative
capitulez	Indicative
înverzești	Indicative
meritase	Indicative
încărunțeau	Indicative
acrimii	None
câștigase	Indicative
sorbirăți	Indicative
nisipurile	None
cufundaserăm	Indicative
îngrijise	Indicative
murasem	Indicative
utilizară	Indicative
aurea	Indicative
mâhneai	Indicative
bârfiseși	Indicative
creștină	None
actrița	None
traversaseră	Indicative
măsori	Indicative
curăț	Indicative
băgaseși	Indicative
robea	Indicative
iubiși	Indicative
tânjeau	Indicative
conținuseși	Indicative
brava	None
dezvolt	Indicative
dispui	Indicative
domnilor	None
fixăm	Indicative
întrevăzusem	Indicative
sughiț	Indicative
citiserăți	Indicative
mulseră	Indicative
arsese	Indicative
încălțară	Indicative
împăunăm	Indicative
plantau	Indicative
dezamăgirăți	Indicative
librarului	None
compuneau	Indicative
risipea	Indicative
sfătuiau	Indicative
documentară	Indicative
luminos	None
apocalipsul	None
respira	Indicative
desprinseseși	Indicative
apuseserăm	Indicative
magistrului	None
adunasem	Indicative
transatlantică	None
mâhnit	None
interzicea	Indicative
alcătuiserăți	Indicative
ulmii	None
pasezi	Indicative
preferaseră	Indicative
căpătând	None
definiției	None
irita	Indicative
marinului	None
sângerosul	None
străzilor	None
rulară	Indicative
înzestrând	None
întinăm	Indicative
protejarăți	Indicative
ungeați	Indicative
încercuiești	Indicative
prelungiseră	Indicative
răzbuna	Indicative
vitezele	None
întrevăzuși	Indicative
interesaserăm	Indicative
surului	None
apăsă	Indicative
lansase	Indicative
clădirii	None
autorităților	None
zdrobeai	Indicative
copleși	Indicative
țigară	None
culeseși	Indicative
păstrăvii	None
fugii	Indicative
minuscule	None
treburile	None
numi	Indicative
analelor	None
chimic	None
moșteni	Indicative
învioraseși	Indicative
înmărmurirăți	Indicative
elementari	None
păru	Indicative
bisericile	None
haiducul	None
împerecheaserăți	Indicative
sfânta	None
îngreunasem	Indicative
binefăcătorul	None
obligat	None
iubise	Indicative
arsului	None
urechii	None
îmbucăm	Indicative
zgâiseși	Indicative
depuseseră	Indicative
diminuarăți	Indicative
scăpase	Indicative
urbanizarea	None
poștale	None
dezghețarăm	Indicative
pragul	None
spuma	Indicative
inarule	None
adiași	Indicative
intenționăm	Indicative
instabilității	None
muta	Indicative
aținusem	Indicative
inelarule	None
încăpățânatei	None
adora	Indicative
secvențial	None
cânt	Indicative
semnă	Indicative
mulțumiserăm	Indicative
distrat	None
sinonimelor	None
admiri	Indicative
lămuri	Indicative
absorbite	None
delimitat	None
desfășuraseși	Indicative
mașinile	None
întărâtară	Indicative
curățaserăți	Indicative
jachetele	None
supuneau	Indicative
decădere	None
făurești	Indicative
tranziționalilor	None
adâncise	Indicative
vizualizași	Indicative
prescriseseși	Indicative
mulțumind	None
mistreți	None
veneai	Indicative
țeseai	Indicative
întâmplau	Indicative
rescris	None
răzlețeau	Indicative
încurcaserăți	Indicative
împăturirăm	Indicative
împunseră	Indicative
ghicii	Indicative
țiterei	None
ciopliseră	Indicative
iarba	None
răzgândise	Indicative
vânau	Indicative
fluturaseși	Indicative
olivelor	None
împerecheaserăm	Indicative
macedonenilor	None
întrerupeai	Indicative
slăviseră	Indicative
ridicaseră	Indicative
încetaseră	Indicative
înscrise	Indicative
epuizat	None
compari	Indicative
ghidau	Indicative
pașcă	None
mândrea	Indicative
scumpeau	Indicative
legi	Indicative
destup	Indicative
produci	Indicative
judecătorul	None
ospăta	Indicative
supraviețuit	None
cioplise	Indicative
astruc	Indicative
ferecaseră	Indicative
sfâșiem	Indicative
sugrumaseși	Indicative
răcorim	Indicative
cercurile	None
venerau	Indicative
fluierat	None
principalelor	None
proverbelor	None
dispărea	Indicative
uciseseră	Indicative
trântești	Indicative
blestemi	Indicative
împerecheasem	Indicative
râurilor	None
răcoarea	None
atingeau	Indicative
completezi	Indicative
tranzițională	None
odihnise	Indicative
influență	Indicative
urai	Indicative
nădăjduia	Indicative
bivolului	None
datora	Indicative
amestecau	Indicative
lărgiră	Indicative
târguii	Indicative
distingea	Indicative
amuzau	Indicative
văzură	Indicative
cuveni	Indicative
elimin	Indicative
pișatul	None
împăna	Indicative
găureai	Indicative
răsturnaseși	Indicative
vânaserăm	Indicative
dinamica	None
ațipi	Indicative
certi	Indicative
decisese	Indicative
traduseseră	Indicative
ruga	Indicative
imaginarăți	Indicative
deveniră	Indicative
jalnic	None
răzbun	Indicative
muiarăm	Indicative
carnivor	None
îngâmfa	Indicative
înseraserăți	Indicative
ospătezi	Indicative
îndeletniciră	Indicative
expediau	Indicative
gusta	Indicative
logodise	Indicative
răbojirăți	Indicative
prescrise	Indicative
pasă	Indicative
îmbuibaseră	Indicative
cuteza	Indicative
jupuii	Indicative
ardeiul	None
iritaseși	Indicative
duioși	None
rinichii	None
vădeai	Indicative
rescrii	Indicative
întreprins	None
învățau	Indicative
avortaseși	Indicative
fugiseră	Indicative
trandafirii	None
