chorobowa	Feminine
dokonam	None
zniszczyłybyście	None
prosiakiem	None
znośna	Feminine
drukowałem	Masculine
kalce	None
nocni	Masculine
pazurami	None
jedwabna	Feminine
dodałybyśmy	None
przemyślałam	Feminine
stoczniom	None
zaimka	None
ulewach	None
wymagali	Masculine
grób	None
rozwiązałem	Masculine
latałem	Masculine
smoczych	Masculine
ligustr	None
wierzchowce	None
dramatów	None
ściągałeś	Masculine
kradziony	Masculine
śledziowych	Masculine
podani	Masculine
gliście	None
rzeczy	None
suszeni	Masculine
bluzę	None
całowała	Feminine
przyjęłaby	Feminine
zadane	Neuter
starcza	Feminine
znajdowała	Feminine
zgubiłeś	Masculine
lapońskich	Masculine
niektórzy	Masculine
obrażona	Feminine
nieodpowiedzialna	Feminine
skorupę	None
ziębnąłbym	Masculine
najdelikatniejsi	Masculine
szukał	Masculine
zamówilibyście	Masculine
ziewałby	Masculine
księgowy	None
eksportowane	Neuter
kuśnierzy	None
odchodzili	Masculine
kanadyjskimi	None
bezpieczeństwa	None
wyżłom	None
zapalona	Feminine
wymogłaby	Feminine
mijali	Masculine
awersem	None
samsaro	None
języka	None
rozkładowi	None
sajgonem	None
jednogłośna	Feminine
tradycyjna	Feminine
australijscy	Masculine
watykańskich	Masculine
Bułgarze	None
magiczna	Feminine
księgowym	None
pozostające	Neuter
koloniom	None
organizowali	Masculine
jawna	Feminine
wyłeś	Masculine
podróżujące	Neuter
adaptera	None
bałkańscy	Masculine
pszennych	Masculine
proponujące	Neuter
drukowanych	Masculine
bander	None
ekonomicznych	Masculine
metamorficzna	Feminine
Południowoafrykańczyk	None
kupowane	Neuter
rzepakowi	None
wybrała	Feminine
surducie	None
bębniąca	Feminine
kierująca	Feminine
zbierało	Neuter
pogrzebany	Masculine
pobierz	None
zostawiłabym	Feminine
skandaliczna	Feminine
hongkońska	Feminine
psychologiczna	Feminine
dodzwoniłaś	Feminine
pasjansami	None
pijali	Masculine
upału	None
przypuściła	Feminine
historyczna	Feminine
nawyku	None
hipokryzjami	None
filmoteką	None
dziobałbym	Masculine
traktowani	Masculine
szczerych	Masculine
westernach	None
nośnikiem	None
polecane	Neuter
śpiewała	Feminine
podejrzewali	Masculine
mężczyzno	None
krachami	None
siadał	Masculine
ocaleni	Masculine
tautologiczni	Masculine
diagramów	None
aferach	None
pusta	Feminine
sutenerem	None
tańczyła	Feminine
szwedzcy	Masculine
poróżnili	Masculine
dokumenty	None
wieloznacznych	Masculine
zakładnikach	None
nimfę	None
królikarni	None
tenisistach	None
produkować	None
statysto	None
wyznaczony	Masculine
trzymaliśmy	Masculine
krzyżówko	None
czcionka	None
używany	Masculine
pnij	None
nagonką	None
sprawiał	Masculine
przeprosiłbyś	Masculine
muzyku	None
zasłużył	Masculine
wirus	None
obrazie	None
odkryli	Masculine
wymiarowych	Masculine
widziana	Feminine
szybcy	Masculine
sygnał	None
trzebiłby	Masculine
pogrzebałem	Masculine
pożycz	None
zaproszenie	None
sprzyjająca	Feminine
ściągają	None
sąd	None
urzędasy	None
lecząca	Feminine
dwukierunkowych	Masculine
pobożni	Masculine
posiadające	Neuter
rozróżniam	None
produktu	None
powtarzało	Neuter
spięciom	None
administracje	None
dała	Feminine
szybszych	Masculine
otrzymany	Masculine
czyniłem	Masculine
ćwiczyli	Masculine
usuwałem	Masculine
krymskotatarska	Feminine
odkrywalibyście	Masculine
agorze	None
urugwajscy	Masculine
znaleźli	Masculine
mieszkaliśmy	Masculine
żeglarka	None
pokazywane	Neuter
łatwych	Masculine
karciana	Feminine
metodystyczna	Feminine
mordowało	Neuter
rzekłbym	Masculine
przyjaznych	Masculine
płacony	Masculine
fotograficzna	Feminine
tensorowa	Feminine
strzelec	None
strzelało	Neuter
polowałbyś	Masculine
poprosiłeś	Masculine
przygotowałybyście	None
rzucił	Masculine
ukradłaby	Feminine
oceniony	Masculine
kontrolujące	Neuter
jąkał	Masculine
obserwująca	Feminine
trwałby	Masculine
sklejką	None
gorsi	Masculine
halibutom	None
odpowiedniejsza	Feminine
amerykańska	Feminine
obiecana	Feminine
temperaturze	None
bohrze	None
charkając	None
sprawdziłem	Masculine
sprawdzili	Masculine
zależna	Feminine
trwaliście	Masculine
pilnych	Masculine
gwałcą	None
podróżowali	Masculine
odbijają	None
spokojnych	Masculine
wywołaliście	Masculine
poprawione	Neuter
pocieszył	Masculine
filmowane	Neuter
wyborcza	Feminine
najrzadsza	Feminine
kruchsi	Masculine
umierające	Neuter
wyłączające	Neuter
machane	Neuter
rasistowskich	Masculine
krowa	None
sunęłabyś	Feminine
hokeistą	None
domowi	Masculine
kochałbyś	Masculine
pijawki	None
usuwała	Feminine
macedońscy	Masculine
ogierem	None
ludowi	Masculine
śledziowi	Masculine
tworzyłem	Masculine
zastanawiali	Masculine
ostryg	None
ciemni	Masculine
najłatwiejsza	Feminine
wartych	Masculine
złożyłem	Masculine
słyszeliście	Masculine
marli	Masculine
wynajęła	Feminine
przegrali	Masculine
towarzyska	Feminine
żywotna	Feminine
automatyczna	Feminine
gęści	Masculine
wieśniaka	None
sprawdzona	Feminine
burz	None
pamiętające	Neuter
żartowali	Masculine
poważniejszych	Masculine
izbom	None
złupiło	Neuter
wysiadłoby	Neuter
ćwierćnutami	None
małpia	Feminine
pożarta	Feminine
wodnymi	None
tęskniąca	Feminine
piszące	Neuter
anarchistyczna	Feminine
bytowa	Feminine
zapłacony	Masculine
uderzałoby	Neuter
kserowałaś	Feminine
płciowych	Masculine
poziomic	None
słyszana	Feminine
niedoszła	Feminine
zamówili	Masculine
najczytelniejszych	Masculine
najświeższa	Feminine
telefonował	Masculine
biograficzna	Feminine
kozich	Masculine
niejasna	Feminine
jasnobrązowymi	None
rtęciowych	Masculine
zacząłby	Masculine
zapomniałbym	Masculine
asteroidą	None
swobodnych	Masculine
uważnych	Masculine
poprawiała	Feminine
gwizdalibyśmy	Masculine
egranizacjach	None
bedni	None
złapany	Masculine
zaiwań	None
antyczni	Masculine
dwujęzyczność	None
pytała	Feminine
dusząca	Feminine
wspominana	Feminine
najdoskonalsza	Feminine
kolegę	None
wiarygodnością	None
ariańscy	Masculine
jąłbym	Masculine
górscy	Masculine
grzmiałbym	Masculine
przytulna	Feminine
kantami	None
drogich	Masculine
brytyjscy	Masculine
pośladkach	None
unieważnienie	None
atakowało	Neuter
uciekali	Masculine
śpiączką	None
napad	None
tektonicznych	Masculine
korabie	None
rączkę	None
najśliczniejsi	Masculine
brazylijskimi	None
mieszane	Neuter
unikało	Neuter
złośliwi	Masculine
pokazywalibyście	Masculine
aksonami	None
serdeczni	Masculine
zrobiłaś	Feminine
zadała	Feminine
medytowałbyś	Masculine
pokonany	Masculine
absolutni	Masculine
uncję	None
wyłączane	Neuter
wybuchała	Feminine
uśpieni	Masculine
zwartymi	None
rzekł	Masculine
przyszli	Masculine
jednostki	None
wybielacz	None
tostami	None
straciłbym	Masculine
niejawnych	Masculine
samych	Masculine
zaczynała	Feminine
trzmielom	None
kwilące	Neuter
bordowych	Masculine
wałówce	None
nadziejami	None
barszcz	None
kierował	Masculine
doceniane	Neuter
fagotami	None
ruszała	Feminine
panująca	Feminine
moda	None
śpiewało	Neuter
wielka	Feminine
dojrzałabym	Feminine
dodalibyście	Masculine
jadalna	Feminine
przysięgała	Feminine
województwom	None
truskawkowych	Masculine
żarówek	None
rocznicą	None
lamparty	None
systematyczna	Feminine
trąbka	None
wiązłby	Masculine
lwimi	None
fajnych	Masculine
urzędasom	None
bywanie	None
kabaczka	None
drapie	None
meteor	None
pośrednia	Feminine
usunęło	Neuter
radość	None
miętowa	Feminine
zainsynuowaliśmy	Masculine
narządem	None
atmosferyczna	Feminine
płaciła	Feminine
zamordowane	Neuter
analogowych	Masculine
składany	Masculine
wybuchnęłaby	Feminine
lusterkami	None
demontowalibyśmy	Masculine
okropna	Feminine
epidemia	None
zachowałem	Masculine
ułamek	None
spadalibyśmy	Masculine
obserwuje	None
oddano	None
łaźnię	None
Szwedowi	None
pamiętano	None
produkowałeś	Masculine
starczych	Masculine
wykorzystujące	Neuter
mięsnych	Masculine
chudych	Masculine
zerżnęlibyście	Masculine
otrzymana	Feminine
wynieść	None
słuchała	Feminine
opróżniłabyś	Feminine
burzony	Masculine
histopatologię	None
starzy	Masculine
podcast	None
ułomna	Feminine
zauważyłeś	Masculine
korzystałeś	Masculine
nadmiernych	Masculine
prawnoautorscy	Masculine
barokowa	Feminine
możliwa	Feminine
ciemnych	Masculine
pandemiach	None
paserem	None
bałtycka	Feminine
głupoty	None
dusiłoby	Neuter
poetka	None
projekcjach	None
sunęła	Feminine
myszce	None
pacjentów	None
autentycznych	Masculine
wtórna	Feminine
wędkarstwem	None
pierworodni	Masculine
nieskończonych	Masculine
leczyłaby	Feminine
bolce	None
nirwanę	None
kajaliście	Masculine
konkurowałabyś	Feminine
wyhaftowaliby	Masculine
potwierdzająca	Feminine
wyjaśniłbyś	Masculine
pozwalaliby	Masculine
chirurgiczna	Feminine
sprzężone	Neuter
mięsu	None
przeinaczyła	Feminine
oceniane	Neuter
kryzysie	None
gapił	Masculine
licealista	None
cudowni	Masculine
zdrowaśko	None
obuta	Feminine
lubili	Masculine
gęstszych	Masculine
graniczyłbym	Masculine
pasieką	None
wrogowie	None
niepełnosprawnych	None
jemeńskich	Masculine
brudziliśmy	Masculine
normalna	Feminine
gotowało	Neuter
niewiadoma	Feminine
zauważyłem	Masculine
czułem	Masculine
agentur	None
kontrolowało	Neuter
zazdrościłbym	Masculine
tenis	None
produkowałabyś	Feminine
poprawniejszych	Masculine
utworom	None
prawnikiem	None
benzenie	None
głosowałam	Feminine
dolni	Masculine
przestrzegał	Masculine
kaplica	None
późni	Masculine
rządzące	Neuter
estońscy	Masculine
opowiadające	Neuter
zantagonizowali	Masculine
prosiętami	None
znaczylibyśmy	Masculine
uciekałbyś	Masculine
ptaszysko	None
polityczna	Feminine
ogarniaj	None
eksperyment	None
pokazałeś	Masculine
Rosjanką	None
krzywych	Masculine
skakał	Masculine
wiosłowałbyś	Masculine
woniałem	Masculine
maskowali	Masculine
organizowalibyśmy	Masculine
przepiłam	Feminine
zwyciężałaś	Feminine
napiszę	None
modrzewiami	None
czesani	Masculine
obserwowałoby	Neuter
pustkowiu	None
zamożnych	Masculine
jadowita	Feminine
tokarzem	None
werblach	None
próżniejszych	Masculine
hurtowa	Feminine
wywołała	Feminine
anatolijskich	Masculine
braterska	Feminine
zadałeś	Masculine
dźwiękowych	Masculine
bociany	None
sycylijska	Feminine
dokonywał	Masculine
wymyśliłem	Masculine
puściło	Neuter
Anglikiem	None
łagodnych	Masculine
wykorzystywał	Masculine
neonem	None
symulujące	Neuter
mglista	Feminine
mas	None
zbierałbyś	Masculine
pojawiał	Masculine
koił	Masculine
cegła	None
uchodźco	None
piękniejsza	Feminine
dokonywany	Masculine
guglałam	Feminine
kłóciłaby	Feminine
koszona	Feminine
betonowała	Feminine
oczywista	Feminine
mieszkał	Masculine
pałac	None
daliście	Masculine
tracona	Feminine
złośliwa	Feminine
najubożsi	Masculine
nieobecna	Feminine
cesarskich	Masculine
tłuszczami	None
matrycami	None
pejoratywnych	Masculine
przygotowałaś	Feminine
wykrwawiłabyś	Feminine
głośna	Feminine
obfitych	Masculine
głodna	Feminine
kleiłam	Feminine
antylopę	None
szachownicą	None
łagodna	Feminine
wskazywała	Feminine
docenialiście	Masculine
napadach	None
chmurką	None
kolumbijscy	Masculine
zniszczyła	Feminine
łudziłeś	Masculine
efektowi	None
łamałby	Masculine
cale	None
mierżące	Neuter
mącicielowi	None
całowali	Masculine
ekspedientem	None
niezbędnych	Masculine
unikatowa	Feminine
oglądali	Masculine
tajlandzkich	Masculine
komentujące	Neuter
rozróżnilibyście	Masculine
znajdę	None
czułam	Feminine
studiuję	None
szanowane	Neuter
kochałem	Masculine
językowi	Masculine
kleiliście	Masculine
głosowałem	Masculine
emocja	None
szczęśliwa	Feminine
pogrzebał	Masculine
rodził	Masculine
podziwiał	Masculine
lniana	Feminine
żująca	Feminine
wapienia	None
pękał	Masculine
rozwiąże	None
sprawdzałam	Feminine
kręceni	Masculine
liczniejszych	Masculine
kosmicznych	Masculine
kupują	None
zalogował	Masculine
rozbili	Masculine
siadała	Feminine
śpieszył	Masculine
rzeczona	Feminine
rektorzy	None
lękałoby	Neuter
zaciążyłyby	None
motorniczemu	None
artystyczna	Feminine
oddani	Masculine
taternikami	None
nachrapnik	None
uratowana	Feminine
opiekowali	Masculine
uciążliwych	Masculine
najmocniejszych	Masculine
wykopał	Masculine
odkrywająca	Feminine
adwersarzami	None
chirurgami	None
ślepych	Masculine
żaru	None
trzaskała	Feminine
najlojalniejszych	Masculine
birmańscy	Masculine
równociągła	Feminine
galopowała	Feminine
zasługujmy	None
wspominała	Feminine
greccy	Masculine
inteligentnych	Masculine
buchało	Neuter
wstążeczce	None
cyrkowi	Masculine
odbierało	Neuter
stająca	Feminine
składana	Feminine
rozmawiało	Neuter
piłeczkom	None
mordowali	Masculine
morfiną	None
odebrałeś	Masculine
polowało	Neuter
starością	None
wynajęłabyś	Feminine
kontrolowane	Neuter
nieruchomych	Masculine
zmianę	None
szczecińscy	Masculine
alpejskich	Masculine
powtórzmy	None
dźwięcznych	Masculine
przestrzegaj	None
abonując	None
kajmany	None
oderwani	Masculine
krokusy	None
wnukom	None
wywoływane	Neuter
borowa	Feminine
intymnych	Masculine
lateksem	None
krzyczał	Masculine
skazałabyś	Feminine
rumu	None
sprzątnęła	Feminine
księży	None
notował	Masculine
łacińscy	Masculine
ostatecznych	Masculine
obszerna	Feminine
drażniąca	Feminine
drogę	None
testowi	Masculine
burzylibyśmy	Masculine
rozczarowana	Feminine
płynna	Feminine
wygralibyśmy	Masculine
beżowych	Masculine
płacone	Neuter
stracone	Neuter
rozetami	None
dumaj	None
kłóciłbym	Masculine
biuru	None
prostokątna	Feminine
otrułem	Masculine
trosk	None
rozsadzałem	Masculine
żyłyśmy	None
robiące	Neuter
czernice	None
chujowa	Feminine
ukraińskich	Masculine
żołnach	None
słodka	Feminine
poprowadziłabyś	Feminine
podrzędna	Feminine
haftowała	Feminine
fizycznych	Masculine
runąłeś	Masculine
obiektywie	None
łodyg	None
żute	Neuter
cienkich	Masculine
oceniałem	Masculine
przeszkadzało	Neuter
wyjąłeś	Masculine
głosowaliby	Masculine
lansowali	Masculine
doprowadzani	Masculine
pokonaniem	None
zapalili	Masculine
ćwiczył	Masculine
wołało	Neuter
przyzwoita	Feminine
powojennych	Masculine
używająca	Feminine
zauważył	Masculine
płynąca	Feminine
histydyny	None
zmieniłaby	Feminine
wielcy	Masculine
złamane	Neuter
wymogliśmy	Masculine
akcentów	None
plemiennych	Masculine
cieńszych	Masculine
oddałby	Masculine
ładowana	Feminine
atomowych	Masculine
sernikach	None
ubodzy	Masculine
pokrywająca	Feminine
poroniona	Feminine
liściowa	Feminine
okazałoby	Neuter
zdementowalibyśmy	Masculine
refowanie	None
wylani	Masculine
dawane	Neuter
karmione	Neuter
maltańskich	Masculine
abstynencję	None
uratowała	Feminine
odchodziła	Feminine
kirgiska	Feminine
gazowych	Masculine
gadał	Masculine
legionistą	None
ujemnych	Masculine
dziękował	Masculine
stawiali	Masculine
pokazywali	Masculine
kajali	Masculine
mazowieccy	Masculine
rodzice	None
śpiących	Masculine
bakteriobójczych	Masculine
grzybowa	Feminine
panika	None
międzynarodowi	Masculine
todze	None
własna	Feminine
prawdopodobnych	Masculine
wstawał	Masculine
przedwojennych	Masculine
pismakami	None
romantyczniejsza	Feminine
uciekałem	Masculine
odpowiednich	Masculine
cielskach	None
mercedesów	None
wybierające	Neuter
charakterem	None
kicałabym	Feminine
dał	Masculine
sekstę	None
zadzwoniła	Feminine
wahała	Feminine
chirurdzy	None
siusiałam	Feminine
zatrzymani	Masculine
podwójnych	Masculine
sportowa	Feminine
objawami	None
chowali	Masculine
rachunków	None
mowach	None
postępie	None
zrobiłbym	Masculine
neologizmami	None
filary	None
szastałby	Masculine
rudych	Masculine
hojna	Feminine
zapaliło	Neuter
boleśni	Masculine
cyfrowa	Feminine
pornograficznymi	None
zmieniłabym	Feminine
martwiła	Feminine
zajączek	None
brunatna	Feminine
ściągała	Feminine
rozstrojowi	None
brudni	Masculine
nowsi	Masculine
studni	None
cis	None
ukrywały	None
przyjmująca	Feminine
pestce	None
spodziewałoby	Neuter
rzuciliby	Masculine
jeżowi	Masculine
gęstych	Masculine
unicestwiony	Masculine
kłębu	None
klejona	Feminine
emiraty	None
sunęliście	Masculine
kryzys	None
mądra	Feminine
psychopatycznych	Masculine
odpoczywali	Masculine
propanowi	None
inwalidą	None
łat	None
roczna	Feminine
najnudniejszych	Masculine
bordowa	Feminine
antycząstek	None
imponował	Masculine
pokonana	Feminine
żelazna	Feminine
boksie	None
technikom	None
wstawaliby	Masculine
puścisz	None
piersiami	None
ignorował	Masculine
czadyjska	Feminine
odstawiona	Feminine
ślepiu	None
fałszerz	None
zweryfikowałeś	Masculine
pojawiłem	Masculine
mamrotałby	Masculine
wyjąłem	Masculine
myliło	Neuter
kostki	None
zabalsamowani	Masculine
próbowała	Feminine
leworęcznych	Masculine
zamykał	Masculine
dowodziłbym	Masculine
słynąca	Feminine
odbudowała	Feminine
siedzieli	Masculine
higienicznych	Masculine
podali	Masculine
szwajcarzy	None
podatkowa	Feminine
zwyczajna	Feminine
haftowałbym	Masculine
zodiakalnych	Masculine
szachistami	None
batutę	None
wspomniane	Neuter
runęła	Feminine
obserwowane	Neuter
odkrywali	Masculine
gdakanie	None
alpejska	Feminine
ciastkami	None
minuty	None
ławka	None
kulturo	None
kolonia	None
ogromom	None
chodnika	None
zabite	Neuter
meteorologicznych	Masculine
nastawieni	Masculine
jezdnią	None
śmieszniejsi	Masculine
znałem	Masculine
chwaliłbym	Masculine
poczekał	Masculine
dziwnych	Masculine
mijana	Feminine
wędrowało	Neuter
płonął	Masculine
pojawiła	Feminine
prany	Masculine
grubsza	Feminine
chwalił	Masculine
wyłączajmy	None
sprawiane	Neuter
znaliśmy	Masculine
błyskałeś	Masculine
ruda	Feminine
tłusta	Feminine
parapsychologicznych	Masculine
tworzyłeś	Masculine
pękałby	Masculine
pytali	Masculine
masaże	None
sprzeczkami	None
gnijących	Masculine
zdolni	Masculine
brytyjska	Feminine
zabiliśmy	Masculine
dręczące	Neuter
obalony	Masculine
prozaicznych	Masculine
zybuczkowce	None
sprawdzi	None
zamykani	Masculine
laotańskich	Masculine
wołała	Feminine
czasoprzestrzenie	None
tworzyłbym	Masculine
ćwiczyć	None
wskazywałaby	Feminine
ziejące	Neuter
potrawach	None
dedykowane	Neuter
kombinezony	None
legarach	None
wyrzuciłem	Masculine
przepięknymi	None
korzystnych	Masculine
hamująca	Feminine
notowałaby	Feminine
sarkajmy	None
miligramów	None
chciwych	Masculine
pochodziła	Feminine
unicestwiła	Feminine
suszony	Masculine
potrzebni	Masculine
puzon	None
jaz	None
chirurgicznych	Masculine
legalna	Feminine
metodystycznych	Masculine
omanu	None
śmierdzicie	None
opatentowała	Feminine
dębowa	Feminine
drukarniami	None
bliźniętami	None
jawiło	Neuter
kupcu	None
wyrzucili	Masculine
umówili	Masculine
zamykane	Neuter
zadzie	None
ściągane	Neuter
usuwałoby	Neuter
marzyła	Feminine
teatralna	Feminine
zapraszani	Masculine
kurnikiem	None
moczyłby	Masculine
starsi	Masculine
dodałbym	Masculine
posiadaliście	Masculine
minusami	None
gryzłeś	Masculine
dramatycznymi	None
wyjaśnił	Masculine
sprawiająca	Feminine
obserwował	Masculine
pewni	Masculine
psem	None
wahadłem	None
najaktywniejszych	Masculine
kruczki	None
zaprosił	Masculine
żółwiach	None
składająca	Feminine
należeliby	Masculine
wyznaczyli	Masculine
okrutnych	Masculine
znajdziecie	None
cudowna	Feminine
drgające	Neuter
fantastyczna	Feminine
częstsza	Feminine
krypton	None
napierdalałby	Masculine
Indonezyjczycy	None
ekranizacją	None
zakażesz	None
tasakami	None
spotkałam	Feminine
łamała	Feminine
powtarzałeś	Masculine
tłumaczyli	Masculine
znikałybyśmy	None
widoczna	Feminine
chciałbyś	Masculine
uratowany	Masculine
podatni	Masculine
najświętszych	Masculine
padałbym	Masculine
obrażające	Neuter
czerpane	Neuter
fulu	None
zazdrosnych	Masculine
golona	Feminine
straceni	Masculine
ogromnych	Masculine
napisani	Masculine
kartonowa	Feminine
limburska	Feminine
sunęło	Neuter
bywałbym	Masculine
otaczająca	Feminine
buraczana	Feminine
kolców	None
półpiętrami	None
liściasta	Feminine
zastanawiała	Feminine
winna	Feminine
zmieniłem	Masculine
dusilibyśmy	Masculine
montażystą	None
rzadkich	Masculine
wągier	None
używane	Neuter
identyfikująca	Feminine
gładka	Feminine
dokonałam	Feminine
zapominałaby	Feminine
dostarczająca	Feminine
zapamiętała	Feminine
siódemką	None
skręciła	Feminine
Angola	None
mądrzyłby	Masculine
błaha	Feminine
gadatliwa	Feminine
odwzajemniony	Masculine
znaczyłaś	Feminine
wyświetlająca	Feminine
traktowane	Neuter
bakteryjna	Feminine
smutaliby	Masculine
partaczach	None
porównywalnymi	None
zaczynaj	None
pisarek	None
pracowitych	Masculine
ściema	None
dźwig	None
równych	Masculine
przystająca	Feminine
niszczone	Neuter
ładniejszych	Masculine
tramwajem	None
stawiająca	Feminine
sztandarem	None
ciasto	None
prawniczych	Masculine
poprzedzalibyście	Masculine
posłuchajcie	None
odchodziliście	Masculine
zasłużyłem	Masculine
księgowych	None
wiosłowałem	Masculine
śmiałem	Masculine
wczesnych	Masculine
organistko	None
śpiewali	Masculine
mieszana	Feminine
topolowych	Masculine
szczudłaki	None
zaraźliwa	Feminine
obiecałem	Masculine
wywoływany	Masculine
najodpowiedniejszych	Masculine
pożyczałby	Masculine
kawy	None
odmianą	None
poprawiałaś	Feminine
wandalizmie	None
nadzorowali	Masculine
reportaże	None
wyruchałbyś	Masculine
kazachstańskich	Masculine
algorytmom	None
chorwacka	Feminine
bibliografiami	None
osmańscy	Masculine
archaiczna	Feminine
dachowi	Masculine
zakazy	None
jadany	Masculine
wiałyśmy	None
najsprawniejsza	Feminine
azerska	Feminine
gadaliście	Masculine
kastrowało	Neuter
czujące	Neuter
przyrodniczych	Masculine
równiejszych	Masculine
wykorzystująca	Feminine
dowiedziano	None
zabrałeś	Masculine
kwartetom	None
przeinaczyłabyś	Feminine
urzędy	None
tratwie	None
usuwałbym	Masculine
głosowała	Feminine
ocenił	Masculine
zbierany	Masculine
kręcona	Feminine
masek	None
chowałaś	Feminine
wisiała	Feminine
kirgiskich	Masculine
Rusku	None
studiujące	Neuter
religiach	None
zaczynałabym	Feminine
dochodziłbym	Masculine
więźnia	None
poprosił	Masculine
nieumarli	Masculine
kaszalotem	None
zachowaliśmy	Masculine
farmakologicznych	Masculine
szubienicy	None
spuść	None
wyhaftował	Masculine
przezimowałbyś	Masculine
niuansów	None
dochodziłoby	Neuter
żądło	None
jamajskich	Masculine
chciał	Masculine
czerpała	Feminine
łgarz	None
promienia	None
przemysłowi	Masculine
odkrywana	Feminine
pokażę	None
odstawiło	Neuter
poprowadzą	None
poprawiliśmy	Masculine
odwiedzałaby	Feminine
namibijskich	Masculine
uboga	Feminine
wymagało	Neuter
otaczałeś	Masculine
zawodowi	Masculine
dodatkowych	Masculine
przesadzałeś	Masculine
pocztowi	Masculine
klękałybyśmy	None
przepięknych	Masculine
nazywać	None
ciot	None
próbę	None
sądziła	Feminine
pomocą	None
psychoterapeuci	None
ładowane	Neuter
odczyniłabym	Feminine
esejów	None
gnaliby	Masculine
szkodziłaby	Feminine
mocniejszych	Masculine
przypadkowych	Masculine
przesadzaliby	Masculine
mgliści	Masculine
notatniku	None
nadzorująca	Feminine
domach	None
składzie	None
rajdowcami	None
rządzeni	Masculine
oskarżałam	Feminine
wdychany	Masculine
bełtalibyście	Masculine
parabola	None
pokazujące	Neuter
dekrecie	None
łodydze	None
wiejskich	Masculine
nękałbyś	Masculine
klasycyzmu	None
medalionach	None
paliło	Neuter
połykaliby	Masculine
łódzkich	Masculine
rodzinna	Feminine
siejąc	None
deptaków	None
odwiedzali	Masculine
kaszmirem	None
monogramy	None
chełpiliście	Masculine
kameruńska	Feminine
wielkich	Masculine
debilem	None
porozmawiała	Feminine
radna	None
wracał	Masculine
zrozumiałeś	Masculine
warczyłaby	Feminine
spieprzałabym	Feminine
pustakami	None
łudzili	Masculine
kotłowniach	None
zamykany	Masculine
wybierałaś	Feminine
węgorzami	None
uratowałam	Feminine
zwierzęca	Feminine
cotangensach	None
szewców	None
biurko	None
humanistę	None
piwu	None
jezdniach	None
poroniła	Feminine
luba	Feminine
zmieniłby	Masculine
dwujęzyczna	Feminine
tracące	Neuter
miejskich	Masculine
oskarżające	Neuter
polowała	Feminine
grzebie	None
zburzyła	Feminine
zazdrością	None
polki	None
ciężaru	None
pokonała	Feminine
poróżniliby	Masculine
skrzynki	None
cysteiny	None
najszczerszych	Masculine
wieców	None
skowronki	None
zamarzają	None
morderstwem	None
septymą	None
placki	None
powtórzyłeś	Masculine
wyprowadzeniem	None
porcelanowych	Masculine
metalurgiczna	Feminine
lotosu	None
spuszczona	Feminine
amortyzatora	None
podróżując	None
napisałabym	Feminine
zapłaciło	Neuter
dorzeczy	None
heretyckich	Masculine
smołę	None
ptasich	Masculine
krzycząca	Feminine
dobrowolnych	Masculine
polowaniem	None
splądrowało	Neuter
mandarynce	None
zewnętrzni	Masculine
Irlandkami	None
kokosowa	Feminine
pęknięty	Masculine
nękające	Neuter
poufnych	Masculine
połknięci	Masculine
kicz	None
skończeniewymiarowych	Masculine
smażone	Neuter
pięcie	None
ukryło	Neuter
poprzednich	Masculine
straciłby	Masculine
krakowskich	Masculine
pizdą	None
skromni	Masculine
marznąłbyś	Masculine
akceleracja	None
zarezerwowana	Feminine
jezior	None
powtórzony	Masculine
odbierane	Neuter
dedykowało	Neuter
otworzyła	Feminine
głosując	None
kibicowałabym	Feminine
dochodząca	Feminine
rzymska	Feminine
dwukołowych	Masculine
odwiedzająca	Feminine
odpowiadałaby	Feminine
zauważyli	Masculine
dzierżone	Neuter
lepiliśmy	Masculine
stawiała	Feminine
formalnych	Masculine
nigeryjskich	Masculine
niewinnych	Masculine
kserowalibyście	Masculine
białoruska	Feminine
argentyńska	Feminine
nurkował	Masculine
aluminiowa	Feminine
kraju	None
samolotach	None
amplitudo	None
czuło	Neuter
najpotężniejsza	Feminine
obraziłem	Masculine
widocznych	Masculine
wyrządziłbyś	Masculine
optycznych	Masculine
słoiczki	None
ceniłem	Masculine
puścił	Masculine
zwrotnicami	None
szalało	Neuter
jawiła	Feminine
wyjęta	Feminine
mieszać	None
wędrownych	Masculine
turystyczni	Masculine
zmieniłeś	Masculine
trzymałbym	Masculine
podziwiałem	Masculine
fizyczna	Feminine
pomagało	Neuter
wonieli	Masculine
znosiłabym	Feminine
korsykańskich	Masculine
wywołał	Masculine
urodzeni	Masculine
głucha	Feminine
erotyczna	Feminine
szantażujesz	None
urugwajskich	Masculine
uważaliśmy	Masculine
oskarżał	Masculine
pisalibyśmy	Masculine
puszczana	Feminine
betonowałaś	Feminine
mijająca	Feminine
ślusarzem	None
jugosłowiańska	Feminine
biologiczna	Feminine
zamożni	Masculine
poprosiłbym	Masculine
bilety	None
arystokratyczna	Feminine
zostawione	Neuter
biednych	Masculine
dodałyście	None
wyjaśniłoby	Neuter
dowodzeni	Masculine
sygnałowi	None
piszczeli	Masculine
styczniowych	Masculine
zatrzymany	Masculine
węszyliśmy	Masculine
niecierpliwych	Masculine
fińskich	Masculine
wymagasz	None
skrzypkowie	None
owady	None
krakałabym	Feminine
księgową	None
połączeni	Masculine
podejrzewałem	Masculine
mieszali	Masculine
szukałeś	Masculine
łapiesz	None
czytało	Neuter
podobnych	Masculine
zadany	Masculine
modlili	Masculine
naprawiał	Masculine
laików	None
komitetu	None
zaczynałem	Masculine
najlżejsza	Feminine
chroniąca	Feminine
dłoń	None
zebrani	Masculine
wyświetlało	Neuter
kompilowane	Neuter
najniższa	Feminine
stetoskopem	None
wysyłająca	Feminine
zapominać	None
elfich	Masculine
najpowszechniejsza	Feminine
ufałeś	Masculine
pokoleniu	None
psychicznych	Masculine
żywokostem	None
mokradeł	None
skróciłem	Masculine
podła	Feminine
zimująca	Feminine
skorpionach	None
kwadransa	None
pirata	None
rodząca	Feminine
przypomniał	Masculine
minimalna	Feminine
przyjazna	Feminine
kwestionująca	Feminine
południowi	Masculine
jadała	Feminine
dymali	Masculine
chełpią	None
kubańska	Feminine
korzystająca	Feminine
poprosiła	Feminine
beżowi	Masculine
samolubni	Masculine
dotknęło	Neuter
kazachska	Feminine
podziemnych	Masculine
wsparła	Feminine
lubiąca	Feminine
obywatelstw	None
tajlandzka	Feminine
kromka	None
szukałem	Masculine
najwcześniejsi	Masculine
skracali	Masculine
najzdolniejsi	Masculine
wyjęci	Masculine
pogadało	Neuter
arabskich	Masculine
katakanie	None
pojmowaliście	Masculine
filmowano	None
dotknąłeś	Masculine
zakładające	Neuter
sporu	None
żeńskich	Masculine
skromniejszych	Masculine
kapturach	None
grupom	None
otaczające	Neuter
łużycka	Feminine
planowałem	Masculine
negocjowali	Masculine
skazana	Feminine
lekkoatletami	None
jeżdżące	Neuter
znikające	Neuter
siekaczach	None
brudziłbyś	Masculine
okradał	Masculine
karaibskich	Masculine
wziąłem	Masculine
normą	None
właściwa	Feminine
zimował	Masculine
automatyczni	Masculine
wybrało	Neuter
robiłbym	Masculine
małych	Masculine
hojnych	Masculine
pożarty	Masculine
biologicznych	Masculine
gotyckich	Masculine
klonami	None
chorzowskich	Masculine
dobra	Feminine
zniszczyły	None
chat	None
pielgrzymkę	None
zachorować	None
abisyńskich	Masculine
nieumarłych	Masculine
szwedzka	Feminine
alkoholiczka	None
umarł	Masculine
niechlujna	Feminine
najważniejsi	Masculine
obszerniejszych	Masculine
rozwiązane	Neuter
jasnoszarych	Masculine
dowodziło	Neuter
działoby	Neuter
drażnił	Masculine
odpływ	None
absorbująca	Feminine
romantyczniejsi	Masculine
fioletowa	Feminine
jawor	None
otworzyło	Neuter
pytało	Neuter
symulowała	Feminine
mrówkolew	None
staroangielska	Feminine
hiszpańskich	Masculine
napowietrzyłbym	Masculine
europ	None
męczyli	Masculine
umieranie	None
wybrani	Masculine
odstawiony	Masculine
pojemni	Masculine
kieliszkiem	None
atakujące	Neuter
wierzące	Neuter
rozwijana	Feminine
jąkali	Masculine
chroniona	Feminine
opatentowania	None
rozwiązalibyśmy	Masculine
rozbił	Masculine
tworzone	Neuter
kawowych	Masculine
gaworzono	None
obejmująca	Feminine
potwierdziła	Feminine
nakrył	Masculine
skończyli	Masculine
potwierdzała	Feminine
przekwitałam	Feminine
najmocniejsza	Feminine
abonament	None
słuchane	Neuter
likaony	None
drukowali	Masculine
dzisiejszych	Masculine
pisana	Feminine
kibicowaliście	Masculine
ówcześni	Masculine
alabaster	None
kaskader	None
brunatnych	Masculine
dawało	Neuter
wyjaśnię	None
czerninami	None
najstarsi	Masculine
szalała	Feminine
najtwardsi	Masculine
portugalska	Feminine
poróżniłabym	Feminine
abiturientów	None
siedziałem	Masculine
towarzyskich	Masculine
kąsać	None
dotykane	Neuter
gaworzyłbym	Masculine
eksperymentowała	Feminine
sprzyjało	Neuter
uważasz	None
wpływali	Masculine
internetowa	Feminine
mieszkańcem	None
oddychająca	Feminine
enklawach	None
kłóciło	Neuter
odebrałem	Masculine
brazylijska	Feminine
wykałaczki	None
łby	None
zmieniali	Masculine
oddające	Neuter
włączająca	Feminine
klęcząca	Feminine
imponujące	Neuter
cenił	Masculine
zaniechało	Neuter
belgijskich	Masculine
machała	Feminine
ubóstwialibyśmy	Masculine
zadaliście	Masculine
kładzione	Neuter
zapalone	Neuter
wiedźmy	None
pokrywał	Masculine
edytowałam	Feminine
okazałeś	Masculine
wybitniejsi	Masculine
bywałabym	Feminine
zmieniające	Neuter
radiologii	None
obrazili	Masculine
kamienni	Masculine
pląsać	None
lubieni	Masculine
wzrostom	None
periodykiem	None
przypomniana	Feminine
oskarżająca	Feminine
narciarscy	Masculine
rozważani	Masculine
opiekunów	None
nadmierna	Feminine
sęp	None
solna	Feminine
kolęd	None
graniczna	Feminine
sarkałabyś	Feminine
złupiliby	Masculine
doceniana	Feminine
umarły	Masculine
poprosiłabym	Feminine
wschodząca	Feminine
pożyczona	Feminine
oktant	None
zamykałabyś	Feminine
nadużywająca	Feminine
poprawiłbyś	Masculine
nieśmiertelni	Masculine
mazowieckich	Masculine
karmiona	Feminine
telefoniczna	Feminine
zdementował	Masculine
prawnoautorskich	Masculine
zburzylibyśmy	Masculine
zamówione	Neuter
semantyczna	Feminine
najpróżniejsza	Feminine
czeskich	Masculine
zapomniałaby	Feminine
zalogowałam	Feminine
sprawiedliwych	Masculine
doprowadzany	Masculine
tekstom	None
piłkarzom	None
podkowami	None
młodzi	Masculine
oliwą	None
literówkę	None
polan	None
brudniejszych	Masculine
najprzyjaźniejsi	Masculine
montownię	None
dyktatury	None
zakonniku	None
przegapiłem	Masculine
pornograficzna	Feminine
niesprawiedliwych	Masculine
dziejące	Neuter
mrugała	Feminine
smocza	Feminine
dowodzące	Neuter
adeptów	None
otrzymywałby	Masculine
starotestamentowych	Masculine
jąkałaby	Feminine
denerwowali	Masculine
białoruskich	Masculine
przypominałoby	Neuter
błądziłoby	Neuter
spróbowałem	Masculine
szabatu	None
zabrani	Masculine
rozproszone	Neuter
krzywi	Masculine
werandzie	None
antytrynitaryzm	None
kategorię	None
atomom	None
słynna	Feminine
dymna	Feminine
psuło	Neuter
lodowcowi	Masculine
nukleon	None
przynosiło	Neuter
stroma	Feminine
oceniające	Neuter
karp	None
posiadałaby	Feminine
tanich	Masculine
skłonności	None
analizowane	Neuter
sfałszował	Masculine
pielgrzymów	None
oszukiwało	Neuter
żułby	Masculine
surrealiści	None
rabatem	None
drżano	None
pozostawałby	Masculine
koczowniczych	Masculine
duchowa	Feminine
uratowane	Neuter
kwantowa	Feminine
całych	Masculine
usunęliśmy	Masculine
przypomniała	Feminine
ukradnijcie	None
numerowane	Neuter
drogowskazem	None
kochali	Masculine
kierowałbym	Masculine
wylany	Masculine
maliny	None
dziesiętnych	Masculine
smażony	Masculine
przyjęte	Neuter
okradała	Feminine
szpital	None
prawdopodobna	Feminine
kradnące	Neuter
aksony	None
kinowa	Feminine
zdiagnozowana	Feminine
dymiło	Neuter
szastałabym	Feminine
niesprawiedliwa	Feminine
przygotowałbyś	Masculine
dźwigające	Neuter
ponadprzeciętna	Feminine
sęk	None
odkrywałoby	Neuter
łódzka	Feminine
jadowitymi	None
uznawany	Masculine
nosowa	Feminine
ćwiczeń	None
gorzałeś	Masculine
małpowaliśmy	Masculine
kreskówką	None
szczułem	Masculine
fruwałaś	Feminine
wytłumaczeni	Masculine
beleczka	None
hokejowa	Feminine
polskich	Masculine
usunęli	Masculine
dostarczające	Neuter
mniejszościami	None
wieczna	Feminine
najkrótszych	Masculine
zrozumiałych	Masculine
dzieciętach	None
źli	Masculine
dyskotekowa	Feminine
chaotyczni	Masculine
kalifem	None
australijskich	Masculine
meteorologiczni	Masculine
rurociągi	None
absorbując	None
kółek	None
śpiewanie	None
chórem	None
katowickich	Masculine
zenit	None
galopowałaby	Feminine
wdychane	Neuter
Greku	None
podli	Masculine
psychosomatycznych	Masculine
skórzani	Masculine
stany	None
biedni	Masculine
porównywalnych	Masculine
skromniejsi	Masculine
wcześniejszych	Masculine
spuszczaliśmy	Masculine
potężnych	Masculine
starość	None
biblijna	Feminine
podała	Feminine
wszystkich	Masculine
ceniła	Feminine
tolerowali	Masculine
dokonująca	Feminine
zweryfikowało	Neuter
wytłumaczona	Feminine
rombem	None
łapałby	Masculine
krasna	Feminine
banalna	Feminine
ginęła	Feminine
żeglowanie	None
osmańska	Feminine
demograficznymi	None
kosiłbym	Masculine
ziewalibyśmy	Masculine
oceniany	Masculine
myliłem	Masculine
kradł	Masculine
ukryliście	Masculine
gruzińska	Feminine
słuchałby	Masculine
przyjaźnie	None
lewi	Masculine
pokrywałaby	Feminine
głupota	None
turkusowych	Masculine
czynione	Neuter
wdepnąłbym	Masculine
klęczał	Masculine
najczulsza	Feminine
wulkaniczni	Masculine
jodłowych	Masculine
wafla	None
bawełniana	Feminine
przyniósł	Masculine
budziło	Neuter
zdobiły	None
begoniom	None
machałaby	Feminine
kosmopolicie	None
uczęszczałbyś	Masculine
polonijna	Feminine
hamował	Masculine
smutałbym	Masculine
spałaszowałabyś	Feminine
wybrał	Masculine
posiadała	Feminine
masowców	None
puszczony	Masculine
urządzeniach	None
przyrostek	None
obaliłby	Masculine
zgubione	Neuter
drapieżnych	Masculine
nawiedzona	Feminine
harowaliście	Masculine
traciłem	Masculine
kondensatorze	None
moralni	Masculine
ryczące	Neuter
ataki	None
zasłużeni	Masculine
dostawałeś	Masculine
dusiliby	Masculine
wędrowców	None
kupowałeś	Masculine
komentowałyście	None
odbierany	Masculine
kątami	None
botaniczna	Feminine
doskonalsza	Feminine
czystych	Masculine
dziwiłem	Masculine
stomatolog	None
mące	None
ocalona	Feminine
elektryczni	Masculine
krzemień	None
omamu	None
kabałę	None
umieraliście	Masculine
belgijska	Feminine
czytelniejsza	Feminine
hadisów	None
kartach	None
laryngologu	None
westernami	None
znoszony	Masculine
włodarzom	None
wszelkich	Masculine
pączkiem	None
najluźniejsi	Masculine
mocniejsza	Feminine
rozbiłybyście	None
normalni	Masculine
poranki	None
najładniejszych	Masculine
kapciach	None
podnosiliśmy	Masculine
starych	Masculine
obaliłem	Masculine
nocnymi	None
koszernych	Masculine
meduz	None
zjebkami	None
neolitycznych	Masculine
zniesławieniu	None
oszukani	Masculine
peptydy	None
odkryła	Feminine
serc	None
krzycz	None
niewiadomych	Masculine
odpoczął	Masculine
emeryturo	None
bezwzględna	Feminine
dyskotek	None
krymska	Feminine
barionów	None
Łotyszką	None
zwyciężające	Neuter
majeranków	None
podniesiona	Feminine
pomysłowi	Masculine
zebrałbyś	Masculine
najrozsądniejsza	Feminine
ziejąca	Feminine
kontrola	None
zjedzone	Neuter
karabinków	None
wiertarko	None
dymanie	None
jebnęliśmy	Masculine
boskich	Masculine
rotorami	None
grabiłby	Masculine
wyżynie	None
ładnych	Masculine
kierowała	Feminine
buziakowi	None
zrobiła	Feminine
abonująca	Feminine
owsianych	Masculine
Łotyszowi	None
rytualnych	Masculine
bliźni	None
granicząca	Feminine
kłamiące	Neuter
życzące	Neuter
uczestniczyłem	Masculine
atakowana	Feminine
lustrzana	Feminine
podziwiało	Neuter
diecezjalna	Feminine
wykopała	Feminine
uprzedziłby	Masculine
dodające	Neuter
rządzona	Feminine
owieczkę	None
makowiec	None
śluzowcach	None
zastanawialiśmy	Masculine
bezchmurna	Feminine
uznawali	Masculine
wybitnych	Masculine
mierzy	None
ratujące	Neuter
zerował	Masculine
feministyczna	Feminine
parowałybyśmy	None
ekolodzy	None
płaciliby	Masculine
klasycystycznymi	None
żółwi	None
solidniejszych	Masculine
potwierdzali	Masculine
wrodzy	Masculine
wsparci	Masculine
jasnożółtych	Masculine
renesansowych	Masculine
sierpniowych	Masculine
katu	None
marokańscy	Masculine
reprodukcjach	None
hamowałby	Masculine
dyskretna	Feminine
taniochę	None
starałem	Masculine
zniewieściałych	Masculine
wyhaftowane	Neuter
zamówiona	Feminine
ekologiczna	Feminine
uczęszczali	Masculine
zachorowałam	Feminine
gdyńscy	Masculine
żałowałbyś	Masculine
łudzony	Masculine
odchodziło	Neuter
pamiątek	None
najbarwniejszych	Masculine
oszukiwał	Masculine
najpilniejszych	Masculine
znalazłabym	Feminine
przeleciałem	Masculine
żółtawa	Feminine
bezpodstawna	Feminine
kominiarza	None
północna	Feminine
tłumaczyłam	Feminine
fikcję	None
zewnętrznych	Masculine
panował	Masculine
ocaliło	Neuter
jął	Masculine
poprowadzone	Neuter
uważali	Masculine
fonologia	None
owadożerna	Feminine
notesu	None
łamane	Neuter
społeczeństwu	None
polowałbym	Masculine
abonowalibyście	Masculine
spróbowała	Feminine
pszenna	Feminine
akcelerometrach	None
popełniłeś	Masculine
pogrzebało	Neuter
oglądaliście	Masculine
lodowcowa	Feminine
gibony	None
pilnika	None
grzebani	Masculine
działałem	Masculine
przyjmowali	Masculine
idealna	Feminine
starcie	None
goniła	Feminine
analizująca	Feminine
wyłudzał	Masculine
zaufałem	Masculine
przysięgałabyś	Feminine
bakburtom	None
trzymające	Neuter
poprawni	Masculine
zdiagnozowali	Masculine
chwialibyście	Masculine
reklamowa	Feminine
sejsmometru	None
podziwiałeś	Masculine
internatu	None
sromu	None
katowiccy	Masculine
płaciłeś	Masculine
płakałem	Masculine
wzięliśmy	Masculine
ukośników	None
wróżkach	None
umysłów	None
wyjaśniona	Feminine
wywołując	None
czapkami	None
potęgom	None
straży	None
prześcieradle	None
zaczynało	Neuter
sami	Masculine
armeńskich	Masculine
mitycznych	Masculine
iskałeś	Masculine
wytryskuję	None
dodałby	Masculine
parzysta	Feminine
puszczali	Masculine
oddawany	Masculine
złożyło	Neuter
pnąca	Feminine
towar	None
najśmieszniejszych	Masculine
braterskich	Masculine
ostatnich	Masculine
uczestniczyli	Masculine
obiecali	Masculine
kryjące	Neuter
czerpiąc	None
kochające	Neuter
śpiewałaby	Feminine
rumom	None
grzechotnik	None
siedziała	Feminine
stawiałabyś	Feminine
biblijni	Masculine
ewentualni	Masculine
rozmyty	Masculine
najdalsi	Masculine
ukradziona	Feminine
rozbiła	Feminine
sklepom	None
wyuzdana	Feminine
wstawałby	Masculine
poznałeś	Masculine
zamordowany	Masculine
śniące	Neuter
holenderska	Feminine
żerdzi	None
mnicha	None
wymyślali	Masculine
weekendowych	Masculine
samotni	Masculine
przyjmujące	Neuter
kurdyjska	Feminine
mruczmy	None
jasnoszara	Feminine
stygnąłbyś	Masculine
wyrządzona	Feminine
ambitnych	Masculine
wyrzutków	None
przedmowach	None
najgęstsza	Feminine
przegapiłeś	Masculine
macierzyńskich	Masculine
schnące	Neuter
południowych	Masculine
uderzone	Neuter
rozwiązała	Feminine
czosnkowi	Masculine
myliła	Feminine
listopadowa	Feminine
kalarepę	None
zamówiło	Neuter
fioletowawa	Feminine
uderzana	Feminine
szczujące	Neuter
wyglądała	Feminine
kręcił	Masculine
cierpliwa	Feminine
solidna	Feminine
uratowałeś	Masculine
chciałoby	Neuter
zawarło	Neuter
mniejsi	Masculine
czajnik	None
cietrzewi	None
doiłbyś	Masculine
naga	Feminine
drylujecie	None
nordycka	Feminine
Angielką	None
rzucane	Neuter
irlandzcy	Masculine
najpóźniejszych	Masculine
odstawiłabym	Feminine
najpewniejszych	Masculine
koszykarza	None
szczuć	None
chrzczone	Neuter
jacykolwiek	Masculine
przechodnia	Feminine
zniknął	Masculine
zblazowana	Feminine
kradli	Masculine
książeczko	None
gwiazdozbioru	None
pluszowa	Feminine
podpaleniami	None
jesionowa	Feminine
sprawdzić	None
raso	None
sinusa	None
modląca	Feminine
puzonów	None
dinozaura	None
mocni	Masculine
rozmyło	Neuter
zadzwonili	Masculine
powiadomienie	None
hydraulicznych	Masculine
znajdźmy	None
padało	Neuter
numerował	Masculine
itrowi	None
żeńska	Feminine
namibijska	Feminine
dedykowana	Feminine
ciekawszych	Masculine
trwające	Neuter
umył	Masculine
wyłudza	None
wskazywaliśmy	Masculine
ukrywała	Feminine
nazywaliby	Masculine
ślepotą	None
oceniłem	Masculine
mola	None
mięczaków	None
pochodzili	Masculine
przekwitania	None
odraczając	None
dowiedzieliśmy	Masculine
ratowałbym	Masculine
przeleciały	None
fałszywych	Masculine
okropni	Masculine
podniesione	Neuter
garnek	None
gdyńskich	Masculine
otrzymywał	Masculine
wdepnęłoby	Neuter
kapitalistyczna	Feminine
obiecywani	Masculine
rzuca	None
czerwieńsi	Masculine
studiować	None
indoeuropejska	Feminine
rdzeniami	None
gapiłaby	Feminine
paliła	Feminine
superkomputera	None
zostawiona	Feminine
pisałem	Masculine
obrażał	Masculine
glinę	None
pozaskończonych	Masculine
milczała	Feminine
drukowałeś	Masculine
rozróżniali	Masculine
rządzili	Masculine
uczciwa	Feminine
halibutem	None
pierdziałoby	Neuter
łatami	None
zdementowaliby	Masculine
najtrudniejszych	Masculine
kierowałaby	Feminine
mieszalibyście	Masculine
sefardyjska	Feminine
limburskich	Masculine
nieprzyjemni	Masculine
tłumaczyłby	Masculine
elastycznych	Masculine
ukochanych	Masculine
zabijaj	None
podpalił	Masculine
rewolucyjnych	Masculine
burzyli	Masculine
kłamani	Masculine
odpowiadali	Masculine
mackach	None
ołtarzy	None
rażona	Feminine
wyniósł	Masculine
gwałcilibyśmy	Masculine
afiniczna	Feminine
dziwni	Masculine
uśpiony	Masculine
podkreślane	Neuter
saksofonista	None
myliliby	Masculine
buddyjskich	Masculine
zakonnicy	None
dumała	Feminine
antropologicznych	Masculine
dialektowi	None
jenami	None
dotknąłem	Masculine
pulpitami	None
uciekające	Neuter
architektoniczna	Feminine
więźniach	None
smutałabym	Feminine
uciekania	None
rozwijany	Masculine
rozważyłabym	Feminine
bakterię	None
zatrzymał	Masculine
filmoteki	None
pęknie	None
unicestwiłby	Masculine
kreatury	None
prowitamin	None
naprawiałaby	Feminine
anagramem	None
obserwowałam	Feminine
rozważyłbym	Masculine
spałaszowałaby	Feminine
kastrata	None
podkreślać	None
kardiologiczna	Feminine
jesionowych	Masculine
wspomnieni	Masculine
zabił	Masculine
mieszająca	Feminine
amfiteatrze	None
następnych	Masculine
zazdrośni	Masculine
potwierdzał	Masculine
waleta	None
zamężni	Masculine
wolniejsza	Feminine
pamiętali	Masculine
wampirowi	None
jarzmach	None
przedsionków	None
podchodziliście	Masculine
dżumie	None
miłosierdziu	None
Xboxów	None
genealogiczna	Feminine
oglądające	Neuter
czerpał	Masculine
maciczna	Feminine
carze	None
dawałaś	Feminine
atakowała	Feminine
jadaliśmy	Masculine
najodpowiedniejsza	Feminine
więcierzom	None
mieszkało	Neuter
sterowiec	None
umyłam	Feminine
płonące	Neuter
osobom	None
szaleni	Masculine
sterczące	Neuter
szyno	None
diamentowych	Masculine
telefonowałbym	Masculine
ryczał	Masculine
kozicę	None
krótsza	Feminine
aliteracyjna	Feminine
znajdowali	Masculine
gotowali	Masculine
uderzyłeś	Masculine
goliłyby	None
adekwatnych	Masculine
szczekałaś	Feminine
wykrzyknika	None
zapałkami	None
zostawiłeś	Masculine
budzące	Neuter
korzeniach	None
męskoosobowych	Masculine
temperatura	None
sprężynie	None
napisał	Masculine
wyniosła	Feminine
zakładnik	None
odkrytych	Masculine
absorbowała	Feminine
oskarżało	Neuter
podstawę	None
onirycznych	Masculine
nieskończona	Feminine
łudziła	Feminine
wymusiła	Feminine
ograniczona	Feminine
okrągłych	Masculine
nurkowaliby	Masculine
bajta	None
cięższych	Masculine
iglastych	Masculine
katabasów	None
zabiłeś	Masculine
antysemicka	Feminine
zwrotna	Feminine
zaczęły	None
wsparty	Masculine
lekarze	None
zapomniał	Masculine
zniszczony	Masculine
pochodził	Masculine
środę	None
lankijscy	Masculine
głosowaliśmy	Masculine
kartograficznych	Masculine
kleptomanii	None
postradana	Feminine
sterów	None
pieprzyliście	Masculine
obgadacie	None
napojowi	None
plansz	None
pojawiłeś	Masculine
przeciwni	Masculine
zbierałabym	Feminine
rzeczywistych	Masculine
najzabawniejszych	Masculine
prawi	Masculine
epicyklami	None
komentowali	Masculine
usunięta	Feminine
diodzie	None
robił	Masculine
najcięższych	Masculine
wybuchałem	Masculine
sport	None
obgadałeś	Masculine
bułgarscy	Masculine
kocich	Masculine
wawrzynu	None
krzyczała	Feminine
ojcach	None
słoneczna	Feminine
zamożniejszych	Masculine
kwartału	None
równi	Masculine
bandyci	None
pisałaś	Feminine
diagnozowani	Masculine
wyłączana	Feminine
broniłeś	Masculine
żołnierzami	None
nastawiony	Masculine
oświetlało	Neuter
różowawa	Feminine
topolowa	Feminine
zapamiętalibyśmy	Masculine
wywołany	Masculine
cyrkowych	Masculine
biochemiczna	Feminine
ule	None
dziobałam	Feminine
małżach	None
dodawałby	Masculine
marnowali	Masculine
afgańscy	Masculine
złożyłam	Feminine
wytłumaczyłbyś	Masculine
klękałeś	Masculine
metafizyczna	Feminine
poprawna	Feminine
iberyjskich	Masculine
nieżonatych	Masculine
częstochowscy	Masculine
zasilaczu	None
złupiona	Feminine
dusiłem	Masculine
otrzymywało	Neuter
męczył	Masculine
skazaliśmy	Masculine
ciekłabyś	Feminine
higieniczni	Masculine
składało	Neuter
bydgoscy	Masculine
połączył	Masculine
klawiaturami	None
mitologicznych	Masculine
kremu	None
barachła	None
choinka	None
studiowało	Neuter
spieprzyłbym	Masculine
płonęło	Neuter
znali	Masculine
półprostej	None
opatentowany	Masculine
schizofrenicznych	Masculine
Uzbeku	None
żułbyś	Masculine
wspominałeś	Masculine
chorzowska	Feminine
podziwiała	Feminine
współczynników	None
odradzałbym	Masculine
sterczyłybyście	None
szklanymi	None
kierowałam	Feminine
produkowałaby	Feminine
poruchalibyśmy	Masculine
telefonowalibyście	Masculine
uderzane	Neuter
kibicowałaby	Feminine
wstawionych	Masculine
zastanawiałeś	Masculine
sraliby	Masculine
stawiani	Masculine
dające	Neuter
bromowa	Feminine
zdiagnozowane	Neuter
potrzebowaliśmy	Masculine
etiopscy	Masculine
zmywarek	None
czytałem	Masculine
stypendium	None
szczepowi	Masculine
pochodnych	None
szmat	None
mitologiczna	Feminine
niszczył	Masculine
samodzielna	Feminine
jurajskich	Masculine
klonowi	Masculine
mszami	None
banglające	Neuter
liniowi	Masculine
rzeczoznawców	None
złożył	Masculine
wymyśliłoby	Neuter
rozpuszczeni	Masculine
łotrem	None
czyściłem	Masculine
uboższych	Masculine
cytowała	Feminine
wietrzna	Feminine
burzone	Neuter
rzucona	Feminine
kładł	Masculine
skalpeli	None
pożyczali	Masculine
pępku	None
sejsmometrowi	None
dzikich	Masculine
ksylofon	None
polowalibyśmy	Masculine
sardynka	None
konsularni	Masculine
fałszywka	None
wertykalnych	Masculine
sułtan	None
naprawiająca	Feminine
wymyślona	Feminine
portugalskich	Masculine
dowiedzieli	Masculine
rozczarowany	Masculine
ziębnąłem	Masculine
karzące	Neuter
potrzebowało	Neuter
uwiedziony	Masculine
zamachowcom	None
tłumacząca	Feminine
złożyły	None
gramofonach	None
miewał	Masculine
ginąca	Feminine
popierdolonych	Masculine
próbował	Masculine
trwało	Neuter
włócznię	None
czekany	None
podgrupami	None
prali	Masculine
rzadszych	Masculine
bezokolicznika	None
omanem	None
korozjami	None
idealizmie	None
szczurza	Feminine
ryczeliście	Masculine
najgłośniejsza	Feminine
skaczące	Neuter
szanowała	Feminine
służącej	None
remisy	None
białorzytka	None
majowa	Feminine
melonik	None
rządziła	Feminine
umawiała	Feminine
oskarżała	Feminine
groził	Masculine
zauważyłby	Masculine
niscy	Masculine
mydlnica	None
gdyńska	Feminine
podejrzewanie	None
przemytnicy	None
smacznych	Masculine
zachodnia	Feminine
uważałbym	Masculine
uliczek	None
uczestniczył	Masculine
zaniechał	Masculine
zamykali	Masculine
Żyda	None
sarkazm	None
serdeczna	Feminine
obrażeni	Masculine
ludzka	Feminine
rewolucyjna	Feminine
gaszące	Neuter
palmowych	Masculine
włodarzowi	None
samodzielnych	Masculine
wymogliście	Masculine
opuszczał	Masculine
zgubiła	Feminine
wdepnęłabyś	Feminine
dokonują	None
najwyższa	Feminine
zachodziła	Feminine
ogarniała	Feminine
śrubokrętów	None
ostrożni	Masculine
skróciłoby	Neuter
unia	None
budzili	Masculine
zwymyślałbym	Masculine
akcjonariuszem	None
chwilek	None
konkretnych	Masculine
zbiegałaby	Feminine
czynie	None
jakakolwiek	Feminine
grożące	Neuter
zamówiłam	Feminine
nękała	Feminine
pokazali	Masculine
posłańcowi	None
lizyny	None
dworkami	None
różniczkowalna	Feminine
ornitologa	None
niknął	Masculine
całkowitymi	None
straciliście	Masculine
Kanadyjki	None
islamscy	Masculine
odbudowałoby	Neuter
kocia	Feminine
półkolistych	Masculine
łamani	Masculine
himalajska	Feminine
wonieć	None
obiecywany	Masculine
wschodziło	Neuter
wskazane	Neuter
ekstremalna	Feminine
malarkach	None
biedniejsza	Feminine
trwałoby	Neuter
patyk	None
umierająca	Feminine
pełni	Masculine
heretycka	Feminine
nowości	None
słyszałeś	Masculine
prezerwatywę	None
Czirokezami	None
egoistycznych	Masculine
pocie	None
demontowane	Neuter
prezydentura	None
polityka	None
dodałabym	Feminine
chwaliła	Feminine
przeżyłbym	Masculine
brodziłbym	Masculine
burnusa	None
poprawiające	Neuter
zawiodła	Feminine
uszkodzona	Feminine
odrzuciłem	Masculine
podkreślali	Masculine
karaibscy	Masculine
anachroniczna	Feminine
posłuchał	Masculine
czułabyś	Feminine
lisia	Feminine
gumowa	Feminine
opatentowało	Neuter
szanowany	Masculine
zajączkom	None
dostarczała	Feminine
zauważyłbyś	Masculine
ukradłabym	Feminine
okoliczników	None
tlenowa	Feminine
poruchało	Neuter
usuwane	Neuter
obsesyjna	Feminine
gorąca	Feminine
szukało	Neuter
tłumaczona	Feminine
statywu	None
tracony	Masculine
idealizmem	None
dworzanin	None
ognioodpornych	Masculine
trzymałem	Masculine
pytające	Neuter
kręcone	Neuter
stawiające	Neuter
uderzyli	Masculine
czasze	None
sportach	None
licealistkom	None
minerały	None
księżycowa	Feminine
wisielibyśmy	Masculine
obraziła	Feminine
słuchało	Neuter
zmieniałem	Masculine
dodatkowa	Feminine
lubiło	Neuter
watykańska	Feminine
przezimowałam	Feminine
otruta	Feminine
szczupłymi	None
babilońskich	Masculine
kręcony	Masculine
animacjami	None
rosyjscy	Masculine
wykładnie	None
żyjąca	Feminine
ćwiczeni	Masculine
tętnica	None
widzieliśmy	Masculine
bałtyccy	Masculine
żonkil	None
przestrzegałem	Masculine
przeleciał	Masculine
jeździło	Neuter
eucharystyczna	Feminine
etapie	None
zantagonizowałyby	None
odraczałbyś	Masculine
kopana	Feminine
rakotwórcza	Feminine
kalin	None
dyskretnych	Masculine
magnetycznych	Masculine
przysięgając	None
wydmowa	Feminine
żywa	Feminine
jeździłabyś	Feminine
kolczatki	None
dzika	Feminine
rękawiczka	None
marzylibyśmy	Masculine
paskiem	None
konkurować	None
poprzedzałabym	Feminine
niebiańskich	Masculine
zastanawiało	Neuter
powtarzałabym	Feminine
potakiwacz	None
orla	Feminine
przyjemna	Feminine
podkreślany	Masculine
najbogatsi	Masculine
dyszelibyście	Masculine
krzyczenie	None
okrzemkami	None
darmowych	Masculine
transformatory	None
rządowa	Feminine
lękiem	None
parkowałyśmy	None
trzymali	Masculine
duszone	Neuter
podstawowych	Masculine
uwielbiany	Masculine
siarczanem	None
krowianko	None
pękająca	Feminine
krowom	None
uwiódł	Masculine
manometry	None
klarnetu	None
płacili	Masculine
uprawiało	Neuter
endorfiny	None
zwykli	Masculine
cofana	Feminine
wyznaczeni	Masculine
śliwę	None
cichych	Masculine
fortelowi	None
semantycznych	Masculine
stawiałoby	Neuter
sialibyście	Masculine
słynęło	Neuter
traktowali	Masculine
wiejące	Neuter
libańska	Feminine
starałabyś	Feminine
kinowych	Masculine
teorią	None
kaszlałaby	Feminine
dojrzeli	Masculine
robili	Masculine
numerycznych	Masculine
cytowali	Masculine
śmiałyście	None
łatwiejszych	Masculine
znajdowałaby	Feminine
unicestwił	Masculine
łączkach	None
bezrobotnych	Masculine
zapomniałam	Feminine
zimniejszych	Masculine
wspólnych	Masculine
kniaź	None
hibernację	None
ocaliłabyś	Feminine
skończyłaby	Feminine
wzięty	Masculine
poznała	Feminine
drukarniach	None
filmowałabyś	Feminine
sraliście	Masculine
najcichsi	Masculine
absorbujące	Neuter
naprawiałem	Masculine
wielościanów	None
ziębnęłabym	Feminine
kolekcjonowałeś	Masculine
proponująca	Feminine
zawiodłoby	Neuter
olane	Neuter
odczasownikowych	Masculine
zmieńcie	None
późniejsza	Feminine
deskorolce	None
edytowałabym	Feminine
zbiegało	Neuter
dowodziłem	Masculine
ciemion	None
woniała	Feminine
doceniała	Feminine
lepkich	Masculine
inteligentni	Masculine
znacząca	Feminine
spóźniona	Feminine
orna	Feminine
pośrednich	Masculine
koreańskich	Masculine
dbające	Neuter
izotopów	None
przekwitali	Masculine
tolerowane	Neuter
socjalistami	None
miewalibyśmy	Masculine
przyjmowało	Neuter
starali	Masculine
perfumerii	None
marnowalibyśmy	Masculine
Maju	None
podcasting	None
opatentowana	Feminine
strefa	None
kręgiel	None
martwiłaby	Feminine
przynoszone	Neuter
odbijane	Neuter
kładli	Masculine
oglądała	Feminine
zaniechany	Masculine
równoległa	Feminine
włosami	None
karząca	Feminine
podochodziłam	Feminine
puszczone	Neuter
zakochało	Neuter
wahałbym	Masculine
przestarzałych	Masculine
różniczkowa	Feminine
truskawkowa	Feminine
przelecieli	Masculine
składałaby	Feminine
wywołałeś	Masculine
przepraszałybyście	None
pilska	Feminine
harowałoby	Neuter
ćwiczone	Neuter
betonowane	Neuter
notowało	Neuter
przeszkadzaj	None
eksportował	Masculine
ściągałabyś	Feminine
zadałbym	Masculine
dawalibyście	Masculine
seminaryjnych	Masculine
listka	None
działające	Neuter
tapczanowi	None
poprzedzało	Neuter
komentująca	Feminine
kuchennych	Masculine
smyka	None
wskazany	Masculine
wyrządziła	Feminine
zabita	Feminine
zapomniany	Masculine
czyniła	Feminine
spieszyli	Masculine
modemów	None
zamówiony	Masculine
wędkarstwu	None
bohatyrnęłabyś	Feminine
ocalony	Masculine
zajawka	None
teatralnych	Masculine
goni	None
skowronkach	None
lodowisko	None
cycuszki	None
prawie	None
liderach	None
upartych	Masculine
wschodnia	Feminine
problematyczna	Feminine
podnosiła	Feminine
elfia	Feminine
ukrywał	Masculine
kwantach	None
pewnych	Masculine
kawału	None
przemyślało	Neuter
traktowana	Feminine
oddałeś	Masculine
znalazłeś	Masculine
magnetyczna	Feminine
zniszczyłby	Masculine
brata	None
zawarłaś	Feminine
zostawiło	Neuter
banalniejsza	Feminine
kwestionowana	Feminine
brudziliście	Masculine
oddawałem	Masculine
niepodległa	Feminine
ostrzy	Masculine
badani	Masculine
niespodziankami	None
zabity	Masculine
umawiał	Masculine
karnawałowych	Masculine
wynajęci	Masculine
cytowany	Masculine
używało	Neuter
nieśmiali	Masculine
tajałem	Masculine
wtorków	None
przeszkadzaliśmy	Masculine
Andorczycy	None
dziewczynkami	None
frezerami	None
przeprowadzany	Masculine
naukowa	Feminine
pełnych	Masculine
kosiarza	None
wybierali	Masculine
najpoważniejsza	Feminine
powtórzone	Neuter
modlitwom	None
potencjalna	Feminine
komorach	None
przypuściłabyś	Feminine
wyjęła	Feminine
kartezjańskich	Masculine
zaniechaj	None
niewystarczających	Masculine
marach	None
papieskich	Masculine
neonu	None
droższa	Feminine
zaniechali	Masculine
tracił	Masculine
związki	None
przeprowadzane	Neuter
etiopska	Feminine
delikatniejsza	Feminine
wołałaby	Feminine
pąków	None
akademiach	None
obelisku	None
macicami	None
zwycięstwie	None
wędrujące	Neuter
wygrało	Neuter
tragiczni	Masculine
Angolom	None
animacjach	None
straszni	Masculine
muchomor	None
znoszę	None
bretońskich	Masculine
rozpuszczalnych	Masculine
chcieliby	Masculine
uderzające	Neuter
bełtami	None
afinicznych	Masculine
taoizmem	None
wodoszczelna	Feminine
Słowaków	None
francuscy	Masculine
radiowozie	None
jaskrawa	Feminine
dachowa	Feminine
chrześcijańskich	Masculine
pisała	Feminine
połyka	None
lutowałbym	Masculine
należałeś	Masculine
bezalkoholowa	Feminine
ptaszkach	None
leczeni	Masculine
nadchodząca	Feminine
żałowaliśmy	Masculine
uwielbiali	Masculine
ludowych	Masculine
rzucał	Masculine
wymówiłaś	Feminine
wypędzeni	Masculine
pożycza	None
pamiętało	Neuter
kariery	None
sprzężony	Masculine
cwał	None
karali	Masculine
wykopiesz	None
hafnu	None
sadystycznych	Masculine
kartofle	None
napisany	Masculine
maszynie	None
lwia	Feminine
zdumiewająca	Feminine
jeżówko	None
napisałbyś	Masculine
doceniano	None
unicestwione	Neuter
chciało	Neuter
kartonowych	Masculine
powrozu	None
przegrana	Feminine
najebana	Feminine
tureckich	Masculine
zebrana	Feminine
wycieczki	None
opuszczała	Feminine
skarpet	None
przemyślał	Masculine
obrażali	Masculine
ściągająca	Feminine
komentowałyśmy	None
głosujące	Neuter
podatkowych	Masculine
berberyjscy	Masculine
puszczona	Feminine
jadowitych	Masculine
muzułmańscy	Masculine
Majówie	None
kupujące	Neuter
protestantyzmu	None
przekrojom	None
perukom	None
rozczarowane	Neuter
babilońska	Feminine
koptyjskich	Masculine
imponowała	Feminine
zasłużyłam	Feminine
truciznę	None
konsulacie	None
wygarnięte	Neuter
krakowscy	Masculine
niebiańscy	Masculine
wymówką	None
ziębnąłby	Masculine
wspomniałeś	Masculine
kanastach	None
diagnozowana	Feminine
wiekuista	Feminine
nieważna	Feminine
petentów	None
pożyczylibyście	Masculine
mgławicami	None
dzieciobójstwem	None
zamknęlibyśmy	Masculine
dzierżył	Masculine
usuwaliśmy	Masculine
złotonośnych	Masculine
analogowa	Feminine
dramatycznych	Masculine
bezpłatnych	Masculine
sprawdzane	Neuter
jedynaka	None
angielska	Feminine
publiczna	Feminine
zapomniałybyście	None
pewna	Feminine
diamentowa	Feminine
szarlotki	None
homoseksualni	Masculine
zastanawiałam	Feminine
dźwigał	Masculine
sąsiednia	Feminine
zapomniałbyś	Masculine
zmartwychwstawał	Masculine
drażniła	Feminine
bezsenna	Feminine
muzycznych	Masculine
czesząca	Feminine
siedziało	Neuter
przezimowałabym	Feminine
azbestowi	Masculine
ćwiczyliśmy	Masculine
zachciankę	None
ambulans	None
śledząca	Feminine
siusiałeś	Masculine
pogardliwa	Feminine
uśpię	None
wędrowali	Masculine
planowana	Feminine
serwetkom	None
burzyłam	Feminine
mieszkałby	Masculine
przeglądarko	None
zasługująca	Feminine
pomagające	Neuter
zamordował	Masculine
głosować	None
sprawdziła	Feminine
brzydkich	Masculine
psychosomatyczni	Masculine
pomagająca	Feminine
fizyczni	Masculine
siarkowa	Feminine
stalowych	Masculine
ludowa	Feminine
potwierdzeni	Masculine
słonicę	None
obojętni	Masculine
siadałam	Feminine
odraczałyście	None
bieżąca	Feminine
krzywoprzysięstwu	None
proponowałbyś	Masculine
wiałbyś	Masculine
kruchych	Masculine
puszczał	Masculine
genealogii	None
obrabowany	Masculine
wszystkożerna	Feminine
żyłbym	Masculine
mylona	Feminine
okazie	None
połowie	None
krupami	None
elektrochemiczna	Feminine
pędzili	Masculine
metalu	None
standardowa	Feminine
sądził	Masculine
spotkaliśmy	Masculine
zajebałyśmy	None
pojawił	Masculine
planszą	None
dochodzące	Neuter
koma	None
półfinałowych	Masculine
hydrostatycznych	Masculine
szóstkach	None
rodakowi	None
podchodziło	Neuter
aniliną	None
klasycystyczna	Feminine
gazowa	Feminine
pobożnych	Masculine
umyli	Masculine
robociznę	None
obwodnice	None
ornych	Masculine
pozwalałaby	Feminine
wylali	Masculine
najmilsi	Masculine
platanowa	Feminine
widziałeś	Masculine
opiekowało	Neuter
ospo	None
złapałybyście	None
pytani	Masculine
poczekałbym	Masculine
obalone	Neuter
analnych	Masculine
grzeszyłabym	Feminine
chciałby	Masculine
zwom	None
zarezerwował	Masculine
dostawało	Neuter
robociznami	None
agresywna	Feminine
przytuliła	Feminine
pękłeś	Masculine
kusił	Masculine
wyborczych	Masculine
dotknięty	Masculine
wyglądające	Neuter
wyuzdanych	Masculine
zjełczali	Masculine
hrabstwie	None
oderwanych	Masculine
kłuci	Masculine
chwilowa	Feminine
czynił	Masculine
prawdziwi	Masculine
wziąłeś	Masculine
bagnetami	None
aktualna	Feminine
dwujęzyczni	Masculine
zamordowaliśmy	Masculine
okazom	None
bystra	Feminine
wytryskiwałaby	Feminine
machałyście	None
przypuszczaliśmy	Masculine
umowa	None
zmienili	Masculine
wspomniałam	Feminine
ignoruje	None
siostrzana	Feminine
notowali	Masculine
nigeryjska	Feminine
korzystali	Masculine
cofało	Neuter
leczył	Masculine
hadronów	None
kompozytorami	None
sześciennych	Masculine
pokazywałby	Masculine
wywoływałam	Feminine
tlałyście	None
czułych	Masculine
nośników	None
zauważyliśmy	Masculine
czerwcowa	Feminine
krwistych	Masculine
wirusowych	Masculine
szkodzili	Masculine
siatce	None
samochodom	None
obowiązkiem	None
zaproszona	Feminine
obciążał	Masculine
najdalsza	Feminine
kupiło	Neuter
umówiłem	Masculine
mknęłoby	Neuter
grynszpanu	None
dziesiętna	Feminine
czytająca	Feminine
kwadratowych	Masculine
naw	None
granatowa	Feminine
edytowany	Masculine
sielankowa	Feminine
moczowa	Feminine
podnosiło	Neuter
panowała	Feminine
suszarki	None
dałeś	Masculine
długowieczna	Feminine
dziecinnych	Masculine
olejów	None
gasili	Masculine
nastawiona	Feminine
katastrofami	None
znalezieni	Masculine
chować	None
wydumana	Feminine
zapomniało	Neuter
brzęczelibyście	Masculine
gdańskich	Masculine
pozwalałam	Feminine
niepewnościom	None
wielorybami	None
huśtawkach	None
dodaliśmy	Masculine
jadeitu	None
wsparłby	Masculine
konkurowałoby	Neuter
okazane	Neuter
ochronna	Feminine
wylała	Feminine
korzystna	Feminine
najneutralniejsza	Feminine
temblakom	None
nurkująca	Feminine
unicestwieni	Masculine
wziąłby	Masculine
mylony	Masculine
nadzorowani	Masculine
niepoważna	Feminine
marychy	None
płotka	None
duchom	None
zadałam	Feminine
siewnikach	None
pomoce	None
wanadem	None
zbierana	Feminine
twardymi	None
subtropikalna	Feminine
szukała	Feminine
ptakami	None
znikał	Masculine
górnolotnych	Masculine
planszówek	None
zawodnikowi	None
pobrany	Masculine
jazzowych	Masculine
lakonicznymi	None
biustonoszem	None
zależnych	Masculine
skręcony	Masculine
wieprzowinę	None
główni	Masculine
lansujące	Neuter
jednoczesnych	Masculine
zabili	Masculine
otruli	Masculine
odpowiedzialnych	Masculine
ekipami	None
lipniejsza	Feminine
belgijscy	Masculine
darwinistów	None
prawidłowych	Masculine
zamordowało	Neuter
sprawdziłeś	Masculine
pocieszyła	Feminine
dręczyli	Masculine
bogata	Feminine
atakach	None
rozwiązani	Masculine
cofali	Masculine
zburzylibyście	Masculine
przelecieliśmy	Masculine
namawiana	Feminine
przysięgałybyście	None
duża	Feminine
podgrupom	None
architektem	None
strzelajcie	None
oddziały	None
ciekawska	Feminine
sapała	Feminine
ostrosłup	None
nadepnę	None
północnokoreańscy	Masculine
północnokoreańskich	Masculine
nagrywarkach	None
szczeliny	None
sprawdziło	Neuter
zasłużyli	Masculine
dziuplą	None
łapał	Masculine
wykrwawiony	Masculine
barbarzyńska	Feminine
pijał	Masculine
historycznych	Masculine
zaczynali	Masculine
dbałby	Masculine
kawiarenek	None
meksykańska	Feminine
tymczasowych	Masculine
śniliby	Masculine
bambusowa	Feminine
żyłeś	Masculine
bicza	None
odraczałaś	Feminine
grzmiąca	Feminine
siedziałaby	Feminine
zrzucili	Masculine
germańska	Feminine
chłopa	None
edytowała	Feminine
dojrzałych	Masculine
wyjątków	None
literacka	Feminine
zaufaliście	Masculine
oddana	Feminine
trapezy	None
ostrożniejsza	Feminine
ukochana	Feminine
bezbarwna	Feminine
twierdzili	Masculine
histeryczna	Feminine
wspieraniem	None
Czesi	None
delikatnych	Masculine
poznałem	Masculine
grzeczni	Masculine
ignorowało	Neuter
gier	None
dotknęłam	Feminine
duszona	Feminine
przedmową	None
niedostępni	Masculine
piskorze	None
poproszona	Feminine
luksusu	None
przeszkodą	None
krzyczące	Neuter
kradziona	Feminine
ubóstwialiśmy	Masculine
wschodzi	None
wpływowa	Feminine
kserowałbyś	Masculine
perły	None
raził	Masculine
siewca	None
trakcyjnych	Masculine
odczynić	None
betonowa	Feminine
popłochach	None
zrozumiano	None
scenarzystom	None
gwałcona	Feminine
gromadząca	Feminine
obalał	Masculine
dyktatura	None
zgniła	Feminine
nowoczesnych	Masculine
doprowadzające	Neuter
najlepsza	Feminine
gadały	None
bretońscy	Masculine
niemierzalnych	Masculine
widziany	Masculine
lewacka	Feminine
zamykała	Feminine
znalazł	Masculine
perska	Feminine
złom	None
ćwiczące	Neuter
rozwiązałaby	Feminine
legionistom	None
pachnących	Masculine
strzelał	Masculine
mijany	Masculine
uznawani	Masculine
zmieniało	Neuter
zadałoby	Neuter
sefardyjscy	Masculine
twierdzące	Neuter
niektórych	Masculine
rozmawialiby	Masculine
namawiała	Feminine
socjalistyczna	Feminine
unikaliśmy	Masculine
dziękowali	Masculine
spiąłeś	Masculine
lodom	None
kambodżańskich	Masculine
ślimakiem	None
obuliście	Masculine
dałaby	Feminine
najgrubsza	Feminine
obrabowałoby	Neuter
egzaminowali	Masculine
bumerang	None
czwóreczce	None
spodziewająca	Feminine
dramatu	None
zwyciężać	None
aktywista	None
wyniosłaby	Feminine
nowojorskich	Masculine
mięsna	Feminine
oracza	None
jajwata	Feminine
czytelników	None
zerwałbym	Masculine
burzące	Neuter
laskom	None
przyniosłaby	Feminine
paląca	Feminine
gdakało	Neuter
przestrzegana	Feminine
kapki	None
odbudowaliby	Masculine
kaktusowi	Masculine
poproszono	None
cząsteczek	None
szantażowalibyście	Masculine
czerwcami	None
słuchana	Feminine
eksperymencie	None
negocjowała	Feminine
gwałciłabyś	Feminine
tańcząca	Feminine
lutowane	Neuter
potwierdzające	Neuter
władzy	None
znikałby	Masculine
nagła	Feminine
dzisiejsza	Feminine
mackami	None
otrzymałaby	Feminine
dedykowany	Masculine
poprowadziłybyście	None
oddawana	Feminine
zrobilibyśmy	Masculine
wybrali	Masculine
starożytna	Feminine
droga	Feminine
chwalisz	None
metaforą	None
stawałbym	Masculine
czeska	Feminine
poprawiło	Neuter
zrobiliby	Masculine
wybieraliśmy	Masculine
deweloperze	None
demon	None
kapitalistycznych	Masculine
skrzyżowań	None
rozwiązał	Masculine
zrobiłabym	Feminine
mniejsza	Feminine
jadalni	Masculine
elektrycznych	Masculine
agresorem	None
jasnowidzeniu	None
krwawi	Masculine
aszkenazyjska	Feminine
niezrzeszona	Feminine
letnia	Feminine
wymyślałbyś	Masculine
pozwalał	Masculine
najbanalniejsi	Masculine
wahajcie	None
zapierdalałabyś	Feminine
ratowana	Feminine
czyścili	Masculine
zadałem	Masculine
filmowana	Feminine
Hiszpanka	None
karmił	Masculine
radościami	None
pilskich	Masculine
wszystkożernych	Masculine
żytnia	Feminine
głosowali	Masculine
zaprowadzili	Masculine
demokratyczni	Masculine
burundyjskich	Masculine
kapie	None
podpisał	Masculine
szwagrze	None
wracałyście	None
światem	None
technicznych	Masculine
meteorytami	None
moczyło	Neuter
namiętnościom	None
tenisowa	Feminine
radioaktywna	Feminine
szukałam	Feminine
nieprzygotowana	Feminine
wypędzony	Masculine
feniccy	Masculine
krzyczeli	Masculine
okazana	Feminine
lapońska	Feminine
mistycyzmowi	None
oglądałam	Feminine
rozwiązałby	Masculine
zarabiałbyś	Masculine
zjadło	Neuter
oddychające	Neuter
ujebałbyś	Masculine
trzymająca	Feminine
myślom	None
utleniłby	Masculine
autobiografiami	None
jabłkach	None
fosforowych	Masculine
nieodpowiednich	Masculine
klękało	Neuter
wyspiarzowi	None
medyczna	Feminine
dodawałabym	Feminine
wyglądaliby	Masculine
pobralibyście	Masculine
kanadyjskich	Masculine
odrzucił	Masculine
uznawałabym	Feminine
rozpuszczona	Feminine
śmieje	None
Koptowi	None
dodane	Neuter
ostrzegałem	Masculine
podnosząca	Feminine
ściągnięci	Masculine
dodatkowi	Masculine
drogowych	Masculine
kłute	Neuter
prała	Feminine
przeciętna	Feminine
strzelaniem	None
robiłem	Masculine
diablice	None
mordowania	None
przygotował	Masculine
kryptografii	None
pierwszych	Masculine
obiecywała	Feminine
tradycyjni	Masculine
połączyłbym	Masculine
podnosilibyście	Masculine
cytoplazmatyczna	Feminine
przestrzegająca	Feminine
lewicowi	Masculine
zdementowała	Feminine
potrzebowały	None
persymona	None
wiedźmo	None
bezprzewodowych	Masculine
autobiograficzna	Feminine
zamówiłem	Masculine
Francuzka	None
oczywiści	Masculine
jasnożółta	Feminine
burzył	Masculine
przyszłych	Masculine
kimali	Masculine
wyjaśniane	Neuter
wysocy	Masculine
wykorzystywane	Neuter
klasycystycznych	Masculine
seksualna	Feminine
obrót	None
właściwych	Masculine
bojami	None
globalnymi	None
piłeczka	None
pępka	None
najpotężniejszych	Masculine
pisał	Masculine
oświetlany	Masculine
elastyczna	Feminine
zacznę	None
mokrych	Masculine
kibicowali	Masculine
kursami	None
konkuruj	None
arystokratyczni	Masculine
piękna	Feminine
szczegółowa	Feminine
poiłoby	Neuter
wierzyłoby	Neuter
ortograficznych	Masculine
gardziłaby	Feminine
matematycznych	Masculine
starałeś	Masculine
burce	None
traktora	None
słodkowodnych	Masculine
wydziałów	None
czytałaby	Feminine
żartowalibyśmy	Masculine
powtórzyła	Feminine
żałowałaby	Feminine
świerzbu	None
radiowymi	None
gapiłam	Feminine
optyk	None
odchodzące	Neuter
winni	Masculine
głównych	Masculine
headshot	None
oświetlani	Masculine
widząca	Feminine
etapowi	None
ametystowa	Feminine
wniosków	None
igrała	Feminine
oszukiwany	Masculine
toksyczna	Feminine
platynowa	Feminine
spróbowałaś	Feminine
używałaś	Feminine
usługi	None
korzystając	None
zatrzymalibyśmy	Masculine
antycznych	Masculine
ukrywany	Masculine
mądrzejsi	Masculine
tajni	Masculine
zrozumiana	Feminine
pasożytnicza	Feminine
niezapomniani	Masculine
niedokonana	Feminine
dręczyć	None
ciemnoczerwonych	Masculine
polująca	Feminine
juliańska	Feminine
genowi	None
wysyłali	Masculine
chciana	Feminine
marycha	None
zakończeniach	None
traktowaliśmy	Masculine
minimalnych	Masculine
malowidłom	None
nosowych	Masculine
twardszych	Masculine
straciłam	Feminine
zgubieni	Masculine
tworzyli	Masculine
dzidami	None
próbowało	Neuter
zalogowania	None
sprawna	Feminine
zniszczeniom	None
leczyli	Masculine
zniszczyłaby	Feminine
odpowiadałbym	Masculine
przysłówki	None
pokazywała	Feminine
najszybsza	Feminine
ograniczonych	Masculine
księżycowi	Masculine
obszerniejsza	Feminine
szkiców	None
butany	None
wylaliśmy	Masculine
usunięci	Masculine
tatarami	None
chroniło	Neuter
mianownikowi	None
angolskich	Masculine
tolerowani	Masculine
sfałszowałbym	Masculine
języczkowa	Feminine
biedna	Feminine
przeżył	Masculine
zamężna	Feminine
bezrobotna	Feminine
dymnych	Masculine
nikczemna	Feminine
marznęłabyś	Feminine
gołych	Masculine
krokiety	None
najdzielniejszych	Masculine
przymiotu	None
szmaragdu	None
właściwsza	Feminine
refowałeś	Masculine
skrzydełkami	None
zaprosiła	Feminine
usuwało	Neuter
ody	None
wisieliście	Masculine
fosami	None
taczce	None
słoniny	None
numerowałem	Masculine
machałbyś	Masculine
gwiżdżąca	Feminine
zadzwoniłam	Feminine
tenisowi	Masculine
hamowałbym	Masculine
telegrafowałaś	Feminine
winogronowych	Masculine
robione	Neuter
powolna	Feminine
wskazali	Masculine
kanonizację	None
mlasków	None
wiosłowano	None
zdementowana	Feminine
wspominani	Masculine
błyskaliby	Masculine
elementarna	Feminine
bliżsi	Masculine
słabsza	Feminine
trojańska	Feminine
Holenderce	None
zarezerwowane	Neuter
poprzedzali	Masculine
albom	None
Kanadyjczyk	None
odkryłam	Feminine
najzamożniejsi	Masculine
odbudowana	Feminine
borowiny	None
zeszytem	None
biochemicznymi	None
najzwyklejsza	Feminine
majsterkowała	Feminine
narciarska	Feminine
bezsenni	Masculine
poprawiła	Feminine
jonizujące	Neuter
wyjaśniałem	Masculine
wpływowi	Masculine
średniowiecznych	Masculine
dwuwymiarowych	Masculine
różnowartościowa	Feminine
przekłamań	None
zrobiłaby	Feminine
hamowała	Feminine
ligustru	None
kościom	None
jedyneczko	None
wrednych	Masculine
stygną	None
mierzony	Masculine
zniknęłabyś	Feminine
żywi	Masculine
wymyślałem	Masculine
upuszczony	Masculine
śpiewająca	Feminine
skrzynią	None
straci	None
termometrów	None
uderzyła	Feminine
cytrynce	None
wybraliście	Masculine
hektarów	None
aglutynacyjnych	Masculine
świadomi	Masculine
porzekadłach	None
szelki	None
zawierania	None
jaguarem	None
fizyce	None
poprawiane	Neuter
esemesowałam	Feminine
chińska	Feminine
różniczkowi	Masculine
dalsza	Feminine
krzemowych	Masculine
potrzebujesz	None
wyjaśniałby	Masculine
skamieniałość	None
akuszerka	None
spadkiem	None
samarytańska	Feminine
lekarstwach	None
ładowałabyś	Feminine
spróbowali	Masculine
pojmujemy	None
śmierdzieć	None
oceniła	Feminine
zatrzymałaś	Feminine
ocenieni	Masculine
żywopłotów	None
walet	None
turami	None
kwiliłabym	Feminine
szczerzyłaś	Feminine
pojawiałabyś	Feminine
wywoływaniu	None
pomagała	Feminine
złapał	Masculine
uboższa	Feminine
szanujące	Neuter
makaronach	None
igra	None
krzyży	None
ciemniejszych	Masculine
runęliście	Masculine
archidiecezjach	None
zmyślony	None
farmo	None
wdychana	Feminine
kłująca	Feminine
ruszali	Masculine
skłamałby	Masculine
doprowadzają	None
nieprzewidywalna	Feminine
umiaru	None
konsularnych	Masculine
hamujące	Neuter
broniłbym	Masculine
skrócona	Feminine
smakowało	Neuter
rodzajnika	None
kilometrach	None
znaczyła	Feminine
skróciło	Neuter
lodowcom	None
ostrzegająca	Feminine
latarce	None
gniada	Feminine
najsilniejszych	Masculine
nijaka	Feminine
twory	None
pszenicznych	Masculine
magicznych	Masculine
najatrakcyjniejsza	Feminine
naziolami	None
wyniósłby	Masculine
hebrajska	Feminine
namawiał	Masculine
dwuwymiarowi	Masculine
spadające	Neuter
radioaktywnych	Masculine
zdiagnozowani	Masculine
śniłby	Masculine
podkradalibyście	Masculine
ukradziony	Masculine
lekkich	Masculine
dysydenta	None
wyświetlał	Masculine
mikrofonem	None
lewymi	None
szczerząc	None
skracające	Neuter
znałby	Masculine
opisywałby	Masculine
wieczni	Masculine
liliowa	Feminine
włączać	None
używałeś	Masculine
pilnikiem	None
rodzona	Feminine
kosiarkę	None
śmieszna	Feminine
kompakcie	None
iglaści	Masculine
sudeckich	Masculine
zadzwonił	Masculine
granicznych	Masculine
podrywałbym	Masculine
domniemani	Masculine
dwuwymiarowa	Feminine
mandżurskich	Masculine
potrawami	None
przepraszając	None
Albankom	None
oświetlane	Neuter
nikotynowa	Feminine
glacjalna	Feminine
erotycznych	Masculine
spora	Feminine
lesba	None
zielonkawa	Feminine
piersiach	None
podziemni	Masculine
skakała	Feminine
zajętych	Masculine
posłuchałem	Masculine
głośnik	None
nadzorowała	Feminine
armeńscy	Masculine
drobiazgi	None
pieprzyłam	Feminine
czeremsze	None
planujące	Neuter
odpowiedzialni	Masculine
wyjaśniłem	Masculine
sąsiedzkich	Masculine
życzyłbym	Masculine
upuścił	Masculine
znika	None
drżące	Neuter
cywilnych	Masculine
kopiowałaś	Feminine
szalonych	Masculine
kont	None
pochodziliśmy	Masculine
dopływy	None
cedząca	Feminine
rannych	Masculine
nadzwyczajnych	Masculine
karmiłeś	Masculine
iniekcjach	None
tworzyłabym	Feminine
ładna	Feminine
radiofoniczni	Masculine
przeinaczyliście	Masculine
podchodziłem	Masculine
mamutów	None
śmieszkowałaby	Feminine
republik	None
chronieni	Masculine
zachowałeś	Masculine
dożyło	Neuter
białka	None
opatentowani	Masculine
hartu	None
ruchem	None
lubiłem	Masculine
nowotestamentowych	Masculine
złapane	Neuter
dermatologom	None
rażące	Neuter
pozwalałby	Masculine
gasząc	None
logarytmicznych	Masculine
emocjonalnych	Masculine
pilniejszych	Masculine
szantażował	Masculine
poprawiłam	Feminine
alkoholowych	Masculine
potęgą	None
korzystał	Masculine
ambasad	None
przyciskach	None
podnoszące	Neuter
zadał	Masculine
drgaliście	Masculine
najgorsi	Masculine
austriaccy	Masculine
cofałem	Masculine
wpływał	Masculine
rychlejsi	Masculine
połknąłbyś	Masculine
humorystyczna	Feminine
kropla	None
gliwicka	Feminine
teoretycznych	Masculine
nieznośna	Feminine
indonezyjskich	Masculine
zadzwoniłaby	Feminine
orliki	None
zwyciężała	Feminine
okazu	None
czyniłoby	Neuter
najdroższych	Masculine
wyłączalibyście	Masculine
zimowi	Masculine
dodaję	None
kameruńskich	Masculine
dzierżyli	Masculine
wymogli	Masculine
przyrodnicza	Feminine
scholastyczna	Feminine
ściągnęło	Neuter
cebula	None
kanałami	None
obiecywałem	Masculine
stroiki	None
pocztowych	Masculine
czcza	Feminine
kolorowych	Masculine
chromem	None
karmieni	Masculine
biernych	Masculine
przydupasów	None
rzutom	None
zachował	Masculine
sypał	Masculine
warta	Feminine
odpowiadało	Neuter
ogromni	Masculine
dowiedziało	Neuter
kursom	None
trakcyjna	Feminine
siejbo	None
sprzętami	None
wyłudziłaby	Feminine
uratowało	Neuter
zrzucił	Masculine
maszynach	None
bywała	Feminine
smażona	Feminine
japońscy	Masculine
czytali	Masculine
blokom	None
zrozumiałam	Feminine
próbowali	Masculine
odbudowali	Masculine
odbijana	Feminine
siarkowych	Masculine
aparat	None
osądów	None
nietypowych	Masculine
seksualni	Masculine
tworzyło	Neuter
sześcienna	Feminine
stracił	Masculine
szyna	None
trakcja	None
opowiadałbym	Masculine
uprawiała	Feminine
esencjami	None
kumałam	Feminine
otyłych	Masculine
odwrotnościom	None
obudowy	None
wyjaśniała	Feminine
negocjowalibyśmy	Masculine
alpagi	None
wozowi	None
akrobatycznych	Masculine
saksońskich	Masculine
wyznaczył	Masculine
batyskaf	None
nadepnęli	Masculine
pluszowych	Masculine
sfałszowała	Feminine
głośnych	Masculine
transkrypcyjnych	Masculine
wróżkę	None
donicami	None
ratująca	Feminine
algorytmem	None
opolscy	Masculine
jeździłam	Feminine
namiętności	None
silniejsza	Feminine
teatralni	Masculine
mieszany	Masculine
uczące	Neuter
pokazały	None
boscy	Masculine
więzłam	Feminine
broniony	Masculine
filc	None
aktywistami	None
schowkiem	None
poprawiłbym	Masculine
szerszenie	None
brudnych	Masculine
uciekająca	Feminine
anagramu	None
sypaliby	Masculine
cienia	None
dotykała	Feminine
kochana	Feminine
adwersarzom	None
pojawiłoby	Neuter
fistaszki	None
glacjalni	Masculine
logopedyczna	Feminine
wapna	None
cyborgi	None
roztargniona	Feminine
kryli	Masculine
szowinizmu	None
bezchmurnych	Masculine
świadoma	Feminine
lutowało	Neuter
słyszeliby	Masculine
identyfikowało	Neuter
płacące	Neuter
spałaszowalibyśmy	Masculine
ważni	Masculine
nękane	Neuter
gwałcili	Masculine
zapłaciła	Feminine
luminoforu	None
potwierdzało	Neuter
najsilniejsi	Masculine
należały	None
rozważył	Masculine
urlopów	None
socjalistycznych	Masculine
negocjujesz	None
fermionowych	Masculine
hostie	None
widziałabym	Feminine
ignorowali	Masculine
śpieszyły	None
konkretna	Feminine
koptyjscy	Masculine
pietruszce	None
odpoczywająca	Feminine
ryczą	None
siało	Neuter
wymagające	Neuter
zmarłymi	None
nosiła	Feminine
melodiami	None
doprowadzała	Feminine
geometryczni	Masculine
przyjąłeś	Masculine
jodłowa	Feminine
dokonywała	Feminine
Ukraińcem	None
humorystycznych	Masculine
wizytówce	None
ciągłych	Masculine
fantastycznych	Masculine
wykitowałabyś	Feminine
syci	Masculine
tańsza	Feminine
kimałbyś	Masculine
wyjaśniało	Neuter
srająca	Feminine
mądrych	Masculine
odporności	None
żałowałem	Masculine
urodziłbyś	Masculine
grawitacyjnych	Masculine
ładowany	Masculine
fałszerstwem	None
borowinie	None
mrugałabyś	Feminine
czapka	None
guawo	None
tworzony	Masculine
wielokropek	None
oślice	None
ustępstwo	None
wyłaby	Feminine
przeszkód	None
śmiałby	Masculine
rozczarował	Masculine
odpowiedzialna	Feminine
zabrane	Neuter
wstrząsami	None
chloranowi	None
posiłku	None
runą	None
stawała	Feminine
kombinezonem	None
nieoficjalna	Feminine
czasówką	None
liściastych	Masculine
mierzili	Masculine
narzekała	Feminine
gromadzenie	None
usuwająca	Feminine
rażąca	Feminine
wydupczone	Neuter
spragnieni	Masculine
krajan	None
zgubiłem	Masculine
tworzyłby	Masculine
wiadomością	None
kawiorem	None
skórzana	Feminine
kwestionujące	Neuter
francuska	Feminine
przekomarzałbym	Masculine
kurdyjscy	Masculine
ignorowała	Feminine
dolnołużyckich	Masculine
butikami	None
wypędziło	Neuter
telewizyjnych	Masculine
uprzedziłem	Masculine
sprawiała	Feminine
riposta	None
wulkaniczna	Feminine
słomiani	Masculine
wynajęta	Feminine
myta	Feminine
ćwiczona	Feminine
grzebała	Feminine
karmiliby	Masculine
pomysłowych	Masculine
rozbieżna	Feminine
kłód	None
dochodzone	Neuter
dalekimi	None
piano	None
lśniących	Masculine
swastyki	None
niemych	Masculine
monarchisto	None
twardzi	Masculine
planowaniu	None
trącona	Feminine
zmieniłbym	Masculine
podniosłaś	Feminine
okrutniejsza	Feminine
czytające	Neuter
nienaturalnych	Masculine
szkodziła	Feminine
opisująca	Feminine
brzęczałeś	Masculine
bębnił	Masculine
legioniści	None
jabłek	None
wyrządziły	None
negocjująca	Feminine
wyniesiona	Feminine
łyka	None
brazylijskich	Masculine
spotkałeś	Masculine
rozbiłem	Masculine
zbyta	Feminine
radiofonicznych	Masculine
ozdobnych	Masculine
studiowała	Feminine
ujadało	Neuter
nieokreślonych	Masculine
przekomarzałbyś	Masculine
fasadach	None
selerowi	Masculine
czytałeś	Masculine
wołałybyście	None
spuszczone	Neuter
iberyjska	Feminine
diodą	None
wzięło	Neuter
zweryfikowali	Masculine
teraźniejsza	Feminine
terrorystycznych	Masculine
jednokierunkowych	Masculine
ufałybyście	None
aglomeracjom	None
dręczona	Feminine
mądrzałybyście	None
karna	Feminine
koszulek	None
norweskich	Masculine
magnezowa	Feminine
zniknęła	Feminine
śmiejąca	Feminine
zapłaciłem	Masculine
dwuwargowa	Feminine
kwiląca	Feminine
opatentowaliby	Masculine
ostrych	Masculine
naparstnicach	None
przymiotnik	None
wyłączały	None
zrozumieli	Masculine
lalkom	None
napierdalacie	None
szermierka	None
nieodpowiednia	Feminine
grożąca	Feminine
schlebiamy	None
kieliszek	None
kupiliśmy	Masculine
jedwabnych	Masculine
żurom	None
zaganiaczu	None
gnani	Masculine
spadałbym	Masculine
czyniąca	Feminine
rozproszyli	Masculine
chaotyczna	Feminine
szczuł	Masculine
uważające	Neuter
piszą	None
jagnięcych	Masculine
prezydent	None
kaszmirze	None
wdepnął	Masculine
mięśni	Masculine
obszar	None
zweryfikowane	Neuter
pisałby	Masculine
dymałeś	Masculine
przedsiębiorca	None
zmieniałeś	Masculine
panowalibyście	Masculine
browce	None
odbierani	Masculine
spółgłoskach	None
jagnięca	Feminine
ruszyli	Masculine
zabrany	Masculine
wyrzuciłbym	Masculine
zjedzona	Feminine
komentowana	Feminine
łysych	Masculine
analizowało	Neuter
edytująca	Feminine
powolnych	Masculine
walko	None
połykałoby	Neuter
brodawnikach	None
raciborscy	Masculine
impresjonizm	None
dolnołużycka	Feminine
rozgrzeszylibyśmy	Masculine
chłeptały	None
filtrów	None
potrzebnych	Masculine
zainsynuował	Masculine
bagażniki	None
przyjmował	Masculine
wspominało	Neuter
zwyciężało	Neuter
oceniłybyśmy	None
rzekłby	Masculine
wspaniałych	Masculine
wachą	None
krakowska	Feminine
najpiękniejsi	Masculine
oddałam	Feminine
roślinożerna	Feminine
ciężarnych	Masculine
kupował	Masculine
księgowo	None
owadzich	Masculine
nowojorscy	Masculine
tworzenie	None
zadałby	Masculine
ocenia	None
męczylibyście	Masculine
zdiagnozowało	Neuter
najwęższych	Masculine
zbożowych	Masculine
młodych	Masculine
strąków	None
przedostatnia	Feminine
jeździli	Masculine
otrzymałam	Feminine
nokautach	None
apelację	None
zaczekał	Masculine
nawozu	None
ufało	Neuter
oddał	Masculine
podrywająca	Feminine
szewska	Feminine
poligamistko	None
zoogeografii	None
tropikalnych	Masculine
rządząca	Feminine
zauważone	Neuter
kwiatowymi	None
odrzucona	Feminine
pedantyczna	Feminine
ekwilibrystką	None
czekające	Neuter
pszenżyto	None
nazywałem	Masculine
plonie	None
proponowałbym	Masculine
eksportowałabyś	Feminine
najpiękniejsza	Feminine
wymyślał	Masculine
sprzyjał	Masculine
pajęczyny	None
półfinałowa	Feminine
wykopalibyście	Masculine
wymiernych	Masculine
kołach	None
nęcąca	Feminine
najaktywniejsza	Feminine
częściowa	Feminine
przemytem	None
puszczany	Masculine
dodało	Neuter
polujące	Neuter
dająca	Feminine
spotkałem	Masculine
wodospadami	None
rzeczą	None
orkę	None
sprawdzali	Masculine
abonujemy	None
kupkami	None
lądowiskom	None
polowalibyście	Masculine
plażom	None
gaszeni	Masculine
tancerzach	None
najnowszych	Masculine
altruistycznych	Masculine
uczyłem	Masculine
rozbitkowie	None
rozproszyła	Feminine
strzelająca	Feminine
zakazałoby	Neuter
rosą	None
najemcy	None
aramejskich	Masculine
etanami	None
obgadaliśmy	Masculine
dusiła	Feminine
meteoryty	None
otrzymywane	Neuter
niszcząca	Feminine
religijna	Feminine
uznawane	Neuter
niezależnych	Masculine
niewymiernych	Masculine
zaprowadzona	Feminine
hasały	None
duchowych	Masculine
gadają	None
jednostkach	None
adeptami	None
powojenna	Feminine
doiłaś	Feminine
badali	Masculine
północnokoreańska	Feminine
publicznymi	None
gazetach	None
płacona	Feminine
cypryjscy	Masculine
uwiedliście	Masculine
latałbyś	Masculine
niemi	Masculine
ładowałem	Masculine
wiałem	Masculine
ciała	None
bawarscy	Masculine
kwazicząstkami	None
słodkich	Masculine
zrobili	Masculine
tęsknił	Masculine
sporych	Masculine
zerwała	Feminine
wybuchająca	Feminine
zdobiło	Neuter
podchodzące	Neuter
absurdalna	Feminine
złupili	Masculine
wahali	Masculine
dumaliby	Masculine
prostokątnych	Masculine
deszczowa	Feminine
przytuliłybyście	None
szopą	None
opisywało	Neuter
numerowany	Masculine
północnych	Masculine
przesadzał	Masculine
dowolna	Feminine
jazzowa	Feminine
grzywka	None
najlżejszych	Masculine
marzył	Masculine
estońska	Feminine
badana	Feminine
ciągnikom	None
rzucony	Masculine
rezusami	None
podziwiali	Masculine
mechanizmom	None
bredziło	Neuter
rozwiązana	Feminine
wymagana	Feminine
najebanych	Masculine
dożywotnich	Masculine
macica	None
modliło	Neuter
mylili	Masculine
idealnych	Masculine
przeinaczyłeś	Masculine
płotki	None
konkurowały	None
barwniejszych	Masculine
pigwie	None
wybieranie	None
ocaliłoby	Neuter
delikatniejszych	Masculine
szpakiem	None
łożu	None
ukryte	Neuter
cedziły	None
błądzące	Neuter
najpłytszych	Masculine
niższa	Feminine
szpilkach	None
siostrzenicą	None
chcielibyście	Masculine
wracałem	Masculine
brudzi	None
zburzyło	Neuter
maszerowałbym	Masculine
arytmetycznych	Masculine
gadająca	Feminine
dawnych	Masculine
kolejowa	Feminine
połknięty	Masculine
poważni	Masculine
weterynarze	None
kostarykańskich	Masculine
niewinni	Masculine
usuwające	Neuter
rozmawiali	Masculine
fotki	None
rozkazów	None
zaczynaliśmy	Masculine
zamykające	Neuter
bezzębna	Feminine
cieszyńskich	Masculine
urolog	None
spadałem	Masculine
śniąca	Feminine
wpływowych	Masculine
ofiary	None
zapłacił	Masculine
zaprzeczyło	Neuter
dekoracyjna	Feminine
rodzenie	None
romansidłami	None
szczęki	None
tragedii	None
wioską	None
nigeryjscy	Masculine
tropiku	None
entalpia	None
graniczyło	Neuter
niewystarczająca	Feminine
zaciążył	Masculine
obrażony	Masculine
hamburgerów	None
kwestionują	None
starotestamentowi	Masculine
łokciu	None
dekado	None
gaście	None
skręcone	Neuter
uczęszczała	Feminine
skazało	Neuter
nazywające	Neuter
śląscy	Masculine
szarawych	Masculine
prowitaminami	None
monarchistach	None
umarłem	Masculine
octanu	None
neutronów	None
udręczeni	Masculine
przekomarzałaś	Feminine
działane	Neuter
legionami	None
chłamem	None
ulubionych	Masculine
trawy	None
płatna	Feminine
mądrzyliby	Masculine
borowych	Masculine
odkrywała	Feminine
neutralna	Feminine
gwizdać	None
kabaretu	None
konsensusów	None
przegraliśmy	Masculine
piękni	Masculine
wylało	Neuter
kursach	None
kolorowi	Masculine
ćpając	None
choinkę	None
nieprzygotowanych	Masculine
jamajscy	Masculine
domniemana	Feminine
szklana	Feminine
kile	None
wahająca	Feminine
oporników	None
windo	None
biurowych	Masculine
pokonałby	Masculine
pęknięta	Feminine
zastanawiające	Neuter
denerwujące	Neuter
tkaczki	None
wskazała	Feminine
pacynką	None
czułbym	Masculine
karawanami	None
chatka	None
podchodził	Masculine
urodzinowymi	None
dzieciobójstwach	None
zabijała	Feminine
doceniają	None
obozów	None
przeliczalnych	Masculine
oddawane	Neuter
ciasnych	Masculine
czekająca	Feminine
kardiologicznych	Masculine
kąsałem	Masculine
pajęczyno	None
łudziliśmy	Masculine
alkoholowi	Masculine
wielojęzyczni	Masculine
upadku	None
siadałbym	Masculine
chowała	Feminine
częściowych	Masculine
politeistycznych	Masculine
wypędzili	Masculine
szpadle	None
migdałowych	Masculine
jednorazowych	Masculine
broniące	Neuter
oniryczna	Feminine
goście	None
jednobarwna	Feminine
archidiecezje	None
analiz	None
grzeszyli	Masculine
oceniała	Feminine
moczone	Neuter
leniwych	Masculine
śpiewające	Neuter
napowietrzyłabyś	Feminine
portugalscy	Masculine
muzyczni	Masculine
mydłem	None
skąpych	Masculine
kawałkami	None
podnosiłem	Masculine
kostnicy	None
rzecznych	Masculine
jasnozieloni	Masculine
ukryli	Masculine
podpalona	Feminine
zniszczyło	Neuter
rozwiązałbyś	Masculine
niepozorna	Feminine
głębsza	Feminine
umowach	None
unikająca	Feminine
złupiony	Masculine
padaliście	Masculine
nieczytelna	Feminine
moczowych	Masculine
obiektywem	None
wiosennych	Masculine
patyną	None
płynące	Neuter
zawarłoby	Neuter
młyn	None
podwójni	Masculine
skończeniewymiarowa	Feminine
przekwitaniu	None
grypa	None
wysiadł	Masculine
przeprosił	Masculine
bośniackich	Masculine
pisaliby	Masculine
wyjęlibyście	Masculine
pieluch	None
pisałeś	Masculine
ogarniał	Masculine
ateista	None
adopcją	None
pijałbyś	Masculine
bratków	None
przestrzenna	Feminine
zdobiony	None
grabem	None
morsa	None
puenta	None
sanitariusz	None
wymiksowali	Masculine
wyświetlające	Neuter
ekologicznych	Masculine
heheszek	None
anagramy	None
narzekałabyś	Feminine
maszerowały	None
błoń	None
straciłeś	Masculine
złapani	Masculine
drewniana	Feminine
trenerem	None
pytaniu	None
najpełniejsza	Feminine
pannach	None
leworęczni	Masculine
koronką	None
niejawna	Feminine
dupek	None
mądrzy	Masculine
przeprowadzać	None
wierzyła	Feminine
sporadycznych	Masculine
trzaska	None
zwyciężałam	Feminine
kasztanie	None
poniemieckich	Masculine
trzebiliśmy	Masculine
stolicy	None
odradzała	Feminine
znała	Feminine
znalazła	Feminine
analfabetą	None
kutas	None
haremowi	None
części	Masculine
opolska	Feminine
podziwiałybyście	None
wymuszony	Masculine
negocjował	Masculine
śniłbym	Masculine
absurdyzm	None
łęku	None
łużyccy	Masculine
dowiedziałam	Feminine
sępy	None
ujadalibyście	Masculine
maskujące	Neuter
działałoby	Neuter
czosnaczkowi	None
rąbaliśmy	Masculine
psychoterapeutów	None
bezdźwięczna	Feminine
brzęczeli	Masculine
kotłownię	None
żebrakowi	None
przynoszony	Masculine
wojenna	Feminine
cedziłabyś	Feminine
odrzuciła	Feminine
strefą	None
koronka	None
centralnych	Masculine
zostawiłam	Feminine
oglądało	Neuter
powtórzyłem	Masculine
ściągnęli	Masculine
różniczkowalnych	Masculine
czwórka	None
śledzeni	Masculine
meksykańskich	Masculine
absorbował	Masculine
najdrapieżniejsi	Masculine
fotograficznych	Masculine
krakało	Neuter
dostawałaś	Feminine
zweryfikował	Masculine
kupowałaby	Feminine
rzucająca	Feminine
podkreślająca	Feminine
podświadoma	Feminine
współczesna	Feminine
berberyjska	Feminine
podziwiany	Masculine
pokrzywie	None
wydrą	None
dłutami	None
nienaturalna	Feminine
mokra	Feminine
ług	None
krytyczni	Masculine
kradła	Feminine
globalna	Feminine
okrucieństwie	None
utleniłeś	Masculine
biskupach	None
zamknęliście	Masculine
fermionów	None
uważałem	Masculine
najważniejszych	Masculine
tajska	Feminine
pospolitych	Masculine
dostarczali	Masculine
wschodziła	Feminine
bliskowschodnia	Feminine
choinkami	None
rozumniejsi	Masculine
zabójstwom	None
wyrazami	None
numerowałeś	Masculine
zarobionych	Masculine
bombach	None
przytuliłabyś	Feminine
umarłe	Neuter
tancerce	None
potwierdzony	Masculine
rzeczna	Feminine
czytaliśmy	Masculine
pojmowałaś	Feminine
opowiadało	Neuter
puchaczem	None
miesiączkowi	Masculine
uwielbiająca	Feminine
spał	Masculine
widzielibyśmy	Masculine
czereśnie	None
chwiejemy	None
kupiona	Feminine
stawiałbym	Masculine
posagowi	None
ściągany	Masculine
arkadą	None
afirmacje	None
spróbowany	Masculine
używałam	Feminine
szczerzyłoby	Neuter
podałaś	Feminine
muzyków	None
odbijał	Masculine
macedońskich	Masculine
armia	None
antonimów	None
spójna	Feminine
stroika	None
ścienna	Feminine
cegiełek	None
polscy	Masculine
formalna	Feminine
parowozy	None
wsparli	Masculine
hipopotamowi	None
żebrakami	None
kuźnia	None
marszałków	None
miewani	Masculine
obgadałem	Masculine
bezsennych	Masculine
parują	None
rozróżniłeś	Masculine
jelenich	Masculine
powszechniejsza	Feminine
chroniące	Neuter
urugwajska	Feminine
palone	Neuter
żołnierskich	Masculine
narzekali	Masculine
skrzydlaci	Masculine
fonetycznych	Masculine
satrapą	None
kłułyśmy	None
kopiowała	Feminine
regularna	Feminine
chemicznych	Masculine
zjedli	Masculine
wskazująca	Feminine
zapłacona	Feminine
przeinaczone	Neuter
Rosjanie	None
przynosiłoby	Neuter
brudziłabym	Feminine
teoretyczna	Feminine
czerpana	Feminine
zrabowana	Feminine
interpunkcyjnych	Masculine
kolekcjonowała	Feminine
wzajemnych	Masculine
upiorach	None
ambiwalentna	Feminine
gęsta	Feminine
pracowniku	None
fonetyczkom	None
empirycznych	Masculine
zszywce	None
organizowała	Feminine
zgubiony	Masculine
organizmami	None
pożądana	Feminine
krany	None
najjaśniejsi	Masculine
populistycznych	Masculine
pierścieniu	None
gało	None
obciążamy	None
nadużywali	Masculine
władco	None
diagnozowałby	Masculine
podałbym	Masculine
łotewskich	Masculine
dochodziliście	Masculine
radosna	Feminine
opisywał	Masculine
wpływające	Neuter
znajdował	Masculine
jawiłybyście	None
skręciliby	Masculine
znał	Masculine
wybierzecie	None
traktująca	Feminine
wygrani	Masculine
słoni	Masculine
owocowa	Feminine
poznane	Neuter
dłuższa	Feminine
przyniesiony	Masculine
hawajska	Feminine
strażnika	None
siarczan	None
odrzucone	Neuter
odwiedzana	Feminine
mordowała	Feminine
dyszy	None
wspaniali	Masculine
ogórkowa	Feminine
szachownice	None
ściągało	Neuter
przykładów	None
rozróżniała	Feminine
skończyłem	Masculine
jedyni	Masculine
przezimował	Masculine
komputerowi	Masculine
hiszpańska	Feminine
śledziennico	None
zjebać	None
pszeniczna	Feminine
maskujcie	None
semestr	None
granatowi	Masculine
foremnych	Masculine
bogacza	None
zamknęłaś	Feminine
testowych	Masculine
białawych	Masculine
podażą	None
zdobił	Masculine
pniaka	None
pocilibyśmy	Masculine
leczyłbym	Masculine
podejrzewała	Feminine
zamordyzmowi	None
katarscy	Masculine
nadużywaliśmy	Masculine
rylcom	None
gromadziłam	Feminine
szogunem	None
domowych	Masculine
mieszała	Feminine
zestawione	Neuter
ciepłych	Masculine
dywizy	None
spodenek	None
krótkometrażowych	Masculine
przekomarzali	Masculine
nepalska	Feminine
uczęszczał	Masculine
najwcześniejszych	Masculine
wesołych	Masculine
widziane	Neuter
boja	None
paskali	None
woltów	None
leśna	Feminine
szczuj	None
zarabiałabym	Feminine
tektoniczna	Feminine
proroku	None
międzynarodowa	Feminine
kastrujące	Neuter
najtańszych	Masculine
poczekali	Masculine
atrakcyjniejszych	Masculine
ostrzegające	Neuter
połączona	Feminine
sycylijscy	Masculine
badajmy	None
ważniejszych	Masculine
oddałem	Masculine
szumów	None
turnieju	None
gwieździsta	Feminine
podków	None
najwyższych	Masculine
dostępnych	Masculine
rudę	None
najświętsza	Feminine
przeżuwaczem	None
szczekał	Masculine
zmieniłbyś	Masculine
zdobiąca	Feminine
pracowici	Masculine
równoległych	Masculine
bluszczu	None
sprawdzało	Neuter
zachodziłbym	Masculine
trzymała	Feminine
kłamstwami	None
ciekliśmy	Masculine
szanował	Masculine
wyglądałoby	Neuter
archanioła	None
mylące	Neuter
uczęszczająca	Feminine
nepalskich	Masculine
chrzcił	Masculine
tworzylibyśmy	Masculine
zwrotnych	Masculine
zostawiłbym	Masculine
pożyczał	Masculine
panujące	Neuter
samochodowych	Masculine
ontologicznych	Masculine
operacje	None
kłuta	Feminine
przyjęło	Neuter
przeszkadzał	Masculine
przeczytałaby	Feminine
kłuć	None
najwybitniejsza	Feminine
patologię	None
jen	None
mięśniowa	Feminine
poprowadzony	Masculine
składałby	Masculine
obiecywałeś	Masculine
jonizowaliście	Masculine
kompilowany	Masculine
ocalili	Masculine
zakonnikowi	None
fagoty	None
pobrało	Neuter
parkowała	Feminine
medytował	Masculine
czytała	Feminine
opiekujące	Neuter
węglowa	Feminine
mięso	None
tańczyłem	Masculine
potencjalnych	Masculine
demagoga	None
znoszone	Neuter
metodami	None
poetycka	Feminine
piosenko	None
marom	None
poroniłam	Feminine
poprawiało	Neuter
odkrywane	Neuter
eksperymentalna	Feminine
cyberprzestrzeniach	None
pełzająca	Feminine
aspektu	None
estońskich	Masculine
graniczyli	Masculine
łabędzi	None
mazowiecka	Feminine
kandelą	None
źrenicami	None
otchłanie	None
przeczytała	Feminine
najbrutalniejszych	Masculine
pesymistyczna	Feminine
niezrzeszonych	Masculine
padająca	Feminine
prawnych	Masculine
tylibyśmy	Masculine
dżuma	None
dowiedziałbyś	Masculine
manifestów	None
uczony	Masculine
czekali	Masculine
życzeniom	None
autochtoniczna	Feminine
wierz	None
robiłby	Masculine
przeciętnych	Masculine
dziennik	None
wodni	Masculine
dwukropki	None
fanatykami	None
pałami	None
szalałaś	Feminine
ekonomiczna	Feminine
zajebana	Feminine
wyjścia	None
tapczanach	None
spróbował	Masculine
stojan	None
zwierz	None
puszczałeś	Masculine
galaktoza	None
kolanach	None
najchłodniejszych	Masculine
rolniczych	Masculine
koszą	None
latali	Masculine
spadało	Neuter
najgłębsza	Feminine
pomagał	Masculine
jeździłem	Masculine
logarytmiczna	Feminine
wspominałam	Feminine
przestarzała	Feminine
zebrała	Feminine
osobista	Feminine
najbiedniejsi	Masculine
przygotowało	Neuter
potwierdzane	Neuter
nagich	Masculine
spektrometrów	None
przyjemni	Masculine
małpich	Masculine
gryzące	Neuter
Gruzinkę	None
męcząca	Feminine
przystających	Masculine
średnicą	None
karpaccy	Masculine
tolerował	Masculine
zdumiewających	Masculine
ostentacyjna	Feminine
odebrał	Masculine
konsekwencjom	None
hemolizy	None
przeszkadzała	Feminine
zgubiona	Feminine
otrzymaliście	Masculine
laska	Feminine
chciałeś	Masculine
śląskich	Masculine
dalsi	Masculine
gromadzisz	None
angielskich	Masculine
organizujące	Neuter
imponowały	None
najbrzydszych	Masculine
słucha	None
dżentelmenem	None
klonowych	Masculine
wyjebała	Feminine
dymało	Neuter
potrzebowałbym	Masculine
kręcisz	None
ojczyznę	None
dowodząca	Feminine
bydgoskich	Masculine
bezwzględni	Masculine
zależni	Masculine
wiosłowalibyśmy	Masculine
korzystałem	Masculine
pozwalająca	Feminine
koi	None
żądana	Feminine
nieszkodliwa	Feminine
wiosenna	Feminine
filiżanko	None
krtaniowych	Masculine
oszukali	Masculine
atakująca	Feminine
uszkodzonych	Masculine
pawiem	None
hrywną	None
międzygwiezdnych	Masculine
arii	None
kambodżańska	Feminine
igrałam	Feminine
zaryzykowała	Feminine
warstwą	None
pachnideł	None
ginęłoby	Neuter
akadmickich	Masculine
leśnych	Masculine
dawana	Feminine
odebrała	Feminine
cydry	None
słuchałeś	Masculine
dziedzińców	None
ciężarna	Feminine
najdalszych	Masculine
puszysta	Feminine
harmonia	None
wolnych	Masculine
drapieżna	Feminine
wykres	None
pojawiło	Neuter
wysiadłam	Feminine
motkom	None
szalejmy	None
groźni	Masculine
filozoficzna	Feminine
czaszami	None
bratanic	None
nakryta	Feminine
popełnilibyśmy	Masculine
historyku	None
przyjąłbym	Masculine
karałem	Masculine
ciekawsza	Feminine
wykonalna	Feminine
czarnawych	Masculine
podkreślające	Neuter
chwytów	None
bogatych	Masculine
intensywnych	Masculine
kłębku	None
klonów	None
dodawaliśmy	Masculine
azjatyccy	Masculine
odstawili	Masculine
łużyckich	Masculine
uczciwymi	None
okiennych	Masculine
sporadyczna	Feminine
wpływała	Feminine
odpowiadająca	Feminine
gasiliby	Masculine
zawiedziony	Masculine
złapana	Feminine
przodująca	Feminine
upokorzeniom	None
czardasz	None
sądzony	Masculine
wyrocznia	None
najskromniejszych	Masculine
spodziewałem	Masculine
krasa	None
śledziliby	Masculine
blasze	None
nagłych	Masculine
występująca	Feminine
zajebaliśmy	Masculine
chełpił	Masculine
marudziłbyś	Masculine
jemiołuszko	None
autopsje	None
testament	None
przedramionach	None
straszniejsi	Masculine
szafy	None
zabrała	Feminine
karałam	Feminine
wymiarowa	Feminine
zauważyłam	Feminine
rzemiosłach	None
aquaparki	None
geometrycznych	Masculine
skłamałam	Feminine
wydupczyłyście	None
dożyli	Masculine
pomagali	Masculine
wojskowa	Feminine
ludożerców	None
amerykańskich	Masculine
zdementowałem	Masculine
kameruńscy	Masculine
chłodnych	Masculine
kopani	Masculine
hamowany	Masculine
najczęstszych	Masculine
najsłynniejszych	Masculine
dodawało	Neuter
krótkich	Masculine
pyt	None
bywałem	Masculine
likierem	None
czarowi	None
anatolijska	Feminine
partyzantkami	None
gęsia	Feminine
proponował	Masculine
oceanicznych	Masculine
czarom	None
deweloperowi	None
czynili	Masculine
kontrolowali	Masculine
kiełbasy	None
plebanię	None
orzechowa	Feminine
pisadłem	None
fryzjerki	None
mieszkali	Masculine
bateriach	None
technologiczna	Feminine
raportami	None
dokonujące	Neuter
gaworzyłabym	Feminine
proponowałem	Masculine
docentem	None
zasłużona	Feminine
zdobili	Masculine
kichało	Neuter
dojrzejcie	None
zabijająca	Feminine
rydwanach	None
oskarżaliby	Masculine
opowiadała	Feminine
szczeciną	None
tolerujące	Neuter
konkretniejszych	Masculine
przesiek	None
sanitariusze	None
zesrali	Masculine
zbyć	None
siostrzanych	Masculine
zmyśliłaby	Feminine
najbezpieczniejsza	Feminine
milsza	Feminine
wylaszczyliby	Masculine
zadzwoniliśmy	Masculine
egzaminowałaś	Feminine
gęgane	Neuter
kwestionowała	Feminine
cenili	Masculine
żyjące	Neuter
traszką	None
chciałam	Feminine
stracona	Feminine
potwierdziłaś	Feminine
pokazaliśmy	Masculine
prane	Neuter
skacząca	Feminine
kłusowałabym	Feminine
zburzone	Neuter
syta	Feminine
przeczytani	Masculine
dekarzami	None
męczennice	None
dźwignęliby	Masculine
twierdziło	Neuter
skąpomoczem	None
powszechnych	Masculine
następnika	None
arystokratycznych	Masculine
zbiegała	Feminine
neuronami	None
wartościowych	Masculine
chłepta	None
dowodzone	Neuter
galopowalibyśmy	Masculine
strzelające	Neuter
obciążając	None
kontrolująca	Feminine
zabiłem	Masculine
starało	Neuter
spinkom	None
słyszalni	Masculine
jenom	None
urodzilibyście	Masculine
wymusilibyście	Masculine
pokazałem	Masculine
kaligraficznych	Masculine
kelnerce	None
kwestionowałem	Masculine
najszersza	Feminine
sprawni	Masculine
łamana	Feminine
przypuścił	Masculine
prorokowi	None
studniami	None
próbowałeś	Masculine
dosięgnęłabyś	Feminine
przyrostkiem	None
czadyjskich	Masculine
klikałem	Masculine
przegapiłam	Feminine
przeżute	Neuter
spróbuje	None
zebrałem	Masculine
ziołami	None
robiło	Neuter
cerkiewnosłowiańskich	Masculine
zerżnięte	Neuter
plastycznych	Masculine
aktywniejszych	Masculine
ograniczeni	Masculine
ortodoksyjna	Feminine
nadobnych	Masculine
połączone	Neuter
kołtunów	None
ściągana	Feminine
wielkopolska	Feminine
dawajcie	None
trwalszych	Masculine
przybysze	None
zamknęło	Neuter
ładowali	Masculine
lizana	Feminine
panowało	Neuter
bażanty	None
oszukiwani	Masculine
różniczka	None
uchodźcach	None
wygodniejszych	Masculine
twardsza	Feminine
wysiadła	Feminine
soku	None
wyglądało	Neuter
robiona	Feminine
zawarłby	Masculine
kurtkami	None
krucha	Feminine
fotogenicznych	Masculine
plantacją	None
utleniona	Feminine
unicestwić	None
cypryjska	Feminine
przepraszające	Neuter
zakazany	Masculine
sprawdzany	Masculine
rozważone	Neuter
pojmowali	Masculine
krajobrazach	None
farmaceutyczna	Feminine
bitwami	None
szanowana	Feminine
japońskich	Masculine
śmieciówek	None
krystalografia	None
widokach	None
wilgotnych	Masculine
napisałam	Feminine
katastrofalna	Feminine
obywatelstwa	None
dziąsłowych	Masculine
śpiewałem	Masculine
schowano	None
protonie	None
biegał	Masculine
ciekawych	Masculine
rytmowi	None
muzułmanach	None
obrabowana	Feminine
dziwili	Masculine
kłócili	Masculine
wygrałem	Masculine
czerpali	Masculine
rotorem	None
stawał	Masculine
sojuszowi	None
pozaskończona	Feminine
rozpaczało	Neuter
brzydsza	Feminine
cnotami	None
katom	None
dzwońce	None
kasynie	None
pędziła	Feminine
prewencjo	None
osobowych	Masculine
drażniłaś	Feminine
wymówił	Masculine
podnosił	Masculine
najtrudniejsza	Feminine
szamanami	None
latające	Neuter
absorbowany	Masculine
automatach	None
himalajskich	Masculine
benzeny	None
odwiedzani	Masculine
trutnia	None
lonżo	None
wyczynach	None
kłułyście	None
twardych	Masculine
puścili	Masculine
sądzilibyście	Masculine
konkuruje	None
nurkujące	Neuter
genewska	Feminine
gardzili	Masculine
utlenione	Neuter
źródlana	Feminine
gza	None
radiowi	Masculine
zamówiła	Feminine
blogerem	None
plusie	None
podziwiane	Neuter
wybieram	None
hebrajscy	Masculine
ważniejsi	Masculine
egzystencje	None
otrzymywałbyś	Masculine
przeczytali	Masculine
radła	None
osobowa	Feminine
spragnionych	Masculine
uznawałbym	Masculine
obejmowałaby	Feminine
genetycznych	Masculine
sądzeni	Masculine
dowolnych	Masculine
sfałszowali	Masculine
wymyślił	Masculine
zaufała	Feminine
kwestionowany	Masculine
powtarzające	Neuter
cudzysłowom	None
bułgarska	Feminine
kusiła	Feminine
przysięgałybyśmy	None
włączany	Masculine
wykorzystywała	Feminine
zaciążyłabym	Feminine
złożylibyśmy	Masculine
pomagałby	Masculine
telegraficzna	Feminine
czapraki	None
najdzikszych	Masculine
gromie	None
ludojady	None
mali	Masculine
emocją	None
Amerykanom	None
ateistyczna	Feminine
nadzorujcie	None
roślinna	Feminine
brązowawa	Feminine
wyjaśniany	Masculine
ograniczał	Masculine
rościj	None
wygrana	Feminine
splądrował	Masculine
dawniejszych	Masculine
ludziom	None
mądrzała	Feminine
pokazało	Neuter
ładował	Masculine
bezzębnych	Masculine
oglądająca	Feminine
masztem	None
akcesoria	None
ostrzegał	Masculine
potwierdzili	Masculine
ortodoksyjni	Masculine
słynnych	Masculine
obciążany	Masculine
asemblerem	None
orgazmy	None
narzekanie	None
most	None
tyliśmy	Masculine
wymyśliliśmy	Masculine
świerzbiałaś	Feminine
próbująca	Feminine
balkonom	None
pytane	Neuter
torcika	None
dusił	Masculine
bulwkom	None
złotówce	None
bytomska	Feminine
zabrałem	Masculine
ratowałabyś	Feminine
dekoracyjnych	Masculine
nowszych	Masculine
psycholożka	None
luźniejszych	Masculine
potakiwała	Feminine
informacyjnych	Masculine
żyłby	Masculine
ratowali	Masculine
germanu	None
niepoważni	Masculine
branżami	None
płonęła	Feminine
potrzebowali	Masculine
bretońska	Feminine
spróbowana	Feminine
ściąga	None
symboliczna	Feminine
przeprowadzkom	None
łamali	Masculine
imponująca	Feminine
pojawiałoby	Neuter
mylił	Masculine
ograniczające	Neuter
zaprowadzony	Masculine
nurkom	None
żujące	Neuter
życzyłabym	Feminine
meteorologiczna	Feminine
lutująca	Feminine
zasługiwał	Masculine
pokazany	Masculine
puszczeni	Masculine
zasługiwało	Neuter
grabiła	Feminine
wracali	Masculine
długowiecznych	Masculine
pokonał	Masculine
składane	Neuter
słyszałaby	Feminine
trapezom	None
fonetyczni	Masculine
kryjąca	Feminine
uczyłaś	Feminine
sprośna	Feminine
uśpiła	Feminine
pioruny	None
różniczkowych	Masculine
listków	None
jabłkowa	Feminine
bolesnych	Masculine
uciekało	Neuter
dzicy	Masculine
młodsza	Feminine
lansowane	Neuter
nadzwyczajni	Masculine
grzmiałaby	Feminine
mknęła	Feminine
Etruskowie	None
tatarska	Feminine
karawany	None
wymuszona	Feminine
rubinowi	Masculine
kimałoby	Neuter
stróż	None
podpierdoleni	Masculine
wyświetlałaby	Feminine
polowałam	Feminine
tensorowych	Masculine
umysłowi	Masculine
kolonisty	None
przymiotnikowych	Masculine
żałowała	Feminine
aptekarska	Feminine
grzebane	Neuter
późniejszych	Masculine
późna	Feminine
obietnicami	None
żydowscy	Masculine
rozpaczała	Feminine
analizowałem	Masculine
łaskę	None
czwórkach	None
żucie	None
słuchająca	Feminine
cieńsza	Feminine
zbierali	Masculine
zapaliła	Feminine
przedwczesna	Feminine
urodzinowych	Masculine
wahał	Masculine
lękała	Feminine
obiektywni	Masculine
biedniejsi	Masculine
etiopskich	Masculine
główna	Feminine
pozostawałaby	Feminine
zawodowych	Masculine
epitafiów	None
wiesiołka	None
znaleźliby	Masculine
rzucili	Masculine
wiana	None
zacna	Feminine
sławojkom	None
równa	Feminine
sławni	Masculine
wcześniejsza	Feminine
nowiem	None
dłużnikach	None
seksualnych	Masculine
kremacji	None
świątyni	None
szrot	None
koparką	None
przyniesione	Neuter
pojawiali	Masculine
odwiedzaliście	Masculine
zauważyliście	Masculine
wróbel	None
lubymi	None
morałów	None
współcześni	Masculine
niedoszłych	Masculine
niedopałki	None
cytrynowa	Feminine
wzięłaś	Feminine
podstawowi	Masculine
pozwalało	Neuter
zerwana	Feminine
nowość	None
skończyło	Neuter
tygrysie	None
śmietniku	None
bezlitosna	Feminine
podejrzewałeś	Masculine
równoczesnych	Masculine
sprawdzałem	Masculine
krawędzie	None
żmiją	None
przytulony	Masculine
zespolonych	Masculine
podrywalibyśmy	Masculine
przyjaciela	None
atakowane	Neuter
rozważane	Neuter
wdepnęłam	Feminine
zjadliwa	Feminine
pozostawała	Feminine
kuchenna	Feminine
polecany	Masculine
dzierżyłby	Masculine
karnawałów	None
trwająca	Feminine
rozpaczaliby	Masculine
dokonałby	Masculine
gotowała	Feminine
parkowałby	Masculine
taksówkarzem	None
papierowych	Masculine
fałszywa	Feminine
pobrali	Masculine
recepcja	None
sławna	Feminine
kręgach	None
odrzuciwszy	None
budująca	Feminine
przestrzegałam	Feminine
kwintom	None
okresowi	Masculine
komentował	Masculine
publicznych	Masculine
podałyśmy	None
pożarci	Masculine
rażeni	Masculine
romantyczni	Masculine
najciekawsza	Feminine
pożarłabym	Feminine
powrósłem	None
trzeźwa	Feminine
zakazała	Feminine
tworzyłoby	Neuter
gryzł	Masculine
Irlandczykiem	None
sprawdzana	Feminine
różnicach	None
należała	Feminine
parkowałabym	Feminine
parująca	Feminine
śledzę	None
pozwalała	Feminine
wymóżmy	None
wywoływałbyś	Masculine
cisi	Masculine
werand	None
starożytni	Masculine
nosowymi	None
narodowa	Feminine
kwaśna	Feminine
wymyśliłam	Feminine
grecka	Feminine
skazaliście	Masculine
tępa	Feminine
człowieku	None
bogaci	Masculine
leasingowa	Feminine
dziwna	Feminine
wskazałeś	Masculine
złapałeś	Masculine
spinkami	None
dokonał	Masculine
dedykowała	Feminine
kopiowany	Masculine
lampartem	None
ozonowa	Feminine
zaufali	Masculine
przyjaznymi	None
ogłowi	None
wybredni	Masculine
bandytami	None
gastrofazom	None
uważała	Feminine
rodzili	Masculine
maszerowałam	Feminine
lżejszych	Masculine
silniejsi	Masculine
mrozoodporna	Feminine
rozmawiałem	Masculine
najcudniejsi	Masculine
gęstsza	Feminine
graniczyć	None
przepiękna	Feminine
konkursów	None
kosztował	Masculine
dzidziusiami	None
strasznych	Masculine
grzybieni	None
odważnych	Masculine
trafna	Feminine
umyła	Feminine
prawosławnych	Masculine
ogromna	Feminine
zrzucona	Feminine
domenę	None
pokrywające	Neuter
ciekawa	Feminine
poprośmy	None
przyprawialiście	Masculine
drgali	Masculine
usunęłabyś	Feminine
łososiowa	Feminine
badała	Feminine
potakiwało	Neuter
kiełbas	None
kwietniowa	Feminine
przypominania	None
liczna	Feminine
gałązek	None
maszerujesz	None
komórkowa	Feminine
tonęłabyś	Feminine
zawarłeś	Masculine
doktorom	None
drzemało	Neuter
dzierżyłem	Masculine
wróblom	None
rzecznymi	None
przelecielibyśmy	Masculine
błonia	None
szczerszych	Masculine
chłopach	None
trzaskałabyś	Feminine
płynęłyście	None
pitnych	Masculine
zasługiwałabym	Feminine
promenadę	None
gwiżdżące	Neuter
złożyłaś	Feminine
rybna	Feminine
pokrywane	Neuter
zaciążyli	Masculine
nieparzystych	Masculine
kompletnych	Masculine
sioguni	None
rycz	None
brzoskwiniowa	Feminine
marsjańskich	Masculine
głuchych	Masculine
galopowaliby	Masculine
mądrzejszych	Masculine
utlenić	None
absorpcjach	None
ważka	Feminine
pytałeś	Masculine
mordobiciom	None
wschodzące	Neuter
wykorzystywany	Masculine
pytał	Masculine
koszul	None
metalowa	Feminine
kleiła	Feminine
rozmawiałeś	Masculine
marznące	Neuter
losowi	Masculine
cytowało	Neuter
grozy	None
trwanie	None
broniona	Feminine
proponowałabym	Feminine
odbudowałaś	Feminine
szczurzych	Masculine
platynowych	Masculine
pokazywałem	Masculine
kanał	None
spięła	Feminine
prałbyś	Masculine
dodałem	Masculine
przypomnieli	Masculine
postradał	Masculine
standard	None
klępom	None
karą	None
czworokątów	None
uczyło	Neuter
pożądany	Masculine
pokazała	Feminine
poznamy	None
formalni	Masculine
Serbach	None
twierdziła	Feminine
recepcjami	None
pojony	Masculine
potrzebowałby	Masculine
nostalgiczna	Feminine
wybrałem	Masculine
mierząca	Feminine
obłych	Masculine
strategiczni	Masculine
alfabetycznych	Masculine
obserwowany	Masculine
sypała	Feminine
noszone	Neuter
zapamiętało	Neuter
drużynach	None
niszczony	Masculine
szczupłych	Masculine
bośniacka	Feminine
budzony	Masculine
trójki	None
kwark	None
potężniejsi	Masculine
senna	Feminine
wybitniejszych	Masculine
usznych	Masculine
spieprzylibyśmy	Masculine
poronieniami	None
zjadliwych	Masculine
wojennych	Masculine
wiecznych	Masculine
opiłków	None
gonił	Masculine
obgadałbym	Masculine
doprowadzająca	Feminine
potakiwałbym	Masculine
cierpliwi	Masculine
wskazywalibyście	Masculine
twierdząca	Feminine
złapałem	Masculine
podzielna	Feminine
rozważające	Neuter
posłuchało	Neuter
czardasza	None
latarnikiem	None
hydrauliczna	Feminine
wasalami	None
parabole	None
rąbać	None
cukiereczkowi	None
przedszkolach	None
tragicznych	Masculine
krypta	None
deistą	None
palimpseście	None
zastanawiał	Masculine
milczał	Masculine
systematycznych	Masculine
wyłączająca	Feminine
śnieżnobiała	Feminine
sterczyłaś	Feminine
tonęłam	Feminine
obiecywał	Masculine
gajem	None
podpisałeś	Masculine
konfigurowałabyś	Feminine
globalnych	Masculine
fajkiem	None
ignorowałabyś	Feminine
zjełczałych	Masculine
tęsknili	Masculine
poznańscy	Masculine
wszyscy	Masculine
kastrowałam	Feminine
gwałcił	Masculine
sprawiałoby	Neuter
wymusiło	Neuter
draży	None
wiosłowaliby	Masculine
rzucone	Neuter
kurczę	None
poprzedzająca	Feminine
stronami	None
ignorowane	Neuter
gryzło	Neuter
płodna	Feminine
neutrony	None
antysemickich	Masculine
ratowała	Feminine
zrobilibyście	Masculine
jaboli	None
jugosłowiańscy	Masculine
gromadziła	Feminine
badające	Neuter
doskonali	Masculine
kochała	Feminine
koszykarzowi	None
najemnicy	None
niedostępnych	Masculine
gaszenie	None
spieprzałam	Feminine
żelatyny	None
katalońscy	Masculine
szczura	None
przekomarzałam	Feminine
morale	None
agrestem	None
odbieraliby	Masculine
drogowi	Masculine
serwera	None
lalką	None
bredziliśmy	Masculine
gonienie	None
wrzątkowi	None
wierzyli	Masculine
filaru	None
zgromadzeniu	None
pieprzony	Masculine
szlachetna	Feminine
mówcach	None
trudna	Feminine
tchawicy	None
traktowało	Neuter
oglądał	Masculine
ściennych	Masculine
histerycznych	Masculine
słupkach	None
Macedończykiem	None
palona	Feminine
karpackich	Masculine
oboczność	None
umówiła	Feminine
dwukołowa	Feminine
żałowałabym	Feminine
narkotycznych	Masculine
zdobicie	None
kołchoz	None
zaprzeczyli	Masculine
płascy	Masculine
niema	Feminine
turkusów	None
dzielniki	None
akademii	None
słodkowodna	Feminine
włączania	None
argentyńskich	Masculine
lokatorzy	None
niszczyła	Feminine
pozostawali	Masculine
styczniowa	Feminine
gościńca	None
zaproszeni	Masculine
poduszeczek	None
najcięższa	Feminine
pojemna	Feminine
cyrk	None
rozumnych	Masculine
ratowałaś	Feminine
olszowa	Feminine
siniaków	None
prostych	Masculine
tęskniłaby	Feminine
górnołużycka	Feminine
chowające	Neuter
należeli	Masculine
krwawa	Feminine
bankomatach	None
autografy	None
żyłem	Masculine
skończonych	Masculine
wiecheć	None
szefów	None
olimpiada	None
wypędziliby	Masculine
samolubnych	Masculine
cudo	None
białoruscy	Masculine
tańczylibyście	Masculine
obgadał	Masculine
subtropikalnych	Masculine
tułaczu	None
przytulaniu	None
oceniani	Masculine
krwista	Feminine
atrakcyjniejsza	Feminine
najtańsza	Feminine
zmieniona	Feminine
szczałby	Masculine
przeźroczysta	Feminine
papierowa	Feminine
wylaszczyłoby	Neuter
urocza	Feminine
fauli	None
śliną	None
nanometr	None
gorzałbyś	Masculine
bezpieczniejsza	Feminine
pułkami	None
zębom	None
martwa	Feminine
potrzebowałam	Feminine
pustynia	None
oszczepom	None
dokonało	Neuter
narodowych	Masculine
radzić	None
ałtajskich	Masculine
marchewkowi	Masculine
nijakich	Masculine
filmował	Masculine
jednoczesna	Feminine
poprosili	Masculine
cieniami	None
tropikalna	Feminine
brzemion	None
pontyfikat	None
otruci	Masculine
azerbejdżańska	Feminine
holenderscy	Masculine
papieska	Feminine
ostoj	None
owadożernych	Masculine
lezące	Neuter
zrobiło	Neuter
alergologami	None
ozonie	None
ewentualnych	Masculine
drzewami	None
nieromantycznych	Masculine
bruzdami	None
naziol	None
stonoga	None
betonowaliśmy	Masculine
wykopane	Neuter
najdoskonalszych	Masculine
tłumaczy	None
poważniejszymi	None
zrozumiałem	Masculine
plan	None
odkrywany	Masculine
gotowych	Masculine
zrabowane	Neuter
mazurska	Feminine
pękała	Feminine
grawitacyjna	Feminine
wysoka	Feminine
przejrzystych	Masculine
splądrowałabym	Feminine
magnetowidom	None
mundialach	None
konkurowała	Feminine
odbijaliby	Masculine
odpowiadałoby	Neuter
zwierzątek	None
budził	Masculine
szpinet	None
straszydłom	None
pociągi	None
chorwackich	Masculine
produkowana	Feminine
imponowało	Neuter
borówki	None
miso	None
odbierająca	Feminine
chłodniejsza	Feminine
wyniosłem	Masculine
wirusowa	Feminine
wodoodpornych	Masculine
chciałem	Masculine
przeżyła	Feminine
stront	None
dyskotekowych	Masculine
biszkopcie	None
jedyna	Feminine
marnowani	Masculine
marokańskich	Masculine
wzięli	Masculine
kaskadami	None
nowoczesnymi	None
feministycznych	Masculine
sfałszowana	Feminine
ginekologicznych	Masculine
niepotrzebnych	Masculine
bezpieczni	Masculine
zimowaliście	Masculine
buchała	Feminine
przekwitajcie	None
pisząca	Feminine
radioaktywni	Masculine
eksportowała	Feminine
numerowana	Feminine
szalet	None
potwierdzałybyście	None
kier	None
słynni	Masculine
mierzona	Feminine
ruchała	Feminine
poprzedzał	Masculine
pogadaliście	Masculine
wysyłała	Feminine
otrzymała	Feminine
przytuliłeś	Masculine
kreatywni	Masculine
solidnych	Masculine
kręgami	None
dziwiłam	Feminine
przodował	Masculine
kwestionowało	Neuter
modły	None
mylna	Feminine
chwalona	Feminine
zwyciężaliby	Masculine
plotkowałbym	Masculine
protektoraty	None
podniosła	Feminine
kolorowa	Feminine
ocenialiśmy	Masculine
zachowany	Masculine
żartu	None
odważna	Feminine
napisaliśmy	Masculine
podzwrotnikowych	Masculine
gwiezdni	Masculine
dochodziło	Neuter
palące	Neuter
mordercą	None
brzęczałabyś	Feminine
językowych	Masculine
pomiarem	None
wspominałoby	Neuter
łaknęłaby	Feminine
znosiło	Neuter
dźwigała	Feminine
wilgotniejszych	Masculine
usunąłbyś	Masculine
uratował	Masculine
czkawki	None
filmowany	Masculine
pierwotniak	None
smażyli	Masculine
podkradamy	None
zła	Feminine
kłamiesz	None
maź	None
znikała	Feminine
gnana	Feminine
zimozielonych	Masculine
kontynentalna	Feminine
ciągnikach	None
mechaniczna	Feminine
śródziemnomorska	Feminine
zaczekaliśmy	Masculine
niszczyłaby	Feminine
drewnem	None
obiecała	Feminine
guglałaś	Feminine
wymagała	Feminine
koreańska	Feminine
janowcom	None
usuwany	Masculine
zarezerwujemy	None
jednobarwnych	Masculine
maratonów	None
nadziejom	None
szopkach	None
dokonanych	Masculine
plująca	Feminine
kolanowych	Masculine
zdobiła	Feminine
wybitni	Masculine
zerkaliście	Masculine
analizie	None
obserwowani	Masculine
dzienna	Feminine
optyką	None
zarabiał	Masculine
mocnych	Masculine
przyniesiona	Feminine
markerem	None
obiecująca	Feminine
leniwa	Feminine
barmanów	None
równoczesna	Feminine
przeżyli	Masculine
żebraków	None
splądrowali	Masculine
cytoplazmatycznych	Masculine
przyprawiałabyś	Feminine
konfigurowało	Neuter
izotopowych	Masculine
strzelbę	None
rozsądnych	Masculine
uderzyłem	Masculine
doceniali	Masculine
opiekowałeś	Masculine
brudna	Feminine
odmienni	Masculine
koreańscy	Masculine
marokańska	Feminine
łamiących	Masculine
napisana	Feminine
wyrzucona	Feminine
kajałabyś	Feminine
chronił	Masculine
wywołali	Masculine
poprzedzaliśmy	Masculine
meksykańscy	Masculine
właściwi	Masculine
kartograficzna	Feminine
słitaśna	Feminine
dzielna	Feminine
więzłabyś	Feminine
spadała	Feminine
dręczyłam	Feminine
gospodzie	None
śmieszkowalibyśmy	Masculine
pokazaliście	Masculine
maszerowała	Feminine
sini	Masculine
uczennicom	None
zrobię	None
klaczach	None
roztrzepaliście	Masculine
całował	Masculine
dziobali	Masculine
wymogła	Feminine
Angielkę	None
zapraszało	Neuter
zrozumiał	Masculine
szanująca	Feminine
trwaliby	Masculine
trygonometryczna	Feminine
podzwrotnikowa	Feminine
opisywałem	Masculine
łożyskom	None
zaruchasz	None
kawały	None
hurtownia	None
marchewkowa	Feminine
składające	Neuter
kichałaby	Feminine
wełnianych	Masculine
wspomnieliśmy	Masculine
pamiętajcie	None
jesienna	Feminine
urządzeniu	None
chrzczony	Masculine
powtarzał	Masculine
ezoteryczna	Feminine
przedwczesnych	Masculine
padające	Neuter
spójnych	Masculine
skręcił	Masculine
wkurwiałam	Feminine
lutowych	Masculine
wspominali	Masculine
planowały	None
dawaj	None
wygrałabym	Feminine
przyjęliśmy	Masculine
okazaliście	Masculine
sposobom	None
medalista	None
ręczna	Feminine
żywicy	None
wełna	None
oszczep	None
skrzypaczce	None
poważniejsza	Feminine
wargowa	Feminine
mazurscy	Masculine
najwygodniejszych	Masculine
jednorazowa	Feminine
miałowi	None
legendą	None
nieżonaci	Masculine
brazylijscy	Masculine
izotopowa	Feminine
pojmuje	None
marnośći	None
atmosferyczni	Masculine
karni	Masculine
sejsmografów	None
tchawicom	None
zarobiona	Feminine
brylantowa	Feminine
dzietność	None
toksycznych	Masculine
angolska	Feminine
uprawialiście	Masculine
uwielbiana	Feminine
zaryzykował	Masculine
paradoksalna	Feminine
spragniona	Feminine
płaciłabyś	Feminine
budową	None
sprzężona	Feminine
luźnych	Masculine
kiełbia	None
karało	Neuter
kusiłem	Masculine
groźnych	Masculine
sójek	None
sprawdzony	Masculine
kopiowałem	Masculine
nadużywała	Feminine
poziomych	Masculine
pozostawało	Neuter
zesrajcie	None
wykitowałby	Masculine
zrobionych	Masculine
zastanawiałem	Masculine
skręcona	Feminine
dotykaliby	Masculine
ilością	None
postradali	Masculine
majonezach	None
wtórnych	Masculine
chroniłybyście	None
weźmiemy	None
wonnych	Masculine
niepotrzebna	Feminine
opactwach	None
siadali	Masculine
sarkałoby	Neuter
wilgotna	Feminine
mrąca	Feminine
okno	None
lewa	Feminine
stygnęlibyście	Masculine
muzułmańskich	Masculine
skręciliśmy	Masculine
kolumny	None
tęczę	None
przedmałżeńska	Feminine
wybuchałabyś	Feminine
zajazdowi	None
wewnętrznych	Masculine
najzręczniejszych	Masculine
odpowiadałem	Masculine
zlewie	None
Arabem	None
zadziąsłowi	Masculine
wulkan	None
znajdująca	Feminine
sporzy	Masculine
inteligencję	None
obrabowane	Neuter
ostrzeżenie	None
pierwsi	Masculine
sprawiany	Masculine
przeleciała	Feminine
barnów	None
naprawialibyśmy	Masculine
znosząca	Feminine
oczywistych	Masculine
zimowych	Masculine
fonetyczna	Feminine
samochodowa	Feminine
rzeczywiści	Masculine
cichsza	Feminine
baskijskich	Masculine
całkowalnych	Masculine
dźwigali	Masculine
baskijscy	Masculine
analizowany	Masculine
przełęczy	None
demontowany	Masculine
wartościowi	Masculine
skrzydlata	Feminine
podejrzewałbym	Masculine
pożyczył	Masculine
pobożnymi	None
przedmałżeńskich	Masculine
obalałaś	Feminine
bareizmowi	None
podlewające	Neuter
poznany	Masculine
toskańska	Feminine
zoologiczna	Feminine
zakochanych	Masculine
stała	Feminine
śpieszyli	Masculine
perskich	Masculine
upuściliśmy	Masculine
monogramem	None
wymiotowałeś	Masculine
spieprzałbyś	Masculine
małpowała	Feminine
rozproszył	Masculine
paliłabym	Feminine
Palestynek	None
podchodzili	Masculine
przypomniało	Neuter
wyrzuciłam	Feminine
kawałów	None
zmienna	Feminine
spodziewałam	Feminine
klechy	None
porozmawiałbym	Masculine
męska	Feminine
woźnym	None
archaniołów	None
otrzymałem	Masculine
wyrzutek	None
parszywi	Masculine
obaliłeś	Masculine
kastrowane	Neuter
wrażliwa	Feminine
wiał	Masculine
śnił	Masculine
mitologia	None
alkoholowa	Feminine
zrozumiany	Masculine
zawory	None
rychła	Feminine
kultura	None
profesami	None
pacjentką	None
ratowało	Neuter
tautologii	None
którakolwiek	Feminine
odkrywał	Masculine
wspomniało	Neuter
szalejące	Neuter
sabotowałoby	Neuter
wybuchnęłoby	Neuter
przyjęli	Masculine
łamało	Neuter
wywołałaś	Feminine
zaczęte	Neuter
czynele	None
wyrze	None
dolnymi	None
kornikami	None
organizatorami	None
zasługiwali	Masculine
edytowane	Neuter
pokrywany	Masculine
wyświetlała	Feminine
przegrane	Neuter
partykułą	None
pokonało	Neuter
potwierdziło	Neuter
podochodzili	Masculine
przypominana	Feminine
najnowsza	Feminine
śledzone	Neuter
rozproszyliście	Masculine
sławojki	None
elementu	None
przesadzała	Feminine
wdychałoby	Neuter
uczyła	Feminine
egzekucyjnych	Masculine
terapią	None
trafnych	Masculine
litewskich	Masculine
popełnił	Masculine
niejakich	Masculine
unieważnieniem	None
bojaliby	Masculine
wskazałybyście	None
bredziłam	Feminine
kimałabyś	Feminine
uparci	Masculine
trudnych	Masculine
mula	Feminine
kucowi	None
weselszych	Masculine
zarabiająca	Feminine
nakryty	Masculine
towarzystwami	None
uwielbiane	Neuter
potop	None
dotykające	Neuter
egoistyczna	Feminine
kładące	Neuter
niższych	Masculine
zjadł	Masculine
kręcili	Masculine
paradygmaty	None
ośmiobitowi	Masculine
nadzorowany	Masculine
melon	None
centra	None
wirtualni	Masculine
odkryliśmy	Masculine
herców	None
czerpało	Neuter
zerwało	Neuter
złupienie	None
nieodmiennych	Masculine
sabotować	None
starająca	Feminine
skracał	Masculine
przynosiła	Feminine
zmiennych	Masculine
spodziewałbyś	Masculine
pstrągiem	None
działał	Masculine
wulgaryzmu	None
skończyłeś	Masculine
uwiodłybyśmy	None
zerwały	None
najsłodszych	Masculine
napisałeś	Masculine
pokojem	None
wywołało	Neuter
uciekał	Masculine
amerykańscy	Masculine
więdnąłbyś	Masculine
koniakach	None
sprzeciw	None
zabalsamowałam	Feminine
szczupli	Masculine
organizował	Masculine
sprawy	None
gadaliby	Masculine
działająca	Feminine
pariasom	None
szubienicami	None
rdzeniowi	None
zarabiała	Feminine
elektroniczna	Feminine
rozmywałabym	Feminine
kochani	Masculine
odo	None
dworzanom	None
woniałaby	Feminine
książkowych	Masculine
najodważniejszych	Masculine
czeźnięcie	None
chowało	Neuter
katach	None
najemnikiem	None
płynął	Masculine
przynosząca	Feminine
spróbowałbyś	Masculine
uśpiona	Feminine
chujowych	Masculine
należałaby	Feminine
schizofrenio	None
wędrowna	Feminine
puścilibyśmy	Masculine
gila	None
nowoczesna	Feminine
kopała	Feminine
przyniosła	Feminine
wykitowała	Feminine
trąbą	None
podniosłeś	Masculine
dodzwonilibyście	Masculine
królewska	Feminine
umysłowa	Feminine
produkujące	Neuter
bezwstydna	Feminine
dowiecie	None
prośbo	None
wykorzystujmy	None
szklarni	None
zestawiona	Feminine
samogonami	None
nieuczciwa	Feminine
częsta	Feminine
lepsi	Masculine
używaniem	None
niepozornych	Masculine
gromadzone	Neuter
zaśmiecona	Feminine
meduzami	None
zebraliśmy	Masculine
przeżuty	Masculine
poiłeś	Masculine
chora	Feminine
wdzięczni	Masculine
farmaceutycznych	Masculine
imponowałeś	Masculine
spokojna	Feminine
słynęła	Feminine
niezapomnianych	Masculine
ograniczało	Neuter
trzaskalibyśmy	Masculine
połączyła	Feminine
wpływająca	Feminine
głuszców	None
przypomniany	Masculine
wspominaniu	None
obalił	Masculine
oglądaliśmy	Masculine
przekwitałoby	Neuter
ambitniejszych	Masculine
zastrzeżonych	Masculine
dumnych	Masculine
zabijał	Masculine
rządowi	Masculine
drażniłbyś	Masculine
ulubieni	Masculine
nękani	Masculine
palił	Masculine
pełnoletnia	Feminine
zasługiwałbyś	Masculine
zimowała	Feminine
martwiłem	Masculine
żabojady	None
trzymani	Masculine
mechanikach	None
zwięzła	Feminine
kroiliby	Masculine
dodająca	Feminine
podwójna	Feminine
smerfy	None
próbujące	Neuter
wrzątek	None
traktujące	Neuter
kradnąc	None
żelbetowych	Masculine
mijaliście	Masculine
uznająca	Feminine
dosrał	Masculine
lepione	Neuter
uzależnieni	Masculine
rzygałbyś	Masculine
lakonicznych	Masculine
demograficzna	Feminine
dialogom	None
posłuchaj	None
hitami	None
poziomicy	None
tańczył	Masculine
głębszymi	None
bladych	Masculine
decyzja	None
rady	None
twierdzicie	None
wołające	Neuter
jadali	Masculine
śledził	Masculine
mieszkająca	Feminine
rysowania	None
bili	None
genewskich	Masculine
stanowiłoby	Neuter
najgłośniejszych	Masculine
broniach	None
rozbiwszy	None
szafach	None
konferencjach	None
kartkami	None
opowiadająca	Feminine
jadaliście	Masculine
karmnik	None
nadużywalibyśmy	Masculine
jeździłeś	Masculine
łaziłby	Masculine
pojawiająca	Feminine
bagażnika	None
drobiazg	None
kontrolowaliby	Masculine
obiekcie	None
skręcili	Masculine
nieuczciwych	Masculine
bosych	Masculine
mierzące	Neuter
aktorze	None
bękartami	None
organiczna	Feminine
rtęciowa	Feminine
schowali	Masculine
dbajcie	None
dawała	Feminine
wywołane	Neuter
alkoholom	None
wymagałam	Feminine
zawarłem	Masculine
pokażmy	None
zapomniane	Neuter
negocjowałeś	Masculine
zniszczona	Feminine
terrorystyczna	Feminine
kibicował	Masculine
radioamatora	None
zachowała	Feminine
parskałoby	Neuter
ciepła	Feminine
narzekało	Neuter
numerujemy	None
zatrzymało	Neuter
miodowych	Masculine
styczniowi	Masculine
kalejdoskopie	None
zaprowadzeni	Masculine
kaczce	None
umówić	None
demokratę	None
sapałabym	Feminine
głębocy	Masculine
zawiodło	Neuter
tworzyliśmy	Masculine
węzłowi	None
podkowom	None
koszone	Neuter
odmiennych	Masculine
nieprawd	None
biegające	Neuter
kwadratowi	Masculine
chomątom	None
badał	Masculine
podnieść	None
bębniłaby	Feminine
cotygodniowych	Masculine
zasłużyła	Feminine
bożych	Masculine
pokonali	Masculine
gęgająca	Feminine
słynące	Neuter
wyrzuciłeś	Masculine
elektrownię	None
krojony	Masculine
skłamał	Masculine
opactwo	None
wskazana	Feminine
dokona	None
minimalistyczna	Feminine
tajskich	Masculine
kaszubskich	Masculine
kukurydziana	Feminine
podało	Neuter
lnianych	Masculine
obrażone	Neuter
lutowa	Feminine
kożuch	None
kraje	None
szałwią	None
dałam	Feminine
łopatek	None
zabawnych	Masculine
czekoladowych	Masculine
stawali	Masculine
planowany	Masculine
monad	None
rozsadzaliby	Masculine
anakondy	None
żądany	Masculine
badałoby	Neuter
biochemicznych	Masculine
uprzedony	None
wykładnią	None
wylałoby	Neuter
autorów	None
umięśnionych	Masculine
pieprzylibyśmy	Masculine
złożyli	Masculine
bogatsza	Feminine
zapominajmy	None
ryżowa	Feminine
prestiżowi	Masculine
przypuściłbyś	Masculine
koszmarnych	Masculine
obejmowałbym	Masculine
kaukaskich	Masculine
ozdobna	Feminine
używani	Masculine
smutni	Masculine
pękali	Masculine
torebko	None
opuszczali	Masculine
poziomicę	None
romantyczna	Feminine
księgarniami	None
miodowa	Feminine
lizalibyście	Masculine
eksplozjom	None
pytany	Masculine
celulozę	None
wypędził	Masculine
cywilizacjach	None
ciufciach	None
dotknął	Masculine
sprzęgliście	Masculine
zrozumiałaś	Feminine
uprawiany	Masculine
wdychałeś	Masculine
październikowych	Masculine
tulipanowcom	None
robiliby	Masculine
trwałych	Masculine
korzystała	Feminine
seminarzyści	None
wczesna	Feminine
sfałszowałoby	Neuter
występowałem	Masculine
świecka	Feminine
wskazałbyś	Masculine
ładująca	Feminine
pytałyście	None
najokrutniejszych	Masculine
trosce	None
cała	Feminine
grzybom	None
zrabowali	Masculine
oderwana	Feminine
gwałciłbyś	Masculine
rychli	Masculine
zwrotni	Masculine
głos	None
komedia	None
masażystka	None
zachodziłabym	Feminine
ontologiczna	Feminine
najniższych	Masculine
przypominane	Neuter
szlacharów	None
polecało	Neuter
rubinowa	Feminine
edytowałeś	Masculine
mierzyłaś	Feminine
okrągła	Feminine
potwierdzona	Feminine
czezłabym	Feminine
numeryczna	Feminine
oceniało	Neuter
chroniłabyś	Feminine
wyhaftowany	Masculine
lepiona	Feminine
demontujące	Neuter
rzymscy	Masculine
chełpiłabyś	Feminine
dawniejsza	Feminine
złamała	Feminine
szlauch	None
fakturo	None
problematycznymi	None
eksportowali	Masculine
pierdziałybyście	None
cytowana	Feminine
piorunów	None
lambda	None
obaliło	Neuter
siedzieliśmy	Masculine
zalogujcie	None
mijane	Neuter
pięła	Feminine
nadchodzące	Neuter
wracała	Feminine
czekajcie	None
odwiedzałybyście	None
bystrzy	Masculine
kłóciła	Feminine
znaczyłoby	Neuter
niebezpieczni	Masculine
tyłem	Masculine
sadyzmu	None
wyjaśniające	Neuter
magnetowidach	None
wskazanie	None
stali	Masculine
praktycznych	Masculine
dosięgnął	Masculine
kucalibyście	Masculine
grzybek	None
indyjska	Feminine
trakcyjni	Masculine
zakładanie	None
lekarzowi	None
wełniana	Feminine
otworzyłabym	Feminine
szczuplejsza	Feminine
ogłoszeń	None
drobiazgowa	Feminine
