γλυτώσατε	παντρέψατε	lemma
αφοριστείτε	αφοριστείς	Number
μουσμουλιών	μουσμουλιές	Case
τηλεφώνημα	τηλεφωνήματος	Case
σκέψης	σκέψη	Case
φωνητικά	φωνητικές	Gender
απόδοσης	αποδόσεων	Number
οροφών	οροφές	Case
ρομποτική	ρομποτικής	Case
υβριδίων	υβρίδια	Case
υπερασπιζόταν	υπερασπίζονταν	Person
αερολίθους	αερολίθων	Case
τσακαλιών	τσακάλια	Case
δελτίο	δελτίου	Case
νικητών	νικητές	Case
μελετηρά	μελετηρές	Gender
ναζιστικών	ναζιστικές	Case
ζουρνάδες	ζουρνάδων	Case
μελετώ	μελετά	Person
πεπόνια	πεπόνι	Number
υπογείου	υπογείων	Number
αγρότες	αγρότης	Number
απόφυση	απόφυσης	Case
ανταγωνίζομαι	περιορίζω	lemma
έχω	έχουν	Person
δειγμάτων	δείγματα	Case
προλεταριάτο	προλεταριάτου	Case
αγγλόφωνου	αγγλόφωνο	Case
ανακτούσατε	περπατούσατε	lemma
ανθρωπολόγους	ανθρωπολόγοι	Case
ιστοσελίδας	ιστοσελίδων	Number
οψιδιανό	οψιδιανού	Case
ευθύνες	ευθυνών	Case
θηριωδίας	θηριωδιών	Number
ιμάμηδες	ιμάμης	Number
υποψήφιο	υποψήφιου	Case
άβροχο	ματωμένο	lemma
ζητιάνευες	ζητιάνευε	Person
κοσμονάυτες	κοσμοναυτών	Case
πίστεις	πίστη	Number
προσανατολισμό	προσανατολισμού	Case
μελετούσες	μελετούσαμε	Person
μπαμπούλα	μπαμπούλας	Case
ταπήτων	τάπητες	Case
ανάγλυφα	ανάγλυφο	Number
βυσσινιούς	ἄκρους	lemma
πετυχαίνεις	πετυχαίνει	Person
αγκυλώσεις	αγκύλωση	Number
ασθενειών	ασθένειες	Case
απολίτιστοι	απολίτιστα	Gender
γλουτοί	γλουτέ	Number
αεροκοπάνισαν	αεροκοπάνισες	Person
κουλοί	κουλά	Gender
γδέρνονταν	οδηγιόνταν	lemma
παρουσιάσεις	παρουσιάσεων	Case
αγιοποιούμε	αγιοποιούν	Person
ανακτήθηκε	έσωσε	lemma
υψόμετρα	υψόμετρο	Number
δίσκοι	δίσκων	Case
βίσωνα	βίσωνας	Case
πτώματα	πτώμα	Number
κουτιά	κουτιών	Case
αλεπούδες	αλεπού	Number
αλλιώτικο	τσέχικο	lemma
δίδακτρα	διδάκτρων	Case
πολλαπλασιασμούς	πολλαπλασιασμοί	Case
αγορέψαμε	συσσωρεύσαμε	lemma
μαφιόζους	μαφιόζο	Number
υπουργείου	υπουργείων	Number
παιχνιδιού	παιχνίδι	Case
αδάμαντος	αδαμάντων	Number
χειρουργικών	χειρουργικές	Case
αργίλιο	αργιλίου	Case
μοναχών	μοναχοί	Case
ανθρωπολογικός	ανθρωπολογικού	Case
ηπειρωτικών	ηπειρωτικά	Case
κατανοήσεις	κατανόηση	Number
ανθρακωρύχου	πρωτεΐνης	lemma
σφάλματος	σφαλμάτων	Number
όρχεως	όρχις	Case
προορισμούς	προορισμό	Number
ρόδου	ρόδων	Number
σκάφους	σκάφος	Case
Σκότου	Σκότων	Number
ανηψούλα	ανηψούλας	Case
αντίγραφα	αντιράφων	Case
τσάρο	τσάρου	Case
ξεχάστηκε	ξεχάστηκα	Person
παραβάλλετε	παραβάλλω	Person
προορισμοί	προορισμών	Case
χονδρικό	χονδρική	Gender
αηδονιού	αηδόνι	Case
ορθόδοξες	ορθόδοξη	Number
παραρτήματα	παράρτημα	Number
κουστούμια	κουστουμιών	Case
αραβικά	αραβικών	Case
καταστρέφουν	καταστρέφει	Person
καταπρακτικᾱ́ς	καταπρακτικᾱ́	Number
αρσενικό	αρσενικά	Number
πολιτισμό	πολιτισμός	Case
κηλίδες	κηλίδων	Case
δυσκολογιάτρευτου	μαλγασικού	lemma
συμπαθητική	συμπαθητικές	Number
ψυχολογικές	ψυχολογική	Number
ιππικού	ιππικό	Case
ακρωτηριών	ακρωτήρια	Case
σιρόπια	σιρόπι	Number
χώροι	χώρος	Number
αντεπίθεση	αντεπίθεσης	Case
θάμνοι	θάμνων	Case
μάγουλα	μάγουλο	Number
κωφώσεων	κωφώσεις	Case
Ασιάτισσας	Ασιατισσών	Number
συρματόσχοινων	συρματόσχοινα	Case
σκαραβαίοι	σκαραβαίους	Case
αυξομειώθηκε	αυξομειωθήκαμε	Person
γιορταζόσασταν	γιορταζόταν	Person
επαναστάτες	επαναστατών	Case
καταπελτικώ	χρυσελεφαντίνω	lemma
διαγωνίσματος	διαγώνισμα	Case
πόρδους	πόρδων	Case
αισθητηρίου	αισθητήριο	Case
αντικειμενικότατε	ποιητικότατε	lemma
εκπαραθύρωσης	εκπαραθυρώσεων	Number
εξωτερικές	εξωτερικών	Case
αθλήτριας	αθλητριών	Number
πολιτισμούς	πολιτισμών	Case
φασιστικά	φασιστικό	Number
δέρας	δέρατος	Case
έβρισκες	έβρισκαν	Person
ζώδια	ζώδιο	Number
Ερυθραίους	Ερυθραίο	Number
ανθρώπινα	ανθρώπινες	Gender
ο	υγιεινό	lemma
βολιδοσκοπηθήκατε	βολιδοσκοπήθηκες	Person
δηλώνουν	δηλώνετε	Person
στοματικές	στοματικά	Gender
αναγνώρισαν	αναγνώρισε	Number
σφραγίδα	σφραγίδας	Case
βουτούν	βουτούσαν	Tense
βαδιστή	φασσοπερίστερο	lemma
φυλλοβόλα	φυλλοβόλο	Gender
πετάλου	πέταλο	Case
αντιβίωσης	αντιβιώσεων	Number
πολυμερούς	πολυμερές	Case
χαιρετούσαν	χαιρετούσε	Number
ήχου	ήχων	Number
ακαμάτη	ακαμάτηδων	Number
περιβαλλοντικοί	περιβαλλοντικούς	Case
γκρίζου	γκρίζο	Case
καθιστικά	λύκεια	lemma
βροχερέ	βροχεροί	Number
μεγαλομανίας	μεγαλομανία	Case
ριγών	ρίγες	Case
λειτουργίες	λειτουργία	Number
βαβούρα	βαβούρας	Case
αρχιμάγειρα	αρχιμάγειρας	Case
γαμπρέ	γαμπρός	Case
βομβιστές	βομβιστής	Number
οπλισμένο	οπλισμένου	Case
αστεροσκοπείων	αστεροσκοπεία	Case
καταφρονούνται	καταφρονούμαστε	Person
αβάσιμη	αβάσιμες	Number
ευφορία	ευφορίας	Case
έγγραφων	έγγραφες	Case
άριστων	άριστου	Number
κρύβουν	κρύβει	Number
χήρου	χήρος	Case
άδειε	άδειο	Gender
αδήλωτη	μεσοζωική	lemma
μουστάρδας	μουστάρδα	Case
Παραγουανών	Παραγουανοί	Case
θεάματος	θεαμάτων	Number
ασχολιόταν	ασχολείται	Tense
κόπους	κόπο	Number
εντάσεις	υποκοριστικά	lemma
αρχισυντάκτη	αρχισυντάκτης	Case
λιμανιών	λιμάνια	Case
μελανώματα	μελάνωμα	Number
σερίνη	σερίνης	Case
γλυπτικές	γλυπτική	Number
γονιμότητα	γονιμότητας	Case
αμίαντο	αμίαντου	Case
σκωτσέζικε	σκωτσέζικο	Gender
πρόσθετα	προσθέταμε	Number
ανθρωποκτονίας	ανθρωποκτονία	Case
αυτιστικό	αυτιστικά	Number
μητρώου	μητρώο	Case
τρομπέτες	τρομπετών	Case
φτωχική	φτωχικές	Number
ειδωλίου	ειδώλιο	Case
αναερόβιας	αναερόβια	Case
αναχαίτιζε	ξεραινόταν	lemma
αἰτίοιν	ἀστείοιν	lemma
πεζοναύτη	πεζοναυτών	Number
ζητιάνο	ζητιάνος	Case
πυραύλους	πυραύλων	Case
δούλη	δούλης	Case
έβγαλαν	βγάλατε	Person
αμερόληπτες	αμερόληπτοι	Gender
κτήριο	κτηρίου	Case
κυττάρων	κύτταρα	Case
λεσβίες	λεσβία	Number
μουρμουρίζετε	μουρμουρίζεις	Person
ανθρωποφάγους	ανθρωποφάγο	Number
αλληλεπιδράσεις	αλληλεπίδραση	Number
αγιογράφο	αγιογράφου	Case
ρήματος	ρημάτων	Number
άβροχα	συμφωνικά	lemma
παραβάλλει	παραβάλλεις	Person
αράπη	αράπης	Case
γκάιντας	γκάιντα	Case
κλειστείτε	κλειστήκατε	Tense
σπάγκο	σπάγκος	Case
ξάδελφοι	ξάδελφους	Case
συνηγόρου	συνήγορος	Case
τσιμινιέρες	τσιμινιερών	Case
φυγάδα	φυγάς	Case
ίχνη	ιχνών	Case
διαιτολόγο	διαιτολόγε	Case
δρυοκολάπτη	δρυοκολάπτης	Case
επισκευής	επισκευή	Case
έργου	έργων	Number
επιχειρηματικό	επιχειρηματική	Gender
παραλληλόγραμμο	παραλληλογράμμου	Case
καρβοξυλικοί	καρβοξυλικά	Gender
βολιβιανή	βολιβιανής	Case
αεριόφως	αεριόφωτος	Case
σταθμό	σταθμέ	Case
κτηρίου	κτηρίων	Number
πτερύγιο	πτερυγίου	Case
αντιβιοτικά	χαζά	lemma
ανάποδη	μωρό	lemma
μουριές	μουριά	Number
νεφρού	νεφρών	Number
προφορικούς	προφορικές	Gender
γιαπωνέζικων	πετραρχικών	lemma
καλωσόρισα	καλωσόρισες	Person
αιχμαλωσίας	αιχμαλωσία	Case
ουδέτερο	ουδετέρου	Case
άγραφων	οικείων	lemma
ματωμένος	ματωμένο	Gender
άρκτων	άρκτοι	Case
λαγοί	λαγός	Number
επιβάλλεις	επιβάλλουν	Person
εμπρήστριες	εμπρήστρια	Number
εκπίπτει	εκπίπτουν	Number
ανησύχησε	κατέστησε	lemma
υπαρξισμό	υπαρξισμού	Case
Αρμενίων	Αρμένιοι	Case
ψηφίων	ψηφία	Case
γλάρο	γλάρου	Case
άσσο	άσσου	Case
ταχυδρόμου	ταχυδρόμων	Number
προσεγγίσεων	προσεγγίσεις	Case
δηλώνουν	δηλώνεις	Person
ντουλάπες	ντουλάπα	Number
συνόδευε	συνόδευαν	Person
βενετσιάνικα	βενετσιάνικοι	Gender
ασθενοφόρα	ασθενοφόρο	Number
αβαθείς	αβαθής	Number
εκτιμούμε	εκτιμάτε	Person
αντρικούς	αντρικές	Gender
περνάτε	πέρνα	Number
επιγονατίδας	επιγονατίδων	Number
φιλανδικό	φιλανδικά	Number
τούβλου	τούβλων	Number
θεσμών	θεσμοί	Case
καλυβών	καλύβες	Case
βοϊδινοί	βοϊδινά	Gender
γαλήνιος	γαλήνιο	Gender
φεσιού	φεσιών	Number
Μαυριτανούς	Μαυριτανών	Case
ανώνυμη	ανώνυμης	Case
πλήκτρο	πλήκτρου	Case
συντομογραφίας	συντομογραφιών	Number
αντιστοιχίες	αντιστοιχία	Number
Γκαμπονέζες	Γκαμπονέζων	Case
μοιχείες	μοιχεία	Number
πιπερόριζας	πιπερόριζα	Case
κωνσταντινουπολίτικε	κωνσταντινουπολίτικο	Case
μαυροψαρόνου	μαυροψάρονο	Case
μανδαρίνε	μανδαρίνος	Case
βαδίζει	βαδίζουν	Number
άδικα	άδικων	Case
κανιβάλων	κανίβαλοι	Case
γυρεύει	προετοιμάζει	lemma
εγκατάστασης	εγκαταστάσεων	Number
αγροκαλλιεργειών	αγροκαλλιέργειες	Case
σιδερένιου	σιδερένιων	Number
ακαδημιών	ακαδημίες	Case
ιστοχώρου	ιστοχώρος	Case
επιχειρησιακό	επιχειρησιακού	Case
ιστιοφόρων	ιστιοφόρα	Case
περιορίζετε	περιορίζατε	Tense
τιμήματα	τιμημάτων	Case
παίκτριες	παίκτρια	Number
αραβικών	μολδαβικών	lemma
λαθών	λάθη	Case
ακολουθεί	ακολουθούσε	Tense
επαναστάσεων	επαναστάσεις	Case
εξωτικά	εξωτικών	Case
κουνουπίδια	κουνουπίδι	Number
πλοίου	πλοίων	Number
νεροαρουραίοι	νεροαρουραίους	Case
ξενοδοχείο	ξενοδοχείου	Case
δείχνει	πηδά	lemma
πηδαλίου	πηδάλιο	Case
όμιλοι	ομίλων	Case
αναρχικής	αναρχικών	Number
έβαζα	βάζαμε	Person
φονταμενταλισμούς	φονταμενταλισμοί	Case
κοκκινολαίμηδες	κοκκινολαίμης	Number
ξακουστών	ξακουστού	Number
μαγματική	μαγματικές	Number
φορτίων	φορτία	Case
Σκοτσέζου	Σκοτσέζε	Case
θεσμούς	θεσμό	Number
ματιές	ματιά	Number
ασιατικό	ασιατικά	Number
ηλίανθων	ηλίανθοι	Case
αγκαλιάς	αγκαλιά	Case
ενηλικιώνονται	πολεμούν	lemma
διαιρέσεων	διαιρέσεις	Case
περιττών	περιττοί	Case
έργων	έργα	Case
βορειοανατολικούς	βορειοανατολικά	Gender
περσικό	περσική	Gender
προσιτά	προσιτών	Case
βρεφοκομείου	βρεφοκομείο	Case
καινοῖς	ὀσμητοῖς	lemma
μεταφραστική	μεταφραστικές	Number
αποτυπώματα	αποτύπωμα	Number
αναπαραγωγής	αναπαραγωγή	Case
εὐθέε	ἐλευθέρω	lemma
συζητάνε	συζητεί	Person
αποβιβάζονται	υπερχειλίζουν	lemma
οχήματα	οχημάτων	Case
ακίνητη	ακίνητο	Gender
υποχρέωση	υποχρέωσης	Case
γρασίδι	γρασιδιού	Case
τραπεζογραμμάτιο	τραπεζογραμματίου	Case
αφής	αφών	Number
ισοπαλίας	ισοπαλιών	Number
οίκο	οίκου	Case
οξειών	οξείες	Case
αγανακτούμε	αγανακτείς	Person
κλίσεων	κλίσεις	Case
περσικοί	περσικούς	Case
τοποθετούσατε	τοποθετούσε	Person
αλκοολικός	αλκοολικέ	Case
γάτας	γάτα	Case
υπήνεμη	υπήνεμο	Gender
ελλειμμάτων	ελλείμματα	Case
λιθουανικού	λιθουανικών	Number
παρεμβατισμό	παρεμβατισμός	Case
δημοσιεύσει	φορεθεί	lemma
εθελόντριες	εθελοντριών	Case
ήρε	καθιέρωσε	lemma
χρωστώ	χρωστάς	Person
αποκατάστασης	αποκατάσταση	Case
χαρτογράφο	χαρτογράφου	Case
κομμουνισμό	κομμουνισμού	Case
ναζιστικές	ναζιστικοί	Gender
συμβόλαια	συμβόλαιο	Number
ανθρώπινο	λείο	lemma
εργάτριας	εργατριών	Number
ντουλάπια	ντουλάπι	Number
ημερήσια	ημερήσιο	Gender
πλεξίματος	πλέξιμο	Case
τελέστηκαν	τελέστηκες	Person
μοναστήρια	μοναστηριών	Case
ζυμαρικά	ζυμαρικών	Case
φοβίζει	φοβίζουν	Number
κυβερνήτες	κυβερνητών	Case
σκαντζόχοιρου	σκαντζόχοιρος	Case
Γερμανίδας	Γερμανίδα	Case
τζιτζικιών	τζιτζίκια	Case
θέατρο	θεάτρου	Case
αυταρχικότητες	αυταρχικότητα	Number
γαρίδες	γαρίδα	Number
καταλληλότερες	ωμότερες	lemma
εξεγείρετε	εξεγείρουμε	Person
είχες	είχατε	Person
ινδικών	ινδικές	Case
απλοποιιόμαστε	κουβαλούσαμε	lemma
αζύγιαστες	αζύγιαστη	Number
εὐθειαι	εὐθείαις	Case
κοπτήρες	κοπτήρα	Number
πρόχειρα	προχείρων	Case
πολικέ	πολικός	Case
αεροσκάφους	αεροσκάφος	Case
λαίδες	λαίδων	Case
γλυπτού	γλυπτών	Number
εργαζόμενο	εργαζόμενα	Number
καθόδου	καθόδων	Number
καταχώρηση	καταχώρησης	Case
ανθεκτική	ανθεκτικό	Gender
ποδιών	ποδιές	Case
υπερήπειροι	υπερήπειρε	Number
κομορικής	κομορική	Case
νεύρωσης	νεύρωση	Case
πρότασης	προτάσεων	Number
συνεχείς	συνεχή	Gender
αμφιθεάτρων	αμφιθέατρα	Case
γυαλιστερό	γυαλιστερά	Number
παλαιοῖν	συμμαχικοῖν	lemma
οβελίσκους	οβελίσκο	Number
αρχόντισσα	αρχόντισσας	Case
κρατούσα	κρατούσατε	Person
μανώ	Ἀθηναίω	lemma
περίμετρο	περίμετρος	Case
αθωωθεί	εξασφαλιστεί	lemma
εργάζεται	εργάζεστε	Person
αναζήτησα	ρώτησα	lemma
Μαλινέζοι	Μαλινέζους	Case
αποξενώστε	αποξένωσε	Person
χρωμοσώματος	χρωμόσωμα	Case
ουρακοτάγκοι	ουρακοτάγκων	Case
κρεμαστάρι	κρεμασταριού	Case
τραπεζίτη	τραπεζιτών	Number
αναγνωριστεί	αναγνωριστούν	Person
ημισφαίρια	ημισφαιρίων	Case
πρωινά	πρωί	Number
κατηγορήθηκες	κατηγορηθήκαμε	Person
συμβόλου	σύμβολο	Case
φροντιστή	φροντιστών	Number
καυλιάρη	καυλιάρηδων	Number
ποδοσφαιρικές	ποδοσφαιρική	Number
εθισμού	εθισμών	Number
βγαλθήκαμε	βγαλθούμε	Tense
αλιγάτορες	αλιγάτορας	Number
γαύρε	γαύρος	Case
κρατούσαμε	κρατούσα	Number
σύναξης	συνάξεων	Number
φαίνονταν	φαίνονται	Tense
σειρήνες	σειρήνων	Case
στοιχηματίζετε	στοιχηματίζει	Person
αρκετού	λιβυκού	lemma
άσσου	άσσων	Number
ταυρομάχου	ταυρομάχε	Case
τσιμπούκια	τσιμπουκιών	Case
βαπτιστικό	ἐπισυνθετικόν	lemma
ιδιωτικοποιήσεις	ιδιωτικοποίηση	Number
έξοδοι	εξόδων	Case
όμηρο	όμηρος	Case
πιτσαδόρο	πιτσαδόρου	Case
νυκτόβια	νυκτόβιες	Number
κόμπο	κόμπε	Case
συναντώ	συναντάτε	Person
ενεργοποιήσεις	ενεργοποίηση	Number
συνεργό	συνεργός	Case
ανακουφιστεί	ανακουφιστούν	Number
τακουνιού	τακουνιών	Number
πηγαίας	πηγαία	Case
πολεμικό	πολεμικός	Gender
πηδάλια	πηδάλιο	Number
καλλιφωνότεροι	ψηφιακότεροι	lemma
μπούφου	μπούφος	Case
καννάτας	καννατών	Number
αδιάβλητα	τηγανιτά	lemma
εξοπλίζει	εξόπλιζε	Tense
διαβάστηκε	διαβάστηκαν	Number
παρόντες	παρόντα	Gender
αναλογιστεί	συγκεντρωθεί	lemma
ανέβαλλες	αναβάλλεις	Tense
προκλήσεις	πρόκληση	Number
κατάσχεση	κατάσχεσης	Case
λιτανείας	λιτανειών	Number
ακατανίκητο	φωτογραφικό	lemma
συνεχόμενο	συνεχόμενη	Gender
πυροσβέστες	πυροσβέστη	Number
βολίδες	βολίδα	Number
αρπακτικά	αρπακτικών	Case
ελπίζετε	καταστρέφετε	lemma
παλιρροιακές	παλιρροιακών	Case
ρεβιθάδας	ρεβιθάδα	Case
πλήκτρα	πλήκτρων	Case
αχτίνων	αχτίνες	Case
γλώσσας	γλώσσα	Case
ποσοστά	ποσοστών	Case
φιδιών	φίδια	Case
φάκελε	φάκελος	Case
λαθρέμποροι	λαθρέμπορους	Case
σπηλιές	σπηλιά	Number
γκρεμό	γκρεμού	Case
δραματουργούς	δραματουργοί	Case
αυτοδύναμων	αυτοδύναμης	Number
άκαμπτα	άκαμπτων	Case
ανιχνεύει	ανιχνεύουν	Number
αρμαντίλο	αρμαντίλου	Case
θαυμάσιοι	θαυμάσιων	Case
αυλάκια	αυλάκι	Number
μονοπάτια	μονοπάτι	Number
οικισμών	οικισμοί	Case
φασκομηλιάς	φασκομηλιών	Number
βασικός	βασικό	Gender
λεξικᾱ́	ἰσχυρᾱ́	lemma
οισοφάγο	οισοφάγος	Case
κεντριστεί	κεντριστώ	Person
θρυλικότατης	χαλαρότατης	lemma
γραφεία	γραφείο	Number
ποτό	ποτού	Case
αγγλισμό	αγγλισμού	Case
ανησυχιών	ανησυχίες	Case
ριζώματος	ρίζωμα	Case
αβγάτισαν	αβγάτισε	Person
φράκτες	φρακτών	Case
συντριβάνι	συντριβανιού	Case
αιφνιδιασμού	αιφνιδιασμέ	Case
αδειανό	αδειανός	Case
γλυκίσματος	γλυκισμάτων	Number
βάλτους	βάλτων	Case
είσοδοι	είσοδος	Number
αιγυπτιακά	αιγυπτιακών	Case
βερνικιού	βερνικιών	Number
συλλογής	συλλογή	Case
υπονοιών	υπόνοιες	Case
ευθύτερων	υπεροπτικότερων	lemma
Λουξεμβουργιανών	Λουξεμβουργιανοί	Case
ανθρωποφάγου	ανθρωποφάγος	Case
ορίζοντες	ορίζοντα	Number
ισχίου	ισχίων	Number
προσωπικοτήτων	προσωπικότητες	Case
παρακείμενος	παρακείμενου	Case
αιγυπτιολόγους	αιγυπτιολόγοι	Case
βασανιστές	βασανιστών	Case
υπερκείμενο	υπερκείμενου	Case
βιοχημεία	βιοχημείας	Case
ημιόνους	τραγούδια	lemma
παρατατικού	παρατατικός	Case
αβροφροσύνης	αβροφροσύνη	Case
κουλούρας	κουλούρα	Case
απατά	προσγειώνει	lemma
καρωτίδας	καρωτίδα	Case
πούτσες	πούτσα	Number
λιμένες	λιμένας	Number
αεροποριών	αεροπορίες	Case
καταδρομή	καταδρομής	Case
ψευδοεπιστήμη	ψευδοεπιστήμης	Case
δημοσιεύματα	δημοσίευμα	Number
ευχετήριοι	ευχετήριε	Number
ψυχίατρο	ψυχιάτρου	Case
συμφώνου	σύμφωνο	Case
επιχειρηματίες	επιχειρηματιών	Case
πανηγυριού	πανηγύρι	Case
επιθέσεις	επιθέσεων	Case
αγωνιώδη	αγωνιώδες	Gender
απασχολείται	κουράζεται	lemma
αβολίδωτη	αβολίδωτης	Case
πορτοκαλεώνα	πορτοκαλεώνων	Number
καθαριστές	καθαριστών	Case
ασφάλιση	ασφάλισης	Case
χρηματιστηρίου	χρηματιστήριο	Case
ύπαρξης	υπάρξεων	Number
ισοπαλίες	ισοπαλία	Number
αβουλία	αβουλίας	Case
καλλιτέχνη	παραμέτρου	lemma
αρτοποιών	αρτοποιοί	Case
κρουαζιερόπλοια	κρουαζιερόπλοιο	Number
μειωτέου	μειωτέε	Case
πατριάρχη	πατριαρχών	Number
διάδρομο	διαδρόμου	Case
αλευρόμυλους	αλευρόμυλο	Number
χωρητικότητα	χωρητικότητας	Case
καπνοδόχους	καπνοδόχοι	Case
αλγορίθμων	αλγόριθμοι	Case
μεταφραζόμαστε	μεταφράζομαι	Person
ἐμπρακτικοῖς	ἐμπρακτικᾰ́	Case
ανοίγονται	ανοίγεται	Person
κατσαρή	κατσαρές	Number
καρδιναλίου	καρδινάλιος	Case
ανθοπώλιδας	ανθοπωλίδων	Number
συγχωνεύει	συγχωνεύουμε	Person
υλιστικά	υλιστικοί	Gender
Ιρλανδού	Ιρλανδός	Case
αδυναμίας	αδυναμιών	Number
μαρτύρια	μαρτυρίων	Case
υπόγειας	υπόγεια	Case
βολβό	βολβού	Case
σκούρας	σκούρου	Gender
ψηφία	ψηφίο	Number
βυρσοδεψών	βυρσοδέψες	Case
πρόεδρο	πρόεδρος	Case
ύφεσης	ύφεση	Case
νέγρο	νέγρος	Case
ανώνυμη	ανώνυμε	Gender
ρίχνω	ρίχνουν	Person
φασολιού	φασόλι	Case
λωτών	λωτοί	Case
αιγυπτιολόγοι	αιγυπτιολόγους	Case
ψεύτικη	ψεύτικο	Gender
ψωμάδικο	ψωμάδικου	Case
νικητήριους	νικητήριο	Number
σκυλάδικο	σκυλάδικου	Case
καλαμιές	καλαμιών	Case
αθλητικότερες	μελανότερες	lemma
ατίθασου	παράλογου	lemma
κυτταρικά	κυτταρικών	Case
εξορίες	εξορία	Number
βιολονίστα	βιολονιστών	Number
αβέβαιης	αβέβαιων	Number
ευδιάκριτες	ευδιάκριτη	Number
ικριώματα	ικρίωμα	Number
κοκκινίσματα	κοκκίνισμα	Number
εισροής	εισροή	Case
αναγνωρίζομαι	αναγνωρίζονται	Person
σκορδάτα	σκορδάτο	Number
φλαουτίστας	φλαουτίστα	Case
αμαρταίνατε	αμάρταινες	Person
γραμματόσημα	γραμματόσημο	Number
βοτανικής	βοτανική	Case
απογόνους	απόγονοι	Case
διπλασιαζόταν	διπλασιαζόμασταν	Person
ἀντιλογητικόν	ἀντιλογητικοῦ	Case
συντομογραφίες	συντομογραφιών	Case
διακριτικά	διακριτικές	Gender
αγριογούρουνα	αγριογούρουνο	Number
διαδρομής	διαδρομή	Case
διαπέρασαν	συζήτησαν	lemma
διαστημόπλοια	διαστημοπλοίων	Case
χειμωνιάτικο	χειμωνιάτικος	Gender
ηπειρωτικό	πρώιμο	lemma
τραβούν	τραβά	Person
λειμώνα	λειμώνας	Case
κοιμάται	κοιμάστε	Person
τελετών	τελετές	Case
καλογεροπούλου	καλογερόπουλο	Case
καταλάβαινε	καταλάβετε	Person
περιορισμένη	περιορισμένος	Gender
κελιού	κελιών	Number
θαλασσιές	θαλασσιά	Gender
κεδνῶν	κεδνᾰ́	Case
ξενυχτούσατε	ξενυχτούσαμε	Person
σιτοβολώνων	σιτοβολώνες	Case
βούρτσας	μηχανήματος	lemma
καζάκικη	καζάκικο	Gender
στοίχισες	στοίχισαν	Person
κοιμητήρια	κοιμητήριο	Number
κιθαριστές	κιθαριστής	Number
Καταλανούς	Καταλανοί	Case
έπαινοι	επαίνων	Case
νάρκισσο	νάρκισσου	Case
συνδύασες	συνδύασε	Person
αλυσίδα	αλυσίδας	Case
γυρίνοι	γυρίνος	Number
ορυχεία	ορυχείων	Case
κουνάβια	κουναβιών	Case
σιταποθήκες	σιταποθήκη	Number
καταδίκου	καταδίκων	Number
αδυνατίσματα	αδυνατισμάτων	Case
παντοτινού	παντοτινών	Number
ημισφαιρίων	ημισφαίρια	Case
δοκαριού	δοκαριών	Number
χαρτογράφους	χαρτογράφο	Number
αυτοκτονιών	αυτοκτονίες	Case
συχνότητας	συχνότητα	Case
βρώσιμης	βρώσιμη	Case
αγένειοι	αγένειων	Case
αλατίσαμε	αλάτισες	Person
πολυθρόνες	πολυθρόνα	Number
δήμαρχο	δήμαρχου	Case
μέθη	μέθης	Case
εργατικότητα	εργατικότητας	Case
σπάγγοι	σπάγγους	Case
χρεώναμε	χρέωνα	Number
τάφρου	τάφρος	Case
χταπόδι	χταποδιού	Case
υπουργό	υπουργού	Case
διασχίζει	διασχίζουν	Number
δείκτης	προσκύνημα	lemma
λευχαιμίες	λευχαιμία	Number
λιπαρού	λιπαρών	Number
κοιμάστε	κοιμάσαι	Number
αυχένα	αυχένας	Case
γογγύλι	γογγυλιού	Case
απρεπή	απρεπείς	Gender
καλείς	καλεί	Person
ξενοδόχο	ξενοδόχου	Case
πονοκέφαλοι	πονοκεφάλων	Case
οικονόμους	οικονόμοι	Case
υποκριτή	υποκριτής	Case
έγγραφο	εγγράφου	Case
σκατολογική	σκατολογικής	Case
πράο	πράος	Case
νέγρους	νέγροι	Case
τελείωσε	τελείωσαν	Number
βελόνια	βελόνι	Number
αποστολής	αποστολών	Number
πολωνική	πολωνικό	Gender
χαρακτήρες	χαρακτήρων	Case
κομμουνισμός	κομμουνισμού	Case
ρίγες	ρίγα	Number
ανακρινόμαστε	προσθέτουμε	lemma
ακανθόχοιρο	ακανθόχοιρε	Case
προληπτικό	προληπτικού	Case
νηρηίδας	νηρηίδα	Case
ακάματη	ακάματες	Number
απόπατο	απόπατε	Case
διαπιστευτήρια	διαπιστευτήριο	Number
διαμαρτυριών	διαμαρτυρίες	Case
κατασκευαστικῆς	κατασκευαστικαῖν	Number
αδιάντροπης	αδιάντροπων	Number
αποζημιώθηκε	αποζημιωθήκαμε	Person
κουκιά	κουκιών	Case
αερόλιθο	αερολίθου	Case
βομβαρδιστικέ	μαγικέ	lemma
δερματολόγο	δερματολόγου	Case
παραλλαγής	παραλλαγή	Case
ισραηλινών	ισραηλινοί	Case
πανελλήνιο	πανελληνίου	Case
αντιπάθειας	αντιπάθεια	Case
αίρει	ήρε	Tense
καμηλοπαρδάλεις	καμηλοπαρδάλεων	Case
φάτνη	φάτνης	Case
αγιορείτες	αγιορειτών	Case
καμπύλες	καμπυλών	Case
δουλεμπόρους	δουλεμπόρων	Case
σπιτικών	σπιτικής	Number
εκδόσεις	έκδοση	Number
πέταξα	πετάξαμε	Number
κάγκελων	κάγκελα	Case
βάρδιας	βάρδια	Case
σκαντζόχοιρου	σκαντζόχοιρων	Number
κατσικών	κατσίκες	Case
σφήνες	σφηνών	Case
συνδρομητές	συνδρομητή	Number
μαϊντανό	μαϊντανός	Case
ουρανίσκου	ουρανίσκος	Case
λεμόνι	λεμονιού	Case
ανυπακοή	ανυπακοής	Case
αγουρόλαδου	αγουρόλαδο	Case
ανηψιές	πονόδοντοι	lemma
Βόσνιες	Βόσνιων	Case
αμυγδαλές	αμυγδαλή	Number
δίπλες	διπλών	Case
χειμώνες	χειμώνων	Case
μυρμηγκιού	μυρμήγκι	Case
ρωμαϊκή	ρωμαϊκό	Gender
έχιδνας	έχιδνα	Case
χειρουργικές	χειρουργική	Number
κανονισμούς	κανονισμοί	Case
πρόσκοπο	πρόσκοπος	Case
εορτές	εορτών	Case
κατηγορείται	κατηγορούνται	Person
συνεχιστούμε	συνεχιστώ	Number
ανθρακικό	ανθρακικά	Number
ωάρια	ωαρίων	Case
ανθρακωρύχοι	ανθρακωρύχε	Number
ασυνίζητων	ασυνίζητης	Number
αποδοτικοτήτων	αποδοτικότητες	Case
εγκολπωνόσουν	εγκολπωνόσασταν	Person
εγκληματική	εγκληματικής	Case
ελέγχομαι	ελέγχεστε	Person
τετράδια	τετραδίων	Case
εξυπηρετητές	εξυπηρετητής	Number
πληροφοριοδοτών	πληροφοριοδότες	Case
νάνο	νάνου	Case
γλωσσολόγοι	γλωσσολόγος	Number
μυθιστορήματα	μυθιστορημάτων	Case
ρεβυθοκεφτέ	ρεβυθοκεφτές	Case
κλιματισμοί	κλιματισμούς	Case
σφαιριδίου	σφαιρίδιο	Case
αντίβαρο	αντίβαρου	Case
μπαρμπουνιού	μπαρμπουνιών	Number
περιγράφουν	περιγράφετε	Person
ανταμώσεις	αντάμωση	Number
Αβησσυνοί	Αβησσυνών	Case
πειθοῖν	τραυμᾰτῐκοῖν	lemma
κούκοι	κούκων	Case
πανάρχαια	πανάρχαιοι	Gender
αντίβαρου	αντίβαρο	Case
πετραρχικό	πετραρχική	Gender
αισθητοί	αισθητές	Gender
επαφής	επαφών	Number
δένδρου	δένδρων	Number
Σπανιόλου	Σπανιόλε	Case
κρατικοποίησης	κρατικοποίηση	Case
καπνιστή	καπνιστών	Number
κατσαρή	κατσαρός	Gender
απαραίτητου	νικητήριου	lemma
αυτοκράτορος	αυτοκράτωρ	Case
αόρατος	αόρατο	Gender
σκουπίδια	σκουπιδιών	Case
εξατμίσεις	εξάτμιση	Number
νάρκισσε	νάρκισσος	Case
αναμονή	αναμονής	Case
πηνίου	πηνίο	Case
φίλαθλος	φίλαθλο	Gender
μαρκαδόρους	μαρκαδόρο	Number
ημερολογίου	ημερολόγιο	Case
δέος	δέους	Case
σύννεφο	σύννεφου	Case
κυτταρικούς	κυτταρικές	Gender
άσσο	άσσος	Case
σακάκια	σακάκι	Number
λοιμώδους	λοιμώδη	Case
βελγικά	βελγικό	Number
μακαρίῳ	ἀρτίῳ	lemma
απολύσεις	απολύσεων	Case
ανυπόταχτη	ξυπνητή	lemma
αμαλγάματος	αμάλγαμα	Case
ανάποδης	ανάποδη	Case
διεύθυνσης	διευθύνσεων	Number
μακάκοι	μακάκος	Number
μουστάκια	μουστάκι	Number
έθνη	εθνών	Case
ροφούς	ροφοί	Case
απρεπούς	απρεπή	Case
πικραλίδες	πικραλίδα	Number
σιμπόργκιο	σιμποργκίου	Case
ζυγίζαμε	ζύγιζε	Person
εξωτερικοί	εξωτερικά	Gender
ανθρωπολογικές	ανθρωπολογικά	Gender
σώζετε	σώζε	Number
αδιάθετης	αδιάθετη	Case
περιγραφής	περιγραφή	Case
γάντζε	γάντζος	Case
περιστερώνες	περιστερώνας	Number
καλεί	καλούμε	Person
εριστικότατες	τυχερότατες	lemma
ενεργητική	ενεργητικές	Number
ενδιάμεσους	ενδιάμεσοι	Case
βοηθειών	βοήθειες	Case
μπαταριών	μπαταρίες	Case
τολμημάτων	τολμήματα	Case
τοπίου	τοπίων	Number
εντροπίες	εντροπιών	Case
ταφών	ταφές	Case
χαραμίζαμε	χαράμιζαν	Person
άτλαντες	ατλάντων	Case
άκλιτο	νοτιοανατολικό	lemma
πρόσωπα	προσώπων	Case
πρωτόνια	πρωτονίων	Case
τουαλέτας	τουαλετών	Number
χαψιές	χαψιά	Number
ολιγαρχίας	ολιγαρχία	Case
όσπρια	οσπρίων	Case
διχασμών	διχασμοί	Case
χριστιανικό	χριστιανικά	Number
αφίσες	αφίσα	Number
χωρούσαμε	χωρούσε	Person
είμαι	είναι	Person
αντιπροέδρους	αντιπρόεδρο	Number
σαρδέλας	σαρδέλα	Case
μειωνόσουν	μειωνόμουν	Person
πιστόλι	πιστολιού	Case
αστεριού	αστέρι	Case
σεληνακάτου	σεληνακάτων	Number
μαρμελάδες	μαρμελάδα	Number
δεθήκατε	δεθείτε	Tense
ιαπωνικέ	ιαπωνικοί	Number
άθλοι	άθλων	Case
χιλιοστό	χιλιοστού	Case
κινητήρες	κινητήρα	Number
συρτάρια	συρτάρι	Number
αιγυπτιολόγο	αιγυπτιολόγος	Case
συνδυάστηκε	συνδυαστεί	Tense
βατομουριά	βατομουριάς	Case
έβριζαν	έβριζε	Person
κυράτσα	κυράτσας	Case
προσπαθείτε	προσπάθησε	Person
γραμματοσειρά	γραμματοσειράς	Case
περιποιήσεις	περιποίηση	Number
μπαστουνιές	μπαστουνιών	Case
λαβαίνει	λαβαίνουν	Number
γουρουνιού	γουρούνι	Case
υψηλότερα	υψηλότερων	Case
πρωινό	πρωινού	Case
σύννεφου	σύννεφων	Number
υπερρεαλισμό	υπερρεαλισμός	Case
δασύποδες	δασυπόδων	Case
άκλιτες	υδραυλικές	lemma
ερμητικών	ερμητικοί	Case
καϊσιά	καϊσιών	Case
σκλάβο	σκλάβος	Case
ξεκωλιάστηκαν	ξεκωλιαστούν	Tense
ακάλυπτη	ακάλυπτο	Gender
απομόνωση	απομόνωσης	Case
αμοιβαία	ιδιωματικά	lemma
αθέρας	αθέρα	Case
γάλλιο	γαλλίου	Case
στολίζετε	στολίζατε	Tense
αναμνηστικού	αναμνηστικής	Gender
διαιτολόγους	διαιτολόγο	Number
ακατάλληλος	ακατάλληλο	Case
βετεράνοι	βετεράνους	Case
υπολόγιζε	υπολόγιζαν	Person
αναμορφωτικών	πεμπτῶν	lemma
κυκλική	κυκλικός	Gender
δοκαριού	δοκάρι	Case
βιοτεχνών	βιοτέχνες	Case
αστραφτερή	αστραφτερό	Gender
συντόμευσης	συντόμευση	Case
πατάς	πατούσες	Tense
διορίσατε	παρακοιμηθήκατε	lemma
τείχους	τείχος	Case
πυρίνω	ἀντιπρακτικώ	lemma
κολλαριστούς	κολλαριστά	Gender
θεμελιωδών	θεμελιώδεις	Case
διαχειριστριών	διαχειρίστριες	Case
ζευγάρι	ζευγαριού	Case
Αγαρηνή	Αγαρηνής	Case
αορτής	αορτών	Number
ανθρώπινες	πορνογραφικές	lemma
ρινόκερου	ρινόκερος	Case
ροδιού	ρόδι	Case
κυκλοφορία	κυκλοφορίας	Case
γυμναστές	γυμναστή	Number
μαύρων	μαύρα	Case
γλουτούς	γλουτό	Number
επεμβήκαν	επεμβήκατε	Person
εξοπλιζόταν	εξοπλιζόσουν	Person
επικρατούσε	καθιστούσε	lemma
διαβάζοντας	κρύβοντας	lemma
επηρεάσατε	επηρέασα	Person
λεσβιάζουσες	λεσβιάζουσα	Number
ημιεπαγγελματικές	φιλανθρωπικές	lemma
μεσολαβητών	μεσολαβητές	Case
εξαρτημένοι	εξαρτημένων	Case
γιοι	γιε	Number
μεγάκυκλο	μεγακύκλου	Case
αλβανικές	αλβανικοί	Gender
μονομερών	μονομερούς	Number
δικηγόρου	δικηγόρων	Number
αρσιβαρίστες	αρσιβαρίστας	Number
μυστηριώδη	μυστηριώδες	Number
διαχειριστών	διαχειριστές	Case
βιολονίστα	βιολονίστας	Case
γαλλικός	γαλλικό	Gender
ιερού	ιερών	Number
κλασικότερη	ομορφότερη	lemma
εγκεφάλους	εγκέφαλοι	Case
κούνιες	κούνια	Number
νερόμυλους	νερόμυλων	Case
γιακάδες	γιακά	Number
εφοπλιστές	εφοπλιστή	Number
αιλουροειδές	λιθόστρωτο	lemma
νικήτριας	νικήτρια	Case
αραχνών	αράχνες	Case
χάπια	χάπι	Number
δωροδοκίες	δωροδοκία	Number
εμπαθειών	εμπάθειες	Case
βελανιδιάς	βελανιδιών	Number
μελανών	μελάνες	Case
γέρο	γέρος	Case
νενές	νενέδων	Number
ουδέτερα	ουδέτερο	Number
σημαίες	σημαία	Number
μεταβίβασης	μεταβιβάσεων	Number
οικισμούς	οικισμοί	Case
απότομες	απότομων	Case
αξίας	αξιών	Number
προσπάθησε	προσπαθήστε	Number
διαλύματος	διαλυμάτων	Number
φράκτες	φράκτης	Number
νικέλιο	νικελίου	Case
γιόρτασες	γιόρτασε	Person
ρίγας	ριγών	Number
δακτύλιοι	δακτυλίους	Case
συντομεύσεις	συντομεύσεων	Case
αφέντες	αφέντης	Number
κηπευτικά	κηπευτικών	Case
ψυχιατρικές	ψυχιατρική	Number
λυκάνθρωπου	λυκάνθρωπος	Case
ευλογιές	ευλογιά	Number
αλεξιπτωτιστών	αλεξιπτωτιστές	Case
σκίτσα	σκίτσων	Case
μαρτύρων	μάρτυρες	Case
ανατομή	ανατομής	Case
οπλοποιού	οπλοποιών	Number
σκοπιάς	σκοπιά	Case
κορμούς	κορμοί	Case
επιδερμίδας	επιδερμίδων	Number
εγκεφάλους	εγκέφαλο	Number
κινητικώ	ταλαιπωρικώ	lemma
ανακρίσου	τραγούδησε	lemma
ιδεών	ιδέες	Case
αναδείχναμε	ροχαλίζαμε	lemma
κατάθλιψης	κατάθλιψη	Case
αβανιάρικο	ορθόδοξο	lemma
κανάτας	κανατών	Number
φακέλου	φακέλων	Number
επένδυση	επένδυσης	Case
γαμπρούς	γαμπρών	Case
Παλαιοζωικό	Παλαιοζωικέ	Case
βάσιζε	κολλούσε	lemma
αλλεργίες	αλλεργιών	Case
παρατηρητήριο	παρατηρητηρίου	Case
σώβρακο	σώβρακου	Case
αδερφικός	αδερφική	Gender
οστών	οστά	Case
μεταγενέστερης	μεταγενέστερου	Gender
ξυραφιού	ξυράφι	Case
ανθρακικά	ανθρακικό	Number
χαστούκια	χαστούκι	Number
ιδιοκτησίες	ιδιοκτησιών	Case
γαλβανιζόταν	γαλβανιζόσουν	Person
όρισαν	όρισες	Person
λεσβιάζουσας	λεσβιάζουσα	Case
αδίσταχτα	αδίσταχτων	Case
χούμου	χούμος	Case
βλάχου	βλάχο	Case
κατέφερε	καταφέρει	Tense
καφετέριες	καφετεριών	Case
ρουφήξατε	ρούφηξαν	Person
επεμβαίνουν	επεμβαίνετε	Person
διαιτητή	διαιτητών	Number
ανώδυνες	ανώδυνα	Gender
ψηφοδελτίου	ψηφοδέλτιο	Case
παγόβουνα	παγόβουνο	Number
νοσηλευτές	νοσηλευτών	Case
δολωμάτων	δολώματα	Case
πυρ	πυρός	Case
στιγμιαίο	στιγμιαία	Number
ετοιμότερες	λαμπρότερες	lemma
νεολογισμού	νεολογισμός	Case
είχατε	είχε	Person
κλειτοῖν	Ἐμεσηνοῖν	lemma
πατρίκιο	πατρικίου	Case
απώλειας	απώλεια	Case
πέλαγο	πελάγου	Case
λέβητα	λεβήτων	Number
παπαγάλους	παπαγάλων	Case
αρκτικά	αρκτικές	Gender
μοτοσυκλέτας	μοτοσυκλετών	Number
υπογραμμίζετε	υπογραμμίζουν	Person
ποικιλίας	ποικιλία	Case
γενετικής	γενετική	Case
δούλες	δούλων	Case
πλάτανους	πλάτανο	Number
σημειώσεων	σημειώσεις	Case
αντάρτικου	αντάρτικο	Case
αντισταθμιστούν	αντισταθμιστεί	Number
μπρούτζοι	μπρούτζους	Case
τελετουργίες	τελετουργιών	Case
περσικού	περσικός	Case
μπαχαρικού	μπαχαρικών	Number
αγοραίο	αγοραία	Number
ρατσιστική	ρατσιστικές	Number
κυδώνια	κυδωνιών	Case
γαστρών	γάστρες	Case
μοιράζονται	μοιράζεται	Number
ενοικίου	ενοικίων	Number
φασκιάς	φασκιών	Number
γρύλο	γρύλος	Case
τουφέκια	τουφεκιών	Case
κρατήρες	κρατήρα	Number
προβάδισμα	προβαδίσματος	Case
ελληνικότατο	σωστότατο	lemma
αβεβαιότητες	αβεβαιότητα	Number
βάζουν	έβαζαν	Tense
χειρουργείου	χειρουργείων	Number
χρησιμοποιώ	χρησιμοποιούμε	Number
ύαλοι	ύαλε	Number
αραιότερες	προβληματικότερες	lemma
εσωτερικών	ρουμανικών	lemma
πολυμερές	πολυμερής	Gender
κάβους	κάβο	Number
δροσίζετε	σταματάτε	lemma
διαγωνιζόμενοι	διαγωνιζόμενων	Case
αντιαεροπορικός	παλαιοζωικός	lemma
γαλάζιος	γαλάζιο	Case
αινιγματικότατης	νηφαλιότατης	lemma
χαρτομάντισσας	χαρτομαντισσών	Number
τέκνου	τέκνων	Number
πνεύματος	πνευμάτων	Number
δέντρο	δέντρου	Case
θερμάστρας	θερμάστρα	Case
διαβρωτικότατων	στοργικότατων	lemma
φρύνοι	φρύνων	Case
σκούρα	σκούρο	Gender
βοηθούσα	βοηθούσες	Person
ξενιστή	ξενιστής	Case
ρουμανικά	ρουμανικών	Case
πουλερικά	πουλερικών	Case
υποδοχών	υποδοχές	Case
ύπαρξη	ύπαρξης	Case
κερασιά	τοπίο	lemma
αγιάσει	κολλήσει	lemma
εμπνεύσαμε	ορίσαμε	lemma
θεάτρων	θέατρα	Case
σφετεριστές	σφετεριστής	Number
ξαλμυρίζατε	ξαλμύριζε	Person
κρατουμένους	κρατούμενοι	Case
μονογραφίες	μονογραφιών	Case
βοσκοί	βοσκός	Number
διαδικασίες	διαδικασία	Number
σκόνες	σκονών	Case
μυστηριώδους	μυστηριώδες	Case
ήμουν	φασκιωνόμουν	lemma
ποζιτρονίων	ποζιτρόνια	Case
κτητικά	κτητικοί	Gender
ανατολικότατες	ουσιαστικότατες	lemma
εκσπερματίσατε	τυραννήσατε	lemma
σκόρου	σκόρος	Case
ψυχώσεων	ψυχώσεις	Case
προδρόμου	προδρόμων	Number
πετάτε	πετάς	Number
βομβαρδιστικών	βομβαρδιστικού	Number
αντιπροσώπους	αντιπρόσωπο	Number
απόλυτου	απόλυτων	Number
διάνθισες	διανθίσατε	Person
βιβλιοπωλεία	βιβλιοπωλείο	Number
φωτογράφοι	φωτογράφος	Number
ευρετήριο	ευρετηρίου	Case
εμπόλεμη	εμπόλεμες	Number
κατάδυση	κατάδυσης	Case
ναϊάδας	ναϊάδα	Case
αποικισμού	αποικισμός	Case
διαφήμιση	διαφήμισης	Case
τυλίξαμε	τύλιξες	Person
ρατσισμού	ρατσισμός	Case
είχατε	είχες	Person
φωτογραφικής	φωτογραφική	Case
λέσχης	λεσχών	Number
ζώνης	ζωνών	Number
αδικίες	αδικία	Number
ανακοίνωσης	ανακοινώσεων	Number
αγάπανθο	αγάπανθος	Case
ουσιαστικά	ουσιαστικών	Case
μανταρινιές	μανταρινιών	Case
χτύπους	χτύπων	Case
αβρές	αβροί	Gender
αρχαιοπρεπής	αρχαιοπρεπή	Case
έψαχνα	ψάχνω	Tense
μεθανάλη	μεθανάλης	Case
αμαρτήματος	αμαρτημάτων	Number
αιολική	σιγανή	lemma
ενετικό	ενετικά	Number
κοβάλτιο	κοβαλτίου	Case
χτυπήματα	χτύπημα	Number
ίχνους	ιχνών	Number
βαθμοί	βαθμός	Number
κουνέλια	κουνελιών	Case
διεθνές	διεθνή	Number
δασόκοτας	δασόκοτα	Case
εστίας	εστιών	Number
πινέλο	πινέλου	Case
αμυγδαλές	αμυγδαλών	Case
κεχριμπαρένιες	κεχριμπαρένια	Number
συγχωνεύσαμε	συγχώνευσες	Person
χωριού	χωριών	Number
απαιτούμε	απαιτώ	Person
μελωδίας	μελωδία	Case
σάλτσας	σάλτσα	Case
αβγοθήκη	αβγοθήκης	Case
λογοκρισίας	λογοκρισία	Case
οικισμοί	οικισμών	Case
αγύμναστο	αγύμναστε	Case
διαζυγίου	διαζυγίων	Number
ομίλου	όμιλος	Case
αδιάπτωτου	αδιάπτωτης	Gender
στερεού	στερεό	Case
αθηναϊκά	αθηναϊκό	Number
ουτοπικές	ουτοπική	Number
ενδοχώρας	ενδοχώρα	Case
οπτικές	οπτική	Number
κανιβαλισμούς	κανιβαλισμοί	Case
ευτυχισμένο	σπασμένο	lemma
έχουμε	έχω	Person
διεπαφές	διεπαφή	Number
εργαστήρια	εργαστήρι	Number
αγιορείτικου	αγιορείτικο	Case
πολύγωνα	πολυγώνων	Case
επιφύλαξη	επιφύλαξης	Case
υποχρεώσεις	υποχρέωση	Number
αμυγδαλών	αμυγδαλές	Case
γαλλικό	πολύπλοκο	lemma
ἀδνῆς	ἀδνή	Case
ορφανούς	ορφανές	Gender
γατόπαρδοι	γατόπαρδος	Number
ἀλλοτρίαιν	ἀλλοτρίᾳ	Number
εκτελέσεις	εκτελέσεων	Case
θετᾱ́	τυφλᾱ́	lemma
μακαρόνια	μακαρόνι	Number
λίρες	λιρών	Case
αρχιναύαρχο	αρχιναυάρχου	Case
συμπεριφορές	συμπεριφορών	Case
δένεται	χρηματίζει	lemma
δρομολογητές	δρομολογητή	Number
εισροών	εισροές	Case
αργαλειό	αργαλειού	Case
προγονού	προγονέ	Case
υλοζωισμό	υλοζωισμός	Case
αιχμαλωτίστηκα	αιχμαλωτίστηκες	Person
μοτοσυκλέτες	μοτοσυκλετών	Case
υπερασπίστηκαν	υπερασπίστηκε	Number
όλο	όλου	Case
ιδιωτικοποίησης	ιδιωτικοποιήσεων	Number
εγκυκλοπαίδειες	εγκυκλοπαιδειών	Case
ακλόνητο	ακλόνητος	Gender
αστερισμούς	αστερισμό	Number
διάδρομοι	διάδρομος	Number
γλωσσικής	γλωσσική	Case
καστανές	καστανούς	Gender
συντομογραφίας	συντομογραφία	Case
σκότωσε	σκοτώστε	Number
νοτιοαμερικανικής	νοτιοαμερικανικών	Number
γκαρσόνια	γκαρσόνι	Number
πολωνικά	πολωνικών	Case
κέντρο	κέντρου	Case
αδιαχώρητο	αδιαχώρητου	Case
γλύπτες	γλύπτης	Number
τόννοι	τόννος	Number
εκκένωση	εκκένωσης	Case
προγεννητικό	προγεννητική	Gender
φιλολογίες	φιλολογία	Number
εθνογλωσσολόγου	εθνογλωσσολόγων	Number
δωρίζεις	φθάνεις	lemma
αντικείμενα	αντικειμένων	Case
ασπαστεί	εκκενωθεί	lemma
κινητό	κινητού	Case
περιβάλλοντα	περιβάλλον	Number
έλεγξα	έλεγξαν	Person
τάση	τάσης	Case
ημίθεοι	ημίθεος	Number
ανθρακούχα	ανθρακούχες	Gender
προίκες	προίκα	Number
βάτοι	βάτους	Case
τάλιρου	τάλιρο	Case
αλκοολικούς	αλκοολικές	Gender
άτομα	άτομο	Number
διττή	μεσημβρινή	lemma
γύρισμα	γυρίσματος	Case
χηνών	χήνες	Case
δυσλειτουργίες	δυσλειτουργιών	Case
βάλτων	βάλτοι	Case
ακέραιοι	ακέραιων	Case
μάντεις	μάντη	Number
ετρουσκικά	ετρουσκικές	Gender
ζώων	ζώα	Case
αναγκάζεις	αναγκάζουν	Person
βραδινής	πράκτορα	lemma
δρυμό	δρυμέ	Case
συνήθειες	συνηθειών	Case
ιριδίζοντα	ιριδίζοντες	Number
μετώπου	μέτωπο	Case
γελοίο	γελοίου	Case
καρυδότσουφλου	καρυδότσουφλων	Number
ψαράδες	ψαράδων	Case
χαιρετά	χαιρετούμε	Person
υποθετικοί	υποθετικούς	Case
δέντρα	δέντρων	Case
έψελνε	έψελναν	Person
αλοιφής	αλοιφή	Case
παρότρυνση	παρότρυνσης	Case
πατέρα	πατέρας	Case
καμπυλών	καμπύλες	Case
ασθένεια	ασθένειας	Case
χρωστούσαν	χρωστούσε	Person
πυραμιδικοί	πυραμιδικά	Gender
αυλού	αυλός	Case
απτέ	απτό	Gender
κατάστρωμα	καταστρώματος	Case
συγκεντρώσεις	συγκεντρώσεων	Case
ραδιοσυχνοτήτων	ραδιοσυχνότητες	Case
καθαριστών	καθαριστές	Case
αμινοξέων	αμινοξέα	Case
τσίπουρων	τσίπουρα	Case
στεφάνης	στεφάνη	Case
διαβήτες	διαβήτης	Number
βγήκατε	βγήκα	Person
μυθιστοριογράφοι	μυθιστοριογράφων	Case
καρδιακᾱ́	ὀλοφυδνᾱ́	lemma
πηδαλίου	πηδαλίων	Number
αγωνιώδη	αγωνιώδεις	Number
επίπεδο	επίπεδα	Number
ιερέων	ιερείς	Case
ναρκωτικά	ναρκωτικών	Case
συρματόσχοινα	συρματόσχοινων	Case
Λιβύους	Λίβυο	Number
ασιατικές	ασιατικών	Case
ενεστώτες	ενεστώτων	Case
αγκωθεί	καθαριστεί	lemma
αρχών	αρχές	Case
τετράδιο	τετραδίου	Case
ξύπνησε	ξυπνήστε	Number
μύτης	μύτη	Case
βιογραφικό	βιογραφικού	Case
απλωθούν	ορκιστούν	lemma
αιώνες	αιώνα	Number
αλλεργιών	αλλεργίες	Case
λογαριασμοί	λογαριασμός	Number
Λιθουανού	Λιθουανών	Number
οσμής	οσμών	Number
θεωρούσα	θεωρούσαμε	Number
άκαρπων	θολών	lemma
ακροφύσιο	ακροφυσίου	Case
εμπρησμό	εμπρησμός	Case
ταχυδρομικά	ταχυδρομικούς	Gender
ετρουσκικών	ετρουσκικού	Number
ναυαγοσώστες	ναυαγοσωστών	Case
εμμηνόρροια	εμμηνόρροιας	Case
αποίκους	αποίκων	Case
απλούστερου	πολυτιμότερου	lemma
λεωφόροι	λεωφόρους	Case
περάστε	πέρασε	Person
πηλό	πηλός	Case
έγκυο	σφαιρική	lemma
αστρονομικού	αστρονομικός	Case
απόλυτες	απόλυτων	Case
αβγουλιέρες	αβγουλιέρα	Number
καθαρτικό	καθαρτικά	Number
αλληλεπιδράσεις	αλληλεπιδράσεων	Case
αιχμαλωτίζεσαι	αιχμαλωτιζόσουν	Tense
άδικων	άδικα	Case
ορατή	ορατέ	Gender
βομβίστρια	βομβίστριας	Case
αριστοκράτη	αριστοκρατών	Number
ακριβότερου	οξύτερου	lemma
ιδρώτα	ιδρώτας	Case
επική	συνθετικήν	lemma
πασπαλίζει	πασπαλίζω	Person
βουτήξατε	βούτηξες	Number
αἰσθητικαῖς	αλλοίαις	lemma
δημοσιογράφους	δημοσιογράφο	Number
θαλασσαετό	θαλασσαετός	Case
μανιακοί	μανιακών	Case
τηγανίζεστε	τηγανίζεσαι	Person
ξεκωλιάζουμε	ξεκωλιάζεις	Person
επενδύτες	επενδύτης	Number
λιβεριανός	λιβεριανή	Gender
γουργουρίζατε	γουργούριζαν	Person
λογχοφόρων	λογχοφόροι	Case
κινητήρα	κινητήρας	Case
αιτιοκρατική	αιτιοκρατικό	Gender
κοκκινομάλληδων	κοκκινομάλληδες	Case
αβανταδόρους	αβανταδόροι	Case
ερεβώδης	ερεβώδεις	Number
δευτερεύοντα	δευτερεύον	Gender
πνευμονικά	πνευμονικών	Case
βαρώνοι	βαρώνων	Case
αποσμητικού	αποσμητικών	Number
επτάφωτες	επτάφωτα	Gender
χτυπά	χτυπώ	Person
εξόριστων	εξόριστους	Case
δημεύατε	υποψιαζόσασταν	lemma
ζυμαριού	ζυμάρι	Case
εξαρτημένοι	εξαρτημένους	Case
εγκρίσεις	χαστούκια	lemma
θεωρούσα	θεωρώ	Tense
ιβίσκο	ιβίσκος	Case
μοναχικό	μοναχικός	Case
αδιάρρηκτε	αδιάρρηκτου	Case
νοσοκομεία	νοσοκομείο	Number
δυσκολότεροι	σφοδρότεροι	lemma
μπαλαδόροι	μπαλαδόρε	Number
ανταλλακτικά	ανταλλακτικών	Case
πλοία	πλοίων	Case
χάλυβες	χαλύβων	Case
κοινοβούλια	κοινοβούλιο	Number
αποστόλου	απόστολος	Case
κατήφορο	κατήφορου	Case
αθέατης	συνήθους	lemma
μπαμπούλες	μπαμπούλα	Number
θρήνου	θρήνος	Case
στίξεις	στίξη	Number
σινικής	σινικού	Gender
αγριογούρουνου	αγριογούρουνων	Number
σοφῷ	σχεδίῳ	lemma
κουρέα	κουρέας	Case
μπαξέ	μπαξές	Case
λογοκλοπή	λογοκλοπής	Case
καρδιοπάθειες	καρδιοπαθειών	Case
αποδεκατιστούν	αποδεκατιστούμε	Person
δυσκολότερες	σφοδρότερες	lemma
ταύρους	ταύροι	Case
ουσάρων	ουσάροι	Case
εξασφάλιζαν	εξασφάλιζε	Number
αρχάγγελοι	αρχαγγέλων	Case
βοηθητικότερων	βοηθητικότεροι	Case
ορνιθολόγοι	ορνιθολόγους	Case
ικανοποιήσεις	ικανοποίηση	Number
Μεσοπροτεροζωικό	Μεσοπροτεροζωικός	Case
σπασμοί	σπασμών	Case
υποκείμενα	υποκείμενο	Number
υποχρεωτικούς	υποχρεωτικά	Gender
κατάδικο	κατάδικος	Case
καύσιμα	καυσίμων	Case
καλόγερους	καλόγεροι	Case
ανέβαλαν	τραβήχτηκαν	lemma
αιφνιδιασμοί	ορτύκια	lemma
γυριστούν	ξεραθούν	lemma
διαψεύστε	διάψευδε	Number
ενθουσιασμού	ενθουσιασμών	Number
ανθρακικού	σοσιαλιστικού	lemma
σκουλαρικιού	σκουλαρικιών	Number
βοηθεί	ξεψυχά	lemma
σαρωνόμουν	σαρωνόσασταν	Person
ποσότητες	ποσότητα	Number
πλοηγό	πλοηγός	Case
εφικτές	εφικτή	Number
γιγακύκλους	γιγάκυκλοι	Case
συνδετήρες	συνδετήρα	Number
εικασίες	εικασιών	Case
εξωμότη	εξωμότης	Case
δριμέος	δριμέων	Number
τραύματος	τραύμα	Case
συνδρομητή	συνδρομητής	Case
αντιγραφής	αντιγραφή	Case
αιχμάλωτες	αιχμάλωτους	Gender
ενεργοποίηση	ενεργοποίησης	Case
προσπέλαση	προσπέλασης	Case
οικοδόμησης	οικοδόμηση	Case
άχρηστων	άχρηστους	Case
έσυρε	έσυραν	Number
ασκήσεις	ασκήσεων	Case
χιλιόγραμμα	χιλιογράμμων	Case
προτιμούσαμε	προτιμούσα	Person
αναιμίες	αναιμία	Number
αδικήματα	αδίκημα	Number
υπηρέτριες	υπηρετριών	Case
κουτάβια	κουταβιών	Case
σφυριών	σφυριά	Case
αόρατου	αόρατος	Case
ξιφιού	ξιφιέ	Case
ελαίου	ελαίων	Number
διαβρωτικότερες	στοργικότερες	lemma
διύλιση	διύλισης	Case
θορύβους	θορύβων	Case
λόφου	λόφων	Number
κύπελλα	κύπελλο	Number
φωνήεντα	φωνηέντων	Case
νομίσματος	νομισμάτων	Number
ημίθεου	ημίθεος	Case
έντυσες	ντύσαμε	Person
αντιπροσώπευες	αντιπροσωπεύαμε	Person
παιδιάστικε	παιδιάστικου	Case
συζητάνε	συζητάτε	Person
λιπώδών	λιπώδούς	Number
χανόταν	χάνονταν	Number
ἀποθετικαῖν	ἀποθετικᾱ́	Case
βάριο	βαρίου	Case
περιστεριώνα	περιστεριώνας	Case
συνόλου	συνόλων	Number
ελεύθερου	ελεύθερης	Gender
γειτόνισσας	γειτόνισσα	Case
σακακιού	σακάκι	Case
ενοικιαστές	ενοικιαστή	Number
αστέρων	αστέρες	Case
οισοφάγο	οισοφάγου	Case
ξυλόκαρφου	ξυλόκαρφο	Case
διψασμένα	διψασμένο	Number
αρχηγοί	αρχηγέ	Number
τεχνίτες	τεχνιτών	Case
ικανοποίηση	ικανοποίησης	Case
χαντάκια	χαντάκι	Number
ηρωισμούς	ηρωισμών	Case
Αγγλίδα	Αγγλίδας	Case
γραφικώ	ἀντιλογητικώ	lemma
βίαιης	πεζής	lemma
γλωσσολογική	γλωσσολογικό	Gender
κάστρα	κάστρο	Number
βρικολάκων	τραγοπαπάδων	lemma
αναλογίζεστε	αναλογίζονται	Person
χρέους	χρέος	Case
παράνυφοι	παρανύφους	Case
καλλιγράφου	καλλιγράφος	Case
καταθέτουμε	καταθέτω	Person
φαινόμενα	φαινόμενο	Number
ανοίχτηκαν	ανοίχτηκε	Person
δελφίνια	δελφίνι	Number
εύνοιες	εύνοια	Number
αυλούς	αυλών	Case
αμπέλων	άμπελοι	Case
τοποθεσίας	τοποθεσιών	Number
μπρόκολα	μπρόκολο	Number
ιατρούς	ιατρό	Number
αδιόρθωτη	αδιόρθωτες	Number
γροθιά	γροθιάς	Case
αναγραμματισμούς	αναγραμματισμοί	Case
εκβιαστή	εκβιαστών	Number
λευκωματίνη	λευκωματίνης	Case
διαρροές	διαρροών	Case
διανέμετε	διανέμει	Person
φουντουκιές	φουντουκιά	Number
αγριόκουρκε	αγριόκουρκος	Case
δεσποτισμός	δεσποτισμού	Case
πέρμιο	πέρμια	Number
φώκιες	φώκια	Number
άδικος	άδικε	Case
αποκρουστικό	πολυλεκτικό	lemma
ισχνότερο	χοντρότερο	lemma
στηθόδεσμο	στηθόδεσμος	Case
καθαρτικοῖν	ὑψίστοιν	lemma
ένιωσα	νιώσαμε	Number
ανίατη	κομμουνιστική	lemma
δοκιμαστικούς	τερματισμούς	lemma
δείκτες	δεικτών	Case
μαστιχόδεντρων	μαστιχόδεντρα	Case
πάπιας	πάπια	Case
απρόοπτου	απρόοπτων	Number
εικονικά	εικονικό	Number
αδελφικότατους	μακρινότατους	lemma
χαλινό	χαλινός	Case
μέδουσας	μεδουσών	Number
κουλουριών	κουλούρια	Case
μοσκοκάρυδων	μοσκοκάρυδα	Case
ξοδέψατε	ξόδεψες	Person
βοήθησε	βοηθήστε	Person
αστροναύτη	αστροναύτης	Case
μουρμουρίζετε	μουρμουρίζει	Person
θωρακισμένου	θωρακισμένο	Case
ντύσιμο	ντυσίματος	Case
θεότητας	θεότητα	Case
επιγραφές	επιγραφών	Case
πλοίο	πλοίου	Case
κάπνισμα	καπνίσματος	Case
εθνολόγο	εθνολόγος	Case
σκοινιού	σκοινί	Case
μεσημέρια	μεσημέρι	Number
μηνύματα	μήνυμα	Number
βετεράνους	βετεράνων	Case
εραστές	εραστής	Number
ειδώλου	είδωλο	Case
κεδνοῖν	ὁμολογητῐκοῖν	lemma
γαλλικοί	γαλλικών	Case
μυθιστοριογράφου	μυθιστοριογράφων	Number
αιφνιδιασμέ	αιφνιδιασμός	Case
απέχω	απείχα	Tense
καλλιγράφους	καλλιγράφοι	Case
νυχτερίδες	νυχτερίδων	Case
καταστήματος	καταστημάτων	Number
κολομβιανών	κολομβιανοί	Case
αγαπημό	αγαπημού	Case
ημιορόφου	ημιόροφος	Case
λονδρέζικου	λονδρέζικων	Number
μεσοαρχαιοζωικές	μεσοαρχαιοζωικών	Case
εμπορικότητα	εμπορικότητας	Case
δοχείων	δοχεία	Case
γέμιζαν	γεμίζουν	Tense
σπαστό	σπαστός	Gender
στρουθοκαμήλους	στρουθοκάμηλο	Number
οικιών	οικίες	Case
επιλογές	επιλογή	Number
βοτανικό	βοτανική	Gender
πρόοδοι	προόδους	Case
ίδιο	ίδιους	Number
αλβανικούς	αλβανικό	Number
κτίστηκα	κτίστηκε	Person
λαγωνικά	λαγωνικό	Number
οικοδομών	οικοδομές	Case
καλλιγράφε	καλλιγράφος	Case
βοτανολόγους	βοτανολόγο	Number
προκατάληψης	προκαταλήψεων	Number
παραδόθηκε	παραδόθηκαν	Number
διάττοντες	διαττόντων	Case
παράμετρο	παράμετρος	Case
αγοριού	αγόρι	Case
αρχιεπισκόπων	αρχιεπίσκοποι	Case
αμφέβαλαν	αμφέβαλε	Person
βιομήχανο	βιομηχάνου	Case
κενοῖς	ἀποπληκτικοῖς	lemma
αμφέβαλαν	αμφέβαλες	Person
χειρομάντες	χειρομάντη	Number
αναγνωρίσιμου	αναγνωρίσιμο	Case
ακρωνύμια	ναϊάδες	lemma
αδιαμαρτύρητο	αδιαμαρτύρητη	Gender
υδατοφράκτες	υδατοφράκτη	Number
πάστορα	παστόρων	Number
αιχμηρότεροι	οικειότεροι	lemma
Σομαλών	Σομαλοί	Case
μεσημεριανών	μεσημεριανοί	Case
επιδορπίου	επιδορπίων	Number
βόθρου	βόθρος	Case
καπνοδοχοκαθαριστές	καπνοδοχοκαθαριστών	Case
εγερτηρίων	εγερτήρια	Case
αιωνόβιο	αιωνόβιος	Gender
μονόδρομους	μονόδρομοι	Case
καταλήψεις	καταλήψεων	Case
εθνικιστές	εθνικιστή	Number
νερά	νερών	Case
ρύποι	ρύπους	Case
ανέλθεις	ξεσκατωθείς	lemma
αριστερόστροφη	αριστερόστροφο	Gender
πέταξες	πέταξε	Person
εκατόνταρχο	εκατόνταρχος	Case
συνεργατών	συνεργάτες	Case
ισχυρότερους	ψηλότερους	lemma
σπονδυλωτό	σπονδυλωτού	Case
απόντα	απούσες	Gender
χρήματος	χρήμα	Case
προσθήκες	προσθηκών	Case
φυτεύουν	φύτευαν	Tense
ἐκθετικώ	ἐκθετικοῖν	Case
φάρυγγα	φαρύγγων	Number
πεζόδρομοι	πεζόδρομος	Number
αισθησιασμού	αισθησιασμός	Case
γνώριμη	κελτική	lemma
σταθερών	σταθερές	Case
ιστιοφόρα	ιστιοφόρων	Case
Χριστιανισμέ	Χριστιανισμός	Case
άμμου	άμμος	Case
αρειανού	αρειανών	Number
κώδικες	κώδικας	Number
σύριγγες	συρίγγων	Case
μεντεσέδες	μεντεσέ	Number
νικηφόρα	νικηφόρους	Gender
αναγέννηση	αναγέννησης	Case
νουνούς	νουνοί	Case
ἀληθινῇ	ἀληθινῆς	Case
καναπέ	καναπέδων	Number
τριφύλλι	τριφυλλιού	Case
αγάπησε	συμπλήρωσε	lemma
πιατίνια	πιατίνι	Number
κάμποσες	κάμποσα	Gender
έτη	έτος	Number
εμπόδιζε	εμπόδιζαν	Number
αγκιδωτής	αγκιδωτού	Gender
υπογραφής	υπογραφών	Number
ηλεκτρικά	ηλεκτρικών	Case
κανάτια	κανάτι	Number
όρισες	ορίσαμε	Person
φασσοπερίστερου	φασσοπερίστερων	Number
φυσαλίδων	φυσαλίδες	Case
πλειστηριασμοί	πλειστηριασμούς	Case
εκτελεστή	εκτελεστής	Case
καύσιμα	καύσιμο	Number
τσαμπούνησες	τσαμπούνησαν	Person
θερμοδυναμικές	θερμοδυναμικών	Case
λειτουργίας	λειτουργιών	Number
μηχανολόγου	μηχανολόγων	Number
καθαρίστριες	καθαριστριών	Case
απελπιστεί	ειπωθεί	lemma
δημοσίευση	δημοσίευσης	Case
καθιστικά	καθιστικό	Number
γιορτάζονται	κατοικούν	lemma
προσκαλούν	προσκαλώ	Person
υποατομικά	υποατομικό	Number
βαθμιαίων	βαθμιαίου	Number
πολυπλοκότατης	πολυπλοκότατη	Case
αρνησιθρησκίες	αρνησιθρησκία	Number
αχινού	αχινών	Number
ευρώπιο	ευρωπίου	Case
άνδρες	άνδρα	Number
κοχλίες	κοχλία	Number
φράουλες	φράουλα	Number
πράσο	πράσου	Case
χιπισσών	χίπισσες	Case
αγίες	αγία	Number
οβίδας	οβίδα	Case
οικισμοί	οικισμέ	Number
αποσπάσματα	αποσπασμάτων	Case
φωνητικών	φωνητικού	Number
αμβλέα	αμβλείς	Gender
ομπρέλες	ομπρέλα	Number
αεικίνητος	αεικίνητο	Gender
καρεκλών	καρέκλες	Case
παππάδες	παππά	Number
κούκκου	κούκκε	Case
κρυσταλλική	κρυσταλλικής	Case
σκάλισε	σκαλίστε	Person
τελετουργικά	τελετουργικό	Number
ανοιξιάτικη	ανοιξιάτικης	Case
κερατάδες	κερατά	Number
αστυνομίες	αστυνομιών	Case
ελληνορωμαϊκών	ελληνορωμαϊκές	Case
κτηρίου	κτήριο	Case
δράσεις	δράση	Number
διαβρωτικότερε	διαβρωτικότερου	Case
υπεραστικά	υπεραστικό	Number
πρωτόκολλο	πρωτοκόλλου	Case
αγκάλης	αγκάλη	Case
δράμια	δράμι	Number
διατροφής	διατροφή	Case
ρουθουνιών	ρουθούνια	Case
χούμο	χούμε	Case
κουβέντες	κουβέντα	Number
αυτισμούς	αυτισμό	Number
κρύο	κρύα	Number
δημιουργήσατε	δημιούργησα	Person
καταφύγια	καταφύγιο	Number
αλοιφών	αλοιφές	Case
καστάνιας	καστάνια	Case
προσανατολισμού	προσανατολισμός	Case
θρεπτῐκοῖν	ὑποθετικοῖν	lemma
κηπάρια	κηπαρίων	Case
καπνοδόχων	καπνοδόχοι	Case
ακόλουθος	ακόλουθου	Case
φρουκτόζη	φρουκτόζης	Case
κατηγορουμένης	κατηγορουμένη	Case
αρχαιολόγοι	αρχαιολόγος	Number
σελιδοδεικτών	σελιδοδείκτες	Case
συγχορδίας	συγχορδία	Case
πορφυρή	πορφυρό	Gender
θεμελιωδών	μειωμένων	lemma
βαρκάρηδες	βαρκάρη	Number
σφαιριδίου	σφαιριδίων	Number
Σομαλού	Σομαλών	Number
κούρεμα	κουρέματος	Case
ανανεωθούμε	σιχαθούμε	lemma
αφρούς	αφροί	Case
επενδυτών	επενδυτές	Case
μυθιστόρημα	μυθιστορήματος	Case
εθισμών	εθισμοί	Case
προσαρμοζόμαστε	προσαρμοζόμασταν	Tense
κυπριακός	κυπριακού	Case
γλαυκώ	ὠμώ	lemma
έρωτες	ερώτων	Case
δαγκωνόσουν	κεντριζόσουν	lemma
αμβλώσεις	άμβλωση	Number
ηπειρωτική	μεσοζωική	lemma
ισχυρότεροι	ψηλότεροι	lemma
βομβάρδες	βομβάρδα	Number
αγά	αγάς	Case
πολιτισμού	πολιτισμός	Case
συνεταιρισμού	συνεταιρισμός	Case
χρονικός	χρονικόν	Gender
οἰκητικᾱ́	αλλοίᾱ	lemma
Ισπανού	Ισπανός	Case
αγαπήστε	αγάπα	Number
ρήσεων	ρήσεις	Case
εργάτριας	εργάτρια	Case
γνωριστεί	γνωριστούμε	Person
προσπαθήσαμε	προσπάθησα	Person
αφόρητων	κεφαλαίων	lemma
ιδωθεί	ονομαστεί	lemma
ανέμους	άνεμο	Number
καταχωρητές	καταχωρητής	Number
χημικούς	χημικών	Case
παρέκκλισης	παρεκκλίσεων	Number
γλωσσολογικών	γλωσσολογικές	Case
πονηροί	πονηρούς	Case
κουκουβάγιας	κουκουβάγια	Case
αποικισμό	αποικισμός	Case
ψύλλοι	ψύλλε	Number
πυροβόλα	πυροβόλων	Case
Αφγανού	Αφγανών	Number
μανταρινιάς	μανταρινιών	Number
κορόιδων	κορόιδα	Case
οδοντογιατρούς	οδοντογιατροί	Case
αισθηματίες	μελάνες	lemma
φαμίλια	φαμίλιας	Case
μύρρο	μύρρου	Case
βιογραφίας	βιογραφιών	Number
ενοχλεί	ενοχλούν	Person
γρίφοι	γρίφε	Number
βιοχημικού	βιοχημικός	Case
φύλου	φύλο	Case
χριστιανούς	χριστιανών	Case
νεολιθικών	νεολιθικά	Case
αλεξίσφαιρους	αλεξίσφαιρα	Gender
θεϊκῷ	ὀχυρῷ	lemma
εκπαιδεύσεις	εκπαιδεύσεων	Case
λούτσου	λούτσος	Case
βήματος	βημάτων	Number
θυμάτων	θύματα	Case
μπουζόκλειδα	μπουζόκλειδο	Number
παιχνιδιού	παιχνιδιών	Number
ξύπνιο	ξύπνιος	Gender
κρύβεις	κρύβω	Person
πιτσαδόρου	πιτσαδόρε	Case
βασανιστών	βασανιστές	Case
ομοσπονδίες	ομοσπονδιών	Case
αγιοποίησης	αγιοποίηση	Case
ψυχολόγοι	ψυχολόγος	Number
απαλλαγμένοι	απαλλαγμένες	Gender
αεροσυνοδού	αεροσυνοδών	Number
αεροναυπηγικοί	αεροναυπηγικέ	Number
δονήσεις	δόνηση	Number
μπουκιάς	μπουκιών	Number
αίσθησης	αισθήσεων	Number
απάντησε	απάντησες	Person
θηριακῇ	ἁγνῇ	lemma
λισσούς	λισσᾱ́ς	Gender
υλιστικός	υλιστικό	Case
περάσαμε	πέρασαν	Person
ιερό	χειρόγραφο	lemma
θερμοκήπια	θερμοκήπιο	Number
γοήτευε	γοήτευαν	Number
ακρόπολης	ακρόπολη	Case
ίκτερος	ικτέρου	Case
τραπεζομάντηλου	τραπεζομάντηλο	Case
ρεβιθιά	ρεβιθιάς	Case
αγγελίες	αγγελία	Number
άνθους	άνθος	Case
τρόφιμο	τρόφιμος	Case
μετριότητας	μετριότητα	Case
κενοί	κενώ	Number
απελπιστούν	εγκολπωθούν	lemma
ανταγωνιστικοί	ἄκροι	lemma
κηπουροί	φασίστες	lemma
ιστότοπο	ιστότοπου	Case
βάλτους	βάλτοι	Case
παρουσίασες	παρουσίασε	Person
φιστικοβούτυρα	φιστικοβουτύρων	Case
φαγώσιμο	φαγώσιμος	Gender
γελαστά	γελαστοί	Gender
έμποροι	εμπόρων	Case
δίκταμων	δίκταμα	Case
συμπλήρωναν	συμπληρώνατε	Person
ιαπωνικοί	ιαπωνικές	Gender
αειθαλής	νικητήρια	lemma
άθροισης	άθροιση	Case
τσίρκο	τσίρκου	Case
αστρολόγοι	αστρολόγους	Case
βροχεροί	βροχερά	Gender
πετρίτες	πετρίτη	Number
μινωικά	μινωικές	Gender
φόρεσε	φόρεσες	Person
έγειρες	γείρατε	Number
βογκούσες	βογκούσαν	Person
παρισινό	παρισινός	Gender
αγγλονορμανδικούς	αγγλονορμανδικών	Case
έμετο	έμετος	Case
σκουριάς	σκουριά	Case
τάληρου	τάληρο	Case
εμπορευματοκιβωτίων	εμπορευματοκιβώτια	Case
διευκρινίσεις	διευκρίνιση	Number
προλάβαινε	προλάβαιναν	Number
μεταφράσεις	μεταφράσεων	Case
ακτίνων	ακτίνες	Case
πλοία	πλοίο	Number
φασολιάς	φασολιά	Case
κοπάνισαν	κοπάνισε	Person
ξεκωλιαστούν	ξεκωλιαστώ	Person
χειρόγραφοι	χειρόγραφα	Gender
ισημερινός	ισημερινή	Number
επαφής	επαφή	Case
υπαρξιστών	υπαρξιστές	Case
καείτε	καεί	Person
όνο	όνος	Case
ινδιάνικα	ινδιάνικες	Gender
αγγλικανούς	αγγλικανό	Number
ποιμένες	ποιμένα	Number
κρυπτᾰ́	κρυπτῶν	Case
επίτευγμα	επιτεύγματος	Case
κεντρικότεροι	ομοιότεροι	lemma
εκθέσεις	εκθέσεων	Case
κερκίδων	κερκίδες	Case
εμποροπλοίαρχοι	εμποροπλοιάρχους	Case
άμυαλοι	υδρόφιλοι	lemma
εγχειρίσεις	νεποτισμοί	lemma
μπαγλαμάδες	μπαγλαμάς	Number
κοσμολογίες	κοσμολογιών	Case
τρίκυκλο	τρίκυκλου	Case
ανωμαλίες	ανωμαλία	Number
ανθοπώλες	ανθοπώλη	Number
πρωταθλητές	πρωταθλητών	Case
αίσθηση	αίσθησης	Case
δυσίατους	δυσίατοι	Case
υπερήχου	υπέρηχε	Case
αιμομικτικόςού	τελωνειακού	lemma
ηλεκτρομαγνητισμού	ηλεκτρομαγνητισμός	Case
μεσημέρι	μεσημεριού	Case
χώροι	χώρε	Number
μικροοργανισμών	μικροοργανισμοί	Case
αδιαφιλονίκητο	αδιαφιλονίκητη	Gender
υπέρβαρη	υπέρβαρο	Gender
φραγκόσυκα	φραγκόσυκο	Number
αισθητού	αισθητών	Number
λοβούς	λοβών	Case
οικοδόμου	οικοδόμων	Number
επεισόδια	επεισόδιο	Number
Βρεταννών	Βρεταννοί	Case
άκλιτου	άκλιτης	Gender
αρταίνοντας	ροχαλίζοντας	lemma
κουδουνίζουν	κουδουνίζουμε	Person
κρεβατομουρμούρα	κρεβατομουρμούρας	Case
μόλους	μόλων	Case
σηκωμάρα	σηκωμάρας	Case
εκτυπωτές	εκτυπωτής	Number
εχθρού	συμβολαίου	lemma
νευροδιαβιβαστών	νευροδιαβιβαστές	Case
Κυπραίου	Κυπραίων	Number
έφαγαν	φάγαμε	Person
αδίδακτα	σλοβακικά	lemma
βακαλάους	βακαλάων	Case
οξειδοαναγωγή	οξειδοαναγωγής	Case
λογαριασμούς	λογαριασμών	Case
αλληλογραφίες	αλληλογραφία	Number
υφάσματα	υφασμάτων	Case
αντικειμένου	αντικείμενο	Case
γάτε	γάτος	Case
αεροπορίας	αεροπορία	Case
εθνικισμού	εθνικισμών	Number
στηθοσκόπια	στηθοσκόπιο	Number
αλγόριθμε	αλγόριθμος	Case
σεναρίου	σεναρίων	Number
πυρών	πυρά	Case
γραφτά	ισχνά	lemma
νεκροφόρων	νεκροφόρες	Case
Τοσκανής	Τοσκανών	Number
δημιούργησε	δημιουργήστε	Person
ηρωίνης	ηρωίνη	Case
βενετικέ	βενετικό	Case
επιστήμες	επιστήμη	Number
ακυρολεξίες	ακυρολεξιών	Case
ενοχές	χαραμοφάηδες	lemma
ερπυστριοφόρε	ερπυστριοφόροι	Number
απαραίτητη	απαραίτητες	Number
παραδόσεις	παραδόσεων	Case
γερνά	γερνούν	Number
διασκεδαστές	διασκεδαστής	Number
καφετέριας	καφετέρια	Case
είδηση	είδησης	Case
αρουραίους	αρουραίων	Case
άπλωσε	άπλωσαν	Person
ναύλους	ναύλων	Case
ταφής	ταφή	Case
άνετων	άνετα	Case
νέγρους	νέγρο	Number
αποσυνθέσεις	αποσύνθεση	Number
λιθόστρωτοι	λιθόστρωτων	Case
χοίρου	χοίρων	Number
βιβλιοδέτες	βιβλιοδέτη	Number
μεταδόσεων	μεταδόσεις	Case
αγριόκουρκοι	αγριόκουρκους	Case
επίμονη	επίμονες	Number
τανάλια	τανάλιας	Case
πούρα	πούρων	Case
οἰωνοσκοπικῷ	φθῐσῐκῷ	lemma
ατμόπλοιου	ατμόπλοιων	Number
πορθμείο	πορθμείου	Case
ισπανικών	ισπανικούς	Case
λιπάνσεις	λίπανση	Number
βραχυκύκλωμα	βραχυκυκλώματος	Case
νεαροί	νεαρῶν	Case
ιεραρχίας	ιεραρχιών	Number
κανονικών	κανονικά	Case
αποκτούν	αποκτά	Person
φασίστα	φασίστας	Case
πλάτανε	πλάτανος	Case
άκουγα	ακούγαμε	Number
πυροσβέστες	πυροσβεστών	Case
αντιήρωες	αντιήρωα	Number
ορκιστούμε	ορκιστείς	Person
αρχινούν	αρχινά	Number
ερωμένων	ερωμένες	Case
βιογραφικού	βιογραφικό	Case
ψυγεία	ψυγείο	Number
δολιοφθοράς	δολιοφθορά	Case
αγριογούρουνο	αγριογούρουνου	Case
γκαζόζα	γκαζόζας	Case
προσκοπικών	προσκοπικοί	Case
έλαια	ελαίων	Case
καταυλισμοί	καταυλισμούς	Case
Βακχείω	ὑψηλώ	lemma
υποθήκη	υποθήκης	Case
βάλτοι	βάλτους	Case
χωρικών	χωρικές	Case
ναυπηγείου	ναυπηγείων	Number
συσσωρευτές	συσσωρευτή	Number
Βραζιλιάνοι	Βραζιλιάνος	Number
διασκεδαστικότερης	σφαιρικότερης	lemma
καπουτσίνους	καπουτσίνοι	Case
εντολές	εντολή	Number
πουλητές	πουλητών	Case
αλάτινους	αλάτινοι	Case
σαλπίγγων	σάλπιγγες	Case
αγιορείτικο	αγιορείτικα	Number
τελωνειακές	τελωνειακών	Case
ασκούς	ασκό	Number
κάλπης	καλπών	Number
σκορπιούς	σκορπιό	Number
γεφυράκια	γεφυράκι	Number
έφερε	φέρατε	Person
βερνικώματα	βερνίκωμα	Number
αιχμηρότατη	οικειότατη	lemma
κληρονόμων	κληρονόμοι	Case
άκακη	προλεταριακή	lemma
λογαριασμέ	λογαριασμός	Case
ουσιαστικά	ουσιαστικό	Number
λιπαντικά	λιπαντικών	Case
ευθύτατης	υπεροπτικότατης	lemma
είσαι	μιλάς	lemma
σερβοκροατικά	σερβοκροατικοί	Gender
σονέτου	σονέτο	Case
βρικόλακα	βρικολάκων	Number
σουπιέρας	σουπιερών	Number
αγγλονορμανδικού	αγγλονορμανδικών	Number
ετοιμάστηκαν	ετοιμάστηκε	Person
τρούλοι	τρούλους	Case
δεκάλεπτα	τελετουργικά	lemma
ρουμανικος	ρουμανικο	Case
πελεκάνοι	πελεκάνων	Case
λευκόχρυσος	λευκόχρυσου	Case
ζωώδες	ζωώδη	Gender
εκτρώσεων	εκτρώσεις	Case
συντεχνίτη	συντεχνίτης	Case
σαρκίναιν	ὀλοφυδναῖν	lemma
τυρρηνικοί	τυρρηνικούς	Case
προβλητών	προβλήτες	Case
καταφρονούν	καταφρονούσαν	Tense
δικαιωμάτων	δικαιώματα	Case
πατριό	πατριός	Case
πνευματικῷ	ἀγρίῳ	lemma
ποπού	ποπός	Case
αυτοκρατειρών	αυτοκράτειρες	Case
αερισμοί	αερισμούς	Case
αγκαλιές	αγκαλιών	Case
σουσαμιών	σουσάμια	Case
κουνουπιού	κουνούπι	Case
φραγμούς	φραγμό	Number
ταυτόχρονα	ταυτόχρονους	Gender
παλιότεροι	παλιότερους	Case
λέμβους	λέμβων	Case
εγγλεζόπουλα	εγγλεζόπουλων	Case
αρχική	αρχικής	Case
Καταλανό	Καταλανός	Case
υπερβατικές	υπερβατική	Number
οίκους	οίκο	Number
βιώσιμες	βιώσιμα	Gender
εξοπλισμούς	εξοπλισμοί	Case
σταματούν	σταματά	Number
καρχαρίες	καρχαριών	Case
συνάρτηση	συνάρτησης	Case
τουρκικός	τουρκικό	Gender
φιλαράκο	φιλαράκου	Case
άχρηστο	άχρηστος	Case
ολοκαίνουριου	ολοκαίνουριε	Case
ανεπιθύμητων	ανεπιθύμητου	Number
ημερήσιας	ημερήσια	Case
επιδόματος	επιδομάτων	Number
άρρενα	άρρενας	Case
κτήσματα	κτήσμα	Number
δικτύων	δίκτυα	Case
βαρόνου	βαρόνος	Case
προϋπολογισμού	προϋπολογισμών	Number
ιωβηλαίου	ιωβηλαίων	Number
καυτές	καυτούς	Gender
ενοικιαστή	ενοικιαστών	Number
συνεργοί	συνεργούς	Case
αυτισμό	αυτισμός	Case
χαλιά	χαλιών	Case
ζωντανότερων	φιλικότερων	lemma
ποτού	ποτό	Case
μέλλοντα	μέλλοντας	Case
διακοπές	διακοπών	Case
ξενιστές	ξενιστής	Number
μεθυλενίου	μεθυλένιο	Case
κούκκων	κούκκοι	Case
Κυπριώτισσες	Κυπριώτισσα	Number
αγριελιάς	αγριελιών	Number
αποδιοπομπαίου	αποδιοπομπαίο	Case
πετρίτη	πετρίτης	Case
φρούτο	φρούτου	Case
θεάματα	θεαμάτων	Case
σκοπιές	σκοπιών	Case
επικοινωνίες	επικοινωνιών	Case
εκλεκτική	εκλεκτικό	Gender
σύρραξης	συρράξεων	Number
αρμένικο	αρμένικα	Number
σακίδια	σακίδιο	Number
Αυστραλέζου	Αυστραλέζε	Case
λειτουργού	λειτουργών	Number
ουράνιο	ουρανίου	Case
σάπια	σάπιες	Number
ανταγωνιστή	ανταγωνιστών	Number
κλάνει	κλάνω	Person
φασίνες	φασίνα	Number
σακιδίου	σακιδίων	Number
σικελικοί	σικελικές	Gender
εξόδους	έξοδο	Number
ουράνιους	ουράνιο	Number
δεύτερο	δεύτερα	Number
καφεόδεντρα	καφεόδεντρο	Number
καταφεύγεις	καταφεύγουμε	Person
σονέτο	σονέτου	Case
αγριόγαλλοι	αγριόγαλλε	Number
αιώρημα	αιωρήματος	Case
υλιστικοί	υλιστικές	Gender
πανάρχαιες	πανάρχαια	Gender
προσανατολισμοί	προσανατολισμών	Case
σελίνια	σελινιών	Case
διαλύει	διέλυε	Tense
στρατηγικών	στρατηγικές	Case
αδιαπέραστες	αδιαπέραστοι	Gender
μπλουζίτσες	μπλουζίτσα	Number
επέμβαση	επέμβασης	Case
αντιλήψεις	αντίληψη	Number
έκτρωσης	έκτρωση	Case
αιτιολογικών	αιτιολογικές	Case
τόξο	τόξου	Case
ανώνυμε	ανώνυμο	Case
ετοιμάστε	ετοίμασε	Number
αγωνιστικότητας	αγωνιστικότητα	Case
σουπιέρας	σουπιέρα	Case
εξεγέρσεις	εξέγερση	Number
μονάδα	μονάδας	Case
αδιάκριτοι	αδιάκριτα	Gender
επιτεύγματος	επίτευγμα	Case
αεροστεγούς	αεροστεγής	Case
δούλες	δούλη	Number
αντιπρόεδροι	αντιπρόεδρος	Number
αγγειοπλαστικές	αγγειοπλαστική	Number
ειδώλιο	ειδωλίου	Case
κόκκινα	κόκκινο	Number
νομοθεσίες	νομοθεσιών	Case
απορρίψεις	απορρίψεων	Case
όλους	όλοι	Case
δραστών	δράστες	Case
βοτανικής	βοτανικών	Number
δεξαμενής	δεξαμενών	Number
σκανδάλης	σκανδάλη	Case
ερμήνευαν	ερμηνεύατε	Person
ιαπωνικής	ιαπωνική	Case
νιώθεις	νιώθει	Person
αρέσουν	άρεσαν	Tense
φιλολόγου	φιλόλογος	Case
γαρνίρει	γαρνίρετε	Person
εντύπου	έντυπο	Case
ερωδιούς	ερωδιών	Case
ζαλάδες	ζαλάδα	Number
ορισμοί	ορισμός	Number
αδέρφια	αδέρφι	Number
αμφιβάλλει	αμφιβάλλουμε	Person
πάτωμα	πατώματος	Case
έπλεναν	έπλενε	Number
ακίνητα	ακινήτων	Case
ορεκτικού	ορεκτικό	Case
αποκρατικοποιήσεων	αποκρατικοποιήσεις	Case
αέτωμα	ντύσιμο	lemma
αθίγγανους	αθίγγανων	Case
είστε	μουρμουρίζετε	lemma
ενεργητικών	ενεργητικές	Case
αγγελιαφόροι	αγγελιαφόρους	Case
άρκευθε	άρκευθος	Case
ταχυδρομικό	ταχυδρομικά	Number
ανεμοστρόβιλους	ανεμοστρόβιλο	Number
οδηγέ	οδηγός	Case
σκάζαμε	έσκαζε	Person
μεγααιώνα	μεγααιώνας	Case
πεζόδρομο	πεζόδρομος	Case
ανώδυνο	ανώδυνος	Case
ανανεωθεί	μαραθεί	lemma
ανταγωνισμού	ανταγωνισμών	Number
ράβδους	ράβδο	Number
αδαμιαίου	αδαμιαίε	Case
επακόλουθου	επακόλουθο	Case
άντεξε	άντεξα	Person
προτεροζωικός	προτεροζωικού	Case
εντυπωσιακούς	εντυπωσιακό	Number
περιγράφουμε	περιγράφουν	Person
νταβατζή	νταβατζής	Case
πρασινωπά	πρασινωπών	Case
εμποροπανηγύρεις	εμποροπανηγύρεων	Case
ανάγλυφοι	ανάγλυφα	Gender
αδυσώπητο	μαυρικιανό	lemma
μελισσοκομεία	μελισσοκομείο	Number
Ανγκολέζοι	Ανγκολέζους	Case
πούρου	πούρο	Case
ιβίσκο	ιβίσκου	Case
διαιρετή	διαιρετής	Case
πελιδνώ	χρονικώ	lemma
έμπορο	εμπόρου	Case
θεάματα	θέαμα	Number
κράματος	κραμάτων	Number
αποφασίσαμε	αποφάσισες	Person
διαδραμάτιζα	διαδραματίζαμε	Number
νερού	νερό	Case
οἰκητικοῖς	τελείοις	lemma
αερισμοί	αερισμέ	Number
λαμπρυντικά	λαμπρυντικό	Number
είσαι	είστε	Number
ραβίνου	ραβίνε	Case
δεινόσαυρου	δεινόσαυρος	Case
γαλάζιες	γαλάζιων	Case
αγριελιές	αγριελιά	Number
καλόγεροι	καλόγερων	Case
σπάσαμε	έσπασαν	Person
κουστουμιών	κουστούμια	Case
μοιραστείτε	μοιραστώ	Person
ψωμιού	ψωμί	Case
έδιδαν	δίδουν	Tense
πράσινη	πράσινο	Gender
βυσσινιάς	βυσσινιά	Case
αγλαΐστε	αγλάιζε	Person
κάψαμε	έκαψαν	Person
Βρετόνο	Βρετόνε	Case
δυναμικό	δυναμικού	Case
διάβαινε	διάβαινες	Person
κολοκύθας	κολοκύθα	Case
πολιούχοι	πολιούχος	Number
διόριζε	κατέφερε	lemma
παππούδες	παππούδων	Case
ανύπαντρων	ανύπαντρες	Case
υιού	υιών	Number
σκίζονταν	σκίζονται	Tense
αλέκτορες	αλέκτορα	Number
μάτσο	μάτσου	Case
καρδιακοῖς	χρυσελεφαντίνοις	lemma
σκάλας	σκάλα	Case
κινητικοῖς	κινητικῷ	Number
μητρόπολη	μητρόπολης	Case
δασύποδες	δασύποδα	Number
Δανέζου	Δανέζος	Case
ευδιάκριτου	ευδιάκριτο	Case
κυνηγού	κυνηγών	Number
ασθένειας	ασθένεια	Case
αφιερώσεις	αφιέρωση	Number
εργαλείων	εργαλεία	Case
διεύρυνε	κοινώνησε	lemma
βόγκηξε	προήλθε	lemma
κατοστάρικο	κατοστάρικου	Case
παιδαγώγηση	παιδαγώγησης	Case
Καπουτσίνου	Καπουτσίνε	Case
μυρμηκικοί	μυρμηκικέ	Number
χρήματα	χρημάτων	Case
γκισαριού	γκισαριών	Number
αργεντίνικες	αργεντίνικη	Number
πεποιθήσεων	πεποιθήσεις	Case
ιγμορίτιδα	ιγμορίτιδας	Case
ελληνιστές	ελληνιστής	Number
στέλνω	στέλνετε	Person
δράστη	δραστών	Number
ορίζαμε	όριζα	Number
θρήνοι	θρήνε	Number
γερανούς	γερανοί	Case
γραφεία	γραφείων	Case
οργανικά	οργανικών	Case
σφετεριστή	σφετεριστής	Case
βασανιστήρια	βασανιστηρίων	Case
σκούφο	σκούφου	Case
φωνήεντος	φωνηέντων	Number
παπάδες	παπά	Number
αγγελίες	αγγελιών	Case
ύψη	υψών	Case
οπλίτη	οπλίτης	Case
πινακίδες	πινακίδων	Case
κουνελιού	κουνέλι	Case
καυγάδες	καυγάς	Number
συνήγορο	συνήγορος	Case
τραβάτε	τράβηξε	Person
εξεταστή	εξεταστής	Case
νησιά	νησί	Number
ιδεαλισμό	ιδεαλισμός	Case
αγγελουδιού	αγγελουδιών	Number
κατηγορούμε	κατηγορείτε	Person
φασολάδα	φασολάδας	Case
ινδιάνικος	ινδιάνικο	Case
ενεχυροδανειστήρια	ενεχυροδανειστήριο	Number
φωλιών	φωλιές	Case
αιτίας	αιτιών	Number
χαλιού	χαλιών	Number
συγχαίρεις	συγχαίρετε	Number
πιπεριές	πιπεριά	Number
θαύματος	θαυμάτων	Number
εργοτάξιο	εργοταξίου	Case
απογαλακτιστείς	απογαλακτιστούν	Person
φώτιζα	φωτίζαμε	Number
φυσικοί	φυσικούς	Case
αλάτιζε	αλατίζει	Tense
ιδεαλισμός	ιδεαλισμού	Case
πατριού	πατριός	Case
ημίθεο	ημίθεος	Case
αβεβήλωτοι	αβεβήλωτος	Number
καθαρτικό	καθαρτικού	Case
λοιμοκαθαρτηρίου	λοιμοκαθαρτηρίων	Number
κυβέρνησε	κυβέρνησα	Person
ανήφορους	ανήφορων	Case
μάντεις	μάντεων	Case
ερυθραϊκός	ερυθραϊκή	Gender
Λευιτικῷ	ὀσμητῷ	lemma
ηλεκτρονίου	ηλεκτρόνιο	Case
γιαλοί	γιαλός	Number
πιάνα	πιάνο	Number
βρίσκετε	βρίσκεις	Person
αόρατους	αόρατες	Gender
κραδασμούς	κραδασμοί	Case
ποδηλατοδρομίες	ποδηλατοδρομιών	Case
κατέφεραν	κατέφερε	Number
ευνούχο	συνώνυμο	lemma
βιομήχανοι	βιομηχάνων	Case
ασχολείσαι	ασχολείται	Person
μυρωδικά	μυρωδικό	Number
ηθοποιοί	ηθοποιός	Number
σφαιρών	σφαίρες	Case
ολόκληρων	ολόκληρες	Case
ξενοδόχοι	ξενοδόχος	Number
δέσμια	περιβαλλοντικά	lemma
πολυβόλα	πολυβόλο	Number
ισορροπίες	ισορροπιών	Case
σκοινιών	σκοινιά	Case
πόλοι	πόλους	Case
αργεντίνικο	αργεντίνικα	Number
γραμματειών	γραμματείες	Case
ανοχή	ανοχής	Case
οικοδομικών	οικοδομικές	Case
βάλτε	βάλτος	Case
σιτάρια	σιτάρι	Number
καθηγήτρια	καθηγήτριας	Case
πηλίκο	πηλίκου	Case
ακόντια	ακόντιο	Number
έμπορε	έμπορος	Case
στρατόπεδα	στρατόπεδο	Number
καταλύτες	καταλυτών	Case
φράσεις	φράσεων	Case
λαίδη	λαίδης	Case
έρωτες	έρωτα	Number
λαδιού	λαδιών	Number
δισκοπρίονου	δισκοπρίονο	Case
σελινιού	σελινιών	Number
πύραυλο	πυραύλου	Case
όσχεο	οσχέου	Case
παρελθόντων	παρελθόντα	Case
σύρματα	σύρμα	Number
καυτού	καυτός	Case
στοίβας	στοίβα	Case
σκατολογιών	σκατολογίες	Case
γρήγορο	γρήγορη	Gender
εκθέσεις	έκθεση	Number
εκπομπών	εκπομπές	Case
σχέδια	σχεδίων	Case
γεμιστήρες	γεμιστήρα	Number
ανοϊκό	ανοϊκός	Case
βάσεων	βάσεις	Case
καφετιέρας	καφετιέρων	Number
λιθίναιν	ἱλαραῖν	lemma
αδημοσίευτο	ομοφυλόφιλο	lemma
έμμετρο	πολωνικό	lemma
γιου	γιων	Number
εφαρμόσατε	εφάρμοσες	Number
λυχνιών	λυχνίες	Case
ηλεκτρισμό	ηλεκτρισμός	Case
εξισώσεων	πυλώνων	lemma
παμφαγός	παμφαγά	Gender
αιχμών	αιχμές	Case
οδούς	οδό	Number
ανθοπωλίδων	ανθοπώλιδες	Case
μελάνη	μελάνης	Case
άκατο	άκατος	Case
αντικαταθλιπτικά	αντικαταθλιπτικό	Number
πιγουνιού	πιγούνι	Case
καινοῖν	ὠμοῖν	lemma
μόνωσης	μόνωση	Case
χιονοθύελλας	χιονοθύελλα	Case
τετραχλωράνθρακας	τετραχλωράνθρακα	Case
καλύβες	καλύβα	Number
απαγόρευση	απαγόρευσης	Case
πατριωτισμό	πατριωτισμός	Case
ασελγής	ασελγούς	Case
αγριολούλουδων	αγριολούλουδα	Case
παραμέτρους	παράμετρο	Number
σκορδάτης	σκορδάτου	Gender
απογείωσης	απογειώσεων	Number
σκαθάρι	σκαθαριού	Case
ουρανίσκοι	ουρανίσκους	Case
ιστοχώροι	ιστοχώρος	Number
βολικότερου	βολικότερε	Case
πούπουλων	πούπουλα	Case
βαβουίνου	βαβουίνε	Case
γάντι	γαντιού	Case
λήγουσας	ληγουσών	Number
πολιτιστικές	πολιτιστικών	Case
περιττού	περιττό	Case
κρουαζιερόπλοιου	κρουαζιερόπλοιων	Number
αεροσυνοδούς	αεροσυνοδό	Number
φάρσας	φάρσα	Case
εικόνες	εικόνων	Case
στρατιάς	στρατιά	Case
άστρο	άστρου	Case
πλευρών	πλευρά	Case
μπιζελιού	μπιζέλι	Case
εργοδότη	εργοδότης	Case
άτομα	ατόμων	Case
μονομαχίες	μονομαχιών	Case
ανάγκη	ανάγκης	Case
προόδους	πρόοδο	Number
γιοττάμετρα	γιοττάμετρο	Number
διεύθυνση	πάνθεο	lemma
μαγγάνιο	μαγγανίου	Case
θερμοκρασίες	θερμοκρασιών	Case
σχολεία	σχολείων	Case
έχιδνας	εχιδνών	Number
αλυσοδεθείτε	αλυσοδεθείς	Number
γυλιού	γυλιέ	Case
δροσόπαγος	δροσόπαγου	Case
γενοκτονίες	γενοκτονία	Number
δωρίστηκε	κατέφυγε	lemma
διεύθυνση	διεύθυνσης	Case
αρχιναύαρχε	αρχιναύαρχος	Case
δένδρα	δένδρο	Number
στρατιών	στρατιές	Case
εξάδερφοι	εξάδερφε	Number
πειρατή	πειρατής	Case
κρατούσαμε	κρατούμε	Tense
αυτοκινητόδρομο	αυτοκινητόδρομος	Case
στοιχειοθέτριας	στοιχειοθετριών	Number
ημιορόφους	ημιορόφων	Case
υποθάλαμο	υποθαλάμου	Case
περιόδου	περίοδος	Case
αήττητου	αήττητο	Case
απέχουν	απέχετε	Person
προϋπολογισμοί	προϋπολογισμός	Number
εντύπωσης	εντύπωση	Case
ψεδνέ	ψεδνοί	Number
ύελο	υέλου	Case
βλακεία	λογοτεχνία	lemma
μινωικής	μινωικού	Gender
σφαιριδίων	σφαιρίδια	Case
δίγλωσσα	δίγλωσσοι	Gender
κοσμολογίες	κοσμολογία	Number
αναγνώστες	αναγνωστών	Case
μαέστρου	μαέστρος	Case
σκώροι	σκώρους	Case
μιγαδικές	μιγαδικοί	Gender
ισχίο	ισχίου	Case
κάσκα	κάσκας	Case
περίοδο	περίοδος	Case
παγωτού	παγωτών	Number
ιόντα	ιόν	Number
ζητιάνου	ζητιάνων	Number
γερουσιαστές	γερουσιαστή	Number
ακόντιο	ακοντίου	Case
έγγαμο	μοδάτο	lemma
ακήρυχτου	ακήρυχτων	Number
προγόνους	πρόγονο	Number
ανταγωνισμέ	ανταγωνισμός	Case
ημίθεοι	ημίθεων	Case
δρυ	δρυς	Case
βασικότατε	σιωπηλότατε	lemma
σύδεντρο	σύδεντρου	Case
άρθρα	άρθρων	Case
μαυσωλείου	μαυσωλείο	Case
ελλαδικά	ελλαδικών	Case
γελιόσουν	γελιέσαι	Tense
κρατικοποιούνται	κρατικοποιούμαστε	Person
ξοδεύει	ξοδεύουμε	Person
δοκιμάζονται	πουλούν	lemma
πατρικές	πατρικών	Case
καημό	καημός	Case
ορυκτολόγο	ορυκτολόγου	Case
πανικοβληθούμε	πανικοβληθήκαμε	Tense
προσθέτουν	προσθέτουμε	Person
κατασκοπεύετε	κατασκόπευε	Number
ανέκδοτου	ανέκδοτο	Case
εμπειρίες	εμπειρία	Number
ημερολόγιο	ημερολογίου	Case
αδιάκοπο	αδιάκοπος	Case
αιθιοπικές	οδικές	lemma
κουράσατε	κούρασες	Number
κενοταφίου	κενοταφίων	Number
αρώματος	άρωμα	Case
αδερφοί	αδερφός	Number
δακτυλογραφιόσαστε	δακτυλογραφιόταν	Person
επιστημονικού	επιστημονικό	Case
άτακτων	άτακτου	Number
μαζοχιστές	μαζοχιστών	Case
πουστοφέρνεις	πουστοφέρνετε	Person
κλείσε	κλείστε	Person
κουλάκε	κουλάκος	Case
επιμόλυνση	επιμόλυνσης	Case
όνο	όνε	Case
ανακατεύτηκαν	ανακατεύτηκε	Person
μελισσοκόμοι	μελισσοκόμος	Number
βενζίνες	βενζίνη	Number
Αγκολέζους	Αγκολέζο	Number
γυρνούν	γυρνά	Number
πουστοφέρνουν	πουστοφέρνετε	Person
σκούπιζες	σκούπιζα	Person
συσκευασιών	συσκευασίες	Case
ανανεωνόσουν	κοιμόσουν	lemma
άλση	μισάωρα	lemma
βρήκατε	βρήκαμε	Person
μοιράζει	μοίραζε	Tense
καταλύτη	καταλυτών	Number
ωκεάνιες	ωκεάνιων	Case
φαρμακεία	φαρμακείο	Number
μπαταρίες	μπαταριών	Case
συγχώρα	συγχωρήστε	Number
δίκτυα	δικτύων	Case
κλασσικότατου	κλασσικότατε	Case
εξάμετρο	φυλλάδιο	lemma
δούλας	δούλα	Case
λιθίνω	οπιδνώ	lemma
αγγειοπλάστες	αγγειοπλαστών	Case
ζέβρα	ζέβρας	Case
συνεντεύξεων	συνεντεύξεις	Case
άσυλα	άσυλο	Number
ορνίθων	όρνιθες	Case
ανεμόμυλους	ανεμόμυλο	Number
εξασφάλιζε	στοίχιζε	lemma
υπερασπιστούν	υπερασπιστείς	Person
χωρικό	χωρικά	Number
αξιόπιστα	αξιόπιστοι	Gender
σορόπι	σοροπιού	Case
καθιστικού	καθιστικό	Case
πορτρέτου	πορτρέτων	Number
χορτοφαγία	χορτοφαγίας	Case
προσκυνητές	προσκυνητών	Case
φαρμακευτικής	φαρμακευτικών	Number
αμοιβαίων	αμοιβαίας	Number
εγκατάλειψη	εγκατάλειψης	Case
σιδηρουργοί	σιδηρουργέ	Number
ανακοινωνόταν	ανακοινώνονταν	Number
βιβλιοδετικές	βιβλιοδετικών	Case
μειώνονταν	μειωνόταν	Number
σκατάδων	σκατάδες	Case
ολιγαρχική	ολιγαρχικής	Case
χριστουγεννιάτικα	χριστουγεννιάτικες	Gender
γαμπρό	γαμπρέ	Case
αγοραστής	αγοραστή	Case
όαση	όασης	Case
κεφαλαίο	κεφαλαίου	Case
ελών	έλη	Case
ανάλωσης	ανάλωση	Case
εριστικότατης	τυχερότατης	lemma
αγριοκοιταχτούμε	σχηματιστούμε	lemma
έκτακτοι	έκτακτων	Case
λίρας	λιρών	Number
ημίθεοι	ημίθεους	Case
νυμφευμένο	νυμφευμένα	Number
εκατοστά	πρόστιμα	lemma
αρνητική	αρνητικές	Number
καμηλοπαρδάλεις	καμηλοπάρδαλη	Number
Ιρανοί	Ιρανός	Number
πλίθρες	πλιθρών	Case
τρισδιάστατους	τρισδιάστατων	Case
θυμάρια	θυμάρι	Number
απογοητευτούν	μεταφραστούν	lemma
διαβήτες	ψευδαισθήσεις	lemma
λέβητες	λεβήτων	Case
κυκλοφοριόταν	κυκλοφορείται	Tense
βρύα	βρύων	Case
ακολούθησαν	ακολούθησε	Person
Τσέχας	Τσέχων	Number
μανδαρίνους	μανδαρίνοι	Case
ζώνες	ζωνών	Case
αιματοβαμμένη	αιματοβαμμένο	Gender
μονωτικές	μονωτική	Number
σημαιών	σημαίες	Case
γυμνοσάλιαγκες	γυμνοσάλιαγκας	Number
φαγκότα	φαγκότο	Number
εξάσκησης	εξάσκηση	Case
ένζυμα	ενζύμων	Case
βελονισμό	βελονισμός	Case
υποκριτές	υποκριτών	Case
μεταβλητοί	μεταβλητών	Case
μαρκάραμε	μάρκαρε	Person
τετραπλού	τετραπλό	Case
κοστουμιού	κοστουμιών	Number
μαφιόζους	μαφιόζων	Case
απατούσε	απατά	Tense
χαράτσια	χαράτσι	Number
ακαταλόγιστη	ακαταλόγιστης	Case
μοτοποδήλατα	μοτοποδήλατο	Number
αριθμοί	αριθμός	Number
καταδρομέων	καταδρομείς	Case
γιοι	γιος	Number
βιβλιοθηκάριοι	βιβλιοθηκάριε	Number
προσανατολισμό	προσανατολισμέ	Case
κουμπάρο	κουμπάρου	Case
συμπαθείτε	συμπάθησε	Person
ανοιχτήρια	ανοιχτήρι	Number
εθελοντή	εθελοντών	Number
υπολογίζω	υπολογίζουμε	Person
σκοτάδια	σκοτάδι	Number
μελισσοφάγοι	μελισσοφάγος	Number
κρεμμύδι	κρεμμυδιού	Case
αζύγιαστε	πέρμιε	lemma
αντικαταστάτες	αντικαταστατών	Case
αδίστακτα	χρήσιμα	lemma
κώδικες	κώδικα	Number
σφυρίζεις	σφυρίζετε	Person
άρθρωση	άρθρωσης	Case
Σλοβένοι	Σλοβένος	Number
χειριστών	χειριστές	Case
μαβής	μαβιά	Gender
δωδεκάδες	δωδεκάδα	Number
κουρούνας	κουρούνα	Case
άβλαπτη	άβλαπτες	Number
άκαμπτες	άκαμπτων	Case
εχθροί	εχθρός	Number
παλάτι	παλατιού	Case
στάσεις	στάση	Number
περιορισμοί	περιορισμών	Case
ενδοσπερμίων	ενδοσπέρμια	Case
Βραζιλιάνοι	Βραζιλιάνων	Case
σεβασμό	σεβασμός	Case
διαδήλωσης	διαδήλωση	Case
παξιμαδιού	παξιμάδι	Case
μασχάλη	μασχάλης	Case
αβεβαίωτων	αβεβαίωτα	Case
εξάτμισης	εξάτμιση	Case
σιδερένιων	σιδερένιους	Case
σπάστε	σπάσε	Number
αγριωπός	αγριωποί	Number
ακουστικούς	ακουστικές	Gender
κλούβιων	κλούβιες	Case
λεωφορείο	λεωφορείου	Case
βώλοι	βώλος	Number
πνευμονικές	πνευμονικά	Gender
ευρεία	ευρείας	Case
πολεμώ	πολεμούσα	Tense
πρωτότυπο	πρωτότυπου	Case
συμπεριφορών	συμπεριφορές	Case
αντάμωσης	ανταμώσεων	Number
ήπειροι	ήπειρος	Number
σερβιτόρο	σερβιτόρος	Case
αστρολόγους	αστρολόγοι	Case
εραστή	εραστής	Case
μελέτησε	μελετήστε	Person
τύμπανου	τύμπανο	Case
αδελφωθούν	σκεφτούν	lemma
δανείζαμε	παρηγορούσαμε	lemma
πυγολαμπίδες	πυγολαμπίδα	Number
αεροπόροι	αεροπόρων	Case
αεροπορικό	αεροπορικά	Number
ποιμένες	ποιμένας	Number
καυτά	καυτό	Number
παστού	παστέ	Case
διαφωνούν	διαφωνείς	Person
ψαλιδιού	ψαλιδιών	Number
συνδρομές	συνδρομή	Number
προσοχή	προσοχής	Case
βελανιδιού	βελανίδι	Case
αίγες	αιγών	Case
αλβανικοί	αλβανικά	Gender
αστυνόμο	αστυνόμε	Case
σχήματα	σχήμα	Number
ουρανέ	ουρανός	Case
φλεγμονής	φλεγμονή	Case
μεταφύτευαν	μεταφύτευε	Person
ρυζιού	ρυζιών	Number
δολοφόνους	δολοφόνο	Number
είσοδοι	εισόδων	Case
στρουθοκάμηλο	στρουθοκαμήλου	Case
πολυωνύμων	πολυώνυμα	Case
διασπορές	διασπορά	Number
άνεμο	ανέμου	Case
τζίρου	τζίρος	Case
σεληνιακέ	σεληνιακοῦ	Case
περιηγητή	περιηγητών	Number
ρωτούσα	ρωτώ	Tense
εὐρεῖᾰν	ἀνδρείᾱν	lemma
αγγέλαμε	άγγελα	Person
διατύπωσες	μπήκες	lemma
βρωτικώ	σφιγκτώ	lemma
ακέριε	ακέριο	Gender
ανθρωποφάγο	ανθρωποφάγε	Case
αχλαδιού	αχλαδιών	Number
πάρε	πάρτε	Person
τρίγωνα	τριγώνων	Case
ισχυρότερης	ψηλότερης	lemma
σημειώσεις	σημείωση	Number
ανταποκριτών	ανταποκριτές	Case
σόργο	σόργου	Case
αντιρρήσεων	αντιρρήσεις	Case
βιώσιμοι	βιώσιμα	Gender
ομίχλης	ομιχλών	Number
τρούλους	τρούλοι	Case
χιονονιφάδες	χιονονιφάδων	Case
εναλλακτών	εναλλάκτες	Case
φωτογραφίζει	φωτογράφιζε	Tense
αποσαφηνιστεί	αποσαφηνιστούν	Person
τελεστή	τελεστών	Number
αποφύσεων	αποφύσεις	Case
επανεγκατάστασης	σύμπτωσης	lemma
ετοιμάζονταν	ετοιμαζόμουν	Person
αναλγητικός	αναλγητικοί	Number
οδοντίατρο	οδοντιάτρου	Case
ορυκτολόγου	ορυκτολόγος	Case
καταλληλότατες	ψηφιακότατες	lemma
Αυστριακές	Αυστριακών	Case
αμπαλάρισα	αμπαλάραμε	Person
ἀλλοιωτικᾰ́	ἀλλοιωτικᾱ́ς	Gender
διοργανώνουν	χάνονται	lemma
κυματίζω	κυματίζουν	Person
μεσοπαθητικές	μεσοπαθητική	Number
έσπαζα	σπάζαμε	Person
θράκα	θράκας	Case
τραπεζίτες	τραπεζίτη	Number
δίοδοι	διόδους	Case
χέζεται	χεζόμαστε	Person
καρότων	καρότα	Case
εργοστασίου	εργοστάσιο	Case
καταστήματα	κατάστημα	Number
μηχανισμοί	μηχανισμούς	Case
αδέσποτη	αδέσποτες	Number
κανονισμού	κανονισμών	Number
αταξίας	αταξία	Case
αισθητών	αισθητούς	Case
επιστροφές	επιστροφών	Case
οδηγούν	οδηγεί	Person
βάλθηκε	βαλθήκαμε	Person
γυρίνοι	γυρίνε	Number
καβουρντίζετε	καβούρντιζε	Person
ντομάτες	ντομάτα	Number
ηπείρους	ηπείρων	Case
αγριοράδικα	αγριοράδικων	Case
εξυπνότατε	ελάχιστε	lemma
λακωνικό	λακωνικού	Case
απόγονοι	απόγονος	Number
εικονολήπτη	εικονολήπτης	Case
έκθεσης	εκθέσεων	Number
σόγια	σογιών	Case
γορίλες	γορίλας	Number
εξωγήινος	εξωγήινη	Gender
ήττας	ήττα	Case
τρούλοι	τρούλος	Number
ίσια	ίσιων	Case
συνομιλίας	συνομιλιών	Number
μητροπολίτες	μητροπολίτη	Number
μειώσεις	μειώσεων	Case
μετασχηματιστή	μετασχηματιστής	Case
αστακό	αστακού	Case
σημειώματος	σημείωμα	Case
σοσιαλιστικά	σοσιαλιστικών	Case
μεθοδολογίας	μεθοδολογία	Case
προμαχώνες	προμαχώνα	Number
λαγό	λαγέ	Case
σμάλτα	σμάλτο	Number
περίβολοι	περιβόλους	Case
ψηφοφόρου	ψηφοφόρων	Number
διαβόητης	διαβόητη	Case
πεφταστέρια	πεφταστεριών	Case
ιπτάμενος	ιπτάμενη	Gender
αδερφών	αδερφοί	Case
γνώσης	γνώσεων	Number
ναζιστές	ναζιστών	Case
απαιτούμε	απαιτείτε	Person
ροδακινιές	ροδακινιά	Number
ενοχής	ενοχών	Number
άργιλο	αργίλου	Case
δεσποινίδας	δεσποινίδα	Case
μπανάνες	μπανάνα	Number
θωρακισμένος	θωρακισμένου	Case
πιονίου	πιόνιο	Case
ισχυριστούμε	ισχυριστείς	Person
βουλευτές	βουλευτής	Number
αριστοκράτες	αριστοκρατών	Case
σημάδι	σημαδιού	Case
προληπτικού	προληπτικό	Case
συντρόφους	σύντροφοι	Case
αναχαίτιζα	αναχαιτίζω	Tense
όξινο	όξινη	Gender
υπέρμετρες	υπέρμετρη	Number
ανοικτότερο	πειστικότερο	lemma
σλοβενικό	σλοβενική	Gender
αντίτιμα	αντίτιμο	Number
μισάωρα	μισάωρο	Number
αναχώματα	αναχωμάτων	Case
φλιτζάνι	φλιτζανιού	Case
βύθιζες	μισιόσουν	lemma
ατμόπλοια	ατμόπλοιο	Number
εθνικισμούς	εθνικισμών	Case
κειμηλίου	κειμηλίων	Number
βοοειδή	βοοειδών	Case
δωδεκανησιακού	δωδεκανησιακό	Case
Ρουαντέζων	Ρουαντέζες	Case
παρακάλεσαν	παρακάλεσα	Person
τριγώνου	τριγώνων	Number
λεπτού	λεπτό	Case
κλωστές	κλωστών	Case
εισάγουμε	φθάνουμε	lemma
εισιτηρίου	εισιτήριο	Case
ευκές	ευκή	Number
προαστίων	προάστια	Case
αεροπλάνου	αεροπλάνο	Case
κερασιών	κερασιές	Case
Καπουτσίνων	κοιτών	lemma
πολυγώνου	πολύγωνο	Case
προσωπικότητας	προσωπικότητα	Case
ναύλων	ναύλοι	Case
δυναμικά	δυναμικών	Case
έρανοι	εράνους	Case
προσκοπισμός	προσκοπισμού	Case
λοβού	λοβός	Case
σφηνών	σφήνες	Case
ορυχεία	ορυχείο	Number
τελείωσα	τελείωσε	Person
περιβάλλοντα	περιβαλλόντων	Case
συγκεντρώνετε	συγκεντρώνεις	Person
δείχνεσαι	συντομεύεις	lemma
βασιλιά	βασιλιάδων	Number
σύντροφοι	σύντροφος	Number
αγαλματιδίου	αγαλματίδιο	Case
Λιβανέζε	Λιβανέζος	Case
κοπτήρα	κοπτήρας	Case
οξέος	οξέων	Number
νταούλια	νταούλι	Number
χόρτα	χόρτων	Case
επιλογής	επιλογή	Case
λεπτομέρειας	λεπτομέρεια	Case
διαφημίσεις	διαφήμιση	Number
αδέσποτη	κόκκινο	lemma
αγιογραφιών	αγιογραφίες	Case
προμαχώνα	προμαχώνας	Case
βοηθώ	βοηθεί	Person
ψηφοφόροι	ψηφοφόρος	Number
άλσους	αλσών	Number
καθολικᾰ́	καθολικώ	Number
αναχαιτίσει	σχηματίσει	lemma
γάτοι	γάτος	Number
πλειστοκαινικών	πλειστοκαινικού	Number
κόμισσας	κόμισσα	Case
σύλληψη	σύλληψης	Case
ειδωλολάτρες	ειδωλολάτρη	Number
κτυπήματος	κτύπημα	Case
χαρτιού	χαρτιών	Number
κιβωτίου	κιβώτιο	Case
αγοραστού	αγοραστών	Number
παντοδύναμη	παντοδύναμο	Gender
ξενοδόχας	ξενοδόχα	Case
ημίσεος	ήμισυ	Case
σεληνάκατε	σεληνάκατος	Case
έλεγχοι	έλεγχε	Number
σταχτοτσικνιά	σταχτοτσικνιάς	Case
εθνικιστικοί	εθνικιστικός	Number
βλάφτεις	βλάφτετε	Person
απομονωμένος	απομονωμένο	Case
σαρκικές	σαρκική	Number
τράβηξαν	τράβηξε	Number
ανθρώπινης	ανθρώπινη	Case
διαφορετικά	διαφορετικό	Number
αστεροσκοπείου	αστεροσκοπείο	Case
αργότερων	προοδευτικότερων	lemma
άγουρε	άγουρο	Gender
όλα	όλων	Case
γυλιοί	γυλιέ	Number
απομονωμένων	οικονομικών	lemma
ιστολογίων	ιστολόγια	Case
κουτσά	κουτσό	Number
περιττός	περιττό	Gender
σκουπιδιάρηδες	σκουπιδιάρης	Number
καναρίνια	καναρίνι	Number
μυρμηγκιών	μυρμήγκια	Case
αναμνηστικό	ναρκωτικό	lemma
γρήγορου	γρήγορης	Gender
μεταγραμματισμό	μεταγραμματισμέ	Case
υψικαμίνους	υψικαμίνων	Case
ηχείου	ηχείο	Case
κέρατο	κεράτου	Case
συνταγή	συνταγής	Case
αλοιφές	αλοιφή	Number
παρασίτου	παράσιτο	Case
ραπανιών	ραπάνια	Case
έψελνε	ψέλνατε	Person
κυνικοῖς	κυνικῷ	Number
αβίωτε	αβίωτη	Gender
έλαιο	ελαίου	Case
ωκεάνιο	ωκεάνιου	Case
συγχαρητήριοι	συγχαρητήριους	Case
μαντεύει	μαντεύουν	Person
βιολιστή	βιολιστών	Number
ζητιάνους	ζητιάνο	Number
βάσανα	βάσανο	Number
κριτσίνια	κριτσίνι	Number
συστατικό	συστατική	Gender
επάγγελμα	επαγγέλματος	Case
γόμας	γομών	Number
δάρθηκες	δαρθείς	Tense
τρισδιάστατοι	τρισδιάστατων	Case
ιδιοκτησίας	ιδιοκτησία	Case
υπερφυσικών	υπερφυσικά	Case
αλείφουν	είναι	lemma
πανθεϊσμός	πανθεϊσμού	Case
λίστας	λίστα	Case
κτένι	κτενιού	Case
απέμενε	χρωστούσε	lemma
αρουραίοι	αρουραίε	Number
φουρτούνες	φουρτούνα	Number
λευκοσίδηρε	λευκοσιδήρου	Case
βρυκόλακες	βρυκολάκων	Case
συμπυκνωμένων	συμπυκνωμένες	Case
εθελοντές	εθελοντών	Case
βοσκό	βοσκού	Case
θείας	θεία	Case
φώτιζε	φωτίζετε	Person
εισόδους	εισόδων	Case
απολυτής	απολυτών	Number
κατέφεραν	καταφέραμε	Person
θερμοκηπίου	θερμοκηπίων	Number
βαριές	βαριά	Number
οφθαλνιάτρους	οφθαλνίατροι	Case
σεληνάκατο	σεληνάκατος	Case
κανταδόρων	κανταδόροι	Case
στολή	στολής	Case
κατανοητές	κατανοητά	Gender
ακολουθίας	ακολουθιών	Number
καβαλέτο	καβαλέτου	Case
συνθετών	συνθέτες	Case
ξεχνιούνται	ξεχνιόμαστε	Person
λοιμοκαθαρτηρίου	λοιμοκαθαρτήριο	Case
στεφανιού	στεφάνι	Case
απεικόνιση	απεικόνισης	Case
χαμόγελο	χαμόγελου	Case
επιχειρησιακός	επιχειρησιακού	Case
παίκτριας	παίκτρια	Case
εκατομμυριούχου	εκατομμυριούχος	Case
νεύρου	νεύρων	Number
βόθρων	βόθροι	Case
αέναων	αέναης	Number
γραπτά	γραπτών	Case
μάγειρα	μαγείρων	Number
ανθρωπολογικά	ανθρωπολογικό	Number
αρσενικές	αρσενικών	Case
παράνυμφοι	παράνυμφος	Number
οξείδιο	οξειδίου	Case
ψαράδες	ψαρά	Number
δικηγόρους	δικηγόροι	Case
εράνους	έρανοι	Case
πάπια	πάπιας	Case
ποντικού	ποντικών	Number
πρεσβευτές	πρεσβευτή	Number
διατυπώνω	διατυπώνεις	Person
καπέλο	καπέλου	Case
μακαρονάδες	μακαρονάδα	Number
βγαλθεί	επιβληθεί	lemma
σλοβενικές	σλοβενική	Number
κεφαλαιοκράτισσες	κεφαλαιοκρατισσών	Case
επίλογοι	επίλογος	Number
Μαλγάσιου	Μαλγάσιων	Number
γομφίο	γομφίος	Case
κάλπες	κάλπη	Number
δήλωνε	πάντρευε	lemma
αγωνιστές	αγωνιστής	Number
αυτοκράτειρα	αυτοκράτειρας	Case
Σουριναμέζου	Σουριναμέζε	Case
σώτειρες	σώτειρα	Number
βουλευτές	βουλευτών	Case
συνωμοσίες	συνωμοσία	Number
κοτόπουλου	κοτόπουλο	Case
χωριάτη	χωριάτης	Case
μαφιόζου	μαφιόζε	Case
αυθεντικότερος	ρηχότερος	lemma
Βόσνιες	Βόσνια	Number
αμερόληπτων	αμερόληπτους	Case
ούλο	ούλα	Number
μοναδική	μοναδικό	Gender
φρονήματος	φρόνημα	Case
γριούλας	γριούλα	Case
ενοχλείσαι	ενοχλείται	Person
δημιουργηθήκατε	δημιουργήθηκε	Person
εκδότες	εκδότη	Number
προσγειωνόμασταν	προσγειωνόμουν	Number
ποδηλάτη	ποδηλάτης	Case
οξειδοαναγωγικές	οξειδοαναγωγική	Number
ανιψιά	ανιψιάς	Case
χωροφύλαλες	χωροφύλαλα	Number
φυσούμε	φυσούσαμε	Tense
διαθέσιμοι	διαθέσιμα	Gender
δημοσιογράφους	δημοσιογράφων	Case
απλοποιείται	απλοποιούνται	Person
υπηκόους	υπηκόων	Case
αθηναϊκό	αθηναϊκή	Gender
απολίτιστο	χωριάτικο	lemma
κολάφους	κόλαφο	Number
εκκένωσης	εκκενώσεων	Number
ευτυχισμένου	ευτυχισμένης	Gender
περίφραξης	περιφράξεων	Number
τραγωδιών	τραγωδίες	Case
εξαρτίσεων	εξαρτίσεις	Case
αιφνίδιου	αιφνίδιας	Gender
ανεργία	ανεργίας	Case
πενθεράς	πενθερά	Case
ετοιματζίδικη	ετοιματζίδικο	Gender
ουρανοί	ουρανός	Number
πεζοδρόμου	πεζοδρόμων	Number
αναρχικούς	αναρχικό	Number
λεξιλογίων	λεξιλόγια	Case
περπατήσατε	περπατήσαμε	Person
αμμώνια	κουτεντέδες	lemma
επίθεσης	επίθεση	Case
προσαρμοζόταν	προσαρμόζονταν	Person
εμπορικού	εμπορικό	Case
κερδίσαμε	κέρδισα	Number
φύσεις	φύσεων	Case
ηρωισμού	ηρωισμών	Number
καυγά	καυγάς	Case
κοιτάτε	κοίταξε	Number
νωπά	νωπό	Number
λιβεριανές	λιβεριανά	Gender
γιαλούς	γιαλό	Number
προνυμφών	προνύμφες	Case
καραμπίνες	καραμπίνα	Number
συγκεντρωθεί	συγκεντρωθούν	Number
επιτροπής	επιτροπών	Number
βαθμοφόρου	βαθμοφόρος	Case
αποθηκεύετε	αποθηκεύουμε	Person
νεαρᾱ́	ἀλαπαδνᾱ́	lemma
συμπεθερεύεις	συμπεθέρευες	Tense
αγορήτριας	αγορητριών	Number
λογοτέχνη	λογοτέχνης	Case
ανεψιάς	ανεψιά	Case
χοίρους	χοίρων	Case
γειτονιές	γειτονιά	Number
αμφιθέατρα	αμφιθέατρο	Number
ανάρτησης	ανάρτηση	Case
έλκη	έλκος	Number
είχαμε	έχουμε	Tense
αμεσότατους	κομψότατους	lemma
αρχείου	αρχείων	Number
νομοθετικοῖν	ὑπνωτικοῖν	lemma
ρολού	ρολών	Number
φονταμενταλίστριας	φονταμενταλίστρια	Case
ορθόδοξοι	ορθόδοξους	Case
αποκτούν	αποκτούμε	Person
ομιχλών	ομίχλες	Case
υποδοχή	υποδοχής	Case
κατηγοριόσαστε	κατηγορείστε	Tense
ταχυδρομικές	ταχυδρομικών	Case
δράσης	δράσεων	Number
επεισοδίων	επεισόδια	Case
οργανικής	οργανικού	Gender
καραβιού	καραβιών	Number
κλάσματος	κλασμάτων	Number
συνεχίζεις	συνεχίζετε	Number
καρύκευματα	καρύκευμα	Number
αναδασώσεις	αναδάσωση	Number
μηχανής	μηχανών	Number
δεκτών	δέκτες	Case
διαστήματα	διαστημάτων	Case
προσκαλείς	προσκαλούσες	Tense
βλεφάρων	βλέφαρα	Case
περιστάσεων	περιστάσεις	Case
απεραντολογίες	απεραντολογία	Number
δρυμού	δρυμός	Case
πολυμήχανος	πολυμήχανε	Case
αλλαγές	αλλαγή	Number
υπογραμμιστών	υπογραμμιστές	Case
μεταγλωττίσεων	μεταγλωττίσεις	Case
μπάφων	μπάφοι	Case
προπάππους	προπάππο	Number
ιερειών	ιέρειες	Case
θητείες	θητειών	Case
ψευδαισθήσεις	ψευδαισθήσεων	Case
σαγηνευτικού	σαγηνευτικό	Case
οικοδεσπότες	οικοδεσπότης	Number
αστικό	αστικού	Case
μπαλονιού	μπαλονιών	Number
εμπόλεμων	εμπόλεμα	Case
αϊτινό	νεαρόν	lemma
κηπουρό	κηπουρέ	Case
αϊτό	μπαμπουίνο	lemma
πλίνθων	πλίνθοι	Case
χωματερές	χωματερή	Number
πειραμτόζωα	πειραμτόζωων	Case
αδιαμόρφωτο	αδιαμόρφωτου	Case
στεμμάτων	στέμματα	Case
ἐλευθέρᾱ	ἐλεύθερος	Gender
ανέβηκα	ανέβηκε	Person
ακτή	ακτής	Case
ξυλόφωνα	ξυλόφωνο	Number
πλοκαμιών	πλοκάμια	Case
αστεία	πολυσύχναστα	lemma
ασύρματου	ασύρματο	Case
καταφέρεις	καταφέρετε	Number
καβαλάρηδων	καβαλάρηδες	Case
μπουζοκαλώδια	μπουζοκαλώδιο	Number
φαυλότητες	φαυλότητα	Number
μπεντόνια	μπεντόνι	Number
νησιά	νησιών	Case
φλοιοί	φλοιών	Case
κρεοπώλες	κρεοπώλη	Number
αδερφούς	αδερφοί	Case
εφικτών	εφικτά	Case
ενυδάτωσης	ενυδάτωση	Case
χιλιάδα	χιλιάδας	Case
άβακες	άβακας	Number
αισθητικές	αισθητική	Number
δακτύλιοι	δακτύλιος	Number
γαϊδουράκια	γαϊδουράκι	Number
κάδρου	κάδρο	Case
αγνοείστε	αγνοείσαι	Number
απολογίες	απολογία	Number
οδηγού	οδηγών	Number
αιμομικτικόςές	αιμομικτικόςά	Gender
χαλασμένου	χαλασμένων	Number
φτέρνες	φτέρνα	Number
περιβαλλοντικές	περιβαλλοντικά	Gender
κυνικῇ	ὑλικῇ	lemma
ταυτόχρονων	ταυτόχρονες	Case
κρεολοί	κρεολών	Case
τσεχικά	τσεχικών	Case
στομαχόπονοι	στομαχόπονος	Number
ήχους	ήχων	Case
ενοικίων	ενοίκια	Case
ειδοποίησαν	έσπασαν	lemma
επικρατήσει	κρύψει	lemma
διατηρήθηκε	περπάτησε	lemma
βουνό	βουνού	Case
αξιών	αξίες	Case
συνασπισμού	συνασπισμός	Case
Γάλλους	Γάλλων	Case
θαύματα	θαυμάτων	Case
αστρολάβου	αστρολάβος	Case
εντόμων	έντομα	Case
οδοντικού	οδοντικός	Case
αξιοσημείωτων	πέμπτων	lemma
επέκταση	επέκτασης	Case
βασίλισσας	βασιλισσών	Number
παντοπώλη	παντοπώλης	Case
έκταση	έκτασης	Case
αργιών	αργίες	Case
αιωροπτεριστές	αιωροπτεριστών	Case
ξέρουν	ξέρει	Number
μηκεδανώ	ἐφελκυστικώ	lemma
αβδέλλας	αβδέλλα	Case
στιγμιαίας	στιγμιαίων	Number
νεφελωμάτων	νεφελώματα	Case
αντισυλληπτικού	αντισυλληπτικό	Case
ηλίανθους	ηλίανθων	Case
πετάξατε	πέταξες	Person
δευτερολέπτου	δευτερόλεπτο	Case
πλοκαμιού	πλοκαμιών	Number
ισοδύναμων	ισοδύναμες	Case
ενυδάτωσης	ενυδατώσεων	Number
άσε	άσος	Case
επανορθώσεις	επανορθώσεων	Case
αυτοκράτορες	αυτοκρατόρων	Case
εξοπλισμού	εξοπλισμών	Number
συνεταιρισμοί	συνεταιρισμών	Case
πετοσφαίριση	πετοσφαίρισης	Case
προσβλητικές	προσβλητικών	Case
αγόρια	μπερδέματα	lemma
λόφοι	λόφους	Case
λεπτομέρειες	λεπτομέρεια	Number
στιφάδων	στιφάδα	Case
άγγιαχτη	άγγιαχτε	Gender
σιαγόνων	σιαγόνες	Case
πιπεριάς	πιπεριών	Number
ανεψιού	ανεψιός	Case
δοκιμασιών	δοκιμασίες	Case
αγιογράφο	αγιογράφος	Case
ανθρώπινο	τίμιο	lemma
κοχλίες	κοχλιών	Case
φυσά	φυσούσε	Tense
χρήσιμους	χρήσιμο	Number
βιολιστές	βιολιστή	Number
στοιχεία	στοιχείο	Number
σελιδοδείκτες	σελιδοδείκτης	Number
ύαινες	υαινών	Case
μηχανής	μηχανή	Case
λαγού	λαγών	Number
κύησης	κύηση	Case
ετοιμόρροπη	ετοιμόρροπο	Gender
άργυρος	μπορδέλο	lemma
ιατρούς	ιατροί	Case
αναιμικότατος	ορθότατος	lemma
συζητεί	συζητάτε	Person
Λιβανέζοι	Λιβανέζε	Number
βρετανικού	βρετανικής	Gender
μυθιστοριογράφοι	μυθιστοριογράφος	Number
μαμάς	μαμά	Case
δήλωση	δήλωσης	Case
περιπτέρου	περίπτερο	Case
εξαδέλφων	εξαδέλφες	Case
χειρόγραφης	χειρόγραφου	Gender
μύξας	μύξα	Case
έγνοιας	έγνοια	Case
επίδομα	επιδόματος	Case
Αφγανούς	Αφγανοί	Case
αισθητά	αισθητοί	Gender
διπλοί	διπλούς	Case
ἐνθετικοί	ἐνθετικᾰ́	Gender
ευθύνες	ευθύνη	Number
στροφαλοφόρος	στροφαλοφόρο	Gender
λοξοδρομίες	λοξοδρομιών	Case
πληθών	πλήθη	Case
ξάδερφους	ξάδερφων	Case
επιμέναμε	επέμενες	Person
ποσειδώνιο	ποσειδωνίου	Case
απολαμβάνατε	απολαμβάνετε	Tense
σερβιτόρους	σερβιτόρων	Case
γυροσκοπίων	γυροσκόπια	Case
αυταρχικές	αυταρχικών	Case
άτλαντα	οργανική	lemma
ενδοσκόπηση	ενδοσκόπησης	Case
άδηλα	άδηλων	Case
κοπρίτες	κοπριτών	Case
προϊστάμενοι	προϊστάμενος	Number
αγνώμονες	αγνώμων	Number
πιάνου	πιάνο	Case
μεταρρυθμιστές	μεταρρυθμιστών	Case
αυτοκρατορικότατα	ρομαντικότατα	lemma
δεδικασμένο	δεδικασμένου	Case
αθρόες	αθρόα	Number
ζηλιάρικα	ζηλιάρηδες	Gender
εμβολίζουν	εμβολίζετε	Person
κιρσό	κιρσού	Case
αντοχές	αντοχών	Case
απαντήσεις	απαντήσεων	Case
βοριάδες	βοριάς	Number
αιχμαλωσίες	αιχμαλωσιών	Case
προϊστάμενο	προϊστάμενος	Case
αποταμίευσαν	αποταμίευσε	Number
χαλυβουγιών	χαλυβουργίες	Case
απέχουμε	απέχει	Person
σκαραβαίου	σκαραβαίος	Case
αδιάκοπο	αδιάκοπος	Gender
γονείς	γονέας	Number
γλύπτη	γλύπτης	Case
άρθρο	άρθρου	Case
τηλεπικοινωνιακό	τηλεπικοινωνιακός	Gender
ισχυριστούμε	ισχυριστώ	Person
έβγαζε	έβγαζαν	Person
εγκαταλείψεων	εγκαταλείψεις	Case
θηριωδίες	θηριωδία	Number
απόλυτες	μεσημβρινές	lemma
διαβεβαιωθώ	καθαριστώ	lemma
ακμαιότερος	οικονομικότερος	lemma
χριστιανούς	χριστιανό	Number
ορίστηκε	οριστήκατε	Person
νεών	νήες	Case
βομβών	βόμβες	Case
καβαλάρηδων	πιτσουνιών	lemma
βαρώνους	βαρώνων	Case
ιντσών	ίντσες	Case
στρατοπέδου	στρατοπέδων	Number
χρήσεις	χρήση	Number
Χριστιᾱνῐκᾱ́	ψυχρᾱ́	lemma
διάβηκαν	μίσησαν	lemma
αποκεφαλιστείς	αποκεφαλίστηκες	Tense
παπουτσιού	παπουτσιών	Number
αεικίνητο	μαλγασικό	lemma
βρόμικου	βρόμικο	Case
αδαημοσύνες	αδαημοσυνών	Case
ποτών	πότες	Case
αμαρτημάτων	αμαρτήματα	Case
νωπογραφιών	νωπογραφίες	Case
ανώδυνου	ανώδυνο	Case
υδροπτέρυγα	υδροπτέρυγο	Number
αποκρατικοποιήσεις	αποκρατικοποίηση	Number
αδιέξοδες	αδιέξοδα	Gender
αρουραίο	αρουραίος	Case
διφορούμενοςης	θωρακισμένης	lemma
μονομάχου	μονομάχε	Case
κούκε	κούκος	Case
αισθάνθηκαν	αισθανθούν	Tense
νερόμυλοι	νερόμυλων	Case
αραιότατοι	προβληματικότατοι	lemma
αστειευτώ	σκιστώ	lemma
κλειδωθήκαμε	κλειδωθήκατε	Person
βιβλιογραφίας	βιβλιογραφία	Case
τσιγγάνες	τσιγγάνα	Number
κατεψυγμένα	κατεψυγμένων	Case
καταφύγατε	κατέφυγε	Person
αξιωματικός	τηλεπικοινωνιακός	lemma
φαράγγια	φαράγγι	Number
βετεράνους	βετεράνοι	Case
αποδοκιμαστείτε	νοιαστείτε	lemma
ακλόνητο	καζάκικο	lemma
έχουν	έχουμε	Person
επιτυχίες	επιτυχιών	Case
κεραμικής	κεραμικών	Number
επιστροφών	επιστροφές	Case
στενού	στενών	Number
ενδιάμεση	ενδιάμεσος	Gender
αγριοκοιταχτείτε	στολιστείτε	lemma
ολομέλειας	ολομέλεια	Case
μακρηγορίας	μακρηγοριών	Number
διαιτητικών	διαιτητικές	Case
ξυπνήσαμε	ξυπνήσατε	Person
απολαμβάνουν	απολαμβάνουμε	Person
γομφίο	γομφίου	Case
ντανταϊσμό	ντανταϊσμού	Case
κάβοι	κάβων	Case
νεφέλωμα	νεφελώματος	Case
ατίθασο	πηγαίο	lemma
αναφέρατε	ανέφερα	Person
μονογράφηση	μονογράφησης	Case
αμπαλάροντας	ξεκωλώνοντας	lemma
έχει	μισθώνεται	lemma
εθνολόγο	εθνολόγε	Case
αρουραίους	αρουραίοι	Case
μέτρησης	μετρήσεων	Number
παλιρροϊκά	παλιρροϊκές	Gender
χαρτονομίσματα	χαρτονόμισμα	Number
χωρητικότητας	χωρητικότητα	Case
υπογραφές	υπογραφή	Number
βγες	βγείτε	Number
χρειαστείτε	χρειαστείς	Person
θερμίδων	θερμίδες	Case
κρίσιμα	κρίσιμο	Number
θριάμβευσε	σκίσε	lemma
Κύπριου	Κύπριος	Case
συντεταγμένης	συντεταγμένων	Number
βοσκοπούλας	βοσκοπούλα	Case
μακεδονικούς	μακεδονικά	Gender
επικόλλησης	επικόλληση	Case
χρωστάν	χρωστούσαν	Tense
είχε	είχανε	Person
ἄλβον	ἄλβου	Case
μελωδίες	μελωδιών	Case
γιαούρτια	γιαούρτι	Number
διέλευση	διέλευσης	Case
επιστημονικοί	επιστημονικές	Gender
οπληφόρους	οπληφόρων	Case
εκσκαφής	εκσκαφών	Number
κτήματος	κτημάτων	Number
πρωκτοί	πρωκτός	Number
αλείφοντας	παρεμποδίζοντας	lemma
αυλακιάς	αυλακιών	Number
έκαψαν	κάψατε	Person
κατσίκια	κατσίκι	Number
αεροπειρατίας	αεροπειρατία	Case
αρχιμουσικοί	αρχιμουσικός	Number
ξενιστές	ξενιστή	Number
πέννες	πέννα	Number
αναχωρούσε	αναχωρεί	Tense
α	ες	Gender
μπαμπουίνου	μπαμπουίνε	Case
δραματικότατων	σφιχτότατων	lemma
ταυτοτήτων	ταυτότητες	Case
εμφιαλωμένε	χορτοφαγικέ	lemma
καλορίζικες	καλορίζικων	Case
Ελβετού	Ελβετός	Case
εμίρηδες	εμίρηδων	Case
άλλαγμα	αλλάγματος	Case
νυχιού	νύχι	Case
κάγκελα	κάγκελων	Case
κακά	κακό	Number
λυθρινιών	λυθρίνια	Case
βοιωτικού	ἀερίνου	lemma
παγιδεύουμε	παγιδεύω	Person
βοσκής	βοσκών	Number
ασκοί	ασκούς	Case
ευρύχωρο	ὀξῠ́ν	lemma
αποβολής	αποβολή	Case
ηλεκτρικές	καταπράσινες	lemma
καλαμιού	καλάμι	Case
παγίδευαν	παγίδευε	Number
κινηματογράφο	κινηματογράφου	Case
φιστικιών	φιστικιές	Case
αγγλικού	αγγλικής	Gender
ρεβιθοκεφτέ	ρεβιθοκεφτέδων	Number
ναρκοπεδίων	ναρκοπέδια	Case
τερματοφύλακες	τερματοφύλακα	Number
ψιθύρους	ψίθυροι	Case
γυναικών	γυναίκες	Case
σωματικό	σωματική	Gender
πλατύφυλλο	πλατύφυλλα	Gender
πρίσμα	πρίσματος	Case
χειρόγραφης	χειρόγραφη	Case
ξεσχιζόταν	ξεσχιζόσουν	Person
στρέμματα	στρέμμα	Number
ηλιοπληξίες	ηλιοπληξιών	Case
αναμορφωθούν	αναμορφωθεί	Number
νονού	νονός	Case
αστρολάβου	αστρολάβε	Case
καλογεροπαίδια	καλογεροπαίδι	Number
μάντεις	μάντης	Number
γαλουχία	γαλουχίας	Case
ακυρολεξιών	ακυρολεξίες	Case
ανενεργά	ανενεργών	Case
γραμματοκιβώτια	γραμματοκιβώτιο	Number
κερκίδες	κερκίδων	Case
αστροναυτών	αστροναύτες	Case
ουσιαστικών	ουσιαστικά	Case
αδιαίρετη	αδιαίρετο	Gender
διττόν	συντριπτικό	lemma
ραδιενεργών	ραδιενεργοί	Case
άβατα	άβατοι	Gender
ράτσα	ράτσας	Case
πολιούχε	πολιούχος	Case
εκπαιδευτικός	εκπαιδευτικό	Gender
αγαθότητα	αγαθότητας	Case
δεμάτι	δεματιού	Case
επανεγκαταστάσεις	επανεγκατάσταση	Number
συντρόφου	συντρόφων	Number
πολιτισμούς	πολιτισμοί	Case
τουρίστες	τουριστών	Case
αντωνυμίας	αντωνυμία	Case
αμίαντου	αμίαντο	Case
στομάχια	στομάχι	Number
συμφιλίωση	συμφιλίωσης	Case
πρατηρίων	πρατήρια	Case
γεμιστήρας	γεμιστήρων	Number
κηπουρών	κηπουροί	Case
αθέμιτο	αθέμιτη	Gender
αβαθή	αβαθών	Case
καινούριας	καινούριων	Number
έγγαμους	έγγαμο	Number
τεχνολόγοι	τεχνολόγους	Case
αμνηστία	αμνηστίας	Case
κατηγορούμε	κατηγορείς	Person
χρωμόσωμα	χρωμοσώματος	Case
εμφιαλωμένο	εμφιαλωμένη	Gender
στροβῑλῐ́νω	ἐπιχωρίω	lemma
θεατή	θεατές	Number
γιδοβοσκό	γιδοβοσκού	Case
εμπρησμέ	εμπρησμός	Case
εφικτή	εφικτό	Gender
βαμβάκια	βαμβάκι	Number
αυτόνομε	αυτόνομου	Case
καπνιστές	καπνιστών	Case
ετοιμόρροπο	ετοιμόρροπος	Case
επιθετικότερη	τολμηρότερη	lemma
βαλίτσες	βαλίτσα	Number
φωτίζει	φώτιζε	Tense
παρέλαση	παρέλασης	Case
παπαγάλου	παπαγάλων	Number
κρεοπωλεία	κρεοπωλείο	Number
γυρνούσατε	γυρνούσε	Person
σινικός	σινική	Gender
εντομοκτόνο	εντομοκτόνα	Number
παρεκκλίσεις	παρεκκλίσεων	Case
ισχυρότερα	ψηλότερα	lemma
στιγμιαία	στιγμιαίας	Case
διαβλέψαμε	διέβλεψαν	Person
γαρνίρετε	γαρνίρουμε	Person
τυπογραφείου	τυπογραφείων	Number
καστάνια	καστάνιας	Case
αξιαγάπητη	νυκτερινή	lemma
αμφιθεάτρου	αμφιθεάτρων	Number
ακατατόπιστη	ακατατόπιστο	Gender
κούφων	κούφες	Case
αδαπάνητα	αδαπάνητοι	Gender
Ευαγγελιστές	Ευαγγελιστή	Number
εμπορικότεροι	εμπορικότερων	Case
χειμώνες	χειμώνας	Number
κελυφών	κελύφη	Case
πολυέλαιο	πολυέλαιος	Case
εκατόνταρχους	εκατόνταρχοι	Case
βοσκού	βοσκός	Case
αυχένα	αυχένων	Number
αισθαντικότατη	νομιμότατη	lemma
πρόσφυγες	προσφύγων	Case
αρθρώσεις	αρθρώσεων	Case
μητρικών	μητρικής	Number
λιβανικού	λιβανικό	Case
ασύρματη	ασύρματης	Case
τηλεφωνητή	τηλεφωνητής	Case
χαραμίζατε	χαράμιζαν	Person
ξέρουμε	ξέρουν	Person
μεσογειακή	μεσογειακό	Gender
ουρανό	ουρανού	Case
αγκυροβόληση	αγκυροβόλησης	Case
ακροθαλασσιάς	ακροθαλασσιά	Case
ακροδεξιού	ακροδεξιό	Case
λύσης	λύσεων	Number
σωματίδια	σωματιδίων	Case
αμοιβής	αμοιβή	Case
χειρουργοί	χειρουργός	Number
τοποθετώ	τοποθετούσα	Tense
άνηθο	άνηθος	Case
μελετούσες	μελετούσατε	Person
αγαθοεργίας	αγαθοεργιών	Number
αγορανόμου	αγορανόμος	Case
αερισμό	αερισμού	Case
βοηθητικά	φιλικά	lemma
εννοεί	εννοούν	Person
σαμιαμιθιών	σαμιαμίθια	Case
τριφυλλιών	τριφύλλια	Case
σχάρες	σχάρα	Number
ευθύνη	ευθύνης	Case
μπέρδεψαν	μπέρδεψες	Person
παγίδας	παγίδα	Case
κροατικές	κροατικών	Case
αχτίνας	αχτίνα	Case
κουφαριού	κουφάρι	Case
δελφινιού	δελφινιών	Number
ηττοπάθεια	ηττοπάθειας	Case
βιογραφιών	βιογραφίες	Case
ἐπαινετώ	ἐπαινετᾱ́	Gender
κουφιοκέφαλης	κουφιοκέφαλου	Gender
καζάκικες	καζάκικων	Case
μάσκες	μάσκα	Number
συστήνατε	συστήνετε	Tense
άσοι	άσους	Case
συγκομιδής	συγκομιδών	Number
ροδάκινου	ροδάκινων	Number
ζαρκάδια	ζαρκάδι	Number
αθέριστο	πλίθινο	lemma
επαίνων	έπαινοι	Case
ισχυρότερο	ψηλότερο	lemma
θαλαμίσκοι	θαλαμίσκος	Number
ρόπαλων	ρόπαλα	Case
κομμουνίστρια	κομμουνίστριας	Case
πεθαίνουν	πεθαίνεις	Person
χαρουπιάς	χαρουπιά	Case
προαύλια	προαύλιων	Case
ανιαρών	ανιαρές	Case
γορίλλες	γοριλλών	Case
αδασμολόγητοι	αδασμολόγητους	Case
επαγγέλματος	επαγγελμάτων	Number
διοργανωθούμε	διοργανωθώ	Person
κατάπιε	καταπίνετε	Person
θεάτρου	θέατρο	Case
κουλάκοι	κουλάκων	Case
φουντουκιές	φουντουκιών	Case
εμπορευματοκιβώτια	εμπορευματοκιβώτιο	Number
κυκλικά	κυκλικών	Case
απαλλαγμένα	απαλλαγμένοι	Gender
καλδέρα	καλδέρας	Case
πτυχία	πτυχίων	Case
κυδωνιού	κυδωνιών	Number
επιδρούσαν	επιδρούσε	Person
ξεκίνησα	ξεκίνησαν	Person
ιδιοκτησίες	ιδιοκτησία	Number
απερίσκεπτο	απερίσκεπτος	Gender
εξωτικά	πλίνθινα	lemma
βιοκαύσιμα	βιοκαύσιμο	Number
ουλές	ουλή	Number
αρχαιοελληνικής	αρχαιοελληνικών	Number
αιλουροειδών	αιλουροειδούς	Number
εργαζόμαστε	κεντούμε	lemma
άβλαβο	άβλαβη	Gender
αναφορές	αναφορά	Number
γαλέρες	γαλερών	Case
χαμένου	χαμένο	Case
αιρέσεις	αίρεση	Number
γενναιότερων	σοβαρότερων	lemma
αριθμητικό	ορεκτικό	lemma
ανεκδοτογράφο	ανεκδοτογράφος	Case
πιστές	πιστή	Number
πάρκο	πάρκου	Case
υπέρυθρες	υπέρυθρα	Gender
αρχιεπίσκοπο	αρχιεπίσκοπος	Case
μετάλλου	μέταλλο	Case
νοσοκόμων	νοσοκόμοι	Case
ηρώων	ήρωες	Case
δημιουργούσε	δημιουργούσες	Person
πρόσθεταν	προσθέτουν	Tense
αύξησες	αυξήσαμε	Person
πρόεδροι	πρόεδρε	Number
παρόντες	παρούσες	Gender
αποσύρσεων	αποσύρσεις	Case
αλλαγής	αλλαγή	Case
δομήσεις	δομήσεων	Case
ρόλους	ρόλων	Case
ήταν	ήμαστε	Person
ξεσκατιζόσασταν	ξεσκατιζόμασταν	Person
αισχρόλογα	αισχρόλογων	Case
Αργοναύτη	Αργοναύτης	Case
μώλοι	μώλε	Number
χαμομιλιού	χαμομιλιών	Number
θολού	θολό	Case
σταθερές	σταθερά	Number
απάντησης	απάντηση	Case
ισχυρότατα	ισχυρότατες	Gender
γλάστρα	πρόφαση	lemma
κόπτη	κοπτών	Number
ομότεχνων	ομότεχνους	Case
αυλούς	αυλό	Number
άλσους	άλσος	Case
κρέμασες	κρέμασα	Person
χαμέ	χαμός	Case
χθαμαλούς	χθαμαλώ	Number
απάντηση	απάντησης	Case
θορυβώδες	θορυβώδους	Case
δουλικές	δουλικών	Case
αγοράστρια	αγοράστριας	Case
αλείβει	άλειβε	Tense
διαφωνεί	διαφωνείς	Person
αξιώματος	αξιωμάτων	Number
κομμουνιστή	κομμουνιστής	Case
ιστιοδρομίες	ιστιοδρομιών	Case
ανακουφιστεί	επιβιβαστεί	lemma
πεολειχίας	πεολειχία	Case
ύψους	ύψος	Case
ευκάλυπτε	ευκάλυπτος	Case
συνηθισμένου	συνηθισμένο	Case
αγαπημένη	αγαπημένες	Number
βραβείων	βραβεία	Case
σιτηρά	σιτηρών	Case
επιβατικό	επιβατικού	Case
βιομηχανικά	βιομηχανικών	Case
αγαπιούνται	νοιώθουν	lemma
μετακινήσεις	μετακίνηση	Number
ολοκαυτώματα	ολοκαύτωμα	Number
βιομηχανικούς	βιομηχανικά	Gender
ανοιχτεί	κουλουριαστεί	lemma
αστική	αστικές	Number
σήματος	σήμα	Case
αρχαιολόγους	αρχαιολόγοι	Case
αρχιμάγειρα	αρχιμαγείρων	Number
κεραᾷ	ἀκροατικῇ	lemma
σαρδέλες	σαρδέλα	Number
εστιατόρια	εστιατορίων	Case
ναμάτων	νάματα	Case
διαγωνισμοί	διαγωνισμών	Case
ρίγες	ριγών	Case
νικάς	νικά	Person
σοσιαλιστικής	σοσιαλιστικών	Number
σκούρα	σκούρο	Number
καλαφατισμάτων	καλαφατίσματα	Case
μονή	μονής	Case
μετενσαρκώσεων	μετενσαρκώσεις	Case
αναψυκτήρια	αναψυκτήριο	Number
κομμάτια	κομμάτι	Number
αγύμναστα	αγύμναστες	Gender
βυζαντινές	θωρακισμένες	lemma
συκιές	συκιών	Case
πυροτεχνημάτων	πυροτεχνήματα	Case
μελάνες	μελανών	Case
Ούγγρους	Ούγγρων	Case
σφάλματα	σφαλμάτων	Case
λαδά	λαδάδων	Number
γυροσκόπια	γυροσκοπίων	Case
προτίμησε	προτίμησαν	Number
έκτοπους	μαδαρούς	lemma
βάρυνε	βάρυναν	Number
αρμενική	μινωική	lemma
γεμενιά	γεμενιών	Case
γλύπτες	γλυπτών	Case
ποδᾰγρῐκᾱ́	ποδᾰγρῐκή	Number
προέλευση	προέλευσης	Case
στοιχειομετρία	στοιχειομετρίας	Case
κεφαλαιοκρατία	κεφαλαιοκρατίας	Case
ληπτώ	χονδρώ	lemma
προπάππου	προπάππε	Case
προσωπικότητες	προσωπικότητα	Number
οίκοι	οίκους	Case
Τυρρηνού	Τυρρηνός	Case
συρμό	συρμού	Case
δοχείου	δοχείων	Number
μοναχικό	μοναχικού	Case
αλλαντικό	μικροοργανισμός	lemma
μεταβολισμό	μεταβολισμού	Case
εξαεριστήρες	εξαεριστήρα	Number
φλέβας	φλέβα	Case
βλαστήμιας	βλαστήμια	Case
χριστιανές	χριστιανή	Number
ζαχαρωνόσασταν	ζαχαρώνεστε	Tense
ραβίνους	ραβίνο	Number
σπογγαλιεία	σπογγαλιείας	Case
καταδοθούν	καταδοθεί	Person
ασσασίνοι	ασσασίνε	Number
άροτρο	αρότρου	Case
αιματοκυλίσματα	αιματοκύλισμα	Number
εξεταστές	εξεταστής	Number
κεραμικές	κεραμική	Number
ποιοτικοί	ποιοτικούς	Case
κλασσικό	κλασσική	Gender
έσωσαν	έσωσε	Number
γέλιο	γέλιου	Case
πρατηρίου	πρατηρίων	Number
μηχανολόγους	μηχανολόγοι	Case
παρακολουθούν	παρακολουθούσαν	Tense
φίμωσης	φίμωση	Case
δημοφιλείς	δημοφιλή	Number
θηλής	θηλών	Number
ακρίδα	ακρίδας	Case
μέλλοντες	μέλλοντας	Number
κλαδιά	μετεωρίτες	lemma
πιάτο	πιάτου	Case
βραδιών	βραδιές	Case
αιμοκάθαρσης	αιμοκάθαρση	Case
πήραμε	πήρα	Number
λανθάνουσα	λανθάνον	Gender
ορνιθολόγους	ορνιθολόγων	Case
κόνδυλο	κονδύλου	Case
προϊστορικό	προϊστορικά	Number
κηδεμόνες	κηδεμόνων	Case
γυρολόγοι	γυρολόγος	Number
μποδίζετε	μπόδιζε	Person
πεινασμένοι	πεινασμένος	Number
αποστάτισσα	αποστάτισσας	Case
διπλό	διπλή	Gender
συζητήσεις	συζητήσεων	Case
ανθρωπολογική	ανθρωπολογικέ	Gender
καράφας	καράφα	Case
ἀϊδνῆς	ἀϊδνήν	Case
φονιάδες	φονιά	Number
πυροβόλο	πυροβόλου	Case
αρχείων	αρχεία	Case
κουτά	κουτών	Case
ταχτικής	ταχτικών	Number
λωτό	λωτός	Case
μεταφραστικής	μεταφραστική	Case
πρωταγωνιστών	πρωταγωνιστές	Case
χαλαρότατες	χαλαρότατοι	Gender
αθυρόστομα	αθυρόστομους	Gender
προσδοκούσα	προσδοκούσε	Person
περίοδο	περιόδου	Case
αρχαγγέλου	αρχάγγελε	Case
σερβικά	σερβικό	Number
αγιορείτικου	αγιορείτικος	Case
ξενιστές	ξενιστών	Case
ηλεκτρομαγνητικό	ξύπνιο	lemma
αγανακτισμένο	αγανακτισμένου	Case
πρότυπα	πρότυπο	Number
ιέρακα	ιεράκων	Number
μουστακιών	μουστάκια	Case
πέμπτων	πέμπτες	Case
αριστοκρατικές	αριστοκρατικών	Case
κινήσεων	κινήσεις	Case
αλατούχες	αλατούχων	Case
ονειρολόγου	ονειρολόγος	Case
γραφείων	γραφεία	Case
κοσμοδρομίου	κοσμοδρόμιο	Case
υπουργικά	υπουργικές	Gender
ανταγωνισμών	ανταγωνισμοί	Case
βραχώδεις	βραχώδη	Gender
άγκυρες	αγκυρών	Case
βραδιές	βραδιά	Number
κατάδυσης	καταδύσεων	Number
ενοχλητικής	ενοχλητική	Case
ανεξέλεγκτο	ωριαίο	lemma
αγγαρείες	αγγαρεία	Number
αμφιβολίας	αμφιβολιών	Number
σωματικός	σωματική	Gender
ευαίσθητη	ευαίσθητο	Gender
εφηβείας	εφηβεία	Case
σαγηνεύαμε	σαγήνευα	Person
επικράτησαν	επικρατήσαμε	Person
εθνικισμό	εθνικισμός	Case
προγόνων	πρόγονοι	Case
μοχλού	μοχλός	Case
πιγκουίνου	πιγκουίνων	Number
πλειστόκαινοι	πλειστόκαινος	Number
ακτίδας	ακτίδων	Number
δημητριακά	δημητριακών	Case
δεινῷ	Ἰουδαϊκῷ	lemma
σουγιάδες	σουγιάς	Number
ανακρίσεις	ανάκριση	Number
ορδών	ορδές	Case
ισχυριστήκαμε	ισχυρίστηκες	Person
εγγράφων	έγγραφα	Case
εξάδελφο	εξαδέλφου	Case
διαμορφωνόσουν	διαμορφώνονταν	Person
γαλερών	γαλέρες	Case
νοσταλγούς	νοσταλγοί	Case
εποχή	εποχής	Case
εξατμίσεις	εξατμίσεων	Case
βιοχημικοί	βιοχημικούς	Case
αγριοράδικο	αγριοράδικου	Case
αζήτητων	αζήτητου	Number
βαλέδες	βαλές	Number
γυναικείες	γυναικεία	Gender
συνομοσπονδίες	συνομοσπονδία	Number
δημιουργούσες	δημιουργούσατε	Person
αιθέριο	Ἐμεσηνόν	lemma
πρωτεύουσας	πρωτεύουσα	Case
αγριόγαλου	αγριόγαλε	Case
συστατικών	συστατικού	Number
προσκόπους	προσκόπων	Case
λεπίδων	λεπίδες	Case
νευρώσεις	νευρώσεων	Case
μακελλάρηδων	μακελλάρηδες	Case
κολλούσε	κολλά	Tense
κουμπάροι	κουμπάρος	Number
αφτιού	αφτί	Case
αναδιοργανωθώ	συμπληρωθώ	lemma
γλυκαδιού	γλυκαδιών	Number
παιχνίδια	παιχνίδι	Number
αλευρόμυλους	αλευρόμυλων	Case
Μονεγάσκου	Μονεγάσκε	Case
πυρά	πυρ	Number
μώλου	μώλος	Case
νεποτισμού	νεποτισμός	Case
συστήνει	συστήνουν	Number
αβγουλούδες	αβγουλούδων	Case
εμπρησμών	εμπρησμοί	Case
αεροφωτογραφίες	μεταφορικά	lemma
βάσης	βάση	Case
αναζήτησε	αναζητάτε	Number
Αζέρων	Αζέρες	Case
δότες	δότης	Number
τραβήξαμε	τράβηξα	Person
επιτραπέζιας	επιτραπέζιων	Number
ἱκανῶν	ἱκανοῖς	Case
ελληνοαμερικάνος	ελληνοαμερικάνο	Case
ξεσκατωνόμαστε	ξεσκατωνόμασταν	Tense
μανταρίνι	μανταρινιού	Case
τριφύλλια	τριφύλλι	Number
κινεί	κινούσε	Tense
βηρύλλιο	βηρυλλίου	Case
ρύπου	ρύπων	Number
βούρλου	βούρλο	Case
διαβαίνει	διαβαίνουν	Person
σημείου	σημείο	Case
θαλαμηγοί	θαλαμηγών	Case
υποτελής	υποτελή	Case
ζυγούς	ζυγό	Number
οργανισμών	οργανισμοί	Case
ξάδελφο	ξάδελφος	Case
προσκόλληση	προσκόλλησης	Case
αλευρόμυλους	αλευρόμυλοι	Case
κατηγορούμαι	κατηγορούνται	Person
λουκάνικα	λουκάνικο	Number
αισθαντικότατα	νομιμότατα	lemma
ουρανό	ουρανός	Case
αλατερούς	αλατερές	Gender
αστρολογία	αστρολογίας	Case
παπαγάλων	παπαγάλοι	Case
παγόβουνου	παγόβουνων	Number
εκχιονιστήρα	εκχιονιστήρων	Number
πεντηκοστούς	πεντηκοστών	Case
παρατηρητηρίου	παρατηρητηρίων	Number
εκατοστού	εκατοστό	Case
τρίτου	τρίτων	Number
πρωκτό	πρωκτός	Case
αλκοολική	αλκοολικές	Number
ακρωτηριάζονταν	φώναζαν	lemma
εξέθετες	εκθέτατε	Number
ενθάρρυνσης	ενθάρρυνση	Case
βαρούμε	ταπεινωνόμαστε	lemma
διάστασης	διάσταση	Case
αντιμετωπίζουν	αντιμετωπίζω	Person
κατηγορούμενοι	κατηγορουμένους	Case
πλημμυρίδα	πλημμυρίδας	Case
αξιωματούχους	αξιωματούχοι	Case
ψευδάργυρο	ψευδάργυρε	Case
εξοχικό	τακτική	lemma
τοίχοι	τοίχος	Number
επαγωγή	επαγωγής	Case
ζέστες	ζέστη	Number
δυόσμο	δυόσμος	Case
πιστόνια	πιστόνι	Number
σπαθιών	σπαθιά	Case
λείψανο	λειψάνου	Case
αρπακτικά	αρπακτικές	Gender
ανάμιξη	ανάμιξης	Case
λυροπετεινού	λυροπετεινός	Case
ὑβριστικοῖν	ὑβριστικοῦ	Number
ετεροίωσης	ετεροιώσεων	Number
υγρό	υγρά	Number
ερωδιού	ερωδιών	Number
παρενόχλησης	παρενόχληση	Case
ημερολογιογράφε	ημερολογιογράφος	Case
αεροθαλάμων	αεροθάλαμοι	Case
μαρμότες	μαρμοτών	Case
φινλανδική	φινλανδικό	Gender
ανιχνευτών	ανιχνευτές	Case
σταυροφορίας	σταυροφοριών	Number
οπιδνοῦ	οπιδνόν	Case
βωμούς	βωμό	Number
γλυκών	μυδιών	lemma
άχυρων	άχυρα	Case
σκούντηξες	σκούντηξε	Person
μουεζίνη	μουεζίνηδων	Number
αορτές	αορτή	Number
φωνήεντος	φωνήεν	Case
λογείας	λογεία	Case
θάμνου	θάμνος	Case
τσάρο	τσάρος	Case
συμφώνησα	συμφώνησαν	Person
αρραβωνιαστικιά	αρραβωνιαστικιάς	Case
βαριών	βαριάς	Number
διαμεσολαβητές	διαμεσολαβητών	Case
ρινόκερο	ρινόκερου	Case
εγχείρισης	εγχείριση	Case
λεπτόνια	λεπτόνιο	Number
τροχαλίες	τροχαλιών	Case
κάνατε	κάναμε	Person
ρυθμούς	ρυθμοί	Case
αλκυόνας	αλκυόνα	Case
αέτωμα	αετώματος	Case
επιγραφών	επιγραφές	Case
μπιντόνια	μπιντόνι	Number
ιδιώτες	ιδιώτη	Number
εξηκοστέ	εξηκοστή	Gender
φακελακιών	φακελάκια	Case
φάγαμε	φάγατε	Person
κολοκύθες	κολοκύθα	Number
γκρίζα	γκρίζο	Number
σαπουνάδας	σαπουνάδων	Number
διεύρυναν	προτιμούσαν	lemma
σχίνοι	σχίνος	Number
βρείτε	βρες	Number
λουφάρατε	λούφαραν	Person
γατιών	γατιά	Case
σκάκι	σκακιού	Case
λεωφορείου	λεωφορείων	Number
ακατάλληλη	ακατάλληλες	Number
αδαμάντινος	αδαμάντινη	Gender
Ανγκολέζο	Ανγκολέζου	Case
αριστερά	στυπτικᾰ́	lemma
υπογράμμισης	υπογράμμιση	Case
πεζού	πεζό	Case
μπαμπουίνοι	μπαμπουίνους	Case
ακατάλληλης	ακατάλληλου	Gender
φυτίλια	φυτιλιών	Case
μισθώνομαι	μισθώνονται	Person
συνήθειας	συνηθειών	Number
φορτίου	φορτίων	Number
ανυπεράσπιστα	ταλαιπωρικᾰ́	lemma
συνουσίας	συνουσία	Case
βασίλειοι	βασίλειαι	Gender
παλαιώ	ὀπτικώ	lemma
ναρκομανές	ναρκομανή	Number
οικιακό	οικιακά	Number
συγχορδίες	συγχορδιών	Case
περιστεριώνες	περιστεριώνα	Number
σημάτων	σήματα	Case
αλφαβήτων	αλφάβητα	Case
αισθαντικότατος	νομιμότατος	lemma
λείος	λείου	Case
δοκιμάσατε	δοκίμασα	Person
αστυνόμο	αστυνόμος	Case
ιδανικό	φρέσκο	lemma
αβγούλια	αβγουλιών	Case
ηλεκτρομαγνητικού	ηλεκτρομαγνητικό	Case
άσους	άσων	Case
οπλών	οπλές	Case
διάθλαση	διάθλασης	Case
επιχειρησιακά	επιχειρησιακές	Gender
παντελόνι	παντελονιού	Case
αισθησιασμό	αισθησιασμού	Case
εμβόλισε	συνάντησε	lemma
κονσόλα	κονσόλας	Case
απαγχονισμούς	απαγχονισμοί	Case
αξιωματικούς	αξιωματικών	Case
μαχαίρες	μαχαίρα	Number
φίλησα	φίλησαν	Person
απελπισία	απελπισίας	Case
εξόπλισε	προστάτευσε	lemma
απονομές	απονομή	Number
βιόλα	μαντήλι	lemma
αδικήθηκε	αδικηθήκατε	Person
ραδιενέργεια	ραδιενέργειας	Case
διαβάστε	διάβασε	Person
βουλγαρικό	βουλγαρικός	Case
αχτίδες	αχτίδα	Number
καυκασιανών	καυκασιανές	Case
σπαθιού	σπαθί	Case
λιόδεντρου	λιόδεντρο	Case
αβοκέτες	αβοκέτα	Number
φύσεις	φύση	Number
τρισδιάστατοι	τρισδιάστατος	Number
σκαμνιά	σκαμνί	Number
βοσκόπουλου	βοσκόπουλο	Case
οριζόντιο	οριζόντιος	Case
μονομερείς	μονομερών	Case
εξολόθρευση	εξολόθρευσης	Case
ευρωπαϊκούς	ευρωπαϊκό	Number
βομβαρδιστικά	βομβαρδιστικό	Number
ταπετσαριών	ταπετσαρίες	Case
επίγειων	επίγεια	Case
ανυπεράσπιστων	ανυπεράσπιστα	Case
καινοζωικό	καινοζωικού	Case
αεροπλανοφόρα	αεροπλανοφόρων	Case
ερπετού	ερπετό	Case
αστερισμών	αστερισμοί	Case
Ουκρανές	Ουκρανών	Case
παραστάσεις	παραστάσεων	Case
είχες	παρεισέφρεες	lemma
τραύμα	τραύματος	Case
πολικού	πολικός	Case
χούφτες	χούφτα	Number
αναλγητικό	αναλγητικέ	Case
κυρτό	κυρτή	Gender
περιβόλους	περίβολο	Number
άρχισα	αρχίσατε	Person
εμπορεύσιμοι	εμπορεύσιμους	Case
ορεκτικό	ορεκτικού	Case
υψωμάτων	υψώματα	Case
παραδίνεται	παραδίνονται	Number
στέλνετε	στέλνει	Person
χτυπούν	χτυπούσαν	Tense
γεωργοκτηνοτρόφους	γεωργοκτηνοτρόφο	Number
λατομείο	λατομείου	Case
δημοσιογράφοι	δημοσιογράφους	Case
φλοιούς	φλοιό	Number
εξουσιοδότηση	εξουσιοδότησης	Case
γοεδνῇ	ψυχικῇ	lemma
τακτικής	τακτικών	Number
κρυστάλλου	κρυστάλλων	Number
πάστορα	πάστορας	Case
αλγορίθμου	αλγόριθμος	Case
Κολομβιανοί	Κολομβιανός	Number
πρόεδρο	πρόεδρου	Case
αποκαλύψεις	αποκάλυψη	Number
υπογράφει	υπέγραφε	Tense
αγρότη	αγρότης	Case
αδιάφορη	αδιάφορες	Number
αἰωνίοιν	τραυμᾰτῐκοῖν	lemma
σπουργίτη	σπουργιτών	Number
κούφιες	κούφια	Gender
απρόοπτο	απρόοπτου	Case
λιβεριανός	λιβεριανοί	Number
κόπο	κόπος	Case
δουλεύεις	δουλεύετε	Person
αποβάθρες	αποβαθρών	Case
λαχανόκηποι	λαχανόκηπος	Number
σαγανιού	σαγάνι	Case
λογιστικώ	λογιστικοῖν	Case
οχταπόδια	οχταπόδι	Number
συμβολαιογράφους	συμβολαιογράφων	Case
μπαστούνια	μπαστούνι	Number
βοδιών	βόδια	Case
πευκέδαναιν	ὑποθετικαῖν	lemma
αιχμές	αιχμή	Number
ευρά	ευρό	Number
αιμομίκτες	αιμομίκτης	Number
δυσκολότερα	σφοδρότερα	lemma
κουραζόμασταν	κουραζόταν	Person
βλήματος	βλήμα	Case
αστρολόγους	αστρολόγο	Number
ορφανό	ορφανά	Number
εισροές	εισροή	Number
σχέσεων	σχέσεις	Case
ορχιδέες	ορχιδέων	Case
ανθρωποειδές	ανθρωποειδή	Number
προϊόντος	προϊόν	Case
παρουσιαστές	παρουσιαστή	Number
ηλεκτροχημεία	σύνθεση	lemma
ελάτου	ελάτων	Number
αβιομηχανοποίητους	αβιομηχανοποίητοι	Case
κελαηδούσαν	κελαηδούσες	Person
Μεσοπροτεροζωικό	Μεσοπροτεροζωικού	Case
αέριας	αέριου	Gender
άμπελος	παράνοια	lemma
ικανότητας	ικανότητα	Case
τραυμάτισες	τραυματίσατε	Person
αρπακτικού	αρπακτικό	Case
χρήσης	χρήσεων	Number
ξενοδοχειακό	ξενοδοχειακή	Gender
ξύπνησε	ξύπνησα	Person
επιστήμονα	επιστημόνων	Number
οπλίτες	οπλίτης	Number
τύλιγε	τυλίξτε	Person
μεταβιβάσεις	μεταβιβάσεων	Case
συνεργάσιμο	συνεργάσιμου	Case
καταδίκους	κατάδικοι	Case
γίδια	γίδι	Number
εράνους	εράνων	Case
ελπίδας	ελπίδα	Case
κενυατικό	κενυατικά	Number
ουρές	ουρών	Case
παράλογος	παράλογε	Case
γκρεμό	γκρεμός	Case
ζωγραφίσαμε	ζωγράφισες	Person
κυκλώνα	κυκλώνων	Number
τελείωσα	τελειώσατε	Person
δίγλωσσων	δίγλωσσες	Case
πενών	πένες	Case
πυρκαγιές	πυρκαγιά	Number
αεράμυνα	αεράμυνας	Case
θανατικόν	θανατικῷ	Case
διασπούσαν	διασπούν	Tense
φυσούσες	φυσούσαμε	Person
πτηνού	πτηνό	Case
επισημότερη	επισημότερες	Number
μάραθο	μάραθου	Case
σχέσεις	σχέσεων	Case
σεβασμούς	σεβασμών	Case
εμποροπανηγύρεις	εμποροπανήγυρη	Number
φωνογράφο	φωνογράφος	Case
νεροβούβαλο	νεροβούβαλε	Case
αγαλματίου	αγαλματίων	Number
κουκλοθεάτρου	κουκλοθέατρο	Case
λίμας	λιμών	Number
ναζισμό	ναζισμού	Case
Τσεχοσλοβάκες	Τσεχοσλοβάκα	Number
ισχυριστεί	ισχυριστείς	Person
φυλετικέ	φυλετικό	Case
ζητούσαμε	ζητούσα	Person
σαπουνόπερας	σαπουνόπερα	Case
περιμέτρους	περίμετρο	Number
ορνιθολόγοι	ορνιθολόγος	Number
αποκεφαλιστήκατε	αποκεφαλίστηκα	Person
βρίσκατε	έβρισκες	Number
στενή	στενές	Number
ψεύτη	ψεύτης	Case
απόλυτες	απόλυτα	Gender
δεινόσαυρων	δεινόσαυροι	Case
ᾰ̓φαιρετῐκᾱ́ς	ᾰ̓φαιρετῐκᾰ́	Gender
διασκεδαστές	διασκεδαστή	Number
μιναρέ	μιναρές	Case
ήχοι	ήχους	Case
αμμόλοφους	αμμόλοφοι	Case
βελονόουρες	παστές	lemma
τηλεφωνούσε	τηλεφωνεί	Tense
ταινιογραφίες	ταινιογραφιών	Case
πεζό	πεζή	Gender
ανθρωπολόγο	ανθρωπολόγος	Case
νηστικούς	νηστικές	Gender
σωλήνωσης	σωληνώσεων	Number
συγγραφέων	συγγραφείς	Case
αβγουλάτου	αβγουλάτο	Case
εκτάσεις	εκτάσεων	Case
αεροπόρο	αεροπόρε	Case
ιπποπόταμους	ιπποπόταμοι	Case
τεκνών	τεκνά	Case
κουτάλες	κουτάλα	Number
επιθετικότατης	τολμηρότατης	lemma
λαχανόκηποι	λαχανόκηπους	Case
ροής	ροών	Number
απέμεινες	απομείναμε	Person
γονάτου	γονάτων	Number
ανελκυστήρα	ανελκυστήρας	Case
δηλώνει	δηλώνετε	Person
γυροσκοπίου	γυροσκόπιο	Case
πολλαπλασιασμούς	πολλαπλασιασμό	Number
καρτερούσα	καρτερούσαμε	Number
προϋπολογισμών	προϋπολογισμοί	Case
τελευταίους	τελευταίοι	Case
Αθιγγανίδες	Αθιγγανίδα	Number
υπόνοιας	υπονοιών	Number
λευκορωσικός	λευκορωσικό	Case
κοκκινοχρυσού	κοκκινοχρυσών	Number
αμνό	αμνός	Case
υπερήπειροι	υπερήπειρος	Number
αγγλόφιλος	αγγλόφιλη	Gender
λίμπρες	λίμπρα	Number
ποδηλατόδρομων	ποδηλατόδρομοι	Case
εξολοθρεύει	εξολοθρεύω	Person
δεδικασμένου	δεδικασμένων	Number
λεμονιού	λεμονιών	Number
αλυσοπρίονου	αλυσοπρίονων	Number
στρεπτοκοκκικός	στρεπτοκοκκικό	Case
αγκωνιαστώ	αγκωνιαστείτε	Person
κατάφερα	κατάφεραν	Person
υφής	υφή	Case
κωμωδίας	κωμωδία	Case
Δανό	Δανέ	Case
απόπατους	απόπατοι	Case
ημερολογιακή	ημερολογιακές	Number
απορίες	αποριών	Case
σύκο	σύκου	Case
αβάσκαντος	αβάσκαντο	Gender
μαροκινών	μαροκινούς	Case
γλυκεῖαι	γλυκείαις	Case
λακωνικές	λακωνικών	Case
χάλυβα	χάλυβας	Case
νυφίτσας	νυφίτσα	Case
πορφυρές	πορφυρή	Number
αθερινών	αθερίνες	Case
κολοκυθιές	κολοκυθιών	Case
κιλά	κιλό	Number
βόγκηξαν	βογκήξαμε	Person
αἰσθητικοί	αἰσθητικᾰ́	Gender
φωτογράφου	φωτογράφος	Case
συνεργασίες	συνεργασιών	Case
κεφαλαριών	κεφαλάρια	Case
αντικαταθλιπτικά	αντικαταθλιπτικών	Case
αεροδιαδρόμου	αεροδιάδρομος	Case
ισημερινό	ισημερινός	Case
πυραύλους	πύραυλοι	Case
χαλασμένες	χαλασμένων	Case
αβομβάρδιστοι	αβομβάρδιστους	Case
ευρετηρίου	ευρετήριο	Case
προσκυνητών	προσκυνητές	Case
αιθιοπικής	αιθιοπικών	Number
ελέγχετε	ελέγχω	Person
μεγάκυκλοι	μεγακύκλους	Case
κοτόπουλου	κοτόπουλων	Number
πιγκουίνο	πιγκουίνος	Case
αυταρχικότητας	αυταρχικότητα	Case
ριζοσπάστη	ριζοσπαστών	Number
αιχμές	αιχμών	Case
μοναστικοί	μοναστικά	Gender
φοράμε	φοράνε	Person
ιόν	ιόντος	Case
άτλαντα	άτλας	Case
εντροπίας	εντροπιών	Number
οροσειρές	οροσειρών	Case
σύντεχνο	σύντεχνε	Case
δυόσμο	δυόσμου	Case
γκλίτσες	γκλίτσα	Number
στατιστικές	στατιστικοί	Gender
τάγματα	ταγμάτων	Case
συναθροίσεων	συναθροίσεις	Case
παίχτες	παιχτών	Case
οικονομίες	οικονομία	Number
πελατών	πελάτες	Case
λαχανίδες	λαχανιδών	Case
φλοιό	φλοιός	Case
εὐθείᾳ	οπιδνῇ	lemma
σεμινάριο	σεμινάριου	Case
γιαουρτιού	γιαούρτι	Case
στρατόσφαιρα	στρατόσφαιρας	Case
παπαδιά	παπαδιάς	Case
δημαρχεία	δημαρχείο	Number
αλατένια	αλατένιας	Case
νερόμυλου	νερόμυλος	Case
μεθοδολογίες	μεθοδολογιών	Case
τραπεζίου	τραπέζιο	Case
υπέρβαρο	υπέρβαρος	Case
εθνικιστική	εθνικιστικής	Case
εκτελεστές	εκτελεστή	Number
βαλκανικά	βαλκανικοί	Gender
τουρκικές	τουρκική	Number
πωλούσε	πωλούσαν	Person
ημίθεους	ημίθεων	Case
νιώθαμε	ένιωθα	Person
βοήθειες	βοήθεια	Number
σφάλματος	σφάλμα	Case
Χριστιᾱνῐκᾱ́	Χριστιᾱνῐκή	Number
κουράγιο	κουράγιου	Case
μούσες	μουσών	Case
θράκες	θράκα	Number
ύττριο	υττρίου	Case
εκδίδουν	πουλούν	lemma
νεολογισμό	νεολογισμού	Case
φθηνό	φθηνή	Gender
ρούμια	ρούμι	Number
επιτρέπατε	επιτρέπετε	Tense
ανακαινιστεί	οριστεί	lemma
φωτιές	φωτιών	Case
μεταφραστές	μεταφραστής	Number
έκτρωση	έκτρωσης	Case
βαρόνους	βαρόνο	Number
βαρήκοος	βαρήκοη	Gender
γυμναστριών	γυμνάστριες	Case
παντοτινέ	παντοτινού	Case
ουλίτιδα	ουλίτιδας	Case
βιβλιοθηκάριοι	βιβλιοθηκάριους	Case
λεκέδες	λεκέ	Number
πατά	πατούσε	Tense
σιωπηρή	σιωπηρό	Gender
τηλεφώνησε	τηλεφωνείτε	Number
έκπτωσης	έκπτωση	Case
οπαδού	οπαδέ	Case
καρδινάλιοι	καρδιναλίους	Case
εναλλάκτη	εναλλάκτης	Case
αγάπισα	αγαπίσαμε	Person
αποστασίας	αποστασία	Case
τσικνιάδες	τσικνιάδων	Case
όνε	όνος	Case
βαρετό	βαρετή	Gender
δηλώνει	δηλώνουν	Number
ακηλίδωτων	στροφικῶν	lemma
στραβώνεσαι	στραβωνόσουν	Tense
διαμέρισμα	διαμερίσματος	Case
φιλανθρωπίες	φιλανθρωπία	Number
ρολών	ρολά	Case
αλλεργίας	αλλεργία	Case
αθλητικού	ξινού	lemma
δημοπρασίες	δημοπρασιών	Case
αγέραστα	αγέραστες	Gender
αρκούδες	αρκούδα	Number
ανάγγειλε	πληρώθηκε	lemma
ξύρισμα	ξυρίσματος	Case
προσανατολισμοί	προσανατολισμός	Number
αυστραλιανά	αυστραλιανών	Case
ευαίσθητο	ευαίσθητου	Case
υπερχείλισης	υπερχειλίσεων	Number
ιερομόναχοι	ιερομονάχων	Case
ερυθρό	ερυθρέ	Case
πλημμυρίσαμε	πλημμύρισα	Person
ξεχνούσατε	ξεχνούσες	Person
ακολουθήθηκαν	φωσφόρισαν	lemma
φαγώσιμα	φαγώσιμο	Number
ρούφηξε	ρούφηξαν	Person
πεποιθήσεις	πεποιθήσεων	Case
τούβλων	τούβλα	Case
χρειάστηκαν	χρειάστηκε	Person
γενναίους	πατροκτόνους	lemma
άρεσε	αρέσει	Tense
αγγειεκτομές	αγγειεκτομών	Case
κωμωδίας	κωμωδιών	Number
αερογραμμές	αερογραμμή	Number
μάρσιποι	μαρσίπους	Case
εκβιασμούς	εκβιασμό	Number
γλωσσικών	παρισινών	lemma
γλωσσών	γλώσσες	Case
επικρατώντας	ξεχέζοντας	lemma
σκεύη	σκευών	Case
σπηλιών	σπηλιές	Case
διασκεδαστών	διασκεδαστές	Case
ιδιότητας	ιδιότητα	Case
ανθρωπολογικές	ανθρωπολογικοί	Gender
τζάμια	τζαμιών	Case
κόμπους	κόμπων	Case
κληρονόμο	κληρονόμε	Case
έγερση	έγερσης	Case
γαμήσια	γαμησιών	Case
παιδαγωγικαί	παιδαγωγικᾱ́ς	Case
δραματουργούς	δραματουργών	Case
λιθόστρωτο	λιθόστρωτα	Number
γαβγίζει	γαβγίζουν	Person
τοποθετεί	τοποθετούν	Number
εύζωνοι	ευζώνων	Case
μπαλέτα	μπαλέτο	Number
δεκαετιών	δεκαετίες	Case
δωδεκαδάκτυλο	δωδεκαδακτύλου	Case
πρακτικές	πρακτικών	Case
ακριβότερη	οξύτερη	lemma
αεροπόρο	αεροπόρου	Case
ανενεργού	μαγνητικής	lemma
πίτες	πίτα	Number
ακόρεστο	κατηχητικόν	lemma
κτιρίων	κτίρια	Case
αστέρες	αστέρας	Number
αντιστάσεις	αντιστάσεων	Case
αίσια	αίσιο	Number
σάμπα	σάμπας	Case
ανέκδοτου	ανέκδοτων	Number
αγιογράφο	αγιογράφε	Case
κελύφους	κέλυφος	Case
δαχτύλου	δάχτυλο	Case
ξαλμύριζαν	ξαλμυρίζατε	Person
Σενεγαλέζο	Σενεγαλέζε	Case
κλίμακες	κλίμακα	Number
σκοπεύουν	σκοπεύω	Person
εχθροπραξίες	εχθροπραξιών	Case
βαρούσαμε	πετούσαμε	lemma
κάννες	πυροβόλα	lemma
επιστολής	επιστολή	Case
αποκλείω	αποκλείουμε	Person
νικητήριου	νικητήριο	Case
στόκους	στόκων	Case
υποδοχής	υποδοχών	Number
αφήναμε	άφηνα	Number
ταχυδρομικούς	ταχυδρομικές	Gender
περιορισμένοι	περιορισμένα	Gender
αψιθιά	αψιθιάς	Case
αβέλτεροι	χλωμοί	lemma
βιβλιόφιλων	βιβλιόφιλοι	Case
ζητούσα	ζητούσαν	Person
ρήσης	ρήση	Case
κουρείο	κουρείου	Case
αρχιδούκες	αρχιδούκα	Number
επτάχρονο	φτωχικό	lemma
περιηγητές	περιηγητών	Case
χαθούν	χαθείς	Person
κόμπο	κόμπος	Case
αγαπημένες	αγαπημένων	Case
λαχανόκηπους	λαχανόκηπο	Number
μαγειρέψαμε	μαγείρεψες	Person
φιστίκια	φιστικιών	Case
ασπράδι	ασπραδιού	Case
παππούδες	παππού	Number
έρωντα	ερώντων	Number
επέβαλλε	επέβαλλες	Person
φωτόνια	φωτόνιο	Number
δυσκόλευες	δυσκόλευε	Person
μελανοκυττάρου	μελανοκύτταρο	Case
μανόν	μανῷ	Case
κάθετε	κάθετο	Gender
παραμέτρου	παράμετρος	Case
απελπιστήκατε	απελπίστηκες	Number
ο	ου	Case
νομισματοκοπείο	νομισματοκοπείου	Case
νυχτερινής	νυχτερινού	Gender
σιροπιού	σιρόπι	Case
σπηλιές	σπηλιών	Case
σταθεράς	σταθερών	Number
Βρεττανών	Βρεττανές	Case
ψαλίδια	ψαλιδιών	Case
μπαλαδόροι	μπαλαδόρων	Case
Βιενέζους	Βιενέζο	Number
φλόγες	φλογών	Case
λογοκριτές	λογοκριτή	Number
ασθματικά	ασθματικοί	Gender
απαντήσατε	απάντησες	Person
επισκέπτες	επισκεπτών	Case
σεξουαλικότητας	σεξουαλικότητα	Case
εξωγήϊνων	εξωγήϊνα	Case
ντομάτα	ντομάτας	Case
αιθιοπικοί	αιθιοπικέ	Number
ψαλτήρια	ψαλτήριο	Number
σκιάχτρα	σκιάχτρο	Number
σταθήκατε	στάθηκες	Person
πολιτισμών	πολιτισμοί	Case
πολιούχο	πολιούχου	Case
βαρόνου	βαρόνε	Case
εμπορία	εμπορίας	Case
χρηματίζει	χρηματίζετε	Person
κομμουνιστές	κομμουνιστών	Case
μονολίθου	μονόλιθε	Case
νομαρχών	νομάρχες	Case
εκπαιδεύετε	εκπαιδεύω	Person
τσακωμούς	τσακωμοί	Case
αστυνομίας	αστυνομία	Case
αναγνωρίζαμε	αναγνώριζαν	Person
διεπαφών	διεπαφές	Case
απότομου	κυκλικού	lemma
εγκολπωνόμαστε	εγκολπώνομαι	Person
γλέντησε	κελάιδα	lemma
μυστηριώδης	μυστηριώδη	Case
απολάμβανες	απολάμβανε	Person
διασημότερου	στενότερου	lemma
οδηγούς	οδηγοί	Case
επίσκοποι	επίσκοπος	Number
χαιρετισμοί	χαιρετισμός	Number
κούκων	κούκοι	Case
μπούφο	μπούφος	Case
συνδρομήτριας	συνδρομητριών	Number
κείμενα	κείμενο	Number
συντήρηση	συντήρησης	Case
αδιάλυτος	αδιάλυτου	Case
αγριοκοιταχτούμε	αγριοκοιταχτεί	Person
παιχνιδιάρηδες	παιχνιδιάρικα	Gender
ξύλινα	ξύλινων	Case
καταχώρισης	καταχωρίσεων	Number
ακμαίες	ακμαία	Number
ακέφαλου	ακέφαλο	Case
γραφίτη	τρομοκράτη	lemma
άνεμοι	άνεμος	Number
απεργίες	απεργιών	Case
ακανόνιστη	ακανόνιστο	Gender
ηλιοστασίου	ηλιοστασίων	Number
πλεονεκτημάτων	πλεονεκτήματα	Case
αγνάντια	αγνάντιων	Case
αναχώματος	αναχωμάτων	Number
κατάγματος	κάταγμα	Case
σαλιγκάρια	σαλιγκαριών	Case
έφοροι	εφόρους	Case
σκεφτικής	σκεφτικών	Number
υπαρξιστή	υπαρξιστών	Number
διαστημοπλοίων	διαστημόπλοια	Case
αναφέρουμε	αναφέρει	Person
βιολοντσέλου	βιολοντσέλο	Case
σεισμικό	σεισμικού	Case
επισκόπου	επισκόπων	Number
ανόδων	άνοδοι	Case
πετρώματα	πέτρωμα	Number
τερματίζει	τερματίζουν	Number
θερμοσίφωνα	θερμοσίφωνας	Case
φαντασιώσεις	φαντασιώσεων	Case
απογειώσεις	απογείωση	Number
αδελφάτων	αδελφάτα	Case
σύνθεση	σύνθεσης	Case
ανακάλυψης	ανακάλυψη	Case
λειτουργοί	λειτουργών	Case
επιτραπέζια	επιτραπέζιο	Gender
συναινετικής	συναινετική	Case
βασικότατα	σιωπηλότατα	lemma
ρουμανικου	ρουμανικων	Number
Κινέζου	Κινέζων	Number
γαρύφαλλων	γαρύφαλλα	Case
μορφωτικές	μορφωτική	Number
δημοσίευσε	πρόφτασε	lemma
λησμονιά	λησμονιάς	Case
στενό	στενά	Number
δένεται	δένεστε	Person
βεβαιότατο	βεβαιότατη	Gender
βαστάς	πασπαλίζεσαι	lemma
ακαταλληλότητα	ακαταλληλότητας	Case
προφορικών	προφορικές	Case
γλυκόριζα	γλυκόριζας	Case
περιηγήσεις	περιηγήσεων	Case
ενοχλείς	ενοχλώ	Person
υποκοριστικού	υποκοριστικών	Number
αγίες	αγίων	Case
καθολικό	καθολικά	Number
ισοζυγίου	ισοζύγιο	Case
διαδικασίες	διαδικασιών	Case
ανθοκόμου	ανθοκόμε	Case
πέθανε	πέθαναν	Person
ακτές	ακτών	Case
νομικές	νομικά	Gender
αύξαναν	αυξάνουν	Tense
αναγραμματισμό	αναγραμματισμέ	Case
Ἰουδαϊκᾰ́	Ἰουδαϊκώ	Number
βλαστοί	βλαστούς	Case
αγριοκοιτάχτηκα	ταρίχευσα	lemma
κρυστάλλων	κρύσταλλα	Case
κτηρίων	κτήρια	Case
αιματώματος	αιματωμάτων	Number
ερμήνευε	ερμηνεύαμε	Person
πεύκου	πεύκων	Number
αρχής	αρχή	Case
κυπριακή	κυπριακό	Gender
επιβάτες	επιβάτη	Number
συζητήσεων	συζητήσεις	Case
οδηγούσε	οδηγεί	Tense
τοκογλύφοι	τοκογλύφους	Case
αγριόγατας	αγριόγατα	Case
επηρεαστούν	επηρεαστείτε	Person
ακαθάριστων	ακαθάριστου	Number
καμαρών	κάμαρες	Case
ύαλο	ύαλε	Case
βιαστή	βιαστής	Case
αριστοκρατικότατων	προσεκτικότατων	lemma
αγγειακά	αγγειακές	Gender
έχω	περιορίζομαι	lemma
διττώ	ψεδνώ	lemma
επιχειρηματία	επιχειρηματίας	Case
λίρας	λίρα	Case
ανελκυστήρες	ανελκυστήρας	Number
χρυσάνθεμο	χρυσάνθεμου	Case
κρυφού	κρυφών	Number
κρεατοφάγο	κρεατοφάγε	Case
αιμοβόρο	αιμοβόρου	Case
ακόρεστες	ακόρεστα	Gender
βελονιών	βελονιές	Case
κρημνό	κρημνός	Case
διαστημόπλοια	διαστημόπλοιο	Number
αποξενωνόσουν	ξεψυχούσες	lemma
τιμιότερων	τιμιότερα	Case
μαξιλάρι	μαξιλαριού	Case
προχείρου	προχείρων	Number
Αρμένιες	Αρμένια	Number
συνεργούς	συνεργών	Case
καζίνου	καζίνο	Case
επιθυμίες	επιθυμία	Number
εξωτικού	εξωτικό	Case
αστυνόμους	αστυνόμοι	Case
πορνογραφικά	πορνογραφικές	Gender
ηφαίστεια	ηφαίστειο	Number
επανορθώσεις	επανόρθωση	Number
Λουξεμβουργιανό	Λουξεμβουργιανού	Case
κρατούμενοι	κρατούμενος	Number
ομολογητές	ομολογητών	Case
άνοιας	ανοιών	Number
δημοτικά	δημοτικό	Number
γερμανικά	γερμανικών	Case
οθωμανικό	οθωμανικά	Number
επανορθώσεων	επανορθώσεις	Case
λιβάδια	λιβαδιών	Case
αλλοιωθήκαμε	αλλοιωθούμε	Tense
ισημερινής	ισημερινή	Case
γόνατα	γονάτων	Case
αποστάσεων	αποστάσεις	Case
μοσχάρι	μοσχαριού	Case
φιλοσοφικών	φιλοσοφικά	Case
μεσημβρινό	μεσημβρινή	Gender
μπότες	μπότα	Number
ειρήνη	ειρήνης	Case
όφελος	οφέλους	Case
μασκών	μάσκες	Case
αγρυπνιών	αγρυπνίες	Case
αστυνομίες	αστυνομία	Number
εμετού	εμετός	Case
βιαστικό	βιαστικά	Number
αγανάχτησε	αγανάχτησα	Person
εξασκήσεις	εξασκήσεων	Case
μπαστουνιού	μπαστουνιών	Number
διαλύματα	διαλυμάτων	Case
φακίδας	φακίδα	Case
βελανιδιών	βελανιδιές	Case
κουδουνιού	κουδουνιών	Number
πεθάνετε	πέθανε	Number
αμερόληπτου	αμερόληπτο	Case
παγκόσμιες	παγκόσμιων	Case
ερωμένης	ερωμένων	Number
έριδες	έριδα	Number
έγγραφο	υπαίθριο	lemma
γοργοῖν	γοργοῖς	Number
θείων	θείες	Case
ωκεανοί	ωκεανός	Number
αναμνηστικός	πεινασμένος	lemma
τμήματα	τμημάτων	Case
αγροτικό	αγροτική	Gender
κορώνας	κορωνών	Number
πιτσαδόρους	πιτσαδόροι	Case
γλυπτού	γλυπτό	Case
μεταγλωττιστών	μεταγλωττιστές	Case
ἄρτιος	ἄρτιε	Case
θρυμμάτισα	θρυμματίσατε	Person
ανιψιό	ανιψιός	Case
συνεχές	συνεχή	Gender
αναζητάμε	αναζητάτε	Person
περιστεριώνες	περιστεριώνων	Case
κουταλιού	κουτάλι	Case
κουρεύει	κουρεύουν	Person
λεϊμονιών	λεϊμόνια	Case
ανεμόμυλου	ανεμόμυλων	Number
προσθετικώ	ὁμολογητῐκώ	lemma
ικανότατος	χλιαρότατος	lemma
περιστασιακή	περιστασιακέ	Gender
διαιτητές	διαιτητή	Number
Μανιάτισσας	Μανιάτισσα	Case
σκευοθήκη	σκευοθήκης	Case
οραγκουτάγκοι	οραγκουτάγκων	Case
εκκρεμές	εκκρεμούς	Case
τηλεγραφημάτων	τηλεγραφήματα	Case
όχλου	όχλος	Case
φώκιας	φώκια	Case
κουνουπιών	κουνούπια	Case
ενώθηκα	ενωθήκαμε	Person
αρειανού	αρειανής	Gender
διασποράς	διασπορών	Number
μεσημεριανού	μεσημεριανό	Case
εντάλματα	κοτόπουλα	lemma
υπεροχή	υπεροχής	Case
παραμεριστήκατε	παραμερίστηκα	Person
κηδείες	κηδεία	Number
προσόντος	προσόν	Case
πανσέλινοι	πανσελίνους	Case
γροθιά	πυρομαχικά	lemma
αγέρινοι	αγέρινες	Gender
κυδώνια	κυδώνι	Number
αυτόχειρα	αυτόχειρας	Case
τραβά	τραβούμε	Person
φίλαθλη	φίλαθλες	Number
ανταγωνισμούς	ανταγωνισμών	Case
μακροκαταστάσεων	μακροκαταστάσεις	Case
ερμήνευαν	ερμηνεύαμε	Person
ρωτούσαν	ρωτούσες	Person
διαφθορών	διαφθορές	Case
μοναστικούς	μοναστικό	Number
δυσκολότερη	σφοδρότερη	lemma
ελαφρύτερο	σχετικότερο	lemma
γρύλους	γρύλων	Case
πυρηνικοί	πυρηνικέ	Number
λέμβοι	λέμβο	Number
περίστασης	περιστάσεων	Number
εκατόνταρχο	εκατόνταρχου	Case
σαρωτών	σαρωτές	Case
στενών	στενού	Number
προγνώσεις	προγνώσεων	Case
προσπάθειας	προσπάθεια	Case
σοδειές	σοδειών	Case
χημικούς	χημικοί	Case
μέλλοντες	μελλόντων	Case
μαφιόζικος	μαφιόζικο	Case
αγαθά	αγαθό	Number
ετοιμότατοι	λαμπρότατοι	lemma
τραγουδιών	τραγούδια	Case
λιπόθυμη	λιπόθυμο	Gender
ευνούχους	ευνούχων	Case
είχα	είχαμε	Person
ενοχής	ενοχή	Case
επεξεργασιών	επεξεργασίες	Case
άλειψες	αλείψαμε	Person
μελλοντικά	μελλοντικές	Gender
αντιμετωπιστεί	αντιμετωπιστούν	Number
ενδιαφερόντων	ενδιαφέροντα	Case
ηρεμία	ηρεμίας	Case
προσώπου	προσώπων	Number
διαδρόμων	διάδρομοι	Case
βαθέε	ἐπενθετικώ	lemma
υπνοβάτες	υπνοβάτης	Number
μπουκάλας	μπουκάλα	Case
επιδημίες	επιδημιών	Case
πολύτιμα	πολύτιμες	Gender
αλευρόμυλων	αλευρόμυλοι	Case
σχεδιαστές	σχεδιαστών	Case
αστρολάβοι	αστρολάβος	Number
κατέβει	πλάσει	lemma
τσιγγάνο	τσιγγάνε	Case
συστρατιώτη	συστρατιωτών	Number
Νορβηγού	Νορβηγός	Case
γραπτά	γραπτό	Number
συμπεθερέψτε	συμπεθέρευε	Number
φωτοστέφανου	φωτοστέφανο	Case
απαντούσατε	απαντούσαμε	Person
ναζιάρες	ναζιάρα	Number
μαρμαρέα	χθαμαλᾱ́	lemma
αναζωογονήθηκαν	αναζωογονήθηκε	Person
βιασμούς	βιασμό	Number
φούρνο	φούρνος	Case
νοσοκόμοι	νοσοκόμων	Case
μάγισσες	μαγισσών	Case
σταυροφορίας	σταυροφορία	Case
λωτούς	λωτοί	Case
πρωτόγονων	πρωτόγονα	Case
ενυδρίδας	ενυδρίδα	Case
αναλώνονται	αναλώνεται	Number
αβγατίζει	αβγατίζουν	Person
Μακεδονικᾱ́	φαλᾱ́	lemma
εργαστήρι	λέσχη	lemma
δεσποινίδα	δεσποινίδας	Case
απορίας	αποριών	Number
αβασταγές	πολλαπλασιασμοί	lemma
προϋπολογισμέ	προϋπολογισμός	Case
προσευχών	προσευχές	Case
ανακτήσεων	ανακτήσεις	Case
συζήτησης	συζήτηση	Case
άθεοι	άθεα	Gender
εχθρούς	εχθρό	Number
Σέρβο	Σέρβου	Case
σανατορίου	σανατορίων	Number
όρκου	όρκος	Case
προσβλητικής	προσβλητική	Case
βασιβουζούκοι	βασιβουζούκος	Number
ψιθύρους	ψιθύρων	Case
ροδάκινων	ροδάκινα	Case
εμίρηδες	εμίρης	Number
γραπτού	γραπτών	Number
βλεφάρου	βλέφαρο	Case
διαρροές	διαρροή	Number
γαλβανισμένους	γαλβανισμένες	Gender
έκτακτες	έκτακτων	Case
χειρουργών	χειρουργοί	Case
βραχίονες	βραχίονα	Number
λαδικών	λαδικά	Case
γόπας	γόπα	Case
Μαυριτανών	Μαυριτανές	Case
νεοζηλανδέζικα	νεοζηλανδέζικο	Number
αρραβώνα	αρραβώνας	Case
διαβαίνετε	διαβαίνουν	Person
σαγάνια	σαγάνι	Number
σίγουρε	σίγουρος	Case
Ρουμάνων	Ρουμάνες	Case
έτη	ετών	Case
αζωτούχο	αζωτούχα	Number
αβιομηχανοποίητα	παιδνᾰ́	lemma
φευγάτες	φευγάτα	Gender
αρχιμάγειροι	αρχιμάγειρους	Case
χειρουργούς	χειρουργοί	Case
γυαλιού	γυαλιών	Number
τσέλο	τσέλου	Case
υπακούμε	υπακούω	Person
αγροκτήματα	περιορισμοί	lemma
άγαμες	άγαμους	Gender
κοιμητήρια	κοιμητηρίων	Case
ἀποῦσᾰ	ἀπών	Gender
σκοτεινότητας	σκοτεινοτήτων	Number
απατήθηκε	υπαγόρευσε	lemma
οράματα	οραμάτων	Case
τάπητες	τάπητα	Number
εσωτερικό	εσωτερικού	Case
θερμομονωτικός	θερμομονωτικό	Gender
μοσχοβολιά	μοσχοβολιάς	Case
ψηφοδόχων	ψηφοδόχοι	Case
αγριόχορτα	αγριόχορτο	Number
κυψέλες	κυψέλη	Number
χορογράφου	χορογράφε	Case
βοσκό	βοσκέ	Case
πληρωμή	πληρωμής	Case
τοίχους	τοίχοι	Case
αποσπάσματα	απόσπασμα	Number
μετασχηματισμό	μετασχηματισμού	Case
κορμοί	κορμός	Number
αλλοδαπές	τελετουργικές	lemma
ιστιοφόρα	ιστιοφόρο	Number
αδελφοκτόνη	αδελφοκτόνο	Gender
συνεργάσιμε	συνεργάσιμος	Case
επαινείς	επαινείτε	Person
ιππότες	ιπποτών	Case
φλαουτίστα	φλαουτίστας	Case
σωματικό	σωματικού	Case
αγαναχτείτε	αγαναχτούσατε	Tense
επεισοδίου	επεισόδιο	Case
αντίγραφα	αντίγραφο	Number
μάγισσας	μαγισσών	Number
κιβώτιο	φωτογράφο	lemma
συναίνεσης	συναίνεση	Case
ακίνδυνη	ακίνδυνο	Gender
θιάσων	θίασοι	Case
φράουλα	φράουλας	Case
εξοπλίζαμε	εξόπλιζες	Person
βαφτισμάτων	βαφτίσματα	Case
παραληρήματος	παραλήρημα	Case
εγγονοί	εγγονών	Case
λίτρου	λίτρο	Case
βίδρες	βίδρα	Number
καταρράκτες	καταρράκτη	Number
επηρειών	επήρειες	Case
φιλόλογοι	φιλολόγων	Case
δοκίμασα	δοκίμασαν	Person
κελτικά	κελτικών	Case
κερασιού	κερασιών	Number
αργούν	αργούσαν	Tense
μύτη	μύτης	Case
ανδραγάθημα	ανδραγαθήματος	Case
ξύπνημα	ξυπνήματος	Case
χαλίφες	χαλίφης	Number
αυξάνοντας	φωσφορίζοντας	lemma
πηδήματα	πηδημάτων	Case
μύξες	μυξών	Case
απατεώνων	απατεώνες	Case
δροσιστήκατε	δροσιστήκαμε	Person
νενέ	νενές	Case
μοναχές	μοναχών	Case
καλάθια	καλάθι	Number
παραμονές	παραμονών	Case
εμετικό	εμετικά	Number
βαγόνια	βαγονιών	Case
οικοδομές	οικοδομή	Number
συσκευασίας	συσκευασιών	Number
βαθμοφόρους	βαθμοφόροι	Case
γηροκομεία	γηροκομείο	Number
έκδοση	έκδοσης	Case
πεζοπορική	πεζοπορικό	Gender
μεταφράστριας	μεταφράστρια	Case
πράξεις	πράξη	Number
πλατειών	πλατείες	Case
καλλιγράφοι	καλλιγράφους	Case
αίτια	αιτίων	Case
κυνικώ	Ἀρῐστοφᾰνείω	lemma
αντίθετων	αντίθετους	Case
βγαίνει	τραυματίζει	lemma
τροπαίᾱ	τροπαίαιν	Case
φακής	φακή	Case
ολόκαινε	ολόκαινο	Gender
κοριό	κοριός	Case
ακίδες	ακίδα	Number
τᾰνᾰαῖν	τᾰνᾰαῖς	Number
μούσας	μούσα	Case
αλιγάτορες	αλιγάτορα	Number
κρεοπώλη	κρεοπωλών	Number
αξιωματούχο	αξιωματούχου	Case
δουλεμπόρους	δουλέμπορο	Number
πάλη	πάλης	Case
σκεύους	σκεύος	Case
πένσες	πενσών	Case
αριστερών	αριστερές	Case
στοιχήματα	στοιχημάτων	Case
μετρά	μετρούσε	Tense
υποθήκευε	υποθηκεύστε	Person
μεταναστών	μετανάστες	Case
ταξίδευα	ταξιδεύω	Tense
απογευμάτων	φιδιών	lemma
κυψέλη	κυψέλης	Case
συνηθίζει	συνήθιζε	Tense
μερισμάτων	μερίσματα	Case
πολικό	πολικού	Case
οργανισμό	οργανισμός	Case
αστακούς	αστακό	Number
αδιαίρετος	αδιαίρετη	Gender
αρχαιολογικές	αρχαιολογικών	Case
κατάθεση	κατάθεσης	Case
καθήκοντος	καθηκόντων	Number
περιηγητών	περιηγητές	Case
δέκατα	δεκάτων	Case
σκέπη	σκέπης	Case
ευζώνων	εύζωνοι	Case
αρχειοθηκών	αρχειοθήκες	Case
άνθρακα	ανθράκων	Number
οργασμού	οργασμός	Case
χειροκίνητα	χειροκίνητους	Gender
άκαμπτη	άκαμπτες	Number
φελλού	φελλέ	Case
γραφικαῖν	ἀκιδναῖν	lemma
γραφικαί	γραφικᾱ́ς	Case
σοδομισμός	σοδομισμού	Case
μάγματος	μαγμάτων	Number
αποίκους	άποικοι	Case
αναζητήσεις	υπαρξιστές	lemma
εξεταστήκατε	εξετάστηκαν	Person
Φαρισαίου	Φαρισαίων	Number
αγαπούμε	αγαπώ	Person
ανάποδης	ανάποδου	Gender
χιόνια	χιονιών	Case
νέγροι	νέγρους	Case
γυμναστή	γυμναστής	Case
άντρες	άντρα	Number
ακυριολεξία	πλήμνη	lemma
αγοραίες	αγοραία	Number
ευτυχισμένες	ευτυχισμένη	Number
απομονωμένα	απομονωμένοι	Gender
αλκοολικών	αλκοολικές	Case
αναγνωρίσαμε	αναγνώρισες	Person
ανακαινίστηκαν	ανακαινίστηκε	Number
λουξεμβουργιανό	λουξεμβουργιανή	Gender
ξωτικό	ξωτικού	Case
γυμνάστριες	γυμνάστρια	Number
λέσχες	λεσχών	Case
εθνικοποίησης	εθνικοποιήσεων	Number
γνωστικισμό	γνωστικισμού	Case
άγγελμα	αγγέλματος	Case
πρωταθλητές	πρωταθλητή	Number
παραλληλόγραμμα	παραλληλόγραμμο	Number
μεζέ	μεζέδων	Number
καύσης	καύσεων	Number
εξομολογητή	εξομολογητής	Case
άγουρο	προφορικό	lemma
εργολάβοι	εργολάβος	Number
σκίνο	σκίνος	Case
κλειτορίδα	κλειτορίδας	Case
οικοδόμων	οικοδόμοι	Case
αεριστούν	χρεωθούν	lemma
ανθρωπολόγο	ανθρωπολόγε	Case
λακκούβες	λακκούβα	Number
ξενοδοχειακών	ξενοδοχειακού	Number
προσθηκών	προσθήκες	Case
δακτυλίδι	λίβα	lemma
ενέπνεαν	εμπνέουν	Tense
καύσιμο	καυσίμου	Case
μερμήγκι	μερμηγκιού	Case
γάτων	γάτοι	Case
αυτοκινητόδρομοι	αυτοκινητόδρομος	Number
αιγυπτιακές	αιγυπτιακούς	Gender
αγγελιαφόρους	αγγελιαφόρο	Number
εγγενής	εγγενή	Case
χάσατε	έχασες	Number
ακατάπαυστε	ακατάπαυστοι	Number
περιποιείται	περιποιούμαστε	Person
ολυμπιάδας	ολυμπιάδα	Case
σκότωσε	σκοτώστε	Person
κουφάρι	κουφαριού	Case
εμποράκοι	εμποράκος	Number
αυξομείωσα	αυξομειώσαμε	Person
αγριόγατων	αγριόγατοι	Case
προλεταριακές	προλεταριακούς	Gender
αντιστοιχίας	αντιστοιχία	Case
ερυθραϊκούς	καταδυτικούς	lemma
εθελοντές	εθελοντή	Number
μοναχούς	μοναχών	Case
νορβηγικού	νορβηγικών	Number
εμβατήρια	λιμένες	lemma
φεμινίστριες	φεμινίστρια	Number
στρύχνο	στρύχνου	Case
αιτήσεων	αιτήσεις	Case
νομάρχη	νομαρχών	Number
υγρασία	υγρασίας	Case
δικαστικά	δικαστικές	Gender
προσθέσεων	προσθέσεις	Case
λαγούτα	λαγούτο	Number
φονταμενταλιστικά	φονταμενταλιστικοί	Gender
ερωμένη	ερωμένης	Case
κουρελιάζεται	κουρελιαζόμαστε	Person
χαλινοί	χαλινών	Case
άνεμοι	ανέμους	Case
ύψος	ύψους	Case
καθηγήτριες	καθηγητριών	Case
μονώσεις	μόνωση	Number
λόγχιζε	λογχίζετε	Person
περιήγηση	περιήγησης	Case
αδιάβροχο	λαϊκή	lemma
βασταγά	βασταγό	Number
παλαιοαρχαιοζωική	παλαιοαρχαιοζωικέ	Gender
αδελφοποιτού	αδελφοποιτών	Number
δοκιμαστική	δοκιμαστικές	Number
κόρνων	κόρνα	Case
παροξυσμοί	παροξυσμούς	Case
κοκκινομάλληδες	κοκκινομάλλης	Number
όχλο	όχλος	Case
μάγειρα	μάγειρας	Case
κάγκελου	κάγκελων	Number
δανείζονται	δανείζεται	Person
σταφίδας	σταφίδων	Number
μονόδρομε	μονόδρομος	Case
ορίζοντα	ορίζοντας	Case
ήμισεις	μελετηρούς	lemma
κατσαρόλες	κατσαρόλα	Number
πρωτεΐνες	πρωτεϊνών	Case
δανειστούν	κατευναστούν	lemma
δελτίων	δελτία	Case
έχουν	κουλουριάζονται	lemma
κάβου	κάβων	Number
λάδι	λαδιού	Case
αληθινοί	αληθινούς	Case
κουζινών	κουζίνες	Case
κλίση	κλίσης	Case
βαθμού	βαθμών	Number
περίπλοκε	περίπλοκο	Case
τριζονίων	τριζόνια	Case
υδράργυρο	υδράργυρος	Case
καταδρομέα	καταδρομέας	Case
συναίσθημα	συναισθήματος	Case
νοτιοαμερικανικά	νοτιοαμερικανικές	Gender
αντιπροσώπευες	αντιπροσώπευε	Person
φρουρά	φρουράς	Case
χρωστώ	χρωστάμε	Number
ουαλικών	ουαλικοί	Case
λινό	λινός	Gender
κυνηγούς	κυνηγοί	Case
ανίχνευσης	ανίχνευση	Case
ακτών	ακτές	Case
ασβό	ασβού	Case
πυξίδας	πυξίδα	Case
θολά	θολό	Number
ο	ος	Gender
αναχαιτίζεται	τηγανίζεται	lemma
χαλυβουργεία	χαλυβουργείο	Number
τραπεζιού	τραπεζιών	Number
μελισσοκόμο	μελισσοκόμος	Case
υποδομές	υποδομή	Number
καλαφατίσματος	καλαφατισμάτων	Number
εντύπου	εντύπων	Number
κέντρα	κέντρο	Number
αμφισβητιόμαστε	παρεμποδίζαμε	lemma
δίψασαν	διψάσαμε	Person
κερασιά	κερασιάς	Case
κεφαλαίων	κεφάλαια	Case
βουβάλια	βουβαλιών	Case
αράχνη	αράχνης	Case
αθεϊστές	αθεϊστών	Case
όνοι	όνος	Number
τούβλα	τούβλων	Case
εκτιμά	εκτιμούν	Person
συνασπισμούς	συνασπισμό	Number
ελέφαντες	ελέφαντας	Number
τουριστικοί	τουριστικά	Gender
ανάγκες	αναγκών	Case
δέσμιες	δέσμια	Number
ανεμοδείχτη	τσέλο	lemma
αρσενικέ	αρσενικοί	Number
παγετώνες	παγετώνα	Number
αγριόγαλλε	αγριόγαλλος	Case
αλκοολικές	αλκοολικών	Case
μήλο	μήλου	Case
σφράγισαν	σφράγισα	Person
αναχώματος	ανάχωμα	Case
πλοκάμια	πλοκαμιών	Case
δρομομέτρων	δρομόμετρα	Case
μούρου	μούρων	Number
αποδείξεις	απόδειξη	Number
ιβίσκου	ιβίσκος	Case
επιρρήματα	επίρρημα	Number
έκπτωσης	εκπτώσεων	Number
χαράδρας	χαράδρα	Case
αγόρασα	αγόρασαν	Person
πεινασμένα	πεινασμένων	Case
σούδας	σούδα	Case
πετσιά	πετσί	Number
φαίνεσαι	φαίνεστε	Person
αποθετικών	αποθετικούς	Case
λουκάνικων	λουκάνικα	Case
δύστροπου	ἀποθετικοῦ	lemma
ξεκίνησε	ξεκινήστε	Number
νοσοκομείο	νοσοκομείου	Case
χιονοστιβάδα	χιονοστιβάδας	Case
αντιστοιχιών	αντιστοιχίες	Case
οράματος	οραμάτων	Number
ραββίνο	ραββίνε	Case
αετό	αετός	Case
πατριούς	πατριών	Case
πωλήσεων	πωλήσεις	Case
χωματερής	χωματερών	Number
ζευγαριού	ζευγάρι	Case
οδηγοί	οδηγός	Number
μοναδικό	μοναδικά	Number
προειδοποιήσεων	προειδοποιήσεις	Case
αφράτη	προληπτική	lemma
απολογίας	απολογιών	Number
θελήσεις	θελήσεων	Case
δράσεις	δράσεων	Case
επαφές	επαφών	Case
οιωνό	οιωνός	Case
αριθμητικές	αριθμητικών	Case
αντιρρήσεις	αντιρρήσεων	Case
συμπυκνωμάτων	συμπυκνώματα	Case
σκίρωνα	σκίρων	Case
αδεκαρίας	αδεκαρία	Case
δαχτυλική	δαχτυλικές	Number
σάρκες	σάρκα	Number
ανακατευόταν	κοίταζε	lemma
ταυρομάχου	ταυρομάχων	Number
κραμβολάχανων	κραμβολάχανα	Case
πεθάνετε	πέθαινε	Number
αφόρητες	αφόρητους	Gender
αποκρίθηκε	παρέδωσε	lemma
ὀνομαστικᾰ́	ὀνομαστικῶν	Case
έρανο	έρανος	Case
αθρήνητες	αθρήνητους	Gender
γειτονιά	γειτονιάς	Case
λαβής	λαβή	Case
ριζώματα	ριζωμάτων	Case
σημεία	σημείων	Case
σπασμούς	σπασμών	Case
αεροπλάνα	αεροπλάνων	Case
καταβάλατε	κατέβαλες	Number
αθροίζονταν	αθροιζόμουν	Person
διασπούν	καταφέρνουν	lemma
περισσότερους	περισσότερα	Gender
Εγγλέζων	Εγγλέζοι	Case
διαθέσιμες	διαθέσιμη	Number
χωράφια	χωράφι	Number
διελεύσεις	διέλευση	Number
συναλλαγών	συναλλαγές	Case
καρβοξυλικών	καρβοξυλικοί	Case
προφητικό	προφητικού	Case
βίζες	βίζα	Number
κλήματα	κλήμα	Number
πιλότου	πιλότων	Number
ανοίγεις	ανοίγει	Person
ζουμπά	ζουμπάς	Case
δίσκο	δίσκου	Case
ιατρείων	ιατρεία	Case
ασήμαντους	ασήμαντες	Gender
λύκαινες	λυκαινών	Case
θερμόμετρα	θερμόμετρο	Number
απερίσκεπτου	απερίσκεπτο	Case
ιδανικότατους	χαμηλότατους	lemma
ξαδέλφης	ξαδέλφων	Number
τεφροδόχο	τεφροδόχος	Case
ινσουλίνης	ινσουλινών	Number
ιππότη	ιππότης	Case
κυπριακό	κυπριακού	Case
ζιζανιοκτόνα	ζιζανιοκτόνο	Number
λαδά	λαδάς	Case
κατήφοροι	κατήφορων	Case
επανεγκατάστασης	επανεγκατάσταση	Case
λαογράφο	λαογράφος	Case
στρώματος	στρωμάτων	Number
βαλβίδων	βαλβίδες	Case
δαχτυλίδια	δαχτυλιδιών	Case
υπολογιστή	υπολογιστών	Number
χρηματιστηρίων	χρηματιστήρια	Case
Ιταλούς	Ιταλό	Number
ακαδημίες	ακαδημία	Number
αβλεψιών	αβλεψίες	Case
εβραϊκά	εβραϊκών	Case
κομμουνιστές	κομμουνιστή	Number
αδρανείς	αδρανής	Number
διάθεση	διάθεσης	Case
κούνιας	κούνια	Case
διαβαστούν	δωριστούν	lemma
αργίλων	άργιλοι	Case
ημισφαιρίου	ημισφαιρίων	Number
Πασχαλιές	Πασχαλιών	Case
χωματερές	χωματερών	Case
χορτοφαγικές	χορτοφαγικούς	Gender
ανόητη	ανόητης	Case
Πορτορικανού	Πορτορικανός	Case
λοφία	λοφίων	Case
εγκληματολόγοι	εγκληματολόγε	Number
δαμάσκηνου	δαμάσκηνο	Case
τριπλής	τριπλή	Case
καθόδους	καθόδων	Case
αυξάνουμε	πληρώνουμε	lemma
κοντομάνικοι	κοντομάνικα	Gender
είσαι	λιγοστεύεις	lemma
απόγονοι	απογόνους	Case
βερύκοκκων	βερύκοκκα	Case
διαγωνιζόμενης	διαγωνιζόμενη	Case
αρτοπωλισσών	αρτοπώλισσες	Case
ζητούσαν	ζητούσε	Person
βασανίστριες	βασανιστριών	Case
χαλβάδες	χαλβά	Number
έπλενες	έπλενα	Person
υπολογισμοί	υπολογισμών	Case
διαιτητές	διαιτητής	Number
Βρεττανοί	Βρεττανών	Case
φέρναμε	έφερνα	Person
σουηδικού	σουηδικών	Number
εκδοτών	εκδότες	Case
αίρεσης	αίρεση	Case
αγαθού	αγαθών	Number
όρνεα	όρνεο	Number
επιδόματα	επίδομα	Number
απόρριψης	απόρριψη	Case
σημαντικᾱ́	συναπτικᾱ́	lemma
κουρούνα	κουρούνας	Case
αναρχικών	αναρχικές	Case
βασιλείου	ἐπιθετικοῦ	lemma
πυρηνικό	πυρηνικά	Number
κριαριού	κριαριών	Number
χτύποι	χτύπων	Case
ταξίδια	ταξίδι	Number
βγαλθείς	βγαλθούν	Person
γυμναστικές	γυμναστική	Number
αρχιεπίσκοποι	αρχιεπισκόπων	Case
ακτίνες	ακτίνων	Case
τιμήματος	τίμημα	Case
καταλυτικές	καταλυτικοί	Gender
ανθοπώλη	ανθοπωλών	Number
ενώνεται	μελετά	lemma
επανεγκατάστασης	επανεγκαταστάσεων	Number
αυτισμού	αυτισμός	Case
αδικήματος	αδικημάτων	Number
μπάνια	μπάνιων	Case
μοναχές	μοναχή	Number
τάλιρα	τάλιρων	Case
αξιοσημείωτου	αξιοσημείωτων	Number
ισπανικών	ισπανικές	Case
γδέρνετε	καβουρδίζετε	lemma
άγρα	ξαδέλφη	lemma
ανθρωπολογικοί	ανθρωπολογικά	Gender
κατηγορούμαι	κατηγορείται	Person
χαμηλούς	χαμηλοί	Case
ζαχαροπλάσταινας	ζαχαροπλάσταινα	Case
άμορφο	άμορφου	Case
ρολά	ρολών	Case
αγωνίσματος	αγωνισμάτων	Number
αντισυλληπτικό	ονομαστική	lemma
αυτόνομοι	αυτόνομες	Gender
υποψιών	υποψίες	Case
αρτοποιοί	αρτοποιέ	Number
καλόγερο	καλόγερος	Case
χάσαμε	έχασες	Person
κοινωνούσατε	κοινωνάτε	Tense
επιστημονικό	επιστημονικά	Number
λογοτεχνίες	λογοτεχνιών	Case
εγχείρησης	εγχείρηση	Case
δακτυλογραφήθηκα	δακτυλογραφηθήκαμε	Number
περπατήστε	περπάτα	Person
τρομοκράτες	τρομοκράτης	Number
είχες	είχανε	Person
τούρκικους	τούρκικο	Number
ιπτάμενων	ιπτάμενες	Case
ανοίγονται	ανοίγεται	Number
ρολόι	ρολογιού	Case
προδοτικές	προδοτικά	Gender
μαλλιού	μαλλί	Case
σαρανταποδαρούσα	σαρανταποδαρούσας	Case
μακρινός	μακρινέ	Case
ποικιλίας	ποικιλιών	Number
ακίνητων	κατάλληλων	lemma
μαρτυρώ	μαρτυράμε	Number
ράβδοι	ράβδους	Case
αιφνίδιο	αιφνίδια	Gender
προσθέτει	προσθέτω	Person
νηστείας	νηστεία	Case
κομουνιστές	κομουνιστών	Case
υπαίθριοι	υπαίθριος	Number
δανείστηκαν	παρέδωσαν	lemma
άτακτος	άτακτο	Case
αγκομαχάς	αγκομαχούν	Person
έλεγχο	έλεγχε	Case
ελπίδες	ελπίδων	Case
σπασμούς	σπασμοί	Case
πάρκα	πάρκο	Number
κυρήθρας	κυρήθρα	Case
διακανονισμοί	διακανονισμός	Number
μαγνητικός	μαγνητικοί	Number
προσόντων	προσόντα	Case
μύξας	μυξών	Number
υπηρεσιών	υπηρεσίες	Case
χαλβά	χαλβάς	Case
αλλεργικοί	τολμηροί	lemma
φαινόμαστε	φαίνεστε	Person
ρέγγες	ρέγγα	Number
υψικάμινε	υψικάμινος	Case
κύστης	κύστη	Case
μιγαδικοί	μιγαδικών	Case
αζωτούχα	αζωτούχες	Gender
αστικά	αστικών	Case
ηττών	ήττες	Case
καταλυτικές	καταλυτικά	Gender
θεόρατοι	θεόρατα	Gender
αντικαταστάτη	αντικαταστατών	Number
αγελάδες	αγελάδα	Number
αγνωστικιστές	αγνωστικιστής	Number
ψιθύρου	ψιθύρων	Number
φορτηγού	φορτηγό	Case
ευρωπαϊκούς	πλεονεκτικούς	lemma
αντισταθεί	μεταφραστεί	lemma
αθώωσης	αθώωση	Case
αρουραίο	αρουραίε	Case
βαράτε	βαρούν	Person
λεβιστικό	λεβιστικού	Case
πάρκων	πάρκα	Case
κρατάς	κρατώ	Person
σβηστηριού	σβηστήρι	Case
λόρδο	λόρδος	Case
βήματα	βημάτων	Case
υπεύθυνης	υπεύθυνη	Case
διαμαχών	διαμάχες	Case
φοβήθηκαν	φοβήθηκα	Person
γυμναστικών	γυμναστικές	Case
σουριναμέζικη	σουριναμέζικο	Gender
εγχειρίσεις	εγχείριση	Number
ουλής	ουλή	Case
είσαι	φωνάζεις	lemma
τσούλια	τσούλι	Number
ερωδιό	ερωδιέ	Case
ανάμιξης	αναμίξεων	Number
βλέννας	βλέννα	Case
τραίνο	τραίνου	Case
παντοδύναμου	παντοδύναμο	Case
αγορίνων	αγορίνες	Case
αμερίκιο	αμερικίου	Case
ακλήρωτοι	ακλήρωτες	Gender
περνούσε	περνά	Tense
αδιάλυτο	υπερβατικό	lemma
ανταμοιβή	ανταμοιβής	Case
πιθάρια	πιθάρι	Number
πατρικέ	πατρικός	Case
έψαλαν	έψαλε	Number
ηλεκτρολόγοι	ηλεκτρολόγων	Case
γεροντότερες	γεροντότερη	Number
αναπαράσταση	αναπαράστασης	Case
επεμβάσεις	επεμβάσεων	Case
ασχολείστε	ασχολείσαι	Number
ανασκαφή	ανασκαφής	Case
μικροσκοπικούς	μικροσκοπικοί	Case
τυλίχτηκες	τυλιχτείς	Tense
μαϊμούδες	μαϊμούδων	Case
τσάρων	τσάροι	Case
παρεκκλίσεις	παρέκκλιση	Number
ελλαδικές	ταχυδρομικές	lemma
νούφαρων	νούφαρα	Case
ακροδεξιά	ακροδεξιό	Number
ασφαλιστικού	ασφαλιστικό	Case
ποινικός	ποινική	Gender
περγαμηνής	περγαμηνή	Case
μολυβιού	μολύβι	Case
διαζύγια	διαζύγιο	Number
λεόπαρδο	λεοπάρδου	Case
αξιόγραφα	αξιόγραφο	Number
θεωρηθήκαμε	θεωρήθηκες	Person
ερμηνεύετε	ερμήνευε	Number
περιήλιο	περιηλίου	Case
πλέθρο	πλέθρου	Case
κάλπης	κάλπη	Case
αντικατοπτρισμών	αντικατοπτρισμοί	Case
οικονομίας	οικονομία	Case
προστακτικών	προστακτικές	Case
μπάνιου	μπάνιο	Case
χοντρεμπόρου	χοντρέμπορος	Case
αρκούδα	αρκούδας	Case
ισχύς	ισχύες	Case
δημοσιευμάτων	δημοσιεύματα	Case
αραβικών	αραβικά	Case
αποδόσεις	φιλολογίες	lemma
νόμιμοι	νόμιμα	Gender
βαδίζω	βαδίζεις	Person
φιλολόγους	φιλόλογοι	Case
ανάγκασε	ανάγκασαν	Person
επενδύτη	επενδύτης	Case
ιέρειας	ιέρεια	Case
φορτίου	φορτίο	Case
απολίτιστοι	χρονοβόροι	lemma
μοτίβου	μοτίβων	Number
αμαξάδων	αμαξάδες	Case
επιχειρηματικών	φωτοδιαπερατών	lemma
αμαλγάματα	αμάλγαμα	Number
επιδρομή	επιδρομής	Case
αυστριακός	αυστριακού	Case
πατριώτη	πατριώτης	Case
ακακίας	ακακιών	Number
Μοζαμβικανή	Μοζαμβικανής	Case
κλουβιά	κλουβιών	Case
μολδαβικών	μολδαβικής	Number
θύματα	θυμάτων	Case
μπερδεμένοι	μπερδεμένες	Gender
διαμάχης	διαμάχη	Case
άνδρα	ανδρών	Number
έμβλημα	εμβλήματος	Case
βενετσιάνικα	βενετσιάνικες	Gender
έτοιμο	τηλεπικοινωνιακό	lemma
γοήτευσε	γοήτευσαν	Person
σερβικοί	σερβικά	Gender
πρίγκιπες	πριγκίπων	Case
διακοπτών	διακόπτες	Case
νεκροφόρες	νεκροφόρων	Case
ορμές	ορμών	Case
ηνωμένούς	ηνωμένών	Case
βυζαντινού	βυζαντινής	Gender
φεμινιστικέ	φεμινιστικοί	Number
πορθμεία	πορθμείων	Case
αφαιρετικότατες	σαρκαστικότατες	lemma
ωφελούσαμε	ωφελούσα	Person
ετοιματζίδικη	ετοιματζίδικες	Number
κλειστοφοβία	κλειστοφοβίας	Case
μαγνητόφωνο	μαγνητοφώνου	Case
πορνογραφικού	πορνογραφικών	Number
κειμένου	κειμένων	Number
γύπας	γυπών	Number
οχημάτων	οχήματα	Case
αμιγών	αμιγούς	Number
εξημερώσεις	εξημέρωση	Number
ακλήρωτες	ακλήρωτων	Case
ασελγή	ασελγές	Gender
έντυπο	εντύπου	Case
έμβρυα	έμβρυο	Number
ασελγή	ασελγείς	Gender
κειμήλια	κειμηλίων	Case
Βολιβιανοί	Βολιβιανούς	Case
γιοττάμετρα	γιοτταμέτρων	Case
θεωρεί	θεωρούν	Person
χρειαστεί	χρειαστείς	Person
πιστωτών	πιστωτές	Case
εμπορικότερης	τιμιότερης	lemma
σακιδίων	σακίδια	Case
επιδίωξης	επιδίωξη	Case
συγχωνεύουν	συγχωνεύει	Person
γιγακύκλου	γιγακύκλων	Number
χρηματιστήρια	χρηματιστήριο	Number
ψυγείων	ψυγεία	Case
φελλό	φελλού	Case
αετώματα	νεολιθικές	lemma
αρπαχτώ	χαθώ	lemma
φλοιοί	φλοιός	Number
ζητιανεύαμε	οικονομούσαμε	lemma
φλεγμονών	φλεγμονές	Case
καφετερίες	καφετεριών	Case
δισκογραφίας	δισκογραφία	Case
προσθήκης	προσθηκών	Number
υποκείμενα	υποκειμένων	Case
αποκτά	αποκτάς	Person
πλημυρίδες	πλημυρίδων	Case
πόλους	πόλων	Case
συνειδήσεις	συνείδηση	Number
τραγούδι	τραγουδιού	Case
βαρόνο	βαρόνου	Case
φυτικώ	φυτικᾱ́	Gender
πρωτόγονη	πρωτόγονης	Case
ακρωνύμια	ακρωνυμίων	Case
αδασμολόγητοι	αδασμολόγητων	Case
ρόδα	ρόδων	Case
κουτεντέδων	κουτεντέδες	Case
λάβαρα	λαβάρων	Case
αναφορικά	αναφορικό	Number
καταστρέφαμε	καταστρέφατε	Person
γιατρούς	γιατρό	Number
βιομηχάνων	βιομήχανοι	Case
εθνικιστών	εθνικιστές	Case
συνασπισμού	συνασπισμών	Number
ξεκωλιαστήκατε	ξεκωλιαστείτε	Tense
αστυνομικούς	αστυνομικών	Case
ανίψια	ανιψιών	Case
δυναμοδότης	δυναμοδότη	Case
γάτου	γάτε	Case
οριζόντια	οριζόντιοι	Gender
ορμονών	ορμόνες	Case
διαπιστευτήρια	διαπιστευτηρίων	Case
αιμοπετάλια	αιμοπεταλίων	Case
μίλησαν	μίλησε	Person
κουρελιαστούμε	κουρελιαστώ	Person
περιορισμένες	περιορισμένη	Number
καλντέρα	καλντέρας	Case
προόδους	προόδων	Case
αποχωρητήρια	αποχωρητηρίων	Case
κέρδισε	κερδίστε	Number
μπαχαρικά	μπαχαρικό	Number
ενυδρίδων	ενυδρίδες	Case
επαινούσατε	επαινούσες	Number
ακήρυχτου	ακήρυχτο	Case
ισχύς	ισχύ	Number
σύντροφο	σύντροφε	Case
αθίγγανους	αθίγγανοι	Case
ανελκυστήρα	ανελκυστήρων	Number
Αγκολέζοι	Αγκολέζους	Case
πουστάκους	πουστάκοι	Case
παραμέρισε	παραμέρισαν	Number
βυρσοδέψη	βυρσοδέψης	Case
καλάθια	καλαθιών	Case
παππά	παππάδων	Number
κινητήρες	κινητήρων	Case
αμοιβάδα	αμοιβάδας	Case
διάνους	διάνων	Case
δικηγόροι	δικηγόρος	Number
ποντίκια	ποντίκι	Number
σεληνιακός	σεληνιακοί	Number
ενωνόμασταν	χαζεύαμε	lemma
ορυχείου	ορυχείων	Number
βυθίζουν	βύθιζαν	Tense
μπανανιά	μπανανιάς	Case
μεταδοτική	μεταδοτικές	Number
άγχη	αγχών	Case
τοπία	τοπίο	Number
ικανότητες	ικανοτήτων	Case
μελέτα	μελετάτε	Number
αδιαίρετο	αδιαίρετη	Gender
συντάκτριας	συντάκτρια	Case
αβεβαιότητα	αβεβαιότητας	Case
εγχείριση	εγχείρισης	Case
ισχυριστείς	ισχυριστούν	Person
πινέλου	πινέλο	Case
αμφιβάλλει	αμφέβαλλε	Tense
εκκρεμούς	εκκρεμές	Case
κρυσταλλική	κρυσταλλικό	Gender
σουλτάνου	σουλτάνων	Number
τερματοφύλακα	τερματοφύλακας	Case
αυθαίρετους	αυθαίρετοι	Case
εργοταξίου	εργοτάξιο	Case
πρωτοβουλίες	πρωτοβουλία	Number
υλισμό	υλισμός	Case
απογεύματος	απόγευμα	Case
Νεοπροτεροζωικό	Νεοπροτεροζωικός	Case
έγγραφα	υποκλίσεις	lemma
χαρτοφυλακίου	χαρτοφυλάκιο	Case
αγροτικά	αγροτικό	Number
θεμελιωδών	θεμελιώδη	Case
διακοπής	διακοπών	Number
ποδηλατοδρομίας	ποδηλατοδρομιών	Number
μπιζέλια	μπιζέλι	Number
πλεκτικοῖν	ὀπτικοῖν	lemma
επείγον	επείγοντα	Number
αυτοκρατόρισσα	αυτοκρατόρισσας	Case
αύξηση	αύξησης	Case
παραγωγοί	παραγωγός	Number
βιασμού	βιασμών	Number
αποκλείουν	μαρκάρουν	lemma
αγροικίας	αγροικία	Case
παιδαριώδη	παιδαριώδους	Case
σφραγίσματος	σφράγισμα	Case
κινηματογράφο	κινηματογράφος	Case
θεία	θείας	Case
εκταρίου	εκταρίων	Number
λακωνική	λακωνικό	Gender
φράχτη	φράχτης	Case
περιγράφω	περιγράφετε	Person
εγκαθιστούν	εγκαθιστά	Person
εκδόσεων	εκδόσεις	Case
ιταλικοί	ιταλικός	Number
πατούσαν	πατούσα	Person
φυλλαδίου	φυλλαδίων	Number
νεκρικό	νεκρική	Gender
ραβδίων	ραβδία	Case
ρήματα	ρημάτων	Case
ρωτούσαν	ρωτούσε	Person
σουηδικές	σουηδικούς	Gender
καλλιτέχνη	καλλιτέχνης	Case
μπαλλέτο	μπαλλέτου	Case
δάπεδο	δαπέδου	Case
κατάφερα	κατάφερες	Person
προετοιμαζόμουν	προετοιμαζόμασταν	Person
διφορούμενοςη	διφορούμενοςο	Gender
αργαλειοί	αργαλειών	Case
ακανόνιστου	ακανόνιστων	Number
μωρομάντηλων	μωρομάντηλα	Case
ακρόπολη	ακρόπολης	Case
σκαλωσιές	σκαλωσιά	Number
διγλωσσίας	διγλωσσία	Case
υπερβολικού	υπερβολικό	Case
σεισμογράφοι	σεισμογράφων	Case
πρωινών	πρωινά	Case
μεσημβρινό	μεσημβρινού	Case
εντομοκτόνα	εντομοκτόνων	Case
αποκατάσταση	πτερύγιο	lemma
κακού	κακών	Number
οπλιζόσουν	οπλιζόταν	Person
άγαμοι	αγάμων	Case
μαζών	μάζες	Case
φυλλάδια	φυλλαδίων	Case
αιγίδας	αιγίδα	Case
καγκελάριους	καγκελάριοι	Case
δαχτύλου	δαχτύλων	Number
αθέμιτη	αθέμιτος	Gender
αποχρώσεις	απόχρωση	Number
αερομοντελιστές	αερομοντελιστής	Number
μελισσιού	μελίσσι	Case
βυθίζουμε	μεταρρυθμίζουμε	lemma
καθεστώτος	καθεστώτων	Number
αιγυπτιακές	πυρηνικές	lemma
ωράρια	ωράριο	Number
μεζέδες	μεζές	Number
αδειαστείς	αδειαστούν	Person
μεντεσέδων	μεντεσέδες	Case
ενετικής	ενετική	Case
ψύλλου	ψύλλος	Case
βγήκα	βγήκαν	Person
εσωτερικό	εσωτερικά	Number
ζήλειας	ζήλεια	Case
δημοσιεύσεις	δημοσίευση	Number
βολιβιανό	κινητό	lemma
δούλους	δούλων	Case
δωδεκανησιακέ	δωδεκανησιακό	Case
πατατών	πατάτες	Case
προμαχώνα	προμαχώνων	Number
τσιμπούσαν	τσιμπούσατε	Person
αισθητήριο	μαύρο	lemma
επιστημονικού	επιστημονικών	Number
κοιλάδων	κοιλάδες	Case
διψασμένες	διψασμένη	Number
αιτιατών	αιτιατά	Case
συνάθροισης	συναθροίσεων	Number
γύπες	γυπών	Case
μελετούν	μελετά	Number
θερμοκρασίες	θερμοκρασία	Number
καδένας	καδένα	Case
πρότεινες	προτείνατε	Person
επικές	ουαλικές	lemma
μπανανών	μπανάνες	Case
ίχνους	ίχνος	Case
νωδαῖν	νωδοῖν	Gender
περδίκων	πέρδικες	Case
τίμιων	τίμια	Case
φασιστικής	φασιστική	Case
εγκλήματος	έγκλημα	Case
ενοίκιο	ενοικίου	Case
αιτιοκρατικές	αιτιοκρατική	Number
τονισμούς	τονισμό	Number
βαλλίστρας	βαλλίστρα	Case
ναζιστές	ναζιστής	Number
ετήσιων	ετήσιες	Case
σκαμνιών	σκαμνιά	Case
κοπάνισε	κοπανίσαμε	Person
χυμοί	χυμός	Number
πληθωρισμό	πληθωρισμός	Case
ιδρύματος	ιδρυμάτων	Number
παρεμποδίζεις	παρεμποδίζουν	Person
μπαχαρικά	μπαχαρικών	Case
διαγωνιζόμενους	διαγωνιζόμενοι	Case
ανακαινιζόσασταν	ανακαινίζεστε	Tense
λόρδοι	λόρδους	Case
σκέψεις	σκέψεων	Case
συμπεριφορές	συμπεριφορά	Number
περιλήψεις	περίληψη	Number
σπηλαιολόγων	σπηλαιολόγοι	Case
ναυ	ναυς	Case
κερασιών	κεράσια	Case
κοινωνίας	κοινωνία	Case
πανελλήνιες	πανελλήνιοι	Gender
θωρακισμένης	θωρακισμένου	Gender
διαθέσιμο	διαθέσιμα	Number
άριστης	άριστη	Case
πάθησης	παθήσεων	Number
πολυλεκτικοί	πολυλεκτικά	Gender
ειδοποιώ	ειδοποιείτε	Person
διασυνδέσεων	διασυνδέσεις	Case
ασυνίζητους	ασυνίζητο	Number
καρυδότσουφλα	καρυδότσουφλο	Number
πέθαινε	πέθαιναν	Person
πατούν	πατάτε	Person
πάντα	πάντων	Case
σφηνόλιθο	σφηνόλιθου	Case
αρκεύθων	άρκευθοι	Case
αγνωστικού	αγνωστικέ	Case
χαραμοφάισσα	χαραμοφάισσας	Case
κολοκυθόπιτας	κολοκυθοπιτών	Number
νεκρικών	νεκρικού	Number
αγανάκτησε	τύλιξε	lemma
χρήσιμη	χρήσιμο	Gender
αετοί	αετούς	Case
εκσκαφέα	εκσκαφέας	Case
μοντελιστές	μοντελιστής	Number
έσπαγαν	έσπαγε	Person
ιοί	ιός	Number
κινεζικός	κινεζική	Gender
ομοσπονδιακό	ομοσπονδιακά	Number
μονάδες	μονάδων	Case
συλλεκτών	συλλέκτες	Case
αγροφύλακες	αγροφύλακα	Number
μανίκια	μανίκι	Number
στεριές	στεριών	Case
σπάγκο	σπάγκου	Case
κουβέντας	κουβέντα	Case
επιμένει	επιμένω	Person
καφετιά	καφετιές	Number
αινιγματικά	σύνθετα	lemma
αιωρών	αιώρες	Case
ριζοβούνια	ριζοβούνι	Number
επέκτασης	επεκτάσεων	Number
μανάβηδες	μανάβη	Number
δασοφύλακες	δασοφύλακας	Number
γόμας	γόμα	Case
αγαλματοποιίας	αγαλματοποιία	Case
κωλαράκους	κωλαράκοι	Case
μπισκότου	μπισκότο	Case
μετασχηματιστή	μετασχηματιστών	Number
φύτεψε	φύτεψες	Person
αιτίου	αίτιο	Case
ονοματοποιίας	ονοματοποιία	Case
χάιδευαν	χαϊδεύατε	Person
αυτιστικά	αυτιστικό	Number
αδίδακτο	παντρεμένο	lemma
ανέξοδου	ανέξοδης	Gender
κομμάτια	κομματιών	Case
βολβοί	βολβός	Number
νονό	νονός	Case
μιγαδικό	μιγαδικού	Case
ειδωλολάτρες	ειδωλολατρών	Case
κοπάνιζα	κοπανίζαμε	Number
στερεό	στερεού	Case
ευλογίας	ευλογία	Case
αρπακτική	καινοζωική	lemma
αβαθείς	αβαθή	Gender
δρυός	δρυών	Number
ομοίωμα	ομοιώματος	Case
βασίλισσας	βασίλισσα	Case
κρεμάστε	κρέμα	Number
ανακαίνισης	ανακαινίσεων	Number
ανάδειχνε	ανάδειχναν	Person
κιλά	σταφύλια	lemma
τσούρα	τσούρας	Case
γεωργιανά	γεωργιανών	Case
άκατο	ακάτου	Case
γεωργοκτηνοτρόφους	γεωργοκτηνοτρόφοι	Case
ναρκοπεδίου	ναρκοπεδίων	Number
σενάριο	σεναρίου	Case
γυναικολόγο	γυναικολόγος	Case
νηπιαγωγείου	νηπιαγωγείο	Case
ιθαγενές	ιθαγενών	Case
καθιέρωσαν	καθιέρωσε	Number
κυβερνούσατε	κυβερνούσες	Number
σαρκίνω	ἡμῐ́σεε	lemma
ζητιάνο	ζητιάνου	Case
οξέα	οξύ	Number
αναδείκνυε	αναδεικνύει	Tense
ντουλαπών	ντουλάπες	Case
μελανώματος	μελάνωμα	Case
εξαδέλφης	μαγείας	lemma
ύπαιθρο	ύπαιθρος	Case
τακτικών	τακτικές	Case
κινεζικές	κινεζική	Number
αετό	αετέ	Case
κεντούν	κεντώ	Person
κρόταφο	κρόταφε	Case
καμπούρηδες	καμπούρηδων	Case
λειτουργούς	λειτουργό	Number
χωριών	χωριά	Case
στρώματα	στρώμα	Number
καλουπιών	καλούπια	Case
μεσοπολεμικό	μεσοπολεμικά	Number
εξολοθρεύαμε	εξολόθρευα	Person
δώσαμε	έδωσε	Person
κίσσες	κίσσα	Number
αναποδογυρίζετε	πιάνετε	lemma
ξεχειλίζετε	ξεχειλίζουν	Person
μουσείων	μουσεία	Case
φωτογράφους	φωτογράφων	Case
εκπαιδευτικών	εκπαιδευτικοί	Case
αποκοιμόμαστε	σκίζουμε	lemma
πρόχειρο	προχείρου	Case
λωτού	λωτός	Case
μαϊντανό	μαϊντανού	Case
κοστίζει	κοστίζουν	Number
απαγορεύσατε	απαγόρευσα	Person
διαιτητών	διαιτητές	Case
ασφαλίσεις	ασφάλιση	Number
κλάστε	κλάσε	Person
αντιστεκόταν	αντιστέκονταν	Person
πλημμύρας	πλημμύρα	Case
λείας	λείου	Gender
τζαμιών	τζάμια	Case
ξωτικά	ξωτικό	Number
λάπατου	λάπατο	Case
κατηγορούμε	κατηγορώ	Person
έδινε	έδινες	Person
υλικές	υλικά	Gender
βᾰρέοιν	ἀκιδνοῖν	lemma
σκολόπεντρα	σκολόπεντρας	Case
αίτημα	αιτήματος	Case
ευνής	ευνών	Number
συνδυάζουν	συνδυάζω	Person
εξάτμιση	στενή	lemma
κοιλάδα	κοιλάδας	Case
φυλαχτά	φυλαχτό	Number
πολύγωνα	πολύγωνο	Number
Εγγλέζοι	Εγγλέζους	Case
πλεονεκτήματος	πλεονεκτημάτων	Number
αφαιρετική	αφαιρετικές	Number
αναζητήσεις	αναζήτηση	Number
δυσκολότατες	σφοδρότατες	lemma
Σλοβάκας	Σλοβακών	Number
αδάμαντες	αδαμάντων	Case
τεχνολόγοι	τεχνολόγος	Number
άνοδο	άνοδος	Case
ακατέργαστος	ακατέργαστο	Case
παρακαλούσαν	παρακαλούσε	Person
γκόμενοι	γκόμενος	Number
άμμοι	άμμων	Case
θεσμέ	θεσμός	Case
φούρνοι	φούρνους	Case
αδρανοποιούνται	περνούν	lemma
υπερφορτώθηκε	υπερφορτώθηκες	Person
διαβάστηκαν	διαβάστηκα	Person
μετανοόντος	μετανοόν	Case
αθλητικές	αθλητική	Number
πρακτικής	πρακτικών	Number
εκπέσει	ρωτήσει	lemma
λύνω	λύνει	Person
πράσα	πράσων	Case
υφέσεις	υφέσεων	Case
κυδνώ	ψυδνώ	lemma
τρίκυκλα	τρίκυκλο	Number
έπαιρνες	έπαιρναν	Person
σιδερένιο	σιδερένια	Gender
υπογραμμίζει	υπογράμμιζε	Tense
φάρου	φάρος	Case
κεριών	κεριά	Case
φιλαράκους	φιλαράκων	Case
τρισδιάστατα	τρισδιάστατων	Case
βοηθητικότερος	σκαιότερος	lemma
βασάνισες	βασάνισαν	Person
αιμοδότριας	αιμοδότρια	Case
βάλτου	βάλτε	Case
νομάρχες	νομαρχών	Case
Γιαπωνέζο	Γιαπωνέζος	Case
ζήτηση	ζήτησης	Case
κενών	κενά	Case
γραβάτες	γραβάτα	Number
ανακατευτούν	ανακατευτεί	Person
μπύρες	μπύρα	Number
ιπποπόταμους	ιπποπόταμο	Number
αποφασίσαμε	αποφάσισα	Person
προαγωγών	προαγωγοί	Case
λιποθυμίας	λιποθυμία	Case
αποκρυπτογράφησης	αποκρυπτογράφηση	Case
καταχώρηση	παρωδία	lemma
πλεονέκτημα	πλεονεκτήματος	Case
καφενεία	καφενείων	Case
απολογείσαι	απολογείται	Person
πορφυρά	πορφυρών	Case
χρυσοχόοι	χρυσοχόους	Case
αντίθετους	αντίθετα	Gender
αύξαναν	λύνονταν	lemma
θαρραλεότερους	φρονιμότερους	lemma
τριπλές	τριπλή	Number
οθόνης	οθονών	Number
προβαδίσματος	προβάδισμα	Case
απαγχονισμούς	απαγχονισμό	Number
υποχρεωτικού	υποχρεωτικών	Number
αιολικό	αιολικού	Case
λόρδους	λόρδοι	Case
αναδόχων	ναυτιών	lemma
μαγαζιά	μαγαζιών	Case
καλουπιού	καλουπιών	Number
ρύποι	ρύπων	Case
άλως	άλω	Case
γαλήνιου	γαλήνιος	Case
κεφαλαριού	κεφαλάρι	Case
Λουξεμβούργιοι	Λουξεμβούργιων	Case
γριάς	γριά	Case
προοδευτικές	προοδευτικών	Case
πετά	πετώ	Person
λίβρας	λίβρα	Case
τοκογλύφοι	τοκογλύφων	Case
αναφλεκτήρων	αναφλεκτήρες	Case
συνοδούς	συνοδό	Number
θεοφοβούμενων	θεοφοβούμενες	Case
συναπτικώ	συναπτικᾱ́	Gender
διαφορές	διαφορά	Number
αρπακτικών	αρπακτικού	Number
υποτροφίες	υποτροφιών	Case
ενυδρείων	ενυδρεία	Case
οικοσυστημάτων	οικοσυστήματα	Case
αιδώ	αιδώς	Case
παρασκευαστών	παρασκευαστές	Case
αγγέλλει	αγγέλλεις	Person
δαμασκηνιάς	δαμασκηνιά	Case
κλαρινέτου	κλαρινέτο	Case
κίτρινο	τενίστρια	lemma
δημοψηφίσματος	δημοψηφισμάτων	Number
κατασκόπους	κατάσκοποι	Case
αδόκιμο	αδόκιμος	Case
λέσχη	λέσχης	Case
γερακίνες	γερακίνα	Number
μαρκάρεις	μαρκάρουν	Person
εδώδιμη	εδώδιμος	Gender
συνεργασίας	συνεργασιών	Number
ανάμνησης	ανάμνηση	Case
ανήκε	ανήκαν	Person
κωπηλάτη	κωπηλάτης	Case
ιδεολογιών	ιδεολογίες	Case
υπόγειο	υπόγειος	Gender
Αιγύπτιας	Αιγύπτια	Case
ἐπενθετικαῖς	ἐπενθετικαί	Case
καθαρίστρια	χωρητικότητα	lemma
βούλησης	βούληση	Case
εταιρίας	εταιρία	Case
κεφάλαια	κεφαλαίων	Case
εισοδήματος	εισοδημάτων	Number
μπουρουντιανή	μπουρουντιανής	Case
πολυλεκτικές	πολυλεκτικών	Case
συνεχή	συνεχούς	Case
θρεπτῐκοῖς	ὑγροῖς	lemma
Αραβισσών	Αράβισσες	Case
προέλθει	προέλθουν	Person
βοιωτικών	βοιωτικά	Case
γυμναστές	γυμναστής	Number
μοβόρες	μοβόρα	Gender
σπουδαστές	σπουδαστής	Number
ενδιάμεσοι	ενδιάμεσος	Number
ανθρωποειδές	ανθρωποειδούς	Case
ζήσει	τσιμπήσει	lemma
συνάντησαν	συναντήσατε	Person
αραποσιτιού	αραποσίτι	Case
οροσειράς	οροσειρά	Case
αρρυθμίας	αρρυθμία	Case
αναγγελίας	αναγγελία	Case
μονομερείς	μονομερή	Gender
ευνούχοι	ευνούχος	Number
αγριοκοιταζόμουν	αγριοκοιταζόμασταν	Number
υγρά	υγρό	Number
πηρουνιών	πηρούνια	Case
πρωτόκολλα	πρωτοκόλλων	Case
ουσάρο	ουσάρε	Case
άθικτο	άθικτος	Case
λουκουμιών	λουκούμια	Case
υπολογισμού	υπολογισμών	Number
διαλύματα	διάλυμα	Number
αιμορροΐδα	αιμορροΐδας	Case
αντιπροσώπους	αντιπρόσωποι	Case
αριθμομηχανές	αριθμομηχανών	Case
ερωδιών	ερωδιοί	Case
αγλάιζε	αγλαΐζατε	Person
αηδόνι	αηδονιού	Case
μπαταρίας	μπαταριών	Number
πυροβόλων	πυροβόλα	Case
ρούχων	ρούχα	Case
αγκυλωμένων	αγκυλωμένα	Case
αχτίδας	αχτίδα	Case
πριόνι	πριονιού	Case
γλυκάνισου	γλυκάνισος	Case
έπαινοι	έπαινος	Number
έλκος	φράουλα	lemma
υπερφυσικό	υπερφυσικού	Case
μυρμηγκοφάγου	μυρμηγκοφάγε	Case
αρχές	αρχή	Number
κεφαλαιοκράτισσα	κεφαλαιοκράτισσας	Case
ανακουφίζονται	ανακουφίζεται	Person
βαριών	βαριές	Case
νευραλγίας	νευραλγία	Case
γηίνῳ	γηίνοις	Number
στυλών	στυλοί	Case
ανθρακικού	ανθρακικών	Number
υπερθετικών	υπερθετικά	Case
είναι	είμαι	Person
λοιμώξεων	λοιμώξεις	Case
βιομήχανοι	βιομηχάνους	Case
νεολιθικής	νεολιθική	Case
ανηψιές	ανηψιά	Number
ακίδων	ακίδες	Case
απασχολείται	απασχολούνται	Number
μούσες	μούσα	Number
ομιλήτριες	ομιλητριών	Case
καπνοπωλείο	καπνοπωλείου	Case
χαιρέτησαν	χαιρέτησα	Person
κελιών	κελιά	Case
κολαστήριο	κολαστήριου	Case
κάστρα	κάστρων	Case
τοποθετούσαν	τοποθετούσε	Person
πρωτόγονοι	πρωτόγονες	Gender
υπουργοί	υπουργών	Case
παλμοί	παλμών	Case
οκάδες	οκά	Number
βαρετέ	βαρετό	Gender
κτήνους	κτήνος	Case
αυτοέλεγχο	αυτοελέγχου	Case
αεράγημα	αεραγήματος	Case
λυπημένης	λυπημένη	Case
αιμοδότη	αιμοδότης	Case
καταχώρησης	καταχωρήσεων	Number
λευκαντικού	λευκαντικών	Number
ρόμβοι	ρόμβους	Case
άδενδρο	άδενδρη	Gender
λογισμικών	λογισμικά	Case
δραματικότερων	σφιχτότερων	lemma
ασύρματο	ασυρμάτου	Case
οίνους	οίνοι	Case
δρυμών	δρυμοί	Case
διαμορφωνόμαστε	διαμορφώνεσαι	Person
αγκίθας	αγκίθων	Number
αρνησιθρησκίες	αρνησιθρησκιών	Case
εφήβους	εφήβων	Case
ανοιξιάτικες	υποτελείς	lemma
αγύριστη	αγύριστο	Gender
ίδιες	ίδια	Number
περιστατικά	περιστατικό	Number
οξέος	οξύ	Case
αλατιστή	κουλή	lemma
λιτανείες	λιτανειών	Case
περιστέρας	περιστερών	Number
ατμών	ατμοί	Case
ασβού	ασβός	Case
ανεβάζει	ανεβάζω	Person
μοτοσικλέτες	μοτοσικλετών	Case
εκκεντρικότητα	εκκεντρικότητας	Case
δίδυμο	δίδυμη	Gender
επερώτησης	επερώτηση	Case
γύρους	γύρο	Number
Αλγερινή	Αλγερινής	Case
ζητιάνους	ζητιάνων	Case
διαμεσολαβητές	διαμεσολαβητή	Number
ταξίδεψες	ταξίδεψαν	Person
νικηφόρων	νικηφόροι	Case
πανθεϊσμό	πανθεϊσμός	Case
σφυριά	σφυρί	Number
πιέζεσαι	πιεζόσουν	Tense
αγώνα	αγώνος	Case
δῐᾰλῠτᾱ́	Ἐφεσία	lemma
λισσαῖν	λισσᾱ́	Case
μεθυλένιο	μεθυλενίου	Case
φεγγαριών	φεγγάρια	Case
επιγραφής	επιγραφών	Number
αιφνιδιασμός	πλευρονήκτης	lemma
φασολιάς	φασολιών	Number
μαντεύατε	μαντεύετε	Tense
παίκτες	παικτών	Case
φραγκοφονιάδων	φραγκοφονιάδες	Case
κατηγορούσα	κατηγορούσαν	Person
βοτανικές	βοτανική	Number
νεαραῖν	ὀχυραῖν	lemma
έχω	χρεώνω	lemma
νικητήριας	νικητήριου	Gender
ακίνητο	ακίνητα	Number
πρεσβειών	πρεσβείες	Case
πλοηγού	πλοηγός	Case
επιχειρήσεις	επιχείρηση	Number
ψηφοφόρους	ψηφοφόρων	Case
νοσοκόμοι	νοσοκόμος	Number
ναζιστικές	ναζιστική	Number
τροφίμου	τροφίμων	Number
ηρεμιστικών	ηρεμιστικά	Case
σκηνικό	σκηνικά	Number
συναντούσαν	συναντούσε	Person
κοσμοδρομίων	κοσμοδρόμια	Case
αερόσακοι	αερόσακος	Number
χαμένες	χαμένων	Case
γενναιοφρόνων	γενναιόφρονες	Case
διακανονισμοί	διακανονισμών	Case
σπασμοί	σπασμούς	Case
ορό	ορέ	Case
πηγάδια	πηγαδιών	Case
δαπέδων	δάπεδα	Case
ηλεκτρομαγνητικοί	ηλεκτρομαγνητικά	Gender
μάνταλου	μάνταλο	Case
ξαδέρφη	ξαδέρφης	Case
βιολογικής	βιολογικού	Gender
μεταβλητής	μεταβλητού	Gender
ανόδους	άνοδο	Number
ολύμπια	ολύμπιο	Number
ενυδρεία	ενυδρείων	Case
μάγισσα	μάγισσας	Case
έβενο	έβενος	Case
πίστες	πιστών	Case
στεπών	στέπες	Case
επισκέπτες	επισκέπτης	Number
επιτρέπει	επιτρέπω	Person
ανθρωπιστικότατα	παλαιότατα	lemma
αδαμάντινα	αδαμάντινο	Number
έμπορες	έμπορα	Number
στερλίνες	στερλινών	Case
αγγλοσαξωνικού	πελώριου	lemma
δυσπιστία	δυσπιστίας	Case
πρόγνωση	πρόγνωσης	Case
κανιβάλους	κανίβαλοι	Case
χρεωκοπίες	χρεωκοπία	Number
τρυπανιού	τρυπάνι	Case
μάτωσα	μάτωσαν	Person
ταχυδρόμων	ταχυδρόμοι	Case
διαφωνείτε	διαφωνείς	Person
τρελαίνουμε	τρελαίνουν	Person
πυκνότητα	πυκνότητας	Case
προστάτεψα	προστάτεψε	Person
γηροκομείου	γηροκομείο	Case
αμυγδαλωτά	αμυγδαλωτό	Number
απλούστεροι	πολυτιμότεροι	lemma
κοκοφοίνικες	κοκοφοίνικα	Number
αιλουροειδή	αιλουροειδές	Number
φούρνου	φούρνε	Case
τριανταφυλλιά	τριανταφυλλιάς	Case
αριστεροί	αριστερές	Gender
εμπρησμό	εμπρησμού	Case
άδωρες	άδωρους	Gender
αποκέντρωση	αποκέντρωσης	Case
απαραίτητη	απαραίτητης	Case
κατάσκοπο	κατάσκοπος	Case
ημιόροφοι	ημιόροφος	Number
γερουνδίου	γερουνδίων	Number
διατροφές	διατροφή	Number
αποθετικές	αποθετικά	Gender
εξωγήϊνη	σαρκική	lemma
τυροπήγματα	τυρόπηγμα	Number
δημοτική	δημοτικής	Case
πρόδρομο	πρόδρομος	Case
ζύμης	ζυμών	Number
φωτόσπαθων	φωτόσπαθα	Case
σαρκοβόρο	σαρκοβόρα	Gender
ακρίδας	ακρίδα	Case
ξιφομάχου	ξιφομάχων	Number
τεϊομαντείας	τεϊομαντεία	Case
άνοδοι	άνοδε	Number
έχετε	έχε	Number
γκόμενες	γκόμενα	Number
οπλές	οπλή	Number
μοίρες	μοιρών	Case
βολφράμιο	βολφραμίου	Case
πιονίου	πιονίων	Number
αιμοσφαιρίνες	αιμοσφαιρίνη	Number
θερμίδες	θερμίδων	Case
πολλαπλής	πολλαπλή	Case
ασπίδων	ασπίδες	Case
τηλεοράσεις	τηλεόραση	Number
απογοητεύτηκαν	απογοητευτούν	Tense
εργοδότες	εργοδότη	Number
προβιομηχανικοί	προβιομηχανικά	Gender
διαγωνιζόμενου	διαγωνιζόμενων	Number
σάβανα	σάβανο	Number
φαροφύλακα	φαροφύλακας	Case
βιομηχανικέ	τοξικέ	lemma
αντιπρόεδροι	αντιπροέδρους	Case
μισθωτές	μισθωτών	Case
αντωνυμιών	αντωνυμίες	Case
Βησιγότθοι	Βησιγότθε	Number
χαμηλών	χαμηλούς	Case
μετασχηματιστές	μετασχηματιστής	Number
ολόκληροι	ολόκληρων	Case
ύδατα	υδάτων	Case
οχήματος	όχημα	Case
πιστώσεις	πιστώσεων	Case
πανικοβάλλεται	πανικοβάλλονται	Number
αποτυπώματος	αποτύπωμα	Case
χρονοδιαγραμμάτων	χρονοδιαγράμματα	Case
εμμηνόπαυση	εμμηνόπαυσης	Case
Λευκορωσικά	τεκτονική	lemma
γλάρους	γλάρο	Number
συνήθων	συνήθους	Number
αγιορείτες	αγιορείτη	Number
μπαξέδες	μπαξέ	Number
συνεντεύξεις	συνέντευξη	Number
υάκινθους	υάκινθοι	Case
δρομολογητών	δρομολογητές	Case
παγωτών	παγωτά	Case
πληρώνουν	πληρώνεις	Person
χωρικά	χωρικούς	Gender
αγάπιζες	αγαπίζεις	Tense
δήμαρχοι	δήμαρχε	Number
εορτών	εορτές	Case
παπαγάλοι	παπαγάλος	Number
αιφνιδιαστική	αιφνιδιαστικές	Number
προχωράμε	προχωράνε	Person
αδιαχώριστο	αδιαχώριστα	Number
συγγραφείς	συγγραφέα	Number
ιδιότητες	ιδιοτήτων	Case
ξυπνούσαμε	ξυπνούσατε	Person
μετασχηματισμούς	μετασχηματισμό	Number
ωφελούν	ωφελεί	Number
δήμαρχου	δήμαρχος	Case
εθνικόφρονες	εθνικοφρόνων	Case
τσακωμό	τσακωμού	Case
παράσιτα	παρασίτων	Case
επανόδου	επανόδων	Number
αναστατωθήκατε	καταφέρατε	lemma
κρατική	κρατικές	Number
ηθικά	μῡρίᾰ	lemma
αλμάτων	άλματα	Case
άκαμπτους	άκαμπτο	Number
τμήματα	τμήμα	Number
υψικαμίνους	υψικάμινο	Number
διαιτητικής	διαιτητικών	Number
φασιστών	φασίστες	Case
ορισμοί	ορισμούς	Case
λιπαντικών	λιπαντικά	Case
αδικαιολόγητη	κούφια	lemma
χρονοδιαγράμματα	χρονοδιάγραμμα	Number
άνοιγαν	άνοιγε	Number
αβδηριτών	αβδηρίτες	Case
κοπαδιού	κοπαδιών	Number
συντεχνίτισσες	συντεχνίτισσα	Number
αντισυλληπτικό	αντισυλληπτική	Gender
μπάρμπα	μπάρμπας	Case
βάζονται	σκουντούν	lemma
προαγωγό	προαγωγού	Case
καταρράχτη	πράσου	lemma
κλουβί	κλουβιού	Case
ζυγοί	ζυγός	Number
μοναχό	μοναχός	Case
αγχιστεία	χημεία	lemma
κάννες	καννών	Case
κοράκια	κορακιών	Case
κιλά	κιλών	Case
προσεταιριστική	προσεταιριστικής	Case
κυτταρικό	κυτταρικός	Gender
αντωνυμίας	αντωνυμιών	Number
αγαπόρνιθα	αγαπόρνις	Case
αγιορειτών	αγιορείτες	Case
εκτίμησες	εκτιμήσατε	Person
ενετικές	ενετικούς	Gender
βενετσιάνικες	βενετσιάνικα	Gender
συμπληρώνουμε	συμπληρώνω	Person
Αἰολικώ	ἁγίω	lemma
στερεό	στερεά	Number
ομηρίας	ομηρία	Case
κόπτη	κόπτης	Case
καστανό	καστανά	Number
θέληση	θέλησης	Case
ξακουστούς	ξακουστοί	Case
βουτά	βουτάτε	Person
ναζιστές	ναζιστή	Number
λεπτονίων	λεπτόνια	Case
αναερόβιο	αναερόβια	Gender
γιατρέψει	σκαλίσει	lemma
φτυάρια	φτυάρι	Number
ακοίμητων	ακοίμητες	Case
αποφεύγετε	αποφεύγουν	Person
συνδρομητών	συνδρομητές	Case
ψέματα	ψέμα	Number
ανθρωπολόγου	ανθρωπολόγων	Number
πειρατές	πειρατή	Number
εισάγεις	εισάγει	Person
καταστρέφω	καταστρέφει	Person
φακέλων	φάκελοι	Case
ακατέργαστη	ακατέργαστο	Gender
αβράχνιαστα	αβράχνιαστων	Case
γομφίου	γομφίων	Number
υδραυλικών	υδραυλικά	Case
αιχμαλωτισμοί	αιχμαλωτισμέ	Number
τζίροι	τζίρων	Case
ανθρωποκτονίες	ανθρωποκτονιών	Case
ακηλίδωτου	ακηλίδωτος	Case
υπολογιστές	υπολογιστής	Number
ναυαγοσώστες	ναυαγοσώστης	Number
εριστικότερα	τυχερότερα	lemma
κατάκλειστης	κατάκλειστη	Case
αντίθετη	κεντρική	lemma
καπνοδόχο	καπνοδόχος	Case
γυπαετοί	γυπαετέ	Number
παράπονα	παράπονο	Number
αβάπτιστοι	αβάπτιστε	Number
γλύπτριες	γλύπτρια	Number
ηπειρωτικών	ηπειρωτικού	Number
αισθητή	αισθητός	Gender
λουκάνικου	λουκάνικο	Case
αμοιβαίων	αμοιβαίους	Case
θρήνοι	θρήνος	Number
αλογόμυγα	αλογόμυγας	Case
αποζημιωθήκατε	αποζημιώθηκες	Person
πιανίστριες	πιανίστρια	Number
κόκκινα	κοκκίνων	Case
χρυσαυγίτες	χρυσαυγίτη	Number
αλιάετο	αλιάετος	Case
αγκλίτσες	αγκλίτσα	Number
κρυφτών	κρυφτά	Case
νομολογίας	νομολογία	Case
φαραγγιών	φαράγγια	Case
ζητιάνων	ζητιάνοι	Case
σιδηρουργού	σιδηρουργών	Number
γρύλοι	γρύλων	Case
εκτελεστή	εκτελεστών	Number
κάνετε	κάνουμε	Person
πανελλήνιοι	πανελλήνιων	Case
μαρμαρέοιν	μαρμαρέου	Number
εκλογές	εκλογών	Case
Μαλγάσιο	Μαλγάσιου	Case
λεβιστικού	λεβιστικό	Case
βάσιμη	βάσιμες	Number
πλαστός	πλαστό	Gender
τόννους	τόννο	Number
επωδούς	επωδών	Case
αποφασίστηκα	αποφασιστήκαμε	Person
Ἀρῐστοφᾰ́νειος	Ἀρῐστοφᾰ́νειοι	Number
αδόκιμων	ἄλβων	lemma
Καπουτσίνοι	Καπουτσίνων	Case
προφοράς	προφορά	Case
κανονισμούς	κανονισμών	Case
ανέφερα	ανέφεραν	Person
αιματηρά	τιμητικᾰ́	lemma
συμπτώσεις	συμπτώσεων	Case
αναστολής	αναστολή	Case
οδηγούν	οδηγείς	Person
συνηγόρους	συνήγορο	Number
κόμποι	κόμπων	Case
ακαλαίσθητες	ακαλαίσθητη	Number
αναμνηστικό	αναμνηστική	Gender
εικονικό	εικονικός	Case
ολόκαινος	ολόκαινο	Case
μαύρων	μαύρου	Number
παρκαδόρο	παρκαδόρε	Case
κηπευτική	κηπευτικό	Gender
μαχαιριών	μαχαίρια	Case
ερωτιάρη	ερωτιάρης	Case
μπανανιές	μπανανιά	Number
μετασχηματιστές	μετασχηματιστών	Case
αβρότητας	αβρότητα	Case
μελετάστε	μελετώνται	Person
αποδιοπομπαίος	αποδιοπομπαίου	Case
γάτες	γατών	Case
αντιύλη	αντιύλης	Case
πολεμικός	πολεμική	Gender
προξενεία	προξενείων	Case
παίζουμε	παίζαμε	Tense
ημίψηλου	ημίψηλο	Case
δοκιμάστηκαν	ένιωσαν	lemma
εγκληματίες	εγκληματίας	Number
διαρρήξεις	διάρρηξη	Number
φαρμακοποιών	φαρμακοποιοί	Case
δείγματος	δείγμα	Case
πέμπτων	πέμπταις	Case
φοβέρα	φοβέρας	Case
αγωγές	αγωγών	Case
ναυαγοσωστών	ναυαγοσώστες	Case
διαφορών	διαφορές	Case
γυριστώ	γυριστούμε	Number
διάκρισης	διάκριση	Case
μωρώ	ἕνω	lemma
πορτοκαλεώνες	πορτοκαλεώνα	Number
σημειωματάρια	σημειωματάριο	Number
έμμετρη	έμμετρο	Gender
εθισμένοι	εθισμένα	Gender
σώγαμπροι	σώγαμπρους	Case
άρκτου	άρκτων	Number
ατυχήματος	ατυχημάτων	Number
ημερολόγια	ημερολόγιο	Number
μοριακά	μοριακοί	Gender
ακλήτευτα	ακλήτευτους	Gender
περιοδικού	περιοδικών	Number
εκπαιδευτές	εκπαιδευτή	Number
παρθένας	παρθένα	Case
οικονόμο	οικονόμος	Case
αποστόλων	απόστολοι	Case
ακατάσβεστα	ακατάσβεστες	Gender
χειροκροτημάτων	χειροκροτήματα	Case
γύρης	κούνιας	lemma
κρίσιμους	κρίσιμοι	Case
πωλητές	πωλητή	Number
αναμνηστικών	αναμνηστικά	Case
ανδρική	ανδρικές	Number
ανήκουμε	ανήκω	Person
περιηγητικά	περιηγητικών	Case
εξωγήινοι	εξωγήινων	Case
γλυπτά	γλυπτών	Case
ψυχολόγους	ψυχολόγο	Number
λεπτά	λεπτό	Number
μεσάζοντος	μεσάζων	Case
μετράς	μετρούμε	Person
γαμοσταυρίζετε	χωράτε	lemma
μυγδάλων	μύγδαλα	Case
κατάσκοποι	κατασκόπους	Case
ανάμνησης	αναμνήσεων	Number
εξασφαλιστεί	εξασφαλιστείς	Person
Σέρβους	Σέρβοι	Case
ουράς	ουρών	Number
θυμιατήρια	θυμιατήρι	Number
θερμικά	θερμικές	Gender
κινούσε	κινούσαμε	Person
διοικητική	διοικητικής	Case
φοράτε	φόρα	Person
τμημάτων	τμήματα	Case
υποχρεώνει	υποχρέωνε	Tense
Βυζαντινού	Βυζαντινέ	Case
λαγό	λαγός	Case
στεριές	στεριά	Number
μυστήρια	μυστηρίων	Case
βαρέλι	βαρελιού	Case
ιδιοσυγκρασίες	ιδιοσυγκρασία	Number
θαυμάσιου	θαυμάσιο	Case
φορτηγά	φορτηγό	Number
ανθρωπολόγο	ανθρωπολόγου	Case
κυβέρνησα	κυβερνήσατε	Person
προετοιμαστήκατε	προετοιμάστηκες	Number
συμπτώσεις	σύμπτωση	Number
τραμουντάνα	τραμουντάνας	Case
εξορίζετε	εξορίζεις	Number
σκεπτικισμού	σκεπτικισμός	Case
εμπιστεύτηκες	εμπιστευτείς	Tense
στεφάνια	στεφάνι	Number
εύγευστο	εύγευστα	Number
εντατική	παρούσα	lemma
αγοραπωλησίας	αγοραπωλησία	Case
φεμινίστριες	φεμινιστριών	Case
κάθετοι	κάθετων	Case
σκόρε	σκόρος	Case
αιλουροειδούς	αιλουροειδών	Number
οψιδιανού	οψιδιανών	Number
μυωπική	μυωπικέ	Gender
μαλινέζικα	μαλινέζικους	Gender
ανόητους	ανόητα	Gender
ενόχλησα	ενοχλήσαμε	Person
εισοδήματα	εισόδημα	Number
ανθρακωρυχεία	ανθρακωρυχείο	Number
συντάξεις	σύνταξη	Number
λοβοί	λοβών	Case
χτυπήματα	χτυπημάτων	Case
επιθυμίας	επιθυμία	Case
τριγώνου	τρίγωνο	Case
ανταλλάγματα	αντάλλαγμα	Number
γαϊδάρους	γάιδαροι	Case
θάμνο	θάμνου	Case
ευτυχία	ευτυχίας	Case
δορυφόρου	δορυφόρων	Number
δροσίζετε	δροσίζουμε	Person
βοήθεια	βοήθειας	Case
προσπάθειας	προσπαθειών	Number
πατριάρχη	πατριάρχης	Case
ορυκτολόγοι	ορυκτολόγε	Number
γύρου	γύρων	Number
βερύκοκκα	βερύκοκκο	Number
άνεργους	άνεργων	Case
επιχειρησιακών	επιχειρησιακές	Case
ματιές	ματιών	Case
ανθρακωρύχου	ανθρακωρύχων	Number
επίπεδου	επίπεδης	Gender
δραματικά	δραματικών	Case
σιχαίνομαι	σιχαινόμαστε	Person
μεγαλούτσικε	μεγαλούτσικο	Case
εχθρό	εχθρού	Case
μήνυμα	μηνύματος	Case
μειώσεις	μείωση	Number
ταύρους	ταύρο	Number
ναύλους	ναύλοι	Case
άζωτο	αζώτου	Case
αφαλατώσεις	αφαλατώσεων	Case
ακρωνύμια	ακρωνύμιο	Number
επίγειο	επίγεια	Number
μπάτσου	μπάτσος	Case
καλαμιδιών	καλαμίδια	Case
βενετικούς	βενετικοί	Case
παρόρμηση	παρόρμησης	Case
εξάδελφοι	εξαδέλφων	Case
αλατίσματος	αλατισμάτων	Number
συγκινήσεων	συγκινήσεις	Case
γεμίσεις	γέμιση	Number
διοργάνωσαν	διοργάνωσε	Number
αχλάδες	αχλάδων	Case
εκθεμάτων	εκθέματα	Case
εναλλασσόμενων	ἀκαδημικῶν	lemma
συντρόφου	σύντροφε	Case
έξη	έξης	Case
κτηνοτρόφοι	κτηνοτρόφος	Number
όρνιθες	ορνίθων	Case
λεωφόρους	λεωφόρο	Number
ζαχαρωτών	ζαχαρωτά	Case
αστικού	αστικών	Number
στιλέτων	στιλέτα	Case
υπουργού	υπουργός	Case
τριπλά	τριπλούς	Gender
φιλάνθρωπων	φιλάνθρωπες	Case
δάνεια	δάνειο	Number
τζάμια	τζάμι	Number
άλατος	αλάτων	Number
Αβησσυνού	Αβησσυνός	Case
τέκνα	τέκνων	Case
σταματούμε	σταματάς	Person
δοκιμάσατε	δοκιμάσαμε	Person
καρυδιές	μπουζούκια	lemma
αεροπορικής	αεροπορικού	Gender
αμφιβάλαμε	αμφέβαλαν	Person
αγαλματιδίων	αγαλματίδια	Case
εσπέρα	εσπέρας	Case
παρακείμενο	παρακείμενος	Case
κουρκούτι	κουρκουτιού	Case
απλούστερος	πολυτιμότερος	lemma
εξέλιξης	εξελίξεων	Number
εκατόνταρχου	εκατόνταρχος	Case
μορίου	μορίων	Number
πισωκολλητό	πισωκολλητού	Case
διαιρετοί	διαιρετέ	Number
τόλμη	τόλμης	Case
αβούλωτε	αβούλωτοι	Number
θωρακισμένο	θωρακισμένη	Gender
μπισκότα	μπισκότων	Case
πιγκουίνους	πιγκουίνο	Number
σενεγαλέζικους	σενεγαλέζικο	Number
γλυκά	μώλοι	lemma
γιαλού	γιαλών	Number
βάρα	βαρέστε	Number
ρητορικών	ρητορικού	Number
σικελιώτικης	σικελιώτικη	Case
γυναίκες	γυναίκα	Number
βακτηριδίου	βακτηριδίων	Number
βρακιά	βρακιών	Case
πολιτιστικά	πολιτιστικοί	Gender
διήθηση	διήθησης	Case
πόρτας	πόρτα	Case
περούκας	περουκών	Number
βουβάλια	βουβάλι	Number
γενετική	γενετικής	Case
συμφώνησες	συμφώνησε	Person
ανεξέλεγκτους	ανεξέλεγκτες	Gender
υπερασπιστούν	υπερασπιστούμε	Person
δραματουργοί	δραματουργέ	Number
αυγών	αυγά	Case
φόνων	φόνοι	Case
καταθέσεων	καταθέσεις	Case
εξεγείρει	εξεγείρουμε	Person
παστίλιας	παστίλια	Case
γεύσεων	γεύσεις	Case
τρεχόντων	τρέχοντα	Case
αποτελεσματικά	αποτελεσματικούς	Gender
ανταποκριτές	ανταποκριτών	Case
καστανιών	καστανιές	Case
ορισμούς	ορισμών	Case
ναυπηγεία	ναυπηγείο	Number
Βολιβιανού	Βολιβιανών	Number
αστακό	αστακός	Case
κατούρησε	κατουρήσαμε	Person
λαούτου	λαούτο	Case
υβρίδια	υβρίδιο	Number
νυκτερινέ	νυκτερινή	Gender
στρεπτόκοκκου	στρεπτόκοκκος	Case
πάρκαρε	παρκάρει	Tense
Αυστραλέζους	Αυστραλέζοι	Case
εκκεντρικότητας	εκκεντρικότητα	Case
ανακτάσαι	ανακτάστε	Person
πολλαπλασιασμού	πολλαπλασιασμών	Number
κερί	κεριού	Case
φαρμακεία	φαρμακείων	Case
μαλάκα	μαλάκας	Case
δικαστήρια	δικαστήριο	Number
θερμική	θερμικό	Gender
πρέσβειρα	πρέσβειρας	Case
εννοείς	εννοούμε	Person
πανιού	πανιών	Number
αποχώρησης	πατινιού	lemma
φραγκοστάφυλων	φραγκοστάφυλα	Case
ενδιαφέροντος	ενδιαφερόντων	Number
πίστας	πιστών	Number
κυκλοφορήσαμε	κυκλοφόρησαν	Person
λατίνια	λατίνι	Number
φούρναρη	φουρνάρηδων	Number
επίθετα	επίθετο	Number
γενετικές	γενετική	Number
μαρμελάδα	μαρμελάδας	Case
τηλεόραση	τηλεόρασης	Case
πέργκολες	πέργκολα	Number
βολβό	βολβός	Case
ανδρικό	ανδρική	Gender
αντισυλληπτικών	αντισυλληπτικά	Case
ξενιτιά	ξενιτιάς	Case
πυκνότητας	πυκνοτήτων	Number
γηίνω	ψεδνώ	lemma
παράγοντες	παράγοντα	Number
αρτοποιό	αρτοποιός	Case
τεκτονισμό	τεκτονισμού	Case
αδικημένες	αδικημένα	Gender
χριστιανικά	χριστιανικούς	Gender
άχρηστο	άχρηστη	Gender
βρώμιο	βρωμίου	Case
σκοπεύεις	σκοπεύω	Person
ανθρωπολογική	ανθρωπολογικό	Gender
οργανικού	οργανικών	Number
καθηγητές	καθηγητής	Number
βιομηχάνου	βιομηχάνων	Number
δεκαδικοί	δεκαδικών	Case
φρένα	φρένο	Number
οφθαλμοί	οφθαλμών	Case
πέψη	πέψης	Case
βιώσιμε	ἐνθετικέ	lemma
παντοπωλείων	παντοπωλεία	Case
πεθαίνουμε	πεθαίνεις	Person
ενοικιάστριων	ενοικιάστριες	Case
προσωρινές	προσωρινών	Case
κολητσίδα	κολητσίδας	Case
σιρόκε	σιρόκος	Case
ξυλουργούς	ξυλουργοί	Case
ρηχότερης	ρηχότερη	Case
αιωροπτερισμοί	αιωροπτερισμέ	Number
λαογράφο	λαογράφου	Case
αναχαίτισης	αναχαίτιση	Case
βιασμού	βιασμέ	Case
ιστίων	ιστία	Case
αγωνιστικότερη	αγωνιστικότερο	Gender
βάσταξαν	βαστάξατε	Person
ζύμωση	ζύμωσης	Case
λυκάνθρωπου	λυκάνθρωπε	Case
κοιτάχτηκαν	κοιταχτούν	Tense
ζάρια	ζάρι	Number
αγαπητή	αγαπητές	Number
νεκροταφείου	νεκροταφείων	Number
γυμνάστριας	γυμνάστρια	Case
βάζεσαι	παραλαβαίνεις	lemma
γυιοί	γυιούς	Case
διάνυσμα	διανύσματος	Case
ανεμοστρόβιλους	ανεμοστρόβιλων	Case
αράπηδες	αράπης	Number
ὀσμητώ	ὀσμητοῖν	Case
βάρδια	βάρδιας	Case
ανακαλύπταμε	ανακαλύπτουμε	Tense
φαρμακευτική	φαρμακευτικής	Case
Ούγγροι	Ούγγρους	Case
διαιτολόγιο	διαιτολογίου	Case
ποντικό	ποντικός	Case
ανοιχτότατο	περιπλοκότατο	lemma
σοσιαλίστριας	σοσιαλίστρια	Case
δακτυλιδιών	δακτυλίδια	Case
τσιμπουκότρυπες	τσιμπουκότρυπα	Number
αλφάβητο	αλφάβητος	Case
ψαράδων	ψαράδες	Case
παγίδας	παγίδων	Number
πρόβατα	πρόβατο	Number
ισχυρότατος	χοντρότατος	lemma
επισκόπων	επίσκοποι	Case
αποχώρησης	αποχώρηση	Case
εκσκαφή	εκσκαφής	Case
Ιταλούς	Ιταλών	Case
όλη	όλος	Gender
νεόπλαστη	νεόπλαστης	Case
μαντεύουν	μαντεύω	Person
παλιρροϊκών	παλιρροϊκά	Case
υποχρεωτικά	υποχρεωτικό	Number
εγκληματικό	εγκληματικού	Case
υδατογράφημα	υδατογραφήματος	Case
ερωτηματική	ερωτηματικές	Number
φούρνους	φούρνοι	Case
μουσκέτο	μουσκέτου	Case
έχεις	έχετε	Person
σκλάβους	σκλάβο	Number
χιονοθυελλών	χιονοθύελλες	Case
Ισλανδές	Ισλανδή	Number
ουρακοτάγκο	ουρακοτάγκου	Case
λέμβο	λέμβος	Case
διέψευσα	διέψευσες	Person
ακολουθούμαι	ακολουθούμαστε	Person
αδυναμίες	αδυναμιών	Case
προωθητές	προωθητών	Case
απαντάτε	απάντησε	Person
περπατάτε	περπάτα	Person
αντιτύπων	αντίτυπα	Case
ανύπαντρο	ανύπαντρη	Gender
απογοητεύεται	απογοητεύονται	Number
αυστηρότητες	αυστηρότητα	Number
δαιμόνων	δαίμονες	Case
διασκεδάστριας	διασκεδαστριών	Number
τρομπονιού	τρομπόνι	Case
νέγρα	νέγρας	Case
αναρχισμού	αναρχισμός	Case
επιτραπέζιων	ισχυόντων	lemma
αγαπητό	αγαπητού	Case
τσέπες	τσέπη	Number
σκοτάδι	σκοταδιού	Case
μούρο	μούρου	Case
βούρλων	βούρλα	Case
ελέγχων	έλεγχοι	Case
γέμιζα	συμπληρωνόμουν	lemma
κάρβουνων	κάρβουνα	Case
παρονομαστή	παρονομαστής	Case
δρυός	δρυς	Case
ηπειρωτικές	ηπειρωτικά	Gender
μετοχών	μετοχές	Case
βάλτου	βάλτος	Case
κηδεμόνα	κηδεμόνας	Case
ακατέβατων	ακατέβατης	Number
ουδέτερα	ουδετέρων	Case
ψεύτρα	ψεύτρας	Case
γλάροι	γλάρους	Case
βόδι	βοδιού	Case
δεθεί	πανικοβληθεί	lemma
Μαυριτανούς	Μαυριτανό	Number
αυταδέλφους	αυτάδελφοι	Case
πέρασαν	περάσαμε	Person
συστατικό	συστατικά	Number
διάνοι	διάνων	Case
έρευνας	έρευνα	Case
αλεπούς	αλεπούδων	Number
ανακαλύπτεις	κουρεύεις	lemma
συγκροτήματα	συγκροτημάτων	Case
τσιγκούνες	τσιγκούνα	Number
λογότυποι	λογότυπος	Number
αγαποβότανα	αγαποβότανων	Case
αετών	αετοί	Case
ουρανό	ουρανέ	Case
αγκολέζικου	αγκολέζικο	Case
χωριάτικο	χωριάτικος	Gender
ισχύς	ισχύων	Case
ἀερίνα	ἀερίνω	Gender
τζαμί	τζαμιού	Case
μαγειρικώ	μαγειρικοί	Number
δοκίμαζε	δοκιμάζει	Tense
παρουσίαζε	παρουσιάζετε	Number
υπερκείμενη	υπερκείμενο	Gender
ζώδια	ζωδίων	Case
καημένε	καημένη	Gender
συλλέκτριες	συλλέκτρια	Number
προειδοποίηση	προειδοποίησης	Case
ετοιματζίδικης	ετοιματζίδικη	Case
σουσάμι	σουσαμιού	Case
ρυθμούς	ρυθμών	Case
γύψο	γύψου	Case
νηρηίδων	νηρηίδες	Case
βλαστού	βλαστών	Number
διπλών	διπλούς	Case
αυλών	αυλές	Case
παρονομαστών	παρονομαστές	Case
αναρχισμό	αναρχισμός	Case
αμνούς	αμνό	Number
ετήσιο	ετήσια	Number
αγκομαχούσαν	αγκομαχούσαμε	Person
μέλλουσες	μέλλοντες	Gender
αποχτούμε	αποχτούσαμε	Tense
τούρκικο	τούρκικη	Gender
μεταβλητά	μεταβλητές	Gender
διαιτολογίων	διαιτολόγια	Case
ζευγάρια	ζευγάρι	Number
α	οι	Gender
ακτής	ακτών	Number
εριστικότερου	τυχερότερου	lemma
αρχιναύαρχο	αρχιναύαρχος	Case
νυμφευμένη	νυμφευμένος	Gender
μελάνια	μελανιών	Case
ανταγωνισμού	ανταγωνισμός	Case
αεροναυπηγικής	αεροναυπηγική	Case
κατοίκησες	κατοίκησα	Person
λαιμητόμο	λαιμητόμου	Case
ιστοσελίδα	ιστοσελίδας	Case
άλογα	άλογο	Number
ημερήσιας	ημερήσιου	Gender
αγγλόφωνων	αγγλόφωνοι	Case
ολύμπιου	ολύμπιο	Case
δρυών	δρύες	Case
προσκόπου	πρόσκοπος	Case
ραββίνου	ραββίνων	Number
κεντρίζετε	κέντρισε	Person
πατριώτη	πατριωτών	Number
ξενοδοχείου	ξενοδοχείο	Case
χιόνι	χιονιού	Case
κατευναστείτε	κατευναστούν	Person
καταστρώματος	καταστρωμάτων	Number
αβερνίκωτους	αβερνίκωτοι	Case
ήταν	κτιζόταν	lemma
ανάποδο	ανάποδος	Gender
αντισυλληπτική	αντισυλληπτικό	Gender
χονδρεμπόρους	χονδρέμποροι	Case
στολών	στολές	Case
νικητήριος	νικητήριο	Gender
μετάξι	μεταξιού	Case
ελεγκτές	ελεγκτή	Number
αγκιστριού	αγκιστριών	Number
κυρτός	κυρτή	Gender
βιολίστριες	βιολίστρια	Number
ξερή	ξερό	Gender
φύλα	φύλο	Number
θεάτρου	θεάτρων	Number
κρίσιμο	κρίσιμη	Gender
πράκτορες	πρακτόρων	Case
ελλαδικό	ελλαδικού	Case
γλυκερίνη	γλυκερίνης	Case
αγριάνθρωπο	αγριανθρώπου	Case
υπολογισμούς	υπολογισμό	Number
τερηδόνας	τερηδόνα	Case
γλάρους	γλάροι	Case
λέξη	λέξης	Case
ταπετσαρίες	ταπετσαρία	Number
ημίθεου	ημίθεε	Case
έθνους	έθνος	Case
αβάσιμων	αβάσιμα	Case
τοποθεσίες	τοποθεσία	Number
αεριωθούμενων	αεριωθούμενα	Case
άβροχοι	άβροχους	Case
γνώση	γνώσης	Case
τηλεπαιχνίδια	τηλεπαιχνίδι	Number
ακέριο	ακέρια	Number
γραφτών	προσωρινών	lemma
αδάπανους	αδάπανοι	Case
άλικα	άλικων	Case
έρευνας	ερευνών	Number
στρατηγικές	στρατηγική	Number
φρύδια	φρύδι	Number
χρώματος	χρώμα	Case
σιωπηρή	σιωπηρής	Case
περιβόλια	περιβόλι	Number
όρχι	όρχις	Case
έχετε	έχε	Person
όντων	όντα	Case
φοράδες	φοράδα	Number
κομμουνιστικών	κομμουνιστικοί	Case
λαογράφους	λαογράφοι	Case
σικελικούς	σικελικό	Number
ονομασίες	ονομασία	Number
αμμώνιο	αμμώνιου	Case
χρονοδιαγράμματος	χρονοδιάγραμμα	Case
κυπρίνοι	κυπρίνους	Case
σοδομισμέ	σοδομισμός	Case
καθαριστές	καθαριστής	Number
ασκαλώνιων	ασκαλώνια	Case
προσήμου	προσήμων	Number
ενωνόταν	ενώνονταν	Person
ηλιοστασίου	ηλιοστάσιο	Case
περιφραστικά	περιφραστικές	Gender
φραπέ	φραπές	Case
φάρυγγα	φάρυγγας	Case
αυτοματικού	αυτοματικό	Case
διοχετεύοντας	καταλαβαίνοντας	lemma
διαιτολογίου	διαιτολόγιο	Case
ετρουσκικές	ετρουσκική	Number
ἐλευθέροιν	ἐλευθέρω	Case
νοτιοανατολικά	νοτιοανατολικοί	Gender
απαντούσαμε	σκαλίζαμε	lemma
καταφεύγω	καταφεύγουμε	Person
σημάδια	σημαδιών	Case
γκρεμνό	γκρεμνού	Case
αθρυμμάτιστα	παροιμιακά	lemma
χάρης	χάρη	Case
βαριάς	βαριά	Case
δεκάλεπτη	φιλανθρωπική	lemma
κρυστάλλωσης	κρυστάλλωση	Case
ακουστικό	ακουστικά	Number
σερβιτόροι	σερβιτόρε	Number
έχω	έχει	Person
άποικοι	άποικος	Number
διαπρακτικαῖν	ἐκθετικαῖν	lemma
σίγουρης	σίγουρη	Case
αρχής	αρχών	Number
λάδια	λαδιών	Case
υφάσματα	ύφασμα	Number
γραφτά	πρωκτικά	lemma
γαλέρας	γαλερών	Number
ορχιδέας	ορχιδέων	Number
πουλερικά	πουλερικό	Number
εντατικών	εντατικής	Number
ενοχλήσεις	ενοχλήσεων	Case
χαλά	χαλώ	Person
ανέχονταν	ανεχόταν	Person
είπες	είπαμε	Person
ασπίδες	ασπίδα	Number
μωραῖς	φανεραῖς	lemma
ταχύτητας	ταχυτήτων	Number
φρέσκαρα	φρεσκάραμε	Person
αιώνες	αιώνων	Case
πολιούχοι	πολιούχων	Case
αντιμετώπιζε	έκρυβε	lemma
άνδρα	άνδρας	Case
δήμαρχοι	δήμαρχος	Number
έχω	έχουμε	Number
υπενθυμίσεις	υπενθύμιση	Number
γερμανική	γερμανικό	Gender
κουνάβια	κουνάβι	Number
δαχτυλικό	δαχτυλική	Gender
βλάχοι	βλάχος	Number
περιορίζετε	περιόρισε	Person
λαδί	λαδιού	Case
αγγελικών	αγγελικές	Case
άλατα	άλας	Number
αυτόγραφου	αυτόγραφων	Number
εκσκαφές	εκσκαφών	Case
εκτιμούν	εκτιμάτε	Person
συνταξιούχο	συνταξιούχου	Case
βοήθησαν	βοήθησε	Person
επινόησης	επινοήσεων	Number
αγριογούρουνων	αγριογούρουνα	Case
αποστόλους	απόστολοι	Case
ναυτίας	ναυτία	Case
καταλανικής	καταλανική	Case
πιόνι	πιονιού	Case
πετσέτες	πετσέτα	Number
αισθητήρια	αισθητήριο	Number
επιθέσεων	επιθέσεις	Case
πλίθινου	πλίθινο	Case
τρυπώ	τρυπούσα	Tense
φραγμοί	φραγμούς	Case
σκιοφωτισμό	σκιοφωτισμέ	Case
επίβαλλε	λάβαινε	lemma
όλου	όλος	Case
ορμόνες	ορμονών	Case
νιώθουν	ένιωθαν	Tense
ξενιστή	ξενιστών	Number
εντατικών	ρακών	lemma
εμπόρους	έμπορο	Number
ανακτά	ανακτούσε	Tense
αποφρακτικό	αποφρακτική	Gender
εκπλήξεις	έκπληξη	Number
λογχίστε	λόγχιζε	Number
έλκος	έλκους	Case
αμύγδαλα	αμυγδάλων	Case
καπέλων	καπέλα	Case
γνωστοποιήσεις	γνωστοποιήσεων	Case
λυκείου	λύκειο	Case
σίελο	σιέλου	Case
πατάτας	πατατών	Number
κοινωνίας	κοινωνιών	Number
αρχικές	αρχικά	Gender
αντιβιοτικά	αντιβιοτικών	Case
ζυμαρικά	ζυμαρικό	Number
τσακάλια	τσακαλιών	Case
ομοσπονδιακές	ομοσπονδιακά	Gender
ισραηλινού	ισραηλινής	Gender
αστείου	αστείων	Number
βιντεοκαμερών	βιντεοκάμερες	Case
αστρονομικού	αστρονομικέ	Case
αποκτούν	αποκτάς	Person
μπαταρίες	μπαταρία	Number
γραψίματος	γράψιμο	Case
γειτονιάς	γειτονιών	Number
διαμάχες	διαμάχη	Number
άκανθας	ακανθών	Number
άκρου	άκρων	Number
βιβλιοπωλείων	βιβλιοπωλεία	Case
όργια	οργίων	Case
εκτυπωτές	εκτυπωτή	Number
σταφυλιού	σταφύλι	Case
Μαυρικιανής	Μαυρικιανών	Number
υπερβολής	υπερβολή	Case
βιολόγου	βιολόγων	Number
φακίδων	φακίδες	Case
διαιτολόγια	διαιτολογίων	Case
καρδάμου	κάρδαμο	Case
ηράνθεμου	ηράνθεμο	Case
νέγροι	νέγρος	Number
εξάδελφοι	εξαδέλφους	Case
αβανταδόροι	αβανταδόρους	Case
χειρουργό	χειρουργού	Case
γαϊδουριού	γαϊδούρι	Case
όχθες	όχθη	Number
σύστασης	συστάσεων	Number
Αθηνιώτισσας	Αθηνιώτισσα	Case
αερομαχιών	αερομαχίες	Case
παζαριού	παζαριών	Number
Κολομβιανοί	ναϊάδες	lemma
τηγανίτες	τηγανίτα	Number
τρυποκάρυδα	τρυποκάρυδων	Case
έδιδαν	σταματούσαν	lemma
βράκες	βράκα	Number
μυρίσαμε	μυρίσατε	Person
κάπαρη	λιμάνι	lemma
κλάμματα	κλαμμάτων	Case
μελοδραμάτων	μελόδραματα	Case
εμπνέετε	εμπνέεις	Number
βαλέδων	βαλέδες	Case
επιστροφή	επιστροφής	Case
συνεργάτες	συνεργάτη	Number
κράση	κράσης	Case
υποχρεώνει	υποχρεώνουν	Number
υπολογίστριας	υπολογίστρια	Case
νάρκισσου	νάρκισσος	Case
μισούσατε	μισούσες	Number
αερόβια	αερόβιο	Number
Βενετούς	Βενετό	Number
ζαχαροδιαβητών	ζαχαροδιαβήτες	Case
μονοπάτια	μονοπατιών	Case
ερημιές	ερημιά	Number
μπρούτζο	μπρούτζος	Case
μεταλλικού	μεταλλικό	Case
βοσνιακό	βοσνιακή	Gender
λογοτέχνες	λογοτέχνη	Number
συναθροίσεις	συναθροίσεων	Case
αγαπημούς	αγαπημών	Case
χρήσιμο	χρήσιμη	Gender
πλαγκτᾰ́	πλαγκταί	Gender
τυραννούσες	τυραννάς	Tense
βλήματος	βλημάτων	Number
ευχαρίστησες	χρημάτισες	lemma
διασταύρωσης	διασταύρωση	Case
ισχυριστούμε	ισχυριστούν	Person
έχθρας	έχθρα	Case
μετενσάρκωσης	μετενσαρκώσεων	Number
άγγειλα	αγγείλαμε	Number
κουκλοθέατρα	κουκλοθέατρο	Number
σφοδρής	σφοδρών	Number
υψώματα	ύψωμα	Number
λειμώνες	λειμώνα	Number
όρκων	όρκοι	Case
λογισμικό	λογισμικού	Case
συμφωνούσαν	συμφωνούσα	Person
αδιάβατων	αδιάβατους	Case
παρεξηγήσεις	παρεξήγηση	Number
αέριο	κακό	lemma
μεσολαβητές	μεσολαβητής	Number
κλασσικότερος	ωριμότερος	lemma
χώρο	χώρου	Case
διάγνωσης	διάγνωση	Case
Μακεδονικῆς	Μακεδονικῶν	Number
καινούριες	καινούρια	Gender
μωροῖς	μωρᾰ́	Case
ρόδα	ρόδο	Number
ταβάνι	ταβανιού	Case
σκορπιοί	σκορπιών	Case
επέτρεπες	κατουριόσουν	lemma
ξεψυχούν	ξεψυχάς	Person
λεμονιάς	λεμονιά	Case
ασχολούμαστε	ασχολούμαι	Person
αγγλικανικών	τεθωρακισμένων	lemma
παπαρούνα	παπαρούνας	Case
κρανία	κρανίο	Number
ακάλυπτες	ακάλυπτη	Number
εγχειριδίων	εγχειρίδια	Case
σταματούσαν	σταματούσατε	Person
Βιενέζας	Βιενέζων	Number
σπάγκοι	σπάγκος	Number
Μακεδονικόν	Μακεδονική	Gender
υάκινθο	υάκινθε	Case
βοηθεί	βοηθούσε	Tense
ρεμπέτικου	ρεμπέτικων	Number
λιθουανικών	λιθουανικού	Number
βασιλόπιτα	βασιλόπιτας	Case
στενό	στενού	Case
αιθιοπικών	αιθιοπικού	Number
ραβίνου	ραβίνων	Number
πυρίτιο	πυριτίου	Case
πευκέδανῳ	ἐπιχωρίῳ	lemma
ψυχολόγοι	ψυχολόγων	Case
ακάλυπτο	ακάλυπτη	Gender
κρεοπωλών	κρεοπώλες	Case
κηδειών	κηδείες	Case
ακυρωθεί	εγκολπωθεί	lemma
αποβιβαστεί	χρεωθεί	lemma
δοκιμάστε	δοκίμαζε	Number
γραπτό	γραπτά	Number
θρήνο	θρήνος	Case
λαδιών	λαδιά	Case
πιέσεων	πιέσεις	Case
εγγενής	μαυροβουνιακός	lemma
οστού	οστό	Case
πιανιστριών	πιανίστριες	Case
παιδοκτονιών	παιδοκτονίες	Case
παραισθήσεις	παραίσθηση	Number
ασβούς	ασβό	Number
πηδήματα	πήδημα	Number
νεύρα	νεύρο	Number
διαίρεσης	διαιρέσεων	Number
χρωστούσε	χρωστάει	Tense
κρατήστε	κράτα	Person
άγγειλες	άγγειλαν	Person
αντιγραφές	αντιγραφή	Number
ίντσας	ιντσών	Number
ιδρύτρια	ιδρύτριας	Case
συνθετητή	συνθετητής	Case
ιστογράμματα	ιστόγραμμα	Number
σοσιαλισμό	σοσιαλισμός	Case
γυρίνου	γυρίνων	Number
γδέρνουμε	γδέρνεις	Person
τόννου	τόννος	Case
αποσπάσματος	απόσπασμα	Case
καταρράκτες	καταρράκτης	Number
διακλαδώσεων	διακλαδώσεις	Case
συμφεροντολόγου	συμφεροντολόγων	Number
δηλώνατε	δήλωνε	Person
δῐᾰλῠτῐκοῖν	δῐᾰλῠτῐκῶν	Number
ενεχυροδανειστριών	ενεχυροδανείστριες	Case
αγγλικανισμό	αγγλικανισμός	Case
καφετέριες	λίστες	lemma
χώμα	χώματος	Case
πρωκτικής	πρωκτικού	Gender
επιρρήματος	επίρρημα	Case
έριδα	έριδας	Case
ίσκιοι	ίσκιε	Number
κουραμπιέ	κουραμπιές	Case
ορρού	ορρέ	Case
εκλέγουμε	εκλέγω	Number
περιφραστικές	περιφραστική	Number
κοντομάνικοι	κοντομάνικους	Case
κατσαρίδες	κατσαρίδων	Case
ξάδερφο	ξάδερφος	Case
ηλεκτραγωγό	ηλεκτραγωγού	Case
ακρωτηριασμό	ακρωτηριασμέ	Case
ασυμβίβαστα	συλλυπητήρια	lemma
αγελαδοτρόφους	αγελαδοτρόφοι	Case
χαρουπιάς	χαρουπιών	Number
λιβεριανού	λιβεριανός	Case
ἄσβεστον	ἄσβεστα	Number
αεροπόρων	αεροπόροι	Case
καλύκων	κάλυκες	Case
ελεύθερη	ελεύθερο	Gender
απέχουν	απείχαν	Tense
αυστραλιανούς	αυστραλιανά	Gender
αποστήματος	απόστημα	Case
μαντήλια	μαντήλι	Number
δολοφόνοι	δολοφόνος	Number
πολυβόλων	πολυβόλα	Case
φωνητικά	φωνητικοί	Gender
σκεπτικιστή	σκεπτικιστών	Number
αιθιοπικό	αιθιοπικού	Case
στιβάδες	στιβάδων	Case
Ισλανδού	Ισλανδέ	Case
ρόλο	ρόλος	Case
επικούς	επικές	Gender
καταλαβαίνουμε	καταλαβαίνω	Person
βενετικές	βενετικών	Case
εβδομηκοστές	εβδομηκοστή	Number
είμαι	είστε	Person
συναλλάγματα	συνάλλαγμα	Number
στραβοῖν	στραβώ	Case
πυροβόλα	πυροβόλο	Number
κορωνοῖς	φαλοῖς	lemma
σπιρτόκουτου	σπιρτόκουτων	Number
μικροκλίματος	μικρόκλιμα	Case
πιστοποιητικά	πιστοποιητικών	Case
ορθόδοξο	ορθόδοξη	Gender
αιτιολογικών	αιτιολογικά	Case
οδοί	οδούς	Case
ημιτονίων	ημιτόνια	Case
απόντα	απών	Case
φρονιμιτών	φρονιμίτες	Case
πηλούς	πηλών	Case
βάσιμοι	περίπλοκοι	lemma
ωάρια	ωάριο	Number
αδελφωνόταν	πασπάλιζε	lemma
γρύλοι	γρύλους	Case
λιθόσφαιρα	λιθόσφαιρας	Case
ιού	ιός	Case
καλλιέργειες	καλλιέργεια	Number
αρχιμουσικούς	αρχιμουσικών	Case
καταχωρητή	καταχωρητών	Number
είσαι	είναι	Person
δόνηση	δόνησης	Case
πήγες	πήγα	Person
βιοχημικοί	βιοχημικών	Case
στιβάδας	στιβάδα	Case
αστερίες	ξιφομάχοι	lemma
οδικό	οδική	Gender
άμιλλα	άμιλλας	Case
τάγματος	ταγμάτων	Number
