trillar	None
conduint	Present
galvanitzar	None
augmentada	Past
introduiria	None
fugiren	Past
articularen	Past
sostenir	None
llavaré	Future
trenar	None
gaudides	Past
sentida	Past
armà	Past
falsejada	Past
contractà	Past
sintonitzí	Past
contribuíeu	Past
abrigàrem	Past
prepararien	None
reclamats	Past
decidiríem	None
enfrontessin	Past
endevinat	Past
hàgiu	Present
estàvem	Past
gravéssim	Past
estimaríeu	None
agrairia	None
encenen	Present
criticaries	None
crear	None
reiniciades	Past
reorganitzaven	Past
catalitzada	Past
traspassar	None
refregaríem	None
componc	Present
encreuar	None
proposessin	Past
registrar	None
visitéssim	Past
manlleves	Present
prosperen	Present
seuen	Present
circumcidaríeu	None
esforçaria	None
romandria	None
cuirassats	Past
fusionà	Past
barbin	Present
compilaven	Past
cremada	Past
estendre	None
estimí	Past
erigirien	None
especifiquéssim	Past
traslladaren	Past
invita	Present
confonien	Past
denunciar	None
reflexionar	None
intimidada	Past
purificàvem	Past
trinxar	None
mitigades	Past
manifestis	Present
antecedien	Past
decapita	Present
treballo	Present
mesuraràs	Future
assabentat	Past
propagats	Past
raspallats	Past
tarden	Present
preparat	Past
rotí	Past
cursades	Past
optessin	Past
aguaiten	Present
ampliades	Past
infoníem	Past
jubilar	None
nomenar	None
divulguen	Present
confeccionen	Present
abriguéssim	Past
reparteixin	Present
blindàveu	Past
divinitzaríem	None
esteu	Present
edificaven	Past
popularitzar	None
falsificaríem	None
legislaria	None
llançaràs	Future
grapegéssim	Past
graten	Present
fugien	Past
autoritzar	None
dedicar	None
afeblides	Past
fugir	None
tancar	None
protegeixin	Present
tus	Present
llaví	Past
derrotarien	None
ajornant	Present
acidifiquéssim	Past
aturessin	Past
portats	Past
rebis	Present
desobeït	Past
batran	Future
resant	Present
expressa	Present
remuntarien	None
evocaven	Past
col·leccionada	Past
suplicà	Past
vinc	Present
destorbareu	Future
tòrcer	None
accedeixen	Present
aprestar	None
pujaré	Future
conquistats	Past
prioritzaria	None
mesurar	None
discuteix	Present
aconsellin	Present
rosegar	None
circumcidar	None
uniformitzant	Present
labialitzat	Past
enfonsades	Past
entendria	None
demanaren	Past
empraren	Past
seria	None
assabenta	Present
triomfaren	Past
agitaríeu	None
introduït	Past
assistir	None
encapçalà	Past
suada	Past
estabilitzat	Past
resin	Present
surt	Present
immortalitzada	Past
arresten	Present
avorrides	Past
bordaries	None
entraríem	None
esmenà	Past
teixit	Past
cancel·laren	Past
ridiculitzades	Past
reclamin	Present
col·leccionant	Present
eclipsa	Present
rompent	Present
curada	Past
efectuats	Past
danyats	Past
firmí	Past
adquirien	Past
contenir	None
harmonitzada	Past
detindria	None
acudiríem	None
suprimir	None
dir	None
ventilades	Past
redactarien	None
cerneres	Past
explorant	Present
prometessin	Past
lladris	Present
sospitant	Present
plantegen	Present
cancel·len	Present
constis	Present
discutir	None
corro	Present
consagrat	Past
agregaria	None
obtenen	Present
mirar	None
marcats	Past
faltar	None
autoritzada	Past
rebentà	Past
velaritzarien	None
oblidaran	Future
sacrificaríeu	None
trinxàreu	Past
antecedir	None
bordà	Past
envellida	Past
fotografia	Present
desmilitaritzat	Past
desenterris	Present
desbloquejada	Past
perdo	Present
dedicats	Past
retenir	None
recollida	Past
assimilaren	Past
acorralàvem	Past
xiuxiuejar	None
digitalitzaríem	None
resoldria	None
articulí	Past
practicarien	None
encoratjo	Present
besaré	Future
acompanyaríem	None
compto	Present
omplen	Present
xuclar	None
poblaren	Past
valdrien	None
extingit	Past
secretades	Past
desencadenada	Past
saltà	Past
explotessin	Past
donéssiu	Past
apostàrem	Past
enderrocaria	None
enlluernaríeu	None
entrades	Past
extrapolis	Present
descendeix	Present
efectuaren	Past
pertanyé	Past
reclamarà	Future
arrendades	Past
amenaçats	Past
xatejar	None
facilitarien	None
dormen	Present
soterrada	Past
evolucionessin	Past
simbolitzar	None
propagaven	Past
tremolo	Present
frenen	Present
protegits	Past
sincronitzant	Present
atorgàveu	Past
apoderaria	None
condemnant	Present
difamareu	Future
compondre	None
carreguis	Present
detinguin	Present
recordat	Past
emplenat	Past
elevaren	Past
dissociar	None
executaria	None
assabentaren	Past
emetria	None
completaria	None
citar	None
contingué	Past
assabenten	Present
volta	Present
ajornada	Past
dansada	Past
empresonar	None
despresos	Past
diferenciats	Past
sobrevola	Present
transliterar	None
resultaran	Future
activis	Present
revenja	Present
dirimir	None
explotades	Past
facilitar	None
provocaríem	None
abraçaren	Past
dimeritza	Present
contemplaríem	None
col·locaven	Past
forçà	Past
lletregis	Present
conjugà	Past
girarem	Future
reverenciaré	Future
votaré	Future
vetllar	None
deixà	Past
escurar	None
acampades	Past
emfatitzaven	Past
sabien	Past
deduïda	Past
traslladà	Past
eructant	Present
cooperarem	Future
simularien	None
produeixin	Present
retiraren	Past
completen	Present
presidint	Present
familiaritzades	Past
exhibiríeu	None
inclouran	Future
desbloqueja	Present
mobilitzant	Present
extrapolaves	Past
regnar	None
sotmetria	None
recomençareu	Future
comparec	Present
obeïren	Past
beneeix	Present
ubicaríeu	None
separessin	Past
fragmento	Present
planejar	None
suplantar	None
amar	None
enterbolires	Past
avançar	None
danyar	None
veuen	Present
exigiran	Future
ferits	Past
prepararan	Future
perpetuada	Past
conservarà	Future
moveu	Present
emigrat	Past
bulliran	Future
escriuria	None
espantats	Past
cridaren	Past
emetríem	None
abominen	Present
realitzaria	None
posaríeu	None
demanis	Present
dificultarien	None
endevinant	Present
concentrarien	None
demanàveu	Past
davallen	Present
detectareu	Future
sumà	Past
retingué	Past
promovien	Past
empaquetarien	None
alçant	Present
conjuntí	Past
resultant	Present
sagnat	Past
peques	Present
parodia	Present
beneficiaria	None
ascendits	Past
cultivaríeu	None
acidificada	Past
tolerat	Past
col·locaria	None
sobreviurien	None
cuinarem	Future
doctorada	Past
ordenant	Present
practicar	None
emmascararíeu	None
combinar	None
preveuen	Present
enterbolits	Past
concórrer	None
esterilitzar	None
disseminen	Present
veges	None
distribueix	Present
batallessin	Past
estandarditzada	Past
descendies	Past
toleraria	None
progressaren	Past
substituïssin	Past
ballaren	Past
articulareu	Future
florir	None
excel·lir	None
simplificaven	Past
simbolitzaria	None
detectin	Present
produiríeu	None
desmoralitzat	Past
rompré	Future
vigilin	Present
embolicant	Present
resultessin	Past
protagonitzis	Present
efectuarà	Future
rebudes	Past
democratitzarien	None
continuaria	None
designaven	Past
tirats	Past
trillessis	Past
escorreríem	None
urbanitzaren	Past
robí	Past
comunicada	Past
reclamaré	Future
funcionàvem	Past
occidentalitzats	Past
inscriguin	Present
travessaran	Future
llogada	Past
matades	Past
funcionaran	Future
publicat	Past
incrementarien	None
proposaria	None
datarien	None
torturada	Past
banyades	Past
semblarà	Future
retallares	Past
dónes	Present
xoquen	Present
concloure	None
tesà	Past
guaitades	Past
dolies	Past
alienar	None
realitzessis	Past
digerides	Past
ficades	Past
condemnats	Past
imitarien	None
espantaren	Past
inspiraria	None
independitzaria	None
comptaren	Past
folraves	Past
datar	None
exigíeu	Past
contradient	Present
inventaves	Past
pintessin	Past
penjares	Past
personifiquessis	Past
constar	None
untéssim	Past
solucionaran	Future
protegien	Past
afegeixo	Present
costaria	None
il·luminaria	None
respectaria	None
compilà	Past
refuta	Present
consistiria	None
suplica	Present
aglutinar	None
despatxat	Past
reunirien	None
assumit	Past
fornejats	Past
xarrupessis	Past
renuncio	Present
esperarien	None
enregistraré	Future
cultivin	Present
aposto	Present
cabrien	None
polaritzàrem	Past
dissenyessin	Past
constàrem	Past
petonejares	Past
pelaré	Future
comentat	Past
perfumen	Present
prohibissin	Past
perillar	None
relataria	None
escrius	Present
llegits	Past
abdicaria	None
verbalitzessin	Past
simulats	Past
laboraríeu	None
mataria	None
volaven	Past
exigeixin	Present
contaminà	Past
eliminant	Present
enllesteixen	Present
desautoritzà	Past
guiarien	None
sagnaries	None
protestaven	Past
integraven	Past
canviarem	Future
recordarien	None
mastiquéssim	Past
disposarà	Future
arreglarà	Future
enganxat	Past
cremen	Present
pol·linitzares	Past
escalen	Present
vaporitza	Present
soldessin	Past
digitalitzat	Past
preservaria	None
riure	None
cascats	Past
generaran	Future
consistirà	Future
sobreescalfat	Past
reconstruïren	Past
eliminaven	Past
boicotegéssim	Past
esmenats	Past
eixirà	Future
corroboràvem	Past
conqueriren	Past
immobilitzo	Present
respectaven	Past
altero	Present
elaboraran	Future
trucaren	Past
acceleraràs	Future
voldríeu	None
dormirà	Future
existint	Present
refugiaríeu	None
compensaria	None
procedir	None
estareu	Future
estudiades	Past
firmada	Past
analitzaran	Future
regnin	Present
consagrades	Past
dissenyen	Present
corroboréssim	Past
encarregats	Past
beatificant	Present
inaugurades	Past
simpatitzà	Past
salada	Past
ulularen	Past
punit	Past
generaria	None
desenvolupessin	Past
rebentar	None
tesar	None
ratificant	Present
desautoritza	Present
paralitzats	Past
dansades	Past
agrairem	Future
dialogar	None
transcrivint	Present
atorgaren	Past
col·laborar	None
retornaven	Past
perpetrar	None
parlaries	None
evocar	None
alimentades	Past
alterat	Past
anomenes	Present
triguessin	Past
basaria	None
ofegant	Present
revenen	Present
compràvem	Past
assumirien	None
vaporitzada	Past
inserireu	Future
examinar	None
cessaran	Future
rebentin	Present
solidifiquen	Present
sincronitzarà	Future
observo	Present
doblarà	Future
situaven	Past
adoptin	Present
vindreu	Future
coneixien	Past
desembarca	Present
prohibint	Present
infondre	None
escrigueu	Present
posar	None
obris	Present
beneficiessin	Past
autoritzant	Present
fornejarien	None
retallar	None
enllestiries	None
edità	Past
devoro	Present
digereixen	Present
superaren	Past
magnetitzar	None
conversareu	Future
perfeccionaren	Past
oposarien	None
desitjà	Past
intervindrien	None
trobaran	Future
restringissin	Past
prens	Present
fornegen	Present
perdudes	Past
transcrivim	Present
planxaries	None
desembarcaria	None
caldre	None
molestaria	None
sabreu	Future
fortificaven	Past
segellada	Past
editaria	None
segades	Past
vedaves	Past
amplia	Present
formàreu	Past
lamentéssiu	Past
efectuar	None
extret	Past
homenatjats	Past
mostraran	Future
dialogada	Past
facilitaran	Future
deduiré	Future
interpretà	Past
manaria	None
expandeixin	Present
pintar	None
exhalen	Present
precisant	Present
trec	Present
indignà	Past
promouria	None
generarien	None
moguí	Past
refinat	Past
diria	None
mourem	Future
obligaren	Past
barbaria	None
contemplin	Present
envoltar	None
feminitzarà	Future
entregues	Present
xiularà	Future
rau	Present
menjar	None
abandonades	Past
signaràs	Future
curaria	None
avançats	Past
llicenciaré	Future
consistirien	None
despenguin	Present
destil·laven	Past
agitaren	Past
adonat	Past
garantides	Past
adjurarà	Future
zigzaguegessin	Past
crucificats	Past
localitzar	None
viatja	Present
seleccionarien	None
llencis	Present
telefonéssim	Past
sondejats	Past
reverberant	Present
draga	Present
estem	Present
seure	None
cauria	None
sacrificaren	Past
callant	Present
alienarien	None
verbalitzada	Past
begueren	Past
guardar	None
distribuït	Past
adonar	None
edificarà	Future
ensenyes	Present
triguen	Present
exterminaries	None
nodrint	Present
finir	None
toleressis	Past
influïts	Past
cobrant	Present
demostrar	None
renunciïn	Present
plorarem	Future
convidares	Past
evacuaríeu	None
indiquessin	Past
dejunar	None
indignats	Past
criticada	Past
rearrenquis	Present
regalant	Present
suplicaria	None
llavats	Past
dansaríem	None
coagulada	Past
guanyada	Past
foradada	Past
canviar	None
lligats	Past
subhasta	Present
abandonessin	Past
apreníeu	Past
reduint	Present
despreses	Past
domen	Present
cuidares	Past
corroborant	Present
complir	None
acostar	None
congelada	Past
nuaré	Future
relatant	Present
salvo	Present
eliminaran	Future
admiris	Present
representant	Present
guardo	Present
corroborí	Past
preparà	Past
superat	Past
agradessis	Past
integraria	None
consultes	Present
executats	Past
acordant	Present
comptabilitzaran	Future
reflexionaríem	None
intitulada	Past
naturalitzades	Past
incorporessin	Past
emfatitza	Present
col·leccionà	Past
pal·liada	Past
rearrencaríem	None
escoltades	Past
cobraríeu	None
prohibirien	None
destaco	Present
doldríem	None
encendre	None
exigiren	Past
deïficarem	Future
retallada	Past
actualitzaran	Future
criticarà	Future
carreguessin	Past
lluitaren	Past
estripada	Past
ballàvem	Past
anticipar	None
barallar	None
emprenguessin	Past
anomenar	None
resultar	None
crearia	None
conservareu	Future
gratàreu	Past
dispares	Present
trobarà	Future
demana	Present
dogmatitzaríeu	None
repartirien	None
destorbant	Present
consagrarien	None
encengué	Past
corroboren	Present
llegarà	Future
conduir	None
buidàveu	Past
desenterrats	Past
reforçaries	None
extrapolar	None
importades	Past
saciada	Past
caminarà	Future
il·luminis	Present
giréssim	Past
sostingué	Past
lamenten	Present
orinar	None
donant	Present
confeccionat	Past
modifiquin	Present
declararen	Past
investigat	Past
clamí	Past
sabrien	None
anunciaria	None
expel·lir	None
pugues	None
retornà	Past
eclipsaríeu	None
anticiparíeu	None
modulen	Present
imposen	Present
entregaven	Past
endevinin	Present
desenterra	Present
expandiré	Future
especialitzaràs	Future
comptabilitzen	Present
saludar	None
maleir	None
alçaven	Past
sentíem	Past
tenir	None
respectarà	Future
batejaven	Past
omplint	Present
despatxà	Past
completaves	Past
refusar	None
intenta	Present
reemplaçada	Past
empènyer	None
acusat	Past
preparessin	Past
netejant	Present
compondrien	None
il·lustrats	Past
hauríem	None
remeiéssiu	Past
incrementaria	None
maleïdes	Past
reflexiones	Present
causin	Present
parlat	Past
sobrevolant	Present
sortiré	Future
organitzats	Past
sabotejaven	Past
agafarien	None
afegiries	None
popularitzaren	Past
graduar	None
acudeixin	Present
allotjaràs	Future
motivar	None
cornaran	Future
funcionat	Past
inscriviu	Present
proposaran	Future
activats	Past
distancià	Past
revelar	None
comprovin	Present
calcula	Present
escullo	Present
significats	Past
signaren	Past
conserva	Present
escapades	Past
integrin	Present
torçar	None
suspenguessin	Past
defensaria	None
roda	Present
confeccionar	None
estrenarà	Future
entrar	None
prohibiries	None
truquessin	Past
reflectits	Past
fraternitza	Present
violaren	Past
influïdes	Past
venceria	None
distribuïts	Past
celebrades	Past
aglutinant	Present
brotant	Present
trobis	Present
vendria	None
gravaria	None
alletar	None
acariciant	Present
emfatitzin	Present
necessitaràs	Future
fures	Present
fragmenta	Present
ragué	Past
difonguessis	Past
accelerar	None
emmagatzemades	Past
duraríem	None
ferraria	None
perdran	Future
enregistrada	Past
finançades	Past
dansant	Present
ofenien	Past
optarien	None
acceptant	Present
corones	Present
caçaven	Past
subministraria	None
segellat	Past
prohibiré	Future
conclourien	None
complaem	Present
forgen	Present
insultada	Past
afegits	Past
carregaries	None
suportaran	Future
regnaria	None
llevar	None
manà	Past
ensenyarà	Future
deprimireu	Future
discutirien	None
radicalitzàvem	Past
desvetllaré	Future
destinaré	Future
acceptàrem	Past
solucionats	Past
dominar	None
emmascararien	None
derrotat	Past
xocat	Past
descoratjar	None
suca	Present
dissenyaria	None
suposaria	None
soldar	None
abeuraria	None
sintonitzaríem	None
plaent	Present
dificultar	None
enaiguareu	Future
pertanyen	Present
descendir	None
podent	Present
entrarien	None
admetran	Future
confien	Present
ruixa	Present
estar	None
subornar	None
atacarien	None
donades	Past
signen	Present
gustí	Past
enfada	Present
periria	None
està	Present
rendint	Present
simbolitzarien	None
ajudaríeu	None
protegiran	Future
esgarrin	Present
assolar	None
transfonies	Past
desobeïres	Past
adoptà	Past
pactaríem	None
habitats	Past
tirà	Past
coagular	None
veiessis	Past
decapitaríem	None
comandat	Past
inserir	None
taca	Present
fereixen	Present
torçat	Past
escalfada	Past
acceleraran	Future
prefereixes	Present
avorrir	None
compensar	None
actualitzarien	None
deuria	None
exhumat	Past
solucionà	Past
cedirà	Future
socarrades	Past
consideres	Present
alterin	Present
guanyo	Present
atrapar	None
remat	Past
fitxats	Past
soldats	Past
deposar	None
inhibint	Present
dispararà	Future
perpetuaren	Past
ensorrada	Past
debilitis	Present
comptabilitzat	Past
estiuejaria	None
centro	Present
pobla	Present
amenaçarien	None
suggeriria	None
fabricaria	None
encunyades	Past
pertanyerien	None
estandarditzàreu	Past
causen	Present
deshumanitzaren	Past
guiant	Present
interesso	Present
coexistiran	Future
arrisquessin	Past
consagrar	None
idealitzats	Past
refutà	Past
jubilin	Present
disputada	Past
posseir	None
deixa	Present
classificaria	None
cercaran	Future
expulsis	Present
repetir	None
massacrares	Past
gravaran	Future
envegen	Present
saquejaven	Past
garantiren	Past
modelaràs	Future
acusaria	None
acaronàvem	Past
desmagnetitzar	None
marxen	Present
pessigar	None
controlaria	None
apreciaria	None
firmats	Past
beurà	Future
originaria	None
embolicareu	Future
exiliar	None
parléssim	Past
proporcionaria	None
consultaríeu	None
immortalitzat	Past
insistiria	None
trigat	Past
triada	Past
localitzaran	Future
vengueres	Past
semblant	Present
purificat	Past
empresonà	Past
diries	None
assolat	Past
faltaria	None
proporciono	Present
dispararies	None
aportar	None
inventaria	None
retinguts	Past
llegissis	Past
definirien	None
ruixat	Past
comunicar	None
ventila	Present
esclafaran	Future
educà	Past
descentralitzar	None
sopant	Present
abominades	Past
alteres	Present
atrofiada	Past
idealitzat	Past
oblides	Present
irritàveu	Past
comprant	Present
magnetitzaria	None
donàreu	Past
caguis	Present
alimentats	Past
denominarà	Future
penalitzen	Present
mecanitzar	None
mostrarien	None
trobessis	Past
filtrar	None
erigiria	None
senyalà	Past
onejar	None
realitzades	Past
edites	Present
cremat	Past
fluctuar	None
aplaudeix	Present
iniciaven	Past
esmenat	Past
resar	None
fortificaren	Past
estabilitzats	Past
procediré	Future
homenatjades	Past
pegat	Past
contagiaries	None
lluitin	Present
satisfarà	Future
penjaven	Past
assecant	Present
represa	Past
arrencat	Past
judaïtzats	Past
propagar	None
mortificant	Present
atenuar	None
aglomeressin	Past
restringíeu	Past
sàpigues	Present
culminaria	None
ornamentades	Past
facilitats	Past
deprimir	None
regresséssim	Past
coordinant	Present
encarregarien	None
rescatessin	Past
reaccionar	None
acompanyarà	Future
encantaria	None
contracta	Present
representa	Present
recordaven	Past
faltarien	None
riguessin	Past
inauguraria	None
congelaren	Past
accedien	Past
empenyin	Present
esclafaren	Past
harmonitza	Present
estendran	Future
centraren	Past
destil·laren	Past
llençà	Past
monopolitzàrem	Past
ballin	Present
veient	Present
lladra	Present
posaries	None
embolicar	None
creguessin	Past
alimentàvem	Past
eixir	None
revelaren	Past
comparats	Past
adjurin	Present
escorreguessin	Past
segregar	None
actualitzà	Past
cantares	Past
pretenguin	Present
comandades	Past
regnarien	None
termino	Present
devorant	Present
sumar	None
combatin	Present
nasalitzaríeu	None
salvàreu	Past
perdis	Present
orbitaria	None
costéssim	Past
atenyent	Present
cargolí	Past
relaxar	None
escapa	Present
alçar	None
congela	Present
succeirien	None
terminats	Past
materialitzaria	None
nomenaries	None
inhumada	Past
ferrarien	None
optaran	Future
mutar	None
paralitzat	Past
morires	Past
identificarà	Future
comptabilitzàvem	Past
desfaria	None
adobaràs	Future
procedien	Past
millorin	Present
resolem	Present
recompon	Present
revoltada	Past
aterraren	Past
entusiasmaria	None
concedeix	Present
toleren	Present
tria	Present
reconstruït	Past
cuidat	Past
protagonitzada	Past
inclou	Present
teoritzaren	Past
derrotaríeu	None
dilataríem	None
amades	Past
definides	Past
privatitzaren	Past
estabilitzar	None
refós	Past
clouràs	Future
cessar	None
estripen	Present
relacionar	None
demostrats	Past
pujant	Present
assemblar	None
tricotàreu	Past
simbolitzaries	None
planificaria	None
disputant	Present
excretar	None
paries	Past
temptà	Past
exposarem	Future
descendida	Past
ejaculéssiu	Past
entrevisten	Present
vincularien	None
inaugurar	None
gratar	None
dependre	None
dediquéssiu	Past
esglaiareu	Future
segueren	Past
nedaré	Future
exhuma	Present
queixat	Past
conservar	None
alçades	Past
concloent	Present
rebria	None
xoques	Present
assolarien	None
descompon	Present
simplificar	None
finalitzada	Past
escopir	None
suïcidar	None
conversen	Present
suprimit	Past
allotjaran	Future
practicaven	Past
avorrint	Present
assolien	Past
suïcidessin	Past
oblidats	Past
saciares	Past
atorgaríem	None
signar	None
guardonen	Present
marcarien	None
volessin	Past
batallar	None
allunyat	Past
tindríeu	None
netejaria	None
xuclaven	Past
treballaré	Future
edificaria	None
fugit	Past
causant	Present
conversar	None
combatrà	Future
refregades	Past
voregen	Present
senyalàrem	Past
normalitzen	Present
beneíreu	Past
segrestaren	Past
roncar	None
transferies	Past
inventaríem	None
inhibir	None
refuses	Present
respondria	None
condemnàveu	Past
independitzaven	Past
contemplaren	Past
fundar	None
agità	Past
adoptes	Present
trones	Present
desaprovaven	Past
instaura	Present
carbonitzis	Present
traduïren	Past
firmaven	Past
repartiria	None
telefonat	Past
fraternitzar	None
requerint	Present
influiríem	None
denunciaren	Past
entrenaven	Past
remoldríem	None
dissuadir	None
responguin	Present
evolucionar	None
simbolitzada	Past
lliuraran	Future
seleccionant	Present
sorgiran	Future
tallo	Present
respectaré	Future
observarà	Future
controlin	Present
contagiar	None
debilitar	None
refugien	Present
escapant	Present
riuran	Future
col·locades	Past
fracassarien	None
habitant	Present
eixugà	Past
aido	Present
utilitzarà	Future
celebraria	None
descobreix	Present
creant	Present
estiguin	Present
inaugura	Present
retiràrem	Past
catapulta	Present
restarien	None
perdríem	None
proclamarà	Future
socarrada	Past
circumnavegats	Past
col·loquin	Present
titllen	Present
telefono	Present
romandríeu	None
agraïssin	Past
fondrà	Future
transportades	Past
derivaran	Future
feminitzaries	None
avançareu	Future
deduïen	Past
exerceixen	Present
impedits	Past
dieu	Present
sobreviscut	Past
culminat	Past
caminessis	Past
assassinaria	None
substituïts	Past
mesurat	Past
rememorant	Present
mobilitzà	Past
marxàrem	Past
banyar	None
capturessin	Past
narren	Present
refredaria	None
anomenà	Past
desconeixent	Present
travessis	Present
dificultaran	Future
aixecareu	Future
visita	Present
fortificat	Past
acostaren	Past
desmilitaritzar	None
seguirien	None
rodà	Past
esglaiat	Past
expel·lida	Past
acusar	None
ensorrà	Past
criticà	Past
dauraràs	Future
elaborat	Past
estaria	None
retornen	Present
embarranquéssim	Past
investigats	Past
aprofitaria	None
nodrirà	Future
gambares	Past
abeurades	Past
sintonitzar	None
desenvoluparan	Future
inicià	Past
pentinar	None
comptar	None
intimidareu	Future
prospera	Present
traspassats	Past
reconcilia	Present
netejarà	Future
rauria	None
empalaves	Past
alliberaria	None
comprovaria	None
arrencaríem	None
doldria	None
menjada	Past
procedeixo	Present
enfocaries	None
psicoanalitzaríeu	None
comenta	Present
rebrà	Future
signades	Past
arriscaria	None
firmaria	None
capitularia	None
distingiria	None
arrodonissis	Past
assabentaven	Past
traduïen	Past
enviaven	Past
jutgen	Present
diferenciïn	Present
permetis	Present
moralitzant	Present
civilitzéssiu	Past
succeiria	None
carregats	Past
evacuar	None
plantejada	Past
gaudir	None
laïcitzaríem	None
embrutat	Past
compararia	None
passar	None
tiraven	Past
deuríem	None
alliberada	Past
provarà	Future
legalitzat	Past
graduats	Past
il·legalitzar	None
entrego	Present
transgredeix	Present
enllaçaria	None
qüestionat	Past
lluitarem	Future
ometien	Past
agradessin	Past
partiria	None
traduir	None
desencadenares	Past
envairà	Future
calmin	Present
invitàreu	Past
trigaria	None
restauraren	Past
cantat	Past
arrendéssim	Past
evitaven	Past
afirmaren	Past
destruiria	None
proclama	Present
intensificar	None
aprenien	Past
declarar	None
roman	Present
espantar	None
intimiden	Present
reviscolat	Past
organitzà	Past
dinamitzades	Past
aconseguissin	Past
tustares	Past
reforçarien	None
multiplicaran	Future
esmorzar	None
acceptes	Present
volten	Present
allotjar	None
enfondrà	Future
recorrerien	None
cobrir	None
teoritzar	None
tenim	Present
excediren	Past
llançar	None
doní	Past
prepararà	Future
vulguis	Present
obtingué	Past
hibernar	None
combinaven	Past
regalaràs	Future
caps	Present
pasturàvem	Past
concep	Present
subornaves	Past
compilares	Past
cabessin	Past
continuo	Present
baso	Present
estiren	Present
firmo	Present
triaren	Past
brotaven	Past
barbar	None
caigueren	Past
relacionades	Past
tiranitzar	None
corprèn	Present
persuadides	Past
transferiran	Future
grata	Present
estirant	Present
profetitzà	Past
encreuaríem	None
pactant	Present
captivar	None
serviria	None
emeté	Past
teixida	Past
basaries	None
nadin	Present
signifiquéssim	Past
tastar	None
jugàvem	Past
lloarien	None
llegeixin	Present
definir	None
cuiden	Present
enterraven	Past
comptà	Past
semblarien	None
estiuant	Present
potabilitzin	Present
bullides	Past
consagraria	None
desplaçar	None
sobreestima	Present
guaitaríem	None
olorant	Present
informessin	Past
allarguen	Present
aproximares	Past
dissoldre	None
oïts	Past
mutaríeu	None
succeït	Past
desenterràrem	Past
vendre	None
facilitaria	None
dejunaríeu	None
modernitzaríeu	None
heretades	Past
reflexionareu	Future
actuaries	None
desbordat	Past
habita	Present
senyalar	None
revenien	Past
celebrarien	None
aproximaria	None
modelaven	Past
suïcides	Present
estimaré	Future
castrada	Past
descomponies	Past
entusiasmes	Present
atendrien	None
italianitzada	Past
col·loquessis	Past
bombejant	Present
anhelaves	Past
guiades	Past
motoritzar	None
destrossà	Past
transportats	Past
pruíem	Past
parodiant	Present
exposen	Present
estigmatitzat	Past
aterraria	None
allotjades	Past
excretarien	None
creure	None
demostren	Present
despatxaríem	None
amagaren	Past
protagonitzarien	None
guarniríeu	None
hauries	None
decretades	Past
intensificaren	Past
enganxar	None
conduïts	Past
significaríem	None
establint	Present
dogmatitzàveu	Past
segellar	None
afaitar	None
fornir	None
negaren	Past
anhelar	None
cediren	Past
llançarien	None
comencis	Present
penjà	Past
propicià	Past
intentar	None
nodreixen	Present
publiques	Present
desitjar	None
remeiessin	Past
pesaries	None
corroborats	Past
actuarien	None
netegéssim	Past
destil·lades	Past
pareixeríem	None
animalitzar	None
pintaria	None
obligarien	None
rabegin	Present
exasperaries	None
acolliria	None
negociéssim	Past
transgrediria	None
emfatitzada	Past
destruïes	Past
dono	Present
visitades	Past
presidits	Past
destil·lada	Past
construiran	Future
suposin	Present
amaré	Future
vindries	None
provocareu	Future
llences	Present
dissolguessin	Past
apunyales	Present
assetjat	Past
modernitzà	Past
captiva	Present
acorda	Present
inclinada	Past
especifiquen	Present
exterminaria	None
registrarà	Future
rendiren	Past
perceps	Present
complirien	None
respost	Past
acidificàveu	Past
narrant	Present
diferencies	Present
bombardeja	Present
eliminaren	Past
contradeien	Past
habitarien	None
ploraven	Past
agusat	Past
penjaré	Future
bordàrem	Past
gaudida	Past
eixugar	None
expel·lirem	Future
dibuixaria	None
interessaré	Future
botreu	Future
desistit	Past
creuarien	None
assistien	Past
centrarien	None
individualitzar	None
demostro	Present
alternat	Past
proporcionades	Past
ensenyar	None
exagerats	Past
alliberar	None
vencerien	None
dependrà	Future
arrendada	Past
desclouries	None
veiessin	Past
calculada	Past
endut	Past
parlada	Past
animant	Present
canvia	Present
convertiren	Past
acreditats	Past
harmonitzat	Past
mostrin	Present
interrompé	Past
xiulades	Past
sacrificar	None
endevinaren	Past
sorprenien	Past
enganxaria	None
odiada	Past
conrearà	Future
dibuixarien	None
cita	Present
contraposa	Present
deixaré	Future
bombardejaren	Past
tesada	Past
quantifiquen	Present
relaxà	Past
eguinin	Present
qüestionàreu	Past
afirmessin	Past
xafardejares	Past
degradar	None
liberalitzada	Past
apunyalant	Present
colonitzar	None
elimina	Present
arrendar	None
arxivà	Past
assimilada	Past
afectin	Present
retiraria	None
tinguessin	Past
nedar	None
triarem	Future
etiquetà	Past
aconseguirem	Future
oraries	None
corpreníem	Past
trobaves	Past
ventiléssiu	Past
podades	Past
assistiria	None
proclamades	Past
alleugeriries	None
sagnant	Present
automatitzant	Present
pegarien	None
utilitzat	Past
contraatacaria	None
esgarrapar	None
debutat	Past
insistiren	Past
incremento	Present
conversarien	None
belat	Past
renunciarien	None
eliminada	Past
caçà	Past
antecedeix	Present
legalitzada	Past
definiren	Past
perillàvem	Past
ofendria	None
foradar	None
assemblarien	None
llençareu	Future
enregistrar	None
experimentessin	Past
tastaria	None
anhelà	Past
recomptessis	Past
baixes	Present
estacaven	Past
cola	Present
domar	None
reunides	Past
acordaria	None
mantenint	Present
malparlar	None
ret	Present
contradir	None
personificats	Past
apareixeria	None
deposares	Past
costarà	Future
mantindrem	Future
abolida	Past
educarien	None
solucionades	Past
descansats	Past
manifestada	Past
visquérem	Past
renunciats	Past
escapin	Present
esdevenien	Past
elegissin	Past
animaria	None
emmagatzemà	Past
profunditzar	None
fragmentada	Past
ascendir	None
governar	None
segellaria	None
folren	Present
traspassis	Present
alletades	Past
alenaves	Past
tocaré	Future
cerné	Past
escaparen	Past
signaria	None
perdreu	Future
redimir	None
assisteix	Present
circumnavegaríem	None
dissocià	Past
satisfer	None
perpetraríem	None
originen	Present
fregir	None
sospitessin	Past
folréssim	Past
exposo	Present
compris	Present
comparar	None
reflectiria	None
refresquen	Present
anomenat	Past
ornamento	Present
udolant	Present
coronant	Present
narro	Present
danyant	Present
dificultessin	Past
compraria	None
inclinar	None
contractaries	None
actualitzo	Present
professionalitzats	Past
imprimiren	Past
atures	Present
nasalitzada	Past
honrà	Past
divorcio	Present
optin	Present
suportarien	None
intentessis	Past
entrenada	Past
estalviaré	Future
derrueix	Present
oscil·larà	Future
declarà	Past
citaríem	None
forjat	Past
continuat	Past
articulessis	Past
tanquessin	Past
consideraria	None
descentralitzareu	Future
materialitzarà	Future
ornamentar	None
exigirien	None
justificar	None
descentralitzada	Past
extrapola	Present
extrapolant	Present
existits	Past
habito	Present
empresonàveu	Past
proposà	Past
magnetitzades	Past
condiciones	Present
governarien	None
insereixen	Present
il·luminada	Past
posseeix	Present
encoratjarien	None
trigaré	Future
perfumar	None
poblar	None
anticipades	Past
dialogat	Past
atenuen	Present
parlaren	Past
parà	Past
destacà	Past
cuejar	None
eludiren	Past
discutiria	None
guanyaria	None
concorre	Present
visitaria	None
justifica	Present
adonaria	None
regalis	Present
mancaven	Past
atrau	Present
rotaríem	None
recolzin	Present
presidit	Past
estimulat	Past
corrompre	None
fortificà	Past
estressat	Past
perfumarà	Future
pertanyent	Present
oposaria	None
reorganitzà	Past
informarien	None
previndrà	Future
rendireu	Future
infectades	Past
ejacular	None
celebrà	Past
editaven	Past
trillaven	Past
esclatarien	None
desmoralitzar	None
preserves	Present
simularen	Past
subestimarien	None
significaria	None
aproximar	None
assistissin	Past
maquillar	None
provà	Past
criticar	None
eixugada	Past
arrodonir	None
publicarien	None
causarien	None
discutiran	Future
consultada	Past
denominar	None
callaràs	Future
variïn	Present
ésser	None
deposin	Present
jutjant	Present
saquejar	None
lubricarien	None
separaria	None
faltàveu	Past
oloren	Present
arrissats	Past
naufraga	Present
invitaren	Past
marejar	None
cesséssim	Past
secretin	Present
cristal·litzada	Past
encarregaran	Future
gravà	Past
moc	Present
destil·lessis	Past
formin	Present
acudiren	Past
banyo	Present
elegeix	Present
determinà	Past
acordàrem	Past
culminats	Past
entretenir	None
punxar	None
forçada	Past
nodrit	Past
desconegué	Past
registrin	Present
reconciliada	Past
somriuen	Present
pruo	Present
raus	Present
pregaria	None
ventilada	Past
uniformitzaria	None
dilatada	Past
coronaria	None
doctoraria	None
fredejat	Past
planificada	Past
alegràreu	Past
promou	Present
comportin	Present
avançarem	Future
calmis	Present
excel·liren	Past
pronunciaria	None
especialitzàveu	Past
compartissin	Past
concediran	Future
donis	Present
fregit	Past
atenuàrem	Past
crido	Present
titubàreu	Past
empalessin	Past
aproves	Present
exterminant	Present
fotosintetitzaríem	None
corroboraven	Past
expel·lits	Past
agitar	None
provaré	Future
reconeixent	Present
refondre	None
escandalitza	Present
guiar	None
dispararia	None
reiterat	Past
aboleixen	Present
enyoro	Present
conquistarien	None
desvetllant	Present
beneficiaven	Past
saber	None
decebre	None
conspira	Present
sorprengué	Past
jutjaries	None
modules	Present
terminant	Present
renunciaven	Past
comprovarà	Future
defenestrar	None
aconseguirien	None
guerrejar	None
renovo	Present
estereotipéssim	Past
interrompent	Present
fortifica	Present
absoldrien	None
evaporar	None
batejaríeu	None
arrestaran	Future
catapultes	Present
inscriuria	None
pretenguéreu	Past
provindran	Future
alarmats	Past
assetjant	Present
aixecarà	Future
retallaríeu	None
divertiria	None
lloant	Present
redactats	Past
planificar	None
pregarà	Future
especialitzessin	Past
arrestaren	Past
rebotran	Future
llegaven	Past
fracassaren	Past
fomentà	Past
resoldrien	None
fabricaríem	None
habilitar	None
cansar	None
legislar	None
presidir	None
reinicialitzà	Past
filtrada	Past
atribuït	Past
alimentar	None
fregits	Past
funcionaríem	None
generat	Past
suprimien	Past
ferir	None
compareixerem	Future
allargo	Present
explicareu	Future
finit	Past
brotis	Present
catalitzat	Past
roden	Present
corroeixis	Present
sintonitzà	Past
busques	Present
produïdes	Past
protesten	Present
entregarà	Future
incloïen	Past
diversifiquen	Present
orbitaven	Past
arrapats	Past
divinitzar	None
reviscolà	Past
exhalaren	Past
provindríeu	None
tardes	Present
acolliran	Future
restaurades	Past
adoptat	Past
batallo	Present
perpetraven	Past
lateralitzaré	Future
armen	Present
brindaràs	Future
feminitzareu	Future
acceptin	Present
netejar	None
alleugerar	None
localitzarà	Future
relacionarien	None
emprendre	None
comprès	Past
reemplaçant	Present
parlaven	Past
subhastades	Past
esdevindria	None
acorrerien	None
perdonareu	Future
distreien	Past
cridàvem	Past
restringeix	Present
trobin	Present
suquejaríeu	None
demostrarem	Future
rebel·laren	Past
correspondre	None
escalessis	Past
integraren	Past
justificaria	None
aportarien	None
aprofitaríem	None
promoure	None
tirotejada	Past
creat	Past
pereix	Present
pal·liar	None
assumiria	None
remenats	Past
diagnosticà	Past
avantatjat	Past
tries	Present
penetrada	Past
restringits	Past
assecaren	Past
cantessin	Past
triomfa	Present
confonen	Present
dramatitzar	None
cusin	Present
divulgar	None
apunyalar	None
salvaven	Past
arresto	Present
afectaríeu	None
funcionaria	None
fragmentar	None
obeir	None
dinamitzaré	Future
transmetrien	None
pagaria	None
acompanyessin	Past
mastegàrem	Past
perdona	Present
empitjorades	Past
convertiria	None
proclames	Present
salar	None
envoltarien	None
divorciar	None
arriscat	Past
recuperaríem	None
vulcanitzaria	None
furo	Present
coronarà	Future
associant	Present
torrar	None
eixiran	Future
seleccionà	Past
professionalitzar	None
empenyé	Past
esterilitzessin	Past
celebrin	Present
aturà	Past
solidificà	Past
atens	Present
robes	Present
tallarien	None
compleix	Present
rescatada	Past
refusà	Past
sumarien	None
corregeixes	Present
aplicàvem	Past
privada	Past
estova	Present
desitjaren	Past
heretin	Present
aproximessin	Past
combinaran	Future
aguaitarien	None
aïllada	Past
sabem	Present
dimitirà	Future
rodar	None
caracteritzaria	None
inventarien	None
demanant	Present
realitzin	Present
aïnada	Past
juris	Present
intentarà	Future
orbitat	Past
conceptualitzar	None
estimular	None
botin	Present
dirigida	Past
dupliquen	Present
editats	Past
resoldran	Future
contenint	Present
gambaré	Future
remuntada	Past
descansada	Past
arrencats	Past
esmentar	None
espaventarien	None
propicien	Present
atenyí	Past
impossibilitar	None
ionitzen	Present
impulsessin	Past
reemplaçà	Past
perseveraran	Future
elaborats	Past
trinxada	Past
especificarem	Future
consolidaria	None
activaria	None
derruït	Past
defengué	Past
encreuant	Present
honrat	Past
avorriries	None
vomiten	Present
encunyar	None
refrigerats	Past
aïnes	Present
derivar	None
guerrejaries	None
conrea	Present
capturarien	None
controlat	Past
descloguin	Present
laborar	None
digereixes	Present
admetien	Past
participar	None
abreujada	Past
obliquo	Present
conservat	Past
vexin	Present
protagonitzaran	Future
enfadà	Past
permetria	None
desplaçant	Present
dirigeixen	Present
cobríssim	Past
abrigar	None
apologitzàrem	Past
impulsaria	None
abraçats	Past
emfatitzant	Present
exterminats	Past
desvetllà	Past
sobreestimarem	Future
refusa	Present
inaugurà	Past
ronronejades	Past
escalfaria	None
triares	Past
sortir	None
seguit	Past
citaria	None
rentaràs	Future
atorgaries	None
contemplar	None
introduir	None
coincideixin	Present
estimar	None
prefereix	Present
llatinitzar	None
estalviaríem	None
alleugeririen	None
desmoralitzaria	None
escorregut	Past
oir	None
efectuaria	None
salvar	None
subministrades	Past
cuinant	Present
reformaren	Past
establirien	None
obtindreu	Future
intentaria	None
circularia	None
contradic	Present
colpejades	Past
mecanitzat	Past
elevada	Past
mostraré	Future
experimento	Present
estudiarà	Future
voto	Present
comptabilitzada	Past
instaurar	None
adormir	None
atendries	None
simula	Present
secretar	None
daurar	None
reelegint	Present
cessaria	None
moralitzada	Past
suportar	None
empitjores	Present
plantejar	None
resultat	Past
pagà	Past
ocuparien	None
experimentarien	None
expandiria	None
votarien	None
bulliríeu	None
llençar	None
tacar	None
fugides	Past
vigilaria	None
imposaran	Future
moguin	Present
comentarem	Future
apel·là	Past
enganya	Present
tronaries	None
alternarien	None
aproximat	Past
il·lustrarien	None
pintaren	Past
emeteren	Past
mobilitzaríeu	None
dividiràs	Future
obligarà	Future
materialitzar	None
refugiada	Past
baixà	Past
datéssim	Past
dilataries	None
mostrà	Past
encapçalaria	None
plorada	Past
assimilaries	None
renovarien	None
emmagatzemaríeu	None
tossir	None
rendiria	None
menjaren	Past
faltarà	Future
apareguis	Present
inspeccionar	None
entens	Present
emigra	Present
disposo	Present
violats	Past
abandonaria	None
enllestit	Past
retenen	Present
imaginis	Present
tocar	None
catapultà	Past
cuidessin	Past
bulls	Present
diversifica	Present
fornida	Past
inclouríem	None
torça	Present
transferit	Past
subornat	Past
italianitzarà	Future
distendríem	None
hem	Present
adreçat	Past
aprovàrem	Past
veuries	None
redimeix	Present
inclinaren	Past
criticaràs	Future
esdevenint	Present
curaren	Past
cagaries	None
escriure	None
celebressis	Past
compartirien	None
perfeccionats	Past
remolíem	Past
emplenar	None
defenc	Present
conjugar	None
ferien	Past
diríem	None
envellies	Past
regressant	Present
semblaria	None
alteraven	Past
mous	Present
assaborir	None
sintetitzà	Past
enterren	Present
decretat	Past
viatjaves	Past
tems	Present
concentrades	Past
assumissin	Past
intensificarà	Future
ornamentant	Present
refonguéreu	Past
mobilitzaves	Past
acabaré	Future
terroritzaríem	None
explicada	Past
reparteix	Present
imantats	Past
governaria	None
enaiguàvem	Past
revenir	None
reprenen	Present
engolida	Past
nuar	None
complaguts	Past
industrialitzaran	Future
adreçar	None
diferenciades	Past
supleixin	Present
sec	Present
confongué	Past
devoressis	Past
mortifiquessis	Past
intuïssis	Past
nedaria	None
descosiries	None
dant	Present
competiríem	None
finançar	None
cornessis	Past
disputar	None
destinat	Past
desmilitaritzàrem	Past
dissociarem	Future
firmat	Past
atenyies	Past
aconseguiré	Future
usat	Past
regalar	None
semblà	Past
guanyaran	Future
constrenyeries	None
rebaixar	None
paris	Present
imantareu	Future
penetrant	Present
duplicar	None
activàreu	Past
comunicàveu	Past
acordo	Present
exposarà	Future
evocaríeu	None
fornint	Present
reaccionen	Present
desembarcarien	None
entusiasmessin	Past
heure	None
emancipàreu	Past
jurada	Past
revelats	Past
dificultareu	Future
cargolats	Past
confirmares	Past
exigeixen	Present
derivarien	None
comptabilitzaríeu	None
succeireu	Future
esmentà	Past
incrementàvem	Past
lligues	Present
ajornat	Past
acosta	Present
segregaren	Past
alegrà	Past
apoderen	Present
arxivis	Present
llogant	Present
sentir	None
suportats	Past
proclamares	Past
democratitza	Present
noc	Present
dificultaven	Past
trucades	Past
generalitzat	Past
cobràveu	Past
entenc	Present
motivaria	None
completes	Present
convidaria	None
calculàreu	Past
digerits	Past
dominaran	Future
estudia	Present
imaginàveu	Past
embrutada	Past
fotre	None
evolucionarien	None
hospitalitzada	Past
alterades	Past
reiniciaria	None
creuant	Present
prohibeixen	Present
marxar	None
donaria	None
destacar	None
economitzo	Present
alenades	Past
perpetua	Present
mescla	Present
agradin	Present
eliminar	None
inhibeix	Present
concedirien	None
plaus	Present
alteraria	None
acudint	Present
onegéssim	Past
elegíssiu	Past
escullen	Present
posarien	None
intueix	Present
vulgueu	Present
dissoldria	None
alegraren	Past
afavorit	Past
deriví	Past
optaria	None
coincidiríeu	None
sorprenen	Present
reuniria	None
sobrevivien	Past
emetien	Past
clos	Past
privats	Past
alletats	Past
valdre	None
brillaria	None
cuidaren	Past
provocarien	None
reconeguem	Present
entusiasmar	None
vaporitzaríem	None
estimaren	Past
admetre	None
provades	Past
categoritzar	None
comunico	Present
posseeixin	Present
emmagatzemarà	Future
evitant	Present
allunyaria	None
acompanyaren	Past
transformis	Present
intensificada	Past
diferenciat	Past
sostinguda	Past
augmentarem	Future
compilades	Past
apostaren	Past
viatjarà	Future
circumcidaríem	None
fertilitzant	Present
petonegis	Present
esgarraríeu	None
dedicareu	Future
protagonitzar	None
ajorna	Present
reclamada	Past
titubejarem	Future
respectaren	Past
oblidar	None
arrestar	None
dimeritzarien	None
entreguin	Present
gelis	Present
endevinàvem	Past
poguéssim	Past
disculpar	None
arreglaven	Past
inspirar	None
tingueu	Present
respondrien	None
parir	None
derrotarà	Future
imaginaries	None
cultivat	Past
desautoritzar	None
adono	Present
acollirien	None
demanaré	Future
adoben	Present
sorprendré	Future
comparen	Present
silenciar	None
negociaria	None
rejovenírem	Past
correspons	Present
critiques	Present
calma	Present
signifiquen	Present
aromà	Past
destacarien	None
centralitzaríeu	None
rememora	Present
comunicaríeu	None
fereixin	Present
pertanyerà	Future
brillar	None
iniciessin	Past
mòlt	Past
contravingudes	Past
atomitzaren	Past
terroritza	Present
ataquéssiu	Past
guardareu	Future
untaran	Future
enfrontada	Past
atenguin	Present
corres	Present
expandits	Past
transferir	None
vigoritzo	Present
corroïts	Past
estressarem	Future
modulat	Past
desembocaven	Past
visqueres	Past
concentren	Present
amenaçat	Past
remo	Present
avancessin	Past
enfadàrem	Past
rendissin	Past
coexistir	None
examinaria	None
identifico	Present
posposen	Present
debilitarien	None
ascendiren	Past
lamentaria	None
assassinar	None
contemplà	Past
barrejaven	Past
aliant	Present
desbordar	None
sabut	Past
desapareguem	Present
tituben	Present
valer	None
redimida	Past
empenyeria	None
tinguérem	Past
reflexionada	Past
eixugaries	None
aprovaria	None
saltar	None
cosíssiu	Past
cultivant	Present
erigits	Past
propiciaria	None
establien	Past
sintetitzant	Present
arrenden	Present
etiquetessin	Past
enderrocaries	None
acceptaria	None
toleraran	Future
controlar	None
blindàrem	Past
llegeixes	Present
ennuvola	Present
aboliria	None
mecanitzessin	Past
sintetitzaven	Past
falsejaríem	None
recolzats	Past
repetiria	None
convèncer	None
matin	Present
divulgareu	Future
toquen	Present
convocaven	Past
carbonitzaves	Past
reorganitza	Present
cobraria	None
cremaran	Future
reeixírem	Past
entreté	Present
lloen	Present
comprovà	Past
carregà	Past
sotmeté	Past
pixar	None
restringir	None
perpetuades	Past
perfeccionaria	None
llegaria	None
cremar	None
sumaré	Future
corregien	Past
bombardejaven	Past
divulgat	Past
seleccionar	None
combatrien	None
desenvolupades	Past
transgredint	Present
escollit	Past
arribes	Present
fraternitzareu	Future
prova	Present
arrapada	Past
finalitzades	Past
perdre	None
complissin	Past
apel·lant	Present
plagudes	Past
augmenta	Present
vacil·lar	None
menjaràs	Future
atrevíem	Past
moriré	Future
recuperant	Present
arrenca	Present
adorar	None
perfeccionen	Present
observada	Past
enganxades	Past
transformessin	Past
accedeix	Present
lliguis	Present
esgatinyàrem	Past
mecanitzats	Past
significarà	Future
encarreguessin	Past
eclipsats	Past
comptabilitzar	None
generalitzà	Past
ajudareu	Future
contaminen	Present
asseguràreu	Past
encapçales	Present
nadar	None
compensant	Present
empraria	None
encarreguis	Present
sumat	Past
viola	Present
cruixir	None
limitin	Present
descosíreu	Past
expandirien	None
defensats	Past
alleugerades	Past
precisaríeu	None
millorant	Present
morirà	Future
aprofitaran	Future
humanitzats	Past
obeirien	None
envies	Present
derruïda	Past
procediren	Past
renovat	Past
sorgireu	Future
moduléssim	Past
transportada	Past
observades	Past
anomenaria	None
armades	Past
adobo	Present
pretendria	None
reformats	Past
reorganitzar	None
avançades	Past
treballades	Past
automatitzar	None
viurà	Future
narraria	None
ometre	None
descansarà	Future
reformant	Present
manaven	Past
paralitzà	Past
comparèixer	None
besarà	Future
distraiem	Present
estrenant	Present
pujarem	Future
constrènyer	None
entenguem	Present
inflar	None
modelades	Past
demanaria	None
esmenaries	None
ensorrar	None
legalitzaria	None
honrats	Past
reelegir	None
concorrent	Present
comencin	Present
convenceria	None
publicaries	None
botran	Future
conreat	Past
da	Past
comunicà	Past
intentats	Past
anima	Present
transgredíssiu	Past
plantejaven	Past
servida	Past
empenyessin	Past
suprimiríeu	None
suspendríem	None
conjuga	Present
educar	None
garantirien	None
apologitzareu	Future
animí	Past
votarem	Future
redactades	Past
aliïs	Present
pal·liant	Present
immobilitzà	Past
allisats	Past
prengué	Past
corris	Present
prendrien	None
dares	Past
professionalitzàreu	Past
despendríeu	None
rascar	None
perseverant	Present
despatxa	Present
forçaria	None
regnat	Past
accedeixo	Present
mudant	Present
descentralitzaríem	None
desapareixien	Past
limitaré	Future
practicaren	Past
sopaven	Past
conrearia	None
ometé	Past
provo	Present
comportaren	Past
ventiléssim	Past
arrendat	Past
danya	Present
acampats	Past
importar	None
viurien	None
calcularà	Future
necessito	Present
reaccionat	Past
conspirar	None
triomfessis	Past
alarmaria	None
estrenaren	Past
somrius	Present
enganyaren	Past
pegaríeu	None
tractarien	None
irritada	Past
pot	Present
prestaran	Future
ix	Present
trivialitzar	None
ores	Present
arrapat	Past
demanes	Present
contraposaràs	Future
ataquessin	Past
bullit	Past
portant	Present
nedaries	None
importaré	Future
telefonar	None
tindrien	None
absorbiren	Past
persuadida	Past
dictéssiu	Past
inventaren	Past
barallaven	Past
multipliquin	Present
salvades	Past
tallaren	Past
oprimida	Past
manllevats	Past
espanto	Present
insistiríeu	None
caiguis	Present
mullar	None
servirien	None
enganyades	Past
contravenir	None
catalanitzada	Past
inclinin	Present
nuaríem	None
abreujar	None
subratllar	None
avançaven	Past
revelin	Present
boicotegéssiu	Past
correries	None
ampliessin	Past
masseja	Present
assetjar	None
participaria	None
soterraven	Past
ensenyant	Present
puguem	Present
corprendre	None
posaríem	None
envejat	Past
emigrar	None
universalitzar	None
funcionaven	Past
derrotaria	None
descriureu	Future
destriant	Present
ajudéssiu	Past
lladrar	None
comparegueren	Past
mesclar	None
cultivéssiu	Past
rellegiríeu	None
regades	Past
cessats	Past
classificarien	None
espaventis	Present
exposaren	Past
orbitar	None
encalcis	Present
exilio	Present
cauteritzaries	None
balançarien	None
ordenin	Present
tapa	Present
sacrificàveu	Past
fixar	None
conceptualitzat	Past
iniciaran	Future
infongué	Past
negociarien	None
preserva	Present
penetrar	None
emigraven	Past
tractarem	Future
inicialitzaren	Past
castrat	Past
pronunciaríeu	None
finançaria	None
senyalat	Past
afegíssim	Past
observats	Past
rendeixen	Present
exiliant	Present
rebel·laven	Past
calmades	Past
encorreguessin	Past
descriure	None
coagulant	Present
progressaran	Future
immolar	None
reclamat	Past
allunyar	None
menja	Present
desenvolupat	Past
concentrar	None
catalitzats	Past
mengis	Present
reorganitzades	Past
quedar	None
barallada	Past
revingudes	Past
falsejar	None
parin	Present
exagera	Present
indicaren	Past
datis	Present
marcarem	Future
desembarcaran	Future
estimulats	Past
molestaven	Past
gaudirien	None
modela	Present
liderarien	None
sorgirà	Future
marxis	Present
decidissin	Past
redactar	None
prendria	None
estacàreu	Past
il·lustrar	None
ofegaven	Past
llega	Present
allargaria	None
adopto	Present
sostindran	Future
xoca	Present
nodreixin	Present
penar	None
cites	Present
penjaríeu	None
diagnosticat	Past
adorada	Past
reconeguin	Present
rascada	Past
empitjorat	Past
trobaven	Past
observarien	None
preserven	Present
interpretaria	None
dedicaria	None
ventilen	Present
fotuts	Past
complaguéssiu	Past
arriscar	None
odia	Present
imprimir	None
ordenis	Present
assolida	Past
amputàrem	Past
reviscoles	Present
atribuïdes	Past
colpejaria	None
habitar	None
inclinaria	None
restat	Past
dedicarà	Future
segregàveu	Past
articulen	Present
expandírem	Past
adorní	Past
immolats	Past
lexicalitzada	Past
quedaria	None
cursar	None
centris	Present
elevà	Past
abdicat	Past
vedes	Present
traumatitzant	Present
entraven	Past
desafiaria	None
memoritzats	Past
dictaria	None
calmaríeu	None
categoritzant	Present
cerno	Present
deïficats	Past
tolien	Past
organitzaven	Past
conjunto	Present
coincidiran	Future
dedicada	Past
disputarà	Future
contraposat	Past
integrarien	None
sucat	Past
rellegir	None
associar	None
evitarien	None
dissuadirien	None
usen	Present
respirant	Present
propiciaven	Past
combinares	Past
segrestarien	None
amagar	None
contraposaven	Past
distanciades	Past
alces	Present
professionalitzant	Present
elegiria	None
infon	Present
integrà	Past
intimidant	Present
universalitzàreu	Past
caminar	None
mobilitzar	None
resten	Present
pateixis	Present
vexaries	None
lluitaven	Past
digueren	Past
arribessin	Past
plogué	Past
assegurant	Present
tindríem	None
condicionarà	Future
copiessin	Past
ampliéssim	Past
dirigir	None
conversaven	Past
viatjarien	None
comandaria	None
envoltant	Present
senyalaven	Past
detura	Present
devorin	Present
subministrar	None
parlarà	Future
militaritzar	None
incrementar	None
indignàreu	Past
triomfar	None
industrialitzaria	None
valdria	None
reclamàrem	Past
m'enduré	Future
verificà	Past
abolint	Present
simbolitzen	Present
batuts	Past
contractar	None
suspèn	Present
abaixa	Present
sospità	Past
caieu	Present
cancel·lin	Present
caminen	Present
interrompudes	Past
fortificàvem	Past
gaudit	Past
suportant	Present
vehiculats	Past
ofèn	Present
desitgis	Present
he	Present
saqueja	Present
aglutinaven	Past
exiliaria	None
tremola	Present
reverenciats	Past
emetent	Present
conjugat	Past
celebrat	Past
dictar	None
estarem	Future
embrutar	None
sotmetent	Present
accedirà	Future
preparen	Present
pesquen	Present
recolzaven	Past
arrestin	Present
considerades	Past
estalviar	None
immolada	Past
confirmarà	Future
governes	Present
impedirien	None
amessis	Past
cristal·litzo	Present
escalar	None
acorrala	Present
jauen	Present
contamines	Present
fornejades	Past
portada	Past
calien	Past
centralitzat	Past
ensorrades	Past
porto	Present
suplien	Past
fabriquen	Present
renovaria	None
insultat	Past
romandre	None
subratllaren	Past
fregiríeu	None
rovellat	Past
emetin	Present
renunciarà	Future
refutarem	Future
subhastaves	Past
revoltades	Past
podes	Present
viatjar	None
donarien	None
abrigaria	None
editarà	Future
sacrifica	Present
enviarà	Future
servir	None
acreditaven	Past
encarregaré	Future
mudaren	Past
calculat	Past
cancel·la	Present
condemnà	Past
empenyien	Past
impedir	None
homenatgessin	Past
abolides	Past
honres	Present
distribueixen	Present
afectats	Past
retornaran	Future
asseuen	Present
impossibilitaria	None
apostà	Past
anticipat	Past
afirmarem	Future
aconsellat	Past
sorgiria	None
sincronitzats	Past
visquessin	Past
purifiquen	Present
evocaves	Past
mobilitzarà	Future
elimines	Present
suplantat	Past
repartissin	Past
conservaria	None
impulsin	Present
esmentant	Present
dirigirien	None
beneficiarà	Future
dominis	Present
transformades	Past
embarranquis	Present
cacin	Present
refrescats	Past
construirien	None
evacuaria	None
espiaven	Past
delit	Past
tractaríeu	None
assegurarien	None
enganyares	Past
neguen	Present
complagueu	Present
prestaren	Past
remuntaven	Past
fragmentaria	None
industrialitzar	None
desvetllar	None
exhumessin	Past
capturant	Present
sortirien	None
fracassant	Present
radicalitzats	Past
aplaudides	Past
desbordares	Past
exploraren	Past
allunyarien	None
contamina	Present
publiquen	Present
penetrats	Past
folres	Present
cicatritzar	None
carregant	Present
fondre	None
tapada	Past
mereixeria	None
repartirà	Future
estableixin	Present
classificaven	Past
descendissin	Past
lloà	Past
acompanyà	Past
doblessis	Past
assoliríem	None
robant	Present
mobilitzat	Past
aconseguida	Past
blindaràs	Future
olora	Present
separarien	None
guanyares	Past
dutxar	None
cultiva	Present
ragut	Past
discutit	Past
cessaven	Past
coneguéssim	Past
comprenent	Present
existeix	Present
legalitzats	Past
precisar	None
autoritzaren	Past
assassinaven	Past
bramaràs	Future
admirar	None
triomfo	Present
guardes	Present
revenjats	Past
s'asseurien	None
anomenarem	Future
atribuir	None
coneixeu	Present
disparaven	Past
agusades	Past
resultaren	Past
lletregen	Present
passejada	Past
intensifica	Present
comprengueres	Past
perfumes	Present
jubila	Present
creuada	Past
admetessin	Past
girat	Past
girar	None
modificaria	None
apostaríem	None
purificades	Past
digerir	None
immigrant	Present
visc	Present
exorcitzarien	None
traslladant	Present
compareixeran	Future
venir	None
parteixen	Present
amanseix	Present
perseveren	Present
reiterà	Past
sapiguem	Present
dormir	None
escanejaríeu	None
transformant	Present
civilitzar	None
desmilitaritzéssiu	Past
solidificaries	None
llicenciant	Present
voltaven	Past
agraeixo	Present
encaixaria	None
culminarem	Future
exposaria	None
emmascaràreu	Past
tustàreu	Past
amago	Present
menjaré	Future
denominant	Present
tustareu	Future
professionalitzaríeu	None
lleparàs	Future
comprenen	Present
refredo	Present
transformat	Past
basades	Past
elevessin	Past
mesuraran	Future
automatitzades	Past
contraposats	Past
compongué	Past
purificar	None
calles	Present
decidits	Past
estripàvem	Past
massacrà	Past
amagaven	Past
radicalitzaren	Past
dedicarien	None
calmen	Present
desautoritzada	Past
treballen	Present
rovella	Present
ficà	Past
activades	Past
mantenir	None
arrapa	Present
peririen	None
dialogant	Present
corromp	Present
pensaries	None
pegats	Past
inutilitzar	None
sostindria	None
admès	Past
uniformitzar	None
revinguda	Past
recordades	Past
escapen	Present
guardat	Past
baixaran	Future
violes	Present
abatent	Present
raonar	None
immortalitzar	None
sumaria	None
guanyaríem	None
escoltaria	None
regalada	Past
il·luminarien	None
compararen	Past
titllà	Past
repliquessin	Past
traslladar	None
aplicaré	Future
afectaria	None
alegrarà	Future
ordenar	None
alenéssiu	Past
hospitalitzades	Past
ometin	Present
assimilaré	Future
jugades	Past
coincidiria	None
imprimirà	Future
buscaria	None
milloren	Present
encantades	Past
atrevissin	Past
vomitada	Past
castrar	None
aprofitarà	Future
interessen	Present
encaixen	Present
defensarien	None
ancorar	None
aïllar	None
permet	Present
batejaren	Past
difama	Present
llegeixo	Present
vèiem	Past
embrutéssiu	Past
destinats	Past
tallaria	None
denominaria	None
adaptar	None
departiríeu	None
subratllaries	None
refredarien	None
ornamentat	Past
agregat	Past
confondríem	None
apoderareu	Future
vivim	Present
llicencien	Present
orina	Present
lluitat	Past
ignorar	None
improvisats	Past
dubtes	Present
servit	Past
cremo	Present
sucar	None
codificant	Present
decidírem	Past
immobilitzat	Past
envair	None
podar	None
abateres	Past
guiat	Past
assaborint	Present
obert	Past
anglicitzaríem	None
oprimir	None
extermina	Present
degradant	Present
disminuiran	Future
refutar	None
vindran	Future
mugiries	None
penges	Present
mesclats	Past
atenuarien	None
assenyalarien	None
contemplen	Present
entregar	None
partir	None
esperaries	None
realitza	Present
castra	Present
hagis	Present
replica	Present
colpejats	Past
proposen	Present
emmagatzemin	Present
lideraria	None
separà	Past
obtenir	None
colpejant	Present
emplena	Present
comptats	Past
conduïda	Past
debilitaria	None
aproximades	Past
inspiraran	Future
funcionarien	None
tenien	Past
fonc	Present
presentaria	None
comentaves	Past
sorprendran	Future
desmoralitzant	Present
tricotaries	None
responguis	Present
transferirà	Future
acompanyareu	Future
estovar	None
baixarien	None
resoldre	None
cultives	Present
disputàreu	Past
omplirà	Future
rotant	Present
halaria	None
crucificar	None
judaïtzant	Present
eixides	Past
requerirà	Future
pujats	Past
aprovo	Present
combinats	Past
demanessin	Past
potabilitzar	None
ignoraven	Past
invitàveu	Past
inhalades	Past
confirma	Present
dubtis	Present
editat	Past
netejada	Past
definirà	Future
atacaríem	None
finalitzin	Present
espià	Past
observat	Past
mancarien	None
immigrades	Past
gravin	Present
desemboquin	Present
comprendrà	Future
remoleu	Present
morir	None
conduiria	None
evitades	Past
asseguraràs	Future
aturaran	Future
variades	Past
olorarà	Future
alterarà	Future
uniformat	Past
assabentada	Past
capitulessis	Past
perpetraria	None
dramatitzéssiu	Past
harmonitzessin	Past
martiritzarà	Future
moldre	None
llencin	Present
exigirà	Future
identificaren	Past
destruirà	Future
articularia	None
escórrer	None
destinarien	None
cursis	Present
rescatis	Present
imaginaríeu	None
exterminessin	Past
estressa	Present
fusionarien	None
elegir	None
adones	Present
generà	Past
estovada	Past
notaria	None
mudar	None
beneficiaran	Future
demostrarien	None
motivada	Past
representaren	Past
aprofità	Past
confondria	None
pintà	Past
pujarien	None
xarruparies	None
asseien	Past
furat	Past
caçar	None
realitzar	None
planteges	Present
firmar	None
durarien	None
bufin	Present
succeir	None
suprimiria	None
esmorzen	Present
convertirien	None
carbonitzaria	None
rodaria	None
cures	Present
nevat	Past
senyalades	Past
perpetrats	Past
ensenyaria	None
canvià	Past
cloent	Present
desobeeix	Present
imposessin	Past
xiulessis	Past
suar	None
sonaria	None
observaria	None
untar	None
uniformar	None
amaren	Past
saberes	Past
agruparien	None
veus	Present
dibuixes	Present
enterbolir	None
afecto	Present
transliterats	Past
inicialitzares	Past
impossibilitessin	Past
divinitzats	Past
abraçaria	None
saquegessin	Past
beatificar	None
constituïda	Past
parar	None
parats	Past
reflexionat	Past
triarien	None
perdonarien	None
seguireu	Future
seduïda	Past
baixar	None
jugaven	Past
descoratjats	Past
perden	Present
devoren	Present
roten	Present
creurien	None
absorbir	None
immolant	Present
inspeccionen	Present
participarà	Future
domant	Present
intervingueren	Past
assistirà	Future
tractant	Present
pensarà	Future
pensats	Past
viuran	Future
creien	Past
travessen	Present
entès	Past
perilléssiu	Past
fragmentaries	None
arraulir	None
habiten	Present
suplantada	Past
eguino	Present
bastides	Past
començàveu	Past
suspendria	None
fabricarà	Future
reaparegut	Past
asseguérem	Past
mastegares	Past
polissis	Past
lliurin	Present
voldrien	None
refutàveu	Past
generar	None
desprendria	None
esqueixéssim	Past
pregaren	Past
suïcidaria	None
interrompéreu	Past
idealitzades	Past
boicotejant	Present
pixa	Present
determinar	None
conèixer	None
empitjorarà	Future
esbrinar	None
acollir	None
massacrats	Past
ajudada	Past
oblidat	Past
pecar	None
desembocaria	None
dibuixarà	Future
inventant	Present
esdevingut	Past
escorres	Present
poliries	None
sintonitzes	Present
experimenta	Present
follo	Present
dramatitzaríeu	None
dissenyéssiu	Past
traurien	None
edificades	Past
afavorir	None
tronar	None
guariria	None
reaccionin	Present
mossegaríem	None
excedeixin	Present
enfondreu	Future
copiat	Past
obliga	Present
informaré	Future
extingiria	None
integrant	Present
enregistrà	Past
occidentalitzar	None
insultareu	Future
retornaria	None
bufarien	None
confonent	Present
creixeria	None
menyspreant	Present
fotuda	Past
remuntar	None
alegren	Present
habitin	Present
ascendiria	None
neutralitzaria	None
manipular	None
codifiquen	Present
exhalar	None
cantaven	Past
inaugurant	Present
estenguessin	Past
dispararien	None
constitueixo	Present
modelo	Present
lluiten	Present
descomponen	Present
aturis	Present
immigres	Present
menyspreats	Past
voldrà	Future
volto	Present
augmentades	Past
canviaríeu	None
oblido	Present
intimidades	Past
aconsellaven	Past
tinguda	Past
estabilitzarien	None
homenatjar	None
abatien	Past
ajornar	None
destorbar	None
alliberéssim	Past
reclames	Present
soterraria	None
sacsejà	Past
orada	Past
traure	None
solidificat	Past
col·laborat	Past
debilitaven	Past
preparo	Present
perpetuant	Present
terroritzats	Past
hipnotitzaria	None
tem	Present
agitant	Present
dominada	Past
sancionaríem	None
reprenguí	Past
encunyada	Past
dogmatitzàvem	Past
graduaria	None
recordaria	None
exposàvem	Past
foten	Present
urgir	None
períreu	Past
acostaria	None
dictaven	Past
intentaran	Future
sospitada	Past
veiem	Present
proclamat	Past
ascendiré	Future
felicitar	None
beu	Present
cometre	None
retindran	Future
esquitxarà	Future
torrada	Past
obtén	None
dubtarà	Future
crema	Present
derivaven	Past
uniformis	Present
incorporada	Past
clamar	None
esterilitzades	Past
desconeguéssim	Past
ridiculitzaríeu	None
mastegat	Past
industrialitzat	Past
magnetitzaves	Past
forada	Present
silenciaries	None
assolaria	None
pararan	Future
amat	Past
enutja	Present
cremes	Present
miolar	None
estalviarem	Future
responc	Present
capitularíem	None
dispersa	Present
adoptada	Past
acorralat	Past
giraria	None
aparegué	Past
concedir	None
matar	None
involucraré	Future
volarien	None
distribuirà	Future
confondre	None
intersectar	None
domino	Present
construir	None
regalaven	Past
industrialitzaren	Past
cobres	Present
felicitat	Past
elevo	Present
ferrar	None
apostar	None
exhibien	Past
rebel·laries	None
arrossega	Present
corresponguin	Present
pruirien	None
progressessis	Past
ometent	Present
mullant	Present
simpatitzar	None
admeteren	Past
arregla	Present
soldat	Past
catalanitzar	None
excel·lires	Past
tempta	Present
purificada	Past
ensordir	None
perpetra	Present
atenua	Present
comences	Present
taquen	Present
immobilitzaríem	None
temptant	Present
llicenciades	Past
actuar	None
renovades	Past
utilitzaríem	None
vedà	Past
oposar	None
interpretats	Past
jeu	Present
enutjà	Past
gaudien	Past
descoratjaríem	None
centressin	Past
corromput	Past
abandonarà	Future
estiueja	Present
protestessin	Past
revenjà	Past
llançarà	Future
boxaríem	None
vomitarien	None
uniformats	Past
foradaríem	None
rascat	Past
desmoralitzaries	None
sabessis	Past
girarà	Future
passaríeu	None
immigraré	Future
col·laboraràs	Future
lamentaren	Past
xocaran	Future
succeïts	Past
colonitzà	Past
botudes	Past
difamar	None
desafiades	Past
infonent	Present
arraparem	Future
cobrar	None
tirar	None
calcificada	Past
examinaran	Future
neutralitzar	None
atendran	Future
titllat	Past
superarem	Future
anomenen	Present
defenestraríem	None
corrompies	Past
demoliríeu	None
acreditar	None
penjo	Present
sobreescalfant	Present
rovellaríeu	None
nasalitzades	Past
honraria	None
immunitzant	Present
brotades	Past
independitzarà	Future
aguarien	None
automatitzada	Past
abraçàreu	Past
embolica	Present
proclamen	Present
exploraria	None
destaquis	Present
transliterareu	Future
penetra	Present
enllaçarien	None
evoquí	Past
solda	Present
plac	Present
esternudaren	Past
juraré	Future
notarà	Future
guiarà	Future
rimat	Past
ratificà	Past
enregistrarà	Future
vençuts	Past
vetllà	Past
defenso	Present
buscats	Past
asseguro	Present
incrementades	Past
recupera	Present
percebre	None
juraria	None
recordaré	Future
usis	Present
prosperessin	Past
entregat	Past
somiaren	Past
aturades	Past
finalitzarà	Future
cobrint	Present
servits	Past
estimarà	Future
captivà	Past
gelant	Present
amansir	None
desenterrar	None
secretaries	None
surts	Present
accedíssiu	Past
caçàrem	Past
edificàveu	Past
xopes	Present
salis	Present
enllestiríeu	None
optaren	Past
rendirien	None
aprenent	Present
cuina	Present
pagaré	Future
diem	Present
oblida	Present
modulades	Past
pagades	Past
agafaria	None
llavar	None
excitat	Past
despendran	Future
sopes	Present
entendríem	None
solucionaren	Past
desafiarà	Future
modelar	None
aidéssiu	Past
ensorren	Present
sonats	Past
dilatades	Past
relacionaven	Past
percebessis	Past
construïdes	Past
ometen	Present
adornar	None
exasperar	None
assetjaria	None
mana	Present
italianitzar	None
baten	Present
informo	Present
colaria	None
blindada	Past
refugiaren	Past
destinà	Past
insereix	Present
xiuxiuejant	Present
molien	Past
tapen	Present
conduirem	Future
juren	Present
aprova	Present
enfronten	Present
injectant	Present
compondrà	Future
tractar	None
tindries	None
salàreu	Past
difondrà	Future
afavoriren	Past
tanquí	Past
immobilitzàveu	Past
recorreguéssiu	Past
canviaven	Past
empata	Present
enllesteix	Present
rejovenir	None
entendre	None
tardar	None
reduïts	Past
entrats	Past
plegar	None
aglutinàveu	Past
odiaren	Past
enganxà	Past
acompanyes	Present
restringit	Past
liberalitzant	Present
menades	Past
compiléssim	Past
temé	Past
encoratjat	Past
garanteix	Present
traïda	Past
transmeten	Present
dimeritzarà	Future
extreien	Past
acudien	Past
pagats	Past
repartiran	Future
oferiran	Future
rentades	Past
assecades	Past
desamortitzaran	Future
produiria	None
dominats	Past
qüestionessis	Past
perfeccionar	None
encadenar	None
mantingueren	Past
excitar	None
sembléssim	Past
regressareu	Future
dejunen	Present
argüir	None
lamenta	Present
esmicolats	Past
pregar	None
haurien	None
capturaria	None
experimentats	Past
parlaria	None
sacrificats	Past
descendint	Present
precisarien	None
inclogueu	Present
dominant	Present
agonitzar	None
moure	None
participaren	Past
forgessin	Past
condueixes	Present
absoldré	Future
determinades	Past
retallades	Past
arrosseguin	Present
alçarien	None
adoptaria	None
ascendiran	Future
assumírem	Past
nedant	Present
ampliant	Present
emprenien	Past
protestar	None
pesin	Present
guaites	Present
colonitzareu	Future
amputaríeu	None
accelerats	Past
distribuïren	Past
afeblíeu	Past
entrenar	None
advertireu	Future
udolo	Present
rentin	Present
duro	Present
espiaràs	Future
desencadenaven	Past
ficar	None
batejar	None
afalaga	Present
mereix	Present
respectar	None
hesitaràs	Future
il·legalitzaren	Past
vinculats	Past
preparada	Past
inhalats	Past
alleugerida	Past
enllaçà	Past
brodaven	Past
jugaries	None
confiarien	None
trenats	Past
estoven	Present
entrevistes	Present
cedireu	Future
pujarà	Future
lladrades	Past
partint	Present
demano	Present
cregué	Past
arreglaria	None
zigzaguejant	Present
designà	Past
informaran	Future
nasalitzarà	Future
potabilitza	Present
bordo	Present
emboliquéssiu	Past
subministràveu	Past
repetissin	Past
designant	Present
acordat	Past
neden	Present
involucrar	None
vencéssiu	Past
conquistar	None
retalla	Present
succeeixen	Present
intentaré	Future
toquéssim	Past
ferrada	Past
estimulin	Present
tustar	None
desapareixeria	None
contribuirà	Future
faltaran	Future
enxampen	Present
sondejades	Past
desistiria	None
penjar	None
reconcilià	Past
comprovar	None
acabaren	Past
conqueririen	None
informades	Past
privatitzar	None
somiades	Past
divulgada	Past
intentes	Present
acorden	Present
secretada	Past
desencadenaria	None
denunciaria	None
dimitit	Past
menjaria	None
consulta	Present
allotjarà	Future
penetrà	Past
estalviarà	Future
pensarien	None
filtren	Present
superarien	None
teixien	Past
molestes	Present
descendiria	None
atorguen	Present
desafio	Present
morireu	Future
lligant	Present
propaguen	Present
condicioní	Past
beneïts	Past
persistiria	None
precisis	Present
detectaria	None
generessin	Past
sobrevisqueren	Past
estrenaran	Future
substituirien	None
entro	Present
martiritzats	Past
variaren	Past
consideraríem	None
familiaritza	Present
lliuraria	None
reuniries	None
vindria	None
observant	Present
propicio	Present
contagiarien	None
penjarien	None
destina	Present
privatitzat	Past
desobeint	Present
sospitaves	Past
explota	Present
finalitzaria	None
dotorejaríem	None
perseveréssiu	Past
romanc	Present
encarregàvem	Past
aglomera	Present
centralitzant	Present
ingressaria	None
armo	Present
estimaria	None
ordenaren	Past
volaran	Future
planifiquen	Present
guardonar	None
infeccionaven	Past
intensificà	Past
dessin	Past
prenien	Past
descomponien	Past
redactant	Present
vens	Present
empitjoren	Present
exclamaré	Future
eludir	None
importin	Present
acorralant	Present
aturaren	Past
destorbaràs	Future
sol·licitat	Past
caçares	Past
necessitaria	None
parint	Present
exigida	Past
decebran	Future
esgarrií	Past
triar	None
apunyalat	Past
vetis	Present
tronat	Past
iniciar	None
percebrà	Future
rascaries	None
pesar	None
expulsaria	None
cedides	Past
copià	Past
pecarà	Future
cantàvem	Past
improvisades	Past
liderar	None
repetien	Past
dormits	Past
oferiria	None
etiquetàvem	Past
destacaran	Future
inventats	Past
conservada	Past
passeja	Present
allotgen	Present
explotà	Past
allargarien	None
envelliries	None
admeté	Past
resisteixin	Present
aguaita	Present
parodià	Past
sagnaríeu	None
relataren	Past
tibar	None
desafies	Present
confiaren	Past
començar	None
debilitant	Present
esterilitza	Present
boten	Present
teoritzessin	Past
llatinitzats	Past
mengin	Present
creixeren	Past
oblidin	Present
conquistàveu	Past
dauren	Present
guien	Present
qüestionar	None
confiaria	None
conegué	Past
persistint	Present
suggerissin	Past
cooperes	Present
mataran	Future
monopolitzar	None
planejàveu	Past
parlaríem	None
indicaria	None
maní	Past
remenar	None
suposo	Present
verificaran	Future
efectuada	Past
intuïen	Past
reapareixeria	None
apel·laríeu	None
apoderarien	None
ampliarà	Future
qüestionaré	Future
cooperat	Past
parodiat	Past
sepultaries	None
aturar	None
planto	Present
reformarien	None
instal·laria	None
clou	Present
presenten	Present
bombardegéssim	Past
alçà	Past
formis	Present
emmagatzemaries	None
sucaràs	Future
afegiré	Future
coordinaríeu	None
inventis	Present
recolzaria	None
endevines	Present
donaran	Future
modernitzades	Past
caminareu	Future
volà	Past
creuar	None
acordes	Present
dissoldrien	None
nevaríem	None
presidiria	None
iniciaria	None
m'asseuré	Future
zigzaguegí	Past
complauríeu	None
desencadenaries	None
estalvià	Past
repartida	Past
acompanyant	Present
ofendríeu	None
vorejades	Past
ingressarien	None
reaccionàrem	Past
barbats	Past
suborna	Present
rebel·lant	Present
reinicialitzaríem	None
reconquerides	Past
corren	Present
usaria	None
enterrada	Past
evacuades	Past
calgués	Past
resideixin	Present
esgarrar	None
escornà	Past
restringíem	Past
publicaria	None
alfabetitzar	None
respecten	Present
constarà	Future
apoderar	None
conquerires	Past
llepaven	Past
encaixin	Present
enyoren	Present
neutralitzada	Past
acceptaré	Future
té	Present
resultaria	None
guardarien	None
atènyer	None
apel·laria	None
tardaven	Past
pagada	Past
encarregada	Past
puneixin	Present
aconsellades	Past
acusada	Past
planxar	None
inaugurat	Past
manlleví	Past
cauteritzar	None
guanya	Present
viure	None
tustin	Present
iniciarien	None
arxivessin	Past
coexistit	Past
maleeixen	Present
elegiren	Past
desplaça	Present
guardà	Past
lloga	Present
fundaria	None
entendrien	None
reemplací	Past
caigut	Past
obeïen	Past
resultarien	None
brodo	Present
dolgudes	Past
untada	Past
corroiríeu	None
disminuiria	None
catapultada	Past
renilla	Present
entregarien	None
recordaren	Past
reflecteix	Present
desitjarien	None
penalitzar	None
edificats	Past
cantà	Past
callen	Present
basarem	Future
dedica	Present
contaminaríeu	None
millorar	None
distreuen	Present
encadenàveu	Past
pujaria	None
obtinguem	Present
giraven	Past
format	Past
resolguessin	Past
daurades	Past
atorgaria	None
polida	Past
impulsarà	Future
automatitzat	Past
relatar	None
laïcitzaves	Past
queixant	Present
fotografiaries	None
planxat	Past
assoliria	None
escull	Present
familiaritzaran	Future
produïen	Past
penjada	Past
infecta	Present
immobilitzant	Present
enllaçaran	Future
sap	Present
excedireu	Future
rentant	Present
judaïtzàreu	Past
protagonitzaren	Past
acostaran	Future
experimentaven	Past
revoltà	Past
cuirassades	Past
modula	Present
alegrat	Past
descobrissin	Past
confiades	Past
inspeccionada	Past
incorporarien	None
traduïda	Past
plegàrem	Past
limitessin	Past
declararíeu	None
parlaran	Future
subjectives	Present
rascant	Present
introduïts	Past
agregà	Past
atendrà	Future
pasturar	None
espolsar	None
dutxaríem	None
traslladats	Past
reiniciar	None
silenciat	Past
atrofiar	None
solucionaria	None
reprendrien	None
encenguessin	Past
simulant	Present
anuncià	Past
necessitareu	Future
deshumanitzats	Past
esnifaves	Past
tirant	Present
neixen	Present
resoldries	None
americanitzen	Present
modular	None
crearan	Future
col·labora	Present
ballarem	Future
manifestats	Past
etiquetes	Present
liderarà	Future
deixat	Past
salen	Present
creixé	Past
aixeca	Present
ampliïn	Present
propagaria	None
llegirien	None
immortalitzant	Present
lamentant	Present
aglutinaria	None
consolidaran	Future
sostenen	Present
vexaríem	None
ocuparia	None
monopolitzarien	None
emplenàvem	Past
esclatar	None
agradaria	None
visitessin	Past
baixa	Present
podríem	None
calcificats	Past
enfrontarien	None
disputaràs	Future
ofenent	Present
arreglen	Present
embenar	None
enllestida	Past
revingut	Past
indicats	Past
oposant	Present
constà	Past
atreviria	None
falsificades	Past
liberalitzades	Past
representà	Past
ofereix	Present
empatada	Past
llençaria	None
fracasso	Present
aportaven	Past
discutissin	Past
posposades	Past
estabilitzaria	None
proposes	Present
casar	None
esdevenir	None
ingresso	Present
desitgen	Present
estandarditzessis	Past
determinéssiu	Past
estirada	Past
tancada	Past
netejades	Past
destacat	Past
transgredíreu	Past
oposaran	Future
contribuït	Past
anomeno	Present
conec	Present
sabràs	Future
dramatitzada	Past
erigir	None
terminí	Past
barrejaria	None
manifestant	Present
posseiria	None
brillà	Past
colin	Present
abateren	Past
parlà	Past
jutjat	Past
paralitzades	Past
menada	Past
prenc	Present
afirmà	Past
copiàrem	Past
bateren	Past
coagulà	Past
efectuat	Past
variaran	Future
emmascara	Present
comentaria	None
correrien	None
anuncien	Present
infondré	Future
il·lustrades	Past
anuncio	Present
destria	Present
adreces	Present
juraran	Future
restaria	None
començat	Past
modelada	Past
deposada	Past
autoritzaríeu	None
elaboraria	None
portaríeu	None
treno	Present
seguiré	Future
retornada	Past
verbalitzàvem	Past
danyaven	Past
dejunant	Present
esmentaren	Past
memoritzéssiu	Past
manifestàvem	Past
envoltaven	Past
cabre	None
convidin	Present
comprenem	Present
provocà	Past
refutant	Present
ompliren	Past
créixer	None
buidí	Past
narrar	None
confirmà	Past
dotorejades	Past
coincidirà	Future
bombejar	None
negociaven	Past
rovellar	None
frenessin	Past
deduïts	Past
parèixer	None
enfrontaria	None
retindria	None
aprendré	Future
resto	Present
habilita	Present
rellegits	Past
infectà	Past
competirien	None
remeiar	None
paralitzar	None
circular	None
decapitats	Past
desaprovar	None
instal·lin	Present
reviscolar	None
finançaven	Past
aroma	Present
impossibilitaran	Future
desodoritzàrem	Past
confirmar	None
infiltrada	Past
perfeccionant	Present
reconcilien	Present
assolà	Past
abeurar	None
jutjar	None
punir	None
corroborar	None
punxaren	Past
mostrar	None
renunciaria	None
sabies	Past
desplacen	Present
traduirien	None
soparíem	None
dirigiria	None
molestades	Past
nedà	Past
suspendre	None
llegaren	Past
feminitzarem	Future
dedicat	Past
necessitaré	Future
treballareu	Future
robaré	Future
impulsar	None
folrats	Past
ridiculitzats	Past
sancionats	Past
eixiríeu	None
reflectida	Past
tiraria	None
capturar	None
calia	Past
definissin	Past
provaries	None
assetjarà	Future
dilatar	None
acompanyades	Past
bastir	None
ploure	None
mantindrien	None
fundis	Present
teixits	Past
concentrant	Present
aixequin	Present
embarrancar	None
tracto	Present
sol·licitaries	None
encapçalarà	Future
beneficiïn	Present
assenyalarem	Future
negocia	Present
atrapa	Present
mereixes	Present
buscant	Present
mantindria	None
transmetre	None
envellit	Past
oblidaries	None
tinguin	Present
progressar	None
desborda	Present
dialogues	Present
combinat	Past
doblar	None
sacrificaria	None
generalitzaren	Past
cerques	Present
agonitzaren	Past
centrin	Present
amplies	Present
enganyéssim	Past
protestaria	None
segrestar	None
encalçada	Past
transformaríeu	None
reforma	Present
capficats	Past
imitaven	Past
modulàveu	Past
portessin	Past
desemboquis	Present
vigilada	Past
barallin	Present
allargaràs	Future
decidirien	None
renovarà	Future
arrapen	Present
involucraria	None
conreant	Present
aplicaren	Past
ascendirien	None
individualitzats	Past
massacrada	Past
pesca	Present
estacar	None
utilitzades	Past
allunyaven	Past
amputar	None
adonaven	Past
generaven	Past
conservades	Past
triaves	Past
discuteixen	Present
envairien	None
corroir	None
lloo	Present
subjugar	None
recuperaria	None
cornis	Present
manifestes	Present
aportessin	Past
nadarem	Future
desafiar	None
suprimeixen	Present
desfan	Present
menéssiu	Past
importats	Past
teoritzant	Present
semblaves	Past
destaques	Present
renillessis	Past
comprarien	None
forgí	Past
formes	Present
naden	Present
simbolitzo	Present
transcriure	None
demanen	Present
enviaves	Past
descentralitzant	Present
entrenats	Past
aplaudir	None
gelarem	Future
repetirien	None
proclamar	None
verificaria	None
lexicalitzat	Past
entrevistat	Past
reelegien	Past
heretat	Past
sabotejarien	None
il·lustrin	Present
sacsejàveu	Past
enviant	Present
veies	Past
presidiren	Past
retindríem	None
bordes	Present
magnetitzada	Past
pinten	Present
conquerirà	Future
tinguis	Present
polaritzades	Past
cobrien	Past
segellarien	None
bevent	Present
allarga	Present
espanyolitzàreu	Past
cantin	Present
lamentarem	Future
beatifica	Present
suggeríssim	Past
incorporaren	Past
encantarà	Future
castres	Present
domessin	Past
lliuren	Present
ignoressin	Past
interessaria	None
barrejar	None
existir	None
podríeu	None
deriven	Present
advertides	Past
intersectares	Past
combatran	Future
rabejada	Past
sintonitzen	Present
muten	Present
forjar	None
limito	Present
discutiré	Future
poguéssiu	Past
separat	Past
adornada	Past
partirà	Future
coneixeria	None
vedada	Past
disparen	Present
planifica	Present
digereix	Present
envelleixis	Present
cercareu	Future
cuidar	None
defenestraríeu	None
emmagatzemant	Present
impedeix	Present
trobéssim	Past
sobreestimaria	None
graduares	Past
boxareu	Future
seduint	Present
qüestionaren	Past
habilitarà	Future
inspirats	Past
prosperar	None
trenquin	Present
fotografies	Present
oscil·laria	None
penalitzada	Past
adquirir	None
fabricà	Past
observa	Present
protagonitzaves	Past
destino	Present
fundin	Present
plantà	Past
calgui	Present
refugià	Past
oprimien	Past
recordà	Past
etiquetant	Present
adaptats	Past
immolaven	Past
estripa	Present
enllestíem	Past
castrarien	None
estalviaràs	Future
saltarà	Future
desitjaríem	None
tornaria	None
forçant	Present
llogaven	Past
encaixà	Past
aterrats	Past
empràreu	Past
retornarien	None
exhibeixo	Present
esquitxada	Past
roseguen	Present
oblidaria	None
corregir	None
divorciada	Past
mutaria	None
traspassessin	Past
untaven	Past
gratulaven	Past
concentraven	Past
saltaran	Future
indicada	Past
fusionar	None
intersectes	Present
acampà	Past
concorreria	None
confirmarien	None
demanaves	Past
escolliria	None
envellir	None
integrats	Past
afegiríem	None
provessin	Past
divorciades	Past
confirmaran	Future
suprimida	Past
calculaven	Past
invitada	Past
privar	None
partit	Past
devorarem	Future
arrodoniríeu	None
penjàreu	Past
concentraria	None
manllevant	Present
convencéssim	Past
reunirem	Future
absorbida	Past
afebliria	None
estudien	Present
atrapades	Past
hipnotitzar	None
ajudarem	Future
relacionaria	None
somriuré	Future
vetllaria	None
arguït	Past
barbada	Past
enterràveu	Past
marejada	Past
improvisà	Past
elevar	None
distingirem	Future
aportat	Past
existeixen	Present
llegats	Past
envià	Past
especialitzar	None
interessa	Present
adreçaren	Past
omplissin	Past
encreuat	Past
destinares	Past
replicats	Past
personifiquen	Present
regalaria	None
acudir	None
deixaria	None
incrementats	Past
excel·lien	Past
busco	Present
copien	Present
excedeixen	Present
independitzats	Past
cuso	Present
eclipsar	None
denominà	Past
codificar	None
sol·licitant	Present
titubarem	Future
assabentarà	Future
decapità	Past
construït	Past
neutralitzàrem	Past
humanitzar	None
afegirien	None
mutis	Present
estudiaren	Past
controlarien	None
adaptaven	Past
col·laborarien	None
demostres	Present
transgredir	None
espantant	Present
vetada	Past
parits	Past
plantes	Present
traduiria	None
semblat	Past
efectuant	Present
emfatitzàrem	Past
discrimina	Present
portar	None
cridis	Present
arrossegaren	Past
romans	Present
enfonsarà	Future
violaré	Future
refondria	None
dissuadiria	None
voltar	None
jutjaria	None
propiciaríeu	None
respondran	Future
rabeja	Present
modificaren	Past
parlades	Past
partiran	Future
jugat	Past
eliminarien	None
emfatitzéssiu	Past
xiular	None
comptaria	None
pegaria	None
publicades	Past
exilies	Present
trena	Present
exclamar	None
alegrades	Past
assaboreixo	Present
especificaran	Future
infectats	Past
apostant	Present
brindaria	None
escoltessin	Past
canviaria	None
confiat	Past
apoderin	Present
dificultats	Past
obligaven	Past
sospitar	None
dirien	None
beneficien	Present
enregistressin	Past
nodrir	None
moririen	None
planeja	Present
deveu	Present
contribuir	None
repetint	Present
contribuiria	None
trenades	Past
apodera	Present
carregaríem	None
tocada	Past
assolit	Past
separen	Present
rememorar	None
badallar	None
elevaria	None
oscil·lo	Present
atengueren	Past
refrescant	Present
córrer	None
dirigeix	Present
habilitada	Past
tapats	Past
marcaren	Past
restada	Past
accediria	None
collits	Past
liberalitzà	Past
inserien	Past
descrivim	Present
fabricaran	Future
rebaixades	Past
enterbolit	Past
robar	None
revoltes	Present
subestimats	Past
condicionats	Past
volaries	None
realitzaràs	Future
desistissin	Past
reiniciarien	None
coincidissin	Past
esclatis	Present
influiran	Future
condemnaren	Past
reuníssim	Past
xiulada	Past
cedeixin	Present
suposarien	None
posposats	Past
donaríem	None
aporta	Present
realitzarien	None
aconseguiria	None
boicotejaves	Past
renunciar	None
tirotejat	Past
atenien	Past
reteniu	Present
perir	None
estires	Present
destorba	Present
trobar	None
descendiríem	None
establiré	Future
precisa	Present
abandonats	Past
enganxareu	Future
anomenarien	None
parida	Past
reverida	Past
desféssiu	Past
calcularem	Future
publico	Present
represento	Present
trucaríem	None
refugiades	Past
emancipar	None
neutralitzant	Present
reveriríeu	None
passarien	None
escollirien	None
inicialitza	Present
toco	Present
perdien	Past
acordis	Present
crèiem	Past
dominaven	Past
conceptualitzaria	None
ponies	Past
mesclo	Present
extrauria	None
restringeixin	Present
soldades	Past
exhibeix	Present
dictà	Past
obliquàveu	Past
estén	Present
reorganitzats	Past
convocats	Past
importaríeu	None
popularitzarà	Future
retirà	Past
dubtaven	Past
respectà	Past
anhelàrem	Past
reconeixen	Present
llegiré	Future
eviten	Present
integro	Present
suspenent	Present
col·locà	Past
suplir	None
ancorades	Past
col·leccionats	Past
talla	Present
planxaran	Future
rellegeix	Present
entraria	None
derives	Present
rebre	None
concentràrem	Past
compareixen	Present
narrades	Past
arribaria	None
milloraran	Future
immolàreu	Past
patirien	None
cabí	Past
investigarà	Future
cancel·laven	Past
suquejaven	Past
especialitzen	Present
mullàvem	Past
cercat	Past
trairà	Future
apreciar	None
reemplaçades	Past
aprovarien	None
ateníem	Past
adoptades	Past
empres	Present
cremarien	None
desenvoluparies	None
intueixis	Present
enllestiren	Past
continuar	None
aliaria	None
remoldràs	Future
sorgien	Past
marxaria	None
nuats	Past
inauguraren	Past
repetiran	Future
refusessis	Past
ixes	Present
evolucionat	Past
fumaríeu	None
escrivien	Past
transferint	Present
descendirien	None
promogudes	Past
compararies	None
mercantilitzaries	None
emboliquen	Present
pixen	Present
ajudaria	None
suplicaven	Past
ancoraven	Past
creguis	Present
desenvoluparen	Past
exterminar	None
modulada	Past
encadenà	Past
qüestionà	Past
preparades	Past
intervinguessin	Past
violar	None
dansaves	Past
augmentaria	None
interpretin	Present
designes	Present
desenvoluparà	Future
conceptualitzen	Present
flairàvem	Past
uniformades	Past
terroritzant	Present
utilitzarem	Future
marcades	Past
esclatarà	Future
gamba	Present
imitar	None
derivarà	Future
constats	Past
nado	Present
esgarrapat	Past
resessin	Past
governarà	Future
engolir	None
destorbaven	Past
participat	Past
dragar	None
afartar	None
caracteritzades	Past
morint	Present
independitza	Present
influiria	None
simpatitzàreu	Past
treballarien	None
pescat	Past
construint	Present
desmilitaritzaren	Past
afecta	Present
copiarà	Future
creuria	None
tolgueres	Past
localitzats	Past
sentirien	None
consultà	Past
privat	Past
forjaven	Past
emprendrien	None
suggereixo	Present
localitzaven	Past
aïna	Present
serviríeu	None
provingué	Past
caminada	Past
retíem	Past
classificar	None
destinar	None
integrada	Past
llatinitzada	Past
examinaven	Past
experimentaria	None
començarien	None
copiar	None
modificades	Past
esclatà	Past
oloraríeu	None
col·locarem	Future
negociar	None
trenquen	Present
modelat	Past
entraren	Past
ubicar	None
tustà	Past
requereixen	Present
somia	Present
triomfarien	None
estimades	Past
fundarà	Future
tractaria	None
obtindré	Future
movien	Past
pengessin	Past
animalitzàveu	Past
excel·lint	Present
dissenyà	Past
introduirien	None
exerciria	None
dubtin	Present
plora	Present
saltada	Past
gravarien	None
classifiquessin	Past
incorporaven	Past
ferissin	Past
distingida	Past
exercir	None
repetiré	Future
emmagatzemaria	None
punxes	Present
disposessin	Past
competeix	Present
bastida	Past
cancel·lareu	Future
llençarà	Future
dominarien	None
estimularia	None
reaparegueren	Past
incrementen	Present
aplaudint	Present
assumint	Present
reapareixeran	Future
tancarien	None
provenien	Past
enviaria	None
derrotar	None
assenyalaria	None
teixeixen	Present
arriscarien	None
acolliren	Past
ancoren	Present
industrialitzades	Past
teoritzat	Past
prendre	None
anglicitzada	Past
conquista	Present
estiressin	Past
miolaven	Past
desenterrant	Present
refusat	Past
privin	Present
assaborit	Past
provocada	Past
arrapades	Past
esmenar	None
prohibir	None
pensant	Present
llançàrem	Past
replicaven	Past
idolatra	Present
portà	Past
atemptar	None
controlarà	Future
discutint	Present
menjà	Past
perpetrada	Past
cobririen	None
cuinaren	Past
desenterrada	Past
organitzat	Past
citarem	Future
conquerir	None
rebaixaria	None
convidaren	Past
emetrien	None
interessar	None
sofririen	None
desfessis	Past
fortificar	None
significar	None
incorporaríeu	None
denuncià	Past
proclamaven	Past
crides	Present
sorprendrem	Future
liberalitzar	None
sabíeu	Past
girarien	None
contractaria	None
arriscada	Past
formant	Present
dirimiríem	None
esdevinguda	Past
agonitzo	Present
torturar	None
destruïdes	Past
entusiasmà	Past
agrairan	Future
alterar	None
transmetria	None
atrevits	Past
activà	Past
convidar	None
aïllaren	Past
estudiarien	None
eclipsen	Present
presta	Present
causar	None
posposaven	Past
titllar	None
acariciar	None
refregaria	None
identificaria	None
treure	None
refugiant	Present
atacada	Past
modificat	Past
botessin	Past
veurien	None
afusellant	Present
doblades	Past
puneixen	Present
vaporitzar	None
formar	None
alleugerit	Past
parlarien	None
escoltarien	None
deixéssim	Past
degradin	Present
podrà	Future
passejar	None
acompanyaria	None
reconstruirà	Future
sono	Present
negarien	None
pensades	Past
filtro	Present
entretinguessin	Past
llegiries	None
períssim	Past
italianitzaríem	None
arreglin	Present
harmonitzar	None
manifestaries	None
reflectir	None
contempla	Present
adquirida	Past
distribuiria	None
viuria	None
funciones	Present
acusin	Present
suaren	Past
propaguessin	Past
ofegat	Past
ingressada	Past
nominades	Past
tiràreu	Past
sanciona	Present
discuteixin	Present
comandada	Past
continuarien	None
profetitzar	None
ensopirien	None
llogà	Past
erigiren	Past
alternar	None
admiraren	Past
eguinéssim	Past
arreglaren	Past
tiranitzarem	Future
rendides	Past
culminar	None
usant	Present
anomenin	Present
llegeixen	Present
rascaven	Past
menjarem	Future
soldaven	Past
absorbeixen	Present
dimitir	None
examinaren	Past
oposades	Past
mantinguem	Present
fusionen	Present
inspeccionat	Past
espiades	Past
traumatitzar	None
islamitzar	None
apostats	Past
il·luminares	Past
contribueix	Present
imposat	Past
corrompéreu	Past
coneixerien	None
exorcitzar	None
esternudar	None
pagues	Present
acceptaven	Past
faltin	Present
olorats	Past
internacionalitzar	None
fraternitzéssiu	Past
agruparan	Future
analitzessin	Past
signaven	Past
enderrocar	None
acusarien	None
industrialitzàvem	Past
punxats	Past
canviaren	Past
afalagat	Past
aconseguides	Past
sorprendria	None
salaríem	None
caminaran	Future
dessalinitzada	Past
estripar	None
presa	Past
llicenciarem	Future
encapçalar	None
derrotà	Past
mantingueres	Past
animar	None
torturaven	Past
felicitis	Present
jaurien	None
emmascaràvem	Past
cobrarien	None
descriuríem	None
dubtant	Present
explicaria	None
avançada	Past
rebentaria	None
cercaria	None
mostro	Present
fracassàvem	Past
revenjar	None
pugessin	Past
relaxada	Past
replicades	Past
colonitzessin	Past
xatejaria	None
nàixer	None
crucificat	Past
emprenent	Present
practicaria	None
reuniran	Future
esglaiaven	Past
acostumar	None
extreure	None
assetjo	Present
excedida	Past
reemplaçaria	None
davalla	Present
impedida	Past
informin	Present
edificaré	Future
mortificades	Past
cauteritzis	Present
reformaria	None
llicenciar	None
transfereix	Present
desplaçarà	Future
retindrien	None
disminuirà	Future
perdrien	None
abat	Present
perdonà	Past
distancia	Present
centrar	None
temptaré	Future
encaixarien	None
tolerada	Past
italianitzat	Past
capturaven	Past
cedírem	Past
atribueixen	Present
aconseguit	Past
deixarien	None
immigrar	None
inicialitzar	None
estudiessin	Past
traspassades	Past
actuaran	Future
descriuran	Future
globalitzar	None
imantàrem	Past
dissolguérem	Past
barallarà	Future
esmenant	Present
votares	Past
donar	None
adoren	Present
classificaran	Future
salvant	Present
citades	Past
pararien	None
reconegueren	Past
legislada	Past
procediria	None
beuré	Future
disposéssim	Past
calmar	None
reclamaria	None
sumaves	Past
rompen	Present
ric	Present
menar	None
anhela	Present
aixecàveu	Past
cicatritzat	Past
atribuïssin	Past
celebrar	None
cabries	None
desitjo	Present
enfoquis	Present
aidin	Present
lluitar	None
sincronitzada	Past
abaixen	Present
cremin	Present
mogudes	Past
posseïssis	Past
defensa	Present
entrevistats	Past
causaria	None
digitalitzar	None
coordinarà	Future
forces	Present
assistiríeu	None
enfrontar	None
disposarien	None
substitueixen	Present
sofriran	Future
empatarà	Future
giraran	Future
carregaria	None
reescalfar	None
deïficant	Present
sobreestimar	None
constaran	Future
tires	Present
conduït	Past
estacareu	Future
citat	Past
intensificaran	Future
anunciessin	Past
refutaríem	None
rascades	Past
reduirien	None
transformar	None
servien	Past
descompondre	None
atraure	None
jeure	None
explicat	Past
devorarien	None
destrossaren	Past
diagnosticar	None
deguda	Past
garanties	Past
reverenciïs	Present
ampliaria	None
pelaran	Future
saludàrem	Past
vociferant	Present
participarien	None
expulsen	Present
manifestar	None
protagonitzaven	Past
capolada	Past
saciar	None
mostres	Present
nacionalitzades	Past
actualitzats	Past
existit	Past
sorgirien	None
posseiríem	None
endeutar	None
pronunciar	None
uniformant	Present
convertires	Past
perpetuaves	Past
enfonsaria	None
centralitzà	Past
trucaria	None
segellarem	Future
massejada	Past
il·legalitzant	Present
podries	None
veure	None
signàveu	Past
enfrontaríem	None
atrofia	Present
bastissin	Past
alimentarien	None
dius	Present
suggerir	None
banyen	Present
apliquin	Present
evocaria	None
imposarien	None
retira	Present
vetat	Past
sofriria	None
atorgaríeu	None
rebaixen	Present
ampliar	None
cobrades	Past
solucionin	Present
travessar	None
cridà	Past
encapçalaries	None
amenaçant	Present
promogué	Past
insultà	Past
constituirien	None
tingué	Past
rondinar	None
identificarien	None
salvarà	Future
articularíeu	None
formàvem	Past
expliquessis	Past
enfocaríeu	None
restauraria	None
exhumaries	None
sopat	Past
comptat	Past
estaques	Present
jubilat	Past
hec	Present
senyalant	Present
impediria	None
destrossar	None
seguiria	None
faltant	Present
convencessin	Past
adorant	Present
reorganitzéssim	Past
encapçalarien	None
assimilaria	None
mouries	None
voldreu	Future
perpetraré	Future
viuràs	Future
reconqueriren	Past
diferenciada	Past
catapultaria	None
reprenien	Past
combateren	Past
dimitiria	None
regressar	None
excitessis	Past
produïts	Past
augmentar	None
milloris	Present
estan	Present
temptaren	Past
frena	Present
enllacessin	Past
desapareguessin	Past
apunyalarà	Future
reforcin	Present
escampo	Present
torturades	Past
salaria	None
oraria	None
orinen	Present
exiliada	Past
solucionarà	Future
retinguda	Past
descriu	Present
dansarien	None
modernitzant	Present
redactàvem	Past
tingueren	Past
inclourien	None
fitxades	Past
economitzar	None
expel·lint	Present
observà	Past
dificultaren	Past
rotar	None
preservaríem	None
movem	Present
justifiquessin	Past
compilat	Past
asseguraran	Future
duplicats	Past
treballà	Past
comportaves	Past
empitjorant	Present
revolta	Present
traspasso	Present
disparo	Present
serien	None
consisteixin	Present
brotada	Past
perdonar	None
xiulaven	Past
exageraria	None
tremolen	Present
rodares	Past
agrair	None
acceptarien	None
trucar	None
esglaia	Present
fumant	Present
sol·licitar	None
pentinada	Past
empatar	None
atreuen	Present
allunyessin	Past
venguin	Present
permeten	Present
insultats	Past
escalada	Past
juressin	Past
demanarien	None
alleugerir	None
moguessis	Past
aplaudeixo	Present
basa	Present
obries	Past
verbalitzàrem	Past
celebréssiu	Past
vine	None
abatre	None
creessin	Past
condicionaria	None
exercirien	None
bombardejarien	None
conjuntes	Present
callar	None
penjaria	None
rimar	None
provoca	Present
rebentaven	Past
simularem	Future
sobreviure	None
imaginar	None
profunditzaríem	None
adobarem	Future
plorar	None
llogarien	None
ajudar	None
anomenaves	Past
ascendit	Past
abraçares	Past
vomitar	None
reiniciat	Past
destorbaran	Future
queixa	Present
sortides	Past
aboleix	Present
anticiparen	Past
reapareix	Present
aixecarien	None
degradaran	Future
desbloquejaríeu	None
sobreestimat	Past
dedicaré	Future
escurarem	Future
datades	Past
mostressin	Past
moguéreu	Past
estiraren	Past
reconciliades	Past
investigares	Past
treballessin	Past
inventat	Past
dataria	None
duplicades	Past
frenant	Present
afirma	Present
realitzaven	Past
refusen	Present
protegissin	Past
esclatessin	Past
moralitzar	None
incorporar	None
aplicar	None
aturant	Present
rodat	Past
guanyant	Present
reben	Present
bombardegen	Present
distrauríeu	None
embrutades	Past
informarà	Future
visitarien	None
reclamar	None
estarien	None
comuniquessin	Past
ruixar	None
triaria	None
acabar	None
prohibiria	None
maleiríeu	None
descriguin	Present
funda	Present
dansar	None
exiliades	Past
manifestarà	Future
mantinc	Present
monetitzar	None
refutaven	Past
comprendre	None
giraren	Past
emprarien	None
subjugada	Past
declararà	Future
resoldrem	Future
centren	Present
dedicant	Present
sintetitzarien	None
peco	Present
rompran	Future
penetraven	Past
conreades	Past
imaginin	Present
apostessin	Past
cancel·lar	None
desencadenarien	None
forjaria	None
ajudant	Present
governaran	Future
atemptà	Past
explicaran	Future
explotaria	None
semblades	Past
vorejaven	Past
devoris	Present
masticats	Past
sortiria	None
transmeteren	Past
sincronitzen	Present
parlis	Present
vindrà	Future
estiuejàvem	Past
col·locar	None
necessitar	None
descriuria	None
trobareu	Future
corroborin	Present
raucats	Past
reforçant	Present
plorat	Past
colar	None
quedaríem	None
voltaríem	None
malvenguérem	Past
reapareixien	Past
deprimeixen	Present
espanyolitzaríem	None
envia	Present
buscarien	None
trobada	Past
infecciones	Present
abeuraries	None
contemplant	Present
rovellant	Present
extingint	Present
identificant	Present
escales	Present
vomitares	Past
orar	None
dissenyarem	Future
justificarà	Future
aposta	Present
enviar	None
finalitzats	Past
carreguí	Past
classificà	Past
assabentar	None
persisteixen	Present
magnetitzen	Present
punxaria	None
conversa	Present
grato	Present
acaronar	None
vinculàrem	Past
mitigà	Past
preciso	Present
forcis	Present
carbonitzarem	Future
avantatjats	Past
curar	None
corregits	Past
capficaven	Past
mata	Present
condicionar	None
assisteixen	Present
atenuàvem	Past
desenvolupareu	Future
suïciden	Present
col·locarà	Future
acordades	Past
deixessin	Past
intensificaria	None
retingudes	Past
dinamitzat	Past
curessin	Past
aconsella	Present
ofegar	None
hagin	Present
colpejaven	Past
exclaméssim	Past
nodriren	Past
inhumats	Past
lloada	Past
alliberaven	Past
fumo	Present
excreten	Present
descoratjada	Past
anhelats	Past
vociferada	Past
trinxaràs	Future
decretant	Present
inspirarien	None
omplin	Present
congelessin	Past
tremolar	None
enderrocades	Past
occit	Past
critiquí	Past
falsejares	Past
congelats	Past
enfonsant	Present
polint	Present
entrevistada	Past
salvats	Past
tindria	None
resistiria	None
sotmeten	Present
trigar	None
paguen	Present
tirades	Past
sobrevolar	None
alternada	Past
defensar	None
visquis	Present
ingressar	None
voldràs	Future
refregar	None
vehicularen	Past
identificats	Past
inutilitza	Present
catalanitzat	Past
desfeies	Past
durar	None
proposarien	None
falsifiquen	Present
incloguessin	Past
dejuna	Present
esmentat	Past
debutar	None
arrossegaria	None
idolatrar	None
decidiren	Past
ronques	Present
pol·linitzaríem	None
diràs	Future
remar	None
treballaria	None
il·luminar	None
comprendria	None
peso	Present
traspassaria	None
recomptin	Present
economitzis	Present
personificar	None
sancionaries	None
veieu	Present
tibis	Present
sobrevivint	Present
anglicitzar	None
armin	Present
hauríeu	None
marxant	Present
alimentaven	Past
convocada	Past
travessades	Past
gustareu	Future
toquessin	Past
identificat	Past
dits	Past
aglomeris	Present
expressarà	Future
cremaven	Past
reprenguin	Present
reconciliant	Present
acollien	Past
mereixeren	Past
colat	Past
absoldre	None
sentiria	None
fomentar	None
resultes	Present
especificada	Past
transferides	Past
augmentaríem	None
portaria	None
falsificant	Present
cantis	Present
vinguis	Present
cooperaria	None
ridiculitza	Present
romandrien	None
duraria	None
ballaria	None
complirà	Future
prengueren	Past
cristal·litzaria	None
prosperat	Past
miraria	None
semblar	None
anticipà	Past
arrissar	None
efectuen	Present
verificaven	Past
inclinarà	Future
mossegaven	Past
concloc	Present
eixien	Past
desconeixien	Past
fusionant	Present
memoritzen	Present
ignoraria	None
rotis	Present
informaríem	None
casquin	Present
clamant	Present
alimentat	Past
demostraven	Past
centrades	Past
rient	Present
fenc	Present
imaginat	Past
comandar	None
educades	Past
construiria	None
progressaria	None
inspeccionaràs	Future
barreja	Present
significades	Past
guarnir	None
alçat	Past
acompanyat	Past
vetades	Past
constituïen	Past
vacil·larem	Future
saludat	Past
series	None
fragmentà	Past
provar	None
col·leccionar	None
encaixar	None
subhastada	Past
circumcidat	Past
afavoriran	Future
coagularan	Future
subhastes	Present
criticant	Present
governaren	Past
consolidarien	None
promourien	None
mataries	None
escandalitzar	None
aprofitar	None
veurà	Future
exhibiren	Past
oscil·lar	None
coronar	None
aiden	Present
lubricats	Past
participaran	Future
filtraren	Past
frenaria	None
dividint	Present
refrigerant	Present
gemegar	None
volien	Past
estaries	None
anticiparà	Future
gira	Present
alarmar	None
temptaves	Past
sancionades	Past
allotjats	Past
designarien	None
saquejant	Present
uniforma	Present
solucionis	Present
estalviàveu	Past
inspirà	Past
xocaven	Past
ponen	Present
nuo	Present
curséssim	Past
diran	Future
transportí	Past
anunciats	Past
votant	Present
excedir	None
perpetues	Present
envairia	None
competiran	Future
buscar	None
buiden	Present
racionalitzen	Present
orinaran	Future
cediria	None
conversaries	None
proposar	None
caldria	None
pugis	Present
compartiríeu	None
alternaria	None
exposessin	Past
enfocaren	Past
derivaria	None
segar	None
notar	None
assecar	None
localitzin	Present
informa	Present
rendien	Past
tractades	Past
produïssin	Past
absorbides	Past
atorgarien	None
compensa	Present
habitaren	Past
casaria	None
corregírem	Past
basar	None
registro	Present
pactaria	None
reformar	None
mouria	None
repartiríeu	None
interpretar	None
remen	Present
infiltraren	Past
desistir	None
abrigo	Present
requeriries	None
fracassar	None
acampareu	Future
pairia	None
importa	Present
poblant	Present
secreten	Present
contraposaries	None
imitades	Past
proclamaria	None
sucaren	Past
parlaré	Future
concloguessis	Past
marxarà	Future
preparant	Present
transfongueren	Past
critica	Present
adquiriràs	Future
desencadenar	None
pactis	Present
humanitzí	Past
personificada	Past
aprendre	None
finíssim	Past
cristal·litzà	Past
ferrin	Present
motiven	Present
caracteritzarien	None
reconèixer	None
extrapolareu	Future
agregades	Past
estalviada	Past
refuso	Present
sexà	Past
aguaitant	Present
plantejaren	Past
arribaràs	Future
pol·linitzar	None
rabegéssiu	Past
acarones	Present
decidir	None
cuejaren	Past
disputa	Present
descoratjat	Past
emigressis	Past
doblarem	Future
ensorraves	Past
perfeccionades	Past
comportar	None
subministraren	Past
silenciada	Past
encoratjar	None
urgiren	Past
reverencià	Past
defensant	Present
carregaran	Future
centrats	Past
comprades	Past
calcificar	None
restringeixen	Present
prové	Present
estoví	Past
convocaria	None
sobreestimaríeu	None
informar	None
exposaven	Past
redactaria	None
preservaran	Future
folrar	None
polaritza	Present
consultin	Present
vencereu	Future
triomfaria	None
assabentant	Present
arrossegada	Past
atribuiríem	None
refreguéssiu	Past
considerà	Past
inserires	Past
jugaria	None
desbloquejat	Past
travessaríeu	None
cagaríeu	None
trigarien	None
lliurà	Past
especificà	Past
senyalaríem	None
sabria	None
flairarien	None
calcularia	None
categoritzen	Present
cruixireu	Future
parles	Present
tanquen	Present
resolent	Present
deixar	None
massacraria	None
rebrien	None
multiplicada	Past
acostà	Past
representar	None
participes	Present
visitaren	Past
empès	Past
imposaria	None
falsificada	Past
davallada	Past
moguis	Present
garantien	Past
desplaçarien	None
matessin	Past
autoritzaria	None
enfadar	None
originarien	None
consultaria	None
existiria	None
superaran	Future
requerien	Past
participaré	Future
evolucionats	Past
abdicaríem	None
manis	Present
caurien	None
recordar	None
domaries	None
brindar	None
esperar	None
automatitzàrem	Past
ofegaria	None
construeix	Present
agonitzareu	Future
enganxéssim	Past
elabora	Present
conteniu	Present
expulsar	None
empra	Present
judaïtzar	None
rebutjaran	Future
eclipso	Present
consideressin	Past
usarà	Future
marejats	Past
acamparien	None
conclogueren	Past
entenguérem	Past
refugiats	Past
estudiaria	None
consultis	Present
prestes	Present
veuràs	Future
representen	Present
cargolant	Present
irritaríeu	None
pentinen	Present
encén	Present
colats	Past
firmessin	Past
toleraven	Past
reeixien	Past
extingissin	Past
impulso	Present
penetraren	Past
revistat	Past
determinessin	Past
afartàvem	Past
recomptes	Present
impedit	Past
derrotats	Past
manipulada	Past
assimilàvem	Past
prosperin	Present
arrencaren	Past
assolir	None
afirmarien	None
inhibiria	None
modificarien	None
interpreten	Present
allargats	Past
empresonaven	Past
compartiria	None
motivin	Present
restarà	Future
mercantilitzen	Present
diuen	Present
pinto	Present
transportaria	None
desprendre	None
refredant	Present
reorganitzant	Present
consolidar	None
pescaven	Past
esternuda	Present
esgarriarien	None
treballa	Present
podrien	None
justificàrem	Past
salades	Past
llançades	Past
refrigerat	Past
folrada	Past
suplicàreu	Past
italianitzàrem	Past
esquitxen	Present
bordar	None
tractaran	Future
comprendrien	None
fixarien	None
comportaríem	None
despens	Present
injectà	Past
il·lumina	Present
disposaria	None
suaria	None
conjugues	Present
desaprovo	Present
guanyaràs	Future
pruïda	Past
contaminar	None
combinarien	None
reaccionà	Past
adreço	Present
recull	Present
grapegessis	Past
respectarien	None
separats	Past
enfonsarien	None
pelà	Past
afeblien	Past
labora	Present
inserint	Present
embarrancada	Past
espiada	Past
digues	None
lliurar	None
lletrejares	Past
recomençaré	Future
milloraven	Past
calcificades	Past
prestar	None
exposes	Present
finançaries	None
profetitzant	Present
assumits	Past
masteguen	Present
abolir	None
inclinant	Present
encunya	Present
incloïes	Past
departeixes	Present
corregissin	Past
capturat	Past
trair	None
plantarem	Future
disminuïdes	Past
cedir	None
esterilitzí	Past
cessen	Present
salvaria	None
empitjoraria	None
vigilar	None
observàrem	Past
badallen	Present
esqueixar	None
alleugera	Present
penis	Present
pesaven	Past
estiuejà	Past
prohibiren	Past
conquerits	Past
anglicitzat	Past
produïes	Past
contravindran	Future
reclamarien	None
convidant	Present
alterant	Present
saboteja	Present
refrigerar	None
refino	Present
demolint	Present
pactaven	Past
detindran	Future
llepa	Present
molen	Present
témer	None
falsejades	Past
agraïts	Past
pago	Present
prioritzant	Present
definits	Past
telefonaríeu	None
entrenaria	None
vocalitzar	None
reformat	Past
consagraríeu	None
bombardejades	Past
regalaríeu	None
ossificaríeu	None
estableixen	Present
reflectit	Past
culminarien	None
hesitaria	None
reduïssin	Past
costa	Present
retràs	Future
superaven	Past
designin	Present
volaria	None
democratitzat	Past
ubicàveu	Past
acollits	Past
modelen	Present
esquitxar	None
detindrien	None
escollir	None
suat	Past
assassinaríem	None
recolliren	Past
limitats	Past
prioritzar	None
dedico	Present
coexistiries	None
despenent	Present
independitzen	Present
recorda	Present
aprofitarien	None
urbanitzar	None
conjuntats	Past
atraparien	None
telefonarien	None
definida	Past
sondeja	Present
afegirà	Future
provocar	None
volgueren	Past
emmagatzemats	Past
cruix	Present
fotogravarien	None
queixis	Present
localitzat	Past
emmagatzemada	Past
examinin	Present
rovello	Present
paguessin	Past
varies	Present
omplir	None
confirmaren	Past
sofrien	Past
facilitarà	Future
soterrant	Present
triant	Present
refusades	Past
broden	Present
sostindrien	None
intervindria	None
gustar	None
variaria	None
abraçar	None
multipliques	Present
plorant	Present
lidera	Present
prometé	Past
nomenaria	None
trucat	Past
registraran	Future
florit	Past
emancipat	Past
pixaré	Future
passejaren	Past
persistit	Past
envejant	Present
estudiaran	Future
manifesta	Present
articular	None
aglutinades	Past
disputaria	None
ometéssim	Past
parodiar	None
baixats	Past
vigilaràs	Future
instal·la	Present
esclafades	Past
adonaran	Future
votaria	None
pol·linitza	Present
compraran	Future
vencessin	Past
rebutjar	None
cargoles	Present
deurien	None
lletrejat	Past
instal·laren	Past
prestats	Past
exposarien	None
mossegar	None
expulsí	Past
completaren	Past
assistida	Past
encalçar	None
fotografiar	None
editen	Present
segrestada	Past
estigmatitzada	Past
guanyaré	Future
sintetitzen	Present
advertiries	None
dejunes	Present
participis	Present
edificar	None
buscàrem	Past
duplicat	Past
seguides	Past
captivéssim	Past
replicar	None
desodores	Present
dessalaríeu	None
agrairíem	None
planificaren	Past
oblidant	Present
limitarien	None
expandeixen	Present
apostaven	Past
adonà	Past
renunciessin	Past
continuaran	Future
contradiria	None
aconsegueix	Present
condicionarien	None
paguin	Present
coneixeríem	None
passejat	Past
apoderessin	Past
catalitzar	None
pujaríem	None
enxampa	Present
trigaran	Future
llatinitzaríem	None
subratlléssim	Past
concedida	Past
substituiria	None
democratitzaríem	None
pequin	Present
reinicialitzaria	None
callada	Past
emplenaven	Past
guarden	Present
calla	Present
ubicant	Present
aixecaria	None
bramin	Present
embenats	Past
folrades	Past
variar	None
entraré	Future
aplicaven	Past
superin	Present
reorganitzaren	Past
negà	Past
banyéssiu	Past
privatitzà	Past
distingit	Past
intitularàs	Future
eduquessin	Past
silencio	Present
creurà	Future
expressades	Past
reverenciaves	Past
informaven	Past
extraiem	Present
dediquen	Present
marxes	Present
familiaritzares	Past
desembarcaren	Past
adona	Present
enyorat	Past
despertar	None
començaria	None
integrades	Past
planejaven	Past
fumàrem	Past
halis	Present
partirien	None
atomitzar	None
rejoveneixis	Present
admetria	None
cuirassada	Past
coneguis	Present
publicar	None
apercebien	Past
detenir	None
gratat	Past
harmonitzà	Past
desbloqueges	Present
propiciarien	None
perdonaren	Past
neixes	Present
importaria	None
estimulessis	Past
donaren	Past
preservats	Past
alienaria	None
pegà	Past
distingirà	Future
reiterar	None
coneixem	Present
udolar	None
pesaria	None
dividirà	Future
eclipsà	Past
divulgats	Past
obririen	None
honra	Present
mobilitzàvem	Past
especificar	None
miolarà	Future
instal·len	Present
dibuixessin	Past
divulga	Present
desvetllarà	Future
extingien	Past
reconquerint	Present
obrirà	Future
colonitzaren	Past
untats	Past
trencaria	None
reeixir	None
estudià	Past
exageren	Present
dificultarà	Future
enlluernar	None
allotjaria	None
atraparà	Future
cauteritzen	Present
concentrada	Past
donessin	Past
introdueixen	Present
malvenguessin	Past
presidiríem	None
beus	Present
calmo	Present
fundo	Present
compareixent	Present
redimirien	None
devorares	Past
baté	Past
fornejar	None
agregarien	None
malvendre	None
sentissin	Past
pujà	Past
sospitat	Past
tapat	Past
pugen	Present
ampliaren	Past
redacta	Present
decebo	Present
conduïen	Past
rebel·lar	None
radicalitzà	Past
desclouran	Future
demostraren	Past
suggeriren	Past
remenaven	Past
esperaríem	None
preveure	None
clamen	Present
datà	Past
extingeixen	Present
pesaríeu	None
omples	Present
nacionalitzà	Past
formarien	None
podaries	None
saltes	Present
moriria	None
imitaren	Past
enderrocaven	Past
aïnaré	Future
trencar	None
espolsin	Present
reinicialitzats	Past
atrauria	None
adaptaren	Past
suportada	Past
mostrat	Past
aliarien	None
codificarà	Future
variaries	None
reconquerir	None
arrestats	Past
assequin	Present
datat	Past
provindrien	None
barrejaries	None
cornada	Past
monopolitzaríem	None
trobaria	None
dirimeix	Present
mobilitzaria	None
arrossegaven	Past
simularàs	Future
reorganitzaria	None
passaria	None
participaves	Past
durarà	Future
modifiques	Present
alegro	Present
necessità	Past
aprovarà	Future
critiquéssim	Past
modulessin	Past
invitar	None
insultar	None
concentraran	Future
protegirien	None
merèixer	None
retuts	Past
verificar	None
redactéssim	Past
compensaran	Future
allisar	None
menaran	Future
penada	Past
afectes	Present
situessin	Past
disposat	Past
destripades	Past
dataven	Past
repetit	Past
maleïda	Past
comencen	Present
lloaven	Past
celebraren	Past
trauria	None
recordessin	Past
seduir	None
pegades	Past
aterrarien	None
aconsellarà	Future
replicàrem	Past
rememoraràs	Future
cessarien	None
durant	Present
apreneu	Present
intentis	Present
dictaren	Past
arxivaria	None
centralitzar	None
perfumada	Past
llicenciats	Past
produirien	None
evitaria	None
seleccionen	Present
elegiran	Future
començades	Past
enllaçar	None
marcar	None
alliberat	Past
vingueren	Past
rebaixats	Past
exposàveu	Past
polaritzat	Past
pretendre	None
excedeix	Present
fotosintetitzo	Present
dessalinitzar	None
afeblirien	None
retallen	Present
dubtaria	None
gesticularíem	None
entraves	Past
actualitzaria	None
enllestir	None
inclouen	Present
busquessin	Past
esquitxaven	Past
idealitzen	Present
arreglar	None
consolidin	Present
pactar	None
torçats	Past
xocar	None
generen	Present
encantar	None
remà	Past
arrencaves	Past
fragmentat	Past
finalitzar	None
confiarà	Future
guardonada	Past
atribuirien	None
detectarà	Future
ompliria	None
manéssim	Past
dibuixo	Present
taco	Present
desenvolupada	Past
registraria	None
adrecin	Present
monetitzaríem	None
veniu	Present
abdicarien	None
desmoralitza	Present
tesat	Past
portéssiu	Past
acceptar	None
refredar	None
crucificaria	None
amagat	Past
suportarà	Future
descoratjaria	None
ionitzats	Past
accediren	Past
criticaran	Future
endevino	Present
