épouillé	None
anthropiserons	Plural
tituba	Singular
ensilé	None
mouvait	Singular
réduisit	Singular
fournissant	None
flamant	None
trompa	Singular
marquera	Singular
construisirent	Plural
oseraient	Plural
considéré	None
prédécoupé	None
pâtirent	Plural
retraçait	Singular
crachier	None
divergeront	Plural
mesura	Singular
humilié	None
considéra	Singular
découleront	Plural
évoluaient	Plural
barraient	Plural
rétribuait	Singular
ravagèrent	Plural
collectionnera	Singular
empruntait	Singular
éludé	None
faner	None
sourçant	None
normas	Singular
romancer	None
recruta	Singular
croasser	None
appareilla	Singular
atterrissaient	Plural
étudierons	Plural
priva	Singular
abusaient	Plural
résidé	None
corrèleras	Singular
commercialisaient	Plural
fusionna	Singular
léviterait	Singular
somatisassions	Plural
couvrit	Singular
entremêlaient	Plural
despleieront	Plural
escryer	None
transportèrent	Plural
traînèrent	Plural
rata	Singular
analyserait	Singular
localisant	None
accumuleraient	Plural
muait	Singular
nicher	None
rappelai	Singular
gueuler	None
substituèrent	Plural
stéréotyperait	Singular
exhumèrent	Plural
guasta	Singular
assigné	None
migrer	None
explicquas	Singular
dérégulé	None
retouchèrent	Plural
déchussiez	Plural
explorant	None
rasait	Singular
rêver	None
grommeler	None
radina	Singular
jouxtait	Singular
remettes	Singular
soulevait	Singular
alimenté	None
désagrégeait	Singular
envoyait	Singular
pulvériserait	Singular
encastrant	None
débarasser	None
tubas	Singular
renouait	Singular
carias	Singular
pratiquait	Singular
buvant	None
imita	Singular
rédigeaient	Plural
phosphorylant	None
clouèrent	Plural
lexicalisant	None
renversèrent	Plural
enfilait	Singular
improvisaient	Plural
manifester	None
initia	Singular
rééditera	Singular
provenant	None
supputer	None
déprogrammé	None
sentirez	Plural
umiliast	Singular
généra	Singular
ponctionner	None
primerait	Singular
affinera	Singular
rafla	Singular
charabia	Singular
commenceront	Plural
enfumer	None
simulerions	Plural
insurgèrent	Plural
soumettrait	Singular
crépitant	None
procurâtes	Plural
opilasses	Singular
subsisteront	Plural
carbonyleras	Singular
affaira	Singular
détestasse	Singular
maternerez	Plural
tapoter	None
récusant	None
contrerollerent	Plural
coud	Singular
mâchouillasse	Singular
menaceraient	Plural
collectant	None
compromirent	Plural
prédominaient	Plural
communiquèrent	Plural
insuffla	Singular
oscillait	Singular
distribuerait	Singular
rebaptisera	Singular
désappointasse	Singular
perfectionna	Singular
gout	Singular
piaffer	None
admirait	Singular
écailler	None
mènerait	Singular
accepteront	Plural
reviendront	Plural
guèderait	Singular
pressentaient	Plural
éparpilla	Singular
inspecter	None
officialisera	Singular
surexploitant	None
acquérir	None
mincissant	None
flanqua	Singular
excitèrent	Plural
anhardiroie	Singular
ridera	Singular
surchargerait	Singular
ensanglanterait	Singular
rouâtes	Plural
gouvernèrent	Plural
retournât	Singular
recopia	Singular
recensai	Singular
régira	Singular
siérait	Singular
férir	None
arretera	Singular
daigneraient	Plural
tablaient	Plural
vendront	Plural
affligeait	Singular
signeraient	Plural
adhéra	Singular
combinant	None
aboutiraient	Plural
routa	Singular
horizontalisâmes	Plural
renonça	Singular
réprimer	None
votèrent	Plural
encadré	None
étudiait	Singular
réunît	Singular
distinguerait	Singular
considérait	Singular
détroussait	Singular
pilas	Singular
donnerez	Plural
installerait	Singular
évacuerait	Singular
inondé	None
progressa	Singular
bousculera	Singular
butaient	Plural
gonflèrent	Plural
interpréta	Singular
anordiriez	Plural
brimâmes	Plural
accuserait	Singular
manda	Singular
joindraient	Plural
fissionné	None
aborda	Singular
postposer	None
luisait	Singular
ratifiera	Singular
grandira	Singular
racorni	None
revendiquera	Singular
aggrava	Singular
redécouvrait	Singular
forgé	None
dégrèverons	Plural
désarmé	None
transclure	None
manutentionner	None
augea	Singular
autofinancer	None
accommodera	Singular
dénaturait	Singular
poliça	Singular
enhauncer	None
acusant	None
opéraient	Plural
validerait	Singular
baladait	Singular
entreront	Plural
tractaient	Plural
fixèrent	Plural
interpolerons	Plural
défendrons	Plural
identifièrent	Plural
bâtirent	Plural
fragiliserait	Singular
tarissait	Singular
glamourisa	Singular
nasfrant	None
félicitaient	Plural
warz	Singular
rouèrent	Plural
ravigotâmes	Plural
accomplirait	Singular
couvrirent	Plural
trébucha	Singular
hupast	Singular
aboutiront	Plural
réécouté	None
subventionna	Singular
abstenait	Singular
importait	Singular
peaufinant	None
suspendisse	Singular
scandalisé	None
salant	None
asses	Singular
couva	Singular
promulguèrent	Plural
barrait	Singular
retournera	Singular
chevauchèrent	Plural
décentré	None
indiquerai	Singular
gripper	None
attrista	Singular
menasser	None
exaltera	Singular
dominaient	Plural
débotterions	Plural
insistait	Singular
nettoyèrent	Plural
collecterions	Plural
flatirons	Plural
délibéré	None
revigorai	Singular
convergeait	Singular
distilleront	Plural
suffi	None
buttant	None
refaisait	Singular
drainait	Singular
opiler	None
ist	Singular
vérifieront	Plural
nimbé	None
bessemérisé	None
aimantant	None
organisera	Singular
remporta	Singular
recensassent	Plural
devrions	Plural
affichant	None
renseignaient	Plural
leva	Singular
proférait	Singular
apostillé	None
introduisit	Singular
autopsié	None
résulterait	Singular
excellaient	Plural
aciéré	None
râclaient	Plural
réfuta	Singular
conditionnait	Singular
palpant	None
brumant	None
renverra	Singular
colporter	None
vigilant	None
reflétait	Singular
classifiassiez	Plural
matérialiserait	Singular
abaissèrent	Plural
caparaçonner	None
noueraient	Plural
commit	Singular
répartiraient	Plural
débutassiez	Plural
allumer	None
recrutaient	Plural
concourait	Singular
prierai	Singular
garderont	Plural
redirigeait	Singular
asserchames	Plural
continrent	Plural
renias	Singular
rampasses	Singular
gaimentant	None
humecter	None
enchainer	None
persévérer	None
partageassent	Plural
déguisa	Singular
surbooker	None
obéirait	Singular
plaindrait	Singular
gouras	Singular
ligoterai	Singular
absolvait	Singular
emmêla	Singular
offrirent	Plural
paracheva	Singular
représenteront	Plural
interposèrent	Plural
tria	Singular
tucher	None
dura	Singular
détoxifiant	None
éprouvaient	Plural
accouchait	Singular
sanglé	None
standardisa	Singular
surtraitassions	Plural
établant	None
transperceras	Singular
écouté	None
charriait	Singular
saurît	Singular
déscolarisèrent	Plural
adossait	Singular
brisait	Singular
cliquera	Singular
aluminé	None
rallongeait	Singular
treuillé	None
fraper	None
réduisaient	Plural
mit	Singular
recommencé	None
engagea	Singular
symbolisa	Singular
embastillassent	Plural
découvrît	Singular
conversaient	Plural
prospectant	None
spécifia	Singular
statuera	Singular
côtoyaient	Plural
habituera	Singular
s’époumoner	None
fredonné	None
deporter	None
englué	None
huya	Singular
reconstituera	Singular
flottaient	Plural
prévalait	Singular
approchait	Singular
entonna	Singular
recomposaient	Plural
valsa	Singular
faciliteront	Plural
dobler	None
étonnaient	Plural
séquestrerait	Singular
cernèrent	Plural
casait	Singular
participant	None
chaparderiez	Plural
abhorrait	Singular
aboulé	None
recracha	Singular
mixait	Singular
soulevaient	Plural
dérapera	Singular
giboulé	None
levasses	Singular
animèrent	Plural
croiriez	Plural
encuntrasses	Singular
trias	Singular
mélangèrent	Plural
octroyèrent	Plural
patientera	Singular
licencia	Singular
cicatrisé	None
formaliser	None
améliorera	Singular
emmanché	None
déchiqueta	Singular
offenser	None
éclaterait	Singular
révèlerai	Singular
périront	Plural
flairs	Singular
expatrièrent	Plural
occasionné	None
gyra	Singular
appliquèrent	Plural
réveiller	None
détremperons	Plural
paistrai	Singular
accompagnant	None
améliorer	None
débarassant	None
articulassions	Plural
indiquerait	Singular
avèreras	Singular
ôtait	Singular
réquisitionnèrent	Plural
façonnèrent	Plural
sacralisé	None
retenait	Singular
fragilisèrent	Plural
dégobiller	None
captaient	Plural
défavorisant	None
témoigneront	Plural
survient	Singular
remaniera	Singular
agglomérer	None
intimidaient	Plural
détartrant	None
adoptant	None
distinguerons	Plural
matriceront	Plural
criaient	Plural
intensifiaient	Plural
frustrant	None
panerai	Singular
départagera	Singular
contrevenait	Singular
refinancer	None
pinasses	Singular
germaient	Plural
défèreront	Plural
chalongerent	Plural
faciliterai	Singular
articula	Singular
conspirer	None
apprêtait	Singular
cuirassé	None
implanteront	Plural
encoublera	Singular
parcourra	Singular
marinai	Singular
esma	Singular
revendiqueraient	Plural
relater	None
médire	None
jus	Singular
titra	Singular
réabonnaient	Plural
cabrera	Singular
éternuerai	Singular
parler	None
desreglerons	Plural
frappait	Singular
disner	None
percevrait	Singular
repérait	Singular
signaient	Plural
secourant	None
tentèrent	Plural
rejoignaient	Plural
raya	Singular
aider	None
supervisaient	Plural
récompensèrent	Plural
ulula	Singular
baquetant	None
réengager	None
abader	None
lixivieriez	Plural
neigeait	Singular
préféraient	Plural
lapasse	Singular
radicalisa	Singular
buas	Singular
cognasse	Singular
sufler	None
modulé	None
espundroit	Singular
binotait	Singular
ensanglenta	Singular
dissociant	None
remixé	None
subsisterait	Singular
inscrirait	Singular
résonna	Singular
gargarisé	None
récupérant	None
cota	Singular
anodisant	None
permettras	Singular
guérissait	Singular
commettront	Plural
polluer	None
stipulaient	Plural
assevent	Plural
calmèrent	Plural
amplifiant	None
amenuisaient	Plural
redonneront	Plural
résorber	None
ousta	Singular
sèmerait	Singular
régionalisé	None
mita	Singular
dépeignait	Singular
reconceptualisait	Singular
papillonner	None
ensuivra	Singular
complétait	Singular
cimenté	None
ignoreront	Plural
frapant	None
disséminé	None
laisserait	Singular
pénétré	None
révéla	Singular
éperdît	Singular
exhuma	Singular
rentré	None
déterrèrent	Plural
désobéirent	Plural
diffusa	Singular
paraîtrait	Singular
marger	None
endiguer	None
vanc	Singular
moulai	Singular
munstreront	Plural
melancholieriez	Plural
repinças	Singular
conformait	Singular
découragèrent	Plural
monologué	None
livrera	Singular
grimpaient	Plural
poussera	Singular
coranisaient	Plural
dégottât	Singular
dévastait	Singular
concluaient	Plural
repêcha	Singular
pommera	Singular
stoppaient	Plural
essayaient	Plural
débuteront	Plural
impacterait	Singular
incurvait	Singular
bâillas	Singular
ballas	Singular
simplifiera	Singular
déconcerta	Singular
osera	Singular
structurant	None
contemplera	Singular
déplaît	Singular
complété	None
cuirassasses	Singular
donner	None
mitrailler	None
rutileront	Plural
tirerait	Singular
sillonné	None
festonnâtes	Plural
batta	Singular
cofondera	Singular
patienta	Singular
reversera	Singular
estampé	None
nécessiterait	Singular
encadraient	Plural
matelassé	None
ignorerait	Singular
plastifié	None
baptizer	None
suai	Singular
pains	Singular
rafistolasse	Singular
jauja	Singular
couvera	Singular
virait	Singular
multiplia	Singular
fondirent	Plural
blessera	Singular
épinglant	None
abissas	Singular
embarquera	Singular
puisait	Singular
estimerez	Plural
répartissaient	Plural
élèveraient	Plural
démoulé	None
interposa	Singular
suspectaient	Plural
reconsolida	Singular
démâter	None
perfectionnèrent	Plural
foutaient	Plural
sélectionnera	Singular
visita	Singular
homogénéisera	Singular
accuser	None
annexèrent	Plural
juxtaposâmes	Plural
récriminasse	Singular
tamisant	None
emplâtrant	None
racontaient	Plural
prouvassiez	Plural
rançonnèrent	Plural
replacera	Singular
affronteront	Plural
contribuait	Singular
contrôlera	Singular
percevaient	Plural
tonnant	None
manœuvrait	Singular
dégradaient	Plural
amorcèrent	Plural
fédéralisé	None
surbookant	None
forcerait	Singular
bougerai	Singular
corrompre	None
labourait	Singular
arrivera	Singular
prêtât	Singular
remetant	None
précipité	None
cantonnait	Singular
ajouterait	Singular
masquaient	Plural
franchissait	Singular
cartographièrent	Plural
rentrant	None
dénonceront	Plural
capturerait	Singular
prémunissant	None
réfugiait	Singular
saveurs	Singular
loba	Singular
téléportant	None
affectionnera	Singular
grutas	Singular
expliqueraient	Plural
enfoncerait	Singular
piégea	Singular
traquèrent	Plural
recueillir	None
dénommèrent	Plural
encourageront	Plural
éventré	None
liquidera	Singular
croupissant	None
doctrinerons	Plural
exigeraient	Plural
rembourserait	Singular
rechercheront	Plural
enfiévrassions	Plural
tacherons	Plural
occasionna	Singular
psychologisa	Singular
estampillé	None
ressassas	Singular
finalisait	Singular
harper	None
vandaliser	None
recouvrerai	Singular
redémarré	None
déclarer	None
signeront	Plural
furetant	None
rejettera	Singular
prépareront	Plural
arracheront	Plural
disciplina	Singular
brider	None
cédèrent	Plural
rechercherait	Singular
rétorqua	Singular
conteneurisassiez	Plural
embrassaient	Plural
délirâtes	Plural
zona	Singular
signifieraient	Plural
déplairait	Singular
dissuadèrent	Plural
prônèrent	Plural
érailler	None
buer	None
structuré	None
schématisé	None
administrait	Singular
partiraient	Plural
attaquaient	Plural
confondaient	Plural
assimilerait	Singular
défièrent	Plural
exploserait	Singular
exécuterait	Singular
asséché	None
conditionnerait	Singular
empilait	Singular
reparaît	Singular
triomphé	None
edifierons	Plural
feuilletteras	Singular
rent	Singular
flouasses	Singular
activera	Singular
hivernèrent	Plural
stationnaient	Plural
pollinisâmes	Plural
souhaitera	Singular
prierait	Singular
désavouèrent	Plural
lovas	Singular
rechignant	None
interceptera	Singular
manipulant	None
fidélisé	None
rencontreras	Singular
écloses	Singular
entrerez	Plural
préférât	Singular
hacha	Singular
transférèrent	Plural
interceptait	Singular
niera	Singular
décolleront	Plural
concilièrent	Plural
étiqueter	None
décimas	Singular
munir	None
immortalisera	Singular
associerait	Singular
bleuissant	None
ceda	Singular
découdre	None
meublant	None
grignotant	None
inspirasse	Singular
encombrerai	Singular
gribouillasse	Singular
gives	Singular
gouvernerait	Singular
peser	None
parallélisé	None
sympathisaient	Plural
ramera	Singular
lardera	Singular
fédéra	Singular
dédommagea	Singular
inculpant	None
transporta	Singular
désistera	Singular
canonner	None
pendirent	Plural
divisait	Singular
satisfaisait	Singular
détestassions	Plural
lovant	None
colonisera	Singular
amorcera	Singular
iraient	Plural
haussant	None
individualiser	None
hurtas	Singular
contredisant	None
raineraient	Plural
netoiier	None
dévouait	Singular
échalassant	None
campas	Singular
descendre	None
glané	None
raccompagnait	Singular
interdiras	Singular
compensera	Singular
installèrent	Plural
réfléchirai	Singular
rééditassent	Plural
revend	Singular
rassurait	Singular
affinèrent	Plural
souffrir	None
entouré	None
caractériserait	Singular
marginalisa	Singular
despoilleroient	Plural
comptabilisera	Singular
remplissant	None
acheminait	Singular
naufragerai	Singular
mord	Singular
grisé	None
détrôna	Singular
dormit	Singular
choisiras	Singular
complèterait	Singular
filera	Singular
survolèrent	Plural
éradiquant	None
marcheraient	Plural
campait	Singular
haleter	None
sanctionnait	Singular
éblouissait	Singular
ensemencé	None
soupçonnaient	Plural
empêcherai	Singular
dévalant	None
approfondiront	Plural
affublé	None
miniaturiser	None
bêchevetait	Singular
dressera	Singular
jeûnâmes	Plural
conquéraient	Plural
déchirera	Singular
téter	None
écoulèrent	Plural
libèrerait	Singular
noterait	Singular
absenta	Singular
réparèrent	Plural
régurgité	None
trahira	Singular
apontant	None
tripla	Singular
afferma	Singular
deguisast	Singular
souffrirent	Plural
nécessitèrent	Plural
attaquera	Singular
géolocalisé	None
refoula	Singular
pollué	None
écouteront	Plural
réarrangeant	None
additionnera	Singular
bavé	None
grossissaient	Plural
réchappèrent	Plural
délimité	None
conformaient	Plural
contamina	Singular
vira	Singular
inspectèrent	Plural
tâchait	Singular
crépir	None
recalerons	Plural
spécialiseront	Plural
télévisé	None
orbita	Singular
distancia	Singular
confinait	Singular
hurtai	Singular
désaccordassions	Plural
cuisinai	Singular
dupas	Singular
collaboré	None
chantonner	None
réunifiant	None
enrayera	Singular
tesmoingné	None
définiront	Plural
hydraterait	Singular
arborèrent	Plural
souffriraient	Plural
surpassera	Singular
rétrograda	Singular
imitèrent	Plural
imputaient	Plural
concorder	None
adora	Singular
diamanteront	Plural
dégommer	None
souscrivissiez	Plural
compliqueront	Plural
écroulèrent	Plural
grognant	None
révèreraient	Plural
programmaient	Plural
confinaient	Plural
traversa	Singular
neié	None
arpentait	Singular
approximant	None
mobiliserait	Singular
phantasia	Singular
apuié	None
accaparait	Singular
dresser	None
ricoché	None
glouglouter	None
colonisaient	Plural
goûter	None
assimila	Singular
réfutera	Singular
désacraliser	None
récusèrent	Plural
appropriait	Singular
facilitera	Singular
pilorié	None
prouveraient	Plural
croirez	Plural
attenta	Singular
loguer	None
atterrirent	Plural
contrasté	None
préfigura	Singular
aoûté	None
aboutira	Singular
recruterait	Singular
estimeraient	Plural
mouvoir	None
enfonçasse	Singular
arrachasse	Singular
suivit	Singular
emmenaient	Plural
dicterait	Singular
ressayâmes	Plural
exstirperai	Singular
approfondirent	Plural
léchait	Singular
désarrimé	None
demeurèrent	Plural
culasses	Singular
outrager	None
escalader	None
essoufflant	None
conseillèrent	Plural
empilaient	Plural
exhumer	None
accomplissant	None
badasse	Singular
initiant	None
resemblerent	Plural
vapocraquant	None
abandonnant	None
rasséréner	None
poêlerait	Singular
expurgeraient	Plural
déserté	None
confèrera	Singular
eurs	Singular
désolèrent	Plural
assoupli	None
enrhumerons	Plural
coltiveroit	Singular
avogleroiz	Plural
regretteront	Plural
subvient	Singular
accourciront	Plural
inventaient	Plural
submergé	None
affrontait	Singular
décliné	None
interagissait	Singular
limitait	Singular
grippa	Singular
prévisualisant	None
évaporera	Singular
rallieraient	Plural
équiperait	Singular
recherchaient	Plural
appartint	Singular
doublerait	Singular
trépignait	Singular
guvernas	Singular
reproposé	None
déplaceraient	Plural
embêterait	Singular
conformerai	Singular
becquai	Singular
ensuive	Singular
perdit	Singular
garantissait	Singular
excentrer	None
désintégré	None
pigeonner	None
gonfla	Singular
dispensaient	Plural
présenterait	Singular
anraciniiens	Plural
émit	Singular
enquester	None
pâtissant	None
alimenta	Singular
ajuster	None
prospecter	None
lançait	Singular
culé	None
empiraient	Plural
faudrait	Singular
tentaient	Plural
sombrait	Singular
départager	None
avanchierent	Plural
glanant	None
déroutant	None
nuisant	None
rentrera	Singular
écangueront	Plural
urs	Singular
rouillé	None
éclosant	None
stressant	None
justisiiez	Plural
enmener	None
répondraient	Plural
filtré	None
essuyant	None
brulait	Singular
économisant	None
refluèrent	Plural
matter	None
démythifiant	None
récompensant	None
défolieront	Plural
solder	None
fussiez	Plural
amuserai	Singular
insinuait	Singular
apprendra	Singular
décliner	None
halant	None
accorderez	Plural
murmurant	None
embuschastes	Plural
admonester	None
incrémentant	None
rebuta	Singular
flânant	None
préconiserai	Singular
gaimenterions	Plural
approvisionner	None
bati	Singular
édifieront	Plural
débuta	Singular
frétillerait	Singular
classeront	Plural
esquinté	None
étranglait	Singular
voisiné	None
ancrant	None
polyglottassions	Plural
plaquant	None
atténuera	Singular
ferroutas	Singular
treta	Singular
jaugeant	None
stupéfia	Singular
engourdi	None
stériliser	None
plongea	Singular
dépéri	None
gerra	Singular
drapant	None
séquencé	None
formé	None
entrapercevoir	None
retombaient	Plural
raffinai	Singular
investirent	Plural
schématisant	None
articulai	Singular
neutralisera	Singular
désapprouva	Singular
biné	None
viderait	Singular
ébousiné	None
prélèvera	Singular
retarderait	Singular
réadapté	None
rebotiiens	Plural
dégringolant	None
auditionner	None
arrangeait	Singular
endossera	Singular
plaignirent	Plural
amonta	Singular
photographièrent	Plural
rançonna	Singular
dégoûté	None
concerneront	Plural
éminçant	None
arrachis	Singular
trucidèrent	Plural
cantillai	Singular
requalifier	None
alcoolisassiez	Plural
retiras	Singular
permît	Singular
shampooinerez	Plural
failles	Singular
contas	Singular
arnaquait	Singular
composant	None
compliquer	None
escapperoient	Plural
posa	Singular
suer	None
mèneraient	Plural
secondait	Singular
veilleront	Plural
soudoya	Singular
lover	None
momma	Singular
prolongeriiens	Plural
interpellaient	Plural
prendra	Singular
qualifiera	Singular
choqueraient	Plural
sautillé	None
composera	Singular
ressurgi	None
solliciterait	Singular
dissolvait	Singular
houssepillassiez	Plural
arrachèrent	Plural
procèdera	Singular
formai	Singular
soldant	None
saucissonné	None
déposeront	Plural
remua	Singular
entrât	Singular
déjeusné	None
radioscopassent	Plural
trafiquer	None
constatèrent	Plural
diminueraient	Plural
handicapaient	Plural
étoffé	None
céler	None
reverras	Singular
renommeront	Plural
cartographia	Singular
affaibliront	Plural
bassiné	None
entre-loué	None
reverdi	None
reproduisirent	Plural
initier	None
salassiez	Plural
fréquenteraient	Plural
redoublèrent	Plural
affaissa	Singular
merderont	Plural
horrifia	Singular
traiteraient	Plural
festoierai	Singular
bloguai	Singular
runt	Singular
appréhendaient	Plural
espelassent	Plural
falsifiait	Singular
vocalisasse	Singular
équarrir	None
anéantirait	Singular
rend	Singular
vinifiât	Singular
pua	Singular
salai	Singular
éclairerait	Singular
blanchoiant	None
moissonnassent	Plural
italianiserions	Plural
rétracter	None
déshabillant	None
entera	Singular
enguirlanda	Singular
émiettant	None
dégagerait	Singular
balançait	Singular
refoulera	Singular
décrépiriez	Plural
réouvert	None
singlé	None
fleurissait	Singular
remeüs	Singular
adouber	None
chéri	None
transperça	Singular
attérit	Singular
poussait	Singular
guetté	None
ancumbrastes	Plural
tripler	None
puet	Singular
prospèrera	Singular
donna	Singular
guerroyait	Singular
transcrira	Singular
supplanteront	Plural
réveillonnerez	Plural
claustras	Singular
rêvera	Singular
décaperions	Plural
remez	Singular
vaquaient	Plural
kuidant	None
estinceler	None
analysèrent	Plural
affinait	Singular
menacerez	Plural
entacherions	Plural
déserta	Singular
conceptualiser	None
écoutèrent	Plural
embûchâmes	Plural
perforé	None
recomposerons	Plural
brosderoie	Singular
reconstituèrent	Plural
discernait	Singular
souffrait	Singular
entrainait	Singular
ars	Singular
opteraient	Plural
atteindrai	Singular
enjôler	None
lesta	Singular
tariraient	Plural
usait	Singular
sonna	Singular
transmué	None
resounera	Singular
narguant	None
capitula	Singular
joignirent	Plural
dégringoler	None
écanguer	None
célèbrera	Singular
translitérassent	Plural
toréant	None
bouélant	None
recevait	Singular
signer	None
ablatant	None
plaider	None
allât	Singular
partirons	Plural
débouchèrent	Plural
envenimant	None
surproduit	Singular
cartera	Singular
signifia	Singular
plierait	Singular
dissociait	Singular
interdît	Singular
prédirent	Plural
commercialisera	Singular
mentira	Singular
tergiversât	Singular
bossa	Singular
affuté	None
construisaient	Plural
iouant	None
shampouinera	Singular
saborder	None
désodorisant	None
rassemblera	Singular
consulterai	Singular
junas	Singular
disputerait	Singular
complexifier	None
achever	None
reconstruire	None
empoisonnèrent	Plural
savora	Singular
sacrer	None
tireront	Plural
conformèrent	Plural
embouti	None
affiné	None
compliquant	None
habitait	Singular
abreuvaient	Plural
partitionnerai	Singular
blâmèrent	Plural
patoiserons	Plural
aliant	None
réapprend	Singular
dévoilant	None
cloquer	None
détailler	None
neiger	None
symbolisé	None
serpentait	Singular
importerait	Singular
assumèrent	Plural
dédaigner	None
aquiteriiez	Plural
existeraient	Plural
restauraient	Plural
aprandre	None
collaborant	None
glissé	None
rejoignait	Singular
orai	Singular
desservirait	Singular
embrassera	Singular
accommodaient	Plural
dissolurent	Plural
renverseront	Plural
faiblissaient	Plural
vestant	None
démâté	None
accusa	Singular
dédouaner	None
amélioreront	Plural
organiseront	Plural
agrémentaient	Plural
réussirez	Plural
désinsectisant	None
dissociera	Singular
tétant	None
produisaient	Plural
faignant	None
bevreie	Singular
dîna	Singular
enrichissant	None
intéresserai	Singular
observa	Singular
perdurait	Singular
armeriez	Plural
vautrer	None
refermerait	Singular
frouillant	None
flairer	None
exclues	Singular
scintillé	None
rentrer	None
retiendrait	Singular
réjouissaient	Plural
réalisa	Singular
boycottera	Singular
apparentaient	Plural
pourportissons	Plural
protègeraient	Plural
percutera	Singular
adressèrent	Plural
réduisait	Singular
payât	Singular
présumer	None
recoverant	None
insultaient	Plural
pataugé	None
auleguer	None
achèvera	Singular
donné	None
étudieront	Plural
avisa	Singular
incendiaient	Plural
alourdi	None
reparaissant	None
solidifia	Singular
destituer	None
rendront	Plural
imminâtes	Plural
évoquerait	Singular
recentrant	None
quintuplé	None
échouera	Singular
avantageait	Singular
risqueront	Plural
éliminerait	Singular
promulguassent	Plural
fonctionnalisé	None
extrapolé	None
rejetaient	Plural
dédaigna	Singular
endommagea	Singular
brida	Singular
décernait	Singular
photoshoperai	Singular
merdé	None
baisant	None
ravinas	Singular
obscurcira	Singular
rager	None
resounderoies	Singular
dessaler	None
léché	None
reconsidérer	None
congelant	None
réémet	Singular
décrirons	Plural
paraitra	Singular
abatu	None
vandalisé	None
trompera	Singular
braquait	Singular
opéra	Singular
mordillerait	Singular
contre-attaquerions	Plural
conditionna	Singular
diminué	None
promit	Singular
usas	Singular
lassas	Singular
limoger	None
dirons	Plural
écopant	None
cras	Singular
huilant	None
regorgeaient	Plural
détectait	Singular
prévinrent	Plural
constata	Singular
repassait	Singular
huchier	None
voudraient	Plural
dicta	Singular
polychroma	Singular
recueillaient	Plural
siphonner	None
estovoir	None
consistèrent	Plural
émigra	Singular
illustrait	Singular
esvantastes	Plural
cacheront	Plural
tablait	Singular
codétenait	Singular
entrelardassions	Plural
provera	Singular
obliqua	Singular
propageaient	Plural
protègera	Singular
léchasse	Singular
révolutionna	Singular
plongeront	Plural
satisfaisaient	Plural
contournera	Singular
remontèrent	Plural
compensèrent	Plural
tenaillé	None
répondaient	Plural
éroda	Singular
mattasse	Singular
ventilant	None
dévoreront	Plural
resisterez	Plural
apaisait	Singular
partitionner	None
grimacer	None
figer	None
sortiraient	Plural
repiauler	None
anuié	None
chout	Singular
régirait	Singular
gratiner	None
tourmentera	Singular
couvrira	Singular
voyagèrent	Plural
enjambant	None
communiqueraient	Plural
détaillerai	Singular
vida	Singular
déplorait	Singular
pourchassé	None
énamouré	None
avançoient	Plural
affecta	Singular
ravitaillant	None
connait	Singular
retenti	None
excogitâmes	Plural
seront	Plural
répondront	Plural
mépriser	None
vernissé	None
bouleverserez	Plural
blairaient	Plural
escaladèrent	Plural
bloquait	Singular
trancherait	Singular
espérèrent	Plural
récoltait	Singular
consentissent	Plural
grenada	Singular
unifier	None
monstré	None
sensibilisé	None
jaseront	Plural
réclamant	None
pourvoir	None
décidai	Singular
surgissait	Singular
dribblant	None
plot	Singular
anuier	None
exprimerai	Singular
intersecterai	Singular
érigeront	Plural
recomposant	None
ensabler	None
dressait	Singular
ajourerons	Plural
descupliiez	Plural
atténuerait	Singular
tabustant	None
ergoté	None
maila	Singular
contesta	Singular
métré	None
renforçant	None
adapterait	Singular
réorganisera	Singular
consacrant	None
infourmé	None
désista	Singular
aguerrit	Singular
souhaiterions	Plural
paumé	None
donas	Singular
guidait	Singular
cot	Singular
défroquer	None
décolonisasses	Singular
pousserai	Singular
florissant	None
aumosnant	None
propulsa	Singular
endeuiller	None
veillerai	Singular
torturé	None
subira	Singular
illustraient	Plural
parabola	Singular
agitèrent	Plural
gouvernera	Singular
recensa	Singular
cerqueroies	Singular
handicaperait	Singular
incarnerait	Singular
décora	Singular
supprimaient	Plural
reverrai	Singular
rassemblé	None
répliquera	Singular
excogiterait	Singular
reliassiez	Plural
enseigné	None
groupa	Singular
germera	Singular
bavardant	None
charjai	Singular
cerques	Singular
affûter	None
bouclerez	Plural
stationneront	Plural
dilapidassions	Plural
sua	Singular
ancré	None
ajournèrent	Plural
spiraler	None
produiraient	Plural
soupçonner	None
préservâmes	Plural
jaillira	Singular
mitonné	None
defina	Singular
détordes	Singular
interfaçassent	Plural
illuminant	None
totalisera	Singular
déambulait	Singular
imminé	None
refilâtes	Plural
discriminer	None
vérifié	None
geüssoiz	Plural
congédia	Singular
contraignirent	Plural
cuyder	None
déchargeait	Singular
relaxé	None
troas	Singular
alïes	Singular
racheté	None
dégréant	None
pousserait	Singular
écrabouiller	None
éprit	Singular
épargnèrent	Plural
retraça	Singular
rouspéter	None
bluffas	Singular
jerkasse	Singular
accouchaient	Plural
fabriquerions	Plural
capturât	Singular
transcendasses	Singular
généraliseront	Plural
entrevoyait	Singular
référencer	None
couvriront	Plural
prolongerait	Singular
impulsa	Singular
datas	Singular
matérialisâmes	Plural
autoanalyser	None
compacta	Singular
enfermas	Singular
décollaient	Plural
fuirent	Plural
alliera	Singular
édité	None
jeûner	None
instaura	Singular
ansanglanter	None
escaut	Singular
imposaient	Plural
conviai	Singular
guéer	None
envahira	Singular
perquisitionnerez	Plural
entamerons	Plural
najas	Singular
paradaient	Plural
emploieraient	Plural
hasarder	None
coincé	None
emmenait	Singular
bouclera	Singular
tissant	None
bromera	Singular
propageait	Singular
employa	Singular
trainé	None
échappèrent	Plural
réinstallant	None
pondre	None
laissèrent	Plural
infusé	None
coures	Singular
cultivèrent	Plural
descunseillames	Plural
clonera	Singular
créditassent	Plural
débarquerait	Singular
formulant	None
croupi	None
épousa	Singular
flemmarderions	Plural
démontrèrent	Plural
existerai	Singular
adjectiveront	Plural
regarderait	Singular
instrumentai	Singular
courtauderez	Plural
aviva	Singular
surnommèrent	Plural
surnomma	Singular
profiteraient	Plural
convertissaient	Plural
encroûtai	Singular
enguirlanderai	Singular
confiât	Singular
haoient	Plural
signèrent	Plural
fanfaronner	None
maitrisé	None
conciliait	Singular
ferras	Singular
envisageait	Singular
déprima	Singular
désarmerai	Singular
santis	Singular
barricader	None
confirma	Singular
refroidira	Singular
provoqueraient	Plural
disparaitrait	Singular
grasseyer	None
ourlas	Singular
gagna	Singular
violerait	Singular
gonflerait	Singular
défendraient	Plural
étayé	None
différenciera	Singular
tigrait	Singular
scella	Singular
folâtrer	None
répartissait	Singular
détecterait	Singular
rabâché	None
gagnerions	Plural
ordonnerait	Singular
privilégiait	Singular
représentèrent	Plural
correspondraient	Plural
voisinait	Singular
délimitait	Singular
empiétait	Singular
émirent	Plural
islamiser	None
agaceras	Singular
suggérant	None
stimulera	Singular
décorèrent	Plural
grisonner	None
motorisait	Singular
culpabiliserait	Singular
trouverait	Singular
divinas	Singular
donnâmes	Plural
tyrannisé	None
réadapterai	Singular
démontrait	Singular
comblait	Singular
entraînaient	Plural
craindrait	Singular
raincerai	Singular
honnoureront	Plural
tissé	None
interviewa	Singular
chasseront	Plural
escrima	Singular
rigidifier	None
chalu	Singular
raccompagna	Singular
resurgir	None
aporter	None
atendroies	Singular
brea	Singular
impartir	None
instruisaient	Plural
endommageait	Singular
observerai	Singular
acoquiné	None
monopolisèrent	Plural
grattait	Singular
leurrant	None
citeront	Plural
manifesteraient	Plural
dépoussièrerai	Singular
équivalaient	Plural
condamnant	None
rajoutèrent	Plural
parada	Singular
déshérita	Singular
déboutonnaient	Plural
précipitèrent	Plural
tueraient	Plural
conditionnera	Singular
allaictant	None
travaillât	Singular
mondant	None
embrasseront	Plural
boucla	Singular
confina	Singular
forçaient	Plural
enchaîna	Singular
partîmes	Plural
débandé	None
calculait	Singular
maîtrisaient	Plural
appetisseriiez	Plural
militait	Singular
privaient	Plural
révisera	Singular
trônassions	Plural
entassait	Singular
astreignant	None
spécialisèrent	Plural
contrôlèrent	Plural
mandaté	None
rapproché	None
darda	Singular
conspirèrent	Plural
beives	Singular
fleurissant	None
embarrassait	Singular
dosa	Singular
succédèrent	Plural
gascheras	Singular
fluctuer	None
rivalisaient	Plural
cara	Singular
refaisaient	Plural
convertissait	Singular
prépara	Singular
chinas	Singular
descourageant	None
virgula	Singular
comptabilisé	None
rasseürer	None
redevant	None
entoura	Singular
immobilisera	Singular
fiscaliser	None
tramaient	Plural
prouvèrent	Plural
engagerait	Singular
suda	Singular
valaient	Plural
rongeait	Singular
jeûnant	None
plébiscita	Singular
contrôlerai	Singular
emmurassiez	Plural
convainquirent	Plural
éclairci	None
spirala	Singular
désintégrant	None
pressait	Singular
commença	Singular
veḍront	Plural
écumer	None
tâtonné	None
comblaient	Plural
disparaitront	Plural
préparassions	Plural
numériser	None
conscientisé	None
réclamera	Singular
traîna	Singular
refermer	None
attachaient	Plural
basculèrent	Plural
traversé	None
répugnant	None
percerait	Singular
intéressaient	Plural
oint	Singular
viraient	Plural
manquaient	Plural
desséchant	None
régressera	Singular
nuisit	Singular
justisé	None
scinder	None
américanisant	None
proclamaient	Plural
démoli	None
fustigea	Singular
occasionnaient	Plural
reconnecté	None
revisita	Singular
pantoisai	Singular
circuleront	Plural
égorger	None
émergera	Singular
buller	None
excentrât	Singular
œuvré	None
transmettraient	Plural
lova	Singular
étala	Singular
décocher	None
disputaient	Plural
acté	None
repeupleras	Singular
baptisaient	Plural
idéalisait	Singular
sives	Singular
escortait	Singular
dîtes	Plural
retrouvait	Singular
sentit	Singular
pourfendre	None
réabsorbé	None
reculera	Singular
déréglé	None
pinasse	Singular
réorganisèrent	Plural
crooner	None
démentit	Singular
crépiriez	Plural
décomposa	Singular
stimulant	None
démenassions	Plural
delivré	None
étrenné	None
ambla	Singular
consumé	None
vieillissaient	Plural
harnaché	None
réveilla	Singular
bissé	None
endort	Singular
cuisiner	None
définirent	Plural
critiquèrent	Plural
reprochié	None
segonder	None
déchaînait	Singular
essayât	Singular
affinant	None
miniaturisé	None
occulté	None
rediscutera	Singular
apprendrons	Plural
evitant	None
choit	Singular
retrouvât	Singular
surreprésenter	None
regnes	Singular
blanchissait	Singular
avancerez	Plural
descendait	Singular
diviserait	Singular
starifiant	None
coiffa	Singular
piz	Singular
affolera	Singular
ferra	Singular
alourdira	Singular
rumina	Singular
avoisinaient	Plural
boisassiez	Plural
prépayé	None
décadrer	None
dopait	Singular
formas	Singular
partira	Singular
moucher	None
entamait	Singular
abriterait	Singular
soutinrent	Plural
pourlécher	None
gravira	Singular
décolléter	None
loupé	None
gravitas	Singular
abolerait	Singular
apportant	None
implémentait	Singular
contreplederai	Singular
serviraient	Plural
acaz	Singular
rénovant	None
agenoillant	None
réimportant	None
ceint	Singular
desnoa	Singular
comprendrons	Plural
penchait	Singular
risquerai	Singular
mugir	None
foehnant	None
entablerait	Singular
caftai	Singular
perturber	None
solenniser	None
consolidait	Singular
étayasse	Singular
déversèrent	Plural
bidouillâtes	Plural
batifoler	None
tableriez	Plural
expliqueront	Plural
transcodassent	Plural
lâcherai	Singular
gagé	None
reposerai	Singular
tond	Singular
suspecter	None
marierait	Singular
patina	Singular
abandonnèrent	Plural
surmiserons	Plural
continueront	Plural
nonces	Singular
adjugera	Singular
pontifier	None
embrigaderaient	Plural
optait	Singular
oscillera	Singular
conclure	None
rectifiera	Singular
caroles	Singular
renant	None
planifièrent	Plural
accrurent	Plural
conviant	None
versera	Singular
waiter	None
diminuait	Singular
opterait	Singular
défraya	Singular
massèrent	Plural
récolta	Singular
rentrerai	Singular
énonçant	None
soufflait	Singular
força	Singular
acéré	None
tomberaient	Plural
présentât	Singular
exercera	Singular
sciera	Singular
emmènerait	Singular
lutteraient	Plural
assurait	Singular
plura	Singular
transformeraient	Plural
ménagea	Singular
décaler	None
gacha	Singular
rivalisant	None
éventrer	None
scinderions	Plural
manecier	None
fourmillant	None
qualifieront	Plural
recherchant	None
singulariserons	Plural
germasses	Singular
retord	Singular
déformaient	Plural
oblier	None
desservit	Singular
pikier	None
sautaient	Plural
crama	Singular
attestant	None
fragilisait	Singular
reflèterait	Singular
sablé	None
embrassèrent	Plural
blesser	None
celebrer	None
prononçât	Singular
pela	Singular
brulaient	Plural
envenimèrent	Plural
harasseront	Plural
vivront	Plural
propulsai	Singular
composté	None
creantant	None
houant	None
voltigeant	None
æstimassent	Plural
procréant	None
fleurissaient	Plural
perdait	Singular
menai	Singular
connaitra	Singular
beignerait	Singular
calfater	None
étreindre	None
précipitant	None
muèrent	Plural
ensuit	Singular
étreignissent	Plural
perpétuerait	Singular
escroqué	None
anraciner	None
baliseriez	Plural
contrôlant	None
péchant	None
essais	Singular
divulgua	Singular
islamisé	None
inciterai	Singular
enseignait	Singular
engobèrent	Plural
nourrissait	Singular
retenté	None
approuvèrent	Plural
hausser	None
welcumiiez	Plural
renoncera	Singular
adopterait	Singular
évoquant	None
appartiendrons	Plural
effondrait	Singular
catégorisera	Singular
kist	Singular
abélianisé	None
rafraichissant	None
sonda	Singular
festoyaient	Plural
conjecturerons	Plural
starté	None
huma	Singular
duz	Singular
surmontait	Singular
sujurné	None
berné	None
somont	Singular
requérait	Singular
présageait	Singular
embêtera	Singular
commencera	Singular
réussiraient	Plural
cambrai	Singular
debrisassent	Plural
relisant	None
menacèrent	Plural
revêtaient	Plural
avenger	None
approuvera	Singular
plongèrent	Plural
neigé	None
purifié	None
demanda	Singular
taillèrent	Plural
depescheroient	Plural
trembla	Singular
réinstaurant	None
annoté	None
allumeront	Plural
reflètera	Singular
infectait	Singular
relieront	Plural
deviner	None
enkysterai	Singular
tordit	Singular
enfanteras	Singular
medecins	Singular
abdiquera	Singular
pratiquèrent	Plural
recensera	Singular
boucha	Singular
vuideriiens	Plural
fouiné	None
delitierent	Plural
missionnant	None
ciblait	Singular
entonnant	None
chinoisai	Singular
blecha	Singular
élèvera	Singular
reformaient	Plural
réagissait	Singular
tromperait	Singular
diriez	Plural
accusait	Singular
enlever	None
décrivait	Singular
patrouillèrent	Plural
entamant	None
orientaient	Plural
ceignes	Singular
indemnisera	Singular
déléguer	None
estus	Singular
sorpreṣissons	Plural
ceindre	None
effectua	Singular
glissât	Singular
navrant	None
incorpora	Singular
ramena	Singular
prolongier	None
indisposa	Singular
endurait	Singular
banqueter	None
haussé	None
émergeait	Singular
cailleterons	Plural
traquera	Singular
raconterait	Singular
incomber	None
paramétrer	None
trahissait	Singular
triangulé	None
recelaient	Plural
participera	Singular
garderas	Singular
publièrent	Plural
maintiendront	Plural
irritait	Singular
redeviendrait	Singular
encombrerait	Singular
soûlé	None
désabonné	None
excommuniassiez	Plural
actas	Singular
reconnaîtrons	Plural
entredunas	Singular
abéliser	None
perd	Singular
accélérait	Singular
agrees	Singular
deviendras	Singular
oubliait	Singular
rouvriront	Plural
marquaient	Plural
parsemaient	Plural
épiloguer	None
abstiendront	Plural
pieutera	Singular
expiasse	Singular
prouveront	Plural
dépensaient	Plural
prohiber	None
cesserez	Plural
nièrent	Plural
laisserai	Singular
expérimentèrent	Plural
démasquera	Singular
tabassant	None
fabriquèrent	Plural
raenchonnerai	Singular
recouvrerait	Singular
ajouterez	Plural
avoglerent	Plural
teindre	None
mander	None
grandissaient	Plural
batissoiz	Plural
acoplera	Singular
privait	Singular
foehner	None
paniqua	Singular
périrait	Singular
bombardé	None
démèthylerai	Singular
chambrer	None
hargniiens	Plural
ravageait	Singular
déshabilla	Singular
connaîtrait	Singular
ébattant	None
paresser	None
méprenant	None
gagné	None
inscrivait	Singular
polychromiser	None
condamnera	Singular
triomphèrent	Plural
orent	Plural
blâma	Singular
interprèteront	Plural
effritait	Singular
ravissant	None
abrité	None
invitèrent	Plural
ironiserez	Plural
posseder	None
symboliseront	Plural
dispenserai	Singular
cartographiant	None
bienvenu	None
bauptizai	Singular
desguisant	None
prononceraient	Plural
soupçonnera	Singular
corriger	None
courbant	None
prestions	Plural
chronométré	None
marierai	Singular
indexait	Singular
résultât	Singular
rapprocha	Singular
effacer	None
rouvert	None
sacrifiait	Singular
tacherai	Singular
habiteras	Singular
réapparaitre	None
reconduisit	Singular
delibereront	Plural
itèrerions	Plural
retardait	Singular
masquerait	Singular
brisâmes	Plural
débusquer	None
bayassions	Plural
essayé	None
senblant	None
azuré	None
mehaignierai	Singular
méfier	None
repasseras	Singular
signalisé	None
apposant	None
décousant	None
essoigneroie	Singular
présenter	None
ensuivront	Plural
collaient	Plural
damna	Singular
boitillé	None
muçant	None
pasasses	Singular
collecta	Singular
marxisassions	Plural
figuras	Singular
regroupait	Singular
exempta	Singular
refinançâtes	Plural
épuisaient	Plural
violenta	Singular
chaîné	None
retrouvai	Singular
égaillaient	Plural
enchanta	Singular
disposerez	Plural
brosser	None
reconnoissant	None
exilant	None
apprêté	None
affermant	None
espérer	None
refusait	Singular
jetteraient	Plural
reconduisant	None
panser	None
situèrent	Plural
transfèrera	Singular
ruinait	Singular
pénétrant	None
manifesteront	Plural
toréer	None
goutera	Singular
connaitront	Plural
sillonna	Singular
commémorerait	Singular
focalisait	Singular
volleyerait	Singular
modifia	Singular
abolirent	Plural
expédièrent	Plural
resterait	Singular
cannas	Singular
couronna	Singular
transmettra	Singular
revendiquait	Singular
attendras	Singular
viseraient	Plural
rationalisèrent	Plural
vamperons	Plural
rouvrit	Singular
intensifièrent	Plural
encapuchonnas	Singular
anémieraient	Plural
rayas	Singular
prénommaient	Plural
ressuscitera	Singular
fulminât	Singular
dérogera	Singular
buvaient	Plural
urai	Singular
décrivant	None
passivé	None
tachetasse	Singular
empâtait	Singular
calera	Singular
signalerait	Singular
balaya	Singular
dégrayé	None
accorderai	Singular
élaborèrent	Plural
oies	Singular
avisera	Singular
ensimant	None
stationnait	Singular
goûtaient	Plural
unifièrent	Plural
corseraient	Plural
tourmenta	Singular
réprimerez	Plural
renouvellé	None
adjugé	None
éclatera	Singular
exprimait	Singular
appelaient	Plural
disparaitre	None
tranlaté	None
provoquaient	Plural
bobelineront	Plural
écumera	Singular
extruder	None
exprimèrent	Plural
boiront	Plural
boursoufler	None
caça	Singular
encorderont	Plural
pourvoyaient	Plural
recontacta	Singular
supprimait	Singular
nichaient	Plural
découlait	Singular
maîtrisait	Singular
sabordé	None
achevât	Singular
intenta	Singular
ansa	Singular
véhiculaient	Plural
scalpé	None
dépendirent	Plural
souna	Singular
couronneraient	Plural
repeta	Singular
pelletiserions	Plural
réinstaura	Singular
esparnasse	Singular
danseront	Plural
écouteras	Singular
recoiffer	None
entrebaisiiez	Plural
connaîtra	Singular
désignerait	Singular
formulaient	Plural
ballota	Singular
galopé	None
confissiez	Plural
déposeraient	Plural
bavardoché	None
querolissons	Plural
déconseillait	Singular
approvisionnant	None
excèderait	Singular
factoriser	None
soutenait	Singular
weyveroie	Singular
ameutant	None
chauntiiens	Plural
graissé	None
clamser	None
distinguera	Singular
fustiger	None
anticipa	Singular
monitorant	None
référaient	Plural
héroïseriez	Plural
dégluait	Singular
varierait	Singular
commentaient	Plural
cuidera	Singular
cognait	Singular
computé	None
liséré	None
déchaîna	Singular
asservissant	None
consulta	Singular
rédigeront	Plural
reprécipitâmes	Plural
espionnera	Singular
waz	Singular
ébaudirai	Singular
fasciné	None
urinant	None
trança	Singular
raccordait	Singular
épouvantant	None
paya	Singular
sermonner	None
distrait	Singular
pavana	Singular
entremit	Singular
équivaudra	Singular
inséminait	Singular
ondoyant	None
corrigeait	Singular
verrouillant	None
juz	Singular
décoincé	None
profitait	Singular
plaidait	Singular
folâtreront	Plural
rebroussant	None
inventé	None
construira	Singular
persiflé	None
budgétisé	None
émoussant	None
racler	None
plourerai	Singular
hala	Singular
réoxyderas	Singular
supposa	Singular
insisteront	Plural
aymant	None
célébrait	Singular
condamnâtes	Plural
pleurasses	Singular
piétinaient	Plural
lanceront	Plural
bobina	Singular
élargi	None
diminuerait	Singular
shooté	None
dotèrent	Plural
afublissoiz	Plural
survenir	None
flama	Singular
affaiblir	None
mousserons	Plural
brodaient	Plural
succédasses	Singular
résonnera	Singular
desfier	None
tisser	None
transféraient	Plural
simuleriez	Plural
adestré	None
factorisant	None
reprochaient	Plural
réchauffa	Singular
confondra	Singular
compareront	Plural
reconquit	Singular
enfreignant	None
institua	Singular
dupliquant	None
disposera	Singular
taire	None
préviennes	Singular
luttaient	Plural
entraperai	Singular
pianoter	None
affurer	None
naufragé	None
querellaient	Plural
varapper	None
sécurisa	Singular
fourché	None
trottinassent	Plural
jouir	None
fussions	Plural
intronisa	Singular
acclamèrent	Plural
conjoint	Singular
décloué	None
ramait	Singular
irritaient	Plural
tâta	Singular
joncher	None
barbelait	Singular
décourageant	None
merchandiser	None
méfiera	Singular
décongestionnant	None
ioniseras	Singular
trapper	None
bonifiant	None
évoquera	Singular
luxa	Singular
eschanjant	None
envouter	None
embrasserait	Singular
détectera	Singular
réaffirmèrent	Plural
honorera	Singular
choisissait	Singular
emprenant	None
entêtait	Singular
tissaient	Plural
cunforté	None
embrasera	Singular
bavarderons	Plural
énoncèrent	Plural
affichait	Singular
labora	Singular
déguisaient	Plural
entra	Singular
parola	Singular
supprimerait	Singular
gloussera	Singular
retransmettront	Plural
surestimer	None
coutaient	Plural
poursuivisse	Singular
adjoindront	Plural
classera	Singular
bivouaqua	Singular
doutaient	Plural
abaleront	Plural
oublieront	Plural
procez	Singular
courut	Singular
forerions	Plural
opposerai	Singular
étalera	Singular
reconsidéra	Singular
pantoisastes	Plural
polythéiser	None
caillera	Singular
compliqua	Singular
intéressèrent	Plural
émancipassiez	Plural
ancusasses	Singular
dégazer	None
bâclas	Singular
dédaignaient	Plural
quêtant	None
bourdonnerait	Singular
complimenté	None
affiché	None
quaillerai	Singular
interféré	None
fléchi	None
rougissant	None
décidât	Singular
vendit	Singular
effroyiiens	Plural
écabochant	None
désavouera	Singular
réparaient	Plural
humaniser	None
s’ensauver	None
trompait	Singular
combattaient	Plural
lacérâmes	Plural
démolira	Singular
cessaient	Plural
observerait	Singular
vaincront	Plural
valu	Singular
deshaiteriiez	Plural
surclassaient	Plural
connaîtront	Plural
retissé	None
hériteraient	Plural
lancera	Singular
incrémenter	None
déprimant	None
demeurera	Singular
aiguiser	None
suppliciant	None
remémorerait	Singular
afia	Singular
épaissir	None
réformait	Singular
abandonnerait	Singular
croiserez	Plural
débloqué	None
brillaient	Plural
mutai	Singular
sévira	Singular
rumineriez	Plural
reveant	None
chassèrent	Plural
pulverizeroiz	Plural
bangna	Singular
collectionner	None
sopa	Singular
accorderaient	Plural
abstiendra	Singular
gouraient	Plural
plaira	Singular
centrait	Singular
enseigner	None
répertoriait	Singular
concrétisaient	Plural
dégraissé	None
gouast	Singular
déléguèrent	Plural
parlaient	Plural
massacrait	Singular
nitra	Singular
pédaler	None
inactiver	None
réapparait	Singular
chantonnât	Singular
refuserai	Singular
élèveront	Plural
ronronner	None
désulfureraient	Plural
adoucira	Singular
deviendra	Singular
voterai	Singular
tenterait	Singular
sos	Singular
facetté	None
perçaient	Plural
fusionnait	Singular
motiverait	Singular
volerait	Singular
reservastes	Plural
bailles	Singular
consista	Singular
assassinait	Singular
inspiraient	Plural
arraisonné	None
évoluer	None
enflammaient	Plural
manacher	None
agrandirent	Plural
pressentit	Singular
acompaignié	None
réfrénasse	Singular
avra	Singular
localisait	Singular
traiterai	Singular
offusquera	Singular
esmaioient	Plural
squattait	Singular
peignant	None
recerchié	None
survolassent	Plural
évertuait	Singular
s’adonnant	None
sacrifierait	Singular
publier	None
démembré	None
adjoint	Singular
tira	Singular
plantant	None
mystifier	None
balada	Singular
rengeasse	Singular
dégoûta	Singular
torturera	Singular
déversait	Singular
photographiera	Singular
induisit	Singular
renforcèrent	Plural
choisirez	Plural
punaiser	None
affectionnaient	Plural
codas	Singular
détaillerait	Singular
pleuraient	Plural
pormenerons	Plural
bêtiser	None
explorèrent	Plural
esgarerons	Plural
égara	Singular
monoalkylasses	Singular
bioaccumulé	None
redescendirent	Plural
réunissaient	Plural
rentant	None
encollé	None
agitait	Singular
consuma	Singular
rapatrié	None
condamna	Singular
systématiser	None
ralentirent	Plural
ruina	Singular
murmurer	None
instruisirent	Plural
formata	Singular
fouillera	Singular
malmenant	None
indemnisâtes	Plural
ralentiront	Plural
atteindront	Plural
rimer	None
encrochié	None
baissa	Singular
excéda	Singular
abâtardir	None
révoquera	Singular
prédestineraient	Plural
regroupera	Singular
endetta	Singular
considerera	Singular
afolant	None
voudroit	Singular
sponsoriser	None
essayeront	Plural
deliz	Singular
déconstruit	Singular
situait	Singular
réaliseront	Plural
stigmatisé	None
assortissant	None
suturé	None
bastions	Plural
surfilasse	Singular
orchestra	Singular
deguiser	None
détaillait	Singular
interpeler	None
repaginant	None
galvaudé	None
adaptaient	Plural
séduisirent	Plural
éditerait	Singular
circoncisant	None
catégorisait	Singular
reprendre	None
inquiétaient	Plural
calibraient	Plural
saupoudrer	None
chahuterez	Plural
tablant	None
souffriront	Plural
scrabblé	None
assisterons	Plural
censureraient	Plural
congédier	None
essayerait	Singular
validèrent	Plural
formater	None
renaît	Singular
numa	Singular
patientaient	Plural
substituait	Singular
blessant	None
écroulait	Singular
gesticulant	None
carambola	Singular
visassions	Plural
éclairait	Singular
illuminèrent	Plural
restituerait	Singular
transgressa	Singular
interrompra	Singular
séjournaient	Plural
laborissoiz	Plural
débloquait	Singular
jouirait	Singular
charmait	Singular
renforcer	None
tanguant	None
dissuaderait	Singular
tracèrent	Plural
caler	None
combinaient	Plural
animé	None
régentassent	Plural
hiberné	None
utilisaient	Plural
corrompu	None
marieraient	Plural
parviendrai	Singular
bouscula	Singular
fantasmas	Singular
combina	Singular
aidier	None
encapsulant	None
priverait	Singular
désamarrer	None
parvinrent	Plural
chaus	Singular
réentend	Singular
contrôla	Singular
sursauteront	Plural
rétablira	Singular
entournera	Singular
réjouir	None
rayonnaient	Plural
pormenoit	Singular
décoraient	Plural
subissant	None
querellant	None
subtilisé	None
instituer	None
batisse	Singular
chûtes	Plural
enbusceroient	Plural
lèverai	Singular
survolterons	Plural
plumerai	Singular
dénaturerait	Singular
bret	Singular
interprétaient	Plural
lisser	None
alkyler	None
inspira	Singular
novassions	Plural
permettrez	Plural
deschainassent	Plural
rhabillé	None
déterraient	Plural
observeraient	Plural
parias	Singular
clignant	None
narraient	Plural
recourant	None
envenimer	None
challengeassions	Plural
correspondit	Singular
blessait	Singular
amplifia	Singular
jetterait	Singular
soumettait	Singular
abolirait	Singular
utiliserai	Singular
enjoignait	Singular
concilia	Singular
dépeignit	Singular
remarquaient	Plural
cogné	None
vaincre	None
recommencèrent	Plural
cancanant	None
dulcifier	None
tressaient	Plural
amélioraient	Plural
accédaient	Plural
chevauché	None
romanisasse	Singular
voulu	None
réformer	None
retranchaient	Plural
aventura	Singular
flanquaient	Plural
obéissait	Singular
foutait	Singular
calquait	Singular
rencontrerez	Plural
dévoilerait	Singular
acquerrait	Singular
valer	None
libéralisant	None
statuait	Singular
baverez	Plural
déclareraient	Plural
garda	Singular
attrapaient	Plural
touchast	Singular
corroborerait	Singular
écroulerait	Singular
étoufferait	Singular
assoit	Singular
mura	Singular
choisît	Singular
enroulaient	Plural
volait	Singular
octupler	None
circula	Singular
redémarrera	Singular
agglutinât	Singular
oubliant	None
assisterait	Singular
poursuivrait	Singular
renfermaient	Plural
dulcifiassions	Plural
mesureront	Plural
agrandira	Singular
falloir	None
disputa	Singular
essuioies	Singular
rampait	Singular
flatant	None
gouter	None
professera	Singular
couchait	Singular
recueillera	Singular
inactivant	None
caroleroies	Singular
fêteront	Plural
consacrerait	Singular
glandé	None
légitimerait	Singular
déplaisaient	Plural
coiffait	Singular
démissionnera	Singular
rétorquer	None
apiqué	None
anticipèrent	Plural
propageront	Plural
préféra	Singular
booker	None
dépoussiérer	None
freineront	Plural
résiderait	Singular
avanceraient	Plural
arrosé	None
humiliera	Singular
grattouillé	None
enlogeant	None
ressuscitât	Singular
accepta	Singular
purgeaient	Plural
vivifié	None
effacé	None
compromet	Singular
antra	Singular
colt	Singular
suivrons	Plural
commentera	Singular
nonceras	Singular
bâti	None
émaillèrent	Plural
révoquer	None
soutira	Singular
dessineront	Plural
confia	Singular
toiletter	None
certifia	Singular
réaffirmait	Singular
palabra	Singular
étouffait	Singular
anglicisant	None
dévorèrent	Plural
conservera	Singular
allégué	None
engouant	None
occupèrent	Plural
lima	Singular
resistant	None
supposerons	Plural
repèrera	Singular
aggloméré	None
libella	Singular
contredisait	Singular
conduisit	Singular
convicteroient	Plural
creinsimes	Plural
stipendié	None
chevé	None
clamaient	Plural
parachevèrent	Plural
chalouperons	Plural
pista	Singular
illustré	None
arpenta	Singular
faciliteraient	Plural
rallieront	Plural
redécoller	None
invoquaient	Plural
rétamassiez	Plural
fomenter	None
honorant	None
ancumbré	None
déboursant	None
culminait	Singular
abissâmes	Plural
enclenchait	Singular
baptist	Singular
siégèrent	Plural
soufflaient	Plural
accélèrera	Singular
codétient	Singular
pulvérisera	Singular
attestait	Singular
topographia	Singular
écumaient	Plural
sillonnait	Singular
ruis	Singular
raccorderait	Singular
omettre	None
merdâmes	Plural
enchantaient	Plural
trouvera	Singular
bénéficierait	Singular
damnifïeroit	Singular
excusassiez	Plural
remplirent	Plural
béquillâtes	Plural
projetaient	Plural
convertiraient	Plural
rapprocheraient	Plural
amusait	Singular
intercalant	None
bernas	Singular
matraquait	Singular
aerer	None
confisquera	Singular
éventant	None
pelai	Singular
batre	None
acoardiroiz	Plural
redéploya	Singular
réélit	Singular
désinscrit	Singular
publierez	Plural
annulerait	Singular
annihilerait	Singular
bonifié	None
extrayait	Singular
assujettissant	None
industrialisât	Singular
lamer	None
récoltaient	Plural
regîtraient	Plural
empiegera	Singular
arrangé	None
enserrait	Singular
contestèrent	Plural
paradas	Singular
mentit	Singular
farfouillant	None
despensoit	Singular
réimporté	None
affilerez	Plural
détournant	None
reliaient	Plural
signeriez	Plural
baserait	Singular
réorganiser	None
insérait	Singular
montrera	Singular
justifiait	Singular
effroiastes	Plural
dégustaient	Plural
tirerai	Singular
froissa	Singular
radoubé	None
formassiez	Plural
facilita	Singular
indiqueraient	Plural
rattachaient	Plural
surimposé	None
aspergeaient	Plural
embranché	None
destors	Singular
brees	Singular
résistera	Singular
plièrent	Plural
croulant	None
embarquèrent	Plural
avortant	None
totaliserait	Singular
transiteront	Plural
barberai	Singular
frôla	Singular
bougeaient	Plural
prévirent	Plural
carroyer	None
attaquerait	Singular
rebutait	Singular
consumait	Singular
ressuiissons	Plural
modernisera	Singular
escondire	None
concernerait	Singular
évertuera	Singular
élargirait	Singular
désolait	Singular
coexistera	Singular
confirmerait	Singular
cordas	Singular
empoisonnant	None
prévaut	Singular
réveillèrent	Plural
réussît	Singular
céda	Singular
approprièrent	Plural
alertera	Singular
initié	None
lamai	Singular
tarissaient	Plural
émoussé	None
despenciez	Plural
promenait	Singular
rembarqua	Singular
défibrillerons	Plural
subsistèrent	Plural
dactylographiant	None
ethnographier	None
confectionnant	None
proportant	None
souppasses	Singular
présidait	Singular
basanant	None
enchaînait	Singular
redonnèrent	Plural
schématisas	Singular
numiiez	Plural
présidèrent	Plural
nuira	Singular
sniffaient	Plural
polluait	Singular
éliminé	None
redemanderait	Singular
jouissaient	Plural
mobiliseront	Plural
convoitaient	Plural
essoinast	Singular
franchiser	None
exterminait	Singular
gelait	Singular
connaîtraient	Plural
bromant	None
proposeront	Plural
coprécipita	Singular
rendu	None
t’époumonasses	Singular
contrôlaient	Plural
couvrirait	Singular
assoilerai	Singular
inaugurèrent	Plural
restreignirent	Plural
éclore	None
réconcilieront	Plural
sauta	Singular
concentrera	Singular
résumerait	Singular
comprennes	Singular
profitasses	Singular
dépensèrent	Plural
festina	Singular
brillera	Singular
promeut	Singular
rajas	Singular
dérobera	Singular
reversé	None
préfèreront	Plural
déjouèrent	Plural
volleyèrent	Plural
comprendre	None
téléchargerez	Plural
expérimenté	None
éberluâtes	Plural
consisteraient	Plural
attribueront	Plural
étonnant	None
agiteront	Plural
différencieront	Plural
éperdu	None
écuma	Singular
gêneraient	Plural
bruité	None
manifestaient	Plural
expurger	None
amonter	None
politisant	None
mélangerons	Plural
nierait	Singular
jurerai	Singular
carburasses	Singular
agita	Singular
validera	Singular
iolyant	None
hanter	None
garderait	Singular
criblé	None
sensibilisant	None
devinait	Singular
préfigurer	None
persisteront	Plural
tranlaterons	Plural
augmentèrent	Plural
adobes	Singular
ôté	None
enflant	Singular
épargnerai	Singular
chiffreraient	Plural
comprendront	Plural
sécha	Singular
raffina	Singular
mâchonnant	None
contestaient	Plural
cols	Singular
lancinât	Singular
pourchassa	Singular
endommageront	Plural
fiscalisé	None
surgi	None
freinait	Singular
déplussions	Plural
assassiner	None
twitté	None
dysfonctionneront	Plural
séchas	Singular
rédigé	None
prédéfinir	None
annoncera	Singular
uniformisé	None
guiderait	Singular
opposait	Singular
indiquer	None
kayakassiez	Plural
violait	Singular
ceindrez	Plural
sonas	Singular
habita	Singular
monologuer	None
récapitulé	None
éviscérer	None
conter	None
communes	Singular
recraché	None
congédiant	None
sanctifiant	None
aboyé	None
fermât	Singular
corrompt	Singular
marier	None
ressentiront	Plural
plaindront	Plural
pousser	None
qualifierons	Plural
dépendront	Plural
advenir	None
étalèrent	Plural
ancontriiez	Plural
jailli	None
déboulé	None
dispatchât	Singular
maitrisaient	Plural
terra	Singular
quast	Singular
transportera	Singular
chevrotant	None
basant	None
relogeant	None
pulvérisé	None
foulèrent	Plural
pénaliserait	Singular
haranguassiez	Plural
chourâmes	Plural
aliteraient	Plural
ouvrirait	Singular
renot	Singular
espleitames	Plural
gorgeait	Singular
sculptant	None
disparaître	None
estreindroie	Singular
vicier	None
rebaptisai	Singular
kidnappèrent	Plural
passiveront	Plural
grimper	None
ramassaient	Plural
granulerions	Plural
prophétisait	Singular
gravissaient	Plural
éviscéré	None
tomberai	Singular
mangeras	Singular
aornassions	Plural
effiloquant	None
basculait	Singular
paradant	None
imposant	None
freins	Singular
carburant	None
gaba	Singular
endommagerait	Singular
frottera	Singular
quereller	None
accorda	Singular
tuèrent	Plural
encourager	None
reformata	Singular
subir	None
épicer	None
enferrassions	Plural
omit	Singular
réglementa	Singular
demeurerai	Singular
émincerions	Plural
patiné	None
dussent	Plural
gara	Singular
maquillâmes	Plural
préfiguraient	Plural
méditaient	Plural
palpiter	None
résumaient	Plural
recommencerait	Singular
débrouillait	Singular
récrit	Singular
désolidariser	None
consommeront	Plural
esbatist	Singular
suças	Singular
retransmettra	Singular
offraient	Plural
validait	Singular
intitulé	None
fustigeaient	Plural
maillas	Singular
enflammèrent	Plural
eississent	Plural
temprera	Singular
massacrera	Singular
feuilletteriez	Plural
acheminaient	Plural
précipitera	Singular
hallucinasse	Singular
réagirent	Plural
ponctuait	Singular
rompra	Singular
migrera	Singular
éberlué	None
reclorai	Singular
gouté	None
absorbèrent	Plural
combleront	Plural
intitula	Singular
échafaudant	None
saturé	None
négligerait	Singular
décoder	None
essuyait	Singular
évinça	Singular
submergeait	Singular
insistant	None
référé	None
montrerait	Singular
marketant	None
chômant	None
desrobant	None
perla	Singular
transmuter	None
martyrisé	None
défocaliser	None
retranchait	Singular
réentendre	None
cavalcader	None
convertissant	None
grisant	None
acheminerait	Singular
mondialisâtes	Plural
abusera	Singular
déniaiseront	Plural
citas	Singular
impacta	Singular
autoproclama	Singular
biscuiterait	Singular
abolissaient	Plural
rapa	Singular
repent	Singular
boycottant	None
surchargeant	None
representer	None
radioactivassent	Plural
présenteront	Plural
suspend	Singular
useront	Plural
rebrousserions	Plural
dérailla	Singular
bouleversa	Singular
projetèrent	Plural
palpa	Singular
affermé	None
entramez-vos	Plural
prédécoupâmes	Plural
comandasse	Singular
mangeront	Plural
devorant	None
rythmait	Singular
infantiliserai	Singular
pioché	None
violant	None
menaient	Plural
agissait	Singular
manquait	Singular
soulant	None
alia	Singular
parviendrez	Plural
cadré	None
booka	Singular
habundissoiz	Plural
apporterez	Plural
corsât	Singular
césariser	None
épargnant	None
codifièrent	Plural
ribotant	None
défit	Singular
cru	None
ajointer	None
stria	Singular
accueillait	Singular
laissaient	Plural
tremper	None
cliqua	Singular
propulseront	Plural
emménager	None
impactait	Singular
dilater	None
réarrangea	Singular
roucoulant	None
envahiront	Plural
décorassent	Plural
raserons	Plural
fluidifierait	Singular
découla	Singular
fomentèrent	Plural
swingué	None
glana	Singular
desplaçoit	Singular
vinifié	None
ordonnancé	None
réorganisant	None
résulta	Singular
violeraient	Plural
renchérissent	Plural
capturait	Singular
imposait	Singular
protégea	Singular
déposerait	Singular
baz	Singular
surveillèrent	Plural
triplait	Singular
succéda	Singular
séparerait	Singular
relativisa	Singular
prophétisa	Singular
accordaient	Plural
anthropiserait	Singular
contaminé	None
utiliseriez	Plural
invaliderait	Singular
gagneraient	Plural
emboîtassions	Plural
minera	Singular
chauffaient	Plural
rattraperons	Plural
écrira	Singular
apparentant	None
condamnerait	Singular
déclarèrent	Plural
monopolisa	Singular
faufilé	None
géra	Singular
gracia	Singular
existera	Singular
dissimula	Singular
ressentiraient	Plural
cantas	Singular
offrait	Singular
scandait	Singular
anéantira	Singular
pressaient	Plural
separant	None
recréait	Singular
empêcher	None
delaissoie	Singular
bayasse	Singular
bridé	None
convoquera	Singular
enduisaient	Plural
avorta	Singular
apporta	Singular
ratera	Singular
guettait	Singular
reconnaîtra	Singular
antéposé	None
influençaient	Plural
confrontèrent	Plural
countrefaisoie	Singular
peindre	None
insultait	Singular
aboschasmes	Plural
revenait	Singular
trusquiner	None
tomba	Singular
attisa	Singular
répercuter	None
assurerai	Singular
blasphémé	None
dînant	None
parti	None
raccourcira	Singular
fomenta	Singular
informerai	Singular
picorâmes	Plural
essoinerons	Plural
aluminer	None
combattant	None
imbiber	None
scolarisassiez	Plural
résidât	Singular
achemina	Singular
échaudé	None
rouvrait	Singular
répondriez	Plural
avertissant	None
admirerai	Singular
écrouler	None
confondrait	Singular
demourer	None
contrariaient	Plural
asset	Singular
retransmet	Singular
toisassiez	Plural
prouvant	None
entreprend	Singular
mobiliser	None
chialât	Singular
harassas	Singular
prétendre	None
colorait	Singular
empiegé	None
restructura	Singular
prénommeraient	Plural
martyriser	None
reconvertirent	Plural
volèrent	Plural
déménagèrent	Plural
paissait	Singular
réaffirmera	Singular
saisiront	Plural
abjurant	None
ramifié	None
espionnait	Singular
escut	Singular
resforcier	None
dévisager	None
perpétuait	Singular
cogérer	None
installât	Singular
recentré	None
admiré	None
apposa	Singular
détectaient	Plural
démantelèrent	Plural
diffusaient	Plural
proscrivit	Singular
enregistra	Singular
façonnait	Singular
ravagerait	Singular
composeront	Plural
ridiculisait	Singular
sabra	Singular
créditait	Singular
pivoté	None
emmener	None
caroleriiez	Plural
bénéficiât	Singular
titré	None
cailleras	Singular
badigeonné	None
variait	Singular
sellé	None
fusaient	Plural
inclurait	Singular
conservait	Singular
manovreroient	Plural
cerneras	Singular
sacraliser	None
mutant	None
dissuadait	Singular
déplaceront	Plural
offusquaient	Plural
métrassions	Plural
admirera	Singular
graciât	Singular
déliteras	Singular
rappliquassiez	Plural
fichant	None
téléphona	Singular
gratté	None
voloie	Singular
reconnaîtront	Plural
prenoit	Singular
dépendra	Singular
cracheriiez	Plural
comblâtes	Plural
enlevasses	Singular
fragmenta	Singular
érodèrent	Plural
cravaché	None
suspectait	Singular
rentrèrent	Plural
devrez	Plural
accueilli	None
agoniser	None
falis	Singular
circuiter	None
boirait	Singular
codétinssiez	Plural
clarifiera	Singular
peinera	Singular
soulevant	None
bayas	Singular
culbutasse	Singular
sueraient	Plural
paint	Singular
dotaient	Plural
pâtira	Singular
cité	None
rapetisser	None
patrouillait	Singular
élançaient	Plural
spolia	Singular
cordonnerai	Singular
éructâtes	Plural
droppant	None
dénigré	None
châtier	None
planer	None
persuadait	Singular
christianisa	Singular
trouveraient	Plural
arriserons	Plural
tissa	Singular
battront	Plural
débequètera	Singular
déposséda	Singular
pousseront	Plural
prolongeant	None
proliférant	None
terrorisait	Singular
échappera	Singular
témoigna	Singular
déguerpîtes	Plural
pressuré	None
saxophoné	None
rattrapant	None
consultait	Singular
insistera	Singular
venté	None
douta	Singular
secrété	None
remplaçaient	Plural
disses	Singular
associeront	Plural
semblera	Singular
restaurera	Singular
favorisèrent	Plural
allongera	Singular
avèreraient	Plural
pédalant	None
tasta	Singular
circoncire	None
adorait	Singular
aigrisses	Singular
regardaient	Plural
rabâcher	None
cuntenissoiz	Plural
arroger	None
enveloppait	Singular
ébauchassions	Plural
appliqua	Singular
fortifiaient	Plural
inquiétèrent	Plural
discourt	Singular
déménageaient	Plural
raréfier	None
attaquerai	Singular
chevasse	Singular
flottait	Singular
bruncha	Singular
enrouler	None
chaponné	None
déroulerait	Singular
désapprouvait	Singular
instruirait	Singular
hurter	None
estampas	Singular
retardaient	Plural
voguant	None
lierez	Plural
ennuieraient	Plural
scanda	Singular
fendillera	Singular
codifia	Singular
menacerait	Singular
atrophiasses	Singular
secourt	Singular
entrainaient	Plural
bernera	Singular
chevroteront	Plural
fignoler	None
annelé	None
gênèrent	Plural
composa	Singular
caressas	Singular
débutèrent	Plural
assumaient	Plural
dissipait	Singular
sentimentaliser	None
sabla	Singular
décevant	None
enrouerai	Singular
point	Singular
pallieriez	Plural
appuyèrent	Plural
mulota	Singular
jalousait	Singular
livrerait	Singular
concocta	Singular
phosphorylasses	Singular
chronomètrerait	Singular
acoz	Singular
affleuraient	Plural
éclairant	None
luisant	None
achevaient	Plural
desceller	None
réitéra	Singular
révoqua	Singular
enveloppaient	Plural
marquerait	Singular
demeurât	Singular
cherchait	Singular
qualifièrent	Plural
représenté	None
légitimait	Singular
muras	Singular
semèrent	Plural
paraît	Singular
éditait	Singular
noyauter	None
glisserait	Singular
cerclé	None
transporteront	Plural
discuterait	Singular
estanchier	None
bloqué	None
consentait	Singular
rapprocher	None
juas	Singular
flasher	None
livrait	Singular
dévoilera	Singular
prôner	None
doing	Singular
tirèrent	Plural
opposeraient	Plural
pécher	None
installeront	Plural
dénivelât	Singular
rua	Singular
croiserait	Singular
regardait	Singular
étatiseras	Singular
perdrait	Singular
prélevèrent	Plural
révélant	None
cert	Singular
rappelait	Singular
développant	None
soutirant	None
mentionnerait	Singular
mobilisaient	Plural
concilierons	Plural
tuait	Singular
rétorquait	Singular
buvait	Singular
résiliât	Singular
cristallisait	Singular
réclama	Singular
progressait	Singular
chaut	Singular
chiffonnâmes	Plural
écœurant	None
enchaînaient	Plural
comptabilisant	None
prédominant	None
dépréciait	Singular
omirent	Plural
vidait	Singular
exhibait	Singular
entreprendra	Singular
lober	None
illuminait	Singular
disclaimeroit	Singular
agglutiné	None
repincé	None
blackboulassions	Plural
jonglant	None
brancardâmes	Plural
ensuivit	Singular
rêvé	None
remarquai	Singular
cofinançant	None
contesteraient	Plural
fourrer	None
démanteler	None
survenu	None
douter	None
incurvant	None
démarquaient	Plural
nitrerez	Plural
cédait	Singular
jugeassions	Plural
baliverna	Singular
captant	None
inhumait	Singular
aboulant	None
zébras	Singular
atténuait	Singular
escoltoient	Plural
justifierait	Singular
façonna	Singular
esparpeillissoiz	Plural
encabané	None
affaiblissait	Singular
désoxyderas	Singular
eschiverent	Plural
tiquer	None
multipliaient	Plural
vitupérâmes	Plural
approuvait	Singular
alas	Singular
machinait	Singular
vaironnera	Singular
renommèrent	Plural
sillonnaient	Plural
fanant	None
ruchasses	Singular
dénombrera	Singular
détrôner	None
carda	Singular
monétiser	None
marchandé	None
devenant	None
ramifiant	None
intéressait	Singular
accorderont	Plural
adosser	None
réactiva	Singular
ganta	Singular
rigolera	Singular
posât	Singular
aboyait	Singular
hydrogéner	None
rosseriez	Plural
flaz	Singular
convoitant	None
responsabilisant	None
complétèrent	Plural
proposé	None
assertant	None
autocorrigé	None
bousculaient	Plural
investissant	None
rentas	Singular
veḍist	Singular
essaiai	Singular
surnageait	Singular
avertirait	Singular
renflouant	None
assolant	None
corneta	Singular
éluant	None
souhaiterez	Plural
surlignerait	Singular
soutiendra	Singular
illustra	Singular
espusé	None
entrechoquassiez	Plural
brillèrent	Plural
emploierait	Singular
énoncerons	Plural
respiraient	Plural
redessina	Singular
stalinisant	None
hésitera	Singular
craqua	Singular
tablas	Singular
trappant	None
démenant	None
cantonnaient	Plural
discrédita	Singular
galera	Singular
plusse	Singular
résignant	None
mélangea	Singular
astien	Singular
fascina	Singular
cagua	Singular
fouiller	None
griser	None
déclineront	Plural
maigrirons	Plural
clamèrent	Plural
détériorer	None
effacerai	Singular
compassant	None
suffirait	Singular
redescendit	Singular
plagié	None
plaindra	Singular
désagrégé	None
subventionné	None
enrôlant	None
reposeraient	Plural
énucléé	None
populariseront	Plural
mortifié	None
englobait	Singular
remarquèrent	Plural
lavas	Singular
songé	None
savait	Singular
consolidèrent	Plural
freina	Singular
excella	Singular
dévoua	Singular
autopilotant	None
desrengier	None
terrassera	Singular
perdurerait	Singular
commenté	None
distillait	Singular
conserverons	Plural
codifiait	Singular
analysa	Singular
colmater	None
ragé	None
pourrissaient	Plural
surmené	None
soulas	Singular
encagouleras	Singular
rapportaient	Plural
déchiffrer	None
bronzant	None
emprunteraient	Plural
valorisaient	Plural
débuté	None
imputait	Singular
larguaient	Plural
sert	Singular
déblaya	Singular
délester	None
huyant	None
répercutant	None
diversifiait	Singular
renouèrent	Plural
dreçant	None
élançait	Singular
occupant	None
cousait	Singular
embrochera	Singular
copierai	Singular
compléter	None
félicita	Singular
mineras	Singular
provenir	None
ébouillanter	None
demenerons	Plural
bétonnerions	Plural
calculant	None
flut	Singular
accentuaient	Plural
protègerai	Singular
encodera	Singular
irrité	None
désembouera	Singular
boursicoteront	Plural
dénotaient	Plural
entrelacé	None
habitèrent	Plural
affirmaient	Plural
réservait	Singular
affiner	None
répugnaient	Plural
complexifié	None
embûchant	None
étoffa	Singular
découvrira	Singular
rajoutaient	Plural
assigneras	Singular
souscrivant	None
prétendant	None
décrieriez	Plural
carras	Singular
accrut	Singular
conqueṣis	Singular
rama	Singular
déraper	None
interconvertir	None
sommeillant	None
éduqueras	Singular
bâtonner	None
reniera	Singular
épuisèrent	Plural
désolidarisant	None
refont	Plural
coursera	Singular
adestroit	Singular
réfrigérant	None
retravailleront	Plural
droguait	Singular
rencontrèrent	Plural
trempaient	Plural
incitèrent	Plural
conformer	None
reconduisirent	Plural
arrosèrent	Plural
supervisèrent	Plural
pétitionna	Singular
démontreraient	Plural
étripasse	Singular
soupesé	None
tans	Singular
fust	Singular
survolera	Singular
tonitrué	None
dévastaient	Plural
crieront	Plural
rencontrai	Singular
vêtit	Singular
caramélisassions	Plural
naquirent	Plural
revendiqué	None
connaîtrons	Plural
récréé	None
lyophilisa	Singular
rédigera	Singular
mensongierions	Plural
capasse	Singular
maximaliser	None
traqueront	Plural
rencontrerai	Singular
opterons	Plural
pencheront	Plural
laisserez	Plural
planterait	Singular
réfutâtes	Plural
ignorai	Singular
développeraient	Plural
rôti	None
regretta	Singular
donneras	Singular
remporteraient	Plural
rétribuer	None
engloutira	Singular
dénucléariser	None
appliqueront	Plural
accepteras	Singular
ardoisé	None
saisirent	Plural
fragilisé	None
rodas	Singular
poinçonner	None
abrogeait	Singular
parvient	Singular
reprendrait	Singular
semblant	None
dormirent	Plural
sentir	None
atocheriiens	Plural
encadreriez	Plural
deslogerez	Plural
évinçant	None
déplurent	Plural
resumé	None
spécialisaient	Plural
cossa	Singular
désirait	Singular
consacreraient	Plural
remémorer	None
facturaient	Plural
restituait	Singular
augmentant	None
intersectant	None
font	Plural
escusant	None
exigerait	Singular
oubliai	Singular
lurreras	Singular
effrois	Singular
massacrer	None
conduira	Singular
assonançant	None
jouté	None
occupait	Singular
limiterait	Singular
paysagea	Singular
contrevient	Singular
tergiversé	None
encordassent	Plural
retiendront	Plural
recentra	Singular
doteront	Plural
interceptaient	Plural
tirerons	Plural
adaptant	None
polychromaient	Plural
mentirait	Singular
corroborant	None
fonça	Singular
bloquerai	Singular
raccrocha	Singular
contribuâtes	Plural
consultera	Singular
reproché	None
oublié	None
mommas	Singular
enterrera	Singular
déshonorait	Singular
chourinaient	Plural
rivalisait	Singular
suffisait	Singular
scrutait	Singular
rebadigeonnai	Singular
penetras	Singular
beurrer	None
inocula	Singular
gardait	Singular
accapara	Singular
diagnostiqua	Singular
atachié	None
rebrûlât	Singular
divisa	Singular
intitulerait	Singular
crochetant	None
varias	Singular
ramasserait	Singular
couronnait	Singular
cailler	None
promulguer	None
court-circuiter	None
rappelleraient	Plural
décolorant	None
appréciait	Singular
éparpillèrent	Plural
ruinant	None
affilé	None
massai	Singular
assaini	None
boulassent	Plural
maltraitait	Singular
contraignaient	Plural
étiquetant	None
débrouillé	None
surclassait	Singular
achèterait	Singular
jardinassent	Plural
intima	Singular
écriras	Singular
ornait	Singular
collaborerait	Singular
monétisasse	Singular
masquait	Singular
étonnerait	Singular
approuchier	None
cadmié	None
distança	Singular
pardonnant	None
réciteras	Singular
récusait	Singular
deslïera	Singular
débarder	None
bâillonner	None
dénonçaient	Plural
parcourt	Singular
propageai	Singular
essaimant	None
simplifia	Singular
mandata	Singular
desvasse	Singular
interposé	None
résinant	None
pelleter	None
armèrent	Plural
prépareraient	Plural
toussa	Singular
malmené	None
tuna	Singular
émancipa	Singular
anters	Singular
supplié	None
nappa	Singular
désertèrent	Plural
capitulera	Singular
plumeront	Plural
fructifiâtes	Plural
finança	Singular
oz	Singular
échelonneront	Plural
retourneraient	Plural
esgratigneroient	Plural
sonder	None
entepreté	None
bottai	Singular
utiliserait	Singular
drapait	Singular
enragé	None
ottroyant	None
retardera	Singular
snober	None
hennir	None
arrosait	Singular
crématiserez	Plural
rapprochèrent	Plural
eût	Singular
removroient	Plural
provoquèrent	Plural
impacteront	Plural
mesclé	None
sentît	Singular
honnourassions	Plural
démentirent	Plural
échapperait	Singular
triompha	Singular
rachetait	Singular
bouleversèrent	Plural
compléta	Singular
canteras	Singular
mira	Singular
flageolant	None
immigraient	Plural
rembourseras	Singular
gansé	None
élisaient	Plural
critiquera	Singular
activeraient	Plural
incapaciter	None
partagerait	Singular
purifia	Singular
conversant	None
radioactivant	None
supervisera	Singular
figuré	None
opprimaient	Plural
stigmatisait	Singular
cotisèrent	Plural
proposerait	Singular
latinisé	None
durcissait	Singular
gracias	Singular
produisit	Singular
dessaisir	None
cafouillasses	Singular
déferla	Singular
gira	Singular
hantâmes	Plural
africanisé	None
circonscrivant	None
brit	Singular
alumer	None
psychiatriserions	Plural
prolongeait	Singular
déguisera	Singular
illusionner	None
exhalait	Singular
retrouver	None
ballotant	None
concaténer	None
cumandé	None
vénérer	None
checkeraient	Plural
indignaient	Plural
frisé	None
livrassent	Plural
diffuseraient	Plural
rechercha	Singular
part	Singular
mesler	None
ferrerait	Singular
archivera	Singular
adaptèrent	Plural
traiterait	Singular
déparler	None
candidaté	None
serez	Plural
assuma	Singular
garnir	None
aboutissaient	Plural
isoler	None
commentait	Singular
dort	Singular
contrefaire	None
tueras	Singular
rééquilibrer	None
œuvraient	Plural
biscuité	None
maschera	Singular
adreceras	Singular
réalisé	None
logeasmes	Plural
dévier	None
dématérialisé	None
rétablirait	Singular
culmineront	Plural
félicitai	Singular
prouverait	Singular
entrains	Singular
vinifierai	Singular
resquillassent	Plural
décerna	Singular
renouer	None
constituant	None
subjectiviseriez	Plural
tigra	Singular
puni	None
chicana	Singular
révéraient	Plural
régénérer	None
provoquerait	Singular
détruirai	Singular
proposer	None
favoriseront	Plural
illuminera	Singular
armait	Singular
sinisa	Singular
recomposa	Singular
réuniraient	Plural
chercheront	Plural
longera	Singular
blâmait	Singular
couronnera	Singular
utiliserons	Plural
feront	Plural
agressait	Singular
régimant	None
absorbait	Singular
encourageant	None
générant	None
absout	Singular
cofondas	Singular
demanderez	Plural
senefiiiez	Plural
remémorant	None
positionnerait	Singular
chuteront	Plural
guaiteroit	Singular
anastomoser	None
bridgé	None
réuniront	Plural
adoptaient	Plural
replacé	None
dévidant	None
séduisaient	Plural
horripilant	None
banchant	None
répandraient	Plural
amincissant	None
kaolinisé	None
coardé	None
tardera	Singular
rempailleriez	Plural
kidnappera	Singular
décarboné	None
interjeter	None
trempait	Singular
bloquerait	Singular
asphyxié	None
discutera	Singular
pagaya	Singular
enduire	None
brandissaient	Plural
rendit	Singular
saviez	Plural
proclamant	None
adressât	Singular
repeignant	None
psalmodia	Singular
maintinrent	Plural
dégénéra	Singular
glaner	None
seinasse	Singular
dépendre	None
mastiquer	None
aviliront	Plural
recompté	None
dégobilleriez	Plural
nourrissaient	Plural
restreindra	Singular
primeras	Singular
dallerons	Plural
agioterons	Plural
niella	Singular
ramenaient	Plural
enorer	None
surpassaient	Plural
dépensait	Singular
recoucheraient	Plural
délaissaient	Plural
disait	Singular
blindé	None
embarquât	Singular
troublèrent	Plural
gardé	None
terrait	Singular
limiteront	Plural
connaitrai	Singular
lapidèrent	Plural
signaleront	Plural
contrediront	Plural
conviendrai	Singular
resguarder	None
guiant	None
baraqueras	Singular
boita	Singular
prétendait	Singular
agrémenter	None
régnèrent	Plural
bombai	Singular
convergeaient	Plural
relancera	Singular
douner	None
prendrai	Singular
prônera	Singular
dénia	Singular
blêmissant	None
maintînt	Singular
devenait	Singular
grimperont	Plural
inertasse	Singular
hériterait	Singular
autogéré	None
ambuler	None
permettes	Singular
paillasse	Singular
bousculèrent	Plural
garder	None
dépêché	None
usurpait	Singular
centralisa	Singular
démonétisassiez	Plural
déclencher	None
annuleront	Plural
recycla	Singular
souffrirait	Singular
empirait	Singular
expulsa	Singular
lithographierons	Plural
soulagera	Singular
choquer	None
constaterai	Singular
rêvait	Singular
subsister	None
fabriquerait	Singular
bicarbonatâtes	Plural
décrédibilisâtes	Plural
reléguait	Singular
intervenaient	Plural
cherchai	Singular
collectionnait	Singular
baptisèrent	Plural
criait	Singular
fichera	Singular
cumula	Singular
occuperait	Singular
approcheront	Plural
étripant	None
comprirent	Plural
smurfant	None
débarquera	Singular
immobilisait	Singular
pleuvaient	Plural
plaignaient	Plural
éradiquer	None
papillonnât	Singular
freineraient	Plural
notifiait	Singular
renièrent	Plural
procédait	Singular
déracineras	Singular
dérogeait	Singular
bâillonneraient	Plural
cimentait	Singular
revigorant	None
encouragèrent	Plural
restât	Singular
abêti	None
ordonnant	None
raviront	Plural
réclameraient	Plural
accabler	None
désorienter	None
affiliant	None
torché	None
copieront	Plural
sonneront	Plural
proviendra	Singular
brassai	Singular
gruter	None
contesteront	Plural
fouir	None
imagineriez	Plural
accorderait	Singular
supposerait	Singular
osa	Singular
investirai	Singular
découvraient	Plural
démarquerai	Singular
joindra	Singular
parodiait	Singular
reiectasse	Singular
brouta	Singular
réservera	Singular
emprisonnèrent	Plural
couvin	Singular
effectuerai	Singular
collectera	Singular
chloroformasses	Singular
anoblissait	Singular
faiblira	Singular
effoirât	Singular
dissolut	Singular
capas	Singular
usurpant	None
aventuras	Singular
restaurant	None
abroutiront	Plural
outrageant	None
intitulèrent	Plural
remontaient	Plural
conflueront	Plural
concurrençaient	Plural
préféré	None
rembarrâtes	Plural
procèderai	Singular
assassina	Singular
embarqueront	Plural
aimeraient	Plural
européaniser	None
dormirai	Singular
désireraient	Plural
désisté	None
agressèrent	Plural
cuirassait	Singular
tuma	Singular
renverrai	Singular
ocis	Singular
crocheté	None
honnîtes	Plural
giveer	None
baffa	Singular
végétassiez	Plural
repræsenter	None
plagia	Singular
brusquer	None
débrouillant	None
indiqueront	Plural
vulgarisant	None
dévaler	None
effrayant	None
épandu	None
priveront	Plural
costa	Singular
résiliant	None
impliqueront	Plural
contribueront	Plural
comanda	Singular
consyderasmes	Plural
dissimulait	Singular
remplaçait	Singular
phagocyté	None
userait	Singular
arriverez	Plural
ficher	None
bricolé	None
estreindre	None
séduisit	Singular
excité	None
apprendrait	Singular
évitant	None
riva	Singular
travaillasses	Singular
améliorèrent	Plural
écrémé	None
pollueraient	Plural
optimiser	None
bouda	Singular
brula	Singular
abstenaient	Plural
détestait	Singular
acroistre	None
nimber	None
affirmèrent	Plural
abritant	None
atteignait	Singular
systématisant	None
remplacer	None
mundifoie	Singular
métamorphosa	Singular
fusillé	None
commenta	Singular
immoler	None
électrocuter	None
préconisé	None
concernèrent	Plural
filas	Singular
hésitaient	Plural
lutterai	Singular
pressenti	None
restera	Singular
analysera	Singular
trébuchait	Singular
repiaulas	Singular
déversa	Singular
orthographiait	Singular
enconvenencié	None
dédommagerions	Plural
covert	None
réconcilierait	Singular
tanguerions	Plural
cunduiroie	Singular
réifié	None
transposa	Singular
obéirent	Plural
accumulait	Singular
aimerez	Plural
bagoulèrent	Plural
délivrerai	Singular
inféré	None
transparait	Singular
atterrira	Singular
mécroirez	Plural
haiteras	Singular
pardonneront	Plural
sangla	Singular
reveoir	None
utiliseras	Singular
guias	Singular
impatientant	None
planifier	None
surpasserait	Singular
manipulait	Singular
bigarré	None
campaient	Plural
manquera	Singular
prêchera	Singular
collait	Singular
perturbera	Singular
réalisaient	Plural
coprésider	None
préqualifié	None
guideront	Plural
démobilisé	None
desregler	None
dénigrait	Singular
pénétrèrent	Plural
dactylographier	None
infestait	Singular
abondaient	Plural
asemblé	None
repentirions	Plural
raviva	Singular
rétablirai	Singular
déporté	None
primas	Singular
interpolera	Singular
incapacité	None
incarna	Singular
entourloupasses	Singular
désincarcérassions	Plural
seellasse	Singular
occuperai	Singular
rediscuté	None
observèrent	Plural
inviter	None
séquencera	Singular
préviendra	Singular
laminant	None
organisaient	Plural
lamas	Singular
formalisa	Singular
enfreignaient	Plural
frayer	None
amenèrent	Plural
hissait	Singular
cala	Singular
houa	Singular
interpolé	None
survêtit	Singular
baislions	Plural
élanceront	Plural
boycotteraient	Plural
effacèrent	Plural
reverserait	Singular
envair	None
empiffrer	None
attirerait	Singular
séduira	Singular
barrera	Singular
approuchié	None
mommasses	Singular
morus	Singular
imperméabilisant	None
ourdi	None
permissions	Plural
saisissait	Singular
manias	Singular
requit	Singular
règneraient	Plural
puait	Singular
stratifiât	Singular
dépara	Singular
arrachait	Singular
rongeaient	Plural
délogèrent	Plural
bouder	None
facturé	None
japonisassions	Plural
tâcha	Singular
abrégeait	Singular
détruit	Singular
comprimant	None
occidentalisé	None
flirtait	Singular
enviaient	Plural
kifasses	Singular
compilera	Singular
investiront	Plural
aspiraient	Plural
emplissant	None
inculpé	None
bougé	None
estimé	None
enfermèrent	Plural
acclimata	Singular
badé	None
fiabilisant	None
ansai	Singular
arrangerait	Singular
chaussa	Singular
vendraient	Plural
ravageassions	Plural
empaillera	Singular
râpant	None
émulsifié	None
conçurent	Plural
dissimulerait	Singular
abrogeant	None
savions	Plural
apparaitraient	Plural
ouvriront	Plural
captera	Singular
interrompre	None
arasassions	Plural
injecta	Singular
cerna	Singular
commanderont	Plural
votaient	Plural
simulait	Singular
feignait	Singular
remboursa	Singular
quicheras	Singular
souriait	Singular
dériverait	Singular
triaient	Plural
affectaient	Plural
croz	Singular
désemparé	None
cristallisèrent	Plural
classifier	None
crispa	Singular
modifierons	Plural
collectionna	Singular
pignocherai	Singular
supplémentâmes	Plural
levé	None
attérir	None
priera	Singular
détournera	Singular
glamouriseras	Singular
entraimeroient	Plural
conseillié	None
lika	Singular
énoncé	None
diraient	Plural
appliqueraient	Plural
achèverait	Singular
persé	None
galer	None
militer	None
donnassent	Plural
décrochant	None
abdiquait	Singular
rainuré	None
rendre	None
tarderont	Plural
reverront	Plural
méconnaitre	None
décléricaliser	None
prononcé	None
monopolisaient	Plural
prospérait	Singular
révélèrent	Plural
brossa	Singular
attachera	Singular
amenas	Singular
bessemérisant	None
dégageait	Singular
rattraperont	Plural
stockera	Singular
considérèrent	Plural
surpassèrent	Plural
garderaient	Plural
crièrent	Plural
cliva	Singular
éliminera	Singular
remaniassent	Plural
bosser	None
canté	None
dutoit	Singular
séparé	None
depesché	None
kidnapper	None
écologisé	None
dénichant	None
thermiser	None
consolait	Singular
transformeront	Plural
empapaouter	None
glanera	Singular
virevoltant	None
respectera	Singular
aisai	Singular
volé	None
périclitant	None
concédait	Singular
briguer	None
traînait	Singular
casserait	Singular
entarteront	Plural
accompli	None
suscita	Singular
finalisant	None
insultant	None
mandater	None
cautionnant	None
broda	Singular
tornai	Singular
encourageraient	Plural
gaudir	None
mélangeront	Plural
déclencherait	Singular
condamneront	Plural
risquera	Singular
dépolarisas	Singular
suffumiguai	Singular
explosèrent	Plural
intronisant	None
surfait	Singular
découplant	None
reparler	None
décala	Singular
désigneront	Plural
repousserait	Singular
seyait	Singular
suspectas	Singular
adhérèrent	Plural
classa	Singular
relayassiez	Plural
enseignaient	Plural
surent	Plural
obtenu	None
raser	None
trépané	None
baissèrent	Plural
réprouvé	None
montrerai	Singular
apparié	None
afis	Singular
traînassé	None
castré	None
terrassasse	Singular
avalloit	Singular
essaya	Singular
habiterai	Singular
compromettrait	Singular
forças	Singular
succombera	Singular
contournant	None
ajustât	Singular
excisa	Singular
argumenterai	Singular
faciliterez	Plural
coexistait	Singular
décolérassiez	Plural
agonisait	Singular
appréhender	None
insistèrent	Plural
osté	None
engloutir	None
coûta	Singular
relira	Singular
méconnu	None
contrefaisant	None
configurer	None
détrônerait	Singular
présiderait	Singular
soulèveront	Plural
menât	Singular
atterriront	Plural
consistera	Singular
travaillerai	Singular
manachant	None
mouler	None
engrisaillas	Singular
débraser	None
récita	Singular
cracheroiz	Plural
licenciant	None
fluctuant	None
applis	Singular
jointoyé	None
avalé	None
renos	Singular
défaillîtes	Plural
décidé	None
chaluter	None
débordait	Singular
régressa	Singular
circonviendront	Plural
exhaler	None
évacuera	Singular
illustrèrent	Plural
migraient	Plural
commissionné	None
épouserait	Singular
écoulerait	Singular
obtiendrions	Plural
verserai	Singular
massa	Singular
délogea	Singular
éteindront	Plural
paraphé	None
camât	Singular
voudriez	Plural
descriiiens	Plural
conseillaient	Plural
signaler	None
coexisteront	Plural
entrefieres	Singular
émergeaient	Plural
triait	Singular
esgardast	Singular
calmeront	Plural
assignèrent	Plural
défloré	None
réindexer	None
gratifierions	Plural
entraina	Singular
valida	Singular
singularisant	None
redéployait	Singular
sonnera	Singular
tatoué	None
coper	None
bloqua	Singular
subvenir	None
nuisirent	Plural
débagouler	None
désespéraient	Plural
ensabla	Singular
aberré	None
décida	Singular
jalouser	None
fulguré	None
indiquerons	Plural
nuirait	Singular
clôturerai	Singular
totalisant	None
immigrèrent	Plural
songeait	Singular
rediffuser	None
diagnostiqué	None
cohabitait	Singular
esposisse	Singular
élancera	Singular
contreplederoiz	Plural
rétracta	Singular
regagnèrent	Plural
wardé	None
répondrait	Singular
signifiait	Singular
bossant	None
aluma	Singular
farfouillasses	Singular
simplifierai	Singular
bivouaquant	None
enchatonneriez	Plural
encartoucher	None
charria	Singular
résiliera	Singular
contresigna	Singular
enheritiiens	Plural
déformerait	Singular
immuniser	None
récompensasse	Singular
constataient	Plural
pleurera	Singular
modula	Singular
bistré	None
capa	Singular
rallièrent	Plural
offusquait	Singular
annexa	Singular
hériteront	Plural
comploterait	Singular
somma	Singular
renvoyèrent	Plural
devancerait	Singular
piégeait	Singular
ancra	Singular
désaxer	None
bioaccumuler	None
tanceroit	Singular
répartirent	Plural
excepté	None
intéressant	None
gruta	Singular
concédaient	Plural
déduisait	Singular
parodia	Singular
souffrirai	Singular
approuverai	Singular
amusera	Singular
chercha	Singular
fend	Singular
renferma	Singular
napperait	Singular
trait	Singular
importerai	Singular
rigidifié	None
trahissaient	Plural
blacklisté	None
foisonnaient	Plural
procurer	None
pépiant	None
capoter	None
conjecturerait	Singular
rééduqué	None
militaient	Plural
ternira	Singular
décernera	Singular
majorant	None
installeraient	Plural
followé	None
laisseriez	Plural
proteger	None
intercéda	Singular
émancipé	None
désexciter	None
resquillâmes	Plural
haïra	Singular
alertaient	Plural
envia	Singular
poursuivi	None
suffisaient	Plural
éloignerait	Singular
rejouait	Singular
rafraîchi	None
manifestait	Singular
évoquer	None
morfler	None
desservirent	Plural
zoomant	None
respirait	Singular
remettrons	Plural
occupé	None
fusionner	None
hantant	None
presentasses	Singular
renouvelleront	Plural
jeté	None
regrouper	None
manquant	None
jura	Singular
prélasser	None
recollé	None
vivraient	Plural
agrandissaient	Plural
vulgariser	None
fluoies	Singular
pecchant	None
désireront	Plural
corrigèrent	Plural
fournirait	Singular
favoriserait	Singular
civilisassiez	Plural
aimeras	Singular
enfonçaient	Plural
traita	Singular
contesterai	Singular
offert	None
chargeaient	Plural
combattrait	Singular
percevraient	Plural
régala	Singular
démarreront	Plural
meubla	Singular
covoiturer	None
sortirons	Plural
saisirait	Singular
clouait	Singular
rouas	Singular
aoûterons	Plural
connaitraient	Plural
supprimera	Singular
garrocha	Singular
rebaptiseront	Plural
antredonrons	Plural
détestera	Singular
conjura	Singular
appartiendra	Singular
serainer	None
barri	None
déréglementé	None
éviterons	Plural
ramperait	Singular
parrainer	None
celassions	Plural
explosant	None
innocenta	Singular
bâtîtes	Plural
culminer	None
coloniseront	Plural
occlure	None
astreignit	Singular
ruminant	None
emballé	None
dégobilleront	Plural
lifter	None
détient	Singular
reconnaîtraient	Plural
gagnerez	Plural
rééditeront	Plural
terras	Singular
apercevrez	Plural
recensait	Singular
ruissellant	None
égrenant	None
éconduit	Singular
entraidaient	Plural
égalait	Singular
rachèterions	Plural
intervînt	Singular
éveilleront	Plural
émergerait	Singular
pasas	Singular
pratiquaient	Plural
déréglât	Singular
multipliera	Singular
déconseilla	Singular
œuvrera	Singular
scandalisa	Singular
choquèrent	Plural
interpella	Singular
aimèrent	Plural
pocheriez	Plural
possèderait	Singular
mordait	Singular
explosa	Singular
fournirai	Singular
relaschant	None
covin	Singular
finançait	Singular
compensaient	Plural
debaracera	Singular
plafonner	None
refondu	None
handicapa	Singular
tondu	None
turner	None
édita	Singular
acquéraient	Plural
escherroiz	Plural
filtraient	Plural
déclaraient	Plural
procréer	None
orienta	Singular
dessina	Singular
contribua	Singular
assisse	Singular
hésiterait	Singular
expédiait	Singular
refoulé	None
éclipsa	Singular
envenimé	None
nitreront	Plural
chansonné	None
rencontrerait	Singular
cantonnèrent	Plural
remâchasse	Singular
cèderait	Singular
coexista	Singular
douaient	Plural
jugerait	Singular
aborderai	Singular
concorderait	Singular
commas	Singular
décillasses	Singular
happant	None
chercheraient	Plural
agrippé	None
descolorer	None
transmissions	Plural
suivras	Singular
regnier	None
ghettoïsant	None
naquît	Singular
découcher	None
traduisant	None
languissait	Singular
remplaceront	Plural
péleriné	None
affrontasse	Singular
gouacha	Singular
étuver	None
entretint	Singular
obligeât	Singular
inféodèrent	Plural
tombât	Singular
relisait	Singular
aparlas	Singular
entrai	Singular
jutas	Singular
répliquaient	Plural
dépêchait	Singular
capé	None
inauguré	None
mimant	None
caoutchoutant	None
décoré	None
repoussait	Singular
produira	Singular
avantagea	Singular
homicidaient	Plural
missent	Plural
clouté	None
oublièrent	Plural
refusera	Singular
festoyé	None
remplissaient	Plural
clignotant	None
tolérait	Singular
imputa	Singular
desçandoies	Singular
désapprouvèrent	Plural
étatisé	None
excuseras	Singular
partiras	Singular
déféra	Singular
rétablirent	Plural
vivrai	Singular
optèrent	Plural
appréciera	Singular
viabilisé	None
replantaient	Plural
boycottait	Singular
affalassent	Plural
remplir	None
interviewas	Singular
invitai	Singular
abonner	None
crosta	Singular
couvaient	Plural
consommeraient	Plural
creuseront	Plural
préleva	Singular
égorgeait	Singular
alléger	None
rompaient	Plural
rassembla	Singular
oignisse	Singular
dégradait	Singular
évangéliser	None
ramposniiens	Plural
axa	Singular
défait	Singular
débauchant	None
attribuât	Singular
conduire	None
courtisait	Singular
exacerba	Singular
marchait	Singular
numérisé	None
agonirait	Singular
christianiser	None
prédestiné	None
focalisèrent	Plural
défrichait	Singular
baller	None
prouverai	Singular
fornissant	None
solubilisé	None
profitera	Singular
freinerait	Singular
figurèrent	Plural
essoufflera	Singular
informerait	Singular
canta	Singular
fouissant	None
allièrent	Plural
dégréer	None
popularisèrent	Plural
gaffa	Singular
césariseriez	Plural
glander	None
recuises	Singular
grossirent	Plural
commercialisèrent	Plural
dessillant	None
passionnait	Singular
décèderont	Plural
élu	None
marina	Singular
démaquillaient	Plural
dispersera	Singular
acidulé	None
régaler	None
lysant	None
commandaient	Plural
distribua	Singular
anhardirent	Plural
enrayeriez	Plural
engraissant	None
achetant	None
grainé	None
limogeant	None
employèrent	Plural
esposa	Singular
semblait	Singular
méconnaît	Singular
cirera	Singular
mesurerait	Singular
payerait	Singular
résideront	Plural
rétrécira	Singular
recelé	None
retendrions	Plural
recentrait	Singular
canonisassent	Plural
apprendras	Singular
semblerait	Singular
ouvra	Singular
gourer	None
graisser	None
éternueraient	Plural
fessait	Singular
valorisait	Singular
préviendrai	Singular
décidaient	Plural
touz	Singular
barbera	Singular
orchestrera	Singular
coûterait	Singular
afficheront	Plural
fonctionnèrent	Plural
interpoler	None
refluer	None
confier	None
granulé	None
délacer	None
ravitaillaient	Plural
fuies	Singular
sanctionnant	None
frapper	None
pasteuriserions	Plural
corsa	Singular
grillaient	Plural
déverseront	Plural
faufila	Singular
comptera	Singular
infligera	Singular
décriant	None
désinvestirai	Singular
fricassé	None
désapprouvaient	Plural
gagnerons	Plural
député	None
ard	Singular
construisant	None
commémorassiez	Plural
reculèrent	Plural
embrassa	Singular
accentuera	Singular
flourirent	Plural
chapeautait	Singular
commercialisant	None
étalerait	Singular
taguasses	Singular
contretenissent	Plural
bouffer	None
regarderez	Plural
biper	None
coexistaient	Plural
prêchait	Singular
ému	None
foler	None
dégrossirai	Singular
débarrassera	Singular
écroulera	Singular
sût	Singular
misaient	Plural
initialiser	None
répertorierait	Singular
emprunteront	Plural
affirmerait	Singular
improvisa	Singular
adviendrait	Singular
régissaient	Plural
astiquer	None
ripèrent	Plural
caractérisaient	Plural
escortera	Singular
emprunta	Singular
résolvant	None
lubrifiant	None
déminer	None
poserait	Singular
perdras	Singular
grimpa	Singular
produit	Singular
atochoit	Singular
reverraient	Plural
gâter	None
récurer	None
déferlait	Singular
apparentera	Singular
franchira	Singular
appréhenda	Singular
clarifiant	None
diviseront	Plural
foulera	Singular
dolera	Singular
scellait	Singular
assemblera	Singular
mensongié	None
creuser	None
espéra	Singular
cibla	Singular
coudé	None
dévoilaient	Plural
obliant	None
coucherait	Singular
redoublerons	Plural
contresigner	None
brunissant	None
graantant	None
violas	Singular
traquaient	Plural
préciserait	Singular
désirerait	Singular
déréglant	None
tornerai	Singular
pollinisé	None
brisaient	Plural
confectionnaient	Plural
puisèrent	Plural
emballa	Singular
regna	Singular
excogité	None
hissa	Singular
obtiendras	Singular
stocka	Singular
abonné	None
remît	Singular
stabiliserez	Plural
dérangerait	Singular
coïncidera	Singular
éradiqua	Singular
pendillé	None
esbatroie	Singular
dégoudronnassiez	Plural
pelletisâmes	Plural
préciserions	Plural
introduisait	Singular
vérifierai	Singular
ficelant	None
embouassent	Plural
tracassé	None
dessaisissant	None
ensuivant	None
tabula	Singular
convoiteras	Singular
déplacerai	Singular
fis	Singular
réussir	None
arouser	None
influeront	Plural
joindrai	Singular
codirigea	Singular
sema	Singular
consentir	None
bouillonnant	None
trouveriez	Plural
faust	Singular
installait	Singular
radouci	None
tracer	None
ferrer	None
déroulaient	Plural
photographiant	None
étudiassions	Plural
ajoutèrent	Plural
ornèrent	Plural
résonnant	None
fêtaient	Plural
refait	Singular
murissent	Plural
succèderont	Plural
enorgueillissaient	Plural
lustra	Singular
embrasèrent	Plural
sentait	Singular
érigea	Singular
évertué	None
recenserait	Singular
lexicaliser	None
réoccupèrent	Plural
rétabliront	Plural
activait	Singular
savaient	Plural
gauja	Singular
instilleront	Plural
luttant	None
embelli	None
tranchèrent	Plural
livrerions	Plural
équipant	None
éclaboussant	None
troublerait	Singular
dempnames	Plural
consentît	Singular
mentionné	None
échoueront	Plural
forferiiez	Plural
métamorphisèrent	Plural
adioustant	None
verbalisé	None
domestiquant	None
détendre	None
accréditerait	Singular
uniformisant	None
nargué	None
initiaient	Plural
couronnèrent	Plural
éviterez	Plural
recruteront	Plural
reconcentré	None
espaçant	None
butiner	None
repêcherions	Plural
enveloppassions	Plural
apostrophant	None
plantaient	Plural
coopéra	Singular
affermi	None
radioactivé	None
révisèrent	Plural
incombera	Singular
utilisa	Singular
embarquaient	Plural
publiait	Singular
trôneriez	Plural
rencontrât	Singular
remplacèrent	Plural
rançonnait	Singular
déduirait	Singular
peinaient	Plural
œuvra	Singular
calomniassent	Plural
kidnappé	None
revérifierons	Plural
compliquaient	Plural
prédéfini	None
outrerai	Singular
évincera	Singular
vaquant	None
raconta	Singular
adot	Singular
pyrolyser	None
italianisâmes	Plural
pasant	None
escapa	Singular
désintéressé	None
sauvegarda	Singular
rappela	Singular
pondra	Singular
resserrait	Singular
vrombir	None
metre	None
convoitait	Singular
cimenter	None
inventa	Singular
lésait	Singular
dissout	Singular
rompt	Singular
désaliniser	None
réabsorberions	Plural
imposassiez	Plural
colorisé	None
foudroyé	None
doctrina	Singular
dompta	Singular
acquiescèrent	Plural
popularisé	None
amenuiser	None
insurger	None
confortait	Singular
légitima	Singular
emmena	Singular
comparant	None
établirait	Singular
remémoraient	Plural
enchanté	None
divinisé	None
baliserez	Plural
chansonnerions	Plural
poissant	None
échappait	Singular
cuntredire	None
aggravera	Singular
frappera	Singular
complémentant	None
déclinera	Singular
fêtera	Singular
atalanta	Singular
vampiriser	None
attirant	None
décrire	None
souciait	Singular
acquérant	None
china	Singular
déçoit	Singular
retranchèrent	Plural
ravitaillait	Singular
pillait	Singular
informer	None
resplendissant	None
accordait	Singular
mitigé	None
compulser	None
protègeront	Plural
dénichèrent	Plural
utilisera	Singular
cocufiai	Singular
ajourné	None
contre-attaqué	None
escaufassent	Plural
raréfièrent	Plural
aprovendant	None
confectionnait	Singular
sonnèrent	Plural
contrediraient	Plural
affaiblira	Singular
butteras	Singular
monda	Singular
reposèrent	Plural
prénomma	Singular
bastonner	None
agreé	None
attrapèrent	Plural
aveuglé	None
apprécia	Singular
privatiser	None
éliminèrent	Plural
augmenta	Singular
méritait	Singular
enclencha	Singular
aérant	None
perpétraient	Plural
potentialisé	None
assimilait	Singular
diffusassent	Plural
connoissant	None
inonda	Singular
ferrailler	None
tricher	None
mangeroiz	Plural
réfèrera	Singular
retournait	Singular
démembrera	Singular
exprimeront	Plural
stoppera	Singular
répliquèrent	Plural
forcèrent	Plural
recopierai	Singular
prétend	Singular
émet	Singular
aicher	None
rogna	Singular
décideraient	Plural
localisa	Singular
évita	Singular
diminuèrent	Plural
balisaient	Plural
atuché	None
mendiâmes	Plural
reproduiraient	Plural
augmentera	Singular
isolèrent	Plural
éditorialisassiez	Plural
pillèrent	Plural
distanciant	None
mordit	Singular
opterai	Singular
dureraient	Plural
engrangea	Singular
reniflassions	Plural
sala	Singular
participerai	Singular
biscuitant	None
décèlera	Singular
braqua	Singular
réunifié	None
réquisitionnaient	Plural
controversant	None
blettir	None
accepteraient	Plural
bâcher	None
rallierait	Singular
essouffler	None
rugi	None
fusillait	Singular
réfugièrent	Plural
parlèrent	Plural
vibré	None
parachevasses	Singular
répètera	Singular
pillier	None
occasionnèrent	Plural
vendre	None
prêtera	Singular
draché	None
calmerait	Singular
envaser	None
refermèrent	Plural
attesteraient	Plural
fatiguera	Singular
démissionnait	Singular
tût	Singular
fouirait	Singular
ouvrit	Singular
doulant	None
imbriquant	None
remplaçât	Singular
confondit	Singular
fes	Singular
répétaient	Plural
libéraient	Plural
repayer	None
masturbait	Singular
gitât	Singular
légendé	None
touchier	None
emportaient	Plural
neutralisait	Singular
aigrit	Singular
lotir	None
alliait	Singular
jetaient	Plural
comptabilisa	Singular
écoulait	Singular
encadrâmes	Plural
déplumé	None
trempa	Singular
interviendrait	Singular
végéter	None
obstruer	None
traversèrent	Plural
visiteront	Plural
défonça	Singular
ressaisir	None
répétait	Singular
éclairer	None
obtiendraient	Plural
ingèreras	Singular
exigèrent	Plural
déboulonner	None
méthylé	None
lavera	Singular
réislamiser	None
oublia	Singular
knockoutasse	Singular
abîma	Singular
infecta	Singular
apporteraient	Plural
usèrent	Plural
assurera	Singular
rigolé	None
tricoté	None
crapissons	Plural
poissé	None
finaliser	None
amenuisant	None
sédimenter	None
paralyser	None
infligea	Singular
provoqué	None
évacuait	Singular
professèrent	Plural
égorgèrent	Plural
apocopa	Singular
souillassiez	Plural
épilant	None
partit	Singular
concerné	None
penché	None
humera	Singular
distingua	Singular
railla	Singular
préférèrent	Plural
contacterai	Singular
déprécia	Singular
costas	Singular
detranchié	None
cartographier	None
élucubrer	None
fabriquaient	Plural
endeuilla	Singular
encroistroiz	Plural
précisait	Singular
congeler	None
évolua	Singular
mobilisera	Singular
rééquilibrant	None
revigorer	None
scindera	Singular
préconisèrent	Plural
mâchant	None
intercepta	Singular
corsant	None
rapprochaient	Plural
démarrer	None
pillé	None
regroupassions	Plural
calculé	None
cloua	Singular
sassa	Singular
revint	Singular
aidèrent	Plural
organiseraient	Plural
établiraient	Plural
empaumé	None
quieres	Singular
acèrera	Singular
attaqueront	Plural
dévorait	Singular
cosignera	Singular
pelas	Singular
enverraient	Plural
compasser	None
récrié	None
publierons	Plural
motorisant	None
essarterai	Singular
positionné	None
maniait	Singular
stabilisa	Singular
traitté	None
natté	None
bouclerait	Singular
jaugé	None
débarqueront	Plural
exercèrent	Plural
doblas	Singular
exécuta	Singular
décroissant	None
nijastes	Plural
mécroire	None
jasa	Singular
aillas	Singular
ressentaient	Plural
pratiqué	None
suppurèrent	Plural
élança	Singular
réfuté	None
sponsorisa	Singular
discrétisassiez	Plural
éduquer	None
insupporter	None
absorba	Singular
contribuerai	Singular
séduiront	Plural
balança	Singular
débarqua	Singular
saluèrent	Plural
tutoyé	None
transcendant	None
forcer	None
défendît	Singular
valasse	Singular
oblitérer	None
sinisé	None
fusai	Singular
épaulé	None
surpayant	None
rémunérâmes	Plural
administrera	Singular
annotant	None
magouillé	None
disjoint	Singular
reservas	Singular
ardit	Singular
écumèrent	Plural
corsetassent	Plural
déciderait	Singular
choisiront	Plural
industrialisa	Singular
fusionneraient	Plural
annulé	None
aliénèrent	Plural
insensibilisera	Singular
ratait	Singular
climatiser	None
migra	Singular
aymast	Singular
inspireront	Plural
soupesas	Singular
amenant	None
immola	Singular
comptabilisaient	Plural
protestera	Singular
démissionna	Singular
alourdirait	Singular
oppressé	None
comparera	Singular
commuant	None
violeront	Plural
condescendant	None
encaissa	Singular
encerclait	Singular
violaient	Plural
perpétueront	Plural
repoussaient	Plural
défia	Singular
ajoutera	Singular
craint	Singular
débarrassa	Singular
soulignerait	Singular
popularisa	Singular
correspondaient	Plural
doctrinassent	Plural
caces	Singular
deviendraient	Plural
avertissait	Singular
ébouté	None
encrassé	None
glorifiât	Singular
bruma	Singular
coisié	None
diversifièrent	Plural
orbitaient	Plural
archaïsas	Singular
antidata	Singular
remplirai	Singular
livra	Singular
divergea	Singular
remplissait	Singular
engourdir	None
tâcherons	Plural
analysaient	Plural
déversé	None
ganser	None
asséchant	None
corrigeront	Plural
radoucir	None
imputèrent	Plural
disperseront	Plural
minimisant	None
cumulait	Singular
redoubtant	None
siégeait	Singular
écopa	Singular
exsudera	Singular
récusa	Singular
meulant	None
racketté	None
profanant	None
réapparaîtra	Singular
conformeraient	Plural
identifieraient	Plural
lyas	Singular
flambait	Singular
manifesterons	Plural
comprendrai	Singular
bruisserez	Plural
capitalisant	None
décommandas	Singular
récupérèrent	Plural
reprendraient	Plural
alléguait	Singular
brochier	None
adjurant	None
fana	Singular
contraindra	Singular
excaver	None
caboter	None
exclamassiez	Plural
repunir	None
rattacherait	Singular
télédiffusé	None
enchatonneras	Singular
embarquait	Singular
versèrent	Plural
accueillit	Singular
fédérait	Singular
profiterai	Singular
modifieraient	Plural
maquillerez	Plural
surveillait	Singular
continuerez	Plural
popularisait	Singular
renverserait	Singular
représentât	Singular
twista	Singular
updater	None
abala	Singular
approprieront	Plural
pila	Singular
fixa	Singular
formaliserai	Singular
dépassaient	Plural
réchauffait	Singular
resguardé	None
massera	Singular
boire	None
honoraient	Plural
commandant	None
hiverné	None
bees	Singular
nouma	Singular
relit	Singular
coagulai	Singular
émoustillé	None
ulcérer	None
reflua	Singular
blessaient	Plural
démantela	Singular
voulurent	Plural
concentreraient	Plural
connaitriez	Plural
arrisa	Singular
teignaient	Plural
peuplèrent	Plural
catcheriez	Plural
cuidé	None
tatoueront	Plural
environné	None
robbé	None
maté	None
bousculant	None
combattrai	Singular
envasé	None
méritas	Singular
destrosseroit	Singular
barreras	Singular
mattâtes	Plural
exila	Singular
dégraderont	Plural
surfa	Singular
enculasse	Singular
épousaient	Plural
depeschant	None
pognant	None
demustrant	None
reparla	Singular
symbolisaient	Plural
retouchait	Singular
sanctifier	None
coïncider	None
sollicitant	None
redescendront	Plural
débrouillera	Singular
commençaient	Plural
supposera	Singular
jacasser	None
charmé	None
détricoté	None
trahi	None
critiqueront	Plural
airai	Singular
declairer	None
morras	Singular
carroyant	None
interconnectant	None
défié	None
acquittera	Singular
fichasse	Singular
appartiendront	Plural
prévalez	Plural
reluirez	Plural
sympathiserez	Plural
razzié	None
témoigneraient	Plural
gémissant	None
recollant	None
rétablissait	Singular
fissionner	None
sous-classeraient	Plural
razzia	Singular
forcera	Singular
relèveraient	Plural
inclina	Singular
remuait	Singular
hérissé	None
cavalcadassent	Plural
manja	Singular
déposerai	Singular
affectait	Singular
pulvérisa	Singular
scalpâmes	Plural
bouchonneraient	Plural
progressera	Singular
gonflaient	Plural
induira	Singular
fustigeait	Singular
complémenter	None
subtiliseriez	Plural
excluait	Singular
resta	Singular
feintant	None
traduiriez	Plural
nias	Singular
vaquera	Singular
élargissaient	Plural
retrouverait	Singular
sautai	Singular
apprécierai	Singular
concevra	Singular
éructant	None
étripé	None
rodé	None
inaugureront	Plural
entracordames	Plural
baréter	None
commettrait	Singular
désactiva	Singular
cuider	None
déjugé	None
acquirent	Plural
accouchant	None
décapé	None
planera	Singular
blasonnait	Singular
ravina	Singular
concaténé	None
copiloté	None
attestâtes	Plural
engamassions	Plural
lovera	Singular
plorissoiz	Plural
confieront	Plural
intéresserait	Singular
lancina	Singular
troveriiens	Plural
concédé	None
souscrivisse	Singular
accepterai	Singular
germé	None
requinquâtes	Plural
entraîneraient	Plural
tapissaient	Plural
caractérisait	Singular
ratonnaient	Plural
utilisât	Singular
augmenterai	Singular
simplifiant	None
écorchant	None
abuser	None
compliquerait	Singular
répondra	Singular
frotassent	Plural
traduirait	Singular
arrangèrent	Plural
tartiner	None
pressèrent	Plural
entamer	None
boisa	Singular
amena	Singular
gauchissant	None
recyclait	Singular
descendrai	Singular
démarqué	None
permettant	None
anunçant	None
redescendu	None
déclenchaient	Plural
construit	Singular
décomposaient	Plural
medecines	Singular
subiuguié	None
communiqua	Singular
recourberaient	Plural
avoisinerait	Singular
essaieront	Plural
compiler	None
camouflant	None
passionnèrent	Plural
retrouveront	Plural
partiront	Plural
méprend	Singular
musas	Singular
ubérisant	None
rasant	None
postulait	Singular
réfugié	None
arriverai	Singular
soupait	Singular
maniera	Singular
réconcilièrent	Plural
industrialisant	None
barbelant	None
dinas	Singular
échafauda	Singular
vérifiaient	Plural
melles	Singular
résuma	Singular
empâté	None
fanfrelucher	None
diminuera	Singular
équivaut	Singular
sanblassent	Plural
désolidarisa	Singular
galant	None
déseuropéaniser	None
bénéficiant	None
surmontaient	Plural
flairé	None
skateriez	Plural
obscurcissant	None
creusera	Singular
reprennes	Singular
napperons	Plural
inhabité	None
réorchestré	None
rebukissons	Plural
abrogea	Singular
broma	Singular
déroula	Singular
cultivaient	Plural
balla	Singular
mentionnait	Singular
prématuré	None
renversaient	Plural
énerva	Singular
éduquerait	Singular
fixaient	Plural
mutera	Singular
figurera	Singular
approvisionnèrent	Plural
tastant	None
seiournerons	Plural
émergea	Singular
effrayait	Singular
sniffé	None
aspira	Singular
exulter	None
franchi	None
profitaient	Plural
démenait	Singular
liasse	Singular
décimèrent	Plural
obérant	None
transmettront	Plural
respitiiez	Plural
masculinisai	Singular
réécrit	Singular
dimérisas	Singular
fricotait	Singular
étayeraient	Plural
quémandant	None
jugeriez	Plural
bombardera	Singular
craquer	None
ambitionnait	Singular
sanctionnera	Singular
laisseraient	Plural
complotera	Singular
murant	None
continuer	None
égaraient	Plural
reconstruisait	Singular
référait	Singular
remonteront	Plural
sohaidier	None
reconduit	Singular
conseillé	None
renomma	Singular
survolant	None
babit	Singular
huiler	None
chouchouté	None
échelonnant	None
nait	Singular
induisirent	Plural
paraîtra	Singular
permutant	None
acosta	Singular
dégoutter	None
voueront	Plural
vrillant	None
plaisant	None
aseptisé	None
guaaignant	None
défrayèrent	Plural
prononçaient	Plural
évangélisaient	Plural
lassera	Singular
edifier	None
canadianiserions	Plural
toussotant	None
gênas	Singular
espiasse	Singular
accoster	None
diplômant	None
cumbatu	None
apparu	None
posai	Singular
entremettre	None
tolèrera	Singular
lotissant	None
intimidant	None
tuerait	Singular
puis	Singular
battissent	Plural
abordèrent	Plural
pérennisera	Singular
sonorisassent	Plural
déborderait	Singular
aimanter	None
dupant	None
entama	Singular
colonisa	Singular
promeṣissoiz	Plural
chemisaient	Plural
redécouvrit	Singular
herboriser	None
écloront	Plural
personnifiâmes	Plural
recourt	Singular
choyé	None
végéta	Singular
subsumé	None
camoufler	None
fredonnait	Singular
parolas	Singular
augmenteraient	Plural
embauchera	Singular
autodissout	Singular
participait	Singular
renforcissait	Singular
totalisaient	Plural
lesché	None
attardait	Singular
complexâmes	Plural
pagina	Singular
bossé	None
crier	None
déguisait	Singular
remédier	None
fabriqua	Singular
signalaient	Plural
sédimenté	None
descouchant	None
endotriné	None
chiffrerait	Singular
référençait	Singular
tabulas	Singular
déparé	None
décidera	Singular
ébahi	None
écimassent	Plural
commirent	Plural
moyennèrent	Plural
nationalisant	None
dépêchèrent	Plural
baladâtes	Plural
drilla	Singular
diligenta	Singular
esmaieriiez	Plural
transparaître	None
coniecturions	Plural
sait	Singular
ennuya	Singular
aisa	Singular
nuiraient	Plural
prohibaient	Plural
prescrivait	Singular
draina	Singular
redéployé	None
dénombra	Singular
réarmant	None
séparera	Singular
condamnaient	Plural
assureraient	Plural
infectaient	Plural
défaire	None
protégèrent	Plural
câblai	Singular
personnifié	None
totaliseront	Plural
quittaient	Plural
dégroupé	None
surfé	None
transformait	Singular
renfermé	None
instruisait	Singular
appuyait	Singular
canner	None
gagneront	Plural
désignèrent	Plural
éboutasse	Singular
dynamisant	None
justa	Singular
réjouiront	Plural
consommerait	Singular
mentionnèrent	Plural
reparlerons	Plural
dardant	None
arrivé	None
accréditeraient	Plural
plaissié	None
rediffusait	Singular
joindront	Plural
affina	Singular
reiectiez	Plural
nia	Singular
boucané	None
engloba	Singular
frima	Singular
discréditèrent	Plural
missions	Plural
basculant	None
starisâtes	Plural
purgea	Singular
purgeait	Singular
détrempé	None
fournît	Singular
respecteraient	Plural
fusse	Singular
tassera	Singular
sautant	None
countrefaz	Singular
retentira	Singular
chavirassions	Plural
excusait	Singular
plumas	Singular
appropriaient	Plural
signifiaient	Plural
tisonnâmes	Plural
motivaient	Plural
bénissait	Singular
mutualiser	None
épilasses	Singular
rétrocéda	Singular
éluder	None
remédiera	Singular
croisèrent	Plural
brada	Singular
amalgama	Singular
bachoté	None
boudina	Singular
réutiliser	None
réfugiera	Singular
ensaigneroies	Singular
ressentirent	Plural
susurrai	Singular
durerait	Singular
aventurera	Singular
remontant	None
remarchera	Singular
rendort	Singular
solubilisant	None
désinscrirai	Singular
rabrouai	Singular
dîmes	Plural
longèrent	Plural
dépassé	None
daterait	Singular
embauché	None
rechignait	Singular
pratiqueraient	Plural
coûteront	Plural
alternera	Singular
esra	Singular
dispensait	Singular
discouru	None
pressureriez	Plural
gerbasse	Singular
figerait	Singular
matricé	None
enrichissaient	Plural
observait	Singular
déshydraterait	Singular
gamahuchant	None
gous	Singular
initieront	Plural
élaguant	None
assoilé	None
vagabonder	None
rutila	Singular
défendaient	Plural
déjeûnerons	Plural
abet	Singular
kératinisé	None
parcourrait	Singular
ébauchait	Singular
sacras	Singular
recoloniser	None
rédigerait	Singular
étageant	None
incurveras	Singular
déléguaient	Plural
otreier	None
ravagera	Singular
gifla	Singular
mesclassions	Plural
secourait	Singular
surfèrent	Plural
délimitant	None
esmas	Singular
radiostériliserai	Singular
soumettraient	Plural
gravissait	Singular
annexer	None
débarqué	None
turnera	Singular
dégonfler	None
entameront	Plural
retravailler	None
enrichiront	Plural
enduisait	Singular
pariant	None
grapa	Singular
pleurant	None
scintillaient	Plural
loupa	Singular
ébauché	None
remercia	Singular
buriné	None
avancèrent	Plural
sembleraient	Plural
réceptionnait	Singular
entraînera	Singular
emménagea	Singular
solutionnait	Singular
défibrillant	None
façoné	None
envouté	None
compenseront	Plural
slalomer	None
pleurnichas	Singular
fatigué	None
ébrécher	None
azureront	Plural
gaula	Singular
gommant	None
sacrifièrent	Plural
lièrent	Plural
divisèrent	Plural
valorisa	Singular
deut	Singular
légitimèrent	Plural
barra	Singular
pleurerions	Plural
quester	None
associé	None
immisça	Singular
collabora	Singular
interféra	Singular
standardisant	None
moulerez	Plural
zigzaguaient	Plural
sones	Singular
préfigurait	Singular
enlacé	None
prononcer	None
heurterait	Singular
peignit	Singular
pissant	None
articulé	None
afit	Singular
repeupler	None
deslicier	None
ajointé	None
dénommait	Singular
allégeait	Singular
douât	Singular
arangerai	Singular
scandalisait	Singular
sécurisait	Singular
estincellé	None
étonneront	Plural
alis	Singular
nébuliseriez	Plural
bousculait	Singular
rehaussa	Singular
louchant	None
pluchant	None
oultrageasse	Singular
coexistant	None
changeront	Plural
dérivant	None
hésita	Singular
taggé	None
établissaient	Plural
répugnait	Singular
langé	None
cheminas	Singular
entacherai	Singular
préservèrent	Plural
vivre	None
routé	None
desservir	None
demanderai	Singular
souhaitai	Singular
herborisé	None
dédramatiserez	Plural
tenter	None
siphonneras	Singular
gèrera	Singular
assavant	None
aventurèrent	Plural
influenceront	Plural
délimiter	None
travailler	None
entassé	None
justifia	Singular
développé	None
fricasser	None
rehausser	None
bougeait	Singular
développeront	Plural
quitter	None
conclurent	Plural
renfermera	Singular
angenrastes	Plural
skié	None
mériterait	Singular
concrétiseront	Plural
rehaussait	Singular
enfantera	Singular
échancré	None
examinerai	Singular
emmurer	None
téléverserai	Singular
complèterai	Singular
cannibalisèrent	Plural
enrégimentai	Singular
débouta	Singular
détestant	None
allumaient	Plural
reflété	None
aluns	Singular
humecté	None
confinant	None
bottas	Singular
démarquèrent	Plural
étalonnassiez	Plural
influa	Singular
habiterait	Singular
escat	Singular
automatisé	None
organisa	Singular
percuta	Singular
convergera	Singular
attisant	None
escartasmes	Plural
retrouvera	Singular
delaisseroies	Singular
mondialisé	None
francisé	None
dément	Singular
impliqué	None
velcrotasse	Singular
objectivé	None
assumeront	Plural
sourisse	Singular
chapeauter	None
éberluer	None
rotasses	Singular
signalera	Singular
conjecturer	None
renchérit	Singular
cernaient	Plural
débuterait	Singular
orné	None
christianisât	Singular
effrita	Singular
remarqua	Singular
enfermé	None
regonfler	None
manquerez	Plural
escherriiez	Plural
tortillas	Singular
concourant	None
extrayant	None
cryassions	Plural
userai	Singular
attarderai	Singular
émuleras	Singular
composèrent	Plural
inondera	Singular
incitant	None
admirèrent	Plural
assombrirai	Singular
dédiera	Singular
écrasera	Singular
infligeront	Plural
protégeassions	Plural
trouvèrent	Plural
atteindraient	Plural
rejetait	Singular
vaironné	None
rafraîchir	None
évoqueraient	Plural
redonnait	Singular
échut	Singular
illustrerait	Singular
edifiera	Singular
approvisionnaient	Plural
rempiler	None
cosigné	None
déportassent	Plural
recharger	None
surchargeraient	Plural
effondrerait	Singular
soumissionné	None
éparpillant	None
controversé	None
regarderaient	Plural
forant	None
deraisnoit	Singular
détaillera	Singular
contint	Singular
sonnâtes	Plural
bordant	None
lovait	Singular
délogeant	None
gronda	Singular
fermèrent	Plural
enfoncèrent	Plural
baisseront	Plural
nazifier	None
touffait	Singular
injuria	Singular
amarrait	Singular
tapagé	None
accusera	Singular
candi	None
fondit	Singular
sureschauffé	None
participa	Singular
convoler	None
évitaient	Plural
grossira	Singular
ghettoïsai	Singular
délasser	None
reconvertissant	None
grima	Singular
allongèrent	Plural
gangrénâtes	Plural
dévaloriser	None
aparoler	None
torréfier	None
examinerons	Plural
preferer	None
flottera	Singular
plantèrent	Plural
acculant	None
tarjant	None
décrieraient	Plural
oindra	Singular
inclues	Singular
luxasses	Singular
transposé	None
allierait	Singular
déshumanisé	None
vécurent	Plural
escaladait	Singular
enracinas	Singular
coisas	Singular
barrèrent	Plural
ozona	Singular
jaugeait	Singular
éclaboussa	Singular
badigeonner	None
renait	Singular
conféraient	Plural
encasernerai	Singular
fractionnant	None
égrainerions	Plural
justifiant	None
facturait	Singular
teignes	Singular
offrit	Singular
révisé	None
procédaient	Plural
convaincrait	Singular
ruinera	Singular
remariera	Singular
entêté	None
débarquait	Singular
appuieraient	Plural
retâterai	Singular
concaténa	Singular
éclaira	Singular
trouvait	Singular
battrait	Singular
musse	Singular
affuter	None
cautionnâmes	Plural
demandait	Singular
adoreras	Singular
récupéré	None
appelleraient	Plural
engenroie	Singular
glapiras	Singular
regardèrent	Plural
multiplierait	Singular
bafouiller	None
approvisionna	Singular
apparaissait	Singular
décornasse	Singular
sachez	Plural
surmonté	None
cadraient	Plural
aboutirent	Plural
planas	Singular
influai	Singular
décalquant	None
zapa	Singular
acoardiront	Plural
couderait	Singular
appâter	None
triturant	None
immergea	Singular
viela	Singular
bizutant	None
déclasser	None
prima	Singular
gouvernant	None
enclinasse	Singular
germanisât	Singular
prophetizeroient	Plural
traversaient	Plural
débaucher	None
adirer	None
jouiraient	Plural
fixant	None
fournira	Singular
salua	Singular
modelant	None
grevaient	Plural
ravitailla	Singular
glorifié	None
notifiera	Singular
gît	Singular
glaçait	Singular
quitterons	Plural
persuader	None
employaient	Plural
transformant	None
repoussèrent	Plural
prescrivirent	Plural
illustrera	Singular
soupa	Singular
réintégrait	Singular
convainc	Singular
stimulaient	Plural
assénant	None
partageât	Singular
nourri	None
mitonnât	Singular
réécrivisse	Singular
délirant	None
masser	None
perçâmes	Plural
projettera	Singular
nucléariseras	Singular
brassant	None
bailleras	Singular
répondrai	Singular
soudait	Singular
anathématiser	None
protestant	None
lias	Singular
engendra	Singular
usurpa	Singular
dédicaças	Singular
començant	None
appartînt	Singular
évincé	None
alliaient	Plural
géré	None
dérogea	Singular
publiera	Singular
permettraient	Plural
visas	Singular
poursuit	Singular
sonera	Singular
sévissant	None
frustra	Singular
couvait	Singular
blâmant	None
contribuera	Singular
sacrifiaient	Plural
relevassent	Plural
détendaient	Plural
capterait	Singular
tanas	Singular
