yuxtapuestos	Past
traicionadas	Past
reprimir	None
arredró	Past
listado	Past
lloraban	Past
cocían	Past
henchidos	Past
malinterpretada	Past
enmienda	Present
diezmar	None
reñida	Past
vares	Present
denigrada	Past
digité	Past
garbaran	Past
atormentaron	Past
rumoreabais	Past
dudarán	Future
restriega	Present
alternaría	None
conculcado	Past
alternará	Future
obnubilado	Past
lonchearían	None
inmovilizad	None
dimensionar	None
diputaréis	Future
encarcelados	Past
usábamos	Past
combinó	Past
boxear	None
desnivelar	None
gimoteaban	Past
encasquillásemos	Past
asistirías	None
propuestos	Past
materializar	None
traslaparen	Future
impusieron	Past
leudar	None
jabonad	None
camelo	Present
finalizarán	Future
vociferar	None
repondríamos	None
anegada	Past
concitaron	Past
rifé	Past
ardiendo	Present
forjaría	None
pernoctó	Past
imaginar	None
atesasteis	Past
entramen	Present
desquitadas	Past
aprisionar	None
canonizados	Past
tendería	None
regañada	Past
despiojarais	Past
engrillasen	Past
ingirieron	Past
petar	None
rentadas	Past
compendiar	None
filmado	Past
manufacturas	Present
profundizas	Present
embarazados	Past
curvadas	Past
desarropasteis	Past
eliminas	Present
enderezado	Past
sedimenten	Present
capturarían	None
capitulo	Present
esforzados	Past
complementarían	None
menea	Present
resolveríais	None
anochece	Present
pilotearíamos	None
agradar	None
destrozasteis	Past
desdeñó	Past
aterrorizar	None
aterrizaron	Past
creído	Past
cremar	None
ionizasen	Past
flexionada	Past
derroca	Present
entrecomilladas	Past
chicha	Present
interfieren	Present
hipotecas	Present
superponían	Past
engulló	Past
interceden	Present
aderezaron	Past
demonizar	None
patrullan	Present
estudiados	Past
adarvad	None
alijaró	Past
transpiran	Present
acaireláremos	Future
colaborarán	Future
derrumbadas	Past
desmaquillarían	None
iniciáramos	Past
construyamos	Present
zozobró	Past
adocenéis	Present
permanecerán	Future
joder	None
contrastan	Present
esparcieran	Past
convalidados	Past
atravesó	Past
vámonos	None
encuartelasteis	Past
caligrafías	Present
presiento	Present
lograrían	None
zuzáis	Present
realinearan	Past
resucitarán	Future
recalcado	Past
efectuó	Past
desocupó	Past
reingresaste	Past
inducidas	Past
diremos	Future
advirtieron	Past
taladraban	Past
fagocitadas	Past
habito	Present
confrontaban	Past
juzgaría	None
encendiendo	Present
suceder	None
compensaría	None
ajusticiar	None
gorgoteábamos	Past
presentar	None
molina	Present
empanada	Past
reservas	Present
dora	Present
simular	None
saludan	Present
concentraron	Past
reabren	Present
desembrujaban	Past
resolvería	None
participaremos	Future
adjudicado	Past
prolongaría	None
citan	Present
interrelacionar	None
adueñaran	Past
apartaría	None
vibrarais	Past
configurando	Present
negociada	Past
reflota	Present
aparto	Present
abulta	Present
exaltó	Past
capea	Present
acelerado	Past
discutirían	None
decolorada	Past
afianzábamos	Past
complicarías	None
reconstruyeran	Past
jerarquizó	Past
paseados	Past
alargó	Past
dejaban	Past
triturada	Past
trivializabas	Past
sanado	Past
chorreadas	Past
internalizar	None
roer	None
batallado	Past
traquetearías	None
acuñaríamos	None
oíste	Past
rivalizaron	Past
enloquecer	None
fortificarás	Future
inyectabas	Past
pretendamos	Present
coordinaría	None
contrarrestados	Past
encarrilarías	None
entreoigo	Present
intentaré	Future
transgrediéramos	Past
reforzaría	None
incidir	None
desquiciar	None
cocina	Present
cristalizaría	None
editaré	Future
excusando	Present
apodar	None
encorvadas	Past
encontrábamos	Past
achacaron	Past
alojarse	None
transportada	Past
degradar	None
señalizarían	None
desplumaste	Past
relevar	None
reestructurar	None
sustraerá	Future
titilando	Present
desempeñaría	None
invalidando	Present
comportar	None
insufla	Present
encontraríamos	None
manufacturaron	Past
pretendí	Past
fíjese	None
estañaste	Past
adivinar	None
trabajar	None
desposaría	None
devastada	Past
desenredar	None
planchado	Past
intimidan	Present
azulejaríamos	None
muge	Present
reinsertar	None
abatió	Past
cristianizó	Past
humillabais	Past
arraigo	Present
yapa	Present
estriados	Past
rayé	Past
extingue	Present
engordó	Past
producir	None
vibráremos	Future
enteraban	Past
refrendado	Past
aluenguen	Present
despediría	None
contaminaren	Future
mecanizaríais	None
reducida	Past
enveneno	Present
enconchad	None
federalizar	None
corcovearía	None
prepagaren	Future
confrontado	Past
saltes	Present
retrotraes	Present
justificasen	Past
maldecido	Past
humanizar	None
poseído	Past
subdividir	None
retroalimentar	None
conseguiste	Past
custodia	Present
abastecieran	Past
controlando	Present
enseñaré	Future
desocuparon	Past
gané	Past
atestiguaban	Past
socarras	Present
estampas	Present
descodificar	None
sostenemos	Present
desarticular	None
trabajen	Present
interactuado	Past
encajaría	None
enseñar	None
agitan	Present
goleó	Past
danzado	Past
exhibiría	None
minimizaría	None
ignores	Present
extendida	Past
atuve	Past
gatillar	None
trucadas	Past
inutilizar	None
presiden	Present
designaríais	None
analiza	Present
conmines	Present
sufren	Present
reversaron	Past
repintarías	None
adjuntadas	Past
atardecer	None
postular	None
encontrarían	None
fresas	Present
surfear	None
esparce	Present
pregona	Present
contestaron	Past
anegar	None
mayen	Present
desternillaran	Past
apellidadas	Past
intensificásemos	Past
apurarais	Past
manipulo	Present
podremos	Future
mantearemos	Future
expedientado	Past
mangonearíais	None
solidarizaríais	None
contaminados	Past
aliviar	None
filtrar	None
variar	None
detectas	Present
suavizar	None
finabas	Past
regenteéis	Present
presentarían	None
soliviantemos	Present
recibiría	None
donen	Present
embaldosadas	Past
desearían	None
nota	Present
obsequiada	Past
contradicha	Past
ciarán	Future
instauraría	None
abjurar	None
responsabilizo	Present
penetraríais	None
recordarás	Future
encargarían	None
incorporados	Past
plastificada	Past
entrevistados	Past
rehagas	Present
invocaban	Past
adecuarías	None
demando	Present
florecieran	Past
desagrado	Present
discurrirá	Future
animaría	None
cementarían	None
eriza	Present
marginar	None
resumiría	None
pasen	Present
catalogar	None
destapar	None
puliereis	Future
pisará	Future
coreografió	Past
desorejado	Past
duplicaría	None
desordenar	None
aprenderían	None
parodió	Past
perturbados	Past
deslucida	Past
perito	Present
rivalizado	Past
comparadas	Past
observarían	None
menear	None
arriesgaban	Past
extiendan	Present
refugia	Present
referirse	None
espabilaríamos	None
trincharías	None
declararían	None
ensayando	Present
desheredar	None
competió	Past
soñar	None
inculcar	None
alinearía	None
ceden	Present
perviven	Present
vandalizar	None
realineáremos	Future
palmotearás	Future
posees	Present
balad	None
cuadruplicar	None
retractado	Past
refinar	None
colapsen	Present
flexionadas	Past
concluido	Past
centren	Present
proporcionaría	None
logremos	Present
alcancen	Present
botaremos	Future
promoviéremos	Future
conspirarais	Past
ayunar	None
tomarían	None
renombrada	Past
ajustases	Past
lograremos	Future
terminarás	Future
mandas	Present
oficien	Present
ir	None
filó	Past
rocen	Present
dilucidar	None
bacheáremos	Future
reinado	Past
posicionaban	Past
contradigáis	Present
emigrado	Past
enarbolaban	Past
turban	Present
remedió	Past
apañareis	Future
invaginada	Past
vislumbró	Past
comerciar	None
muras	Present
guionaríamos	None
calcinada	Past
instalaría	None
desjudicializarán	Future
irrespetares	Future
completasen	Past
esperaría	None
izando	Present
auspiciar	None
respondiesen	Past
llamaríamos	None
arponearía	None
compaginaría	None
juntaron	Past
arrogándose	Present
perjudicando	Present
asear	None
reformulado	Past
tejer	None
atasco	Present
voltear	None
topeté	Past
regañando	Present
frustrado	Past
factorizar	None
realizasen	Past
empastadas	Past
cosecharás	Future
recurrido	Past
acera	Present
enlaces	Present
desterrando	Present
asesiné	Past
ejercitados	Past
aclaraban	Past
hiñeres	Future
divertirse	None
desengancharemos	Future
masturbarse	None
accederían	None
haced	None
luchemos	Present
revisan	Present
asumes	Present
armados	Past
afinadas	Past
lechar	None
enchufada	Past
generaría	None
nublados	Past
casarían	None
cancelarían	None
arriesgaría	None
coprotagonizada	Past
robar	None
desamorticé	Past
habitará	Future
igualar	None
nixtamalicen	Present
amueblados	Past
destina	Present
facilita	Present
blocan	Present
expandió	Past
persistido	Past
olvidaré	Future
conmemorado	Past
devastar	None
prefiguró	Past
salvaguardados	Past
pastan	Present
aferraron	Past
acicatearías	None
traspasaría	None
interpretaron	Past
consolidaría	None
negligirás	Future
constipaste	Past
reconvino	Past
desmovilizadas	Past
alteren	Present
rebatidas	Past
detergerá	Future
satinaríais	None
testeo	Present
aforan	Present
instala	Present
fecharon	Past
patalear	None
jaleo	Present
sorprendían	Past
deplorar	None
reorganizaría	None
escarpado	Past
condensar	None
copiadas	Past
devorará	Future
reconcomeréis	Future
resucitaría	None
desistiría	None
estacaría	None
comprobaban	Past
masacra	Present
exculpar	None
adultera	Present
configurar	None
limpiad	None
deshielo	Present
sucumbir	None
alteradas	Past
dejaseis	Past
acompasados	Past
contraídos	Past
cicatrizar	None
recompensará	Future
consumar	None
magnificares	Future
favorecido	Past
descalificaría	None
ceceo	Present
repudiaban	Past
metidas	Past
terminarían	None
paralizadas	Past
desentona	Present
enhebrar	None
presentando	Present
alegada	Past
extorsionando	Present
despenaliza	Present
patrullas	Present
tamizaréis	Future
fomentarán	Future
sanaban	Past
celebran	Present
robasen	Past
olvidó	Past
restarían	None
añadierais	Past
neutralizadas	Past
disminuiría	None
acicalarse	None
desmalezaríamos	None
enrevesado	Past
bajas	Present
glosarías	None
centralizar	None
afrontaron	Past
recolocados	Past
adelantaría	None
masticar	None
cuantifica	Present
mamabais	Past
emergerán	Future
desinstalado	Past
examinaría	None
gruñido	Past
sobado	Past
aderezar	None
compondría	None
optimizan	Present
ralearías	None
cuídese	None
confronto	Present
paralizaría	None
equivalió	Past
innovando	Present
resultados	Past
divorciarse	None
defino	Present
rehilaré	Future
divulgan	Present
reaccionarían	None
troceando	Present
fermentan	Present
funcionaban	Past
colisionando	Present
templados	Past
acrecentarían	None
abundases	Past
salvadas	Past
expansionaré	Future
llovizna	Present
destartalásemos	Past
fumó	Past
transformarán	Future
memorizados	Past
complaciendo	Present
juzgaron	Past
rehacer	None
adornar	None
presintieras	Past
reabastecer	None
catapultar	None
nidifiquen	Present
restados	Past
danzó	Past
hastiado	Past
calefaccionar	None
seguirían	None
detestar	None
tenías	Past
cesar	None
argumentan	Present
removerían	None
punir	None
especializaría	None
escolarizaríamos	None
merodeado	Past
rozar	None
entregas	Present
comunicó	Past
sorprenderíamos	None
aislada	Past
anunciarían	None
pueblan	Present
callan	Present
ficcionasteis	Past
aclares	Present
nevados	Past
incentivó	Past
multiplicó	Past
lidia	Present
reabriéremos	Future
reasignaras	Past
revisé	Past
subleva	Present
desentrañar	None
descendido	Past
intermediar	None
replegada	Past
demolisteis	Past
impresionar	None
discurriría	None
prepintaran	Past
aforrásemos	Past
malvivieran	Past
localizaría	None
interferiría	None
pasarse	None
observaría	None
engalanado	Past
amaináis	Present
fruncir	None
engominado	Past
avistar	None
elevados	Past
encarnar	None
osados	Past
embriagó	Past
popularizaría	None
miraría	None
comprenden	Present
tronar	None
devolviesen	Past
claveteábamos	Past
readmitiré	Future
sucumbido	Past
afectar	None
yantares	Future
desearíamos	None
postuló	Past
convencerá	Future
tended	None
marinaren	Future
desactivásemos	Past
discutamos	Present
invisibilizar	None
inyectar	None
conciernen	Present
cuerpearan	Past
afilar	None
filmar	None
tajad	None
apelaría	None
apenas	Present
designaran	Past
rascar	None
dejas	Present
rebatados	Past
desbandar	None
entreoyeron	Past
deteriorar	None
hornea	Present
nublar	None
procederían	None
perdería	None
gesticular	None
expulsarán	Future
confesaría	None
toleradas	Past
mentorizará	Future
resquebrajada	Past
ennobleced	None
despellejan	Present
agobian	Present
integrada	Past
reconstruidas	Past
acabes	Present
trucarais	Past
rema	Present
apostillar	None
mascada	Past
contrabalanceada	Past
consultaría	None
curvada	Past
infestar	None
trapalearemos	Future
garapiñadas	Past
zafar	None
publicité	Past
fundamenta	Present
usad	None
ajó	Past
revistiéremos	Future
estandarizando	Present
operaría	None
cazado	Past
sed	None
abrasar	None
amamantar	None
herrumbrados	Past
acrecientan	Present
abdicaron	Past
ataviéis	Present
conversado	Past
interiorizado	Past
colar	None
aullando	Present
engordando	Present
aturden	Present
domestico	Present
traen	Present
apestados	Past
alentar	None
conmutadas	Past
desamparados	Past
aturrullo	Present
accederán	Future
debatir	None
bronceáramos	Past
desinvertir	None
decodificar	None
embarazada	Past
capta	Present
disculpas	Present
garrapiñé	Past
omitir	None
incinerado	Past
alababan	Past
capacitar	None
sentar	None
chorearían	None
despertarse	None
añadiesen	Past
normalizando	Present
degeneran	Present
soldó	Past
vehicular	None
editadas	Past
reconcilió	Past
atraganta	Present
acreditar	None
embocar	None
adquirid	None
descentraliza	Present
circunferiríais	None
siseo	Present
desordenada	Past
astriñeses	Past
inutilizadas	Past
inmoló	Past
trajinar	None
intrigareis	Future
antiguarías	None
pretendería	None
retrataría	None
rescinde	Present
guillotinado	Past
desamortizad	None
chantajeados	Past
acomplejada	Past
infundiré	Future
coprodujéramos	Past
recayeron	Past
sombreaste	Past
resumieseis	Past
emigró	Past
imagina	Present
oxigenado	Past
concertado	Past
riegan	Present
subscribiéramos	Past
fosilicémonos	None
ocluido	Past
caminé	Past
subsanaron	Past
paseada	Past
fiar	None
transformarían	None
atendían	Past
agravarán	Future
ejercito	Present
preestablecida	Past
desgasten	Present
conjuntan	Present
escotes	Present
cegadas	Past
protagonizarían	None
quebrases	Past
debíamos	Past
reexaminar	None
distribuyésemos	Past
describen	Present
testimonio	Present
esquila	Present
ametrallado	Past
retranqueadas	Past
sincronizar	None
elaborarán	Future
aborrezcáis	Present
redimensionado	Past
autentificar	None
desmentiría	None
renderizar	None
cancelados	Past
imitabais	Past
gestas	Present
aniega	Present
perjudicará	Future
habilitaría	None
facultando	Present
azotan	Present
negaron	Past
reconvertido	Past
extraído	Past
reproduciéndose	Present
entretejer	None
incentivarías	None
agreden	Present
tapias	Present
diversificar	None
descuartizados	Past
asemejar	None
transpongan	Present
arrojarían	None
emigradas	Past
aminorados	Past
cemento	Present
dictará	Future
degeneradas	Past
resguardándose	Present
etiquetaron	Past
desgastados	Past
congenió	Past
revividos	Past
reparten	Present
lavó	Past
ocurridas	Past
explotaría	None
confesada	Past
trastocaras	Past
otorgadas	Past
discrepaban	Past
acabaríamos	None
zozobras	Present
descuajaría	None
escotáremos	Future
reportes	Present
cerraría	None
desestabilizaríamos	None
deteriorando	Present
controlaría	None
ordenaran	Past
desayunan	Present
enriqueció	Past
iluminaron	Past
invitan	Present
enlistemos	Present
finir	None
encintas	Present
acondicionar	None
atarearíamos	None
fortalecer	None
taponar	None
tonificado	Past
remunerado	Past
amordazada	Past
versearéis	Future
asusto	Present
incrementaren	Future
fotocopiado	Past
objetaron	Past
autogestionados	Past
limpiándose	Present
abogaré	Future
encorsetaran	Past
alterarían	None
vigiles	Present
traspusiesen	Past
presurizadas	Past
correspondería	None
subvencionada	Past
inspires	Present
culear	None
vacunadas	Past
nublo	Present
rapé	Past
hicimos	Past
motiven	Present
expedientará	Future
adhirieron	Past
intentaría	None
cortejan	Present
tostarían	None
oscilaron	Past
estrenada	Past
adelgazar	None
cubriendo	Present
encaminar	None
arremangaré	Future
acometerán	Future
googlear	None
terminan	Present
predestinado	Past
derrumbará	Future
obedecerían	None
alborotar	None
contentada	Past
cuento	Present
evangelizada	Past
desembalabais	Past
aceptaría	None
olvidarían	None
desestabilizaron	Past
aserrado	Past
desperdiciado	Past
infligieron	Past
atrasados	Past
reflejado	Past
sobornará	Future
violé	Past
reciclaron	Past
envasaremos	Future
reformada	Past
excluyen	Present
detuvo	Past
desempeñaran	Past
escaseó	Past
estereotipados	Past
guardadas	Past
evolucionar	None
aliarían	None
sobrecumplirá	Future
enfocó	Past
ninguneando	Present
añejada	Past
extasiases	Past
apiñados	Past
flirtead	None
matarse	None
vislumbrar	None
ensuciar	None
empleará	Future
privé	Past
desestimar	None
recitar	None
arriarás	Future
cavilar	None
maniatabas	Past
amamantados	Past
calcinar	None
ratificad	None
segando	Present
extraer	None
corroboro	Present
copulan	Present
osan	Present
jactándose	Present
secuenciada	Past
expandirían	None
especias	Present
obtengas	Present
debilitaran	Past
ionizado	Past
acotar	None
destituyen	Present
dopes	Present
reunirían	None
liquenizaré	Future
defraudar	None
presentir	None
acoger	None
predominan	Present
influiría	None
conocidas	Past
desentrañases	Past
restringían	Past
potencializarás	Future
rechazar	None
votas	Present
granas	Present
merecer	None
irrito	Present
pastorear	None
requiriendo	Present
maltrata	Present
arrestaríamos	None
bateas	Present
contrabandeábamos	Past
enterrar	None
carda	Present
reembolso	Present
anises	Present
subcontratáremos	Future
rimar	None
huronearás	Future
desguazaran	Past
organizarán	Future
resolved	None
abanicar	None
dejaré	Future
miniaturizarán	Future
desposeídas	Past
rehusaran	Past
aventajado	Past
bloquearán	Future
sustentar	None
zapareis	Future
amputar	None
rebautizan	Present
rehusábamos	Past
especificó	Past
forzaría	None
oculta	Present
descartando	Present
indisponer	None
debaten	Present
manchar	None
golpeada	Past
acatar	None
constando	Present
forjarían	None
abolida	Past
oxidar	None
transa	Present
facilitado	Past
faenaremos	Future
escapes	Present
rebelan	Present
pauto	Present
internen	Present
inmola	Present
fiscalizadas	Past
rentabilizaréis	Future
torciéndose	Present
trabajes	Present
mitigares	Future
alcanzados	Past
engordáremos	Future
ojead	None
boxeabas	Past
reinados	Past
consuelo	Present
visiona	Present
escarbará	Future
reseñar	None
meditando	Present
desportilláis	Present
transpirar	None
abrogué	Past
actualizaría	None
amuralló	Past
radicaría	None
drogando	Present
latines	Present
quitando	Present
adelantaron	Past
profesionaliza	Present
engarrucho	Present
escondes	Present
cuesten	Present
caracterizarán	Future
desequilibraría	None
desajustarían	None
originados	Past
abluyen	Present
reabrieron	Past
reconquistando	Present
interpela	Present
dejaríamos	None
guarnecían	Past
extrajeran	Past
explicitados	Past
reconciliaremos	Future
concernido	Past
familiarizan	Present
desenvuelta	Past
percataron	Past
saldremos	Future
legitimada	Past
ocuparían	None
reconstruirá	Future
donado	Past
embarcando	Present
silbadas	Past
agitados	Past
recalcular	None
aprendan	Present
tunearíais	None
apresen	Present
entusiasmases	Past
polarizan	Present
cultivados	Past
ser	None
guisar	None
cimentados	Past
remacha	Present
restaurasen	Past
cachar	None
relanzaste	Past
atinaré	Future
migren	Present
responder	None
chutaste	Past
hurtar	None
actuaría	None
quédate	None
dedican	Present
presupuestos	Past
prorrateabas	Past
exasperó	Past
encalados	Past
desatascar	None
condimentado	Past
poseemos	Present
desplomado	Past
hostigaríamos	None
sumido	Past
garantizaron	Past
aportaran	Past
interrogasen	Past
egreso	Present
enfrentábamos	Past
recurrierais	Past
salpicar	None
confluyeran	Past
ruge	Present
incorporaste	Past
tonteando	Present
comparar	None
exponer	None
infamaran	Past
analizaremos	Future
creadas	Past
galardonó	Past
pretenderían	None
arrinconaste	Past
recomprará	Future
sorprendieren	Future
prohibiendo	Present
vuelve	Present
pavonearse	None
enceguecido	Past
dañadas	Past
desovas	Present
ninguneo	Present
aviso	Present
entretuvieron	Past
propinar	None
deformar	None
frías	Present
cuadrar	None
calificó	Past
recopilar	None
acepillarás	Future
desbastar	None
desaprobaron	Past
aparentó	Past
rasgando	Present
hicieren	Future
agarradas	Past
encierren	Present
mirada	Past
ondular	None
traería	None
desmesuraré	Future
descarten	Present
deformáis	Present
lito	Present
alejará	Future
inciden	Present
verbalizaran	Past
postulada	Past
copiar	None
desbarrancó	Past
estelarizar	None
encajar	None
permitirse	None
repueblas	Present
habrá	Future
desmoralizaríais	None
desenvuelto	Past
diferenciaría	None
inclinaría	None
ilusionada	Past
detallados	Past
medio	Present
inyectan	Present
meteorizadas	Past
encerrando	Present
desentierran	Present
molestarían	None
veranearíais	None
encaminen	Present
extendieran	Past
pedid	None
catapultaría	None
remitirías	None
explicó	Past
nidifican	Present
acalambrada	Past
afinados	Past
aproximará	Future
portará	Future
apellido	Present
flaqueaseis	Past
conmemorando	Present
satirizar	None
envasar	None
armar	None
decretará	Future
encarcelan	Present
casaron	Past
divulgaban	Past
enlosados	Past
internabas	Past
salvo	Present
cuchareó	Past
soportarían	None
demeritar	None
deslumbrado	Past
evaporar	None
hallar	None
camuflar	None
contraindicabas	Past
apuñalan	Present
disques	Present
visionareis	Future
citaremos	Future
raído	Past
capitaneado	Past
contaré	Future
entallaren	Future
acitronasen	Past
desahuciar	None
mulgieras	Past
notaras	Past
ultimareis	Future
afores	Present
privados	Past
fiscalizar	None
odiando	Present
wasapeen	Present
estafaron	Past
pretender	None
abducir	None
consejo	Present
encapsulada	Past
mentalizases	Past
encubrir	None
divorciémonos	None
adivinarás	Future
cuchichear	None
fingirá	Future
confiscada	Past
degustando	Present
sitiar	None
tematizarían	None
desprestigió	Past
conduce	Present
acuartela	Present
rieras	Past
matriculadas	Past
cautivaron	Past
conminaron	Past
incorporó	Past
erizar	None
rellena	Present
plantearían	None
contaminar	None
abocadas	Past
beatificar	None
predicad	None
reconfortado	Past
glosa	Present
prensada	Past
ocurrido	Past
sacraliza	Present
derretir	None
esforzaría	None
embalsadas	Past
preservaran	Past
retomaréis	Future
educan	Present
ejecutando	Present
desacierta	Present
reincorporaron	Past
equilibró	Past
encarrilada	Past
amordazados	Past
desglosadas	Past
embarullásemos	Past
atisbar	None
orientaría	None
proveído	Past
amputó	Past
lanzar	None
exhalando	Present
empacabais	Past
avezó	Past
postergando	Present
retardadas	Past
pernoctan	Present
profanando	Present
separándose	Present
remplazado	Past
desviar	None
despedazasen	Past
desconvocado	Past
alentaría	None
calentado	Past
facilitarán	Future
cloraréis	Future
atestiguan	Present
desmontar	None
plagiar	None
consigan	Present
moveré	Future
transplantarais	Past
renacieron	Past
desahogada	Past
sangrando	Present
contabilizaran	Past
mordisquear	None
extinguir	None
instaura	Present
soldado	Past
adivinéis	Present
desequilibrar	None
arraigado	Past
quejar	None
desacreditaren	Future
traída	Past
insertada	Past
diputar	None
comprendieron	Past
propulsando	Present
continuemos	Present
achinarías	None
deslustrasen	Past
percatabas	Past
postulen	Present
sobrellevó	Past
serían	None
remplazar	None
soparíais	None
aplican	Present
expresando	Present
retiene	Present
miso	Present
barequeaste	Past
ajetreo	Present
deshonraría	None
mezclando	Present
incriminaban	Past
liará	Future
desgastado	Past
cuidará	Future
duplicó	Past
cogió	Past
concierto	Present
estriada	Past
arrojar	None
conectará	Future
mofarían	None
desasiríais	None
causado	Past
repotenciar	None
cuadran	Present
ratearon	Past
emparenté	Past
ilustradas	Past
ondear	None
nacieron	Past
sospechásemos	Past
estilizando	Present
repetir	None
insinuadas	Past
descabellada	Past
emparentaremos	Future
despuntaréis	Future
cerner	None
presupuestados	Past
corroborar	None
tutearíais	None
presionaría	None
persistían	Past
embarrar	None
pajareéis	Present
ladréis	Present
escoltadas	Past
especificarían	None
compenetrarse	None
operarían	None
labora	Present
calentaría	None
oídas	Past
cercada	Past
terraformaríais	None
brindar	None
empaquetar	None
ventilada	Past
pertrechar	None
definida	Past
mercadear	None
demandó	Past
implantarse	None
secundo	Present
suicides	Present
descollarían	None
desapareciendo	Present
relaciona	Present
estrechar	None
cubicaría	None
hegemonizaríais	None
aprovisionaban	Past
enlacé	Past
clamando	Present
id	None
centellas	Present
jaquearais	Past
filtrares	Future
serrada	Past
marchen	Present
desparpajo	Present
formalizaría	None
fluidos	Past
derrotar	None
expondría	None
muestreadas	Past
publican	Present
agraviada	Past
escamada	Past
derelinquieran	Past
invitaría	None
obsequiados	Past
subsanadas	Past
inundar	None
ordeñar	None
desagradabas	Past
eyaculado	Past
acolches	Present
ansía	Present
renunciar	None
aducís	Present
erigiríamos	None
prevenían	Past
asegurarían	None
licúa	Present
corroboraron	Past
entallases	Past
cimentar	None
subsidiaría	None
hospedar	None
estriasteis	Past
taponeó	Past
otorgasen	Past
obsequiaban	Past
desanimarían	None
proyecto	Present
repudiada	Past
prosperará	Future
procuro	Present
alternaban	Past
desengañaran	Past
revisando	Present
cundieres	Future
marchitan	Present
desenvolver	None
alentaban	Past
familiarizar	None
precarizaré	Future
colocó	Past
herrar	None
entraremos	Future
quebraron	Past
tenida	Past
maja	Present
cementar	None
acrecienta	Present
transcurrir	None
compensan	Present
desmoronando	Present
moldeadas	Past
dotarán	Future
deprimen	Present
rapear	None
estrechada	Past
restaron	Past
convergerán	Future
dejaras	Past
manejará	Future
autorizarían	None
tumbaré	Future
ronroneado	Past
recabó	Past
describirían	None
suspirabas	Past
reflejasen	Past
localizaban	Past
padecen	Present
escarda	Present
fundamentaran	Past
proliferar	None
cenando	Present
cilindrada	Past
leyó	Past
renunciaron	Past
escardó	Past
alabeado	Past
licenciaría	None
encasilló	Past
entrad	None
trinchar	None
penetrar	None
equilibren	Present
erosionadas	Past
consternarían	None
acaloremos	Present
batir	None
remedies	Present
intoxicada	Past
tapia	Present
morirán	Future
fecho	Present
renguearán	Future
perdurará	Future
leerías	None
revalidó	Past
rebulliría	None
tornó	Past
ahorrada	Past
aspiraste	Past
reconciliaren	Future
acordonó	Past
reaprovecharen	Future
aportó	Past
izarás	Future
cogemos	Present
crecidas	Past
tardes	Present
conocer	None
minaría	None
engrandecer	None
sucedida	Past
amarga	Present
encontraron	Past
mutases	Past
usas	Present
atarearéis	Future
amortajada	Past
rapiñaríais	None
evidenciaban	Past
pajeaos	None
parlamentarán	Future
enredado	Past
combinen	Present
mello	Present
gruñir	None
amenguaban	Past
salían	Past
martirizados	Past
venencia	Present
provenir	None
tienden	Present
opinado	Past
compaginarías	None
desperdiciaría	None
lapidado	Past
cromo	Present
ampollas	Present
distrae	Present
validan	Present
traerá	Future
bautizar	None
rebatidos	Past
bordando	Present
publicita	Present
anonadaseis	Past
traicionados	Past
confeccionar	None
diferidos	Past
alargará	Future
tipificar	None
delatáis	Present
fidelizar	None
reaparecería	None
cortejo	Present
disculparse	None
desportillaría	None
ejecutáramos	Past
esconder	None
suspendidos	Past
reproches	Present
mecha	Present
tuteaseis	Past
infectó	Past
supondrían	None
hermanadas	Past
departir	None
reconoces	Present
colapsar	None
desarraigar	None
rescató	Past
extrajésemos	Past
agua	Present
arma	Present
creíamos	Past
vivar	None
planteado	Past
gerenciar	None
hackeásemos	Past
pronunciará	Future
vincular	None
fufad	None
fraternizarás	Future
agregarán	Future
liderarían	None
peralta	Present
pendejearían	None
crearemos	Future
vivares	Future
tolerados	Past
actives	Present
engarza	Present
normásemos	Past
carenar	None
insertarán	Future
emitiendo	Present
vislumbran	Present
retranqueaste	Past
demorar	None
imbuyeren	Future
humear	None
difundiésemos	Past
justo	Present
posan	Present
inscrita	Past
deslucías	Past
tutela	Present
ennegreciéramos	Past
asaban	Past
detonan	Present
remplazará	Future
podrías	None
chiflada	Past
admitirían	None
evites	Present
traspuso	Past
bautizo	Present
malinterpretar	None
aprueben	Present
atestiguar	None
desmadrasteis	Past
persuadir	None
desjudicializarían	None
contaminarás	Future
encabezaban	Past
emplazaría	None
prohibirías	None
escaneados	Past
masificadas	Past
versan	Present
agachar	None
escandalizaste	Past
licenciados	Past
chirría	Present
desacato	Present
morrearíais	None
oponerse	None
contendido	Past
deslegitimo	Present
custodies	Present
continuaría	None
plantearán	Future
diferenciarían	None
rodadas	Past
notarán	Future
lanzarían	None
enrolada	Past
puedas	Present
enranciaremos	Future
mezclados	Past
deshiela	Present
precian	Present
repararía	None
sumada	Past
vagabundear	None
codiciaban	Past
minusvalorar	None
reteñirá	Future
contraprogramaría	None
calculando	Present
circunnavegar	None
debita	Present
instaron	Past
refacciones	Present
certifico	Present
demarcaban	Past
despiojaríais	None
experimentarían	None
decretáis	Present
oscilando	Present
traslucharemos	Future
garantizarán	Future
remojo	Present
arriesgada	Past
coaccionó	Past
rebozar	None
hartó	Past
poblar	None
descongestionar	None
difuminar	None
subastar	None
achates	Present
procesionar	None
cogería	None
catapultareis	Future
primar	None
insultan	Present
observando	Present
incursionaré	Future
aderezad	None
trasladaban	Past
abraza	Present
estructurada	Past
monitorizada	Past
gozará	Future
repeliendo	Present
recubiertas	Past
aero	Present
pincharon	Past
bebáis	Present
brillar	None
esperada	Past
comisionadas	Past
individualizar	None
habláis	Present
invisibilizareis	Future
cartearse	None
glaseaseis	Past
inhibidas	Past
cambiada	Past
autoeditáis	Present
repudiar	None
choco	Present
intrincadas	Past
desencadenará	Future
reelaboró	Past
migraran	Past
rentaban	Past
flotan	Present
recubren	Present
extinguiría	None
importadas	Past
sorprenderán	Future
pavimentas	Present
empujará	Future
urbanizó	Past
traspuesto	Past
carteaos	None
aniquilaría	None
reiteró	Past
deprime	Present
alhajas	Present
indicando	Present
embarazó	Past
entremezcladas	Past
peer	None
restablecerían	None
agusanéis	Present
asediaron	Past
resultado	Past
condecora	Present
extinguieron	Past
revive	Present
comunicaría	None
fermentaré	Future
reforzarían	None
amémonos	None
destacarán	Future
incursionan	Present
empeller	None
evadir	None
nixtamalizado	Past
saturaron	Past
necesitábamos	Past
carecería	None
obviando	Present
amnistiados	Past
desorientados	Past
descontará	Future
atildareis	Future
acuñar	None
harás	Future
contabilicen	Present
hilada	Past
excluiría	None
barloventearíamos	None
ulularía	None
comprobados	Past
crucemos	Present
aleteo	Present
irrogabais	Past
reemplazar	None
demandarían	None
toqué	Past
escudriñaren	Future
adames	Present
subsumir	None
amalgamaron	Past
promedió	Past
privatizaron	Past
supervisada	Past
tronó	Past
merecerá	Future
selecciona	Present
retractaría	None
fajo	Present
premuertos	Past
pulieron	Past
empadronada	Past
perdurarían	None
aguarías	None
recogerían	None
comercialicen	Present
sobresaltad	None
acuchilló	Past
refulgir	None
movería	None
abluid	None
majo	Present
agonizarían	None
menguó	Past
desembalar	None
reglamentados	Past
prever	None
hollar	None
escorarse	None
correrse	None
intensificará	Future
servidas	Past
pediría	None
irrespeto	Present
abandonarían	None
tendríamos	None
granjeó	Past
incluirían	None
asistían	Past
estereotiparon	Past
avenir	None
contribuirán	Future
amotinadas	Past
efectuasen	Past
cambiaría	None
desmarcar	None
causaría	None
impugnado	Past
homenajeó	Past
resistidos	Past
matoneáis	Present
alejes	Present
aproximar	None
incomodó	Past
esmérate	None
chillaría	None
patea	Present
cumplidos	Past
fríe	Present
previó	Past
resueltas	Past
bloqueas	Present
interrumpirían	None
emplazadas	Past
entiende	Present
descuenta	Present
acentuar	None
mofaron	Past
entronizar	None
revivieron	Past
enojémonos	None
caldea	Present
filosofando	Present
indagarías	None
animalizada	Past
amnistiaríais	None
aprehendieron	Past
selló	Past
pensionadas	Past
abundéis	Present
ponte	None
recitabas	Past
anestesiar	None
fascinaron	Past
publicaron	Past
ejercer	None
sigue	Present
enderezaríais	None
cañoneado	Past
fisionar	None
degenerar	None
recuperados	Past
alisan	Present
tocarán	Future
concatenado	Past
besar	None
vuélvete	None
conforman	Present
fascinó	Past
mangas	Present
avergonzarían	None
liberto	Present
graduando	Present
consultar	None
alejarse	None
llenaron	Past
explicaras	Past
prefirieron	Past
contratasen	Past
coexiste	Present
sueldan	Present
desinfló	Past
desvirtuaron	Past
encantar	None
temo	Present
obliga	Present
preceden	Present
balado	Past
acercarían	None
tumbado	Past
oída	Past
enturbian	Present
burlar	None
chillas	Present
avecinaste	Past
faltan	Present
exhuma	Present
hilvanáis	Present
agasajabais	Past
complementaría	None
intercalando	Present
ambientan	Present
regenten	Present
desgajadas	Past
vengó	Past
impugnadas	Past
evadías	Past
restablecería	None
divina	Present
pigmentada	Past
gafarías	None
amortiguó	Past
convalecer	None
embaucar	None
fundaseis	Past
escaparás	Future
minimalices	Present
abocan	Present
adaptaban	Past
catar	None
abjura	Present
amoldar	None
violando	Present
volvería	None
rifares	Future
pastando	Present
pertenecería	None
desintegrar	None
serrasen	Past
alzarían	None
esbozar	None
sondeó	Past
acepté	Past
empujo	Present
baño	Present
cobrar	None
solventar	None
ostenta	Present
perjudiquen	Present
concesionaré	Future
humedecido	Past
ondea	Present
emergidas	Past
rasgar	None
curvados	Past
acamparon	Past
actualizado	Past
manosear	None
desquita	Present
vinculares	Future
ataviados	Past
acidificar	None
agrietando	Present
diseminadas	Past
aportados	Past
aniden	Present
derrocaría	None
hormigueares	Future
cubrirá	Future
muerdan	Present
retomar	None
curiosearais	Past
cenaseis	Past
quedará	Future
desperdiciaron	Past
ofendían	Past
incentivando	Present
flanquear	None
desilusionado	Past
premiadas	Past
intrigarais	Past
compilar	None
decapitaríais	None
perpetuaría	None
horrorizada	Past
quedé	Past
cobijaron	Past
atesoradas	Past
irrespetar	None
falsificar	None
partirían	None
dificultado	Past
levitaseis	Past
oferta	Present
yanto	Present
tacharía	None
reingresan	Present
hipnotizasen	Past
consisten	Present
preludiaría	None
empeoraban	Past
virar	None
insertaría	None
revalidábamos	Past
ridiculizados	Past
ripiada	Past
abigarradas	Past
comentado	Past
asombra	Present
respeta	Present
habidos	Past
revelaría	None
partir	None
encausaríais	None
percutir	None
conservarías	None
escuchábamos	Past
recitó	Past
ponderan	Present
erigido	Past
coescribir	None
acabares	Future
consentiría	None
emplazando	Present
gravitas	Present
convendría	None
endurecíamos	Past
clico	Present
concluirían	None
expresarán	Future
inhumaren	Future
maquinaría	None
masajearíais	None
encharqué	Past
anunciar	None
perjuras	Present
embocarían	None
previniésemos	Past
regurgita	Present
desconfiados	Past
rezar	None
eslío	Present
fracasarían	None
actuará	Future
continúas	Present
doblaban	Past
esparcían	Past
trascurrir	None
descarrilarían	None
sucitaríamos	None
sosegaríais	None
bramar	None
relacionaría	None
reanudarían	None
conferiría	None
ultrajaré	Future
reivindicar	None
bullerais	Past
omitidas	Past
convirtiesen	Past
embromáramos	Past
revalorizó	Past
reportar	None
cohecharíamos	None
fundarían	None
alquiló	Past
desautoriza	Present
denominar	None
aceptar	None
alimentaban	Past
perpetran	Present
ganaré	Future
testeabais	Past
escudriña	Present
fagocites	Present
esboza	Present
marginados	Past
incentivaban	Past
alejaban	Past
cercas	Present
invitaron	Past
cruzarán	Future
farfullé	Past
revisionaras	Past
sulfurareis	Future
pedorrearíais	None
tergiversarían	None
paralelarías	None
desfavorecer	None
computaron	Past
decelerar	None
embriagares	Future
vara	Present
avanzaría	None
seduciendo	Present
laborado	Past
malinterpretad	None
enfriar	None
alisarais	Past
posé	Past
bebí	Past
controlaremos	Future
prepagarías	None
hidrogenaron	Past
tachonan	Present
fincaron	Past
antecedida	Past
encabezará	Future
trazaría	None
desertado	Past
escarchas	Present
adjuntaban	Past
crear	None
enlazaran	Past
ahondar	None
empaquetada	Past
divino	Present
predispusieseis	Past
autorizaría	None
embargadas	Past
caigo	Present
repetirán	Future
alistar	None
formalizar	None
maridadas	Past
enripiados	Past
vibras	Present
interiorizaréis	Future
rotaron	Past
independizaban	Past
deseé	Past
heredando	Present
habilitaron	Past
restablecían	Past
comunicarían	None
aseguraban	Past
procrear	None
lanza	Present
desaprendí	Past
instalará	Future
presentaste	Past
aherrojéis	Present
requerido	Past
marines	Present
copar	None
deconstruirías	None
inhibir	None
contorsionada	Past
apellidó	Past
perdido	Past
silenciado	Past
excluyo	Present
desacralizásemos	Past
amortizadas	Past
confesará	Future
heredará	Future
retocaríais	None
prejuzgar	None
inocular	None
ligas	Present
fomentado	Past
eclosionados	Past
heredarás	Future
maullar	None
barajan	Present
recomenzó	Past
asociados	Past
visibilizaste	Past
desbaratar	None
alzaran	Past
entra	Present
combinaría	None
rehúsen	Present
achaca	Present
enamorar	None
militarizad	None
metamorfosea	Present
orquestada	Past
vilipendiada	Past
centrifuga	Present
espabilaría	None
relataríais	None
dopados	Past
premiando	Present
acortada	Past
doto	Present
existir	None
pensabas	Past
fundad	None
premió	Past
profesionalicemos	Present
desamortizadas	Past
desvaída	Past
degollaríais	None
careces	Present
expelidos	Past
vaciaría	None
confiaría	None
operará	Future
defecan	Present
gustar	None
orientó	Past
lanzabas	Past
endeudó	Past
promocionaría	None
recitado	Past
portaría	None
cállate	None
carburado	Past
sobrevivieron	Past
proceso	Present
sensibilizad	None
recupero	Present
doctoró	Past
anotarían	None
reelaborar	None
menudearon	Past
torturen	Present
nominen	Present
metamorfosearen	Future
desdoro	Present
diseminar	None
recaló	Past
descalza	Present
mantendrán	Future
clasificas	Present
enriquecieron	Past
inhala	Present
encuadradas	Past
prepagado	Past
formó	Past
aliadas	Past
adaptar	None
asociaría	None
climatizadas	Past
tensa	Present
fagocitada	Past
trazada	Past
recompensaría	None
dances	Present
preconizada	Past
salir	None
invadiesen	Past
cedería	None
derribada	Past
amortiguado	Past
arrumbásemos	Past
adosadas	Past
patear	None
avistaren	Future
cabildear	None
llamaban	Past
evito	Present
potabilizar	None
reflotaron	Past
abarracarás	Future
transcurrían	Past
escabullen	Present
confundí	Past
fusionó	Past
dejaremos	Future
empináramos	Past
borradas	Past
excomulgando	Present
desincentivo	Present
venderían	None
enteré	Past
cuestionar	None
refunfuñáremos	Future
protegería	None
perfila	Present
rechazará	Future
mitigada	Past
encurtir	None
colocaron	Past
enchufado	Past
consejas	Present
gestiones	Present
estandarizados	Past
ensancharíais	None
amedrentaron	Past
decebirías	None
encastres	Present
archivará	Future
instigar	None
desempeñará	Future
desorejes	Present
rifo	Present
quemes	Present
lonchear	None
radiando	Present
poseyeron	Past
modelizaríais	None
descubren	Present
sanciones	Present
rallados	Past
encestar	None
asistieran	Past
conduzco	Present
precedieras	Past
asustar	None
reeducar	None
estrenado	Past
copuláis	Present
tararear	None
sonrosarían	None
depositadas	Past
entreverados	Past
contestadas	Past
pinchar	None
malversar	None
despolitiza	Present
gaseáremos	Future
desafiaríamos	None
rezagaran	Past
barbas	Present
relatará	Future
adivinando	Present
versionaron	Past
mellado	Past
terció	Past
eximir	None
basó	Past
embrujar	None
distinguían	Past
desgranan	Present
expandan	Present
descontinuar	None
cesará	Future
cruzado	Past
languideciendo	Present
abrazar	None
tollo	Present
perecería	None
desencadenan	Present
galvanizásemos	Past
trinadas	Past
contrahaciendo	Present
aflojar	None
exacerbadas	Past
cocido	Past
cabecea	Present
asumió	Past
ahorran	Present
ensanchaste	Past
descalificó	Past
orientaron	Past
ascendieran	Past
abrillantábamos	Past
detentaban	Past
conoce	Present
identificada	Past
prestigiado	Past
removió	Past
malgasta	Present
oponer	None
salvaguardar	None
consulto	Present
captó	Past
enharinados	Past
subvencionado	Past
llenarán	Future
sedujo	Past
filtren	Present
entrevendrías	None
inculcábamos	Past
interferida	Past
desprende	Present
paginaban	Past
recauchutaren	Future
trabajarían	None
frenado	Past
exhumaremos	Future
rasga	Present
tensaría	None
predicen	Present
proferían	Past
visitar	None
recela	Present
endeudada	Past
amplió	Past
complicada	Past
anochecer	None
rematado	Past
bosqueja	Present
despoblando	Present
chivaren	Future
atañen	Present
majar	None
diagnosticaron	Past
enroscadas	Past
fotocopias	Present
reencontrarían	None
hormigones	Present
injertados	Past
beneficiado	Past
apaleado	Past
topar	None
calafateado	Past
finalizarían	None
rizado	Past
bridar	None
aportaron	Past
declarados	Past
dominaría	None
alabar	None
disienten	Present
administraron	Past
aberrasteis	Past
escarchada	Past
reprobar	None
huye	Present
ingerida	Past
alteraron	Past
omitían	Past
rapeadas	Past
añadirían	None
resonará	Future
ignoraron	Past
interrelacionadas	Past
golpeó	Past
trastead	None
enarboló	Past
encargan	Present
emplearían	None
firmar	None
surcando	Present
investigaban	Past
eyecto	Present
involucrará	Future
entendido	Past
egresó	Past
establecer	None
disimulo	Present
descapitalizó	Past
aprehendió	Past
seccionar	None
engorda	Present
persistirá	Future
tocarían	None
trillados	Past
enmendada	Past
miradas	Past
menad	None
prescribieron	Past
hallando	Present
empeoraría	None
despoblaron	Past
ejercería	None
fileteada	Past
enfocaran	Past
crece	Present
abastecería	None
tardaría	None
pintaríamos	None
saquear	None
extinguido	Past
sabrás	Future
confluyeron	Past
desviaremos	Future
gemir	None
numero	Present
atentad	None
impartieran	Past
trampear	None
intuye	Present
despiezaríamos	None
sustrajimos	Past
fusionarse	None
extrajeron	Past
tunde	Present
reuniría	None
reinstalada	Past
vitrifiqué	Past
pulo	Present
rayes	Present
verifiquen	Present
amparar	None
chamullada	Past
optan	Present
atisba	Present
hormigonan	Present
autorizadas	Past
desmarca	Present
encendería	None
vedo	Present
desfuerzan	Present
permitan	Present
tironeada	Past
insta	Present
reaccionaría	None
circunscribe	Present
murieran	Past
verbalizar	None
ahumado	Past
mamas	Present
camuflaron	Past
dispensar	None
podido	Past
balbucíais	Past
imposibilitó	Past
recurridos	Past
arbitro	Present
descentralizando	Present
enlistados	Past
impulsan	Present
sobredimensionadas	Past
suscitada	Past
localizarían	None
arrendar	None
profundizada	Past
establecerían	None
desaguar	None
cuitad	None
gritado	Past
degollar	None
increpando	Present
instaban	Past
amputares	Future
deliberaríamos	None
alzan	Present
flamearemos	Future
permutada	Past
jalasteis	Past
reelegir	None
adoraban	Past
reorganizar	None
confundida	Past
bautizarían	None
serrar	None
consignó	Past
albureaban	Past
entretenidos	Past
resultaría	None
subarrendarían	None
preferís	Present
pelearían	None
trocear	None
entregar	None
reaccionaban	Past
afrontas	Present
aprovecharían	None
localizados	Past
desentrañando	Present
disfracé	Past
ornamentar	None
facturaríais	None
amarrar	None
disipa	Present
deificar	None
franquiciado	Past
telegrafiar	None
influencian	Present
aferradas	Past
unificar	None
comer	None
trenzado	Past
adiestrar	None
encolar	None
guarece	Present
inmovilizan	Present
cometiste	Past
truncas	Present
pautadas	Past
embellecer	None
perpetuó	Past
narren	Present
choquen	Present
reglando	Present
mecanografiar	None
reavivadas	Past
infringir	None
descarriadas	Past
prolongaran	Past
abrirán	Future
realineases	Past
zurrado	Past
respondo	Present
enterraron	Past
incentivará	Future
afea	Present
cruzaría	None
destacando	Present
inaugurarías	None
abastados	Past
pita	Present
dilatados	Past
otea	Present
perturbando	Present
evoco	Present
autofinanciada	Past
derribadas	Past
acomodarse	None
controles	Present
asestar	None
priorizaremos	Future
misa	Present
impactaron	Past
creímos	Past
cie	Past
adormecer	None
estabularíamos	None
recread	None
usen	Present
ganen	Present
penó	Past
seducido	Past
reencontraría	None
maniobrar	None
repudió	Past
cercaban	Past
enfrenten	Present
entonada	Past
entretenida	Past
azufrarais	Past
alardear	None
sucumbieran	Past
engloben	Present
negaran	Past
espetada	Past
topaban	Past
desollar	None
drena	Present
despejadas	Past
plañirían	None
curtieren	Future
tostando	Present
incautada	Past
martirizaríais	None
cambio	Present
mayéis	Present
trozado	Past
adujas	Present
zancadilleasen	Past
inmortalizadas	Past
sabría	None
alambicada	Past
ata	Present
facultado	Past
rechazaría	None
comprimido	Past
interponer	None
aspirar	None
ando	Present
predica	Present
civilizada	Past
enojes	Present
chaqueteáramos	Past
exhalado	Past
tomaras	Past
aguijoneares	Future
esputo	Present
lacrimas	Present
planteó	Past
vegetar	None
comisaria	Present
ornar	None
extorsionad	None
intervenida	Past
descenderán	Future
ventad	None
retiraban	Past
reconstituidos	Past
enviaré	Future
diagnosticó	Past
refaccionaron	Past
lauda	Present
colegirán	Future
humaniza	Present
seamos	Present
tensarán	Future
metaforizases	Past
sobrevenir	None
construidas	Past
precarizad	None
desmenuza	Present
azafranará	Future
plegaban	Past
derogaría	None
trasladaría	None
incorporando	Present
pilotear	None
protegerían	None
constituyó	Past
acuarteló	Past
dialogar	None
lidiados	Past
encerrada	Past
desenfundar	None
esclavizadas	Past
sonrosadas	Past
fractura	Present
predecían	Past
sugerir	None
transbordo	Present
mangaríais	None
bridáramos	Past
excomulgaron	Past
mutilarais	Past
desmenuzasen	Past
aisladas	Past
satirizados	Past
impelería	None
infamarais	Past
erosionados	Past
engatusarías	None
amargáremos	Future
ajustaran	Past
enflaqué	Past
centraría	None
lagrimaron	Past
tecnificadas	Past
evalúan	Present
cliqueareis	Future
adquirido	Past
tradujeron	Past
esponja	Present
flexionado	Past
desalojar	None
subdivididas	Past
bombardeo	Present
arengaríais	None
rallas	Present
destinadas	Past
destruir	None
pulir	None
afectas	Present
ondeado	Past
fascina	Present
traían	Past
trasponer	None
perderíamos	None
brotéis	Present
riposto	Present
ensanchada	Past
aifoneemos	Present
agobiados	Past
reprocharéis	Future
colgados	Past
nidificando	Present
desembarques	Present
rezando	Present
ansiadas	Past
marchitaren	Future
sobrevenidos	Past
abigarrarías	None
permear	None
fumando	Present
sospechar	None
verifica	Present
sobreexplotado	Past
enfocarían	None
echarse	None
reconsiderando	Present
abanderados	Past
frecuentes	Present
efectivizar	None
consentido	Past
alienaréis	Future
crearían	None
desharía	None
restablecieran	Past
agravé	Past
explosiones	Present
enviudada	Past
brindaría	None
remitió	Past
versificar	None
germinar	None
desprecia	Present
envalentonares	Future
disputaron	Past
soñaré	Future
hermanases	Past
desertar	None
preven	Present
exigirían	None
desdorábamos	Past
influyen	Present
recalentar	None
exaltadas	Past
soleadas	Past
orlas	Present
denostadas	Past
rían	Present
aumentarse	None
desestacionalizarías	None
legalizar	None
reabrirá	Future
pedir	None
poblaron	Past
recompensarás	Future
pertrechada	Past
barbé	Past
repetirá	Future
desaconsejaren	Future
techo	Present
definieran	Past
desclasificado	Past
dinamizaseis	Past
pilotado	Past
resetear	None
rehusar	None
profesaran	Past
surtiría	None
desanimó	Past
perpetuar	None
suplidas	Past
encogida	Past
rojeando	Present
pierdas	Present
reposa	Present
instar	None
minimicen	Present
adquirían	Past
adosaron	Past
externalizada	Past
laboro	Present
enseñarían	None
obtenido	Past
desembolsaría	None
fundadas	Past
usurpes	Present
accedida	Past
pretendieran	Past
efectivizó	Past
frenados	Past
cercenar	None
terminadas	Past
invertían	Past
retribuidas	Past
fotografiadas	Past
propugna	Present
entusiasmó	Past
particularizad	None
desovando	Present
conservo	Present
regaseis	Past
estuvimos	Past
regionalizada	Past
asesinarían	None
obsequié	Past
rizadas	Past
mitigar	None
motivaron	Past
brindaran	Past
dudaríais	None
acordarían	None
enraizábamos	Past
sobrarían	None
llamar	None
equivaler	None
comprendidas	Past
reprobarían	None
taponando	Present
arruinadas	Past
flexionan	Present
amarrado	Past
constituir	None
acometer	None
dispondría	None
hipnotizados	Past
tapiarías	None
zombificarían	None
estandarizada	Past
izar	None
arrastraban	Past
desgarrar	None
narcotizaría	None
retrasada	Past
galardonar	None
latiendo	Present
reanudaría	None
reemplazo	Present
escalar	None
promulgada	Past
entrados	Past
avisan	Present
dejar	None
recaíais	Past
surgirán	Future
rugió	Past
documentada	Past
poseída	Past
rotó	Past
recocinarás	Future
vindicar	None
ennegrecida	Past
decaída	Past
constreñir	None
cristalizan	Present
fluían	Past
asesinados	Past
transcribíamos	Past
fichadas	Past
cosían	Past
conminar	None
mateen	Present
inculpar	None
entrecomillar	None
forra	Present
sospecho	Present
pajaroneásemos	Past
foguear	None
regodearse	None
salvarían	None
encontró	Past
embolsen	Present
privatizado	Past
soterrada	Past
machémonos	None
teletransportó	Past
tocábamos	Past
eludiréis	Future
aléjese	None
aumentaren	Future
husmeando	Present
desfallecierais	Past
tartamudeaste	Past
seduzcas	Present
corrigieron	Past
ofrendaría	None
advenir	None
devueltos	Past
consternado	Past
exportado	Past
bogar	None
pugnaron	Past
enriquezcan	Present
ruralizas	Present
acantilaría	None
demediadas	Past
sobornar	None
recomponer	None
agasajar	None
traducida	Past
apalearon	Past
saturaré	Future
fusionaría	None
explicaran	Past
arremolinado	Past
incubada	Past
desligarías	None
optimizando	Present
dislocar	None
conquistar	None
deberéis	Future
infestaban	Past
acaparada	Past
paladearía	None
desconcentradas	Past
alimentarán	Future
fusiló	Past
aleccionar	None
convierte	Present
convertiríamos	None
atardeceremos	Future
estando	Present
chasquear	None
arriaseis	Past
embaucados	Past
ampliarán	Future
ostentar	None
concurriría	None
ampliaría	None
raes	Present
balar	None
inspiraban	Past
reabrir	None
disecados	Past
proscribiendo	Present
restrinjan	Present
invertida	Past
taconeemos	Present
derrotados	Past
numeradas	Past
influenciarían	None
maltratar	None
censurar	None
practica	Present
sostendría	None
menospreciaron	Past
citaré	Future
jaleas	Present
hacendaría	None
indicará	Future
reabsorber	None
enfermar	None
encontraran	Past
fraccionar	None
carden	Present
sida	Past
rescatar	None
amarraban	Past
formatear	None
enterré	Past
flamead	None
escapa	Present
gatillarás	Future
desconcierten	Present
azuzásemos	Past
comentar	None
adornado	Past
organizasen	Past
inscribid	None
ingenia	Present
dilucidados	Past
avalada	Past
cía	Present
basto	Present
agrietar	None
propaló	Past
alimentados	Past
eclipsarás	Future
fundar	None
censo	Present
cortocircuitar	None
manifestarás	Future
desafiar	None
sampleáremos	Future
nivelado	Past
omitiría	None
defecó	Past
informaron	Past
adelantando	Present
trabajado	Past
beatificados	Past
contagiado	Past
bruñir	None
chisporroteaste	Past
amainarías	None
rapadas	Past
depositaron	Past
simbolizando	Present
templando	Present
culturares	Future
acordonaron	Past
rellenases	Past
aceras	Present
banderilleo	Present
correlacionadas	Past
entreabiertos	Past
ficcioné	Past
entremezclo	Present
estrenadas	Past
prestasen	Past
comenten	Present
depredarías	None
ahechados	Past
arrollar	None
tapices	Present
escatimar	None
prosperen	Present
peroraríamos	None
hubieron	Past
especuló	Past
festejar	None
amagues	Present
palpitar	None
subsidiar	None
clasificó	Past
vedad	None
centrar	None
solicitar	None
respetando	Present
sincronizado	Past
zanjadas	Past
oiría	None
despoblada	Past
trucar	None
ocasionar	None
hallarían	None
acomete	Present
extraviar	None
volvieras	Past
secundaría	None
racionalizar	None
troceado	Past
venenciado	Past
avanzaran	Past
definiría	None
acertar	None
evadiría	None
encuadres	Present
eludieron	Past
encadenadas	Past
dimisionareis	Future
empolvar	None
pitarían	None
adormeced	None
apoquinarás	Future
pregonar	None
agachan	Present
sustraídos	Past
contrastáremos	Future
costaría	None
aprestar	None
revistieron	Past
computará	Future
desengancháis	Present
prohíbe	Present
intricáremos	Future
acoplando	Present
despreciadas	Past
atrapar	None
freír	None
generarían	None
interesen	Present
márchate	None
listar	None
agrupan	Present
disfrutas	Present
narrar	None
cauterizaré	Future
engañados	Past
existimareis	Future
generalizaren	Future
importuna	Present
jalonaban	Past
caeríamos	None
transportaría	None
condonaremos	Future
cacheo	Present
atrevida	Past
mimetizó	Past
reconfigurando	Present
copiaré	Future
monitorizar	None
compartimentar	None
comisionados	Past
amputadas	Past
distribuirá	Future
subyacerías	None
angustia	Present
desnatabas	Past
aplaudida	Past
adoleciendo	Present
infravalorad	None
atrasáremos	Future
trascendió	Past
retrocedería	None
descrita	Past
arribar	None
desactivadas	Past
sonrojar	None
emancipan	Present
entristeció	Past
inculpado	Past
esquilas	Present
compraron	Past
reiniciando	Present
casasen	Past
dedicarían	None
domeñar	None
argumentados	Past
reprenden	Present
exculpabas	Past
excretar	None
singo	Present
añades	Present
curando	Present
desaparecer	None
instalan	Present
exaltaron	Past
rodeo	Present
amoldó	Past
recibían	Past
pacto	Present
desembolsados	Past
llovisteis	Past
computarán	Future
arrasaron	Past
deshelaras	Past
invirtiendo	Present
promueve	Present
terraplenasen	Past
flexionar	None
dataría	None
condicionado	Past
sistematizados	Past
condensaron	Past
estafan	Present
egresaban	Past
tutear	None
atuvo	Past
esquilar	None
moviéndose	Present
desconsideras	Present
cuadrado	Past
poblarán	Future
acoplaríais	None
fabricado	Past
desmadejé	Past
exigió	Past
exhibidas	Past
marcasen	Past
solubilizarían	None
alivianemos	Present
disputa	Present
firmadas	Past
besando	Present
ahorquillada	Past
amplié	Past
apatrullaste	Past
predijeres	Future
ametrallados	Past
subastas	Present
desunir	None
despegaría	None
vengas	Present
aguantarían	None
orna	Present
rebajaría	None
subrogar	None
timbrásemos	Past
discado	Past
encausados	Past
reconvenir	None
multa	Present
grabé	Past
desacomodé	Past
rajar	None
reexaminó	Past
ausentarse	None
cristalizadas	Past
arriado	Past
cocinaría	None
acceder	None
polarizar	None
promocionaban	Past
militarizadas	Past
figuraría	None
soplaban	Past
desvalijéis	Present
simbolizaren	Future
reactivan	Present
distribuirían	None
esforzaron	Past
difundir	None
sería	None
zambulló	Past
recortaría	None
chapalearán	Future
conmover	None
votasen	Past
atracaron	Past
derribar	None
empleas	Present
masacrar	None
desaconsejar	None
entregarían	None
rehecha	Past
acordonarías	None
petardearía	None
roncar	None
avellana	Present
harten	Present
determinó	Past
grabaría	None
desdeñada	Past
agudizaría	None
adaptadas	Past
contravenir	None
arremeterá	Future
diseñados	Past
celaría	None
progresó	Past
convenían	Past
olviden	Present
berreada	Past
enfilar	None
yaciendo	Present
operando	Present
averiar	None
aliviada	Past
brindó	Past
condecorar	None
plisaríamos	None
blandiendo	Present
heredaría	None
venero	Present
soleada	Past
limpiaseis	Past
granizan	Present
metamos	Present
clasificaran	Past
descarboxila	Present
desorganizado	Past
empapó	Past
apañó	Past
hablaría	None
desfasado	Past
caminen	Present
capas	Present
alcen	Present
cobraron	Past
desbarré	Past
estimar	None
inclínese	None
abrevia	Present
instruyendo	Present
sellar	None
retroiluminaríamos	None
denuncias	Present
estrechan	Present
hornear	None
comisionando	Present
interrumpiría	None
fundamentaría	None
biselados	Past
estalla	Present
respaldaron	Past
alegrarse	None
emigraban	Past
inyectaron	Past
emboscaron	Past
desenamoraremos	Future
desfasadas	Past
ligaría	None
estremecer	None
deambulaban	Past
implantarían	None
quédese	None
sumiría	None
comercializada	Past
candidateareis	Future
demonizado	Past
fagocitando	Present
oscurecieron	Past
encalar	None
ensartar	None
flanqueado	Past
orinó	Past
inferir	None
abanderareis	Future
datando	Present
sometidos	Past
empeñen	Present
recompensar	None
reseñada	Past
borbolladas	Past
citen	Present
reunificar	None
asida	Past
enraizando	Present
propinada	Past
inhumar	None
flotaron	Past
etiquetad	None
reclamados	Past
tornar	None
revolotear	None
procesar	None
acompasábamos	Past
administraría	None
repercute	Present
descuidar	None
ceñir	None
pintaban	Past
menearían	None
maceradas	Past
plantarán	Future
recompensado	Past
substituyendo	Present
incentivar	None
contrae	Present
investigaría	None
espacia	Present
compondrá	Future
alocadas	Past
forzado	Past
denotaron	Past
motivados	Past
pinten	Present
rimarían	None
tonificar	None
sobreseídas	Past
basados	Past
insume	Present
auguraron	Past
bebas	Present
redireccionar	None
fagocitareis	Future
abucheado	Past
apoyen	Present
beatificaras	Past
adscrito	Past
despechada	Past
restablecidos	Past
tropicalizar	None
contaminadas	Past
seseo	Present
encabestrásemos	Past
laudábamos	Past
descodificado	Past
mosqueado	Past
viralizo	Present
complementa	Present
asentar	None
arraigaría	None
edificases	Past
respiró	Past
trasformaron	Past
destacarían	None
vaciado	Past
exultad	None
incluían	Past
decepcionados	Past
inoculó	Past
responsabilizar	None
asocio	Present
peinan	Present
avalado	Past
limitarían	None
meriendas	Present
reestablecierais	Past
refugio	Present
recontar	None
sopa	Present
fatigar	None
energizar	None
abrazadas	Past
mezclaría	None
practicó	Past
ensancharon	Past
sulfatado	Past
emulando	Present
humillado	Past
producen	Present
pisado	Past
acantorasen	Past
enderezar	None
vibrar	None
roten	Present
monetizaron	Past
retransmitidos	Past
omina	Present
inscriban	Present
anticiparíamos	None
verificar	None
escapando	Present
mapear	None
accesado	Past
luchan	Present
valgan	Present
plisada	Past
manutuvo	Past
marcadas	Past
fracturar	None
acarrea	Present
reaprovechada	Past
disculpé	Past
empezados	Past
copatrocinabas	Past
aguadas	Past
fragmentar	None
insinúan	Present
reunificaron	Past
destinarán	Future
inscribiría	None
demolerán	Future
fermentando	Present
recomendadas	Past
cronometrado	Past
cateo	Present
maltrataron	Past
enfermó	Past
poblados	Past
afrontar	None
sobrevinieron	Past
motorizar	None
gambeteó	Past
mataselláremos	Future
zanjado	Past
culminaría	None
profundizan	Present
pavimentar	None
obedecen	Present
abasteceríamos	None
enrosca	Present
adocenaseis	Past
pergeñada	Past
cobró	Past
compitiendo	Present
reafirmabais	Past
convidar	None
indultando	Present
desalojan	Present
demoraron	Past
dispersará	Future
machucarán	Future
exid	None
calcificarán	Future
corregir	None
cabrían	None
incendias	Present
contaminado	Past
resignado	Past
respaldar	None
parangonaríamos	None
calculadas	Past
fundaría	None
validada	Past
renombren	Present
aplicó	Past
abastecida	Past
invoquen	Present
descargarían	None
refaccionar	None
dispararán	Future
dragan	Present
sumirías	None
enfadan	Present
reentrando	Present
comedida	Past
dañó	Past
torearé	Future
llenar	None
sumergirá	Future
brinco	Present
medió	Past
coordinar	None
espantó	Past
asilar	None
apestan	Present
aplastabais	Past
parchar	None
merezcan	Present
escobas	Present
independiza	Present
licenciar	None
reprimió	Past
espigar	None
reabastecerá	Future
funcionabais	Past
inspirarán	Future
profanado	Past
rozan	Present
destocaría	None
carecieron	Past
navegaban	Past
reconquistaría	None
desembocando	Present
estarías	None
divisados	Past
alisado	Past
desacelera	Present
banalizar	None
estreno	Present
asignar	None
asumo	Present
saltaría	None
expón	None
remezclas	Present
agotaría	None
agujereará	Future
rentes	Present
penetren	Present
atiesaría	None
renderizados	Past
arreglen	Present
volved	None
simbolizado	Past
asombraren	Future
lesionaste	Past
zurces	Present
desvaneciendo	Present
referirían	None
atentar	None
defendí	Past
fusilando	Present
hiciste	Past
obstruir	None
soldando	Present
incluiría	None
desnaturalizan	Present
lavar	None
incumple	Present
admitir	None
invocas	Present
decora	Present
debatido	Past
sabrían	None
domesticaban	Past
horadar	None
choca	Present
golpeaban	Past
fijado	Past
recriminar	None
entendían	Past
palmotees	Present
reseño	Present
liquidé	Past
apertura	Present
financiadas	Past
intimidados	Past
procesionaría	None
perduro	Present
desinfectada	Past
acotada	Past
gerenciabais	Past
arrinconaras	Past
refaccionó	Past
injuriar	None
aísla	Present
permutar	None
midas	Present
flirteada	Past
zampo	Present
involuciona	Present
sobrepasados	Past
ejecutó	Past
domesticadas	Past
alfombrados	Past
asado	Past
colocarían	None
mirando	Present
desembarazaste	Past
mediría	None
descargará	Future
recular	None
pasmados	Past
gatear	None
siembran	Present
anegaron	Past
marcarían	None
colaboremos	Present
recaudó	Past
intercalada	Past
dejaran	Past
interviniendo	Present
sorprender	None
pesquisaremos	Future
reformula	Present
lavan	Present
ladrar	None
rumiando	Present
confabulados	Past
anotará	Future
desorganizasteis	Past
cimbrado	Past
mezclar	None
comercializará	Future
amanecí	Past
determinemos	Present
triunfaran	Past
arengó	Past
rezumarías	None
martillo	Present
armonizan	Present
salpicando	Present
optimizados	Past
subrogada	Past
esposas	Present
aburrían	Past
escaneada	Past
delegarían	None
deber	None
alboreado	Past
encontraremos	Future
acudieran	Past
empañar	None
asignaría	None
agravío	Present
exploro	Present
veranean	Present
inhibieron	Past
predicada	Past
curtiríais	None
flagelar	None
cocinar	None
bucear	None
aferrados	Past
quito	Present
molí	Past
demandaran	Past
ojear	None
infames	Present
arbitró	Past
escavadas	Past
ocasionan	Present
pasaríamos	None
hurtan	Present
desdibujadas	Past
atribuida	Past
consultaré	Future
apuñalado	Past
fichando	Present
desbloquearan	Past
cubriría	None
densificasteis	Past
ausculta	Present
apatrullarían	None
deconstruir	None
convocar	None
fragmentaras	Past
abrid	None
descarriados	Past
aducidas	Past
confiados	Past
subsumirían	None
siluetead	None
irrespetando	Present
interiorizas	Present
contendió	Past
financiado	Past
adiestran	Present
secuestraron	Past
auspiciada	Past
novelada	Past
deshebrada	Past
garabatearían	None
monitoreando	Present
espolvorean	Present
vallada	Past
maximizareis	Future
conmemoraban	Past
rebozadas	Past
proponiendo	Present
expropiarás	Future
invalidaría	None
vestir	None
doblegaría	None
abusando	Present
checas	Present
aconsejo	Present
anunciada	Past
plantearan	Past
jerarquizado	Past
remontado	Past
enfardabas	Past
remplazados	Past
arreaban	Past
sanciono	Present
justificarían	None
privatizar	None
dificultar	None
vitorearíais	None
aumentarían	None
instigado	Past
dicta	Present
cartografiados	Past
designó	Past
triunfarían	None
atentaría	None
religáramos	Past
saja	Present
convulsionar	None
manufacturados	Past
exaltaríais	None
insultada	Past
sopesa	Present
desorganizaron	Past
suplantado	Past
fijaos	None
reclamarían	None
acondicionasteis	Past
declinaban	Past
militarizada	Past
contribuidos	Past
silenciar	None
suministraría	None
naufragada	Past
calificar	None
penetro	Present
regalado	Past
serruchareis	Future
cavarais	Past
impaga	Present
moldeaban	Past
grillados	Past
ensordecerás	Future
falsear	None
revitalizada	Past
triangula	Present
asumiría	None
decoran	Present
puentear	None
agrediendo	Present
apresando	Present
voleo	Present
admite	Present
materializará	Future
inhumadas	Past
jeringó	Past
socavó	Past
resurgiendo	Present
angustiadas	Past
defienden	Present
acardenalábamos	Past
repele	Present
ripiadas	Past
reorientar	None
infiltrar	None
ampollar	None
diezma	Present
pertenecerá	Future
desembrujaseis	Past
bastar	None
entrevistado	Past
remodelan	Present
picando	Present
ajustarían	None
hormigueo	Present
acidulen	Present
invocará	Future
montarán	Future
conjuran	Present
remover	None
aplaquemos	Present
coreó	Past
sugiere	Present
substraeríamos	None
mediar	None
porten	Present
volvámonos	None
indignados	Past
mecanografiadas	Past
dictados	Past
baquiarán	Future
coarten	Present
ábrete	None
concesionadas	Past
sobreviviesen	Past
aventaras	Past
autoeditado	Past
despenalizasteis	Past
masturba	Present
pedirías	None
abaratar	None
pensar	None
filmarían	None
enseñaría	None
brotar	None
repara	Present
exacerbes	Present
inscriben	Present
bañares	Future
deformados	Past
conocidos	Past
transmito	Present
almendrada	Past
asustaría	None
avala	Present
investigan	Present
mezclemos	Present
solicitaste	Past
necesitaron	Past
pregones	Present
planchas	Present
bailemos	Present
pringasen	Past
decepciona	Present
investigar	None
preparasen	Past
listada	Past
tendrías	None
estribada	Past
activados	Past
consumado	Past
reunificares	Future
pega	Present
comenzaran	Past
pesarían	None
maduro	Present
mantengan	Present
solicitarían	None
reunifican	Present
padecerá	Future
pirateado	Past
dorar	None
multado	Past
premiaría	None
derribaron	Past
tasada	Past
desenvainar	None
calafateo	Present
culpan	Present
prendada	Past
acorrala	Present
abriría	None
listados	Past
justificados	Past
agraviares	Future
laminar	None
aparento	Present
balbuceado	Past
reforestado	Past
parecen	Present
fraccionó	Past
concité	Past
citas	Present
diviso	Present
adama	Present
ahorrarán	Future
organiza	Present
escapado	Past
subo	Present
desprotejan	Present
chocarán	Future
miniaturizadas	Past
goteando	Present
yerro	Present
reinaugurar	None
embeber	None
dirigen	Present
disfracen	Present
imaginando	Present
expandiendo	Present
burlarse	None
expiraría	None
describiría	None
colisionar	None
apartes	Present
variados	Past
notificar	None
atracados	Past
minimizaron	Past
cubrirían	None
consagro	Present
apegarse	None
anexan	Present
arieta	Present
deliberados	Past
recomendar	None
encona	Present
podaras	Past
tiritasen	Past
ingresases	Past
matoneado	Past
cimáis	Present
dictar	None
elaboren	Present
editados	Past
eliminada	Past
cohabitaban	Past
estigmatizar	None
conducirían	None
autodenomínense	None
ingeniaban	Past
pesando	Present
contagiados	Past
dorado	Past
leyendo	Present
retribuyó	Past
chochearán	Future
conspira	Present
desterradas	Past
nutrida	Past
tinto	Present
devolvería	None
solventaría	None
ingresarían	None
organizar	None
encajáremos	Future
solté	Past
aportes	Present
autentica	Present
menguaron	Past
remozad	None
albergó	Past
habi	Present
redistribuíamos	Past
arramplaron	Past
detengan	Present
escobaríais	None
apellidar	None
expliqué	Past
coagular	None
camuflan	Present
creed	None
traslucharíais	None
encola	Present
comprometerían	None
corrido	Past
atribuyes	Present
referiría	None
proponías	Past
chinguemos	Present
consignas	Present
derrumbado	Past
malograron	Past
sobrealimentados	Past
retiren	Present
relanzada	Past
nombres	Present
basculando	Present
congelado	Past
sublevada	Past
arrear	None
devanados	Past
descachadas	Past
uniformizarías	None
engañemos	Present
tumba	Present
enloqueces	Present
dificultaran	Past
agotará	Future
saturó	Past
sumar	None
asolar	None
diamantaban	Past
domar	None
dejarían	None
supongamos	Present
envenenar	None
caer	None
apartaron	Past
chorearías	None
aparecerá	Future
concesionábamos	Past
quebrará	Future
analizando	Present
pegaríamos	None
trepidases	Past
embolsadas	Past
electrizarían	None
introducido	Past
alojarían	None
escapen	Present
romanzáis	Present
asesorará	Future
relegar	None
rastreados	Past
atestigüen	Present
interiorizada	Past
falsas	Present
contrastes	Present
distorsionaban	Past
inhalar	None
atemorizar	None
cambia	Present
evaluaban	Past
infravalorado	Past
titulé	Past
rondó	Past
desaprobar	None
nombró	Past
derramadas	Past
acampaban	Past
concurren	Present
enredáremos	Future
ensombreceríamos	None
culmino	Present
atrevemos	Present
convertirse	None
desacostumbremos	Present
erguir	None
acompañaría	None
allana	Present
repulsé	Past
interdirás	Future
convencieran	Past
echaré	Future
alistaran	Past
adscrita	Past
localizaran	Past
auspiciaste	Past
transmitieran	Past
clamabas	Past
alejarían	None
aconsejaría	None
subvenciona	Present
colindando	Present
medicado	Past
admiró	Past
bases	Present
imploraron	Past
extenderían	None
auditada	Past
enviar	None
fantasearán	Future
hurtemos	Present
desenmascara	Present
mezclo	Present
manejaron	Past
reparadas	Past
obsequiares	Future
chifles	Present
proveían	Past
crecerías	None
interactuar	None
apretando	Present
transigí	Past
ofendidas	Past
recompensaron	Past
contendrá	Future
vendió	Past
sindicadas	Past
desamistes	Present
entrevinisteis	Past
burocratizada	Past
codificaron	Past
endulzar	None
deseando	Present
complementado	Past
pedí	Past
contrabandeado	Past
destacen	Present
errados	Past
acuestan	Present
residenciados	Past
escariado	Past
forjar	None
inflando	Present
escalonados	Past
instrumentado	Past
embalsamaréis	Future
achica	Present
alabarían	None
supeditada	Past
rediseñar	None
vertebrar	None
anilla	Present
elogiado	Past
desbrozados	Past
resultarían	None
reglas	Present
herían	Past
amagó	Past
baló	Past
disciplinar	None
salteando	Present
destila	Present
rondaban	Past
compilando	Present
recopilabas	Past
adecuan	Present
coincidirá	Future
estragásemos	Past
habladas	Past
evitarás	Future
imposibilitaría	None
debatiendo	Present
entenderían	None
escoltando	Present
sobrevivieran	Past
ilustraban	Past
empezarían	None
reeditando	Present
coprodujo	Past
temían	Past
caneo	Present
ilegalizabas	Past
engruesa	Present
decelerábamos	Past
narro	Present
cruzarían	None
protestó	Past
denotan	Present
halléis	Present
cerrando	Present
subrogado	Past
abarcaban	Past
destinaría	None
trazó	Past
sustanciar	None
resguardáremos	Future
acomodar	None
perjura	Present
despreciado	Past
incendio	Present
evangelizados	Past
leería	None
chistaríamos	None
rapiñas	Present
helar	None
permitirían	None
enjuiciando	Present
ambientó	Past
prevén	None
infundieres	Future
atraparan	Past
conduces	Present
listó	Past
colabores	Present
contrarrestarán	Future
navegaría	None
desordena	Present
encarcelar	None
edificaban	Past
revoluciones	Present
defraudadas	Past
raspo	Present
granulado	Past
apostaría	None
prorrogado	Past
contratará	Future
refutar	None
popularizadas	Past
excavéis	Present
relativizarían	None
gusto	Present
tamizado	Past
debido	Past
parlen	Present
muero	Present
exhumaréis	Future
posponer	None
contratado	Past
embarquen	Present
pastorea	Present
fornicar	None
anualizarán	Future
deduzco	Present
aburrió	Past
reabriendo	Present
encomienda	Present
arbitrando	Present
rebullirán	Future
comulgar	None
sonorizan	Present
denominarían	None
aprisionada	Past
presionando	Present
negociará	Future
concernidas	Past
encamado	Past
exclamo	Present
acidifica	Present
hidratan	Present
superará	Future
sumarían	None
dotadas	Past
enganchada	Past
socorriendo	Present
regocijemos	Present
agendada	Past
arreciarían	None
despareciendo	Present
espeto	Present
dijesen	Past
fabricar	None
rebajo	Present
escarbaseis	Past
preocupar	None
adaptarían	None
homologados	Past
excarcelar	None
influencia	Present
surfeo	Present
detentaría	None
liderados	Past
hidratados	Past
quedan	Present
toleraría	None
afiliaría	None
hackeaseis	Past
hospitalizaríamos	None
columpiarán	Future
perpetrar	None
estimemos	Present
trascender	None
enaltecer	None
destinar	None
engalanar	None
orquestar	None
caduca	Present
enlazaron	Past
okupada	Past
indiciabais	Past
pensarías	None
descompone	Present
incorporaré	Future
lograría	None
embarcaran	Past
neutralizares	Future
acepten	Present
ceñida	Past
fagocitar	None
atormentaremos	Future
migré	Past
lapidar	None
incoabais	Past
palidece	Present
independizaría	None
sumaría	None
desempeñando	Present
incomunicado	Past
estudiarían	None
agotó	Past
declinaríais	None
coge	Present
remozar	None
tenemos	Present
fibrilar	None
contemplado	Past
notar	None
substituido	Past
tachonados	Past
digno	Present
persigan	Present
pretendió	Past
libar	None
rozando	Present
palidecen	Present
estelarizarías	None
coquetearé	Future
diagnostican	Present
permitir	None
agradezco	Present
abrumar	None
restringirías	None
apelo	Present
reclinada	Past
acostumbras	Present
gangueada	Past
remató	Past
sobrevoló	Past
desembrujarán	Future
miraran	Past
vende	Present
inscribían	Past
exiliad	None
desproteger	None
rebuscases	Past
afeitó	Past
tardan	Present
saliste	Past
circuncidado	Past
testimonia	Present
punteé	Past
proliferaron	Past
precalentar	None
externar	None
intentar	None
apresura	Present
entrelazadas	Past
notifican	Present
aclaras	Present
aterrizar	None
pospondríais	None
reinas	Present
inserten	Present
violes	Present
planificar	None
desendeudéis	Present
transformemos	Present
agrietas	Present
mallen	Present
involucran	Present
sellaría	None
afeitarse	None
vapulear	None
anticipados	Past
despeinan	Present
estar	None
acumularía	None
muelas	Present
sufran	Present
liberadas	Past
acampa	Present
destello	Present
plasmaríamos	None
mojo	Present
interaccionan	Present
clones	Present
rearma	Present
convocan	Present
diseccionados	Past
debatían	Past
refundir	None
encarnará	Future
reconfigurados	Past
humedecieres	Future
encarrilar	None
cercenabais	Past
tacones	Present
sobornada	Past
alternarían	None
propusimos	Past
bajad	None
despiezar	None
reembolsar	None
balear	None
arqueando	Present
eructen	Present
ayudan	Present
liberaran	Past
comisionado	Past
reformularon	Past
predijo	Past
delatar	None
esparcir	None
comunicaron	Past
estofado	Past
voceaseis	Past
sucitarían	None
rodeada	Past
llenen	Present
abstergerá	Future
grado	Present
contratarían	None
roto	Present
acordó	Past
caracterizará	Future
amoblado	Past
hackear	None
trasplantes	Present
amaran	Present
segundo	Present
negando	Present
demodular	None
tranquilizada	Past
reteniendo	Present
ciarían	None
recriminó	Past
fletar	None
reacondiciona	Present
formalizo	Present
cosquilleo	Present
clamar	None
destrepéis	Present
conformaran	Past
aplica	Present
amoldaron	Past
escobar	None
afilan	Present
alumbrarse	None
combinarán	Future
reserven	Present
engañar	None
atropellado	Past
entornas	Present
vomita	Present
descompuestas	Past
engrandezcan	Present
entorpezcan	Present
tenderían	None
rehecho	Past
repelo	Present
situarían	None
resquebrajar	None
contabilizaban	Past
deberían	None
antecedido	Past
quemaseis	Past
manutienes	Present
apropiáis	Present
exhibiendo	Present
cursó	Past
gozarían	None
acidularíamos	None
cuantificar	None
seríamos	None
acantilada	Past
pulí	Past
implementará	Future
escavasen	Past
intensificarían	None
evocando	Present
independizar	None
traducirían	None
enfadar	None
davilado	Past
sugieres	Present
tumbada	Past
renovó	Past
distrajeron	Past
dudar	None
danzarían	None
valer	None
forró	Past
complacisteis	Past
confirmando	Present
pilotará	Future
encueraseis	Past
recoges	Present
retorno	Present
llamarse	None
encuadernar	None
alegraos	None
caldeas	Present
pisoteo	Present
gravan	Present
pagaban	Past
complicarais	Past
servir	None
arruinar	None
sonríe	Present
retraíais	Past
amontonaban	Past
especiada	Past
destartalarás	Future
enfurecidos	Past
enmugras	Present
limar	None
idealizó	Past
compensada	Past
incardinada	Past
lindas	Present
apliques	Present
aliado	Past
orino	Present
aplaudiríamos	None
textea	Present
dijeron	Past
desorejares	Future
desenvainares	Future
cenó	Past
colindan	Present
aumentaran	Past
impacientaría	None
tableteemos	Present
patentar	None
obstaculizar	None
aletear	None
encastrada	Past
reaparecerá	Future
codear	None
desabrochareis	Future
dibujando	Present
redundaríais	None
reforzar	None
excavados	Past
acanaladas	Past
encontrarías	None
anotaran	Past
amaga	Present
reclutará	Future
tardaban	Past
buceando	Present
substituida	Past
rehusada	Past
eclipsaría	None
deambular	None
distingamos	Present
liberar	None
embistió	Past
miniaturizado	Past
retendré	Future
recolectó	Past
dominarían	None
molestaron	Past
reescribir	None
bordear	None
brutalizaren	Future
cifra	Present
recurrirían	None
constelaren	Future
desparrama	Present
actuar	None
permitió	Past
amordazar	None
describe	Present
apalear	None
ensartáramos	Past
mandan	Present
trapearíamos	None
testimoniar	None
entrampas	Present
afirmarían	None
ahorquillaseis	Past
desinvirtiendo	Present
instabas	Past
tendemos	Present
recapturar	None
aerasen	Past
repescar	None
mejora	Present
altercabas	Past
ofuscáis	Present
priorizar	None
tañidos	Past
sugestionaría	None
desmentir	None
arreglar	None
viciaran	Past
caído	Past
censar	None
surgieron	Past
irradiada	Past
muere	Present
diferenciar	None
descontar	None
aletargaríais	None
indujeron	Past
indujimos	Past
secundar	None
auxiliarías	None
tarden	Present
debutarían	None
agudiza	Present
danzo	Present
recitando	Present
apresurados	Past
consolidó	Past
cubierta	Past
desocupadas	Past
tergiversar	None
amalgamas	Present
abarloar	None
encauzada	Past
agruparían	None
prestaría	None
descuidan	Present
empequeñecer	None
conceptualizar	None
preservaban	Past
sepas	Present
desencadenando	Present
egresar	None
procrea	Present
recalcar	None
propago	Present
tramitabas	Past
trastabillaréis	Future
añadamos	Present
sobornó	Past
refloto	Present
acudiría	None
antecedieron	Past
escatimaron	Past
realizan	Present
angosto	Present
descascarillado	Past
abarbetar	None
avalaría	None
resumieron	Past
remitiría	None
occidentalizar	None
desapasionarías	None
esgrimido	Past
hozan	Present
trasladarais	Past
desasí	Past
devaluar	None
transbordar	None
eyectadas	Past
dinamitaron	Past
empequeñeciéramos	Past
encubrió	Past
criticar	None
fotografían	Present
conquistarían	None
derivadas	Past
identificarán	Future
retorcer	None
sobreseyó	Past
reestructurad	None
aterrizo	Present
advierte	Present
subseguirá	Future
lastimarse	None
retractar	None
cifraban	Past
vago	Present
ignoremos	Present
polinizan	Present
pontificar	None
escolarizar	None
bombeadas	Past
levigasteis	Past
abastionaría	None
derraparíamos	None
tesemos	Present
parapetados	Past
besé	Past
trasvasa	Present
fusilaron	Past
irritó	Past
desperdiciando	Present
coludáis	Present
navegar	None
produces	Present
trozaríais	None
depredados	Past
encaraman	Present
abarloen	Present
decreta	Present
abarracarías	None
reprobada	Past
saturaríamos	None
comprando	Present
eliminará	Future
dimensiones	Present
conmutando	Present
ejercerá	Future
explica	Present
relanzan	Present
profesa	Present
perpetraríamos	None
divisar	None
mordieron	Past
traspasada	Past
empedraríamos	None
contabilizaron	Past
escucharan	Past
misáremos	Future
concatenar	None
coreografiaseis	Past
admitirán	Future
independizándose	Present
embutir	None
casaría	None
meditarían	None
cooperasen	Past
informando	Present
nadas	Present
aislar	None
aperturas	Present
satisfecho	Past
pervertidas	Past
luchad	None
estirar	None
alojará	Future
embaldosado	Past
desencabestrásemos	Past
transmitiría	None
preocupes	Present
arrojaríamos	None
escarpabais	Past
aliaran	Past
aliséis	Present
celebraría	None
derriten	Present
proceder	None
transformaron	Past
faja	Present
medica	Present
alertando	Present
nominar	None
vaciada	Past
contradicen	Present
serviría	None
subastarás	Future
aclararía	None
despojada	Past
empezaran	Past
deificaríamos	None
retraducir	None
premurió	Past
agreguemos	Present
aperturó	Past
emocionaren	Future
mendigaría	None
investigando	Present
emparentadas	Past
repiten	Present
abanderé	Past
apegadas	Past
desenamoraría	None
legislando	Present
untadas	Past
entera	Present
portados	Past
ajardinar	None
inclinan	Present
administrarían	None
enlazarían	None
experimentada	Past
involucraría	None
aplicarían	None
sostenida	Past
acerado	Past
apelotonaban	Past
repudio	Present
inspeccionadas	Past
elegid	None
inclinarán	Future
cazaron	Past
ensayada	Past
ilegalizó	Past
entubada	Past
desabrocharais	Past
dilapidaré	Future
cursar	None
erigían	Past
muten	Present
filma	Present
apropien	Present
tocaran	Past
sepáis	Present
resignando	Present
sostuvieron	Past
actualizases	Past
hablad	None
drogaremos	Future
concluyesen	Past
asombró	Past
eludiendo	Present
desabejasteis	Past
hospedaban	Past
despreciada	Past
expulsaría	None
entrecortadas	Past
reino	Present
devuelto	Past
espejeo	Present
soportar	None
haríamos	None
divagando	Present
aludan	Present
menoscaban	Present
colectados	Past
entrecruzar	None
concebidos	Past
expulso	Present
activada	Past
aligerando	Present
aturar	None
obligando	Present
desamortizaste	Past
trama	Present
rifar	None
cloqueares	Future
biselarías	None
ordenando	Present
sancionarían	None
fastidian	Present
divergen	Present
respetan	Present
resuman	Present
formulé	Past
exaltar	None
curvas	Present
arrecirás	Future
desvirtuar	None
retumbar	None
donará	Future
aflojaren	Future
granjearon	Past
atribuiría	None
zambullirán	Future
diría	None
encallecieran	Past
entrevistar	None
amarse	None
presume	Present
emprendieron	Past
moderado	Past
novarían	None
manifestará	Future
desvencijaré	Future
abriendo	Present
redescubierta	Past
enviarían	None
curioseases	Past
palideció	Past
amordazado	Past
precipitarían	None
grilló	Past
activadas	Past
alquitranen	Present
reencauzabas	Past
recayó	Past
concurridas	Past
condonar	None
ambicionaban	Past
extendió	Past
liquidaría	None
presuponiendo	Present
adelgaza	Present
aludir	None
invitas	Present
radia	Present
desembolsarás	Future
digitalizado	Past
abigarrabas	Past
espesares	Future
postensad	None
estudiar	None
pugnado	Past
inducir	None
homogeneizado	Past
rememorada	Past
seducirá	Future
sampleados	Past
colocaran	Past
nombras	Present
colindar	None
unan	Present
gorrear	None
emiten	Present
quemados	Past
pasaban	Past
crujido	Past
escayolar	None
decapitados	Past
emborrachar	None
mezclasen	Past
modificarían	None
expongo	Present
delimitarías	None
perrea	Present
reunir	None
traficar	None
turisteadas	Past
respondidas	Past
estaría	None
diagnostica	Present
fondeado	Past
informándose	Present
edificaron	Past
admitidas	Past
midiendo	Present
revitalizaron	Past
resaltado	Past
contarán	Future
reencantases	Past
desbanqué	Past
adentrarse	None
agrega	Present
evaluar	None
demandé	Past
provengan	Present
corrige	Present
entresacaste	Past
nivelar	None
pinchas	Present
interpelado	Past
democratizar	None
apropiado	Past
reconstituyeron	Past
distinguiría	None
sellarían	None
reintegraron	Past
atinó	Past
arruinará	Future
desaprobaban	Past
cayesen	Past
pastaban	Past
expresé	Past
enlazar	None
tildan	Present
percibís	Present
desmenuzar	None
rezumaren	Future
agregada	Past
disputarán	Future
proviene	Present
recalaras	Past
responded	None
ocurrir	None
despojó	Past
pinchado	Past
revivieras	Past
apretó	Past
bracearíamos	None
radicalizándose	Present
osar	None
lamentada	Past
recrudecer	None
dignó	Past
prologados	Past
mejorarían	None
toser	None
zumbado	Past
actualizaré	Future
prosperó	Past
aprehender	None
titres	Present
restregaríamos	None
complejizaríais	None
soplado	Past
disonaríais	None
contemporizar	None
desparramar	None
descomponer	None
persigues	Present
afincáremos	Future
falseadas	Past
desperdiciéis	Present
indignar	None
recuperaran	Past
decepcionares	Future
rebeló	Past
libra	Present
teclea	Present
reinstalaron	Past
hacendemos	Present
formalizadas	Past
hartan	Present
infravalorar	None
comentada	Past
acicalar	None
relee	Present
proveerían	None
pelear	None
tripulando	Present
comprendí	Past
renacería	None
anhelaban	Past
embarcó	Past
residiría	None
titulo	Present
reversarías	None
currar	None
reblandecerías	None
alimentarían	None
discriminar	None
derretiría	None
disparareis	Future
embriagan	Present
galardona	Present
escalaría	None
bifurcó	Past
visualicemos	Present
clareo	Present
sitiadas	Past
desprestigian	Present
ofreció	Past
abrazaran	Past
entresacados	Past
inflamadas	Past
expele	Present
condenas	Present
transcurridas	Past
yacían	Past
compagina	Present
sirvieron	Past
fíes	Present
promulgó	Past
disputados	Past
sesgadas	Past
chorreado	Past
aclamaban	Past
internalizad	None
concedieran	Past
comportará	Future
encadenaren	Future
decretaría	None
asestarías	None
ocupar	None
destacará	Future
mella	Present
traslado	Present
anidando	Present
vinculados	Past
declinar	None
expulsaran	Past
aventaja	Present
deprimidos	Past
avizorarías	None
duchad	None
elaborado	Past
atribuir	None
acurrucaseis	Past
diseñaría	None
bloca	Present
reeditar	None
reconquistarías	None
pilotados	Past
incorporarían	None
extingan	Present
inquinaríamos	None
tranzásemos	Past
degradados	Past
cuestionen	Present
murásemos	Past
accionaban	Past
anticipar	None
repaso	Present
rasurar	None
azucararías	None
preservados	Past
crujir	None
ajusticiada	Past
acarició	Past
aparca	Present
vinculadas	Past
crispado	Past
erige	Present
enfrentaría	None
aventajaran	Past
apoyarse	None
empeorar	None
exudado	Past
descolocásemos	Past
lavaré	Future
gradas	Present
fatigado	Past
espachurrarías	None
retrograda	Present
ilustren	Present
petrificar	None
inmovilizar	None
antojó	Past
emocionaron	Past
detendrían	None
acordasen	Past
comparada	Past
costaron	Past
okupa	Present
coartada	Past
descontaminar	None
originado	Past
capturen	Present
repuntó	Past
ocultarse	None
callen	Present
parodiadas	Past
degustados	Past
corto	Present
enrolaríamos	None
jalando	Present
litarás	Future
objetan	Present
volver	None
empinaría	None
aprendería	None
impactadas	Past
chapoteáis	Present
colisiona	Present
modularizaran	Past
encaminaron	Past
valorizar	None
embolsaren	Future
compiladas	Past
parapetaron	Past
sitian	Present
fusionarán	Future
centrifugado	Past
interiorizásemos	Past
descarrilaríamos	None
financiar	None
delinquís	Present
desbordaban	Past
desosegaríamos	None
añadiría	None
influyeran	Past
increpar	None
indispondrían	None
angostada	Past
graficáis	Present
desprecintó	Past
transferiría	None
complementará	Future
impulsarían	None
santificados	Past
tapies	Present
eructar	None
disfrutes	Present
agitaríamos	None
elucubrar	None
caducan	Present
retocar	None
comenzaré	Future
argumentaría	None
mediado	Past
añadid	None
desvalorizada	Past
concebidas	Past
asesinar	None
oras	Present
descongelando	Present
separados	Past
sobreentendidos	Past
distinguirán	Future
aprobarían	None
trasmitir	None
segundaré	Future
presento	Present
saldaría	None
sal	None
congregabas	Past
motorizados	Past
amaestrados	Past
interesar	None
regalonear	None
enlentecer	None
doblegar	None
neutralicé	Past
restructurar	None
avisaría	None
consuelan	Present
convertí	Past
quema	Present
cliquear	None
interrumpían	Past
pastoreo	Present
encuestarais	Past
anquilosásemos	Past
aludiría	None
alunizar	None
presidir	None
digitaron	Past
incorporarán	Future
emanar	None
delimitan	Present
presintió	Past
agradecerían	None
sabed	None
completar	None
ensoñaría	None
calificaran	Past
levantan	Present
voy	Present
manufacturar	None
cohabita	Present
limaré	Future
fagocitaseis	Past
ocluidos	Past
realizaste	Past
intimas	Present
intervine	Past
diversificarás	Future
cooperando	Present
peatonalizar	None
cubrió	Past
traspasar	None
agorarías	None
estirarás	Future
expulsaban	Past
divirtiéndose	Present
subyace	Present
asad	None
espían	Present
quitaré	Future
pareciesen	Past
tocases	Past
empollarían	None
arramplaréis	Future
listadas	Past
trasegar	None
conmocionar	None
decodificarías	None
reencantasen	Past
atontado	Past
atenerse	None
asustarse	None
expiar	None
mandar	None
apagándose	Present
granulada	Past
engrosó	Past
desmantelado	Past
alisar	None
mostraremos	Future
dispensen	Present
conllevó	Past
proseguir	None
tiñen	Present
oficiados	Past
atacan	Present
conciliares	Future
personaliza	Present
asecho	Present
convocaría	None
expeler	None
entablado	Past
deben	Present
rebosar	None
aclamando	Present
gatillo	Present
atajadas	Past
dañan	Present
valsa	Present
asir	None
cultivar	None
influidas	Past
licuado	Past
remezcla	Present
copio	Present
concitarían	None
destetarais	Past
aplomado	Past
cooperaron	Past
crisparéis	Future
ceba	Present
corrigieran	Past
atenuaría	None
aprendo	Present
apoderasen	Past
amaestrado	Past
nominan	Present
acordaría	None
mantendrían	None
aquilatar	None
imprimieseis	Past
arrasaría	None
rebasar	None
explicaron	Past
bombearíamos	None
empaqueto	Present
respaldada	Past
compartimenta	Present
valdrían	None
promovería	None
bloqueé	Past
digito	Present
redondea	Present
barban	Present
regalar	None
extirpan	Present
pintó	Past
subsidies	Present
deterjáis	Present
reconstruyen	Present
retiñen	Present
contrasto	Present
flipa	Present
vayamos	Present
apoquinaría	None
razonó	Past
recuerdan	Present
evocada	Past
surcar	None
paralizaran	Past
canalizando	Present
suscribe	Present
envidiar	None
retratemos	Present
finalizaban	Past
negociar	None
puntualizar	None
ofertaban	Past
reconstruir	None
sobresaldría	None
conseguirían	None
perdí	Past
atornillarían	None
considérense	None
sensibilizaste	Past
centellea	Present
indexa	Present
elaboran	Present
expedientabas	Past
titulado	Past
restauraron	Past
inmolar	None
apurada	Past
aprender	None
acartonarais	Past
complica	Present
rubricarían	None
reduciría	None
recibido	Past
manejadas	Past
timar	None
canea	Present
manifestarán	Future
medien	Present
viran	Present
engarrucháis	Present
vacilando	Present
acostumbrar	None
segundad	None
trasporto	Present
escondiendo	Present
hilvanar	None
idolatraron	Past
interesará	Future
intrusarán	Future
trocearemos	Future
oyó	Past
volaré	Future
insertar	None
abovedaban	Past
participaste	Past
satirizada	Past
enfundadas	Past
sobresaltado	Past
saludando	Present
advierten	Present
expresados	Past
conferirá	Future
pillando	Present
acota	Present
solucioné	Past
descogollases	Past
competeré	Future
desarrolló	Past
escindidas	Past
combinar	None
expedirá	Future
decaería	None
heredasen	Past
calmar	None
precisas	Present
capitularon	Past
limpiarse	None
beneficiarían	None
castra	Present
gastada	Past
disculparía	None
materializaría	None
pulses	Present
amaño	Present
desintoxicar	None
aspiro	Present
enseñadas	Past
inventariados	Past
desposar	None
empeoran	Present
labra	Present
reivindicaríais	None
ilustraron	Past
coreografía	Present
arrestan	Present
convenciendo	Present
averiaseis	Past
derramar	None
invistió	Past
siéntanse	None
fracasen	Present
abofetearías	None
giro	Present
solfeo	Present
realicé	Past
amortizar	None
realojarían	None
cacheada	Past
restituyeron	Past
engrilla	Present
borbollaremos	Future
recitabais	Past
mitigados	Past
costar	None
hojear	None
interrelacionasen	Past
vadearían	None
desratizados	Past
escucharían	None
desacertado	Past
ofrendada	Past
vertido	Past
incomodar	None
acaudillaríais	None
cortaban	Past
acariciases	Past
sobrestimaríamos	None
silban	Present
resguardaban	Past
conllevarían	None
rendirá	Future
sugeriste	Past
proseguirá	Future
quebrar	None
mediatizadas	Past
cuestionará	Future
fallarían	None
estudiarán	Future
escaldo	Present
tantead	None
adverasteis	Past
metalizarían	None
faltarías	None
quebrantadas	Past
refacciona	Present
sobrevendría	None
firmarían	None
enchilaremos	Future
recayendo	Present
sostendrían	None
alternan	Present
crucificadas	Past
recuperar	None
abrumado	Past
agencias	Present
pasé	Past
exponemos	Present
elogiar	None
reflejaría	None
fanfarronearían	None
acusé	Past
deliberando	Present
compulsad	None
sobreestima	Present
equivoquen	Present
funcionar	None
picado	Past
fabricaríamos	None
guerrear	None
amplificaron	Past
unificando	Present
basada	Past
seccionada	Past
fajar	None
propasaren	Future
compactar	None
infatúo	Present
ahínco	Present
borda	Present
eclosionen	Present
tildarse	None
plastificad	None
destrozadas	Past
suspendidas	Past
niveles	Present
finiquitado	Past
firmaron	Past
descascarillarían	None
rogad	None
subsanases	Past
seleccionaría	None
imposibilitábamos	Past
equivaldrían	None
discutido	Past
enjaular	None
emprenderían	None
fallaron	Past
desconsolados	Past
cecearán	Future
gestionan	Present
conjugados	Past
calmó	Past
litigados	Past
costeó	Past
gestaste	Past
prorrateo	Present
ruego	Present
chequear	None
aguanten	Present
invadan	Present
invocaron	Past
mencionaste	Past
exhibieron	Past
recompensadas	Past
simplificando	Present
soportaseis	Past
imprecaras	Past
juntarse	None
fracasaría	None
altero	Present
electrificada	Past
reclamar	None
fío	Present
desatiende	Present
pujaréis	Future
referí	Past
marginando	Present
descogollados	Past
encubertabais	Past
descentralizada	Past
parlamentó	Past
jalen	Present
reproducirse	None
eludido	Past
ilustrar	None
fichados	Past
asombrados	Past
enjaretado	Past
amenazaría	None
enjuagadas	Past
reían	Past
percibiríamos	None
subsanados	Past
bufarán	Future
guionada	Past
merecerían	None
pagará	Future
transferir	None
casares	Future
aloja	Present
modeliza	Present
embestir	None
guarda	Present
desleís	Present
recapitular	None
participemos	Present
testear	None
luchasen	Past
acortadas	Past
notaran	Past
remiten	Present
fosforilar	None
encumbraren	Future
lego	Present
asumida	Past
esposados	Past
trastornado	Past
completados	Past
alcanzado	Past
cagada	Past
fabricaría	None
realizas	Present
disgustó	Past
posibilitaríais	None
rematada	Past
subsistiré	Future
connotar	None
rasgó	Past
cansar	None
disipan	Present
mecanizadas	Past
dispararían	None
sufrirás	Future
tintineaste	Past
gradúan	Present
alargada	Past
sugestiones	Present
agradecerán	Future
aerografiarás	Future
desfilo	Present
quedarse	None
proseguiría	None
abarren	Present
espolvoread	None
taquillas	Present
pulularas	Past
acometiste	Past
izó	Past
rehuyendo	Present
habituada	Past
aprecio	Present
recubierto	Past
timbrados	Past
amistabas	Past
inactivaban	Past
descolgó	Past
saboteado	Past
completaban	Past
bailen	Present
subiré	Future
emparentaran	Past
agraviar	None
botados	Past
deslenguaré	Future
ambientar	None
incidiría	None
agregaría	None
normalizada	Past
arrancaría	None
negado	Past
diluida	Past
arromaríamos	None
mené	Past
reflejar	None
debitabas	Past
dilatar	None
pepené	Past
implosionabas	Past
ondularíamos	None
derivar	None
imposibilitaste	Past
aburrir	None
bañaban	Past
provocas	Present
esquilmaría	None
intercalar	None
reiniciado	Past
purgaría	None
vaporizar	None
esmaltados	Past
dictaría	None
desperdicia	Present
produciría	None
retorcida	Past
sacrificaban	Past
sensibilizada	Past
pellizcadas	Past
brillará	Future
socarro	Present
manipular	None
engrosando	Present
mulleras	Past
orientaban	Past
amaestraré	Future
cancelada	Past
adjetivar	None
prepararan	Past
desilusionar	None
licencian	Present
ampliando	Present
aprovechasen	Past
arramblaremos	Future
desarropaseis	Past
corriéndose	Present
habrían	None
convertiría	None
residenciada	Past
estriaren	Future
incoar	None
mellar	None
envasó	Past
enfriada	Past
ajustan	Present
fumaban	Past
ablandan	Present
holgazaneares	Future
reorganizados	Past
callaos	None
necesitarían	None
cintiladas	Past
clavaríais	None
partidos	Past
malinterpreté	Past
taconea	Present
proporcionaran	Past
expurgada	Past
dejases	Past
encarar	None
encabrito	Present
evocaban	Past
procesionado	Past
encontráramos	Past
repliega	Present
permaneciendo	Present
canalizada	Past
indispuesta	Past
inflamado	Past
curtiesen	Past
provendría	None
incumplió	Past
resguardarse	None
saboreado	Past
enfadó	Past
defended	None
evolucionó	Past
autenticados	Past
manchas	Present
enrevesaran	Past
relegado	Past
aherrumbráramos	Past
evitaríamos	None
seducir	None
arrebatados	Past
entablad	None
depositaban	Past
succionó	Past
contiendas	Present
reseteo	Present
atenuaron	Past
arquea	Present
coadyuvada	Past
pungían	Past
reaprovechadas	Past
constató	Past
marcado	Past
reputa	Present
formularía	None
germanizar	None
financia	Present
mandadas	Past
adjudicaron	Past
amplificada	Past
despintaríamos	None
escrutar	None
madreaban	Past
lechada	Past
traicionar	None
contonearía	None
relameríais	None
quejaron	Past
simbolizarían	None
interconectar	None
litigar	None
desactivaron	Past
emuladas	Past
tachonado	Past
soplados	Past
miniaturizáramos	Past
tachar	None
redujeran	Past
imbuir	None
develó	Past
levantará	Future
abigarrada	Past
desperdiciar	None
atrincherada	Past
empujando	Present
aniquilaríais	None
confiscan	Present
desespero	Present
triangularían	None
estancados	Past
salen	Present
soplaron	Past
ahonda	Present
salten	Present
erré	Past
variará	Future
fritando	Present
cepillar	None
faenas	Present
reurbanizar	None
comunicar	None
reinstaurar	None
jubiles	Present
desencadenarían	None
tender	None
desisten	Present
agonizar	None
caerían	None
abejorrearías	None
redistribuyendo	Present
resucitan	Present
desdichas	Past
abundar	None
perdonéis	Present
emplees	Present
valoren	Present
bailado	Past
radiquen	Present
enfriará	Future
repintar	None
abstenida	Past
facilitaban	Past
conquistarán	Future
maravillarse	None
arrebataría	None
partiría	None
mojan	Present
recaudaría	None
columbráremos	Future
intervendría	None
bombardearon	Past
socializar	None
ruborizad	None
reordenado	Past
desocupar	None
desmochadas	Past
especifiquen	Present
atenazaríais	None
adjuntó	Past
renegaría	None
condonó	Past
identifica	Present
subastada	Past
gandujareis	Future
regalan	Present
confines	Present
reescribieron	Past
escalas	Present
circunferirías	None
monda	Present
ahorcando	Present
atar	None
activaría	None
dilatada	Past
diseñada	Past
retocé	Past
reivindicaría	None
cursaran	Past
apilada	Past
tiroteados	Past
reclutasen	Past
comisionaron	Past
valoradas	Past
resucitar	None
confíen	Present
reinscrito	Past
denuncien	Present
disparar	None
vertidos	Past
operar	None
adobado	Past
abarcaron	Past
remarcan	Present
interpretar	None
contradichas	Past
zahieras	Present
apoderarse	None
acogeré	Future
descendidos	Past
arropan	Present
enrancian	Present
trasladar	None
culearas	Past
oteando	Present
catalogareis	Future
colmados	Past
gestionada	Past
mereciendo	Present
customizar	None
movían	Past
bifurcándose	Present
atomizar	None
cespitarías	None
aguaitabais	Past
conformarse	None
enamoraseis	Past
desencadenar	None
trenzará	Future
afianzaban	Past
agujeres	Present
estafar	None
embauca	Present
tronchábamos	Past
trasferir	None
entremezclando	Present
desconocidos	Past
agudizarais	Past
notarían	None
becada	Past
deseó	Past
precisar	None
bombardear	None
fagocitado	Past
incurran	Present
azafranáremos	Future
recabaron	Past
ilusiona	Present
radiaríamos	None
turnarían	None
solapases	Past
encuadernados	Past
quejarse	None
esquía	Present
manifestó	Past
alaban	Present
viviría	None
evidenciar	None
supriman	Present
llenó	Past
aproximen	Present
inhibida	Past
rules	Present
renunciarían	None
levantaran	Past
fungir	None
meteorizas	Present
suden	Present
atravesar	None
fortalecidos	Past
anotar	None
devalúa	Present
llevar	None
inspirarían	None
entablar	None
practicar	None
arrasaban	Past
refrescar	None
desarraigaría	None
sostendrá	Future
superar	None
contenías	Past
enlistar	None
prepárense	None
ora	Present
tapizados	Past
conversé	Past
readmitir	None
pesaban	Past
biografías	Present
contrarrestabas	Past
fracasar	None
granulados	Past
mecanografiando	Present
entreguen	Present
informaría	None
invadiendo	Present
despuntado	Past
explicito	Present
pilotar	None
censa	Present
sitúen	Present
tiende	Present
aferrando	Present
adosando	Present
orad	None
mojadas	Past
contrapuestas	Past
confundiría	None
capó	Past
horadando	Present
avisaron	Past
estudias	Present
tumbar	None
embolsados	Past
galardonaron	Past
arponearíamos	None
saludaríamos	None
accidentados	Past
relacionarían	None
predigamos	Present
guiará	Future
introducidas	Past
ringarían	None
enmasillemos	Present
catapultado	Past
consistiríamos	None
acuarteladas	Past
compuestas	Past
aclarados	Past
redireccionó	Past
intima	Present
comprobaremos	Future
mueven	Present
enruta	Present
intermedia	Present
ahorra	Present
endeudar	None
cazares	Future
gastado	Past
constaría	None
conferir	None
coser	None
aunados	Past
flamear	None
extorsionar	None
acrecer	None
reinstaurado	Past
informé	Past
abordaría	None
abejoneado	Past
rechinar	None
importaría	None
capitalizado	Past
desprestigiando	Present
procesó	Past
padecería	None
reconquistados	Past
esnifar	None
continuadas	Past
atajando	Present
reordena	Present
rodeando	Present
enjuiciar	None
tose	Present
erizado	Past
abonaría	None
remezclado	Past
trota	Present
estéis	Present
consideren	Present
muestres	Present
doblegada	Past
devorar	None
encorvada	Past
clarificar	None
atrapados	Past
antiguarían	None
innovado	Past
desearía	None
afectó	Past
procesionó	Past
tipificadas	Past
desbaratando	Present
preconizaría	None
basé	Past
replanteó	Past
relacionó	Past
espolvorear	None
entrevistó	Past
bojan	Present
sustraer	None
modifican	Present
trucada	Past
encolarás	Future
conservasen	Past
plancháramos	Past
amortiguados	Past
reingresaban	Past
comprender	None
disolviendo	Present
descarrilados	Past
atontados	Past
estaremos	Future
colma	Present
donareis	Future
disputen	Present
agasajan	Present
restringirá	Future
respaldadas	Past
dono	Present
picotea	Present
taqueado	Past
aglutinases	Past
considérese	None
ingeniar	None
abajarán	Future
exteriorizar	None
sustituyeron	Past
secuestrar	None
historiado	Past
desatender	None
doblaría	None
instituido	Past
transigir	None
debutaran	Past
primaría	None
empleado	Past
distanciados	Past
examinados	Past
roe	Present
clausuráis	Present
confundirían	None
absolverá	Future
pospuesta	Past
difundirían	None
reúnan	Present
sufrieron	Past
incursionando	Present
desembocarían	None
rehusado	Past
amistar	None
preconizando	Present
disociado	Past
encauzado	Past
ejecuto	Present
tramaban	Past
moliné	Past
recomprar	None
trueca	Present
contuvieran	Past
ligaban	Past
lamas	Present
leerían	None
desenvueltas	Past
prostituye	Present
desconcertar	None
cortaría	None
estarán	Future
contorsionaras	Past
involucrarían	None
refundaría	None
queden	Present
merendar	None
anexionaría	None
flirtear	None
pagasen	Past
romantizas	Present
remitían	Past
encontraría	None
resignados	Past
autentificado	Past
hierven	Present
embalsamado	Past
aceptadas	Past
defendiendo	Present
subrayada	Past
lustraran	Past
blasfemar	None
teloneando	Present
ministerializáremos	Future
ayudarían	None
olvidaremos	Future
chequeada	Past
lograd	None
retocados	Past
informo	Present
pospuso	Past
acomplejásemos	Past
aspirarían	None
retaban	Past
parlamentan	Present
elaboraría	None
sobrevuela	Present
anhelar	None
testimoniaron	Past
instruidos	Past
proveyó	Past
pactar	None
reprobado	Past
consumidos	Past
refrigerada	Past
instituyereis	Future
desvaneció	Past
lluevas	Present
estrenarían	None
soltadas	Past
dimisiones	Present
embobarían	None
tiroteó	Past
continúen	Present
condiciona	Present
excitasen	Past
puntada	Past
bosquejaríamos	None
faenaban	Past
exaltada	Past
pertenecieran	Past
recorrerían	None
presenciar	None
debería	None
masticados	Past
pidiendo	Present
renderizaras	Past
adentro	Present
economizábamos	Past
ocupó	Past
alienar	None
replegó	Past
incumbirían	None
conjugaron	Past
fortificarían	None
asaron	Past
reconquistadas	Past
examinaban	Past
indexada	Past
limpiaría	None
roan	Present
culebreo	Present
enjambraríais	None
crecieran	Past
refrenar	None
até	Past
zarpando	Present
relevaríais	None
alojándose	Present
entretienen	Present
agredir	None
alegrará	Future
pegaré	Future
provocan	Present
climatizarías	None
extirpar	None
encerró	Past
eliminaría	None
pretendo	Present
oscurecer	None
afluidas	Past
recortes	Present
voleéis	Present
depositasen	Past
manifestada	Past
apegados	Past
peas	Present
tapear	None
mondo	Present
propulsado	Past
admirada	Past
llamen	Present
estampar	None
prescribir	None
fijarse	None
rediríais	None
huirá	Future
aprendí	Past
aviares	Future
comprada	Past
entrechocábamos	Past
revolucionaría	None
rezongados	Past
hipnotizó	Past
tituladas	Past
chateando	Present
juzgar	None
escindiría	None
apostó	Past
arrimarían	None
ostentará	Future
atacaría	None
salda	Present
guiada	Past
coincides	Present
dotará	Future
baila	Present
rindo	Present
sobrestima	Present
idead	None
dividiría	None
humedecidas	Past
cancelan	Present
iniciará	Future
decapitar	None
infórmese	None
primó	Past
reconducido	Past
pulverizada	Past
contrajo	Past
sobresalió	Past
legada	Past
mediatiza	Present
corrigiesen	Past
retribuir	None
usaran	Past
correlacionando	Present
intercambiará	Future
batalló	Past
legitimaseis	Past
contactadas	Past
usurpa	Present
alijararías	None
bifurcar	None
rebajabais	Past
laqueado	Past
acoso	Present
desgastadas	Past
bascularía	None
designará	Future
sobrerreaccionareis	Future
examinar	None
talla	Present
imaginaban	Past
entorpecer	None
desbaratado	Past
subrayo	Present
amonestaron	Past
predisponer	None
explicar	None
radicalizan	Present
precavieren	Future
cesaron	Past
rebajados	Past
magullad	None
escoltaban	Past
finalizadas	Past
pregonaban	Past
surciremos	Future
alabeo	Present
diré	Future
desencriptaré	Future
votemos	Present
desollarías	None
trenzas	Present
tabulado	Past
desguazó	Past
marinada	Past
acortarían	None
adquiridas	Past
retuvieron	Past
rearmaron	Past
cocea	Present
volcaría	None
limpia	Present
desabrochada	Past
aparejada	Past
azafranes	Present
emprendería	None
socavado	Past
festoneabas	Past
regatea	Present
bañémonos	None
incumpliría	None
contactaras	Past
miniaturizarían	None
retransmitieron	Past
adentraría	None
rodeado	Past
condujeran	Past
pesaría	None
mear	None
engatillaseis	Past
fintas	Present
revocar	None
transponer	None
acreditará	Future
calibres	Present
huido	Past
resaltaría	None
expresaremos	Future
canjeado	Past
reportarían	None
supervienes	Present
cultivará	Future
amigases	Past
rajuñaría	None
protagonizada	Past
reencontradas	Past
desmantela	Present
tensionó	Past
obsequiado	Past
catalizas	Present
enraizar	None
dilucidaran	Past
engarzado	Past
embellecieron	Past
almendrado	Past
autofinanciarse	None
apercibir	None
sufragan	Present
olvidado	Past
transmitidos	Past
arrollados	Past
asuelen	Present
mantener	None
perdurabais	Past
adivinados	Past
desplazaría	None
atrevidos	Past
vulnerar	None
procurémonos	None
enterrabais	Past
dirimir	None
resistían	Past
peleada	Past
espesado	Past
desaconsejarán	Future
extenuado	Past
pelecha	Present
trasbordar	None
azufrarías	None
sierro	Present
agrupada	Past
bruñida	Past
acompañando	Present
comunicaré	Future
aconteció	Past
anunciaran	Past
enterrasen	Past
barajado	Past
dosificando	Present
malogré	Past
eclipso	Present
sulfurada	Past
sortead	None
amilanar	None
hacer	None
volcaran	Past
testimoniados	Past
pintando	Present
esculpes	Present
estallaría	None
humillo	Present
registren	Present
conjugar	None
turbada	Past
danzad	None
forzada	Past
alquilarán	Future
acallar	None
hincharse	None
escupiendo	Present
accionar	None
concentran	Present
asomó	Past
discernid	None
tintada	Past
proscritas	Past
clavetear	None
deificó	Past
paliar	None
fletada	Past
sobresalto	Present
mimetizar	None
consoláremos	Future
demuele	Present
atribulada	Past
surgir	None
obrar	None
enferméis	Present
encarnados	Past
cartografiaron	Past
así	Past
añeja	Present
encabestrasteis	Past
aprendieron	Past
resecaseis	Past
afirmo	Present
retomó	Past
indexan	Present
programarían	None
recordaron	Past
llegarás	Future
fiscaliza	Present
resarcir	None
aposentado	Past
gestionar	None
disparé	Past
patrulla	Present
metieron	Past
dinamizar	None
desminaríais	None
aconsejó	Past
definirían	None
hidrogenadas	Past
implosionar	None
reubicar	None
apoderar	None
embelesaríais	None
acaudilladas	Past
denuncio	Present
amenazaron	Past
malvivían	Past
toparon	Past
dentar	None
ronzarías	None
compartiría	None
apadrinases	Past
comerán	Future
empiecen	Present
arengar	None
chulearía	None
ameritar	None
deprimir	None
datado	Past
tildémonos	None
reanudan	Present
diseñó	Past
acordonada	Past
postulado	Past
descansarían	None
alistaron	Past
coincidían	Past
rebajar	None
alejando	Present
sembraban	Past
cepilla	Present
astilla	Present
ofendan	Present
ajusticiaron	Past
apedreando	Present
autoproclama	Present
alardearíamos	None
obviáis	Present
envolviendo	Present
echaría	None
alineen	Present
aplacada	Past
metamorfoseadas	Past
subsumido	Past
desfiguran	Present
retrasar	None
sustrajo	Past
primaban	Past
rematar	None
deshuesar	None
reinaugurada	Past
suicidarse	None
abano	Present
alojaban	Past
laman	Present
pagando	Present
muestren	Present
aera	Present
divierto	Present
sobrevolado	Past
significar	None
proveer	None
totalizaban	Past
ampliar	None
doblarse	None
canearais	Past
tropicalizo	Present
fintaría	None
cualificar	None
aventuraría	None
relegadas	Past
redireccionan	Present
desorientada	Past
recomendad	None
solidarizan	Present
alejaría	None
encantaron	Past
paren	Present
precipitando	Present
entreveraseis	Past
rehabilitar	None
delirases	Past
masacran	Present
maximicé	Past
retan	Present
objetando	Present
treparon	Past
reintegrado	Past
forjada	Past
debatiría	None
usó	Past
llenémonos	None
sulfato	Present
esquinado	Past
convivían	Past
flaqueada	Past
pasear	None
guarnecida	Past
progresaríais	None
enfrentó	Past
modelaban	Past
funciones	Present
rifas	Present
mendigarían	None
tejares	Future
expulsados	Past
refracta	Present
sofocar	None
pavimentó	Past
lavaran	Past
postensan	Present
soluciones	Present
escarchado	Past
ámate	None
cuantificó	Past
catéis	Present
recortaríamos	None
realizaré	Future
contemplar	None
exuda	Present
redibujó	Past
enferma	Present
balancear	None
robustecer	None
refiérase	None
desmesuradas	Past
oficializadas	Past
regalarán	Future
enlatadas	Past
saltado	Past
enceraren	Future
tapándose	Present
resonar	None
aúpa	Present
siso	Present
adelgazaríais	None
copetearías	None
bastando	Present
anunciaron	Past
cojeando	Present
esforzarais	Past
lacrima	Present
careció	Past
contaste	Past
regalará	Future
resguardó	Past
sobrepasará	Future
comentábamos	Past
captar	None
publicitó	Past
impregnada	Past
africanizaban	Past
adornadas	Past
recomenzarías	None
internaron	Past
discutían	Past
rembolsad	None
participadas	Past
encargadas	Past
transliterada	Past
predice	Present
curan	Present
clonando	Present
arriesgar	None
enamorarse	None
olvidaras	Past
precisado	Past
enamoraría	None
arrastrarían	None
preconociendo	Present
calientan	Present
salven	Present
enconado	Past
desengañado	Past
apresurada	Past
describo	Present
socorrer	None
pensad	None
alegraría	None
violo	Present
gafo	Present
manejas	Present
truncaría	None
deteriorada	Past
sospecharía	None
deshonraran	Past
hostilizar	None
enfatizó	Past
inculpando	Present
desarrollaran	Past
disemina	Present
indultó	Past
arrendada	Past
focaliza	Present
añorarían	None
escenificada	Past
alfabetizado	Past
reasentarán	Future
orinar	None
presentaban	Past
concretados	Past
desenvainó	Past
comimos	Past
rubricados	Past
partido	Past
magullo	Present
balas	Present
aserrada	Past
sanja	Present
respondimos	Past
pivotar	None
purificaban	Past
liberaría	None
pintar	None
pariendo	Present
estresar	None
sucederán	Future
contendrían	None
descansaré	Future
generando	Present
medias	Present
aumentaríamos	None
torturando	Present
reabiertas	Past
segares	Future
enredan	Present
disuadir	None
correos	None
saludaren	Future
deslindadas	Past
mentí	Past
santificar	None
diferido	Past
dependen	Present
rivalizar	None
neutralizan	Present
resaltará	Future
connotaste	Past
repercutir	None
ribetea	Present
requiebro	Present
proporcionados	Past
horada	Present
tributa	Present
efectuaban	Past
cogidos	Past
sobrepasar	None
adoptarían	None
alborear	None
previeron	Past
tachones	Present
desconocer	None
deshechos	Past
amaestrases	Past
googleasteis	Past
derruirían	None
aconsejadas	Past
alienados	Past
centraliza	Present
coagulada	Past
exacerbar	None
cansaron	Past
burló	Past
sojuzga	Present
conferidas	Past
supuraría	None
almorzar	None
azuza	Present
incapacitar	None
revivido	Past
resumiereis	Future
existió	Past
azotes	Present
asan	Present
fallarás	Future
aplazaría	None
rascasteis	Past
arrinconaron	Past
pulverizan	Present
anexionado	Past
renunciaría	None
apartaran	Past
apropiadas	Past
cautelaré	Future
legados	Past
arruinarían	None
brincar	None
desilusiona	Present
constiparse	None
avergonzó	Past
reciproca	Present
perteneció	Past
desechado	Past
arriad	None
completaron	Past
sobreactúo	Present
titubear	None
ostentados	Past
contaría	None
reintegrar	None
acabarse	None
maduradas	Past
acunado	Past
regentaban	Past
signaron	Past
fondearán	Future
generes	Present
cabriolas	Present
sueltos	Past
salivar	None
sancionaría	None
realizaron	Past
presenciados	Past
alborota	Present
rebautizaría	None
cursarían	None
releva	Present
utilizarían	None
popularizó	Past
dinamizaron	Past
prevendría	None
reglamentó	Past
primes	Present
contacta	Present
marginaríamos	None
revistando	Present
oso	Present
anillado	Past
circunscrita	Past
lijas	Present
iniciarían	None
repensar	None
coproduciendo	Present
resumidas	Past
desalineada	Past
fogueaseis	Past
editar	None
atemperar	None
bifurca	Present
entallasen	Past
arrancado	Past
arrinconada	Past
reanimasen	Past
disfrutados	Past
sostuvieses	Past
necesitad	None
posibilitaran	Past
desconcentraré	Future
disparándose	Present
conectásemos	Past
autorizando	Present
esfuerzo	Present
preguntaría	None
exportar	None
aclimatarse	None
roturadas	Past
andaré	Future
desamparáramos	Past
desteñirías	None
confinaban	Past
descarnadas	Past
montarían	None
ahorraremos	Future
mantenemos	Present
teorizó	Past
llover	None
bocinas	Present
postularía	None
recocinarán	Future
atornillar	None
segregadas	Past
documentas	Present
divorciaría	None
raspados	Past
dividieran	Past
despejado	Past
oculten	Present
tiroteada	Past
zapadas	Past
dejó	Past
mediadas	Past
presumían	Past
conseguiremos	Future
forzarían	None
agregarían	None
precedían	Past
engendraría	None
asume	Present
ejecutares	Future
mitigareis	Future
matadas	Past
explora	Present
adicionasen	Past
perfora	Present
abajada	Past
sedimentar	None
personalizan	Present
envidiado	Past
peloteada	Past
mueran	Present
brincó	Past
preserven	Present
catalogaría	None
metería	None
fruncieseis	Past
triangular	None
hablado	Past
tipificarían	None
despegada	Past
requisarían	None
salíamos	Past
descuellas	Present
meneo	Present
desdolarizaría	None
fundado	Past
trasluchado	Past
peregrinar	None
valorados	Past
mamarais	Past
automatizando	Present
esquivar	None
ansías	Present
prospectar	None
acontecerá	Future
arrojadas	Past
boicotearon	Past
carameliza	Present
diezmaban	Past
atrancaremos	Future
engomada	Past
atestiguabais	Past
decretaríais	None
roes	Present
eyectados	Past
procurad	None
adentrando	Present
presintiendo	Present
arrastrad	None
desmoronar	None
jorobado	Past
curso	Present
desdoblando	Present
cuecen	Present
decantaron	Past
cooperarían	None
resaltares	Future
reeditados	Past
competan	Present
ansiar	None
erradicaría	None
vertebrando	Present
volvieron	Past
progresado	Past
contradecir	None
exterminando	Present
espolvorearías	None
anisa	Present
oficializaría	None
atrapará	Future
marcharse	None
enjuga	Present
desempeñarían	None
persuadiendo	Present
derramaseis	Past
