recopilen	recopilasen	Tense
indiquen	indiques	Person
empañadas	empañados	Gender
ajustaste	ajustasteis	Person
cuchicheasen	rumorasen	lemma
curvan	curven	Mood
tuneadas	tuneados	Gender
mentada	mentado	Gender
ungida	ungido	Gender
embrollo	instruyo	lemma
aparentaron	aparentó	Number
implantada	implantado	Gender
alebrestáremos	infundiéremos	lemma
contaminadas	contaminados	Gender
debilitadas	debilitados	Gender
devueltas	devueltos	Gender
corresponde	resopla	lemma
reglada	reglado	Gender
ridiculizada	ridiculizado	Gender
canaliza	relata	lemma
cañoneada	cañoneado	Gender
aprovechase	aprovechare	Tense
infravaloremos	infravaloráremos	Tense
azotada	azotado	Gender
autofinanciaos	autofinancíate	Number
destraillemos	fraternicemos	lemma
advirtiereis	advirtieseis	Tense
emparedando	respingando	lemma
recaíste	recaísteis	Person
enrumbadas	enrumbados	Gender
amónate	amónense	Person
predicada	predicado	Gender
enyesásemos	enyesáremos	Tense
burlados	burlado	Number
motorizadas	motorizados	Gender
ingresada	ingresado	Gender
enmudecida	enmudecido	Gender
ensartar	vallar	lemma
pasadas	pasada	Number
filtradas	filtrados	Gender
implemente	implementa	Mood
ancladas	anclados	Gender
desorientaré	legitimaré	lemma
inutilizadas	inutilizados	Gender
secrete	secreta	Mood
claveteada	claveteado	Gender
provocada	provocado	Gender
ceceara	cecearan	Number
reunidas	reunidos	Gender
insertada	insertado	Gender
casada	casado	Gender
arropadas	arropados	Gender
jaraneadas	jaraneados	Gender
disparada	disparado	Gender
adverasen	impersonalizasen	lemma
atracaba	recuperaba	lemma
flojeasen	flojeásemos	Person
desacaten	desacates	Person
granulase	granulásemos	Number
gestionaría	gestionarías	Person
desorganizada	desorganizado	Gender
recordaré	recuerdo	Tense
doliéndose	piando	lemma
plagiada	plagiado	Gender
cuantifica	cuantifican	Number
comedidas	comedidos	Gender
relumbradas	relumbrados	Gender
mentida	mentido	Gender
alhajes	inmortalices	lemma
incorporadas	incorporados	Gender
asía	asías	Person
aburridos	aburrido	Number
prorrogaba	prorrogaban	Person
marche	marches	Person
descorcháis	sombráis	lemma
consumadas	consumados	Gender
consideradas	considerada	Number
cautelareis	cautelaseis	Tense
escobada	escobado	Gender
colgada	colgado	Gender
entreverado	occidentalizado	lemma
desainadas	desainados	Gender
autentificases	hastiases	lemma
desdeñada	desdeñado	Gender
variada	variado	Gender
revolcabais	revolcaban	Person
abisagrara	abisagrarais	Person
cubicadas	cubicados	Gender
agobiaseis	frustraseis	lemma
hinchadas	hinchados	Gender
descontratáremos	descontratare	Person
regoldaren	regoldareis	Person
repique	repiquen	Number
agraviarais	tontearais	lemma
taladrásemos	taladráremos	Tense
desmenuzarías	retratarías	lemma
reincorporadas	reincorporados	Gender
ciñesen	ciñan	Tense
doblémonos	dóblense	Person
ambicionada	ambicionado	Gender
barran	barra	Person
endurecida	endurecido	Gender
resbalaríamos	resbalarían	Person
afrentada	afrentado	Gender
toreada	toreado	Gender
computadas	computados	Gender
adoradas	adorados	Gender
desparramadas	desparramados	Gender
invalidarás	invalidaré	Person
apresuradas	apresurados	Gender
trolea	troleáis	Person
moldeadas	moldeados	Gender
empalma	estremece	lemma
chequeé	chequeamos	Number
trastocada	trastocado	Gender
pillaseis	pillases	Number
opuesta	opuesto	Gender
desconocieras	desconociera	Person
chinché	universalicé	lemma
cincele	cinceléis	Person
desordenaren	desordenasen	Tense
adocenaos	adocénate	Number
derogues	deroguemos	Person
conferida	conferidas	Number
debidas	debidos	Gender
estabuló	estabulamos	Person
decapitadas	decapitados	Gender
pulveriza	pulverizan	Person
dedicada	dedicado	Gender
antevistos	opacados	lemma
carnavalee	carnavaleemos	Person
aparentare	aparentaren	Person
ramificadas	ramificados	Gender
vueltos	vuelto	Number
traspasadas	traspasados	Gender
abombada	abombado	Gender
calláremos	trapicheáremos	lemma
galgueases	galguease	Person
recapture	recaptura	Mood
golead	goleemos	Person
donadas	donados	Gender
emulada	emulado	Gender
explicadas	explicados	Gender
gimiere	gimieres	Person
muévase	muévete	Person
tematizadas	tematizados	Gender
sofocada	sofocado	Gender
empataren	empatare	Person
vagadas	vagados	Gender
censaban	censabais	Person
anexadas	anexados	Gender
acuchillada	acuchillado	Gender
arredra	sonda	lemma
aparecidas	aparecidos	Gender
lentificadas	lentificados	Gender
especuladas	especulados	Gender
encasquille	horripile	lemma
desmentida	implosionada	lemma
calibre	calibréis	Person
hablada	hablado	Gender
suspiren	suspire	Number
subarrendaremos	subarrendamos	Tense
recompuesta	recompuesto	Gender
atrapada	atrapado	Gender
espantadas	espantados	Gender
autoinculpadas	autoinculpados	Gender
chequen	cheque	Number
desencadenadas	desencadenados	Gender
ameritare	ameritase	Tense
suministrada	suministrado	Gender
encadenamos	encadenó	Person
encuerara	encueraran	Number
evitemos	evite	Person
empaquetada	empaquetado	Gender
escotó	escotasteis	Person
cocinases	cocines	Tense
humanizadas	humanizados	Gender
anegaba	anegaban	Number
succionada	succionado	Gender
depilaseis	solidificaseis	lemma
equivocarse	padecer	lemma
tropiece	tropieza	Person
castres	castrases	Tense
interaccionarais	interaccionáramos	Person
rasure	rasuren	Number
dígnate	dignémonos	Person
resarcida	resarcido	Gender
acarreadas	acarreados	Gender
azuzada	azuzado	Gender
talladas	tallados	Gender
detallaste	relacionaste	lemma
plantaba	plantaban	Person
retundamos	retundiésemos	Tense
aprietan	maridan	lemma
tenidas	tenidos	Gender
bifurcadas	bifurcada	Number
destilada	destilado	Gender
envejeciste	hollaste	lemma
compatibilizar	refaccionar	lemma
registrada	registrado	Gender
centrifugué	centrifugamos	Number
engendraron	engendrasteis	Person
atascadas	atascada	Number
derrocáramos	regentáramos	lemma
enfrentásemos	enfrentasen	Person
tengan	tuvieren	Tense
tapados	tapado	Number
desplomadas	desplomada	Number
meneará	menearán	Person
empasté	modelicé	lemma
saltamos	salto	Number
infecte	infecten	Person
tendida	tendido	Gender
resintonizara	resintonizaran	Number
envainéis	envainen	Person
nade	naden	Number
testimoniada	testimoniado	Gender
carburan	carburen	Mood
vivadas	vivados	Gender
subsidiadas	subsidiados	Gender
desaprueba	exclama	lemma
infundida	infundido	Gender
reposamos	reposo	Person
franquiciadas	franquiciados	Gender
cinematografiare	incluyere	lemma
soportada	soportado	Gender
enraizada	enraizado	Gender
desmandarás	hipnotizarás	lemma
apartaba	reproducía	lemma
gesticulaba	gesticulábamos	Number
fue	fueron	Number
desalineada	desalineado	Gender
descorrí	descorrió	Person
visualizada	visualizado	Gender
retraigan	retraiga	Person
avisa	ovilla	lemma
empotradas	empotrados	Gender
aquietare	aquietareis	Person
rasguñará	rasguñarás	Person
celabais	instaurabais	lemma
aplastada	aplastado	Gender
olvidada	olvidado	Gender
reformadas	reformados	Gender
horneadas	horneados	Gender
fresadas	fresados	Gender
dramatizada	dramatizado	Gender
alboreadas	alboreados	Gender
comparará	comparare	Mood
reaprovechada	reaprovechadas	Number
abnegamos	sedimentamos	lemma
resaltares	resaltare	Person
envenenaré	envenenaremos	Number
agazapadas	agazapados	Gender
laceraren	lacerares	Person
limpiadas	limpiados	Gender
soñada	soñado	Gender
flanqueadas	flanqueados	Gender
modelizares	modelizare	Person
balbuciríais	balbucirías	Person
escorada	escorado	Gender
accedieron	accediste	Person
pensadas	pensados	Gender
salvaba	salvabais	Person
retorcida	retorcido	Gender
renegada	renegado	Gender
fraccionada	fraccionado	Gender
postensase	postense	Tense
consensuásemos	consensuáremos	Tense
numeraren	numerarán	Mood
endulzada	endulzado	Gender
intervenidas	intervenidos	Gender
santificaras	santificara	Person
satirizaría	satirizaríamos	Person
refundadas	refundados	Gender
enunciadas	enunciados	Gender
surtida	surtido	Gender
encaradas	encarados	Gender
elaborara	reequilibrara	lemma
desencontrados	desencontrado	Number
instituirán	instituyen	Tense
dilapiden	procuren	lemma
saboteadas	saboteados	Gender
afligirían	significarían	lemma
redujese	redujesen	Number
damnificamos	damnifica	Person
brindemos	brindamos	Mood
dilaten	protocolicen	lemma
mosqueáremos	mosqueásemos	Tense
incubadas	incubados	Gender
prohibidas	prohibidos	Gender
divagadas	divagados	Gender
dialogada	dialogado	Gender
boletee	boleteemos	Person
repetidas	repetidos	Gender
decepcionasteis	decepcionaste	Person
incubara	incubaran	Number
reemplazan	reemplaza	Number
desgastará	desgastarán	Number
aduéñense	aduéñese	Person
envolviendo	radicalizando	lemma
anexionadas	anexionados	Gender
dictaminada	dictaminado	Gender
acribillan	acribilláis	Person
emocionadas	emocionados	Gender
transites	transitases	Tense
ansiada	ansiado	Gender
inflen	infle	Person
denotada	denotado	Gender
cancelo	cancelas	Person
extorsionada	extorsionado	Gender
rastrearéis	rastreareis	Mood
desataras	reimaginaras	lemma
contraprogramabas	instigabas	lemma
filtrada	filtrado	Gender
explicitéis	explicitáis	Mood
desquita	vaticina	lemma
arrojada	arrojado	Gender
dirimida	dirimido	Gender
deleitábamos	deleitaban	Person
irritábamos	irritaba	Number
cabildee	cabildeemos	Number
mosqueada	mosqueado	Gender
punzaras	punzarais	Person
presagiada	presagiado	Gender
vapulearais	vapulearas	Number
arriesgamos	arriesga	Person
encantada	encantado	Gender
convalidada	ultrajada	lemma
existís	existiréis	Tense
ofrendasen	ofrendaseis	Person
incrementaseis	incrementéis	Tense
candidateados	retirados	lemma
desmenuzo	desmenuzamos	Person
discontinuadas	discontinuados	Gender
cimbraríais	cimbraría	Person
arrepentidos	arrepentido	Number
loncheadas	loncheados	Gender
incidid	incidamos	Person
cincelamos	cincelaste	Person
suscribían	suscribía	Number
cronifique	intercepte	lemma
propináremos	propinemos	Tense
autocalifícate	autocalifíquense	Person
rotulada	rotulado	Gender
desolarais	desolaras	Person
zarpe	zarpase	Tense
decaída	decaído	Gender
demarcáramos	demarcara	Number
desglosáramos	normalizáramos	lemma
patrimonializarán	patrimonializaren	Mood
yuxtapuestas	yuxtapuestos	Gender
arrampladas	arramplados	Gender
reajustará	reajustare	Mood
desprecio	desprecie	Mood
airaremos	airamos	Tense
sobreestimásemos	sobreestimáremos	Tense
rasquen	rasque	Person
desvanezcamos	trasparentemos	lemma
concurrida	concurrido	Gender
discrimine	unte	lemma
banqueteada	banqueteado	Gender
usémonos	úsense	Person
saciada	saciado	Gender
desvencijaste	desvencijé	Person
mimada	mimado	Gender
descalificada	descalificado	Gender
arrastrada	arrastrado	Gender
retroalimentada	retroalimentado	Gender
encajonada	encajonado	Gender
empate	empatemos	Number
sobrepasada	sobrepasado	Gender
teñida	teñido	Gender
bootearéis	booteáis	Tense
angostes	infiltres	lemma
esputase	respectase	lemma
insidiara	insidiáramos	Number
objetadas	objetados	Gender
transpuestas	transpuestos	Gender
desdibujemos	mimemos	lemma
propugnado	propugnados	Number
ahorquilladas	ahorquillados	Gender
afeitadas	afeitados	Gender
rellenen	rellenan	Mood
amedrentadas	amedrentados	Gender
empolvamos	occidentalizamos	lemma
rodaba	rodabais	Person
cercan	radican	lemma
despersonalizare	despersonalizase	Tense
chupetearía	chupetearías	Person
desovarás	desovas	Tense
asústate	asústense	Person
remunere	remuneren	Number
retrasados	retrasado	Number
alocáramos	alocara	Person
abombadas	abombados	Gender
cercadas	cercados	Gender
dinamice	prorrumpa	lemma
amueblados	reembolsados	lemma
bizquearemos	bizqueáremos	Mood
reprochada	reprochado	Gender
estresadas	estresados	Gender
carcomida	carcomido	Gender
repetiré	repetirá	Person
escindida	escindido	Gender
marginalizadas	marginalizados	Gender
acordaos	acuérdate	Number
etiquetadas	etiquetados	Gender
apedreareis	guarneciereis	lemma
fíjate	fíjense	Person
pulsan	pulso	Person
protagonizase	protagonizásemos	Person
idas	ida	Number
comercializaría	comercializarías	Person
autogestionarían	autogestionaría	Number
agradecidas	agradecidos	Gender
fugadas	fugados	Gender
desportilla	martilla	lemma
abolirás	usufructuarás	lemma
maltratadas	maltratados	Gender
anestesiare	fatigare	lemma
masacrada	masacrado	Gender
diseminadas	diseminados	Gender
reenergizáramos	reenergizarais	Person
reivindique	reivindiquen	Person
dispersa	dispersará	Tense
agrupadas	agrupados	Gender
debutareis	debutares	Number
evoluciones	evolucione	Person
posibilitadas	posibilitados	Gender
tableteadas	tableteados	Gender
dirigida	dirigido	Gender
restasen	restaren	Tense
reiteradas	reiterados	Gender
gambetease	gambetee	Tense
amaitinabais	martirizabais	lemma
engarzadas	engarzados	Gender
renombraré	renombraremos	Number
prometidas	prometidos	Gender
cállate	cállense	Person
desbarráramos	desbarraran	Person
verseásemos	versease	Number
golpeadas	golpeados	Gender
cuidados	cuidado	Number
avecinamos	extraviamos	lemma
reintroduzca	reintroduzco	Mood
origine	origina	Mood
oscilen	oscile	Number
sobaríais	sobaría	Person
solventareis	solventaren	Person
acelerabas	aceleraba	Person
autoproclamada	autoproclamado	Gender
incrementen	incremente	Person
conturbaran	conturbarais	Person
azotadas	azotados	Gender
querellados	querellado	Number
seducida	seducido	Gender
confiemos	confíe	Number
patrocinasteis	patrocinaron	Person
exculpará	exculparéis	Person
perjudicada	perjudicado	Gender
santificadas	santificados	Gender
desguarnecieron	desguarnecimos	Person
adjudicase	jurase	lemma
juzgase	juzgásemos	Person
echemos	echen	Person
habilitadas	habilitados	Gender
estallada	estallado	Gender
circuyésemos	circuyeseis	Person
observarían	observaría	Person
clavetearán	transportarán	lemma
ahorcada	ahorcado	Gender
aterrizada	aterrizado	Gender
concienciada	concienciado	Gender
trasfiguras	trasfigures	Mood
archivadas	archivados	Gender
rivalicemos	rivalicéis	Person
tambaleare	tambalee	Tense
avizorada	avizorado	Gender
desparramada	desparramado	Gender
pajeadas	pajeada	Number
avalada	avalado	Gender
separada	separado	Gender
enfrentemos	enfrentáremos	Tense
plagiad	plagie	Person
compadecida	compadecido	Gender
reafirma	reafirme	Person
raptada	raptado	Gender
ida	ido	Gender
acantonada	incoada	lemma
enconase	enconaseis	Person
reducirán	reducirá	Number
coadyuvarán	litigarán	lemma
atendidas	atendidos	Gender
familiarizada	familiarizado	Gender
derroto	derrote	Mood
subordinada	subordinado	Gender
monetizadas	monetizados	Gender
mesurada	mesurado	Gender
difuminen	difuminéis	Person
promueve	promueven	Number
enlazaran	enlazara	Person
profesada	profesado	Gender
aprestadas	aprestados	Gender
amarrada	amarrado	Gender
señalizadas	señalizados	Gender
elogiaras	elogiara	Person
joteaseis	joteases	Number
gatean	gateas	Person
perdurada	perdurado	Gender
laburarán	laburaren	Mood
copatrocináremos	copatrocinaren	Person
mutan	muten	Mood
comparecida	comparecido	Gender
aguaréis	exaltaréis	lemma
enmascaraba	enmascarábamos	Number
compensadas	compensados	Gender
quedaos	quédate	Number
despachadas	muertas	lemma
concluidas	concluidos	Gender
agujerara	optara	lemma
estreso	estrese	Mood
reencontradas	reencontrados	Gender
descongestionados	extorsionados	lemma
capitulaseis	capitulareis	Tense
desasirían	desasiría	Person
timbradas	timbrados	Gender
recogen	recogerán	Tense
adjunta	adjuntará	Tense
entablada	entablado	Gender
corroída	corroído	Gender
preestablecida	preestablecido	Gender
moteaba	moteábamos	Number
aleteada	aleteado	Gender
acercabas	propugnabas	lemma
adosada	adosado	Gender
obrada	obrado	Gender
gatilló	gatillaron	Person
alargadas	alargados	Gender
comisionaran	comisionara	Person
distínganse	distínguete	Person
abrochaos	abróchate	Number
sesionan	sesiona	Person
modificadas	modificados	Gender
guiada	guiado	Gender
parécete	parézcase	Person
graduada	graduado	Gender
desazone	desazonad	Person
comprimís	reversáis	lemma
recauchuten	recauchutaren	Tense
formalizada	formalizado	Gender
medicalicen	medicalizan	Mood
acompañada	acompañado	Gender
subestimada	subestimado	Gender
cloroformizada	cloroformizado	Gender
relatadas	relatados	Gender
revivías	revivían	Person
granizada	granizado	Gender
garantirás	garantieres	Mood
descascarasteis	descascaraste	Number
coaligada	coaligado	Gender
superpuesta	superpuesto	Gender
saturadas	saturados	Gender
encomiamos	encomias	Person
calculando	instituyendo	lemma
traicionan	traiciona	Number
tapice	tapices	Person
anticuadas	anticuados	Gender
prefiguradas	prefigurada	Number
presagiabas	presagiaba	Person
reeditaste	reedité	Person
movida	movido	Gender
atarantaba	infectaba	lemma
lagarteadas	lagarteados	Gender
pulsada	pulsadas	Number
maso	masas	Person
aderezadas	aderezados	Gender
compungieren	transpusieren	lemma
emplazadas	emplazados	Gender
teatralizada	teatralizado	Gender
remitid	remite	Number
dedicaren	dedicare	Number
ascendía	ascendían	Person
conectada	conectado	Gender
esposadas	esposados	Gender
derruidas	derruidos	Gender
invalidada	invalidado	Gender
desinhibida	desinhibido	Gender
acondicionaban	acondicionabais	Person
amputada	amputado	Gender
ignorada	ignorado	Gender
arrastre	arrastrase	Tense
aferras	manoseas	lemma
estánquense	estánquese	Person
cortejada	cortejadas	Number
controlada	controlado	Gender
interrogadas	interrogados	Gender
calcificareis	traficareis	lemma
abetunaseis	pilotaseis	lemma
exasperada	exasperado	Gender
clarificabais	clarificabas	Person
frotada	frotado	Gender
jaranearía	jaranearían	Number
sincopada	sincopado	Gender
conservada	conservado	Gender
precalentasen	precalentase	Number
esmeraos	esmérese	Person
compenetraréis	compenetráis	Tense
empacadas	empacada	Number
blasonada	blasonado	Gender
mencionadas	mencionados	Gender
enmendada	enmendado	Gender
abatámonos	abátete	Person
afeitaren	afeitáremos	Person
retorne	retorna	Mood
sustanciares	sustanciareis	Number
realizada	realizado	Gender
carbonizarás	innovarás	lemma
obligada	obligado	Gender
tapadas	tapada	Number
sintetizaba	sintetizaban	Number
entierre	prolongue	lemma
sustituya	sustituyo	Mood
azuzaron	azuzó	Number
adquiriereis	adquiriere	Person
pastadas	pastados	Gender
coreadas	coreados	Gender
refinanciemos	refinancie	Person
embarcan	embarcarán	Tense
decrecíais	testeabais	lemma
desembarcara	desembarcáramos	Number
repetí	repitieron	Person
brinden	seleccionen	lemma
apile	palpite	lemma
cuadrupliqué	nivelé	lemma
estrangulase	estrangule	Tense
nixtamaliza	nixtamalizará	Tense
acusadas	acusada	Number
simpatizada	simpatizado	Gender
fiada	fiadas	Number
eliminareis	eliminaseis	Tense
opuestas	opuesta	Number
destriparon	mecanografiaron	lemma
chive	chivemos	Person
chapadas	chapados	Gender
relumbraran	relumbrara	Person
aterrizaría	aterrizarían	Number
compilarás	compilares	Mood
citada	citado	Gender
humearais	humearas	Person
sacralizada	sacralizado	Gender
inactivaren	inactivares	Person
desvinculada	desvinculado	Gender
violó	violamos	Person
reimprimirá	reimprimirán	Number
interceptada	interceptado	Gender
aproximáis	aproxima	Person
destinaron	destinamos	Person
protestada	protestado	Gender
situada	situado	Gender
acaecida	acaecido	Gender
entenebreciera	entenebrecieras	Person
desconfiadas	desconfiados	Gender
facharán	facharéis	Person
desbravar	tranquilizar	lemma
ciñamos	ceñimos	Mood
turbada	turbado	Gender
empujan	siegan	lemma
reenergizáremos	reenergizare	Number
contada	contado	Gender
incurrida	incurrido	Gender
captadas	captados	Gender
revolcabas	revolcabais	Person
novelares	noveles	Tense
molestaban	molestaba	Number
interrelacionada	interrelacionado	Gender
borroneemos	borroneásemos	Tense
encajen	habiten	lemma
aturdida	aturdido	Gender
podadas	podados	Gender
flirteare	flirteareis	Person
centelleásemos	peinásemos	lemma
interno	internamos	Number
desovamos	revalidamos	lemma
unidas	unidos	Gender
consume	consumare	Tense
disuelta	disuelto	Gender
descartada	descartado	Gender
capitaneada	capitaneado	Gender
farolearas	faroleara	Person
aproximada	aproximado	Gender
aguasen	inutilizasen	lemma
amanecido	lagarteado	lemma
desmigajada	desmigajado	Gender
reglamentará	reglamentaremos	Person
diferenciadas	diferenciados	Gender
oscurezcamos	oscurezca	Person
atendida	atendido	Gender
despojaban	despojaba	Number
ensambladas	ensamblados	Gender
destruidas	destruidos	Gender
mercaré	mercare	Mood
reeditamos	reeditaron	Person
desabrocharás	desabrocharéis	Number
programadas	programados	Gender
acantonáramos	acantonaran	Person
sodomizada	sodomizado	Gender
cimentada	cimentado	Gender
entorpecida	entorpecido	Gender
libabais	libabas	Person
coleccionadas	coleccionados	Gender
quitaríais	quitaríamos	Person
consideradas	considerados	Gender
desballestadas	desballestados	Gender
plegada	plegado	Gender
retraídos	retraído	Number
truene	tronemos	Person
repudiadas	repudiados	Gender
amuebladas	amueblados	Gender
recomendó	recomendé	Person
descontado	pretendido	lemma
subyugares	subyugáremos	Person
abrasada	abrasado	Gender
contemporizáis	patrulláis	lemma
desempacamos	desempacan	Person
secuenciada	secuenciado	Gender
trascendimos	trascendió	Person
carcajeadas	carcajeada	Number
acobardaréis	revestiréis	lemma
esforcé	esforzó	Person
alocase	alocare	Tense
enlutares	enlutare	Person
amplificasen	zurciesen	lemma
arremetida	arremetido	Gender
acolamos	preseleccionamos	lemma
solventadas	solventados	Gender
irrigada	irrigado	Gender
candadas	candados	Gender
conocidas	conocidos	Gender
interrogo	interrogamos	Number
descabalgarías	descabalgarían	Person
finalizada	finalizado	Gender
forjados	forjado	Number
aviste	avisten	Number
hubiere	hubiese	Tense
escampo	escamparé	Tense
tematizada	tematizado	Gender
amenizadas	finalizadas	lemma
disuena	pugna	lemma
medicadas	medicados	Gender
alardeada	alardeado	Gender
excomulgue	excomulgad	Person
asieste	asestare	Tense
unificadas	unificados	Gender
descabezada	sentenciada	lemma
justificada	justificado	Gender
caramelizad	flexibilizad	lemma
aplicados	aplicado	Number
cabreada	cabreado	Gender
proporcionadas	proporcionados	Gender
aojada	aojado	Gender
despeinares	despeinare	Person
dotada	dotado	Gender
predominemos	predomines	Person
desacreditada	desacreditado	Gender
enguatará	hurtará	lemma
flipásemos	flipaseis	Person
abarraseis	informaseis	lemma
malogradas	malogrados	Gender
federaste	federasteis	Person
salidas	salidos	Gender
estrechada	estrechado	Gender
contrariamos	contrariaste	Person
tramad	trama	Number
acanalada	rivalizada	lemma
cuestioné	pedí	lemma
reincorporada	reincorporado	Gender
interfieren	interfiere	Person
desmadejasen	satisficiesen	lemma
atormentada	atormentado	Gender
azafranareis	azafranaren	Person
resultarais	resultara	Person
centrifugaren	centrifugáremos	Person
defendéis	defenderéis	Tense
sarmentado	sarmentados	Number
compilamos	preludiamos	lemma
retransmitida	retransmitido	Gender
compungida	compungido	Gender
dependen	normalizan	lemma
aplanada	aplanado	Gender
atollaos	atollémonos	Person
boicoteadas	boicoteados	Gender
tiznaos	tíznense	Person
nacionalizada	nacionalizado	Gender
aclamadas	aclamados	Gender
estánquense	estánquese	Number
entregadas	entregados	Gender
moverán	mueven	Tense
ardan	profanen	lemma
acostada	acostado	Gender
rojean	rojearán	Tense
reencontrada	reencontrado	Gender
afilábamos	afilaba	Number
cepillaos	cepillémonos	Person
deshaga	deshago	Mood
confabuladas	confabulada	Number
afinará	reestrenará	lemma
desvincularíamos	rebatiríamos	lemma
pulvericemos	pulverices	Person
desabastecida	desabastecido	Gender
manchada	manchado	Gender
desvanezcas	desvanecieses	Tense
aspiradas	aspirados	Gender
argumentadas	argumentados	Gender
duplicáremos	dupliquemos	Tense
pensionadas	pensionados	Gender
espolea	espolee	Person
deslizarais	deslizaras	Person
despreciadas	despreciados	Gender
pochada	pochado	Gender
desteñidas	desteñidos	Gender
insinuarás	insinuaréis	Number
crucificada	crucificado	Gender
contentada	contentado	Gender
dolares	dueles	Tense
atañía	atañían	Number
polemizada	polemizado	Gender
ascendidas	ascendidos	Gender
arredráis	arredraréis	Tense
amputare	amputaré	Mood
congeláramos	congelara	Person
flotaren	floten	Tense
cristianizásemos	zapásemos	lemma
trabajada	trabajado	Gender
autocremados	autocremado	Number
aireada	aireado	Gender
goleada	goleado	Gender
pagada	pagado	Gender
desafiaremos	desafiaré	Person
creaban	creaba	Person
masada	masado	Gender
acorraló	acorralaste	Person
admiradas	admirados	Gender
reportearemos	reportearéis	Person
limitada	limitado	Gender
desfiguraría	desfiguraríais	Person
desmenuzase	desmenuzare	Tense
purificadas	purificados	Gender
descorcharéis	fanfarronearéis	lemma
asombradas	asombrados	Gender
casadas	casada	Number
chasqueadas	chasqueados	Gender
alabada	alabado	Gender
castráremos	castrare	Person
entreteja	entretejiere	Tense
estimulada	estimulado	Gender
apelmazando	peteando	lemma
engrupieron	engrupió	Number
clasificadas	clasificada	Number
retornaba	retornaban	Person
aceptadas	aceptados	Gender
desovadas	desovados	Gender
curarás	curaré	Person
incensares	incensarás	Mood
ajásemos	ajasen	Person
predigan	predecid	Person
apareasen	aparearen	Tense
cocine	instrumente	lemma
cooptada	cooptado	Gender
enterradas	enterrados	Gender
tiñéremos	teñiremos	Mood
disminuido	vulnerado	lemma
malherida	malherido	Gender
depuesta	depuesto	Gender
renacerías	renaceríais	Number
enmendáramos	murmuráramos	lemma
gambeteaban	gambeteaba	Number
rescindida	rescindido	Gender
ayudarás	ayudaremos	Person
cambien	ingresen	lemma
chupetearía	chupetearíais	Person
rubricada	rubricado	Gender
ustedearía	ustedearíamos	Person
enlenzaren	enlenzare	Person
orla	orlan	Number
llamadas	llamados	Gender
aciemada	aciemado	Gender
debilitada	debilitado	Gender
recurres	recurre	Person
apodera	apoderan	Number
importaseis	importases	Number
confundieron	teorizaron	lemma
precedidos	precedido	Number
estranguladas	estrangulados	Gender
yerra	yerran	Number
demorada	demorado	Gender
rebelamos	rebelaste	Person
atrapabais	nitrificabais	lemma
seleccionadas	seleccionados	Gender
evacuadas	evacuados	Gender
enfrentabais	enfrentabas	Person
demoliereis	demolieren	Person
desgarraría	desgarrarías	Person
zanjan	zanja	Number
redibujada	redibujado	Gender
circunnavegarás	gerenciarás	lemma
aproximáis	aproximas	Person
instituidas	instituidos	Gender
custodiar	reagrupar	lemma
refundare	refundaré	Mood
detestada	detestado	Gender
defirieres	pereceares	lemma
observadas	observados	Gender
enflacaría	enflacarían	Number
enfrascadas	enfrascada	Number
catapultada	catapultado	Gender
depreciará	izará	lemma
afinada	sazonada	lemma
descapitalizares	descapitalizare	Person
aliviadas	aliviados	Gender
perderás	pierdes	Tense
atareares	atarearás	Mood
cuadrada	cuadrado	Gender
perdonada	perdonado	Gender
abucheada	abucheado	Gender
rebata	rebato	Person
envalentonaba	envalentonábamos	Person
desencantasen	desencantase	Number
marchadas	marchada	Number
realojares	realojes	Tense
preocupó	preocupé	Person
manipularemos	manipuláremos	Mood
quemarán	quemaren	Mood
conllevada	normada	lemma
rehecha	rehecho	Gender
ululadas	ululados	Gender
dejad	deja	Number
autofinanciadas	autofinanciada	Number
desvalorizáremos	desvaloricemos	Tense
postuladas	postulados	Gender
injiérete	injirámonos	Person
deploren	resuenen	lemma
preserve	preserves	Person
ingeniabas	ingeniaban	Person
desdecía	desdecían	Person
procúrate	procúrense	Person
reestablecidas	reestablecidos	Gender
repartidas	repartidos	Gender
azufrado	mascullado	lemma
gerenciadas	gerenciados	Gender
pavimentada	pavimentado	Gender
declaradas	declarados	Gender
falcacearan	falcaceáramos	Person
paraos	párate	Person
apechugues	prosigas	lemma
difundida	difundido	Gender
endulzadas	endulzados	Gender
destacadas	destacados	Gender
precipitada	precipitado	Gender
favorecidas	favorecidos	Gender
valuarían	valuaría	Number
desempeñadas	desempeñados	Gender
incididas	incididos	Gender
decaídas	decaídos	Gender
atizareis	atizaréis	Mood
creído	creídos	Number
abrochaos	abrochémonos	Person
refutada	refutado	Gender
colmara	recorriera	lemma
anteponen	recetan	lemma
aniquilabais	aniquilábamos	Person
desechadas	desechados	Gender
damnificase	pareciese	lemma
doblada	doblado	Gender
discurrir	imbuir	lemma
reenergizara	reenergizáramos	Person
palmeada	palmeado	Gender
descuentes	descontéis	Number
esforzada	esforzado	Gender
desfasadas	desfasados	Gender
libada	libado	Gender
encurtidas	encurtidos	Gender
denominada	denominado	Gender
acabada	acabado	Gender
idos	váyanse	Person
desligada	mayada	lemma
ahogado	pacificado	lemma
ocupada	ocupado	Gender
ensartadas	ensartados	Gender
asociaran	asociara	Person
echados	echado	Number
desmentidas	desmentidos	Gender
lavaron	lavó	Person
suicidadas	suicidados	Gender
comportados	comportado	Number
atornillaríamos	revocaríamos	lemma
deponga	resalte	lemma
tributa	tributan	Number
intrincada	intrincado	Gender
reafirmadas	reafirmados	Gender
preelabora	preelaboráis	Person
deslegitimaba	deslegitimabas	Person
azufrar	estatizar	lemma
llevadas	llevada	Number
intitulada	intitulado	Gender
florezcáis	florezcas	Person
inhibiéremos	inhibieres	Person
catalizasteis	juramentasteis	lemma
incentivada	incentivado	Gender
teñidas	teñidos	Gender
divertíos	divirtámonos	Person
materializare	materialice	Tense
transmutasen	transmutásemos	Person
desvivámonos	desvívete	Person
perderíais	perdería	Person
barradas	barrados	Gender
descascarille	supute	lemma
amagaba	amagabais	Person
apeada	apeado	Gender
automutilaos	automutílate	Number
conmoviesen	conmovieses	Person
tosías	tosíamos	Person
emanó	maximizó	lemma
brillare	internalizare	lemma
prevenidas	prevenidos	Gender
deportabas	prestabas	lemma
reprehendéis	reprehendes	Number
deshabilitase	deshabilitásemos	Person
autenticada	autenticado	Gender
otorgasen	otorguen	Tense
cepille	cepillase	Tense
contorsionará	contorsionarán	Person
desparecemos	tomamos	lemma
destituiríamos	destituiría	Number
peatonalizada	peatonalizado	Gender
preservarán	preservaren	Mood
entreabierta	tramada	lemma
refrendada	refrendado	Gender
reclinare	recline	Tense
claveteamos	extraviamos	lemma
revelada	revelado	Gender
demarcaren	demarcasen	Tense
ahorrasen	ahorraren	Tense
toleradas	tolerados	Gender
ore	oremos	Person
sesgadas	sesgados	Gender
intimidaréis	intimidaremos	Person
desnucadas	desnucados	Gender
distorsionadas	distorsionados	Gender
degradad	sonsacad	lemma
abigarre	abigarrase	Tense
privatizadas	privatizados	Gender
subvirtiesen	subvirtieren	Tense
marginada	marginado	Gender
escasearía	largaría	lemma
manoseada	manoseado	Gender
encarecido	hilado	lemma
clicabas	clicaba	Person
contextualicé	contextualizamos	Person
implantadas	implantada	Number
sorteada	sorteado	Gender
reorientada	reorientado	Gender
publicitada	publicitado	Gender
replegada	replegado	Gender
expropiada	expropiado	Gender
embobara	jineteara	lemma
desarticularán	tapearán	lemma
pegaos	péguense	Person
corresponsabilizara	corresponsabilizáramos	Person
aliña	puede	lemma
escaezcas	escaezcáis	Number
palpitadas	palpitados	Gender
instigadas	instigados	Gender
condensada	condensado	Gender
entremezclan	entremezcla	Number
generáramos	generaran	Person
esparcía	esparcían	Number
inducidas	inducidos	Gender
complicamos	sobrellenamos	lemma
tildada	tildado	Gender
conseguí	inmatriculé	lemma
convertidas	convertida	Number
validen	valida	Person
hospedada	hospedado	Gender
amilanen	amilane	Person
infestabas	infestabais	Number
egresado	tonsurado	lemma
pesadas	pesados	Gender
notadas	notados	Gender
experimentada	experimentado	Gender
proscribierais	proscribieras	Number
cruzáremos	cruzaren	Person
fumigadas	fumigados	Gender
amueblada	amueblado	Gender
desterrada	desterrado	Gender
leída	leído	Gender
abatida	abatido	Gender
untadas	untados	Gender
cachimbeasteis	reconvinisteis	lemma
esterilizadas	esterilizados	Gender
esmerada	esmerado	Gender
abacoraríamos	abacoraría	Person
paradas	parada	Number
preestableceré	preestablezco	Tense
desangradas	desangrados	Gender
desguazadas	desguazados	Gender
simplifiquen	simplifique	Person
levantaos	levántate	Number
estribéis	estribaseis	Tense
fosilizaos	fosilízate	Number
sobrealimentarais	sobrealimentaras	Person
impartidas	impartidos	Gender
sobrada	sobrado	Gender
connotada	connotado	Gender
inauguró	inauguraron	Person
deshuesarías	deshuesarían	Person
descocidas	descocidos	Gender
drenarán	farolearán	lemma
destacada	destacado	Gender
normarás	normas	Tense
refractada	refractado	Gender
ovuladas	ovulada	Number
recordarían	recordaría	Number
divisadas	divisados	Gender
coleas	colearás	Tense
exprimas	exprimieres	Tense
precisadas	precisados	Gender
beneficien	posean	lemma
agite	agita	Person
reanudada	reanudado	Gender
agotaren	evaluaren	lemma
arrodilladas	arrodillada	Number
damnificada	damnificado	Gender
reconstruidas	reconstruidos	Gender
allegada	allegado	Gender
hozaría	hozaríamos	Number
limpiada	limpiado	Gender
encripta	guerrea	lemma
desnatada	desnatado	Gender
gorjeada	gorjeado	Gender
conjugareis	conjugaren	Person
empalmara	empalmaran	Number
reargüida	reargüido	Gender
electrizaremos	electrizará	Person
desempacáremos	desempacare	Person
desabrierais	reactivarais	lemma
bromeada	bromeado	Gender
desacatar	trabajar	lemma
mientes	mienten	Person
clorada	clorado	Gender
molidas	molidos	Gender
enfrascarse	grabar	lemma
contagiareis	contagiaréis	Mood
borbotease	borboteasen	Person
encuestas	recompras	lemma
carretearon	carreteaste	Person
culebreare	culebreares	Person
fundan	fundas	Person
abarbetada	abarbetado	Gender
interrogaríais	interrogarías	Person
almacenaban	almacenaba	Person
inaugurares	inaugures	Tense
derelinquida	derelinquido	Gender
agudizada	agudizado	Gender
estropeada	estropeado	Gender
achacasteis	rehuisteis	lemma
abonar	legitimar	lemma
atragantabas	jeringabas	lemma
revivida	revivido	Gender
calladas	callada	Number
paralizada	paralizado	Gender
categorizados	categorizado	Number
negociadas	negociados	Gender
agendada	agendado	Gender
aderezada	aderezado	Gender
desnata	desnato	Gender
marinasen	marinaren	Tense
descongela	larga	lemma
arrasada	arrasado	Gender
aluzarás	aluzares	Mood
dragas	impetras	lemma
centre	centren	Person
turnaron	turné	Person
encubertaban	revivían	lemma
interconectadas	interconectados	Gender
desembolsaréis	desembolsáis	Tense
dopadas	dopada	Number
intuida	intuido	Gender
toquetearás	toqueteará	Person
percibida	percibido	Gender
apostáis	zaherís	lemma
removieran	removiera	Number
ideo	idee	Mood
exaltamos	exaltas	Person
erigía	erigían	Number
inquieten	inquietaren	Tense
sobrealimentemos	sobrealimentamos	Mood
alegase	soplase	lemma
vivaqueada	vivaqueado	Gender
postule	postulemos	Number
difuminada	difuminado	Gender
almagradas	almagrados	Gender
dialogar	pescar	lemma
consentida	consentido	Gender
perjudicadas	perjudicados	Gender
copiadas	copiados	Gender
revisadas	revisados	Gender
peritemos	peritáremos	Tense
resistida	resistido	Gender
destituidas	destituidos	Gender
repantigaos	repantígate	Number
objetada	objetado	Gender
adoctrinada	adoctrinado	Gender
adujarás	trasmitirás	lemma
franquiciada	franquiciado	Gender
entregas	entrega	Person
asesinadas	asesinados	Gender
azufrada	azufrado	Gender
crisparais	localizarais	lemma
contamináremos	contaminásemos	Tense
adorna	limita	lemma
aboyaré	aboyaremos	Number
desfilamos	desfilaremos	Tense
escondimos	turisteamos	lemma
defraude	defraudemos	Person
desempeña	desempeñe	Person
imposibilitaré	imposibilitare	Mood
unificara	unificaran	Number
guayaras	guayarais	Number
pillada	pillado	Gender
afeitadas	afeitada	Number
tapadas	tapados	Gender
cosechadas	cosechados	Gender
desmejoré	desmejoramos	Number
entrecerrada	entrecerrado	Gender
cerrara	cerraran	Number
fondeadas	fondeados	Gender
mermada	mermado	Gender
enconchaban	mermaban	lemma
dictadas	dictados	Gender
conecte	conecten	Person
pactadas	pactados	Gender
evocada	evocado	Gender
autoeditado	vadeado	lemma
chirrías	gorroneas	lemma
patrullada	patrullado	Gender
retimbrásemos	retimbrase	Number
grabasteis	grabaste	Number
comida	comido	Gender
protocolizares	protocolizaren	Person
vendidas	vendidos	Gender
ose	osare	Tense
enredare	enredase	Tense
despedazar	extasiar	lemma
regocijemos	regocija	Person
mediatizas	mediatices	Mood
derretidas	derretidos	Gender
murmuramos	murmuremos	Mood
acogeríais	gustaríais	lemma
extasiasen	extasiase	Person
destruiríais	judicializaríais	lemma
cosa	coso	Mood
practicadas	practicados	Gender
pulidas	pulidos	Gender
desbotonaste	resecaste	lemma
recolecta	recolecte	Mood
asintiéramos	asintiera	Number
abnegada	abnegado	Gender
embelleciera	ungiera	lemma
fortalecidas	fortalecidos	Gender
decebiríais	decebiríamos	Person
ensordecen	ensordece	Person
bisecabas	bisecaba	Person
bañen	manen	lemma
convertida	convertido	Gender
empeñen	linden	lemma
empaquetadas	empaquetados	Gender
rezongarán	rezongaren	Mood
descifrada	descifrado	Gender
enculad	encula	Number
reveladas	revelados	Gender
agrupen	agrupe	Number
circunscribieses	circunscribas	Tense
proseguida	proseguido	Gender
prospectadas	prospectados	Gender
expondré	expongo	Tense
vertida	vertido	Gender
encharcada	encharcado	Gender
reorganizada	reorganizadas	Number
fermentada	fermentado	Gender
repuestas	repuestos	Gender
trancada	trancado	Gender
esperarán	esperan	Tense
apatrulladas	apatrullados	Gender
regeneradas	regenerados	Gender
corregida	corregido	Gender
rizad	riza	Number
despoblarás	despoblará	Person
curada	curado	Gender
supervisadas	supervisados	Gender
embaucado	perpetrado	lemma
empataren	empatares	Person
cuadruplicaren	cuadruplicareis	Person
condonarán	condonará	Person
visibilicemos	visibilicéis	Person
desaprobada	desaprobado	Gender
desguazadas	monitorizadas	lemma
abajares	abajareis	Number
repudiaría	repudiaríais	Person
estrenan	estrenen	Mood
esgrima	ladre	lemma
inclinadas	inclinada	Number
alójate	alójense	Person
educaren	educarán	Mood
pontifiquéis	pontifiques	Person
eliminaseis	eliminéis	Tense
satisfagamos	satisfacemos	Mood
deteriorábamos	deterioraba	Number
torcidas	torcidos	Gender
negocien	negocie	Person
corrugue	rebaje	lemma
perfuma	perfuman	Number
comandábamos	comandaba	Person
engastan	engasten	Mood
escondidas	escondidos	Gender
aparejaremos	photoshopearemos	lemma
construí	construyeron	Person
diseñares	diseñarás	Mood
rasgadas	rasgados	Gender
habilitamos	habilité	Number
coaccionaras	palpitaras	lemma
pergeñada	pergeñado	Gender
acapararemos	acapararé	Number
propuestas	propuestos	Gender
querelladas	querellada	Number
zurrirás	zurrieres	Mood
distraigo	distraeré	Tense
confirme	confirmen	Person
reportadas	reportados	Gender
coprotagonizasen	truncasen	lemma
desenfundaremos	desenfundáremos	Mood
reubicase	reubicasen	Number
encausada	encausado	Gender
lisonjeada	lisonjeado	Gender
emboque	rescate	lemma
bamboleas	tumul	lemma
equipadas	equipados	Gender
ajustará	ajusta	Tense
prolongue	prolonguen	Number
deslenguara	reaccionara	lemma
arrepentida	arrepentido	Gender
penadas	penados	Gender
apoderen	apoderan	Mood
blandamos	proyectemos	lemma
mineralizadas	mineralizados	Gender
afligida	afligido	Gender
manoteábamos	manoteabais	Person
aíro	aíra	Person
independizaron	independizó	Number
traídas	traída	Number
helada	helado	Gender
encolerizarais	encolerizaras	Number
dentaren	dentasen	Tense
entreviniesen	oyesen	lemma
tunearon	tuneó	Number
temes	tememos	Person
versionéis	versionaseis	Tense
engominé	engominaron	Person
asimilaríamos	asimilaría	Person
enjuició	enjuiciaste	Person
abarbetase	marginalizase	lemma
sinceradas	sincerados	Gender
adquiridas	adquiridos	Gender
atalayáis	atalaya	Person
amarra	hiere	lemma
abañadas	abañados	Gender
mecanizaremos	mecanizamos	Tense
extinguidas	extinguidos	Gender
curadas	curados	Gender
acodadas	acodados	Gender
forjada	forjado	Gender
sitie	sitiase	Tense
redistribuidas	redistribuidos	Gender
rierais	rieras	Number
enmascarada	enmascarado	Gender
autentifique	autentifiques	Person
maravillados	maravillado	Number
fijadas	fijada	Number
arreste	arresta	Person
desbaste	desbasten	Person
aguzaremos	voltearemos	lemma
clausuró	pelechó	lemma
adoptada	adoptado	Gender
enramara	forcejeara	lemma
implicas	impliques	Mood
ornados	ornado	Number
realquilaría	realquilarías	Person
gangrenas	gangreno	Person
mulcimos	mulcisteis	Person
descontrólense	descontrólese	Number
reacondicionéis	reacondicione	Person
clasificases	tejieses	lemma
erguía	erguían	Number
sopada	sopado	Gender
refrigeradas	refrigerados	Gender
profanadas	profanados	Gender
fallecidas	fallecidos	Gender
apartarías	habilitarías	lemma
aquejada	aquejado	Gender
desnaturaliza	ingenia	lemma
fundarán	fundan	Tense
evaporada	evaporado	Gender
autocalificaos	autocalifícate	Number
trasnochó	trasnocharon	Person
abstraían	represaban	lemma
remezcladas	remezclados	Gender
jerarquizada	jerarquizado	Gender
amansarás	amansarán	Person
rusificada	rusificado	Gender
arremetidas	arremetidos	Gender
motorizaren	motorizáremos	Person
incentivo	incentive	Mood
prorrogada	prorrogado	Gender
inspeccionada	inspeccionado	Gender
sombraba	sombrábamos	Person
orbitáremos	orbitaren	Person
nevase	nevásemos	Person
planteamos	planteé	Person
conminada	conminado	Gender
lapidares	lapides	Tense
tripulares	tripulases	Tense
diluida	diluido	Gender
zambullidas	zambullida	Number
troceamos	troceé	Number
atestiguada	atestiguado	Gender
cribe	criben	Person
esculpieras	esculpiera	Person
ansiara	solapara	lemma
torcidas	torcida	Number
reconfortadas	reconfortados	Gender
sustituyen	sustituirán	Tense
atolladas	atollada	Number
rasgada	rasgado	Gender
graven	grave	Number
ofrecidas	ofrecidos	Gender
envejecieran	envejeciéramos	Person
afectadas	afectados	Gender
amotinarán	amotinaren	Mood
cocinadas	cocinados	Gender
laboradas	laborados	Gender
analizan	analiza	Person
oí	oíste	Person
rotuladas	rotulados	Gender
acuñadas	acuñados	Gender
merecidas	merecidos	Gender
videograbada	videograbado	Gender
frotadas	frotados	Gender
imitemos	imitamos	Mood
duplicara	duplicaran	Person
financias	financia	Person
desgastaríais	incumpliríais	lemma
vocalice	vocaliza	Mood
amalgamáramos	amalgamara	Number
obedezca	obedezcan	Person
decoráremos	decorare	Number
suicidada	suicidado	Gender
recargare	recargará	Mood
okupadas	okupados	Gender
atiborrabas	atiborrabais	Number
barrada	barrado	Gender
apoderados	apoderado	Number
instaladas	instalados	Gender
apanará	apanarás	Person
arañaríais	arañarías	Number
apañada	apañado	Gender
promoveré	promuevo	Tense
instigarán	instigan	Tense
enrollada	enrollado	Gender
enoja	enojan	Person
enseñó	enseñaron	Person
reasentará	reasentarán	Person
contorsionaréis	monopolizaréis	lemma
inmortalizada	inmortalizado	Gender
escaseaban	fregaban	lemma
condecoraron	transfirieron	lemma
flexionadas	flexionados	Gender
perpetuada	perpetuado	Gender
erotizada	erotizado	Gender
alzarían	alzaría	Person
abreviadas	abreviados	Gender
motivadas	motivados	Gender
vigilada	vigilado	Gender
espachurraseis	espachurrase	Person
extraerán	extraen	Tense
funden	funde	Person
anticipase	involucrase	lemma
fragmentaren	fragmenten	Tense
precia	precian	Person
marinasen	marinásemos	Person
seducidas	seducidos	Gender
desmitificadas	desmitificados	Gender
cuaje	cuaja	Mood
colonizadas	colonizados	Gender
preponderes	preponderases	Tense
obtenidas	obtenidos	Gender
blanqueada	blanqueado	Gender
miradas	mirados	Gender
titubearas	titubearais	Number
restablecieseis	restableciereis	Tense
colaborasen	colaborase	Number
guardada	guardado	Gender
satisficieras	satisficiera	Person
quejes	queje	Person
cañoneen	cañonearen	Tense
desconvenidas	desconvenidos	Gender
entretenidas	entretenidos	Gender
envenenadas	envenenados	Gender
deificáramos	fungiéramos	lemma
vinculadas	vinculada	Number
espumaren	espumare	Person
diseñara	humillara	lemma
rebasada	rebasado	Gender
acorraladas	acorralados	Gender
admire	admiremos	Person
afligía	incrementaba	lemma
vanagloríense	vanagloríese	Number
encarnada	encarnado	Gender
manufacturad	manufactura	Person
descerraje	personifique	lemma
cristianizada	cristianizado	Gender
apaguémonos	apáguense	Person
aceptado	pronunciado	lemma
abatanas	abatanarás	Tense
despistarías	terminarías	lemma
implantados	implantado	Number
permitidas	permitidos	Gender
descalifica	generaliza	lemma
afeminada	afeminado	Gender
exhibidas	exhibidos	Gender
repasada	repasado	Gender
codirigidas	codirigidos	Gender
solapadas	solapados	Gender
exiliada	exiliado	Gender
concentrasen	concentrase	Person
asilada	asilado	Gender
trituradas	triturados	Gender
espetáramos	espetara	Person
simuladas	simulados	Gender
flechadas	flechados	Gender
embaraza	normaliza	lemma
agriamos	agrían	Person
vandalizada	vandalizado	Gender
desagradaba	relacionaba	lemma
dosificada	dosificado	Gender
crece	crezcan	Person
mésense	mésese	Number
reabastecerá	reabastece	Tense
floreada	floreado	Gender
dignar	reimplantar	lemma
desembarcare	desembarcaren	Person
espigada	espigado	Gender
incursionásemos	incursionase	Person
alegraos	alégrate	Number
encerradas	encerrados	Gender
apedreados	reparados	lemma
extraída	extraído	Gender
desparecidas	desparecidos	Gender
prendida	prendido	Gender
hastiada	hastiado	Gender
domiciliadas	domiciliados	Gender
diluviadas	diluviados	Gender
cuadruplicamos	cuadrupliqué	Number
balareis	balare	Person
engalanó	engalanaron	Number
reverenciada	reverenciado	Gender
entristecíamos	testiguábamos	lemma
instrumentéis	instrumentes	Number
fijaos	fíjate	Number
normen	norme	Number
ababillaos	ababillémonos	Person
secuenciadas	secuenciados	Gender
abiertas	abierta	Number
barequean	barequea	Number
arietemos	arietáremos	Tense
inhumada	inhumado	Gender
filetearen	fileteare	Number
destapemos	destapásemos	Tense
corretee	correteare	Tense
copase	copásemos	Person
pertrechen	pertrechan	Mood
cortocircuitemos	cortocircuite	Person
atesoradas	atesorados	Gender
asfaltare	zafare	lemma
contactes	contactéis	Number
gerenciada	gerenciado	Gender
selladas	sellados	Gender
atrapadas	atrapados	Gender
contribuyamos	contribuya	Number
atraviesa	incrementa	lemma
portada	portado	Gender
instalada	instalado	Gender
encubrieres	encubras	Tense
encontraban	encontraba	Number
llaman	llamarán	Tense
enamórate	enamórense	Person
digne	rectifique	lemma
desmoralizase	desmoralizare	Tense
mediadas	mediados	Gender
incriminemos	incriminen	Person
caricaturizadas	caricaturizados	Gender
glaseada	glaseado	Gender
versioné	versionamos	Number
ahorrada	ahorrado	Gender
sueña	soñamos	Person
mejorados	mejorado	Number
ahumada	ahumado	Gender
detectada	detectado	Gender
relanzada	relanzado	Gender
sarmentada	sarmentado	Gender
conjuradas	conjurados	Gender
disculpen	materialicen	lemma
videograbasteis	videograbaron	Person
engañada	engañado	Gender
reconfortada	reconfortado	Gender
liberamos	libera	Person
escaneada	escaneado	Gender
conduélanse	conduélase	Number
tipificaba	tipificábamos	Person
aparcarían	instrumentalizarían	lemma
victimizase	victimizaseis	Person
desmigaremos	desmigaré	Person
enajenases	procreases	lemma
desmembradas	desmembrados	Gender
exculpadas	exculpados	Gender
independizadas	independizados	Gender
reintegrada	reintegrado	Gender
postulemos	postuláremos	Tense
contrabalanceases	contrabalancees	Tense
sometida	sometido	Gender
castellanizadas	castellanizados	Gender
adhiriera	adhiriéramos	Person
decapitada	decapitado	Gender
vacunada	vacunado	Gender
inmatriculadas	inmatriculados	Gender
empollaban	empollabais	Person
vapuleadas	vapuleados	Gender
asentidas	asentidos	Gender
abancalados	heridos	lemma
anidada	anidado	Gender
hilvanad	hilvanen	Person
ofrecida	ofrecido	Gender
apuntalaseis	apuntalásemos	Person
desmalezamos	recapacitamos	lemma
reconocerá	reconocerás	Person
amarra	amarran	Person
abiertos	abierto	Number
honran	honren	Mood
condecoraría	condecorarían	Person
arrasara	arrasaran	Number
amplificada	amplificado	Gender
circuyese	fundase	lemma
obstinada	obstinado	Gender
disciplinada	disciplinado	Gender
deplorarían	deplorarías	Person
burlaos	búrlate	Number
secretada	secretado	Gender
erguidas	erguidos	Gender
rindieran	rindierais	Person
truncadas	truncados	Gender
alcéis	vegetéis	lemma
buitreáis	buitreo	Person
ametralladas	ametrallados	Gender
estoqueásemos	estoquease	Number
modernizadas	modernizados	Gender
acolchonares	acolchonarás	Mood
embargada	embargado	Gender
estrecharon	rugieron	lemma
entró	entraron	Person
traicionada	traicionado	Gender
liaseis	liase	Person
inventada	inventado	Gender
cobijaba	cobijaban	Person
okupada	okupado	Gender
confiadas	confiados	Gender
charloteaste	charloteasteis	Number
maridase	maridaseis	Person
devanadas	devanados	Gender
besuqueara	pospusiera	lemma
definida	definido	Gender
descodificada	descodificado	Gender
moldeada	moldeado	Gender
escarchéis	escarchen	Person
desabrochaban	desabrochabais	Person
timará	timaré	Person
pirateadas	pirateados	Gender
guardan	guardarán	Tense
confabúlate	confabúlese	Person
otorguen	otorgue	Person
empañada	empañado	Gender
abotargaos	abotárguese	Person
cubren	cubrirán	Tense
atavíe	poche	lemma
acaudillase	acaudille	Tense
microscopiarais	microscopiaras	Person
aguardaban	aguardaba	Number
siéntanse	siéntete	Person
despeinase	despeine	Tense
circundan	circundarán	Tense
incentivadas	incentivados	Gender
valorizará	valoriza	Tense
dañada	dañado	Gender
contagiara	pegara	lemma
subsistida	subsistido	Gender
archivada	archivado	Gender
reinviertes	reinviertas	Mood
colindan	imploran	lemma
aplicadas	aplicada	Number
estimada	estimado	Gender
despega	despegará	Tense
abrillantasteis	sedimentasteis	lemma
acariciadas	acariciados	Gender
pegada	pegado	Gender
concertadas	concertados	Gender
recompensada	recompensado	Gender
traída	traído	Gender
decomisáremos	recalificáremos	lemma
abarcada	abarcado	Gender
resquebraje	resquebrajen	Number
agitadas	agitados	Gender
signadas	signados	Gender
adecuada	adecuado	Gender
vives	vivís	Person
depravadas	depravados	Gender
dilucidásemos	dilucidáremos	Tense
ensangrentadas	ensangrentados	Gender
extendidas	extendidos	Gender
subscribía	subscribían	Number
afirmaron	afirmó	Person
preconizada	preconizado	Gender
abrevase	sindicase	lemma
destripadas	destripados	Gender
embestidas	embestidos	Gender
evacuare	evacuaren	Number
reñida	reñido	Gender
embarranques	teclees	lemma
mancomunadas	mancomunada	Number
cepillada	cepillado	Gender
palpitamos	palpitaron	Person
ablacionaría	ablacionaríais	Person
especificadas	especificados	Gender
espolveen	espolvees	Person
avala	avale	Mood
simplificadas	simplificados	Gender
signase	signe	Tense
rezongó	rezongaste	Person
inmortalizarías	inmortalizaría	Person
contraída	contraído	Gender
heladas	helados	Gender
piropease	piropeare	Tense
desconvocaré	desconvocarás	Person
aggiornabas	aggiornabais	Person
tajada	tajado	Gender
polinizadas	polinizados	Gender
desbotonada	desbotonado	Gender
arrugada	arrugado	Gender
divulgada	divulgado	Gender
deglutirán	relegarán	lemma
exaltadas	exaltados	Gender
descomedida	descomedido	Gender
alegada	alegado	Gender
abotonada	abotonado	Gender
estancados	estancado	Number
divorcia	stalkea	lemma
frenteares	frenteare	Person
disputadas	disputados	Gender
aplatanasteis	aplatanaste	Number
invalide	invaliden	Number
abanarían	abanaríamos	Person
empatada	empatado	Gender
mostradas	mostrados	Gender
divorcio	olvido	lemma
atrasado	madurado	lemma
contrabandeáramos	contrabandeara	Person
encorsetadas	encorsetados	Gender
hinchaos	hinchémonos	Person
recapitulemos	recapitulásemos	Tense
amagada	amagado	Gender
restringidas	restringidos	Gender
abochornaréis	abochornarán	Person
enfrentase	enfrente	Tense
causen	cause	Person
desacertase	desacertásemos	Person
maravillaos	maravillémonos	Person
edificadas	edificados	Gender
hojaldrásemos	hojaldrasen	Person
entregara	entregaran	Number
tasadas	tasados	Gender
atinadas	atinados	Gender
rabiasteis	rabió	Person
invadiría	invadiríamos	Number
derrelinquieran	derrelinquiéramos	Person
intercalares	intercales	Tense
comprendiéremos	comprenderemos	Mood
tendidas	tendida	Number
menospreciada	menospreciado	Gender
especificaban	especificaba	Person
abaleamos	abaleasteis	Person
interesados	interesado	Number
llenaría	llenaríais	Person
desplegadas	desplegados	Gender
trasnochadas	trasnochados	Gender
allanar	señalar	lemma
purificada	purificado	Gender
ufanaos	ufánate	Number
retransmitiesen	retransmitiese	Person
abarrotada	abarrotado	Gender
evacuemos	evacúe	Person
entablillaríamos	reagruparíamos	lemma
abrevada	abrevado	Gender
resorberás	resorberán	Person
destruyeres	destruyas	Tense
justificadas	justificados	Gender
empadronadas	empadronados	Gender
explosione	explosionase	Tense
abalearen	foguearen	lemma
saturares	saturases	Tense
embebida	embebido	Gender
agregada	agregado	Gender
portad	porten	Person
disfrutada	disfrutado	Gender
embanderas	embanderes	Mood
desmaquillaré	desmaquillaremos	Number
autoabastecidas	autoabastecida	Number
abatojásemos	pololeásemos	lemma
destapadas	destapada	Number
materializada	materializado	Gender
apoderadas	apoderados	Gender
conformaba	influía	lemma
horrorizadas	horrorizada	Number
dilapidada	dilapidado	Gender
vistas	vistos	Gender
imbuidas	imbuidos	Gender
ajustadas	ajustados	Gender
deshace	laza	lemma
enjuiciadas	enjuiciados	Gender
atraídas	atraídos	Gender
enviadas	enviados	Gender
olvidasteis	olvidó	Person
amortiguadas	amortiguados	Gender
fecundizadas	fecundizados	Gender
recortas	recortarás	Tense
plasmare	plasmaré	Mood
runrunearía	runrunearíais	Person
replanteadas	replanteados	Gender
apretáramos	apretaran	Person
amputadas	amputados	Gender
apelmazarais	apelmazáramos	Person
culebreamos	culebreo	Number
alquila	soba	lemma
atiesé	atiesaron	Person
desencontrada	desencontrado	Gender
acogida	acogido	Gender
defoliaremos	nutriremos	lemma
configuran	vuelan	lemma
violareis	violéis	Tense
enarbolaríais	enarbolaría	Person
bolsearas	bolseáramos	Person
fosforecida	fosforecido	Gender
forcejearán	forcejearéis	Person
raigáis	raiga	Person
propinadas	propinados	Gender
barras	barra	Person
aclimátate	aclimátense	Person
afiebran	fluctúan	lemma
tañeré	taño	Tense
abrochaos	abróchense	Person
adulterad	adulteren	Person
davilaron	rabiaron	lemma
ahormares	quemares	lemma
ronroneaba	ronroneaban	Person
enrolláis	enrollaréis	Tense
anestesiarais	anestesiara	Person
rezada	rezado	Gender
helenizadas	helenizados	Gender
apagados	apagado	Number
esprintásemos	esprintase	Number
superada	superado	Gender
opine	opinen	Number
embellecidas	embellecidos	Gender
preponderéis	preponderemos	Person
eclosionada	eclosionado	Gender
resultarán	resultará	Number
contusionare	contusione	Tense
tonificarían	tonificarías	Person
referenciare	referenciáremos	Person
orquestada	orquestado	Gender
disuadiré	predeciré	lemma
excretadas	excretados	Gender
macolladas	macollados	Gender
vacié	vació	Person
descarboxilaron	lastimaron	lemma
espabilémonos	espabílense	Person
ensillaría	temblaría	lemma
preguntadas	preguntada	Number
meadas	meados	Gender
enladrillados	ingeridos	lemma
interactuada	interactuado	Gender
azucaráremos	retáremos	lemma
implantémonos	implántense	Person
traspapelaba	traspapelábamos	Number
sustituyas	sustituyáis	Number
acompasáis	acompasaréis	Tense
enrevesaríais	inventariaríais	lemma
monetizada	monetizado	Gender
torturadas	torturados	Gender
escatimadas	escatimados	Gender
mensajeásemos	mensajease	Person
infiltradas	infiltrados	Gender
entramparíamos	entramparías	Person
imputarías	imputaríais	Number
carpida	carpido	Gender
recomendada	recomendado	Gender
acatarás	acatares	Mood
vislumbrada	vislumbrado	Gender
desconcertaren	exprimieren	lemma
pallen	palle	Person
empalidecisteis	sanjasteis	lemma
clicada	clicado	Gender
empinareis	empinaseis	Tense
imposibilitares	imposibilitare	Person
circuncidada	circuncidado	Gender
antagonizare	antagonizareis	Person
enteraréis	enteráis	Tense
manoseadas	manoseados	Gender
avergonzadas	avergonzada	Number
apelmazareis	interdijereis	lemma
acampanada	acampanado	Gender
documento	documentaré	Tense
titren	titre	Number
llovidas	llovidos	Gender
empanadas	empanados	Gender
prepararán	preparará	Number
verberares	verberáremos	Person
erigieron	refrendaron	lemma
asesinada	asesinado	Gender
derribada	derribado	Gender
centrifugada	centrifugado	Gender
careara	ladeara	lemma
desalinizarían	desalinizaría	Person
reproducidas	reproducidos	Gender
hendíais	hendía	Person
acordada	sombreada	lemma
ayudáramos	ayudara	Person
desgravadas	desgravados	Gender
perfumadas	perfumados	Gender
cintilará	cintila	Tense
aportadas	aportados	Gender
vaciabas	vaciabais	Number
desobedecieron	desobedeció	Person
interiorizada	interiorizado	Gender
despeñaos	despéñate	Number
desacreditadas	desacreditados	Gender
nutrida	nutrido	Gender
desentendiéndose	trovando	lemma
acelerada	acelerado	Gender
comido	idealizo	lemma
tuitease	tuitee	Tense
trillas	trilláis	Person
escaecía	escaecías	Person
granulada	granulado	Gender
repuestos	repuesto	Number
dilucidarán	dilucidará	Number
deshidratada	deshidratado	Gender
pulsada	pulsado	Gender
abreva	restituye	lemma
contraídos	llevados	lemma
otorgamos	otorgo	Person
adherirá	resonará	lemma
aleteadas	aleteados	Gender
burocratizaré	burocratizare	Mood
mechada	mechado	Gender
tamizada	tamizado	Gender
llenadas	llenados	Gender
envejeces	envejecéis	Number
festejada	festejado	Gender
procesadas	procesados	Gender
inauguradas	inaugurados	Gender
matizadas	matizados	Gender
deterioradas	deteriorados	Gender
gaseen	gasearen	Tense
motivasen	motivase	Person
royereis	royere	Person
charloteada	charloteado	Gender
equivocados	equivocado	Number
abrigada	abrigado	Gender
impulses	impulséis	Person
aniquila	aniquilan	Number
brotamos	invisibilizamos	lemma
enflacada	enflacado	Gender
tenderías	tendería	Person
deterioró	zahirió	lemma
retada	retado	Gender
deambulamos	deambularon	Person
taladradas	taladrados	Gender
endilguen	odien	lemma
restauraríais	restaurarían	Person
correspondida	correspondido	Gender
amenizada	amenizado	Gender
integrad	integra	Person
enjuiciaba	funcionaba	lemma
edifico	miro	lemma
adversaren	adversares	Person
disparados	disparado	Number
responsabilizada	responsabilizado	Gender
cagadas	cagados	Gender
echémonos	échese	Person
oxidada	oxidado	Gender
entrecomillar	estar	lemma
doctorada	doctorado	Gender
ventilada	ventilado	Gender
garantizada	garantizado	Gender
canturreara	pretiriera	lemma
glorifique	glorifiquemos	Number
atrasada	atrasado	Gender
resentidas	resentidos	Gender
esperada	esperado	Gender
oxigenada	oxigenado	Gender
desemborrachadas	desemborrachados	Gender
erizados	inmovilizados	lemma
satisfecha	satisfecho	Gender
pronostiquéis	pronosticaseis	Tense
abucheáis	retribuís	lemma
conminando	sangrando	lemma
rotada	rotado	Gender
recolada	recolado	Gender
bramáis	sangráis	lemma
culpar	reconfigurar	lemma
escaladas	escalados	Gender
concesionada	concesionado	Gender
acuartelada	acuartelado	Gender
individualizada	individualizado	Gender
progrese	progresen	Number
asociase	vacunase	lemma
celebrarán	celebran	Tense
respectaron	respecté	Person
movidas	movidos	Gender
jodiésemos	jodiéremos	Tense
conmemorada	conmemorado	Gender
estornudada	estornudado	Gender
acordadas	acordados	Gender
curiosearás	curiosearé	Person
estilicen	estilizan	Mood
privatizase	privatizases	Person
empaqueté	empaquetasteis	Person
desbarranque	desbarranca	Mood
ajustada	ajustado	Gender
agendarán	agendará	Number
calcáremos	sumergiéremos	lemma
cita	parpadea	lemma
arruada	arruado	Gender
ascendierais	incomodarais	lemma
protegidas	protegidos	Gender
moteada	moteado	Gender
firmadas	firmados	Gender
auxiliado	lastimado	lemma
expelemos	expelo	Number
desacoplado	universalizado	lemma
antedichas	antedichos	Gender
compartan	resistan	lemma
boicotea	utiliza	lemma
descolgada	descolgado	Gender
vendidos	vendido	Number
chocheará	obedecerá	lemma
empolla	pospón	lemma
surgidas	surgidos	Gender
versificada	versificadas	Number
revendas	revendáis	Number
adoquinaren	adoquinarán	Mood
ocultaos	ocultémonos	Person
desenterraría	idearía	lemma
detallaba	detallábamos	Number
asen	ase	Number
prologada	prologado	Gender
desarropemos	induzcamos	lemma
aventurada	aventurado	Gender
incautadas	incautados	Gender
avizoraseis	avizoréis	Tense
adineradas	adinerados	Gender
extravías	extravío	Person
emponzoñando	minimalizando	lemma
corridos	corrido	Number
deflagréis	deflagres	Person
automatizadas	automatizados	Gender
rellenaré	rellenaremos	Number
autografiadas	autografiados	Gender
dudamos	dudo	Person
matados	matado	Number
compenetraras	compenetrara	Person
derrelinquieseis	ganaseis	lemma
encajar	mortificar	lemma
caducaban	caducabais	Person
secadas	secada	Number
asestasen	asestase	Number
endeudéis	endeudáis	Mood
tarareo	tararea	Person
masticadas	masticados	Gender
enloquezcámonos	enloquézcase	Person
tituláremos	titulare	Person
despertadas	despertados	Gender
descansada	descansado	Gender
conjurada	conjurado	Gender
exacerbadas	exacerbados	Gender
envergaron	envergó	Person
nivelarías	nivelaría	Person
enrevesada	enrevesado	Gender
devuelta	devuelto	Gender
acoplados	acoplado	Number
optimizadas	optimizados	Gender
aliñen	repregunten	lemma
acaban	acaben	Mood
tramada	tramado	Gender
retengan	retenga	Person
descorche	gaye	lemma
noveladas	novelados	Gender
entrecruzada	entrecruzado	Gender
clarificada	clarificado	Gender
sincopadas	sincopados	Gender
encastrase	encastrasen	Person
abonadas	abonada	Number
pónganse	póngase	Number
dulcificaba	narcotizaba	lemma
fanfarroneaseis	fanfarroneasen	Person
apoyaos	apóyate	Number
decelerada	decelerado	Gender
degeneradas	degenerados	Gender
intermediaré	intermediará	Person
diagramaríamos	diagramaríais	Person
asimilaba	trasluchaba	lemma
macerada	macerado	Gender
proporcionaba	proporcionaban	Person
gritan	gritas	Person
supervendría	supervendríais	Person
lijares	lijareis	Number
contextualizar	relegar	lemma
chapoteará	chapotea	Tense
arabizará	faenará	lemma
combáis	combaréis	Tense
majaban	majaba	Number
galopada	galopado	Gender
versifica	versifican	Number
estrenamos	estreno	Person
emocionada	emocionado	Gender
constreñida	constreñido	Gender
redondeas	redondeáis	Person
reprendida	reprendido	Gender
miniaturizadas	miniaturizada	Number
concedida	concedido	Gender
ingenie	ingeniare	Tense
abanderase	pepenase	lemma
cabrearéis	cabrearás	Number
ensancháremos	ensanchare	Number
escarpada	escarpado	Gender
empáquense	empáquese	Number
desaparecida	desaparecido	Gender
prestaba	prestaban	Person
defenderéis	defenderá	Person
atorgaría	sobreseería	lemma
fosforiladas	fosforilados	Gender
accionada	galvanizada	lemma
altercamos	yapamos	lemma
estrangulada	estrangulado	Gender
besuquearás	besuquearéis	Number
liquidadas	liquidados	Gender
heredará	hereda	Tense
colocó	colocamos	Person
xerografiábamos	xerografiaba	Person
aplacaréis	persuadiréis	lemma
empapemos	gañamos	lemma
comidas	comida	Number
atrasadas	atrasados	Gender
almacenará	almacena	Tense
mangaste	mangó	Person
confabulados	confabulado	Number
exhumada	exhumado	Gender
embriagábamos	embriagaban	Person
comportarán	comportará	Person
guarezcan	guarecieren	Tense
descartadas	descartados	Gender
autoabastécete	autoabastézcase	Person
excomulgada	excomulgado	Gender
cautivada	cautivado	Gender
aprestadas	aprestada	Number
debitadas	debitados	Gender
metaforizaba	metaforizábamos	Person
repliquéis	repliques	Number
enroscases	enroscares	Tense
aislaste	aislasteis	Person
desensibilizamos	desensibilizaste	Person
enamore	maje	lemma
fías	fiais	Number
fusiladas	fusilados	Gender
avizorad	avizoremos	Person
destituida	destituido	Gender
cremada	cremado	Gender
obréis	obráis	Mood
impactada	impactado	Gender
autorizaréis	autorizáis	Tense
desatendiesen	desatendiese	Number
destocada	destocado	Gender
finiquitare	finiquitará	Mood
escupís	escupes	Number
enganchadas	enganchados	Gender
derrotáremos	derrotare	Person
oso	osamos	Number
cicatrices	cicatrice	Person
sobren	sobre	Person
digiera	digiero	Mood
enfrasquémonos	enfrásquese	Person
chafadas	chafados	Gender
intoxiquéis	intoxicaseis	Tense
dure	durare	Tense
estarcieseis	profundizaseis	lemma
acontece	acontezcan	Person
perseguidas	perseguidos	Gender
estrangulases	estrangulasen	Person
desionizáremos	desionizare	Number
endilgases	tusases	lemma
enlace	enlaza	Mood
desocupamos	desocupemos	Mood
alimentara	fomentara	lemma
desmarimbéis	gayéis	lemma
asfaltase	asfalte	Tense
atacada	atacado	Gender
escalada	escalado	Gender
legitimada	legitimado	Gender
destripó	destripasteis	Person
texteábamos	texteabais	Person
jubilé	jubilasteis	Person
reglas	regla	Person
cercamos	cerqué	Person
autoexcluida	autoexcluido	Gender
alhajamos	alhajo	Person
presidieren	presidan	Tense
incinerada	incinerado	Gender
refanfinflásemos	refanfinflemos	Tense
frecuentada	frecuentado	Gender
despejadas	despejados	Gender
parqueares	parqueases	Tense
pizcaren	pizcasen	Tense
atrofiaremos	atrofiáremos	Mood
clasifícate	clasifíquense	Person
ligadas	ligados	Gender
agrandadas	agrandados	Gender
demandaren	demanden	Tense
bifurcáramos	saciáramos	lemma
desentonaréis	desentonareis	Mood
desandábamos	reciclábamos	lemma
despellejé	despellejamos	Number
aburridas	aburrida	Number
injuriaron	injuriaste	Person
apresurada	apresurado	Gender
conmemoradas	conmemorados	Gender
engendrada	engendrado	Gender
engalanaríamos	engalanaría	Person
ponderadas	ponderados	Gender
relativicen	relativizasen	Tense
trasformada	trasformado	Gender
llegaría	llegarían	Person
embobaría	embobaríais	Person
desolada	desolado	Gender
jineteásemos	jineteemos	Tense
reparadas	reparada	Number
suicidaos	suicídense	Person
internacionalizásemos	internacionalizáremos	Tense
patrulladas	patrullados	Gender
contenten	contentasen	Tense
enchufas	polinizas	lemma
sienten	sentís	Person
conspiras	conspirarás	Tense
hostiliza	hostilizad	Person
empaña	empañe	Mood
retranqueada	retranqueado	Gender
asiladas	asilados	Gender
reforestadas	reforestados	Gender
aposentase	aposentásemos	Number
aprovechada	aprovechado	Gender
pico	picamos	Number
maquillaría	maquillaríamos	Number
domestique	domestiquéis	Person
suturadas	suturados	Gender
encalleció	encallecimos	Person
refinen	refine	Person
parcharíamos	parcharíais	Person
amaos	ámense	Person
pacificada	pacificado	Gender
dejaras	sulfataras	lemma
mopeadas	mopeados	Gender
materializó	materializaron	Person
templaba	templaban	Person
ahorcaba	ahorcábamos	Number
jodida	jodido	Gender
calmen	calme	Number
enjabonaré	perjuraré	lemma
monetizan	moneticen	Mood
legislen	legislan	Mood
acentuares	retroiluminares	lemma
consumasen	consumase	Person
libran	librarán	Tense
golpeada	golpeado	Gender
calmada	calmado	Gender
pintados	pintado	Number
trastornada	trastornado	Gender
fracturarán	fracturará	Number
aruñen	soleen	lemma
franquea	franquean	Number
racionalizada	racionalizado	Gender
usada	usado	Gender
participara	participaras	Person
bombardeadas	bombardeados	Gender
rapeaste	rapeasteis	Person
descoyuntadas	descoyuntados	Gender
engrasadas	engrasados	Gender
ilegalizada	ilegalizado	Gender
recuadráis	recuadras	Number
desobedezca	raiga	lemma
jalare	jaláremos	Person
baremara	remordiera	lemma
compriman	comprimiesen	Tense
encabezada	encabezado	Gender
regentada	regentado	Gender
muñeron	muñiste	Person
acomodadas	acomodados	Gender
aceleraríais	raptaríais	lemma
trasborde	trasbordase	Tense
autenticadas	autenticados	Gender
reconsideradas	reconsiderados	Gender
anunciada	anunciado	Gender
tallaste	tallé	Person
hacinadas	hacinados	Gender
convirtiese	convirtieses	Person
mentalizaba	mentalizábamos	Number
despedidos	despedido	Number
desechada	desechado	Gender
aguijada	aguijado	Gender
zancajeare	zancajee	Tense
egresadas	egresados	Gender
bolseo	bolseas	Person
envejecida	envejecido	Gender
potenciaseis	potenciásemos	Person
apilare	secretare	lemma
grano	granamos	Person
callejearía	vituperaría	lemma
refinadas	refinados	Gender
paladee	paladea	Mood
despreciamos	promovimos	lemma
soterradas	soterrados	Gender
anquilosadas	anquilosados	Gender
dibujáramos	dibujarais	Person
saltee	saltea	Mood
completadas	completados	Gender
adornáis	adorno	Person
preponderadas	preponderados	Gender
languidecidas	languidecidos	Gender
acanalada	acanalado	Gender
denostada	denostado	Gender
achatarrares	achatarres	Tense
tocadas	tocados	Gender
cogidas	revueltas	lemma
erigíamos	erigías	Person
recalabais	recalábamos	Person
concedidas	concedidos	Gender
desplazadas	desplazados	Gender
situados	situado	Number
apaleé	apalearon	Person
detenida	detenido	Gender
postradas	postrados	Gender
ocurriríais	ocurriría	Person
deshelase	deshelare	Tense
orbito	orbite	Mood
comercializada	comercializado	Gender
cortan	exportan	lemma
estropeadas	estropeados	Gender
sobrerreaccionadas	sobrerreaccionados	Gender
alborotadas	alborotados	Gender
encuadraría	encuadraríais	Person
concertados	fomentados	lemma
abstenidas	abstenida	Number
elevan	elevarán	Tense
condensásemos	condensases	Person
conjugadas	conjugados	Gender
quedaos	quédense	Person
interponía	interponías	Person
colmarás	repiquetearás	lemma
desembrujarás	taquearás	lemma
desconcertares	desconcertare	Person
cubiertas	cubiertos	Gender
enfadados	enfadado	Number
retrasadas	retrasados	Gender
galvanizada	galvanizado	Gender
desincentivar	hospedar	lemma
confeccionada	confeccionado	Gender
demarcada	demarcado	Gender
describirían	describiría	Number
escenografiada	escenografiado	Gender
respaldadas	respaldados	Gender
localizada	localizado	Gender
importada	importado	Gender
desangró	sofocó	lemma
erigida	erigido	Gender
blasfememos	blasfemásemos	Tense
desmontáramos	desmontara	Person
punidas	punidos	Gender
sombreadas	sombreados	Gender
proferidas	proferidos	Gender
aniquilado	excarcelado	lemma
interpoladas	interpolados	Gender
enrarezcamos	enrareced	Person
vertebrara	vertebrarais	Person
denominadas	denominados	Gender
zuzaren	zuzare	Person
sentidas	sentidos	Gender
suspiraron	suspiré	Person
besuquease	limitase	lemma
esforzado	esforzados	Number
detallase	detallare	Tense
taconase	taconásemos	Person
sustraía	sustraíais	Person
pretendidas	pretendidos	Gender
despachadas	despachados	Gender
habilita	habilitan	Person
ejecutadas	ejecutados	Gender
socorridas	socorridos	Gender
fluida	fluido	Gender
sableéis	sablee	Person
resaltadas	resaltados	Gender
vuelvan	vuelven	Mood
escurrirías	escurriríais	Person
tensadas	tensados	Gender
situadas	situada	Number
encararéis	intensificaréis	lemma
acongojada	acongojado	Gender
coartada	coartado	Gender
compinchémonos	compínchese	Person
perdidas	perdidos	Gender
trabaje	trabajo	Mood
embarazases	embarazase	Person
guisadas	guisados	Gender
anestesiabas	irrespetabas	lemma
desterníllense	desterníllese	Number
debutasteis	debutó	Person
enredar	propender	lemma
ensayó	ensayamos	Person
encaladas	encalados	Gender
adinerada	adinerado	Gender
atenuada	atenuado	Gender
amortiguase	tercerizase	lemma
tapiareis	tapiare	Person
cuido	cuidas	Person
inmigrada	inmigrado	Gender
educáramos	generalizáramos	lemma
achatarrada	achatarrado	Gender
oxide	oxidase	Tense
predicha	predicho	Gender
batiéremos	batieres	Person
alborotada	alborotado	Gender
discurriese	discurriésemos	Person
bifurcaos	bifúrquese	Person
cuadriplicaremos	gravitaremos	lemma
elaborada	elaborado	Gender
entrecortadas	entrecortados	Gender
prestada	prestado	Gender
trapaleareis	trapalearen	Person
habituadas	habituados	Gender
sojuzgada	sojuzgado	Gender
retradujeseis	retradujeses	Person
maniatemos	maniatásemos	Tense
acalambradas	acalambrados	Gender
suscrita	suscrito	Gender
tipificaran	tipificáramos	Person
libertada	libertado	Gender
fosforilada	fosforilado	Gender
coaligadas	ostentadas	lemma
antojaré	transpiraré	lemma
confrontara	latiera	lemma
acrecentadas	acrecentados	Gender
fomentadas	fomentados	Gender
valgas	valga	Person
raída	raído	Gender
rizaren	ricen	Tense
desforzáremos	desforzare	Number
detones	vadees	lemma
aquejaron	solucionaron	lemma
prometida	prometido	Gender
desheredáis	desheredéis	Mood
vindicada	vindicado	Gender
tocada	tocado	Gender
desprendisteis	desprendiste	Person
acordases	acordase	Person
aflojaré	evocaré	lemma
cursarán	cursaréis	Person
blandías	blandían	Person
estacionada	estacionado	Gender
facturada	facturado	Gender
amoneste	amonesto	Mood
invaginas	invagináis	Number
aherrojarás	aherrojas	Tense
desembrujadas	desembrujados	Gender
protagonizadas	protagonizados	Gender
descompuestas	descompuestos	Gender
irrigaran	irrigarais	Person
decolase	reagrupase	lemma
voceadas	voceados	Gender
realzadas	realzados	Gender
desintegradas	desintegrados	Gender
desafiada	desafiado	Gender
infravalore	infravaloréis	Person
restituyan	restituya	Person
engrandeciese	presenciase	lemma
difaméis	difamareis	Tense
puesta	puesto	Gender
clavásemos	rescindiésemos	lemma
resolléis	resollaseis	Tense
demorasen	mencionasen	lemma
revisaría	revisarían	Person
ennegrezca	ennegrezcan	Number
sembramos	siembras	Person
cotizada	cotizado	Gender
elidieses	elidieres	Tense
abotargaos	abotárgate	Number
gangueada	gangueado	Gender
calló	callamos	Person
enfatizaban	enfatizaba	Number
curtida	curtido	Gender
presupuesta	presupuesto	Gender
acuaticéis	acuatice	Person
pallado	pallados	Number
rociada	rociado	Gender
monitorizadas	monitorizados	Gender
chorearen	gimieren	lemma
triunfe	triunfad	Person
asestada	asestado	Gender
inyectaseis	inyectase	Person
autorizadas	autorizados	Gender
estructurada	estructurado	Gender
aparejabais	urdíais	lemma
volearan	volearas	Person
oficializadas	oficializados	Gender
perdure	perduremos	Number
excavada	excavado	Gender
afluyeseis	sojuzgaseis	lemma
degollaremos	exculparemos	lemma
expedientase	expedientasen	Person
situadas	situados	Gender
amañada	amañado	Gender
rebasada	rebasadas	Number
estipuladas	estipulados	Gender
consuele	consolemos	Person
cohesionadas	cohesionados	Gender
acumulémonos	acumúlese	Person
acachetearíais	recetaríais	lemma
equivocada	equivocado	Gender
deambulase	pecase	lemma
majada	majado	Gender
humanizada	humanizado	Gender
avisadas	avisados	Gender
ornamentada	ornamentado	Gender
asimiladas	asimilados	Gender
distan	dista	Number
extraviamos	extravío	Person
enunciada	enunciado	Gender
revueltas	revueltos	Gender
comprometidas	comprometidos	Gender
cromada	cromado	Gender
abrís	abriréis	Tense
almacenarías	almacenaría	Person
enojaré	ustedearé	lemma
resurgidas	resurgidos	Gender
delirases	delirasen	Person
producidas	producidos	Gender
trabajadas	trabajados	Gender
desconfiada	desconfiado	Gender
alejadas	alejada	Number
birlar	rellenar	lemma
vagaras	vagarais	Person
solicitaba	solicitaban	Person
rehabilitan	rehabilita	Person
peralte	peralto	Mood
reagrupadas	reagrupados	Gender
sobreviraren	sobrevirasen	Tense
referidas	referida	Number
fingidas	fingidos	Gender
horrorizada	horrorizado	Gender
acense	precise	lemma
conformen	conforme	Person
escaseemos	escasee	Person
predeterminadas	predeterminados	Gender
misaste	misasteis	Number
remojada	remojado	Gender
distenderíamos	distenderíais	Person
pareceos	parézcanse	Person
destapadas	destapados	Gender
tatemaríamos	tatemarían	Person
arengó	reculó	lemma
inflan	inflarán	Tense
descontinuaron	presumieron	lemma
examinen	examinan	Mood
adueñado	solventado	lemma
restringida	restringido	Gender
despatarráis	despatarraréis	Tense
empalidecieren	empalidezcan	Tense
apoyen	apoyasen	Tense
sancocháis	sancocharéis	Tense
abusare	abusaré	Mood
datada	datado	Gender
instituida	instituido	Gender
brujulee	brujuleen	Number
aparearé	penderé	lemma
aprobada	aprobado	Gender
utilizados	utilizado	Number
perdida	perdido	Gender
amonaos	amonémonos	Person
consideraos	considérate	Number
concentradas	concentrados	Gender
desempolvare	desempolvase	Tense
siéntase	siéntete	Person
perreé	perreasteis	Person
amortajada	amortajado	Gender
anexada	anexado	Gender
resople	resoplase	Tense
bifurcan	bifurca	Number
congregada	congregado	Gender
hirvamos	hiervas	Person
lacerada	lacerado	Gender
vulcanizará	vulcanizarán	Number
codificada	codificado	Gender
descifradas	descifrados	Gender
asesine	asesinen	Number
callasen	trasladasen	lemma
gañirá	gañirán	Number
escindidas	escindidos	Gender
retroilumine	retroiluminen	Number
experimentan	experimentarán	Tense
enfadadas	enfadados	Gender
encastradas	encastrados	Gender
enfrentaseis	enfrentases	Number
empalmaría	ratearía	lemma
lavamos	lavaremos	Tense
dignáremos	dignare	Person
desenchufare	invisibilizare	lemma
banalizada	banalizado	Gender
alargada	alargado	Gender
clavadas	clavados	Gender
restringen	restrinjan	Mood
galguees	galgueéis	Number
sublimada	sublimado	Gender
embarradas	embarrados	Gender
apatrulle	apatrullare	Tense
empecinare	empecinará	Mood
barritarais	barritaras	Number
levantadas	levantada	Number
intercalaba	intercalaban	Person
escaquéate	ralea	lemma
zumbáremos	zumbásemos	Tense
masificáramos	masificaras	Person
charladas	charlados	Gender
arbolada	arbolado	Gender
administradas	administrados	Gender
encasquillada	encasquillado	Gender
embellecida	embellecido	Gender
hiperventilaras	hiperventiláramos	Person
desmenuzada	desmenuzado	Gender
vertebrada	vertebrado	Gender
configurada	configurado	Gender
estatuiremos	estatuiré	Number
escoltadas	escoltados	Gender
despezadas	despezados	Gender
revitalizada	revitalizado	Gender
techada	techado	Gender
delinearán	murarán	lemma
amonaos	amónense	Person
entendida	entendido	Gender
vistas	vista	Number
reflejadas	reflejados	Gender
discontinúa	recela	lemma
procurada	procurado	Gender
precavieses	precavieseis	Person
empañará	fregará	lemma
saltadas	saltados	Gender
deshojase	incautase	lemma
pasearán	pasean	Tense
desenterradas	desenterrados	Gender
enlosan	obscurecen	lemma
revalorizada	revalorizado	Gender
saponificada	saponificado	Gender
duelo	duela	Mood
tornada	tornado	Gender
chirriarías	subordinarías	lemma
gobernados	gobernado	Number
invocan	invocas	Person
aderezada	forrada	lemma
apurada	apurado	Gender
cabreásemos	cabrease	Number
ayustaría	lancearía	lemma
coronada	coronado	Gender
llenados	llenado	Number
tengo	tienen	Person
diplomen	diplome	Person
degradadas	degradados	Gender
destruyeses	pulseases	lemma
vedada	vedado	Gender
derivadas	derivados	Gender
destelláramos	destellara	Number
preceded	precedan	Person
idas	idos	Gender
rentabilizada	rentabilizado	Gender
hundida	hundido	Gender
sacudiríamos	sacudirían	Person
alquilada	alquilado	Gender
libraría	librarías	Person
descolonizase	descolonizaseis	Person
embarcado	reactivado	lemma
piafada	piafado	Gender
abatidas	abatida	Number
mazné	maznaste	Person
escatimada	escatimado	Gender
revisaban	revisaba	Number
guarnecían	guarnecía	Person
considerasen	consideren	Tense
mediatizadas	mediatizados	Gender
corporizadas	corporizados	Gender
acoplaren	acopláremos	Person
apresados	apresado	Number
remplazada	remplazado	Gender
enfrascada	enfrascado	Gender
rajuñasteis	rajuñó	Person
reasignadas	reasignados	Gender
curren	respiren	lemma
desovada	desovado	Gender
maniobréis	maniobraseis	Tense
desmejorada	desmejorado	Gender
computarizada	llegada	lemma
perforada	perforado	Gender
desocupaste	desocupamos	Person
comenzando	pretextando	lemma
acetificáis	insidiáis	lemma
plegadas	plegados	Gender
abancalarás	abancalares	Mood
constipada	constipado	Gender
televisada	televisado	Gender
revoleases	revoleares	Tense
economizadas	economizados	Gender
engalanaríamos	engalanarías	Person
empujábamos	intrincábamos	lemma
vanagloriada	vanagloriado	Gender
preciada	preciado	Gender
permitidos	permitido	Number
testificadas	testificados	Gender
escaldaremos	escaldaré	Person
disputaríais	disputarías	Person
preciados	preciado	Number
proveídas	proveídos	Gender
bautizadas	bautizados	Gender
encurtida	encurtido	Gender
asesorada	asesorado	Gender
autoabasteceos	autoabastézcase	Person
desilusionarán	desilusionará	Number
regobernará	regobernarán	Number
atenazadas	atenazados	Gender
ganadas	ganada	Number
propina	propinan	Person
arremedaban	arremedaba	Person
sancochada	sancochado	Gender
recubierta	recubierto	Gender
astringiere	astringiéremos	Person
desperezadas	desperezados	Gender
laburáremos	laburemos	Tense
rotadas	rotados	Gender
denunciada	denunciado	Gender
diptongada	diptongado	Gender
compeléis	compelemos	Person
intensificadas	intensificados	Gender
desempolvábamos	sucedíamos	lemma
dígnense	dígnese	Number
egresábamos	egresabas	Person
erizan	erizo	Person
asqueen	asquearen	Tense
acordonadas	acordonados	Gender
desvaída	desvaído	Gender
invaginásemos	invaginemos	Tense
reputadas	reputados	Gender
escuchada	escuchado	Gender
tapiada	tapiado	Gender
alejados	alejado	Number
plegáremos	plegare	Person
enjaezáis	enjaezaréis	Tense
recogidas	recogidos	Gender
entramare	entramáremos	Person
exudes	exudases	Tense
agolpaos	agolpémonos	Person
presenciadas	presenciados	Gender
subrayada	subrayado	Gender
guardadas	guardados	Gender
reconfigurada	reconfigurado	Gender
eximidas	eximidos	Gender
fusionadas	fusionada	Number
tamizaríais	tamizarías	Number
entrecerradas	entrecerrados	Gender
arietaren	sincretizaren	lemma
subtituladas	subtitulados	Gender
retraída	retraído	Gender
marginan	margina	Person
refutarías	refutaríais	Number
aturaras	aturara	Person
subyugada	subyugado	Gender
masculinizadas	masculinizados	Gender
sincoparé	sincopo	Tense
penas	penáis	Number
custodiaría	mineralizaría	lemma
expatriada	expatriado	Gender
tintada	tintado	Gender
robada	robado	Gender
hackeada	hackeado	Gender
borbollada	borbollado	Gender
centralizadas	centralizados	Gender
cobren	limpien	lemma
comparecía	obsequiaba	lemma
amplificábamos	amplificabas	Person
convivierais	conviviéramos	Person
desapalanco	desapalancamos	Person
especulada	especulado	Gender
recluida	recluido	Gender
desaprenderá	desaprenderán	Number
juntadas	juntados	Gender
indexásemos	indexase	Number
adormilado	vislumbrado	lemma
formalizadas	formalizados	Gender
ensamblada	ensamblado	Gender
avergonzadas	avergonzados	Gender
despelotadas	despelotados	Gender
acostados	acostado	Number
mascada	mascado	Gender
aplazadas	aplazados	Gender
desballestada	desballestado	Gender
agachaos	agáchate	Number
enquistada	enquistado	Gender
monitorizada	monitorizado	Gender
propinados	propinado	Number
retrajésemos	retrajéremos	Tense
desplumada	desplumado	Gender
adurí	adurieron	Person
chispee	chispeen	Person
cultivadas	cultivados	Gender
romanticemos	romantices	Person
embistieses	embistieseis	Number
olida	olido	Gender
ensayaban	seducían	lemma
reprehendidas	reprehendidos	Gender
digitada	digitado	Gender
acalorada	acalorado	Gender
guillotinada	guillotinado	Gender
ingresadas	ingresados	Gender
méate	meémonos	Person
supervisada	supervisado	Gender
respaldasen	respaldase	Number
prensadas	prensados	Gender
enflaquecisteis	resignasteis	lemma
amada	amado	Gender
encantadas	encantados	Gender
surfearais	surfearas	Number
destruimos	destruyo	Number
resemblásemos	resemblase	Person
independizados	independizado	Number
apacígüense	apacígüese	Person
interceden	intercede	Number
volcada	volcado	Gender
ganaos	gánense	Person
fustiguen	fustigue	Number
atrofiada	atrofiadas	Number
laminadas	laminados	Gender
omitidas	omitidos	Gender
sistematizadas	sistematizados	Gender
encandila	encandilará	Tense
trasgredida	trasgredido	Gender
divorciadas	divorciada	Number
maravillaos	maravíllate	Person
evidenciadas	evidenciados	Gender
fluye	fluid	Person
obedecida	obedecido	Gender
abobadas	abobados	Gender
tributáis	tributéis	Mood
pereceréis	perecerán	Person
tiznaba	tiznabas	Person
franelease	franeleásemos	Person
drenaba	libraba	lemma
reformatees	reformateen	Person
acurrucaos	acurrúcate	Number
cuajan	cuajarán	Tense
besada	besado	Gender
constatadas	constatados	Gender
acumula	menciona	lemma
abobábamos	predicábamos	lemma
desvanecida	desvanecido	Gender
atentamos	pautamos	lemma
blasonen	revengan	lemma
sumirán	sumen	Tense
aculada	aculado	Gender
dejad	déjense	Person
compararemos	propasaremos	lemma
condicionar	tolerar	lemma
cazaste	cazasteis	Number
ufanados	ufanado	Number
fatigadas	fatigados	Gender
pontifique	pontificase	Tense
desagregada	desagregado	Gender
anteviéremos	anteviere	Person
desbastaban	desbastaba	Person
continuadas	continuados	Gender
carteadas	carteada	Number
jadeara	jadearan	Number
adivinaríais	graznaríais	lemma
retribuyan	retribuya	Number
enloquecidos	enloquecido	Number
opacaríais	opacaríamos	Person
abrazada	abrazado	Gender
mitigadas	mitigados	Gender
acreditada	acreditado	Gender
blandía	rodaba	lemma
presentada	presentado	Gender
tumbe	tumbes	Person
mascullarán	mascullaren	Mood
prepárate	prepárese	Person
raptadas	raptados	Gender
aumentados	aumentado	Number
sufriésemos	sufriese	Number
agrandada	agrandado	Gender
desembrujabais	pensabais	lemma
exacerbabais	exacerbabas	Number
incomunicase	incomunicases	Person
apretada	apretado	Gender
desgracian	ululan	lemma
desconsiderada	desconsiderado	Gender
abonadas	abonados	Gender
otorgadas	otorgados	Gender
aumentadas	aumentados	Gender
gafaremos	gafaré	Number
echada	echado	Gender
catalices	catalizares	Tense
atenuaban	atenuaba	Number
ocultaréis	ocultarás	Person
alistabais	refulgíais	lemma
salgo	sale	Person
embotáis	glorificáis	lemma
agredida	agredido	Gender
role	rolemos	Number
incumbida	incumbido	Gender
maulladas	maullados	Gender
calificadas	calificados	Gender
hueveada	hueveado	Gender
graduadas	graduados	Gender
amparadas	amparados	Gender
codeó	ludió	lemma
amansaste	gañiste	lemma
becada	becado	Gender
empatadas	empatados	Gender
falsificadas	falsificados	Gender
telegrafiasen	telegrafiase	Number
agachémonos	agáchese	Person
serrasteis	serró	Person
desbordada	desbordado	Gender
aducen	obtienen	lemma
despeinasen	despeinen	Tense
hollada	hollado	Gender
contraprogramará	requisará	lemma
ronzadas	ronzados	Gender
referidos	referido	Number
aflojan	afloja	Number
trenzadas	trenzados	Gender
describiéramos	describiera	Person
chiváis	chivaréis	Tense
perezca	perezcáis	Person
desmoralizaré	desmoralizaremos	Number
cedida	cedido	Gender
agujeras	agujeres	Mood
venenciada	venenciado	Gender
transmigradas	transmigrados	Gender
desmesuradas	desmesurados	Gender
candada	candado	Gender
obstruida	obstruido	Gender
encular	retumbar	lemma
contabilizados	procreados	lemma
testificarás	testificaréis	Person
andas	ando	Person
gradas	grada	Person
pavoneaos	pavonéate	Person
enarbola	sobreestima	lemma
ensalzareis	redijereis	lemma
generadas	generados	Gender
discrepadas	discrepados	Gender
aprendan	aprenda	Number
bronceaos	broncéate	Number
reseñadas	reseñados	Gender
embetunabais	embetunábamos	Person
encarrilares	mancillares	lemma
mencione	menciona	Mood
parida	parido	Gender
esprintará	esprintaremos	Person
enmarcan	enmarcarán	Tense
antepaguemos	antepagamos	Mood
desaconsejadas	desaconsejados	Gender
adosadas	adosados	Gender
clavare	clavaren	Number
localizadas	localizados	Gender
difracta	difractará	Tense
untada	untado	Gender
pedías	pedía	Person
repotenciadas	repotenciados	Gender
obstarán	obstan	Tense
descarrilare	descarrile	Tense
encajonar	proferir	lemma
redimida	redimido	Gender
involucionen	involuciones	Person
cacheásemos	cacheemos	Tense
seleccionada	seleccionado	Gender
ahorcajados	ahorcajado	Number
invertiría	invertiríamos	Number
calcada	calcado	Gender
desabastecíais	suprimíais	lemma
acongojases	acongojásemos	Person
cliquearíais	cliquearía	Person
dragaríais	mordisquearíais	lemma
decodificadas	decodificados	Gender
descuidar	pertenecerse	lemma
finalizan	finalizo	Person
desobedecieron	desobedeció	Number
estatizaste	hediste	lemma
apuntillaseis	apuntillareis	Tense
condimentada	violentada	lemma
suplantadas	suplantados	Gender
imaginadas	imaginados	Gender
finalizo	finalizamos	Number
compiladas	compilados	Gender
opositada	opositado	Gender
teletransportada	teletransportado	Gender
tomada	tomado	Gender
concluyesen	concluyan	Tense
quebrantadas	quebrantados	Gender
chupeteares	chupetearás	Mood
pronunciadas	pronunciados	Gender
miramos	miras	Person
respectas	respectes	Mood
hidrataréis	hidratarás	Person
tutelada	tutelado	Gender
salmodiasen	salmodien	Tense
regenteada	regenteado	Gender
adverada	adverado	Gender
bareman	inteligen	lemma
juzgada	juzgado	Gender
corroídas	corroídos	Gender
inscrita	inscrito	Gender
conmocionada	conmocionado	Gender
publico	publica	Person
interrumpidas	interrumpidos	Gender
diagramar	frenar	lemma
revocada	revocado	Gender
holladas	hollados	Gender
construyeran	construyera	Number
espesas	espeso	Person
reunirían	reuniría	Person
implosionaríais	implosionarías	Number
anidaran	anidarais	Person
referida	referido	Gender
preparados	preparado	Number
forzada	forzado	Gender
tensioné	tensionó	Person
reagrupasen	reagrupaseis	Person
atribulada	atribulado	Gender
disueltas	disueltos	Gender
costeada	costeado	Gender
homenajeada	homenajeado	Gender
almagrada	almagrado	Gender
transcritas	transcritos	Gender
bloguees	blogueas	Mood
enaltecida	enaltecido	Gender
curvarías	curvaría	Person
consignada	consignado	Gender
revuelta	revuelto	Gender
cogerá	sorteará	lemma
arranca	arranquen	Person
fragmentada	fragmentado	Gender
ultrajareis	ultrajaréis	Mood
nitrificabais	nitrificaba	Person
remolcadas	remolcados	Gender
adamas	adaman	Person
aseguro	asegure	Mood
poseída	poseído	Gender
atravesadas	atravesados	Gender
enfurecierais	ficcionarais	lemma
pasados	pasado	Number
davilaríamos	davilaría	Number
ayudara	ayudáramos	Number
fosilizados	fosilizado	Number
hechas	hechos	Gender
caricaturizando	pareciéndose	lemma
teorizada	teorizado	Gender
uniformada	uniformado	Gender
embrujadas	embrujados	Gender
tachada	tachado	Gender
troceada	troceado	Gender
consumida	consumido	Gender
asfaltan	asfaltáis	Person
adaptados	adaptado	Number
germinada	germinado	Gender
desmanteladas	desmantelados	Gender
reincidisteis	reincidiste	Number
testimoniado	testimoniados	Number
hurtamos	hurté	Number
desembolsaren	desembolsare	Number
empotrada	empotrado	Gender
afirmaría	invadiría	lemma
acordadas	acordada	Number
acatada	acatado	Gender
monetarizaría	monetarizaríamos	Person
calman	calmas	Person
mancillarais	mancillara	Person
desempatadas	desempatados	Gender
irrespetada	irrespetado	Gender
invadidas	invadidos	Gender
aleados	perjurados	lemma
desviadas	desviados	Gender
pelean	peleen	Mood
congeniadas	congeniados	Gender
acudiré	acudo	Tense
digiera	luche	lemma
enquistan	remojan	lemma
abatojaría	insultaría	lemma
resueltas	resueltos	Gender
supeditada	supeditado	Gender
ofrendada	ofrendado	Gender
usen	use	Number
desentendeos	desentiéndase	Person
atontadas	atontados	Gender
recalentada	recalentado	Gender
deslumbréis	deslumbráis	Mood
predeterminásemos	predeterminasen	Person
funcionemos	funcione	Person
aparejado	aparejados	Number
asqueada	traumatizada	lemma
publicitadas	publicitados	Gender
repelida	repelido	Gender
destiladas	destilados	Gender
supervenidas	supervenidos	Gender
entregada	entregado	Gender
brindadas	brindados	Gender
deploradas	deplorados	Gender
embelleció	embellecieron	Number
impenderán	impendieren	Mood
consignarían	consignaría	Number
cesadas	cesados	Gender
partida	partido	Gender
conciliaba	posicionaba	lemma
coloreada	coloreado	Gender
descarnare	descarnaren	Person
transformada	transformado	Gender
soleadas	soleados	Gender
enchilase	enchilasen	Number
repiqueteasen	repiqueteases	Person
revendidas	revendidos	Gender
acrianzare	hirviere	lemma
traemos	traes	Person
ratificasen	ratifiquen	Tense
chapurreabas	chapurreabais	Number
lloviese	lloviésemos	Number
festoneada	festoneado	Gender
saltea	saltee	Person
preocupadas	preocupada	Number
testificabais	testificaba	Person
equivocó	talló	lemma
fachamos	fachó	Person
arbitrase	arbitrasen	Person
braceara	reemplazara	lemma
apelmazare	oscureciere	lemma
sientes	sienten	Person
familiaricemos	familiariza	Person
abigarradas	abigarrados	Gender
subrayáis	subrayan	Person
condolidas	condolida	Number
indignadas	indignados	Gender
alarmadas	alarmados	Gender
envenenada	envenenado	Gender
notase	note	Tense
seccionadas	seccionados	Gender
enervas	malentiendes	lemma
valuadas	valuados	Gender
depositada	depositado	Gender
capacitase	capacitasen	Person
enfadadas	enfadada	Number
envenenemos	hipnoticemos	lemma
atiborradas	atiborrados	Gender
desnivelares	desniveles	Tense
sellada	sellado	Gender
oxidadas	oxidados	Gender
centradas	centrados	Gender
prescrita	prescrito	Gender
encabezaríais	rojearíais	lemma
sentidos	sentido	Number
agrietada	agrietado	Gender
teletransportásemos	teletransportaseis	Person
ionicen	ionicéis	Person
fundadas	fundados	Gender
arañando	exprimiendo	lemma
clausuradas	clausurados	Gender
abandonada	abandonado	Gender
afánense	afánese	Number
fusionadas	fusionados	Gender
acampes	percutas	lemma
licenciada	licenciado	Gender
concreta	concretad	Person
mirada	mirado	Gender
disentirá	disintiere	Mood
aneblare	humillare	lemma
remuneradas	remunerados	Gender
santificada	santificado	Gender
compele	compelemos	Person
abogando	sucumbiendo	lemma
consensuadas	consensuados	Gender
casará	casare	Mood
geolocalizases	geolocalizares	Tense
puestas	puesta	Number
cotizadas	cotizados	Gender
prejuzgase	prejuzgue	Tense
desosáis	deshuesas	Person
ensalza	interfiere	lemma
crearemos	creamos	Tense
visitadas	visitados	Gender
desconectadas	desconectados	Gender
excedida	excedido	Gender
desvinculáramos	desvincularais	Person
reverenciadas	reverenciados	Gender
tejida	tejido	Gender
alojada	alojado	Gender
invertida	invertido	Gender
conseguidas	conseguidos	Gender
descontextualizadas	descontextualizados	Gender
amplificadas	amplificados	Gender
encarnan	sorben	lemma
enmascaramos	enmascaró	Person
presupuestada	presupuestado	Gender
emulgía	emulgías	Person
añejaba	exhalaba	lemma
preñada	preñado	Gender
expiráremos	expirare	Person
contribuidas	contribuidos	Gender
recreada	recreado	Gender
diferidas	diferidos	Gender
atendríais	atendrías	Number
dificultada	dificultado	Gender
desenredada	pertenecida	lemma
antecederán	antecederás	Person
elegida	elegido	Gender
acostadas	acostada	Number
maduraríamos	maduraría	Number
acaudillare	acaudille	Tense
ionizada	ionizado	Gender
guacareara	guacarearais	Person
chotead	forcejead	lemma
arrendaríamos	idiotizaríamos	lemma
concertare	rubricare	lemma
despepitaste	revesaste	lemma
desmadejaría	melgaría	lemma
discurría	planificaba	lemma
cebadas	cebados	Gender
habituare	habituaren	Person
condenadas	condenados	Gender
distribuirán	distribuiréis	Person
matadas	matada	Number
gestadas	gestados	Gender
avellanaba	avellanabas	Person
contoneaba	contoneaban	Number
abetunaran	festejaran	lemma
trasportara	trasportaran	Person
ampliada	vallada	lemma
considerados	considerado	Number
enojadas	enojada	Number
autoengañaos	autoengáñate	Person
arremedadas	arremedados	Gender
implosionamos	implosionaste	Person
discutirías	discutiría	Person
cultivo	cultive	Mood
pagadas	pagados	Gender
descentralizase	descentralizásemos	Number
proveída	proveído	Gender
reconvertida	reconvertido	Gender
venenciarais	venenciáramos	Person
aflorara	aflorarais	Person
enlace	rocíe	lemma
engolfada	engolfado	Gender
hincada	hincado	Gender
refundí	refundió	Person
comprimiríais	comprimirías	Number
aparcadas	aparcados	Gender
descodificaba	descodificaban	Number
inactivarían	inactivaría	Number
instáramos	instara	Person
argumente	argumenten	Number
sobrevalorada	sobrevalorado	Gender
desarrolle	meche	lemma
desacomodabais	desacomodabas	Person
arriendo	arrendáis	Person
declinarán	declinan	Tense
prospectada	prospectado	Gender
calificaran	calificara	Number
animada	animado	Gender
rehabilitada	rehabilitado	Gender
incrementada	incrementado	Gender
enmascaren	incentiven	lemma
cremaran	cremáramos	Person
esclavizará	esclaviza	Tense
reprendidas	reprendidos	Gender
enfriada	enfriado	Gender
medía	medían	Person
alentadas	alentada	Number
misadas	misados	Gender
licencio	licencia	Person
presumí	presumisteis	Person
señalizada	señalizado	Gender
dispusiéramos	dispusierais	Person
aferraría	aferraríais	Person
transportadas	transportados	Gender
estimadas	estimados	Gender
reteñida	reteñido	Gender
extrañada	extrañado	Gender
enemistadas	enemistados	Gender
arrullada	arrullado	Gender
asustada	asustado	Gender
enojados	enojado	Number
contaminada	contaminado	Gender
mercericen	mercerice	Number
adscrita	adscrito	Gender
defoliando	topeando	lemma
estilizase	preconizase	lemma
reconfiguraríais	reconfigurarían	Person
cómanse	comeos	Person
acompañaban	retrocedían	lemma
atenidas	atenida	Number
distinguida	distinguidas	Number
reclamare	reclamará	Mood
culminada	culminado	Gender
ignoremos	ignoren	Person
bufoneara	bufonearan	Person
sujetada	sujetado	Gender
decaías	decaía	Person
embaldosada	embaldosado	Gender
agraviamos	retamos	lemma
magulle	magullen	Number
tartamudeadas	tartamudeados	Gender
disgregábamos	rebatábamos	lemma
enfervorizaba	enfervorizábamos	Number
desahuciadas	desahuciados	Gender
tuteaba	tuteaban	Number
conjugar	extender	lemma
referido	referidos	Number
reclinares	reclinarás	Mood
sopesaban	sopesaba	Person
tramite	tramitase	Tense
emparentada	emparentado	Gender
estrangularán	pajearán	lemma
acaudilladas	acaudillados	Gender
compaginado	primado	lemma
desanimaras	desanimaran	Person
comparezca	comparezcáis	Person
frenadas	frenados	Gender
ruedo	ruede	Mood
abultada	abultado	Gender
rizad	rice	Person
mazné	maznasteis	Person
inscribíamos	inscribía	Person
rentadas	rentados	Gender
borbolladas	borbollados	Gender
dedicó	dedicamos	Person
denuncie	purgue	lemma
enoje	enojo	Mood
reusadas	reusados	Gender
échate	échense	Person
cabriolásemos	cabriolemos	Tense
añadimos	añaden	Person
relegada	relegado	Gender
desplumaren	desplumen	Tense
recibirás	recibiré	Person
gradan	grada	Number
agazapad	precocinad	lemma
aconsejamos	aconsejaste	Person
trasbordadas	trasbordados	Gender
molestada	molestado	Gender
industrializadas	industrializados	Gender
alivianadas	alivianados	Gender
aguantan	aguanto	Person
afinar	sanjar	lemma
arrogares	arrogarás	Mood
desmembrada	desmembrado	Gender
abordarían	abordaría	Person
anquilosadas	ralladas	lemma
transmute	transmutare	Tense
aproveche	impaciente	lemma
espiaba	sangraba	lemma
suelta	suelto	Gender
implantaos	implantémonos	Person
aparejo	aparejas	Person
predispuestas	predispuestos	Gender
parloteemos	parloteáremos	Tense
enojase	enojásemos	Number
remadas	remados	Gender
acercada	acercado	Gender
sonrosada	sonrosado	Gender
contestaseis	pestañeaseis	lemma
perpetraban	perpetrabas	Person
inyectada	inyectado	Gender
cuadradas	cuadrados	Gender
tendidos	tendido	Number
arrepentidas	arrepentidos	Gender
imitará	imitarán	Number
aprovisionaras	aprovisionarais	Number
marcada	marcado	Gender
sumergiera	sumergiéramos	Number
discordare	hendiere	lemma
despolvadas	despolvados	Gender
intrincadas	intrincados	Gender
regodeadas	regodeada	Number
desvalorizaseis	toreaseis	lemma
utilizabais	utilizaba	Person
refieres	referirás	Tense
iluminada	iluminado	Gender
abrigaste	vulcanizaste	lemma
otorgaren	otorgasen	Tense
sajaréis	sajará	Person
burbujeadas	burbujeados	Gender
derrumbares	gatillares	lemma
bese	besen	Number
maltraten	maltrate	Number
desdobladas	desdoblados	Gender
enranciéis	enranciemos	Person
adjuntaba	adjuntábamos	Person
abigarrada	abigarrado	Gender
eleve	tilde	lemma
procuraos	procurémonos	Person
succione	succiona	Mood
ajuste	ajusten	Person
aperciba	remita	lemma
desmontada	desmontado	Gender
impactase	impactasen	Number
debutareis	debutaseis	Tense
chifladas	chiflados	Gender
varares	vares	Tense
reprobadas	reprobados	Gender
opondré	opongo	Tense
maltraten	maltratan	Mood
bordearías	quebrarías	lemma
solucionada	solucionado	Gender
desistan	desista	Number
arreglare	arreglaren	Person
compendien	soliciten	lemma
engalanada	engalanado	Gender
decebiereis	relacionareis	lemma
rusificaría	rusificaríais	Person
engomará	optimará	lemma
curso	cursaré	Tense
metastaticemos	metastatizásemos	Tense
releía	releíamos	Number
dirige	frita	lemma
compensaríais	compensaría	Person
acantilarás	pasterizarás	lemma
suscribamos	suscriba	Person
florezca	florezcan	Person
fervorizarán	fervorizaré	Person
remezclado	remezclados	Number
contrarrestéis	contrarreste	Person
amónense	amónese	Person
avergonzados	avergonzado	Number
desabejadas	desabejados	Gender
escrutadas	escrutados	Gender
discontinuares	rebobinares	lemma
controladas	controlados	Gender
disertara	mondara	lemma
embarcarais	embarcaran	Person
inspeccionéis	inspeccione	Person
mezclada	mezclado	Gender
twitteabas	twitteaba	Person
sentida	sentido	Gender
secadas	secados	Gender
empalmar	trampear	lemma
avanzada	avanzado	Gender
despedacemos	mimamos	lemma
dilapidase	dilapidare	Tense
achicase	galopase	lemma
tolerada	tolerado	Gender
notadas	notada	Number
gimieres	gimiéremos	Person
adoquinada	adoquinado	Gender
repruebe	reprobase	Tense
asignarías	asignaríais	Number
operada	operado	Gender
enojada	enojado	Gender
ladraríamos	ladrarías	Person
traducida	traducido	Gender
deceleréis	decelere	Person
corrompida	corrompido	Gender
completamos	completé	Number
coadyuvadas	mitigadas	lemma
desahogado	sintonizado	lemma
deconstruyáis	deconstruya	Person
recalibradas	recalibrados	Gender
endosáremos	hostigáremos	lemma
compartimos	compartamos	Mood
delegas	delegues	Mood
describiste	describisteis	Person
restructuradas	restructurados	Gender
mojadas	mojados	Gender
vestidos	vestido	Number
arrumbare	floreciere	lemma
agobiada	agobiado	Gender
stalkeo	stalkeáis	Person
legislada	legislado	Gender
autoproclamamos	torpedeamos	lemma
deshumanizada	deshumanizado	Gender
ribeteadas	ribeteados	Gender
desatendidas	desatendidos	Gender
topetadas	topetados	Gender
abominaban	garrapateaban	lemma
subsumidas	subsumidos	Gender
desportillo	desportillan	Person
apropiada	apropiado	Gender
aumentadas	aumentada	Number
lavadas	lavados	Gender
empleen	emplean	Mood
resignada	resignado	Gender
agitan	agita	Number
retraduces	retraducen	Person
acontecerán	acontecen	Tense
deponga	deponed	Person
escenificase	trasnochase	lemma
atascadas	atascados	Gender
hipotecada	hipotecado	Gender
sufragarían	sufragarías	Person
desluciéremos	premeditáremos	lemma
afrontadas	afrontados	Gender
respetamos	respetas	Person
dependa	regocije	lemma
esmerados	esmerado	Number
pervividas	pervividos	Gender
discriminada	discriminado	Gender
transliteraban	transliterabais	Person
capturaran	capturara	Number
ronzada	ronzado	Gender
diferirán	diferirás	Person
adulteradas	adulterados	Gender
estandarizada	estandarizado	Gender
digite	pormenorice	lemma
adoptase	adoptasen	Person
alojados	alojado	Number
serruchen	serrucharen	Tense
preconocen	preconocerán	Tense
combarían	impondrían	lemma
apremió	regrabó	lemma
deificada	deificado	Gender
preparaos	prepárate	Number
descuartizada	descuartizado	Gender
habladas	hablados	Gender
madurada	madurado	Gender
autoengañada	autoengañado	Gender
contundáis	contundís	Mood
desconcertada	desconcertado	Gender
enraíces	enraizares	Tense
boicoteada	boicoteado	Gender
halladas	hallados	Gender
balbuceadas	balbuceados	Gender
mejorémonos	mejórese	Person
desenmascarase	pescase	lemma
encofrar	valuar	lemma
quitada	quitado	Gender
cedisteis	cediste	Number
galardonada	galardonado	Gender
arremolínense	arremolínese	Number
abarre	abarro	Mood
saturada	saturado	Gender
germanizadas	germanizados	Gender
encomiende	encomienda	Person
refregamos	refregaron	Person
acere	acerare	Tense
entrechocareis	religareis	lemma
desforcemos	incumplamos	lemma
desmembrabas	recaudabas	lemma
encamará	encama	Tense
contraídas	contraídos	Gender
iza	izáis	Person
acerrojadas	acerrojados	Gender
vengada	vengado	Gender
cerciorabais	perdíais	lemma
lactas	lactarás	Tense
mésate	mesémonos	Person
carretearéis	prepagaréis	lemma
censuraré	rivalizaré	lemma
consistamos	consistas	Person
ahorran	ahorra	Number
suscitada	suscitado	Gender
agraden	agradéis	Person
alega	alegan	Person
descrea	descreas	Person
desabejaras	infamaras	lemma
amistasen	amisten	Tense
procreada	procreado	Gender
trepada	trepado	Gender
véase	vete	Person
gravada	gravado	Gender
atada	atado	Gender
desvíe	desviare	Tense
trillada	trillado	Gender
coescrita	coescrito	Gender
exploradas	explorados	Gender
petrifiquéis	petrificáis	Mood
amañen	popularicen	lemma
remodeladas	remodelados	Gender
denotadas	denotados	Gender
cubrirían	cubriríamos	Person
atañen	implosionan	lemma
contextualizada	contextualizado	Gender
hecha	hecho	Gender
emanadas	emanados	Gender
intimaren	intimarán	Mood
reenviada	reenviado	Gender
arbitradas	arbitrados	Gender
achicharran	achicharrarán	Tense
apetecida	apetecido	Gender
carcajeaos	carcajéate	Person
burbujeáremos	burbujeásemos	Tense
torneadas	torneados	Gender
enmarañares	enmarañarás	Mood
emborronada	emborronado	Gender
calumniada	calumniado	Gender
engominaren	quintuplicaren	lemma
enyesaseis	enyesase	Person
pivotes	pivote	Person
corroboradas	corroborados	Gender
cohecharan	cohechara	Person
asirías	mercarías	lemma
usufructuaren	usufructuares	Person
formarían	formaría	Person
adoleces	adolezcas	Mood
cristalizadas	cristalizados	Gender
dimensionada	dimensionado	Gender
mellada	mellado	Gender
vaguearas	vaguearan	Person
reprimidas	reprimidos	Gender
portarán	portan	Tense
declamada	declamado	Gender
corresponsabilizan	corresponsabiliza	Number
gandujábamos	gandujabais	Person
empobrezca	postergue	lemma
restablecida	restablecido	Gender
aprehendidas	aprehendidos	Gender
desacoplada	desacoplado	Gender
copulaseis	copulásemos	Person
colapsaba	patrullaba	lemma
estibase	gritase	lemma
oscilasteis	oscilaste	Number
reeducases	reeducaseis	Number
cuestionadas	cuestionados	Gender
zuce	zuzase	Tense
desinsectare	desinsectáremos	Person
doblen	doblan	Mood
aquerenciados	aquerenciado	Number
apuñalada	apuñalado	Gender
enroscadas	enroscados	Gender
desobedecisteis	desobedecieron	Person
limpiados	limpiado	Number
infligida	infligido	Gender
incitaban	incitaba	Person
entrañara	lograra	lemma
decretaron	trocaron	lemma
deshojada	deshojado	Gender
escarpada	nutrida	lemma
acanalan	acanalamos	Person
absorbía	absorbían	Person
expropiadas	expropiados	Gender
plañáis	plañís	Mood
deconstruyereis	deconstruiréis	Mood
desdolarizáis	fragmentáis	lemma
cumplida	cumplido	Gender
avivadas	avivados	Gender
confiscada	confiscado	Gender
concadenares	reingresares	lemma
referenciásemos	referenciemos	Tense
aludidas	aludidos	Gender
excitara	excitaran	Number
asquea	fuma	lemma
ultrajareis	ultrajéis	Tense
caldeada	jaspeada	lemma
engrillaría	pleitearía	lemma
gorjee	gorjease	Tense
aguzadas	aguzados	Gender
engranada	engranado	Gender
difaméis	difamaseis	Tense
reportearais	reportearas	Number
desdolarizara	mirara	lemma
malparada	malparado	Gender
identificadas	identificados	Gender
acató	explayó	lemma
selfiadas	selfiados	Gender
farfullare	farfullase	Tense
ahumare	imbuyere	lemma
escoria	redunda	lemma
hilvanada	hilvanado	Gender
divulgadas	sumadas	lemma
elaboradas	elaborados	Gender
deforestadas	deforestados	Gender
desterrar	solubilizar	lemma
coloreara	lechara	lemma
dispensaba	mezclaba	lemma
encolerizada	encolerizado	Gender
avergüéncense	avergüéncese	Person
sombraba	sombrabas	Person
enroscaran	enroscaras	Person
pespuntada	pespuntado	Gender
estriadas	estriados	Gender
reconquistada	reconquistado	Gender
coadyuvada	coadyuvado	Gender
portáis	portaréis	Tense
parecidas	parecida	Number
tabulada	tabulado	Gender
acarrea	acarree	Mood
pocheáremos	pocheásemos	Tense
callados	callado	Number
enfermada	enfermado	Gender
dispensadas	dispensados	Gender
conquistadas	conquistados	Gender
enriquecería	enriquecerían	Person
consentido	consentidos	Number
bendijere	retornare	lemma
deshilachada	deshilachado	Gender
pasteurizada	pasteurizado	Gender
asestando	reiterando	lemma
humedeceré	humedezco	Tense
empodrecida	empodrecido	Gender
contended	timbrad	lemma
odiarais	odiara	Person
retraídas	retraída	Number
modulásemos	modulase	Number
acodémonos	acódese	Person
desbandadas	desbandados	Gender
adscribirán	infeccionarán	lemma
facultadas	facultados	Gender
erguida	erguido	Gender
pensada	pensado	Gender
organizadas	organizados	Gender
revocó	revocaron	Number
almagraron	almagrasteis	Person
lucraría	lucraríamos	Person
preseleccionadas	preseleccionados	Gender
rojearán	rojearé	Person
tostada	tostado	Gender
atemorizada	atemorizado	Gender
apuesta	apuesto	Gender
florecerían	floreceríamos	Person
contrastara	contrastáramos	Person
estigmatiza	estigmaticen	Person
exteriorizamos	exterioricemos	Mood
rescatada	rescatado	Gender
decreto	decretan	Person
esquivaseis	esquivasen	Person
centellas	centellarás	Tense
lavados	lavado	Number
recuperada	recuperado	Gender
alumbradas	alumbrada	Number
brutalicemos	brutalice	Person
titrada	titrado	Gender
diga	dijere	Tense
caracterice	caracterizo	Mood
jaspeada	jaspeado	Gender
pagado	pagados	Number
relacionadas	relacionados	Gender
personalizadas	personalizados	Gender
denostado	resguardado	lemma
ampliadas	ampliados	Gender
ajustician	ajusticia	Person
pavimentadas	pavimentados	Gender
rivalizamos	rivalizaremos	Tense
zumbada	zumbado	Gender
late	latid	Person
bendecida	bendecido	Gender
desocupé	desocupamos	Person
revertidas	revertidos	Gender
ingería	ingeríais	Person
acechó	incumplió	lemma
acogiese	priorizase	lemma
cansa	canse	Mood
coordiné	coordinasteis	Person
falseáremos	falseásemos	Tense
escodaban	escodaba	Number
rebataras	rebatarais	Number
anuncio	anuncian	Person
decolada	decolado	Gender
obsesionáramos	obsesionara	Number
embista	embistiese	Tense
cambiamos	prohibimos	lemma
chorreen	raspen	lemma
fertilizásemos	fertilizáremos	Tense
focalizare	focalizáremos	Person
remachada	remachado	Gender
contabilizadas	contabilizados	Gender
reaprovechadas	reaprovechados	Gender
involucradas	involucrados	Gender
descontada	descontado	Gender
centrara	presionara	lemma
renuncio	renunciaré	Tense
arreboladas	arrebolada	Number
observada	observado	Gender
acolchada	acolchado	Gender
envainadas	envainados	Gender
materializaban	materializaba	Person
embriagada	embriagado	Gender
retornará	retorna	Tense
intituladas	intitulados	Gender
sostengan	sostenga	Person
reemplazadas	reemplazados	Gender
ensuciase	ensuciare	Tense
orareis	orares	Number
significamos	signifiquemos	Mood
fortificarán	fortifican	Tense
opónganse	opóngase	Number
superviniereis	supervinieseis	Tense
asemejaba	asemejaban	Person
dañadas	dañados	Gender
publicase	publique	Tense
manejo	maneje	Mood
confligís	tamborileáis	lemma
acobardabas	mareabas	lemma
chinchar	mentorizar	lemma
blasonaren	blasonen	Tense
azuzase	fachase	lemma
absolvieses	absolvieres	Tense
abierta	abierto	Gender
investida	investido	Gender
totalizad	totalicen	Person
sablea	sableará	Tense
contraatacado	mencionado	lemma
redibujes	redibujases	Tense
emponzoñadas	emponzoñados	Gender
encontrarás	encontrarán	Person
dentellearais	dentellearas	Number
refrescada	refrescado	Gender
encumbrada	encumbrado	Gender
clausurada	clausurado	Gender
opacadas	opacados	Gender
daviladas	davilados	Gender
complementadas	complementados	Gender
colindarán	colindaren	Mood
agenciada	agenciado	Gender
madreados	madreado	Number
reformabais	reformaban	Person
protestare	protestase	Tense
diré	recorreré	lemma
desnivelarán	plastificarán	lemma
acacheteen	acachetean	Mood
surtidas	surtidos	Gender
almacenado	tendido	lemma
reelegida	reelegido	Gender
resincronizada	resincronizado	Gender
aprovisionó	preguntó	lemma
pixeladas	pixelados	Gender
lucidas	lucidos	Gender
prevariquen	prevarican	Mood
esposará	esposa	Tense
gozada	gozado	Gender
encuadernadas	encuadernados	Gender
ennegrecida	ennegrecido	Gender
confundidas	confundidos	Gender
sazonadas	sazonados	Gender
enamoró	expulsó	lemma
coartadas	coartada	Number
esclavizamos	fecundizamos	lemma
mutilada	mutilado	Gender
elimine	eliminen	Person
embalse	sise	lemma
abonada	abonado	Gender
aducida	aducido	Gender
siéntense	siéntese	Person
garrapiñase	garrapiñásemos	Number
apretad	reinsertad	lemma
afinada	afinado	Gender
reelaboradas	reelaborados	Gender
machetearéis	macheteará	Person
váyanse	váyase	Number
cansada	cansado	Gender
antedijéramos	antedijera	Number
repreguntamos	repreguntó	Person
traumatizó	traumatizaste	Person
copáramos	pautáramos	lemma
convocando	ridiculizando	lemma
conceptuada	conceptuado	Gender
irrigadas	irrigados	Gender
delaminaban	permeaban	lemma
grapásemos	grapemos	Tense
acrecentare	acrecentase	Tense
reposamos	reposáis	Person
balbucieres	balbuciéremos	Person
cosida	cosido	Gender
escoden	escodaren	Tense
disolviera	monitorizara	lemma
dignificaba	dignificábamos	Person
desmadejaban	incineraban	lemma
grillase	grillásemos	Number
endiosaba	endiosabas	Person
afinquen	tuérzanse	lemma
azote	azota	Mood
reequilibrarais	reequilibrara	Person
inspiradas	inspirada	Number
comenzadas	comenzados	Gender
jaquida	jaquido	Gender
repulsadas	repulsados	Gender
descocieran	transpusieran	lemma
consolidada	consolidado	Gender
inventadas	inventados	Gender
desbocó	desbocasteis	Person
autobombeaos	autobombéese	Person
redefinidas	redefinidos	Gender
agrupo	agrupamos	Person
amenazaran	amenazara	Person
arrulléis	arrulles	Person
colectada	colectado	Gender
aconsejad	trasfigurad	lemma
plasmé	plasmasteis	Person
enchuflad	untad	lemma
gobernareis	gobernaren	Person
internarías	internarían	Person
descolonizaren	descolonizare	Person
amalgamaran	amalgamáramos	Person
adeuda	adeudan	Number
prologadas	prologados	Gender
proscrita	proscrito	Gender
quemadas	quemados	Gender
enmascarar	zarpar	lemma
congratulan	mojan	lemma
afecta	afecte	Person
conformadas	conformados	Gender
entretejerán	entretejieren	Mood
concretadas	concretados	Gender
reabsorbidas	reabsorbidos	Gender
balbucearías	friccionarías	lemma
aprender	revolotear	lemma
ficase	ficaseis	Person
sonreída	sonreído	Gender
acuñábamos	silabeábamos	lemma
reforestada	reforestado	Gender
centralizaban	centralizaba	Number
endureció	perfiló	lemma
climatice	pensione	lemma
jubilada	jubilado	Gender
envueltas	envueltos	Gender
atravesaba	atravesaban	Person
desordenada	desordenado	Gender
bromeadas	bromeados	Gender
inmigradas	inmigrados	Gender
limada	limado	Gender
reprodúcete	reproduzcámonos	Person
clasificados	clasificado	Number
mosquea	mosqueen	Person
toman	tomáis	Person
estampadas	estampados	Gender
descascarillareis	palmeareis	lemma
desconcentrada	desconcentrado	Gender
abjurar	reciclar	lemma
interferida	interferido	Gender
armonizada	armonizado	Gender
amotinaseis	invernaseis	lemma
sancionaren	sancionare	Number
idee	idees	Person
reglamentada	reglamentado	Gender
batallamos	batallasteis	Person
baquío	baquiaré	Tense
envenenásemos	infatuásemos	lemma
colma	retoña	lemma
destruida	destruido	Gender
agólpate	agolpémonos	Person
aguijarías	aguijaríamos	Person
cedidas	cedidos	Gender
atravieses	atraveséis	Person
bautizaren	bautizare	Person
anadearíais	anadearías	Number
aglutiné	tamborileé	lemma
derivaría	derivarían	Number
marcaban	marcaba	Person
hinchaos	hínchense	Person
postrada	postrado	Gender
participe	participen	Person
adquirí	adquirimos	Person
acierten	aciertan	Mood
presididas	presididos	Gender
explotadas	explotados	Gender
apegándose	vandalizando	lemma
deteneos	detente	Number
diviértanse	diviértase	Person
acampada	acampadas	Number
acusada	acusado	Gender
optan	optamos	Person
llorabas	llorabais	Number
asustados	asustado	Number
achicharrada	achicharrado	Gender
previstas	previstos	Gender
compartidas	compartidos	Gender
disminuida	disminuido	Gender
inundada	inundado	Gender
regodéate	regodéense	Person
distínganse	distíngase	Number
aterrorizaren	persiguieren	lemma
conturbados	goleados	lemma
ciberacoses	reabras	lemma
quédense	quédese	Person
agruparíamos	agruparíais	Person
tomarían	tomaría	Person
incoásemos	incoáremos	Tense
intervengo	intervenimos	Number
trapeada	trapeado	Gender
aguzada	aguzado	Gender
remarcada	remarcado	Gender
aclaré	aclaró	Person
desinvierten	restallan	lemma
alimentadas	alimentados	Gender
exhortaremos	exhortáremos	Mood
restaurada	restaurado	Gender
instada	instado	Gender
encasquetamos	retrogradamos	lemma
boje	bojes	Person
sobrentendidas	sobrentendidos	Gender
recorridas	recorridos	Gender
licuadas	licuados	Gender
causada	causado	Gender
atalayaría	pavimentaría	lemma
masacradas	masacrados	Gender
subarriendo	subarrendaré	Tense
peleará	pelearán	Person
complejizada	complejizado	Gender
hurtada	hurtado	Gender
auscultaríais	perpetraríais	lemma
bancasen	bancase	Person
ustedeéis	ustedeaseis	Tense
murada	murado	Gender
abanicábamos	abanicabas	Person
sentados	sentado	Number
evocó	evocaron	Number
minada	minado	Gender
abarbetarán	abarbetará	Number
jodidas	jodidos	Gender
rendida	rendido	Gender
enjaularías	purificarías	lemma
escapadas	escapados	Gender
desfigurada	desfigurado	Gender
dudemos	duden	Person
penetradas	penetrados	Gender
derruida	derruido	Gender
resentida	resentido	Gender
confunda	confundamos	Person
cambian	fascinan	lemma
zampadas	zampados	Gender
vestidas	vestidos	Gender
pertenecieren	perteneciereis	Person
sobrepuesta	sobrepuesto	Gender
conspiráis	rebasáis	lemma
endosada	endosado	Gender
automatizarán	automatizaren	Mood
surtiste	surtieron	Person
participadas	participados	Gender
enterneciéramos	enternecieran	Person
despenalizan	levantan	lemma
afiligranar	romanzar	lemma
desintoxicadas	desintoxicados	Gender
racionada	racionado	Gender
estilizara	estilizaran	Person
trasoyeron	trasoyó	Number
embalsamaba	embalsamábamos	Person
escabechada	escabechado	Gender
enredada	silbada	lemma
colaborasen	colaboren	Tense
mandadas	mandados	Gender
arremedare	arremede	Tense
traslucho	traslucháis	Person
zigzagueabas	zigzagueábamos	Person
conquistases	conquistes	Tense
decodificada	decodificado	Gender
involucionare	involucionaren	Number
permanezco	permanecemos	Number
acometidas	acometida	Number
carbonizada	carbonizado	Gender
contraatacaríamos	contraatacaría	Number
lesionadas	lesionados	Gender
opuestas	opuestos	Gender
desregularéis	repostaréis	lemma
refundada	refundado	Gender
cabeceasteis	cabeceaste	Person
allanada	allanado	Gender
polinizáis	polinizas	Number
vendidas	vendida	Number
subcontratarán	subcontrataremos	Person
retundida	retundido	Gender
equivocadas	equivocada	Number
matada	matado	Gender
violada	violado	Gender
encendidas	encendidos	Gender
imaginemos	imaginamos	Mood
apretujadas	natas	lemma
transplantadas	transplantados	Gender
inutilizada	inutilizado	Gender
derrocan	hierran	lemma
prolongada	prolongado	Gender
campabais	campaban	Person
tesareis	teséis	Tense
decodifiquen	retraten	lemma
chispadas	malversadas	lemma
enredadas	enredados	Gender
muertas	muertos	Gender
agrietaran	agrietara	Person
canso	fondeo	lemma
acodado	razonado	lemma
racaneado	racaneados	Number
independícese	independízate	Person
encasillada	hundida	lemma
traquetean	traqueteen	Mood
financiadas	financiados	Gender
despoblada	despoblado	Gender
oponeos	oponte	Number
acontecida	acontecido	Gender
despoblaron	reprodujeron	lemma
homogeneizarían	homogeneizaría	Person
rodearéis	rodearás	Person
rebelen	rebelasen	Tense
improvisada	improvisado	Gender
trilladas	trillados	Gender
enrojecida	enrojecido	Gender
enceguecidas	enceguecidos	Gender
aprehendida	aprehendido	Gender
decelerando	finalizando	lemma
alisé	valsé	lemma
reaproveché	reaprovecharon	Person
apropiadas	apropiados	Gender
boqueadas	boqueados	Gender
apreciadas	apreciados	Gender
envasar	reponer	lemma
marinadas	marinados	Gender
enviudada	enviudado	Gender
entrene	entrena	Person
aleccionáis	aleccionas	Person
diputemos	diputásemos	Tense
trasnochabais	trasnochábamos	Person
coreada	coreado	Gender
adoptaba	adoptábamos	Number
simplificada	simplificado	Gender
interesaos	interésese	Person
cohechaba	sucedía	lemma
conforme	conformen	Person
ayustada	ayustado	Gender
fantaseada	fantaseado	Gender
purgara	purgáramos	Number
estimuladas	estimulados	Gender
destronada	destronado	Gender
alabadas	alabados	Gender
chufaren	chufáremos	Person
contraprogramemos	traspapelemos	lemma
medidas	medidos	Gender
mesadas	mesada	Number
contraindicada	contraindicado	Gender
cariciarán	tardarán	lemma
abochórnate	abochórnense	Person
criticada	criticado	Gender
bloquearas	bloqueara	Person
descascaradas	descascarados	Gender
estrío	particularizo	lemma
diplomada	diplomado	Gender
distinguidas	distinguidos	Gender
desacoplaba	frivolizaba	lemma
confiscadas	confiscados	Gender
autorretrátate	autorretrátense	Person
atemoriza	atemorizo	Person
desencriptadas	desencriptada	Number
desvaneciere	desvaneceré	Mood
dispararon	malgastaron	lemma
postensadas	postensados	Gender
conformados	conformado	Number
colectivice	colectivizare	Tense
revivió	revivieron	Number
imitadas	imitados	Gender
revitalizadas	revitalizados	Gender
pospuestos	pospuesto	Number
contiende	contienda	Person
naturalizaban	naturalizaba	Number
nevadas	nevados	Gender
reavivada	reavivado	Gender
motivó	motivé	Person
arañásemos	arañemos	Tense
disputare	disputaré	Mood
subtitularán	subtitularemos	Person
satirizada	satirizado	Gender
inculcan	inculca	Person
peínense	peínese	Number
banqueteados	banqueteado	Number
dictamina	dictaminan	Person
inventariadas	inventariados	Gender
drenados	temperados	lemma
culpe	culpase	Tense
desgracien	trinquen	lemma
chufemos	zanjemos	lemma
ocasionadas	ocasionados	Gender
referenciadas	referenciados	Gender
botada	botado	Gender
capearen	tremieren	lemma
discurrieses	puntualizases	lemma
despedace	humedezca	lemma
dignare	dignáremos	Person
desintegrada	desintegrado	Gender
grapasteis	grapó	Person
cuerpee	suscriba	lemma
inoculadas	inoculados	Gender
gafo	gafas	Person
impresionada	impresionado	Gender
congrego	relincho	lemma
interceptadas	interceptados	Gender
reencarnada	reencarnado	Gender
intensificaron	intensificó	Person
adiestrada	adiestrado	Gender
cabeceó	preconizó	lemma
fastidiada	fastidiado	Gender
guindaran	guindáramos	Person
mofan	mofa	Number
reprogramadas	reprogramados	Gender
curtiste	curtieron	Person
asesinó	asesiné	Person
persistiereis	persistáis	Tense
contacten	contacte	Number
incumplida	incumplido	Gender
empaquete	empaquetemos	Number
ensilladas	ensillados	Gender
corrida	corrido	Gender
multipliquen	multiplicasen	Tense
pontificó	pontificamos	Person
cedisteis	refutasteis	lemma
enloquezcámonos	enloquézcanse	Person
llevados	llevado	Number
sufridas	sufridos	Gender
entrenará	entrena	Tense
espíe	sonría	lemma
afilada	afilado	Gender
impulsase	impulse	Tense
castigada	castigado	Gender
conculque	conculquéis	Person
prepagada	prepagado	Gender
habría	habríamos	Number
bamboleadas	bamboleados	Gender
espaciáremos	espaciare	Number
despiértense	despiértese	Person
encubierta	encubierto	Gender
improvisen	improvise	Number
quejen	queje	Number
ordenas	ordenan	Person
demediadas	demediados	Gender
tecnificáis	tecnifico	Person
franquean	franqueo	Person
despojado	despojados	Number
demolidas	demolidos	Gender
deportada	deportado	Gender
trastabillada	trastabillado	Gender
lubricada	lubricado	Gender
comerciaba	subía	lemma
masen	mase	Number
cure	cura	Mood
secuestradas	secuestrados	Gender
encajen	encajad	Person
conviértete	convirtámonos	Person
aligeradas	aligerados	Gender
peritemos	peritásemos	Tense
crucificó	crucificaron	Number
adeudase	adeudare	Tense
rehabilitadas	rehabilitados	Gender
atrasara	atrasaras	Person
aplomaremos	reencantaremos	lemma
amenizarás	amenizas	Tense
alarmasen	alarmásemos	Person
reunid	reúne	Number
columpiados	columpiado	Number
muestrees	muestree	Person
basta	basto	Person
ahijada	ahijado	Gender
disparaos	dispárate	Person
engatusar	presentir	lemma
aislado	aislados	Number
arremedaréis	indultaréis	lemma
demandarais	irradiarais	lemma
empieces	empiece	Person
diseñadas	diseñados	Gender
realojadas	realojados	Gender
gané	ganó	Person
desguarneció	desguarnecieron	Person
fundada	fundado	Gender
endosabas	retractabas	lemma
apiladas	apilados	Gender
rebobinemos	rebobinen	Person
encasquetaríais	encasquetaríamos	Person
constataba	constataban	Number
pulverizada	pulverizado	Gender
sustraída	sustraído	Gender
apagadas	apagada	Number
atropelladas	atropellados	Gender
abanderada	abanderado	Gender
baratares	pesquisares	lemma
demodulen	demodulemos	Person
enquistará	volverá	lemma
incumpliésemos	incumpliesen	Person
cooperarán	cooperan	Tense
recitarais	recitaras	Number
arrebatadas	arrebatados	Gender
encantaseis	fabulaseis	lemma
decantaremos	decantaré	Person
glorificas	glorifiques	Mood
riego	riega	Person
alegares	reabrieres	lemma
blasfemamos	blasfemas	Person
desminada	desminado	Gender
desencantada	desencantado	Gender
recapturadas	recapturados	Gender
calentada	calentado	Gender
contempla	permuta	lemma
atonte	atontemos	Person
restallares	restalles	Tense
naces	nacen	Person
engordemos	engorden	Person
utilizadas	utilizados	Gender
crepitaríamos	crepitarían	Person
desacataremos	multaremos	lemma
liquidaréis	liquidaré	Person
desfuercen	reglamenten	lemma
encauzadas	encauzados	Gender
momificadas	momificados	Gender
encalabozáis	licitáis	lemma
bostecéis	bostezareis	Tense
focalizas	focalizamos	Person
innovada	innovado	Gender
esquiláremos	esquilásemos	Tense
abarloáramos	viboreáramos	lemma
resurgida	resurgido	Gender
atajases	atajaseis	Number
ajusticiadas	ajusticiados	Gender
traslapasen	traslapen	Tense
higienizamos	higienizo	Person
titularemos	titularé	Number
reprimiésemos	reprimiéremos	Tense
desordenad	desordenen	Person
resguardaos	resguárdense	Person
entrecruzare	entrecruzaré	Mood
encestes	enceste	Person
reformaban	reformaba	Person
derroto	teloneo	lemma
escuchados	falsificados	lemma
enmoquetada	enmoquetado	Gender
aforáramos	tremiéramos	lemma
cotorreaseis	provocaseis	lemma
delatadas	delatados	Gender
punida	punido	Gender
asuman	asumiesen	Tense
comprime	comprima	Mood
blanqueó	revisó	lemma
adobarás	adobaré	Person
ahoga	ahogue	Mood
atontada	atontado	Gender
destrababas	fugabas	lemma
reportada	reportado	Gender
revendiereis	revendieseis	Tense
molestadas	molestados	Gender
dilapidadas	dilapidados	Gender
conjeturan	conjetura	Person
bronceáramos	plegáramos	lemma
apreciada	apreciado	Gender
incineradas	incinerados	Gender
desideologice	desideologizase	Tense
inscribiere	inscribiré	Mood
estatizadas	estatizados	Gender
desarrollada	desarrollado	Gender
contagiada	contagiado	Gender
delegados	incumplidos	lemma
votadas	votada	Number
cagaren	cagasen	Tense
encala	repatría	lemma
terraformada	terraformado	Gender
comprobada	comprobado	Gender
encasquillase	encasquillases	Person
entremezclando	expidiendo	lemma
estribo	estriba	Person
desestacionalizes	desestacionalizares	Tense
egresada	egresado	Gender
escaldada	escaldado	Gender
mecanizadas	mecanizados	Gender
escotaban	retitulaban	lemma
diptongaréis	ministerializaréis	lemma
acodada	acodado	Gender
aplauda	aplaudan	Person
alumbraron	alumbró	Number
romancea	romanceamos	Person
imbricadas	imbricados	Gender
apechugarás	apechugaréis	Number
escondida	escondido	Gender
incrustadas	incrustados	Gender
bebida	bebido	Gender
entibiad	mitigad	lemma
equivoca	equivoco	Person
jactaos	jáctense	Person
industrializad	industrialicemos	Person
lastrará	lastraré	Person
contagiáis	contagiaréis	Tense
carpa	carpe	Mood
desempeñarais	desempeñaran	Person
evolucionada	evolucionado	Gender
anhelo	anhelamos	Number
rindan	rindas	Person
desfilemos	franqueemos	lemma
abarque	abarca	Mood
convertidos	convertido	Number
tropicalizadas	tropicalizados	Gender
enlata	titra	lemma
desempatamos	desempatan	Person
instauradas	instaurados	Gender
ahogada	ahogado	Gender
envasas	gimes	lemma
reunificadas	reunificados	Gender
alisará	alisare	Mood
pudiese	pudiesen	Number
contraiga	contraigan	Number
mecanografiada	mecanografiado	Gender
fluctuadas	fluctuados	Gender
reapareciésemos	reapareciéremos	Tense
desconcertadas	desconcertados	Gender
remozada	remozado	Gender
razonarías	razonaríais	Number
papa	papas	Person
apasionadas	apasionados	Gender
patrocinada	patrocinado	Gender
predeterminase	predeterminásemos	Person
odiada	odiado	Gender
proscribiría	proscribirían	Number
viradas	virados	Gender
derretirán	derretiré	Person
turqueadas	turqueados	Gender
ilustrada	ilustrado	Gender
alzada	alzado	Gender
mareada	mareado	Gender
carburizareis	pretiriereis	lemma
preocupa	preocupe	Mood
sospeche	sospecho	Mood
baquíe	exagere	lemma
reseñare	reseñares	Person
licitada	licitado	Gender
diseñadas	recocinadas	lemma
establecisteis	injeristeis	lemma
masajearon	masajeaste	Person
pasamos	pasé	Number
privatizada	privatizado	Gender
despiojare	despiojará	Mood
resistidas	resistidos	Gender
chamuscada	chamuscado	Gender
trabase	trabaseis	Person
lideré	lideramos	Number
balotareis	macerareis	lemma
huevearemos	hueveáremos	Mood
controvertiremos	historiaremos	lemma
repelidas	repelidos	Gender
regularizadas	regularizados	Gender
pásate	pásense	Person
engranaba	instaba	lemma
detengo	detenemos	Number
fallaron	fallé	Person
apaguémonos	apáguese	Person
versionases	versionase	Person
arribadas	arribados	Gender
dramatizarás	dramatizaréis	Number
arrestada	arrestado	Gender
tengamos	tenga	Number
conciliará	conciliarás	Person
asombrase	asombre	Tense
acompañara	acompañaran	Person
procreaba	procreaban	Number
remunerarás	remuneraréis	Person
modeladas	modelados	Gender
embrujarán	embrujará	Person
desacralizaron	desacralizaste	Person
refutadas	refutados	Gender
distinguida	distinguido	Gender
realzada	realzado	Gender
desertificadas	desertificados	Gender
hostilizare	hostilizáremos	Person
continuare	llenare	lemma
girarán	girará	Person
conglomeraríamos	fulguraríamos	lemma
cercada	cercado	Gender
abundando	yuxtaponiendo	lemma
complementaron	complementamos	Person
pertenécete	pertenézcanse	Person
diezmemos	restallemos	lemma
desmontadas	desmontados	Gender
granulabais	granulaba	Person
rapiñada	rapiñado	Gender
adivinadas	adivinados	Gender
reaprovechada	reaprovechado	Gender
inmortalizado	inmortalizados	Number
enjuncadas	enjuncados	Gender
pulvericemos	pulverice	Person
chambeara	sondeara	lemma
vista	visto	Gender
bese	besare	Tense
espaciada	espaciado	Gender
delaminas	delaminamos	Person
segregadas	segregados	Gender
indemnizada	indemnizado	Gender
compaginada	compaginado	Gender
concientizabas	concientizabais	Person
intentadas	intentados	Gender
italianizaba	italianizabais	Person
desemborrachen	desemborracharen	Tense
liquenizarán	liquenizaremos	Person
catearas	catearais	Number
envilezcáis	envilecieseis	Tense
agonicé	agonizasteis	Person
volearen	voleasen	Tense
ahorra	ahorro	Person
reinventada	reinventado	Gender
obsequiadas	obsequiados	Gender
reelaborarán	reelaboraren	Mood
saneadas	saneados	Gender
puntualizada	puntualizado	Gender
amordacéis	amordaces	Number
sucumbiré	sucumbiere	Mood
soñadas	soñados	Gender
malinterpretares	malinterpretare	Person
parlotearéis	parlotearé	Person
emanada	emanado	Gender
rularemos	rulamos	Tense
patentizábamos	patentizaban	Person
brame	repercuta	lemma
cuadruplicare	cuadruplicareis	Person
expedida	expedido	Gender
infatuaseis	infatuases	Number
comprare	compráremos	Number
encegueced	enceguece	Number
preponderaren	preponderareis	Person
cómanse	cómete	Person
abrotoñaba	abrotoñaban	Person
espacia	satiriza	lemma
resorbida	resorbido	Gender
dosifico	tatemo	lemma
desguarneciereis	desguarnecieres	Number
miniaturice	miniaturizase	Tense
abaten	abatimos	Person
desquiciaría	peregrinaría	lemma
esparcida	esparcido	Gender
derogadas	derogados	Gender
nubló	nublamos	Person
complique	complica	Mood
chantajees	hables	lemma
comportaré	comportará	Person
instale	instalemos	Person
encapucharas	encapucháramos	Person
apartadas	apartados	Gender
reconciliada	reconciliado	Gender
deletreada	deletreado	Gender
engarzarían	tapizarían	lemma
amontonada	amontonado	Gender
abarbete	abarbetad	Person
parcele	parcela	Mood
tramadas	tramados	Gender
anidadas	anidados	Gender
encasquetases	encasquetase	Person
convierto	convertiré	Tense
abonan	abona	Number
jadearía	jadearían	Number
comerciado	comerciados	Number
arremolinada	arremolinado	Gender
fildeas	fildeáis	Number
abotaguémonos	abotáguese	Person
desdoblásemos	desdoblemos	Tense
tatuada	tatuado	Gender
arrendadas	arrendados	Gender
espolvoreáis	espolvoreas	Number
adapta	adaptamos	Person
coproducidas	coproducidos	Gender
eyectada	eyectado	Gender
jubilaos	jubílense	Person
recolectabais	recolectabas	Person
empató	remplazó	lemma
maquillada	maquillado	Gender
limpíense	limpíese	Person
frene	frenemos	Number
celareis	celare	Person
historiadas	historiados	Gender
ejecutarían	ejecutaríais	Person
planificases	planificares	Tense
decretaréis	decretarás	Number
confirmadas	confirmados	Gender
posada	posado	Gender
albergadas	albergados	Gender
escobase	escobe	Tense
cojeas	cojean	Person
gestará	gesta	Tense
desesperes	hoces	lemma
regrabada	regrabado	Gender
descomidieras	descomidiera	Person
subastados	subastado	Number
aleásemos	alease	Number
fajada	fajado	Gender
vigilaran	vigilara	Number
cimbrada	cimbrado	Gender
cuadriculen	cuadriculemos	Person
debelaras	debeláramos	Person
coopta	cooptemos	Person
gobernadas	gobernados	Gender
zapé	zapamos	Person
cuarteadas	cuarteados	Gender
descontinuada	descontinuado	Gender
espiadas	espiados	Gender
arrimada	arrimado	Gender
antepondrá	antepondrán	Person
desencantéis	pleguéis	lemma
dosificaríamos	finalizaríamos	lemma
recalentaréis	recalentarás	Number
configuradas	configurados	Gender
inmortalizará	inmortaliza	Tense
embullaran	embullarais	Person
ahueca	ahuecad	Number
controlaríamos	rascaríamos	lemma
agoraría	proseguiría	lemma
dobladas	doblada	Number
empalideciereis	empalidecieres	Number
pasadas	pasados	Gender
compartida	compartido	Gender
carreteen	indaguen	lemma
pedalea	pedalean	Number
tusadas	tusados	Gender
inventariarais	inventariaras	Person
crotoreé	pontifiqué	lemma
cuantifico	cuantificamos	Person
tare	tara	Mood
supeditaron	supeditaste	Person
asestara	lograra	lemma
proyectadas	proyectados	Gender
desconsolada	desconsolado	Gender
descontrólate	descontrólense	Person
transmutáramos	transmutarais	Person
alejases	alejasen	Person
acolada	acolado	Gender
sumarán	suman	Tense
codiciada	codiciado	Gender
deshecha	deshecho	Gender
petrificaren	petrificáremos	Person
discutidas	discutidos	Gender
azadonados	regados	lemma
armonizases	armonices	Tense
redoblada	redoblado	Gender
mantenidas	mantenidos	Gender
valorizadas	valorizados	Gender
escaneadas	escaneados	Gender
apisonada	apisonado	Gender
desprestigiares	desprestigiarás	Mood
fiscalizada	fiscalizado	Gender
ennegrecidas	ennegrecidos	Gender
picoteemos	picoteásemos	Tense
transpiraríais	transpirarían	Person
acampada	acampado	Gender
hormigonareis	hormigonáremos	Person
autorrealizadas	autorrealizados	Gender
reestabilizarás	reestabilizaremos	Person
remojadas	remojados	Gender
prejuzgada	prejuzgado	Gender
bastoneaba	bastoneaban	Person
antepagábamos	antepagaba	Person
concuerden	concuerde	Person
bachearas	fortalecieras	lemma
suspendidas	suspendidos	Gender
damnificadas	damnificados	Gender
desideologizaras	desideologizáramos	Person
fusiónense	fusiónese	Person
enfervorizaren	enfervorizasen	Tense
impresas	impresos	Gender
personalizáramos	personalizarais	Person
tergiversada	tergiversado	Gender
adecúa	vacuna	lemma
impregnadas	impregnados	Gender
desalineases	desalineasen	Person
acotadas	acotados	Gender
subsumida	subsumido	Gender
encapuchada	encapuchado	Gender
ajustaría	supervaloraría	lemma
adorada	adorado	Gender
encontrada	encontrado	Gender
canalizaba	canalizabais	Person
aclarada	aclarado	Gender
avalentare	avaliente	Tense
cuestionaron	cuestioné	Person
predominada	predominado	Gender
absténganse	absténgase	Number
picare	picaren	Person
bala	balad	Number
conocí	conocimos	Person
oponeos	oponte	Person
apetecido	apetecidos	Number
vagabundearán	vagabundearéis	Person
ecualizaré	mercerizaré	lemma
escotadas	escotados	Gender
entreoyereis	entreoyeren	Person
escarpado	lazado	lemma
enrojecidas	enrojecidos	Gender
destruirán	tusarán	lemma
perjuraréis	perjuráis	Tense
interrumpida	interrumpido	Gender
destapada	destapado	Gender
derogada	ligada	lemma
entenebrecías	excavabas	lemma
costeadas	costeados	Gender
negadas	negados	Gender
ensanchadas	ensanchados	Gender
eriza	erizan	Person
lideradas	liderados	Gender
abatidos	abatido	Number
escindiríais	trompezaríais	lemma
gaseáis	gaseas	Number
desembocó	desembocaron	Number
acalenturada	acalenturado	Gender
dóblense	dóblese	Number
inmovilizada	inmovilizado	Gender
sancochadas	sancochados	Gender
condonábamos	condonabas	Person
atemperada	atemperado	Gender
adscritas	preguntadas	lemma
eclipsan	eclipsa	Number
flanqueada	flanqueado	Gender
rectificada	rectificado	Gender
floreadas	floreados	Gender
quejada	quejado	Gender
autolesionadas	autolesionados	Gender
enfangaren	enfanguen	Tense
fumbleadas	fumbleados	Gender
acordados	acordado	Number
aprestaría	restructuraría	lemma
disgregadas	disgregados	Gender
licitadas	licitados	Gender
aclimatada	aclimatado	Gender
traicionadas	traicionados	Gender
puñada	puñado	Gender
empujamos	empujas	Person
humillada	humillado	Gender
divinada	divinado	Gender
hilan	hila	Person
quedadas	quedada	Number
triplicada	triplicado	Gender
pulida	pulido	Gender
radicalizadas	radicalizados	Gender
entubadas	entubados	Gender
enterrada	enterrado	Gender
mimeografío	mimeografíe	Mood
vuelta	vuelto	Gender
negligiréis	negligirán	Person
revaloraste	revalorasteis	Number
alojarás	exclamarás	lemma
vendida	vendido	Gender
avellanadas	avellanados	Gender
decoloradas	decolorados	Gender
desmesurabais	desmesurabas	Person
aguapas	aguaparás	Tense
resuelta	resuelto	Gender
reflejan	reflejen	Mood
tripuladas	tripulados	Gender
enfebreciera	peregrinara	lemma
interpondrán	interpondrá	Number
acuñaría	acuñaríamos	Number
colapsadas	colapsados	Gender
remunerada	remunerado	Gender
calefaccionásemos	respaldásemos	lemma
abarcadas	abarcados	Gender
abultadas	recreadas	lemma
movilizada	movilizado	Gender
detenidas	detenida	Number
samplearás	sampleará	Person
deceleren	reexpidan	lemma
despreciada	despreciado	Gender
excretase	excrete	Tense
utilicémonos	utilizaos	Person
escopleen	escopleasen	Tense
dificultan	fluyen	lemma
desmelenaren	desmelenen	Tense
protegiesen	protejan	Tense
balacee	balaceen	Number
masajearé	masajeo	Tense
anarquizarías	anarquizaría	Person
adormecida	adormecido	Gender
galantearemos	galantearás	Person
atregüé	humedecí	lemma
sobreestimaras	sobreestimáramos	Person
desbarrancad	murad	lemma
pepenen	pepene	Person
refresquen	refresque	Number
desbocabas	olfateabas	lemma
fíjense	fíjese	Person
comes	comemos	Person
delinquiera	sentara	lemma
cooptéis	cooptaseis	Tense
contar	pregonar	lemma
familiarizaba	familiarizaban	Number
desocupadas	desocupados	Gender
echo	fusiono	lemma
moteadas	moteados	Gender
encajada	encajado	Gender
concernidas	concernidos	Gender
detonéis	detone	Person
suprimida	suprimido	Gender
atirantada	atirantado	Gender
envidie	envidiare	Tense
acaireladas	acairelados	Gender
cuadriculada	cuadriculado	Gender
detallare	detalle	Tense
fomentada	fomentado	Gender
recortaran	recortara	Person
sospechases	sospechaseis	Number
devaluadas	devaluados	Gender
reinscribirán	reinscribieren	Mood
barbada	barbado	Gender
gorroneara	gorronearan	Person
garantizadas	garantizados	Gender
afirmado	iniciado	lemma
ametrallaría	ametrallaríais	Person
precalienten	precaliente	Number
inculpada	inculpado	Gender
encorvada	encorvado	Gender
ascendidos	exigidos	lemma
crispada	crispado	Gender
mermadas	mermados	Gender
fermentadas	fermentados	Gender
catapultarás	catapultaréis	Person
colorida	colorido	Gender
arruinemos	arruinamos	Mood
sisadas	sisados	Gender
desposeída	desposeído	Gender
abatanara	remontara	lemma
resentidas	resentida	Number
llevadas	llevados	Gender
tallan	talla	Number
rumbeadas	rumbeados	Gender
dificultaríamos	dificultaría	Person
asombrará	sobreentenderá	lemma
cosechada	cosechado	Gender
fachadas	fachados	Gender
sobredimensionadas	sobredimensionados	Gender
ideada	ideado	Gender
agüitémonos	agüítense	Person
curtidas	curtidos	Gender
atezamos	zancajeamos	lemma
desahuciamos	desahuciaremos	Tense
guardaré	guardarás	Person
están	estarán	Tense
sesgasen	sesguen	Tense
enmarañadas	enmarañados	Gender
beatificada	beatificado	Gender
notaba	notaban	Person
resistían	resistía	Person
muerta	muerto	Gender
condenadas	condenada	Number
ofrendare	ofrendará	Mood
avergonzaos	avergüénzate	Number
alucemos	aluzásemos	Tense
enfundadas	enfundados	Gender
machacada	machacado	Gender
dribleada	dribleado	Gender
detenidas	detenidos	Gender
hipnotizaríamos	hipnotizaría	Number
complacidas	complacidos	Gender
puestas	puestos	Gender
redondeadas	redondeados	Gender
acomodada	acomodado	Gender
citéis	citareis	Tense
traiga	traigan	Person
temblada	temblado	Gender
hollaríamos	hollaría	Person
desinfectará	refrendará	lemma
publicitarían	publicitaría	Number
colapsara	colapsarais	Person
tecnificadas	tecnificados	Gender
pertrechadas	pertrechados	Gender
espumo	reacondiciono	lemma
buitrease	puentease	lemma
comprometiera	comprometieran	Number
lijada	lijado	Gender
obligas	obligarás	Tense
descarnadas	descarnados	Gender
enfundáis	relacionáis	lemma
avanzasen	avanzase	Person
reseñada	reseñado	Gender
galopadas	galopados	Gender
ababíllense	ababíllese	Number
enmarcadas	enmarcados	Gender
bloqueada	bloqueado	Gender
afincadas	afincados	Gender
repudiada	repudiado	Gender
posicionada	posicionado	Gender
supliquéis	supliques	Number
expoliaba	expoliábamos	Person
periclitadas	periclitados	Gender
burilaran	refunfuñaran	lemma
activáis	recuadráis	lemma
estigmatizadas	estigmatizados	Gender
degenerada	degenerado	Gender
evocadas	evocados	Gender
prepintadas	prepintados	Gender
exulceras	exulceres	Mood
sulfuramos	sulfuraremos	Tense
maldije	maldijeron	Person
coleguea	coleguean	Person
paginada	paginado	Gender
trasplantadas	trasplantados	Gender
depilarías	optimizarías	lemma
materializaría	materializarían	Number
aglutinase	aglutine	Tense
imaginada	imaginado	Gender
entrampará	entramparé	Person
caracterizado	traspapelado	lemma
recusadas	recusados	Gender
requiriésemos	requirieseis	Person
accionadas	tercerizadas	lemma
descafeinadas	descafeinados	Gender
atalayaríamos	pelearíamos	lemma
desanimadas	desanimados	Gender
dispusiere	dispusieren	Person
cabida	cabido	Gender
crecida	crecido	Gender
saqueado	saqueados	Number
preparaos	preparémonos	Person
suministraren	suministrare	Person
alistado	alistados	Number
explayada	explayado	Gender
verificada	verificado	Gender
aprisionada	aprisionado	Gender
enloquezca	lidere	lemma
profesionalizada	profesionalizado	Gender
embarcarais	embarcáramos	Person
despeina	despeinen	Person
destetadas	destetados	Gender
hospitalizadas	hospitalizados	Gender
cometida	cometido	Gender
elogian	elogia	Person
entretejiese	hormigonase	lemma
desconciertan	desconcierten	Mood
acopiemos	acopien	Person
secundara	secundaras	Person
bracearán	braceará	Number
arrecida	arrecido	Gender
desembaláis	desembalan	Person
parloteéis	parloteen	Person
traslúcete	traslucíos	Number
regentadas	regentados	Gender
huronearás	huroneares	Mood
contemporizarán	contemporizará	Number
danzadas	danzados	Gender
listada	listado	Gender
zombificadas	zombificados	Gender
calcula	lega	lemma
cohesionáramos	cohesionaras	Person
gritada	gritado	Gender
apelotonase	apelotonásemos	Person
apuestas	apuestos	Gender
catolizaras	catolizara	Person
conseguía	conseguían	Number
abonares	abonáremos	Person
informatizada	informatizado	Gender
concesionó	faltó	lemma
transmigrada	transmigrado	Gender
descarbonatas	descarbonata	Person
escaldadas	escaldados	Gender
picoteemos	picoteáremos	Tense
errásemos	halagásemos	lemma
amansada	amansado	Gender
sedada	sedado	Gender
desgarrarías	desgarraría	Person
federabais	federaba	Person
entronicemos	trapaleemos	lemma
echadas	echados	Gender
desvariada	desvariado	Gender
exigidas	exigidos	Gender
barrases	barrares	Tense
empedrada	empedrado	Gender
maniobradas	maniobrados	Gender
tonsurada	tonsurado	Gender
encontradas	encontrados	Gender
coquetearía	coquetearíais	Person
casca	cascad	Number
vehiculas	vehiculáis	Number
pegara	pegaran	Person
cicatrizarán	cicatrizarás	Person
agrietáramos	agrietara	Person
encuadernada	encuadernado	Gender
propiciadas	propiciados	Gender
especifican	suplantan	lemma
contraindicadas	contraindicados	Gender
revéngase	revente	Person
alardeáremos	oxidáremos	lemma
condonar	proponer	lemma
cohabitaseis	cohabitareis	Tense
gargarice	gargaricéis	Person
pospuestas	pospuestos	Gender
mateaste	matearon	Person
idos	vete	Number
ilusionada	ilusionado	Gender
esgrimen	orlan	lemma
manifestadas	manifestados	Gender
encaminares	encaminases	Tense
coreaba	coreaban	Number
supeditadas	supeditados	Gender
circundada	circundado	Gender
importadas	importados	Gender
infártense	infártese	Person
pegadas	pegada	Number
envidiado	envidiados	Number
bamboleara	bamboleáramos	Number
desalojadas	desalojados	Gender
titradas	titrados	Gender
abundaba	militarizaba	lemma
compilada	compilado	Gender
acarrea	acarrean	Number
romanizadas	romanizados	Gender
abandonemos	abandone	Number
aherrumbraran	mordieran	lemma
disfamásemos	disfamasen	Person
trincháremos	trincharemos	Mood
burocratizada	burocratizado	Gender
candidateáremos	transfiriéremos	lemma
enceradas	encerados	Gender
enlistada	enlistado	Gender
reinscribíamos	reinscribías	Person
ajada	ajado	Gender
abrevarás	abrevas	Tense
arramplamos	arramplemos	Mood
radicalizados	radicalizado	Number
apronta	predice	lemma
acorreríamos	solicitaríamos	lemma
amenazada	amenazado	Gender
adorna	adorne	Mood
cuerpeamos	ocurrimos	lemma
desinsectarais	desinsectaran	Person
despedidas	despedidos	Gender
malhieren	malherirán	Tense
descosida	descosido	Gender
hipotecadas	hipotecados	Gender
degenerarían	degeneraríamos	Person
algopaos	algópense	Person
trasmitiremos	trasmitirá	Person
trabajé	trabajó	Person
plastificásemos	plastifiquemos	Tense
encuartelase	encuartelare	Tense
enrabietarás	enrabietas	Tense
supero	superan	Person
preparadas	preparada	Number
amparare	amparares	Person
catolizada	catolizado	Gender
gratinada	gratinado	Gender
aconsejada	aconsejado	Gender
descodificar	pajarear	lemma
hilvanas	hilvanes	Mood
desmejoraría	desmejoraríais	Person
faroleadas	faroleados	Gender
planificare	planificase	Tense
descontroladas	descontrolada	Number
vistámonos	vístanse	Person
turisteare	turisteáremos	Number
ajé	ajaron	Person
cercaría	teorizaría	lemma
cimbraran	tutelaran	lemma
alzadas	alzados	Gender
enumerarían	enumeraría	Number
empalada	empalado	Gender
embriagaría	nombraría	lemma
declarando	nevando	lemma
escamparemos	escampáremos	Mood
sobrepasadas	sobrepasados	Gender
mopeada	mopeado	Gender
cinceladas	cincelados	Gender
suscitaba	suscitabas	Person
accidéntense	accidéntese	Number
extienda	extiendan	Person
reposaremos	reposáremos	Mood
mangada	mangado	Gender
encajonado	incautado	lemma
sintetizada	sintetizado	Gender
tallada	tallado	Gender
sueña	sueñas	Person
adoquinadas	adoquinados	Gender
besuqueadas	besuqueados	Gender
reargüirías	reargüiríais	Number
discutimos	discutiremos	Tense
desangrada	desangrado	Gender
encargadas	encargados	Gender
enlace	enlaces	Person
demandaste	demandasteis	Person
pactad	pacta	Number
desbaratada	desbaratado	Gender
atenacen	atenace	Person
encienden	enciendan	Mood
residida	residido	Gender
acerca	acercan	Number
repercutiréis	repercutirá	Person
persuadida	persuadido	Gender
desmocharías	fotocopiarías	lemma
pujaras	pujarais	Person
reiteramos	reiteraron	Person
rebajadas	rebajados	Gender
afrontara	afrontaran	Number
entraréis	violaréis	lemma
pisoteemos	pisoteen	Person
abotagadas	oradas	lemma
repujare	repujareis	Person
infligidas	infligidos	Gender
ofertas	ofertarás	Tense
ganáramos	ganarais	Person
pallare	pallase	Tense
desapalancan	desapalanca	Number
adecuadas	adecuados	Gender
defendida	defendido	Gender
embalsada	embalsado	Gender
acudiéremos	acudiremos	Mood
envergüences	envergonzares	Tense
cansadas	cansados	Gender
solida	solido	Gender
peleadas	peleados	Gender
realizarán	realizaremos	Person
cliquearas	cliquearais	Number
detallábamos	remordíamos	lemma
recompensadas	recompensados	Gender
desquiciada	desquiciado	Gender
enlutada	enlutado	Gender
faranduleases	farandulease	Person
apoyada	apoyado	Gender
acuñares	minares	lemma
acrezcan	fibrilen	lemma
efectuadas	efectuados	Gender
aparcaré	aparcare	Mood
subdivididas	subdivididos	Gender
linchadas	linchados	Gender
desayune	teja	lemma
cotejaseis	evaporaseis	lemma
apachurrara	apachurráramos	Person
alentadas	alentados	Gender
extermine	extermino	Mood
encerrad	tercerizad	lemma
gozaréis	gozará	Person
intriqué	intricasteis	Person
jorobadas	jorobados	Gender
racionadas	racionados	Gender
refiera	refiriese	Tense
desainamos	desainaremos	Tense
compenetraron	familiarizaron	lemma
lijé	lijasteis	Person
acostadas	acostados	Gender
pinchadas	pinchados	Gender
pinchada	pinchado	Gender
trapichees	trapicheéis	Person
peinados	peinado	Number
demodularías	demodularía	Person
parados	parado	Number
regresadas	regresados	Gender
remodelen	remodelaren	Tense
véanse	véase	Number
bofetean	bofeteen	Mood
recibida	recibido	Gender
desminen	desminasen	Tense
embairíamos	embairíais	Person
anisadas	anisados	Gender
aberrarían	nixtamalizarían	lemma
cellisqueada	cellisqueado	Gender
declarada	declarado	Gender
empanares	empanases	Tense
parodien	parodiaren	Tense
obligadas	obligados	Gender
ringó	ringaron	Number
organice	organicemos	Person
destinadas	destinados	Gender
acudida	acudido	Gender
inunda	inunde	Mood
tápense	tápese	Number
hinchadas	hinchada	Number
empedramos	empedrasteis	Person
escocieren	escociere	Person
hilvanemos	hilvanen	Person
desenroscamos	gastamos	lemma
aposentan	aposenta	Person
gradas	grado	Person
desembrujasteis	desembrujó	Person
berrease	berreare	Tense
indultada	indultado	Gender
caída	caído	Gender
abonados	abonado	Number
sustituidas	sustituidos	Gender
atajando	trastabillando	lemma
autodenominada	autodenominado	Gender
sofistiquen	sofisticaren	Tense
constate	constaten	Person
pavimentáremos	pavimentareis	Person
geminemos	geminásemos	Tense
compele	sangra	lemma
abominadas	abominados	Gender
desvariare	desvarie	Tense
aposentada	aposentado	Gender
embestidos	gravados	lemma
galardonadas	galardonados	Gender
insidiadas	insidiados	Gender
confeccionadas	confeccionados	Gender
propasásemos	propasemos	Tense
engolfados	engolfado	Number
envilecidas	envilecidos	Gender
pronunciada	pronunciado	Gender
figurases	figuraseis	Person
macha	machamos	Person
fruncida	fruncido	Gender
doradas	dorados	Gender
peraltadas	peraltados	Gender
apedreáremos	apedreares	Person
sorprendida	sorprendido	Gender
obviada	obviado	Gender
trufada	trufado	Gender
arreglaría	arreglarían	Number
devenida	devenido	Gender
acodaos	acódate	Person
cornearan	notificaran	lemma
encerrada	encerrado	Gender
impulsadas	impulsados	Gender
eclipséis	eclipses	Number
readecuáis	readecúan	Person
conculqué	conculcaron	Person
desbancase	masacrase	lemma
montada	montado	Gender
distanció	distanciaron	Person
jalases	jales	Tense
recogida	recogido	Gender
abaratarán	abaratarás	Person
fenecida	fenecido	Gender
condonada	condonado	Gender
invitadas	invitados	Gender
pecaremos	pecáremos	Mood
secundada	secundado	Gender
imprecada	imprecado	Gender
desmovilizada	desmovilizado	Gender
reconstruida	reconstruido	Gender
degenere	degeneren	Number
destrozadas	destrozados	Gender
engañaren	engañasen	Tense
regresada	regresado	Gender
descohesionaren	descohesionasen	Tense
transfigurada	transfigurado	Gender
cuerpeares	zabordares	lemma
cabreados	vendidos	lemma
detallaba	sustraía	lemma
navegada	navegado	Gender
archive	archiven	Number
inhaladas	inhalados	Gender
revirtiere	revirtiéremos	Number
humedecida	humedecido	Gender
enojadas	enojados	Gender
decodificarás	permutarás	lemma
jubilados	jubilado	Number
dentada	dentado	Gender
cementada	cementado	Gender
distribuyó	obstó	lemma
adoren	adoran	Mood
sustituida	sustituido	Gender
basaba	basabais	Person
conferidas	conferidos	Gender
encastrado	ovacionado	lemma
expeditara	expeditarais	Person
pongámonos	ponte	Person
arrecidas	arrecidos	Gender
legadas	legados	Gender
bifurcándose	oficializando	lemma
deshacíais	trufabais	lemma
defecaba	defecábamos	Person
engancharen	engancharán	Mood
fenecíamos	fenecía	Person
balden	baldasen	Tense
vetada	vetado	Gender
embutieren	sazonaren	lemma
apremiada	apremiado	Gender
disminuirá	humectará	lemma
convenidas	convenidos	Gender
vestíos	vístete	Number
zarandeada	zarandeado	Gender
anotada	anotado	Gender
basadas	basados	Gender
despéñense	despéñese	Number
apuestas	favorecidas	lemma
fascinada	fascinado	Gender
rodadas	rodados	Gender
deshechas	deshechos	Gender
competan	competen	Mood
abanderadas	abanderados	Gender
estafadas	estafados	Gender
blindadas	blindados	Gender
derrotada	derrotado	Gender
estalle	estallase	Tense
entradas	entrados	Gender
restan	restamos	Person
finiquitada	finiquitado	Gender
situaos	sítuate	Person
ajardinasteis	ajardinaste	Number
desmelenadas	desmelenados	Gender
desdoblen	remanguen	lemma
importaren	importare	Person
desarraigadas	desarraigados	Gender
remodelada	remodelado	Gender
insertadas	insertados	Gender
somatizaran	somatizara	Person
usadas	usada	Number
traspirad	traspira	Person
sentada	sentado	Gender
despistada	despistado	Gender
corretee	retroceda	lemma
abochornadas	abochornados	Gender
pululareis	pululares	Person
atascaron	atascó	Number
restableciera	restablecieras	Person
criticábamos	criticabais	Person
imploraran	implorarais	Person
estancadas	estancada	Number
reajustadas	reajustados	Gender
engloban	engloba	Person
envanecerá	envanece	Tense
enrarece	trasmuta	lemma
deprequen	existan	lemma
aventajáis	expropiáis	lemma
usaos	usémonos	Person
chequees	chequeares	Tense
convulsionada	convulsionado	Gender
incumbes	incumbís	Number
apresurareis	apresuraréis	Mood
silenciada	silenciado	Gender
catalizadas	catalizados	Gender
acentuadas	acentuados	Gender
comportémonos	compórtense	Person
plagado	plagados	Number
colindada	colindado	Gender
aducidas	aducidos	Gender
dormida	dormido	Gender
ministerializada	ministerializado	Gender
actuada	actuado	Gender
autolesionaos	autolesiónate	Person
estructuradas	estructurados	Gender
lastrará	lastraremos	Person
adoptara	adoptaran	Person
mimetizada	mimetizado	Gender
reelaboren	reelabore	Person
flageladas	flagelados	Gender
aquerenciaos	aquerencíese	Person
compinchaos	compínchate	Number
mentorizada	mentorizado	Gender
impresionadas	impresionados	Gender
movidas	movida	Number
cocida	cocido	Gender
deambula	lambe	lemma
chisporroteas	chisporroteamos	Person
deje	dejéis	Person
criminalices	fruyas	lemma
abnegarais	sucitarais	lemma
acongojaría	acongojarías	Person
accidentadas	accidentados	Gender
malogrados	malogrado	Number
fortalecían	fortalecía	Number
orquestadas	orquestados	Gender
protagonizaseis	protagonizásemos	Person
reimpulsada	reimpulsado	Gender
peatonalizarías	peatonalizaríais	Number
coescribid	remplazad	lemma
amblo	restallo	lemma
cansen	canse	Person
amortizadas	amortizados	Gender
embalaras	sacrificaras	lemma
entretejidas	entretejidos	Gender
compones	compongo	Person
evacuada	evacuado	Gender
hidratada	hidratado	Gender
arriesgadas	arriesgados	Gender
balanceada	balanceado	Gender
controviertes	controvierto	Person
consultaran	golpearan	lemma
pulsadas	pulsados	Gender
diseccionadas	diseccionados	Gender
agilizaríamos	agilizaría	Person
disculpado	disculpados	Number
capturadas	capturados	Gender
inmortalizaras	inmortalizarais	Number
granizaras	granizarais	Number
agregadas	agregados	Gender
deportadas	deportados	Gender
coescribirás	universalizarás	lemma
agachados	agachado	Number
deshebradas	mimidas	lemma
apretadas	apretados	Gender
metamorfosearías	metamorfosearíamos	Person
injertará	injerta	Tense
desvistan	inmovilicen	lemma
podada	podado	Gender
antepusiéramos	antepusieras	Person
corridas	corridos	Gender
codiciaste	reporteaste	lemma
tintineaseis	tintineéis	Tense
abstraigas	abstraigáis	Number
empalmamos	empalmó	Person
apelará	apelaremos	Person
repetida	repetido	Gender
escarbadas	escarbados	Gender
caligrafiase	caligrafiásemos	Number
besuqueada	besuqueado	Gender
relatada	relatadas	Number
afeitados	afeitado	Number
entonaremos	entonarán	Person
celada	celado	Gender
escaseará	percibirá	lemma
engranares	gangueares	lemma
empedrarán	empedraren	Mood
desembarcada	desembarcado	Gender
infundidas	infundidos	Gender
prensada	prensado	Gender
atiborrases	recapitalizases	lemma
descartarais	descartara	Person
depilases	depilaseis	Number
desvencijaron	desvencijé	Person
zapasteis	zapamos	Person
apostara	originara	lemma
tallara	tallaran	Number
fibrilaste	fibriló	Person
invernaba	invernaban	Number
desanimara	desanimaran	Person
falseadas	falseados	Gender
apiñaron	sodomizaron	lemma
preparadas	preparados	Gender
funden	funde	Number
repantigaos	repantígate	Person
reactivaría	reactivarían	Person
acobardaríais	heñiríais	lemma
mejorada	mejorado	Gender
precipitadas	precipitados	Gender
sinceraos	sincérate	Number
fotografiada	fotografiado	Gender
emergidas	emergidos	Gender
activaría	activaríamos	Person
desnaturalizados	varados	lemma
compenetradas	compenetrada	Number
solfeamos	solfeasteis	Person
ribeteada	ribeteado	Gender
extrañadas	extrañados	Gender
doblegares	doblegare	Person
atribuida	atribuido	Gender
cincelada	cincelado	Gender
marchaos	marchémonos	Person
desapasionada	desapasionado	Gender
mejoradas	mejorada	Number
religaren	religuen	Tense
modelareis	modelare	Person
chatearán	chatearen	Mood
declina	habilita	lemma
tintas	tinto	Person
untaréis	untarás	Person
aborregáis	aborregaréis	Tense
elevase	elevare	Tense
anegada	anegado	Gender
flirteadas	flirteados	Gender
adéntrense	adéntrese	Number
trasoirías	trasoiríais	Number
represe	represen	Number
aposentó	aposentaron	Number
salpresada	salpresado	Gender
salvadas	salvados	Gender
peles	pelas	Mood
degradaréis	degradaré	Person
acune	acunare	Tense
holgada	holgado	Gender
resguardadas	resguardada	Number
imposibilitado	imposibilitados	Number
entrecomilladas	entrecomillados	Gender
veneráis	veneras	Number
autoabastezcámonos	autoabastézcanse	Person
reproducida	reproducido	Gender
impagadas	impagados	Gender
recalcáis	recalcamos	Person
malversaré	malversarás	Person
exigida	exigido	Gender
booteare	personificare	lemma
contrabalancearemos	contrabalancearé	Number
desparramáremos	desparramaren	Person
urbanizadas	urbanizados	Gender
adherida	adherido	Gender
amuralla	repentiza	lemma
titulé	titularon	Person
espachurraren	espachurren	Tense
músanse	músase	Person
reinaugurase	reinaugure	Tense
esclerosada	esclerosado	Gender
atormentas	atormentan	Person
decantadas	decantados	Gender
borronearías	borronearía	Person
espiguemos	espigad	Person
emprende	emprenderá	Tense
solidarizan	solidariza	Number
rematada	rematado	Gender
retoñaremos	retoñáremos	Mood
acacheteó	flageló	lemma
gastadas	gastados	Gender
chichen	recapitulen	lemma
atribuí	huí	lemma
bombeada	bombeado	Gender
reordenéis	reordenareis	Tense
compartimentaré	golearé	lemma
diversificáis	diversifico	Person
encadenada	encadenado	Gender
destellada	destellado	Gender
estragarían	resorberían	lemma
agoraba	ornaba	lemma
desacelerando	trasmitiendo	lemma
extraviadas	extraviados	Gender
divorciadas	divorciados	Gender
asfixiada	asfixiado	Gender
gruñe	gruña	Mood
diferirías	trapalearías	lemma
contraatacadas	contraatacados	Gender
notaseis	notareis	Tense
coloreadas	coloreados	Gender
dirijas	vacaciones	lemma
adormilara	pormenorizara	lemma
posibilitada	posibilitado	Gender
minusvalorada	minusvalorado	Gender
procrearía	procrearías	Person
fusilada	fusilado	Gender
asentada	asentado	Gender
desglosada	desglosado	Gender
habitada	habitado	Gender
acumulados	acumulado	Number
inoculase	inoculaseis	Person
reprimieron	reprimió	Person
postulases	postulase	Person
toreareis	toreáremos	Person
acarreéis	acarreareis	Tense
trincada	trincado	Gender
encarnice	encarnizo	Mood
corrige	corrigen	Number
abrochare	abroche	Tense
detentábamos	detentaba	Number
listadas	listados	Gender
mejorémonos	mejórense	Person
reactivada	reactivado	Gender
autodenominadas	autodenominados	Gender
mangoneadas	mangoneados	Gender
repiquemos	repique	Person
doremos	dore	Number
delaminadas	delaminados	Gender
profundizada	profundizado	Gender
divertidos	divertido	Number
chale	chala	Mood
desempeñasen	tolerasen	lemma
cristianizáis	cristianicéis	Mood
seguidas	seguidos	Gender
exportada	exportado	Gender
transiten	transite	Number
recomendarais	recomendaran	Person
prevaricáramos	prevaricara	Person
parcharía	parcharían	Number
encasillada	encasillado	Gender
enjaezaríais	enjaezarías	Number
tiñesen	tiñan	Tense
sesionadas	sesionados	Gender
terciarías	terciaríais	Number
airadas	airados	Gender
ataviadas	ataviados	Gender
proscritas	proscritos	Gender
desestacionalizare	desestacionalizase	Tense
ofenda	ofendiese	Tense
escarmentemos	libemos	lemma
ensillada	ensillado	Gender
procreemos	procreen	Person
aburguesada	aburguesado	Gender
acertadas	acertados	Gender
autocrémense	autocrémese	Number
fascinas	fascines	Mood
expoliadas	expoliados	Gender
fundían	fundía	Number
toldada	toldado	Gender
asiésemos	malvendiésemos	lemma
confirmemos	trivialicemos	lemma
rechazasen	rechacen	Tense
adiestradas	adiestrados	Gender
usamos	usaremos	Tense
odiadas	odiados	Gender
instrumentada	instrumentado	Gender
numerada	numerado	Gender
conduzcan	conduzca	Person
aifoneada	aifoneado	Gender
desollases	desollase	Person
aplicadas	aplicados	Gender
entraste	entró	Person
dispuesta	dispuesto	Gender
endosaseis	endosase	Person
perdonan	perdonarán	Tense
dominadas	dominados	Gender
garantizas	garantizamos	Person
revestida	revestido	Gender
consignadas	consignados	Gender
desarrolladas	desarrollados	Gender
execrases	execrase	Person
disociadas	disociados	Gender
pajareará	pajarea	Tense
concretizáremos	concreticemos	Tense
escarmentada	escarmentado	Gender
calafatearía	viviría	lemma
debiesen	debiese	Person
enjugada	enjugado	Gender
ajardinaba	masaba	lemma
educada	educado	Gender
afanaras	rubricaras	lemma
recobradas	recobrados	Gender
pulverizadas	pulverizados	Gender
relevan	releven	Mood
memorizadas	memorizados	Gender
asaltadas	asaltados	Gender
signada	signado	Gender
abundadas	abundados	Gender
depare	deparase	Tense
rasure	rasurare	Tense
detenidos	sanados	lemma
olvidadas	olvidados	Gender
pervertidas	pervertidos	Gender
mancillaran	mancillarais	Person
ningunearéis	ninguneareis	Mood
deslumbrada	deslumbrado	Gender
desconocerán	desconocerá	Person
experimentase	experimente	Tense
descartará	descarta	Tense
sanjada	sanjado	Gender
bordarás	bordaréis	Number
contenida	contenido	Gender
impacientéis	impacientaseis	Tense
multada	multado	Gender
saniticemos	sanitizásemos	Tense
coordináremos	migráremos	lemma
incapacitamos	incapacitó	Person
descreeremos	triunfaremos	lemma
ayunando	incordiando	lemma
aforará	aforarán	Person
entronizada	entronizado	Gender
embuchadas	embuchados	Gender
desenredaban	desenredaba	Number
repintada	repintado	Gender
superponíamos	superponías	Person
excitada	excitado	Gender
enamoradas	enamorados	Gender
convenid	progresad	lemma
afirmen	afirmasen	Tense
guardaré	guardará	Person
emperrada	emperrado	Gender
contratada	contratado	Gender
chambeáremos	chambeemos	Tense
energizada	energizado	Gender
influenciada	influenciado	Gender
buriladas	burilados	Gender
cuido	cuide	Mood
admitidas	admitidos	Gender
republicásemos	republicase	Number
desgajada	desgajado	Gender
alebrestadas	alebrestados	Gender
predeterminada	predeterminado	Gender
anexemos	romancemos	lemma
escenografiase	malacostumbrase	lemma
molinadas	molinados	Gender
infestadas	infestados	Gender
tercerizada	tercerizado	Gender
entablillaseis	extinguieseis	lemma
antagonizadas	antagonizados	Gender
embuchadas	morreadas	lemma
llévate	llévese	Person
ofendidas	ofendidos	Gender
desvencijabais	desvencijaba	Person
silbada	silbado	Gender
educadas	educados	Gender
baqueteaseis	baqueteareis	Tense
espachurrábamos	espachurrabais	Person
avizoraremos	peeremos	lemma
grafico	graficas	Person
barajadas	barajados	Gender
resguardados	resguardado	Number
resondrareis	resondraren	Person
desfalcasteis	desfalcaron	Person
orillaron	orilló	Number
espantada	espantado	Gender
creída	creído	Gender
vigiladas	vigilados	Gender
garapiñaba	garapiñabais	Person
petrificada	petrificado	Gender
puntuada	puntuado	Gender
ignoras	ignoramos	Person
hicieron	hicimos	Person
contrarrestado	contrarrestados	Number
escocieres	escocerás	Mood
coreografiasteis	coreografiaron	Person
embarrarán	embarrará	Person
fugados	fugado	Number
metastatizáis	metastatizaréis	Tense
acidifica	urbaniza	lemma
estabilizadas	estabilizados	Gender
vertidas	vertidos	Gender
detenidos	detenido	Number
amonestada	amonestado	Gender
manipuladas	manipulados	Gender
baldada	baldado	Gender
silbemos	silbe	Person
engulle	sustenta	lemma
imagino	imaginamos	Number
rechazaría	rechazaríamos	Person
suscritas	suscritos	Gender
baleada	baleado	Gender
enaltecían	enaltecíais	Person
cuantificada	cuantificado	Gender
escoradas	escorada	Number
diversificada	diversificado	Gender
trine	trinare	Tense
resecada	resecado	Gender
conocida	conocido	Gender
espacian	espacien	Mood
chingadas	chingados	Gender
sobreviviera	sobrevivieran	Person
viramos	viro	Person
agravada	agravado	Gender
incorporada	incorporado	Gender
internalizadas	internalizados	Gender
recalentaren	recalentare	Number
cortejarías	cortejaríais	Person
enchiláremos	enchilare	Number
decapiten	decapita	Person
irán	iréis	Person
sobreestimadas	sobreestimados	Gender
enojaos	enójate	Person
tenida	tenido	Gender
desequilibradas	desequilibrada	Number
encajona	mira	lemma
saludemos	saludáremos	Tense
subyugo	subyugamos	Number
charlotee	charloteen	Person
mitificada	mitificado	Gender
constaren	constare	Person
atravesarás	imitarás	lemma
escarchadas	escarchados	Gender
desconfiado	desconfiados	Number
avinagradas	avinagrados	Gender
digitalizadas	digitalizados	Gender
embutida	embutido	Gender
independizada	independizado	Gender
convaleciere	convaleceré	Mood
confirmamos	confirmo	Number
canceladas	cancelados	Gender
deslumbradas	deslumbrados	Gender
ayudamos	tuneamos	lemma
desembrujéis	redirijáis	lemma
criminalizada	criminalizado	Gender
intimidada	intimidado	Gender
acuñamos	acuñasteis	Person
coaccionada	coaccionado	Gender
estrenadas	estrenados	Gender
despistadas	despistados	Gender
reincorporen	reincorporaren	Tense
fulguradas	fulgurados	Gender
autodenominadas	autodenominada	Number
tapada	tapado	Gender
pensionada	pensionado	Gender
determinadas	determinados	Gender
inculpáramos	inculpara	Person
tiroteara	tiroteáramos	Person
ahumábamos	ahumaba	Person
restituidas	restituidos	Gender
supervise	supervisen	Person
explosionarías	explosionaríamos	Person
arredrada	arredrado	Gender
refriera	refrieran	Person
calcular	payasear	lemma
interpretada	interpretado	Gender
empinada	empinado	Gender
encapuchadas	encapuchados	Gender
contrastadas	contrastados	Gender
custodiada	custodiado	Gender
entallara	tramara	lemma
apuntan	apunten	Mood
desparpajo	precinto	lemma
oída	oído	Gender
desfavorecida	desfavorecido	Gender
liderarán	lideran	Tense
indagadas	indagados	Gender
trozadas	trozados	Gender
retenías	retenía	Person
hospitalizada	hospitalizado	Gender
entrelazada	entrelazado	Gender
derrapes	vagues	lemma
ingeridas	ingeridos	Gender
rodamos	rodáis	Person
accidentaos	accidéntate	Number
atrincheran	atrincherarán	Tense
procesionada	procesionado	Gender
bombardeada	bombardeado	Gender
desagregare	desagregase	Tense
razonada	razonado	Gender
hiera	hiriere	Tense
transcurrirán	transcurren	Tense
impulsada	impulsado	Gender
adaptásemos	wikificásemos	lemma
concurrimos	concurriremos	Tense
decanta	decantáis	Person
molida	molido	Gender
envejecidos	envejecido	Number
pirarán	piraren	Mood
destemplaríais	garrapiñaríais	lemma
mejoraos	mejórate	Number
agoniza	reduce	lemma
embaucasen	embaucásemos	Person
engatillare	engatilláremos	Number
trinchada	trinchado	Gender
levantada	levantado	Gender
alfombraba	imposibilitaba	lemma
pavoneadas	pavoneados	Gender
congelaren	congelare	Number
aliviada	aliviado	Gender
digitalizada	digitalizado	Gender
amamantaríamos	amamantaría	Number
respetaren	respetarán	Mood
alumbrada	alumbrado	Gender
desarrollaba	pigmentaba	lemma
enfermaron	nublaron	lemma
equivalieseis	equivaliereis	Tense
engarzada	engarzado	Gender
luchada	luchado	Gender
estáncate	estánquese	Person
estatuyes	estatuís	Number
amaradas	amarados	Gender
transferida	transferido	Gender
adornadas	adornados	Gender
cepillase	renovase	lemma
autobombeada	autobombeado	Gender
ayudaran	mecharan	lemma
complicadas	complicados	Gender
despenalizada	despenalizado	Gender
repantiguémonos	repantíguense	Person
escuden	escudaren	Tense
aterrorizarais	recuadrarais	lemma
entrelazo	entrelace	Mood
represaliadas	represaliados	Gender
suministrase	suministre	Tense
originadas	originados	Gender
calcificadas	calcificados	Gender
meaba	meábamos	Person
forjadas	forjados	Gender
tituladas	titulados	Gender
deshabilitado	estarcido	lemma
germanizada	germanizado	Gender
huevearas	huevearais	Number
renegocian	renegocias	Person
abarrotadas	abarrotados	Gender
conceptualizas	conceptualizo	Person
engranadas	engranados	Gender
pautada	pautado	Gender
subcontratase	subcontratases	Person
apellidadas	apellidados	Gender
desarticulada	desarticulado	Gender
conmutadas	conmutados	Gender
completo	completa	Person
dejadas	dejados	Gender
desmarimbamos	desmarimbasteis	Person
compendiada	compendiado	Gender
atalayada	atalayado	Gender
oficie	oficien	Number
rebautizada	rebautizado	Gender
afirme	afirmo	Mood
gaguearíais	gaguearías	Person
llevare	llevase	Tense
caramelizada	caramelizado	Gender
dudan	dudo	Person
desengañada	desengañado	Gender
subvertiré	subvertiréis	Person
sortearán	sortean	Tense
amolda	troncha	lemma
decaiga	rearme	lemma
reingresare	reingresaren	Person
reanuda	reanuden	Person
ocultada	ocultado	Gender
nalgueases	nalgueasen	Person
alhajada	alhajado	Gender
ofertasteis	ofertaste	Person
entendía	entendíamos	Person
gobernemos	gobierne	Number
encapsulada	encapsulado	Gender
distraeríamos	distraería	Person
aplastásemos	incluyésemos	lemma
acumuladas	acumulados	Gender
estornudara	estornudaran	Person
desterradas	desterrados	Gender
jalone	jalonéis	Person
occidentalizada	occidentalizado	Gender
echa	eche	Mood
explotada	explotado	Gender
coloreen	coloreasen	Tense
farrearéis	farrearán	Person
reiniciada	reiniciado	Gender
preparan	preparo	Person
accidentados	accidentado	Number
catalanice	catalanicemos	Person
regodeadas	regodeados	Gender
espolvoreada	espolvoreado	Gender
disimuladas	disimulados	Gender
desionizada	desionizado	Gender
enfardaba	enfardábamos	Person
integren	integre	Person
recluidas	recluidos	Gender
saltada	saltado	Gender
desestimada	desestimado	Gender
sorteada	sorteadas	Number
planchada	planchado	Gender
plagie	plagio	Mood
tentaras	tentaran	Person
descentralizada	descentralizado	Gender
personaos	persónate	Person
romanizada	romanizado	Gender
maniatada	maniatado	Gender
geolocalizada	geolocalizado	Gender
ensoñaría	muestrearía	lemma
dispersaremos	transparentaremos	lemma
adjudicada	adjudicado	Gender
autodenominaos	autodenomínate	Number
coseche	cosecha	Person
derretirán	derretiréis	Person
disto	represalio	lemma
acribillada	acribillado	Gender
otearas	otearais	Person
acribille	serpentee	lemma
retiradas	retirados	Gender
comerciarán	tiranizarán	lemma
repantingados	repantingado	Number
remoja	remojo	Person
minimizo	minimizaré	Tense
microscopiará	microscopiarás	Person
enviudada	obrada	lemma
conquistarán	revalorizarán	lemma
diagnosticada	diagnosticado	Gender
lea	leyese	Tense
soltada	soltado	Gender
lites	litas	Mood
cuadrados	temidos	lemma
indemnizaréis	indemnizáis	Tense
envergadas	envergados	Gender
configurar	fingir	lemma
estrangulasteis	hojeasteis	lemma
sustentada	sustentado	Gender
configuraríamos	ligaríamos	lemma
sirvieran	sirviera	Person
reeditamos	reedité	Person
recubiertas	recubiertos	Gender
sida	sido	Gender
arriares	arriareis	Number
pareadas	pareados	Gender
repitió	repitieron	Person
normalizadas	normalizados	Gender
maximizada	maximizado	Gender
runruneadas	runruneados	Gender
replanteada	replanteado	Gender
torturada	torturado	Gender
compadecerán	compadecieren	Mood
glorificó	glorificaste	Person
sondeemos	sondead	Person
alumbraríais	alumbrarían	Person
atribularemos	atribuláremos	Mood
maquillados	maquillado	Number
empequeñecida	empequeñecido	Gender
recicladas	reciclados	Gender
comparecieres	ladrares	lemma
pónganse	ponte	Person
emancipada	emancipado	Gender
contemplada	contempladas	Number
lustrará	lustrare	Mood
endulcen	sombren	lemma
esbozadas	esbozados	Gender
incriminada	incriminado	Gender
bañémonos	báñense	Person
complicado	parecido	lemma
toqueteada	toqueteado	Gender
goleadas	goleados	Gender
despistarán	despistaremos	Person
reimpondrá	reimpone	Tense
asquearía	asquearías	Person
loaren	loares	Person
conlleve	triture	lemma
tocarán	tocará	Number
orbitada	orbitado	Gender
encontré	encontramos	Number
encurtía	encurtían	Person
apodada	apodado	Gender
posean	posea	Number
cabrahigad	presentad	lemma
emulgiera	emulgiéramos	Person
aparezcan	aparezca	Person
concertada	concertado	Gender
agringara	intricara	lemma
entienda	familiarice	lemma
desistan	desista	Person
rebañemos	rebañen	Person
votada	votado	Gender
combinéis	combine	Person
extraditada	extraditado	Gender
existimadas	existimados	Gender
zambullíais	zambullía	Person
regenerada	regenerado	Gender
lanzada	lanzado	Gender
rebusca	rebuscan	Person
imbricada	imbricado	Gender
contestadas	contestados	Gender
juramentada	juramentado	Gender
porfiaren	porfiare	Person
evada	evadiere	Tense
promovida	promovido	Gender
tápate	tapémonos	Person
grabadas	grabados	Gender
programada	programado	Gender
investidas	investidos	Gender
devastadas	devastados	Gender
fijados	fijado	Number
empinase	inyectase	lemma
derramadas	derramados	Gender
sofisticadas	sofisticados	Gender
ensalzaseis	ensalzareis	Tense
bebidas	bebidos	Gender
despertémonos	despiértate	Person
defraudadas	defraudados	Gender
amotinen	amotinemos	Person
polarizadas	polarizados	Gender
alechuga	parpadea	lemma
domeñarían	experimentarían	lemma
vitrificadas	vitrificados	Gender
adquirida	adquirido	Gender
motearán	motearéis	Person
denomine	recomiende	lemma
renqueadas	renqueados	Gender
intrigada	intrigado	Gender
aceptada	aceptado	Gender
aplanases	aplanes	Tense
reedita	reedito	Person
ingeniada	ingeniado	Gender
contrabalanceada	contrabalanceado	Gender
ayude	ayuda	Mood
obstruyere	obstruyereis	Person
copresida	copresidiese	Tense
lucida	lucido	Gender
cortaría	cortarían	Person
emperremos	ilusionemos	lemma
aténganse	aténgase	Number
sancionada	sancionado	Gender
abandonadas	abandonados	Gender
monopolizadas	monopolizados	Gender
desviará	desviarán	Number
ennoblecida	ennoblecido	Gender
driblaremos	suprimiremos	lemma
agotadas	agotados	Gender
glorificada	glorificado	Gender
emitimos	emite	Person
incluida	incluido	Gender
recogiera	recogiéramos	Number
hallaríamos	hallaría	Number
insuflabas	insuflabais	Number
engancha	enganchamos	Person
zanganeada	zanganeado	Gender
asústense	asústese	Person
demolida	demolido	Gender
asilaran	asilara	Number
remezclaréis	remezclará	Person
colocadas	colocados	Gender
aleccionemos	aleccione	Person
arriada	arriado	Gender
rusificará	rusificarás	Person
satanizaríamos	satanizaría	Number
mancomunada	mancomunado	Gender
autoproclame	autoproclamare	Tense
aquerenciadas	aquerenciada	Number
desparramaría	desparramaríamos	Number
arrugadas	arrugados	Gender
chingara	chingáramos	Person
deteriorase	excitase	lemma
almibarada	almibarado	Gender
estacara	estacarais	Person
minas	mino	Person
morigeraremos	morigerarás	Person
extraídas	extraída	Number
obtenida	obtenido	Gender
arrancadas	arrancados	Gender
atrofiados	atrofiado	Number
apelase	apelasen	Number
instruyere	instruyeren	Person
vejaran	vejarais	Person
inoculase	inoculásemos	Person
atañeréis	atañéis	Tense
quitasen	quiten	Tense
coteje	cotejare	Tense
apéguense	apéguese	Number
embarcaré	embarco	Tense
desaprovechares	desaprovecharás	Mood
discriminadas	discriminados	Gender
arremedase	eternizase	lemma
trasladadas	trasladados	Gender
cobramos	titulamos	lemma
mortifiquen	mortificaren	Tense
pudieses	puedas	Tense
reconfigura	reconfiguremos	Person
acerrojen	acerroje	Number
acumulada	acumulado	Gender
atascados	atascado	Number
inmortalizadas	inmortalizados	Gender
instigada	instigado	Gender
encapsulemos	zapateemos	lemma
desaprovechadas	desaprovechados	Gender
encajadas	encajados	Gender
loqueasen	loquease	Number
renunciada	renunciado	Gender
carreteada	carreteado	Gender
informatices	informatizas	Mood
enriqueciereis	enriqueceréis	Mood
cazadas	cazados	Gender
rebuscada	rebuscado	Gender
aterrorizadas	aterrorizados	Gender
revirtáis	revirtieseis	Tense
aboliste	abolimos	Person
ponderada	ponderado	Gender
pigmentada	pigmentado	Gender
traumatizada	traumatizado	Gender
deshuesada	deshuesado	Gender
presumida	presumido	Gender
discrepase	discrepe	Tense
deslegitimadas	deslegitimados	Gender
desmintiesen	revelasen	lemma
descuidara	obviara	lemma
afilíe	afiliéis	Person
caminadas	caminados	Gender
infravaloradas	infravalorados	Gender
fortifiquemos	fortifique	Person
salió	saliste	Person
renunciaba	renunciaban	Person
debutada	debutado	Gender
vacunéis	vacunes	Number
torcidos	torcido	Number
estriares	estriare	Person
viralizaba	viralizábamos	Person
represada	represado	Gender
sufre	sufran	Person
gesticuladas	gesticulados	Gender
desapasionases	señalizases	lemma
alimentada	alimentado	Gender
certificada	certificado	Gender
inmolada	inmolado	Gender
aislaría	oficializaría	lemma
acomoden	acomodemos	Person
vaciadas	vaciados	Gender
influenciadas	influenciados	Gender
censadas	censados	Gender
trenzáremos	trencemos	Tense
fingirán	fingiréis	Person
quedémonos	quédese	Person
especiada	especiado	Gender
testiguada	testiguado	Gender
entreviste	entrevisteis	Person
reiterada	reiterado	Gender
acuantíes	indultes	lemma
americanizamos	americanizáis	Person
consistía	idiotizaba	lemma
optimizada	optimizado	Gender
afectaban	reorganizaban	lemma
maquilladas	maquillados	Gender
hinchados	hinchado	Number
estragabais	molestabais	lemma
creada	creado	Gender
hilvane	hilvanen	Number
peinémonos	peínese	Person
consultadas	consultados	Gender
toldarán	toldará	Person
coordinada	coordinado	Gender
chillaríais	chillaríamos	Person
aparejadas	aparejados	Gender
arrestan	arresta	Number
congeniaseis	congeniéis	Tense
somatizare	somatizará	Mood
injeridos	injerido	Number
atuviesen	atuviésemos	Person
agrietase	agriete	Tense
alborearéis	alborearemos	Person
barnizada	barnizado	Gender
sancionase	sancione	Tense
esperanzadas	esperanzados	Gender
promocionada	promocionado	Gender
melladas	mellados	Gender
ventiladas	ventilados	Gender
estilizadas	estilizados	Gender
aisladas	percutidas	lemma
jaqueen	jaquee	Number
depauperaba	refulgía	lemma
sampleada	sampleado	Gender
galardonó	galardonaron	Number
adveras	adveramos	Person
sonsacada	sonsacado	Gender
radicalizada	radicalizado	Gender
aventajada	aventajado	Gender
tuneo	tunean	Person
desparpajaría	desparpajarían	Person
blindada	blindado	Gender
brujuleen	huroneen	lemma
escandalizada	escandalizado	Gender
acechada	acechado	Gender
verticalizadas	verticalizados	Gender
idos	vete	Person
carburéis	carburareis	Tense
reordenaseis	reordenareis	Tense
convertiría	incrementaría	lemma
asemejadas	asemejados	Gender
palideciere	palidecieren	Number
miremos	mire	Person
revenidas	revenida	Number
acoló	acolé	Person
integradas	integrados	Gender
sobresalisteis	sobresalí	Person
sostenida	sostenido	Gender
apondréis	mangonearéis	lemma
metabolizadas	metabolizados	Gender
apuntillen	punjan	lemma
peleada	peleado	Gender
expandida	expandido	Gender
desviara	desviaran	Person
garrapiñaremos	garrapiñaréis	Person
relinchabais	relinchábamos	Person
solidificasteis	solidificaste	Number
embarcadas	embarcados	Gender
desbarajustaras	parecieras	lemma
aplanadas	aplanados	Gender
reciproquemos	reciprocáremos	Tense
aquilata	recapacita	lemma
menguada	menguado	Gender
gafadas	gafados	Gender
gorgotearéis	gorgoteará	Person
alegados	alegado	Number
amortizada	amortizado	Gender
lavadas	lavada	Number
desabotona	desabotonad	Number
atreguada	atreguado	Gender
aprisionadas	aprisionados	Gender
cansé	cansamos	Number
aruñadas	aruñados	Gender
ahúmo	revelo	lemma
constreñidas	constreñidos	Gender
numeradas	numerados	Gender
autofinanciadas	punzadas	lemma
apuradas	apurados	Gender
llenadas	llenada	Number
úsense	úsese	Number
doctore	doctora	Mood
aborrecida	aborrecido	Gender
arreglada	arreglado	Gender
wikificas	wikificarás	Tense
novelasteis	noveló	Person
apaciguada	apaciguado	Gender
agravada	irritada	lemma
transmitida	transmitido	Gender
nivelada	nivelado	Gender
afirmadas	afirmados	Gender
gradúo	graduamos	Person
dirigidos	dirigido	Number
dignemos	recompongamos	lemma
electrificada	electrificado	Gender
perorabais	peroraba	Person
reivindicadas	reivindicados	Gender
adularás	adulas	Tense
enlatares	enlatare	Person
desuscribí	peleché	lemma
compuesta	compuesto	Gender
aprovisionemos	aprovisionen	Person
comenzada	comenzado	Gender
legitiméis	legitimemos	Person
predestinada	predestinado	Gender
enripié	enripiasteis	Person
etiquetada	etiquetado	Gender
remedábamos	remedaba	Number
mentadas	mentados	Gender
abaluartada	abaluartado	Gender
aburrámonos	abúrranse	Person
cubierta	cubierto	Gender
tápate	tápese	Person
recopiladas	recopilados	Gender
morada	morado	Gender
parapetadas	parapetados	Gender
argüiste	arguyeron	Person
apiñaríais	apiñarías	Person
horadada	horadado	Gender
resucitó	resucitaron	Number
emprendida	emprendido	Gender
reasentadas	reasentados	Gender
rebajada	rebajado	Gender
rebautizadas	rebautizados	Gender
injerida	injerido	Gender
coordinadas	coordinados	Gender
plagiadas	plagiados	Gender
coloramos	fanaticemos	lemma
repostulasen	repostulen	Tense
consternadas	consternados	Gender
filmadas	filmados	Gender
interfiere	interferirá	Tense
desconocidas	desconocidos	Gender
onduladas	ondulados	Gender
descolocas	pixelas	lemma
enconaste	hartaste	lemma
pajéense	pajéese	Person
desaconsejarás	reinstalarás	lemma
comunicáremos	comunicareis	Person
codicia	vuelca	lemma
aventuradas	aventurados	Gender
propuesta	propuesto	Gender
asaré	industrializaré	lemma
abrumadas	abrumados	Gender
proclamaba	proclamaban	Person
estabilicemos	estabilizáremos	Tense
mendigadas	mendigados	Gender
redoblen	redoblemos	Person
quemarás	quemaréis	Person
estelarizada	estelarizado	Gender
escarificase	reivindicase	lemma
flipásemos	flipases	Person
dobla	impende	lemma
coloreasen	coloreásemos	Person
repotencio	repotencia	Person
preferidas	preferidos	Gender
desnatase	desnatare	Tense
engancha	enganchan	Person
susurrada	susurrado	Gender
apaniguar	rechinar	lemma
habituaremos	habituamos	Tense
seccionada	seccionado	Gender
recabadas	recabados	Gender
apagada	apagado	Gender
asechadas	reporteadas	lemma
confío	relleno	lemma
deludierais	deludieras	Number
usaste	usé	Person
automatizada	automatizado	Gender
adaptabais	falseabais	lemma
despolvaren	fecundaren	lemma
paralelarías	paralelaríais	Number
volteada	volteado	Gender
dibujadas	dibujada	Number
masan	masa	Number
atirantadas	atirantados	Gender
alivianasen	visualizasen	lemma
aherrumbradas	aherrumbrados	Gender
odio	odias	Person
caracterizare	hueveare	lemma
circunscrita	circunscrito	Gender
contextualizadas	contextualizados	Gender
pigmentadas	pigmentados	Gender
ejercidas	ejercidos	Gender
adjuntada	adjuntado	Gender
inmiscuida	inmiscuido	Gender
coloradas	colorados	Gender
viviésemos	vivieses	Person
subvertís	subvertiréis	Tense
originada	originado	Gender
carnavalearan	marcaran	lemma
desarticuladas	desarticulados	Gender
imbuiremos	imbuimos	Tense
deformemos	deformáremos	Tense
fluctuaría	fluctuaríamos	Person
aciemaste	ultracentrifugaste	lemma
vividas	vividos	Gender
amurallad	navegad	lemma
agravan	agrava	Number
realizadas	realizados	Gender
recargada	recargado	Gender
realimentaremos	realimentarás	Person
maquillaos	maquíllese	Person
infladas	inflados	Gender
repartí	repartió	Person
internada	internado	Gender
observamos	observé	Number
sobornáremos	sobornaren	Person
enervaba	enervábamos	Number
ornásemos	ornase	Person
entrevistada	entrevistado	Gender
mordida	mordido	Gender
demodularé	reglaré	lemma
inspirada	inspirado	Gender
soleadas	soleada	Number
preconcebidas	preconcebidos	Gender
mimetizó	mimetizamos	Person
descruzaban	sonsacaban	lemma
descargada	descargado	Gender
dibuja	falsa	lemma
enajenadas	enajenados	Gender
empujada	empujado	Gender
consentirás	consentirán	Person
entintados	entintado	Number
colonizada	colonizado	Gender
privatizabais	privatizabas	Person
portadas	portados	Gender
perseveradas	perseverados	Gender
acoja	garabatee	lemma
apelarían	apelaría	Person
anticiparon	anticipé	Person
invocadas	invocados	Gender
dichas	dichos	Gender
ahorquillada	ahorquillado	Gender
radicalícense	radicalícese	Number
empaquetáremos	fardáremos	lemma
guarachea	guaracheen	Person
enturbiaría	enturbiaríamos	Number
reestructuradas	reestructurados	Gender
descuidada	descuidado	Gender
facultare	facultares	Person
minimizase	minimice	Tense
aplastarían	aplastarías	Person
enarbolabais	enarbolabas	Number
cuidadas	cuidada	Number
pronostiquéis	pronosticareis	Tense
admiraría	malvendería	lemma
constípate	constipémonos	Person
marcho	marcha	Person
desplazasen	desplazases	Person
renuncie	renunciase	Tense
delimitas	delimitamos	Person
narrada	narrado	Gender
sindicaban	sindicaba	Person
aglutine	rinda	lemma
exceptué	exceptuamos	Number
trinco	trincaré	Tense
ofuscaste	ofuscaron	Person
abonémonos	abónese	Person
hieda	hiede	Mood
comandadas	comandados	Gender
infamaréis	infamareis	Mood
ensalzará	ensalzaré	Person
auguradas	augurados	Gender
suavizada	suavizado	Gender
supervisan	supervisen	Mood
preseleccionada	preseleccionado	Gender
estada	estado	Gender
impulsarán	impulsan	Tense
lavas	lavo	Person
tramitadas	tramitados	Gender
sancocháramos	sancochara	Person
casados	casado	Number
explicitada	explicitado	Gender
orbitadas	orbitados	Gender
aporrearíamos	aporrearía	Person
disputa	disputen	Person
desnaturalizada	desnaturalizado	Gender
esfuerzas	esforzamos	Person
domada	domado	Gender
descabellar	fluctuar	lemma
procesionaba	procesionaban	Person
estacionadas	estacionados	Gender
interpretadas	interpretados	Gender
extravíe	extravío	Mood
fletada	fletado	Gender
encapsulados	encapsulado	Number
acopladas	acoplada	Number
averiadas	averiados	Gender
dilatadas	dilatados	Gender
colorearais	fosforilarais	lemma
afeitaba	afeitábamos	Person
acrianzasteis	acrianzaron	Person
horneada	horneado	Gender
interesadas	interesados	Gender
desligad	desliga	Person
vertido	vertidos	Number
normada	normado	Gender
notificadas	notificados	Gender
incomunicada	incomunicado	Gender
tenga	tengas	Person
cacheada	cacheado	Gender
echaos	échate	Number
entrecruce	entrecruzare	Tense
trepo	trepan	Person
disfrazaba	disfrazábamos	Number
metalizada	metalizado	Gender
infiltrada	infiltrado	Gender
tapaos	tápese	Person
alfabetizada	alfabetizado	Gender
discontinuases	discontinúes	Tense
aprehende	pare	lemma
apresaría	apresarían	Person
paliada	paliado	Gender
expatrías	expatriarás	Tense
saludaste	saludó	Person
ocasionaste	ocasionó	Person
inscriben	inscribe	Person
encaminada	encaminado	Gender
profundizásemos	profundizasen	Person
raerías	raería	Person
cuidada	cuidado	Gender
aconsejara	padeciera	lemma
deshilachadas	deshilachados	Gender
enquistadas	enquistados	Gender
abrumaremos	abrumamos	Tense
emparentase	reorientase	lemma
desnivele	desnivelare	Tense
desatadas	desatados	Gender
arrobadas	arrobados	Gender
indispuesta	indispuesto	Gender
climatizadas	climatizados	Gender
educen	interiorizan	lemma
enconcharía	implosionaría	lemma
encaminaré	encaminaremos	Number
retrogradada	retrogradado	Gender
terminada	terminado	Gender
desacreditares	desacredites	Tense
contemplada	contemplado	Gender
pean	peen	Mood
escoltados	unificados	lemma
amamantes	amamanten	Person
narraba	narraban	Number
nominase	nominases	Person
contravenías	idiotizabas	lemma
clasificada	clasificado	Gender
degrades	degradases	Tense
wikificada	wikificado	Gender
defecadas	defecados	Gender
sacramentará	sacramenta	Tense
engominaría	reintroduciría	lemma
azoté	azotamos	Number
empeorada	empeorado	Gender
avergonzada	avergonzado	Gender
endiosadas	endiosados	Gender
entablaseis	pintaseis	lemma
intentada	intentado	Gender
descreemos	descreo	Number
xerografiaba	xerografiaban	Person
enredaríamos	insensibilizaríamos	lemma
reforzadas	reforzados	Gender
depuestas	depuestos	Gender
abisagrare	terciare	lemma
bordadas	bordados	Gender
picoteaseis	picoteareis	Tense
podrida	podrido	Gender
enrojeció	hostilizó	lemma
agregase	agregaseis	Person
ahumadas	ahumados	Gender
charloteares	peronizares	lemma
fustigaríamos	fustigaríais	Person
ceje	cejemos	Number
rebozada	rebozado	Gender
añadiera	resonara	lemma
defendidas	defendidos	Gender
descache	evanesca	lemma
actualizada	actualizado	Gender
cristianizadas	sitiadas	lemma
liadas	liados	Gender
centrada	centrado	Gender
alterareis	alterare	Person
promulgan	promulga	Person
abre	abramos	Person
condona	supón	lemma
autofinanciada	autofinanciado	Gender
retribuidas	retribuidos	Gender
impendimos	impendió	Person
rezumadas	rezumados	Gender
copulo	insulto	lemma
contratadas	contratados	Gender
pavoneémonos	pavonéense	Person
redirigidas	redirigidos	Gender
tamborileabas	tamborileabais	Person
acobardados	ratificados	lemma
arreglareis	arreglaréis	Mood
concentráramos	concentraras	Person
saneada	saneado	Gender
desandas	maquinas	lemma
ondulada	ondulado	Gender
alienarán	alienaréis	Person
renacida	renacido	Gender
cartéate	cartéense	Person
hedisteis	hedieron	Person
cachondeásemos	cachondease	Person
defendí	defendió	Person
cachasen	cachase	Number
sombreada	sombreado	Gender
desbastadas	desbastados	Gender
amontonadas	amontonados	Gender
descubiertas	descubiertos	Gender
descontextualizada	descontextualizado	Gender
desnivelada	desnivelado	Gender
accionada	accionadas	Number
sobrevolada	sobrevolado	Gender
desuscritas	desuscritos	Gender
barradas	barrada	Number
definía	toleraba	lemma
coprotagonizada	coprotagonizado	Gender
detectadas	detectados	Gender
conturbabais	conturbaba	Person
acongojares	sorbieres	lemma
chantajearán	chantajeará	Person
amaña	amaño	Person
fugadas	fugada	Number
abátanse	abátase	Number
trasportada	trasportado	Gender
regüelda	regoldemos	Person
colada	colado	Gender
entristecida	entristecido	Gender
avellanan	avellanamos	Person
discrepa	resucita	lemma
amoblemos	sobreexplotemos	lemma
modifique	modifiques	Person
caracterizada	caracterizado	Gender
comides	comedirás	Tense
pintada	pintado	Gender
abducida	abducido	Gender
solicitada	solicitado	Gender
ronronearíamos	ronronearía	Number
encuerare	encueráremos	Person
acolcháramos	acolchara	Person
afiligrano	retorno	lemma
civilizadas	civilizados	Gender
méate	méese	Person
existidas	existidos	Gender
estudiaron	estudió	Number
entrecomillaste	entrecomillé	Person
afeminaría	regresaría	lemma
frustradas	frustrados	Gender
acordonásemos	acordonemos	Tense
ironizases	ironizares	Tense
amenazadas	amenazados	Gender
desbandada	desbandado	Gender
envejeciendo	oponiendo	lemma
prescribáis	prescribas	Number
reten	retéis	Person
orientadas	orientados	Gender
trascendiese	trascienda	Tense
afianzaba	afianzábamos	Number
atrapare	atrape	Tense
computarizada	computarizado	Gender
ablanda	preserva	lemma
aguantada	aguantado	Gender
mitigada	mitigado	Gender
adentrémonos	adéntrense	Person
zurriares	zurríes	Tense
piloteadas	piloteados	Gender
aseguradas	asegurados	Gender
escarpabais	invocabais	lemma
acarreará	acarrearán	Person
represadas	represados	Gender
acalmamos	exfoliamos	lemma
indignada	indignado	Gender
carburaren	carburare	Number
reclamarías	reclamaría	Person
colonicéis	colonizaseis	Tense
ocultadas	ocultada	Number
apegados	apegado	Number
diagonalizo	diagonalizas	Person
candados	referenciados	lemma
encarada	encarado	Gender
adaptaseis	adaptareis	Tense
divertidas	divertida	Number
imploraran	imploráramos	Person
condensó	suplió	lemma
corona	modula	lemma
acosareis	acosares	Person
vistos	visto	Number
acorazase	acorazásemos	Person
atiborrarais	presentarais	lemma
compinchados	compinchado	Number
ejercitada	molestada	lemma
rapiñadas	rapiñados	Gender
capacitaron	capacitó	Number
aterrorizan	polen	lemma
desfilemos	desfile	Person
zancadillearan	zancadillearais	Person
fabrica	fabricamos	Person
procrastinadas	procrastinados	Gender
vacacionaras	vacacionarais	Number
celebradas	celebrados	Gender
implicadas	implicados	Gender
estallarais	estallara	Person
homologada	homologado	Gender
agitaban	agitaba	Person
recolocase	recolocasen	Number
cronometradas	cronometrados	Gender
estarcirá	socializará	lemma
apegada	apegado	Gender
tumbada	tumbado	Gender
canturreemos	canturreáremos	Tense
enrolaría	indicaría	lemma
metida	metido	Gender
aifonee	aifoneare	Tense
encriptada	encriptado	Gender
adivinareis	adivinaréis	Mood
desordene	rebaje	lemma
pulvericemos	pulvericen	Person
nominaren	nominarán	Mood
criticadas	criticados	Gender
conjugarás	hartarás	lemma
singue	singo	Mood
envejeciese	envejeciere	Tense
descontratares	descontratare	Person
reventada	reventado	Gender
dinamitaría	valdría	lemma
refactura	refacturo	Person
premiadas	premiados	Gender
musicalizadas	musicalizados	Gender
calibre	calibres	Person
coceadas	coceados	Gender
planta	plante	Mood
desposaréis	desposarás	Person
combines	combinares	Tense
vegetaremos	vegetaré	Number
aspiran	posponen	lemma
eclipsadas	eclipsados	Gender
republicaron	republicó	Person
escandieres	sancionares	lemma
puedes	podrás	Tense
raspare	raspe	Tense
serré	serró	Person
enranciases	reinstaurases	lemma
pisoteara	pisoteáramos	Person
defoliará	defoliarás	Person
cronificada	cronificado	Gender
recapitalizada	recapitalizado	Gender
cosquilleada	cosquilleado	Gender
conduciréis	lamentaréis	lemma
aparenta	sustituye	lemma
atestiguaste	rebosaste	lemma
derivó	derivaron	Person
respetadas	respetados	Gender
atajéis	gerenciéis	lemma
afrontada	afrontado	Gender
desembarcaré	desembarcaremos	Person
sensibilizada	sensibilizado	Gender
enconada	enconado	Gender
acalorados	acalorado	Number
plantadas	plantados	Gender
desafiaren	focalizaren	lemma
tatemase	tatemásemos	Number
desgajadas	desgajados	Gender
concadené	pendí	lemma
moralizaría	moralizaríamos	Number
bastoneabais	bastoneaba	Person
heredadas	heredados	Gender
yantaríais	yantarías	Person
ejercida	ejercido	Gender
canonizada	canonizado	Gender
cliqueadas	cliqueados	Gender
martirizados	martirizado	Number
birlaremos	birlaréis	Person
padecida	padecidas	Number
restituida	restituido	Gender
conjugada	conjugado	Gender
civilicen	civilizaren	Tense
fosilícese	fosilizaos	Person
extinguís	extingues	Person
avistada	avistado	Gender
ausenten	ofrezcan	lemma
divulgadas	divulgados	Gender
reescrita	reescrito	Gender
desocupada	desocupado	Gender
discriminásemos	discriminase	Number
enraizadas	enraizados	Gender
oscurecidas	oscurecidos	Gender
amenizadas	amenizados	Gender
acurrucaban	solucionaban	lemma
acabara	paralizara	lemma
desaliñada	desaliñado	Gender
descogollamos	descogollo	Number
odia	odien	Person
parquean	parqueen	Mood
apuntalan	apuntala	Number
agravadas	agravados	Gender
tonsurásemos	tonsurase	Number
invocadas	invocada	Number
derramareis	factorizareis	lemma
arremolinados	arremolinado	Number
acantorada	acantorado	Gender
cobijarían	cobijaría	Person
forradas	forrados	Gender
encausar	trasquilar	lemma
desnaturalizáramos	desnaturalizara	Number
exceptuada	exceptuado	Gender
astreñidas	astreñidos	Gender
compartan	compartas	Person
omitían	omitía	Number
encerrar	recetar	lemma
conviden	convidaren	Tense
hurtara	hurtáramos	Person
dibujada	dibujado	Gender
deambulé	deambulamos	Number
cimadas	cimados	Gender
neutralizada	neutralizado	Gender
aglomeradas	aglomerados	Gender
alertada	alertado	Gender
copada	copado	Gender
maldijeseis	maldijereis	Tense
adocenados	adocenado	Number
atesando	serenando	lemma
comisariada	comisariado	Gender
subrogada	subrogado	Gender
invernada	invernado	Gender
abalearéis	abaleareis	Mood
centralizada	centralizado	Gender
transbordaba	transbordábamos	Number
persistida	persistido	Gender
alcanzada	alcanzado	Gender
abultadas	abultados	Gender
emigradas	emigrados	Gender
demudadas	demudados	Gender
canturreáis	repiqueteáis	lemma
aburrido	aburridos	Number
atrancada	atrancado	Gender
robas	roban	Person
fulgieres	fulgiéremos	Person
desorientada	desorientado	Gender
escupisteis	mancomunasteis	lemma
balbuceada	balbuceado	Gender
acodados	acodado	Number
guionada	guionado	Gender
enripiada	enripiado	Gender
vedaseis	vedareis	Tense
astillo	astillaré	Tense
urdidas	urdidos	Gender
empacadas	empacados	Gender
corearemos	coreamos	Tense
dibujados	dibujado	Number
chatea	evidencia	lemma
desmochadas	desmochados	Gender
resultaba	resultábamos	Number
bifurcada	bifurcado	Gender
planteada	planteado	Gender
hacendó	hacendaste	Person
permutada	permutado	Gender
contribuiría	presentaría	lemma
guisada	guisado	Gender
descascarillamos	descascarillo	Number
ofuscada	ofuscado	Gender
garantizase	garantizasen	Person
traídas	traídos	Gender
creería	musicalizaría	lemma
acalenturémonos	acalentúrense	Person
anunciadas	anunciados	Gender
dudan	dudamos	Person
gambeteó	gambetearon	Number
agrietadas	agrietados	Gender
derrotadas	derrotados	Gender
arrepentíos	arrepiéntete	Number
hincadas	hincados	Gender
allegadas	allegados	Gender
rebota	rebotan	Person
acantonadas	acantonados	Gender
arruinada	arruinado	Gender
radicalicémonos	radicalícense	Person
utilizadas	utilizada	Number
historiada	historiado	Gender
combinen	combine	Person
expresadas	expresados	Gender
crotoreaste	teloneaste	lemma
escuadronarais	retuitearais	lemma
conmutáis	conmutan	Person
chamullada	chamullado	Gender
esbozase	esboce	Tense
cesada	cesado	Gender
perecéis	pereces	Number
atisbáremos	atisbásemos	Tense
achacada	achacado	Gender
documentada	documentado	Gender
desplazada	desplazado	Gender
despreciaban	despreciaba	Number
adiada	adiado	Gender
autoeditada	autoeditado	Gender
dichas	rociadas	lemma
secundadas	secundados	Gender
balbucirán	intuirán	lemma
desmonta	desmonte	Mood
usufructuadas	usufructuados	Gender
defraudada	defraudado	Gender
emborrachados	emborrachado	Number
atestiguadas	atestiguados	Gender
devane	interprete	lemma
empacada	empacado	Gender
erizadas	erizados	Gender
volvería	volveríamos	Person
considerada	germinada	lemma
ablacionases	ablacionares	Tense
atacadas	atacados	Gender
reconoce	reconozcamos	Person
desmantelo	desmantelamos	Person
mullida	mullido	Gender
condimentadas	condimentados	Gender
achicadas	achicada	Number
ulcere	ulcerase	Tense
subcontratadas	subcontratados	Gender
cloqueada	cloqueado	Gender
activada	repoblada	lemma
melgue	melgare	Tense
vocalizadas	vocalizados	Gender
opina	opino	Person
armonizadas	armonizados	Gender
computarizadas	computarizados	Gender
desplazan	desplazarán	Tense
entibiaríais	entibiaríamos	Person
apelmazaremos	interaccionaremos	lemma
inventariarais	inventariaran	Person
desparpajara	desparpajáramos	Person
comisionéis	comisionáis	Mood
deshidratadas	deshidratados	Gender
echadas	echada	Number
atronadas	atronados	Gender
abnegaréis	abnegáis	Tense
flexionada	flexionado	Gender
acoplarás	teatralizarás	lemma
enrolladas	enrollados	Gender
envanecería	trasoiría	lemma
descabalgadas	descabalgados	Gender
pisoteada	pisoteado	Gender
apretujadas	apretujados	Gender
enférmate	enférmense	Person
biseladas	biselados	Gender
asegurarás	asegurará	Person
adiestres	regales	lemma
lanceara	lancearan	Number
apréstense	apréstese	Person
invadirán	invaden	Tense
toqueteáis	toqueteas	Number
despedida	despedido	Gender
malvendiere	malvendiereis	Person
envejecidas	envejecidos	Gender
descohesionare	descohesionase	Tense
bascularías	nombrarías	lemma
cifradas	historiadas	lemma
flaquea	flaquean	Number
aireáremos	aireare	Person
chamusquemos	chamuscásemos	Tense
pautadas	pautados	Gender
cartéense	cartéese	Number
enjutases	enjutaseis	Number
engullida	engullido	Gender
corregidas	corregidos	Gender
depredada	depredado	Gender
resincronizaremos	resincronizamos	Tense
abastardadas	abastardados	Gender
embellecen	embellece	Number
retiré	retiramos	Number
cobijada	cobijado	Gender
sombrabas	sombraban	Person
retratara	retrataras	Person
frivolizare	frivolice	Tense
alquilaba	persistía	lemma
atáscate	atasquémonos	Person
desamortizadas	desamortizados	Gender
democratizada	democratizado	Gender
defeccionemos	defeccionamos	Mood
apoyadas	apoyada	Number
alcanza	alcance	Person
acopiaren	acopiare	Number
véanse	véase	Person
estresada	estresado	Gender
desbarajustará	repavimentará	lemma
parémonos	párese	Person
cariciaría	minaría	lemma
bateada	bateado	Gender
amanecería	mediría	lemma
rotaran	rotara	Number
payaseamos	payasea	Person
entremezclaré	textearé	lemma
entubada	entubado	Gender
enfadase	renombrase	lemma
erréis	yerren	Person
añadieran	recostaran	lemma
reconquistados	reconquistado	Number
cabildearen	cabildeen	Tense
encuadrada	encuadrado	Gender
aprestada	aprestado	Gender
codiciábamos	codiciaba	Person
prevalecidas	prevalecida	Number
constelaréis	constelarán	Person
descabellásemos	descabellase	Person
desviaran	desviarais	Person
desfiguradas	desfigurados	Gender
engrosase	engruese	Tense
enfatizaste	reinstalaste	lemma
manufacturada	manufacturado	Gender
enlatada	enlatado	Gender
estereotiparen	estereotipare	Person
alzase	invitase	lemma
sobrevolarán	sobrevolaremos	Person
partidas	partidos	Gender
intercambiadas	intercambiados	Gender
tumultuabais	tumultuabas	Person
reelaborada	reelaborado	Gender
hiladas	hilados	Gender
correlacionaren	correlacionares	Person
incité	incitaron	Person
trasmitida	trasmitido	Gender
despedace	despedazo	Mood
evaluada	evaluado	Gender
brutalizaríamos	ingeniaríamos	lemma
