расслабься	Second person Singular
вытянула	None
гнутся	Third person Plural
обзатыливаем	First person Plural
подготавливается	Third person Singular
баллонах	None
утешения	None
горю	First person Singular
пожалей	Second person Singular
соизмеримых	None
переполняют	Third person Plural
расам	None
опрашивает	Third person Singular
практикуясь	None
подвергай	Second person Singular
пряденный	None
изобретает	Third person Singular
отмечаетесь	Second person Plural
насмехается	Third person Singular
выведите	Second person Plural
заливайте	Second person Plural
скрепляют	Third person Plural
набивают	Third person Plural
летят	Third person Plural
бунтуют	Third person Plural
камбал	None
настроим	First person Plural
вынеси	Second person Singular
гаснут	Third person Plural
стремительному	None
огнедышащей	None
выпуклость	None
всплывут	Third person Plural
храни	Second person Singular
грубит	Third person Singular
рой	Second person Singular
калечат	Third person Plural
общенародное	None
критикую	First person Singular
садится	Third person Singular
извращает	Third person Singular
удаляются	Third person Plural
стонут	Third person Plural
скрытое	None
омрачает	Third person Singular
эпицентров	None
подсаживает	Third person Singular
мысленный	None
космополитизме	None
получим	First person Plural
поцелуетесь	Second person Plural
бретонцами	None
бунтует	Third person Singular
сосуществует	Third person Singular
прищуриваю	First person Singular
трактата	None
усыпляют	Third person Plural
ратую	First person Singular
шотландскому	None
пиратскую	None
обзатыливают	Third person Plural
расплывается	Third person Singular
травит	Third person Singular
выстави	Second person Singular
воздерживайтесь	Second person Plural
коснутся	Third person Plural
молебны	None
балуются	Third person Plural
настораживайся	Second person Singular
распоряжусь	First person Singular
перенимают	Third person Plural
кати	Second person Singular
уготовь	Second person Singular
разъем	First person Singular
клюньте	Second person Plural
прожуйте	Second person Plural
переоценивает	Third person Singular
порыву	None
опубликуем	First person Plural
асинхронная	None
огибаем	First person Plural
революционерки	None
сливают	Third person Plural
прогорю	First person Singular
лесохозяйственном	None
делается	Third person Singular
ухитряется	Third person Singular
сочти	Second person Singular
копируют	Third person Plural
дивятся	Third person Plural
козырем	None
переставляют	Third person Plural
изнуряли	None
полотенцем	None
добиваешь	Second person Singular
вынесу	First person Singular
ткут	Third person Plural
путаете	Second person Plural
престижные	None
торгуются	Third person Plural
увидятся	Third person Plural
ведётся	Third person Singular
царят	Third person Plural
долбающий	None
обзаводятся	Third person Plural
добью	First person Singular
различаем	First person Plural
заключается	Third person Singular
улавливаете	Second person Plural
забарабаните	Second person Plural
замучаешься	Second person Singular
распрямятся	Third person Plural
горсток	None
клане	None
встроилось	None
озвучиваю	First person Singular
ругайтесь	Second person Plural
пересмотрю	First person Singular
осматривается	Third person Singular
полупроводники	None
восточнославянское	None
охотятся	Third person Plural
спекулянтам	None
присоединится	Third person Singular
обителях	None
истребит	Third person Singular
печаль	Second person Singular
толчётесь	Second person Plural
обременяет	Third person Singular
бесчисленного	None
смерил	None
ослабнет	Third person Singular
контролю	None
подчёркивается	Third person Singular
подсчётом	None
платится	Third person Singular
рапортуем	First person Plural
выборочно	None
говорятся	Third person Plural
высмеивают	Third person Plural
сделаются	Third person Plural
закрепляются	Third person Plural
залейте	Second person Plural
небосклону	None
вымывают	Third person Plural
плюют	Third person Plural
мысли	Second person Singular
очистит	Third person Singular
припишут	Third person Plural
прошей	Second person Singular
смекнут	Third person Plural
жуй	Second person Singular
наслаждаюсь	First person Singular
осени	Second person Singular
всхлипывайте	Second person Plural
выступают	Third person Plural
александрийскую	None
скрипнешь	Second person Singular
впишите	Second person Plural
зачитавший	None
фиксируем	First person Plural
перекладывают	Third person Plural
сплетничал	None
вышвыривают	Third person Plural
учитываю	First person Singular
высказывайтесь	Second person Plural
образуется	Third person Singular
примыкают	Third person Plural
кандидату	None
перелетела	None
лжёте	Second person Plural
упрекну	First person Singular
простынь	Second person Singular
колитесь	Second person Plural
имитатором	None
ресурсен	None
идентифицирует	Third person Singular
косарьём	None
плещусь	First person Singular
пульсирует	Third person Singular
маневрирует	Third person Singular
преуменьшаем	First person Plural
переливаются	Third person Plural
хами	Second person Singular
удлинённых	None
отключаются	Third person Plural
целуются	Third person Plural
шаркать	None
выбивается	Third person Singular
вольются	Third person Plural
кожевеном	None
уплачивают	Third person Plural
нескончаемое	None
влекли	None
пеняем	First person Plural
прочувствуем	First person Plural
женю	First person Singular
убеждениям	None
приятной	None
отработай	Second person Singular
затихал	None
убавив	None
расправляются	Third person Plural
оснащают	Third person Plural
отсеку	First person Singular
передумывает	Third person Singular
шевельнитесь	Second person Plural
синеет	Third person Singular
одноклассником	None
накидывается	Third person Singular
свариваете	Second person Plural
плыви	Second person Singular
немалым	None
ёкаем	First person Plural
запутываются	Third person Plural
егерем	None
колонизируют	Third person Plural
петарду	None
канем	First person Plural
ломится	Third person Singular
поставятся	Third person Plural
снижают	Third person Plural
авгура	None
пронеситесь	Second person Plural
исследуясь	None
приручается	Third person Singular
различится	Third person Singular
глотают	Third person Plural
финансируются	Third person Plural
отмечаются	Third person Plural
жалуются	Third person Plural
переливание	None
прети	Second person Singular
разлагай	Second person Singular
спутает	Third person Singular
фигурирует	Third person Singular
скорбит	Third person Singular
божьи	None
банкеты	None
гонконгскую	None
выехала	None
издаются	Third person Plural
доверчиво	None
арифметическая	None
опьяняют	Third person Plural
отстоят	Third person Plural
запрашиваю	First person Singular
навредит	Third person Singular
паразита	None
поместят	Third person Plural
выкуешь	Second person Singular
публикуете	Second person Plural
брани	Second person Singular
внедряются	Third person Plural
выступаем	First person Plural
делю	First person Singular
сместится	Third person Singular
вибрациям	None
выборочные	None
хает	Third person Singular
резервирует	Third person Singular
тускнейте	Second person Plural
воскресному	None
выдвигают	Third person Plural
готской	None
арабизированный	None
многоэтажных	None
оседлает	Third person Singular
кану	First person Singular
валяй	Second person Singular
шагают	Third person Plural
разъедая	None
пазлов	None
верхушках	None
приготовляются	Third person Plural
арийцев	None
мшат	Third person Plural
присмотрю	First person Singular
удостоверяется	Third person Singular
соприкасается	Third person Singular
затыкают	Third person Plural
символизирует	Third person Singular
новоявленного	None
оплачивается	Third person Singular
маслину	None
изменяются	Third person Plural
мстит	Third person Singular
связываетесь	Second person Plural
своровал	None
именуют	Third person Plural
проклятьем	None
размещаем	First person Plural
очистится	Third person Singular
временное	None
опутывает	Third person Singular
фотографируются	Third person Plural
моет	Third person Singular
числятся	Third person Plural
посей	Second person Singular
кодируют	Third person Plural
завистях	None
насаждай	Second person Singular
сочетает	Third person Singular
заманчивой	None
гликопротеина	None
небогатом	None
вздохнете	Second person Plural
росянка	None
криминализую	First person Singular
взору	None
карлика	None
обнашиваешь	Second person Singular
вскидываю	First person Singular
растрате	None
пробегут	Third person Plural
протестуют	Third person Plural
конкурсном	None
похоронную	None
глинтвейн	None
поправлю	First person Singular
оконечность	None
сведется	Third person Singular
тку	First person Singular
обозначается	Third person Singular
выказывает	Third person Singular
переплывает	Third person Singular
разведённый	None
опередит	Third person Singular
дворянства	None
фригидный	None
подбиваешь	Second person Singular
обгонит	Third person Singular
крутятся	Third person Plural
озадачивает	Third person Singular
сильной	None
весит	Third person Singular
приступят	Third person Plural
содрогается	Third person Singular
брей	Second person Singular
повысится	Third person Singular
проясняют	Third person Plural
пеллагры	None
дымит	Third person Singular
советуюсь	First person Singular
брегеты	None
прячет	Third person Singular
повесьтесь	Second person Plural
сустава	None
отводятся	Third person Plural
восседает	Third person Singular
сыплются	Third person Plural
дискредитируют	Third person Plural
растекаются	Third person Plural
спится	Third person Singular
покоится	Third person Singular
являет	Third person Singular
соединится	Third person Singular
сушу	First person Singular
отчеканит	Third person Singular
рубит	Third person Singular
царапает	Third person Singular
хозяйствуйте	Second person Plural
переплёту	None
допишем	First person Plural
затеривается	Third person Singular
надушу	First person Singular
водится	Third person Singular
дорабатывайте	Second person Plural
покачивайте	Second person Plural
замачивают	Third person Plural
вкладывает	Third person Singular
смягчаются	Third person Plural
скорректируем	First person Plural
присматривают	Third person Plural
мелю	First person Singular
выпорют	Third person Plural
разыгрывает	Third person Singular
дебютирует	Third person Singular
промышляют	Third person Plural
забиваются	Third person Plural
наложение	None
навязываете	Second person Plural
декларируете	Second person Plural
обрушит	Third person Singular
сматывается	Third person Singular
расторгнут	Third person Plural
понимающим	None
расчётом	None
устроится	Third person Singular
лошаком	None
блюют	Third person Plural
взирает	Third person Singular
одуреем	First person Plural
вынимает	Third person Singular
вводишь	Second person Singular
дымлюсь	First person Singular
криминализуйте	Second person Plural
вилкой	None
назрела	None
литовка	None
магазины	None
отслеживанный	None
сулим	First person Plural
ширится	Third person Singular
ячейкой	None
провайдером	None
палладием	None
твердят	Third person Plural
шокирую	First person Singular
выстоит	Third person Singular
редактируешь	Second person Singular
кастрируют	Third person Plural
неописуемых	None
допрашивают	Third person Plural
мятежу	None
наталкиваетесь	Second person Plural
поддерживается	Third person Singular
насмехаются	Third person Plural
уделяют	Third person Plural
отделывается	Third person Singular
евразийской	None
расквартирования	None
председательствует	Third person Singular
переключаться	None
белоснежен	None
разгромим	First person Plural
обрати	Second person Singular
передёргиваете	Second person Plural
взбираются	Third person Plural
отлучаются	Third person Plural
разглядывают	Third person Plural
распрямляются	Third person Plural
петляйте	Second person Plural
рухнул	None
своде	None
отодвигаемся	First person Plural
колбасим	First person Plural
намереваюсь	First person Singular
активизирует	Third person Singular
метеорами	None
спрогнозировала	None
обезумейте	Second person Plural
выныривает	Third person Singular
выскакивают	Third person Plural
проплывают	Third person Plural
повели	Second person Singular
удосуживается	Third person Singular
старь	Second person Singular
казарма	None
сотворит	Third person Singular
игнорируем	First person Plural
пригорок	None
пространному	None
претензией	None
допытываемся	First person Plural
закопаешь	Second person Singular
прикрикиваю	First person Singular
крену	None
обыгрывает	Third person Singular
подтянут	Third person Plural
обращаем	First person Plural
укрощает	Third person Singular
уравновесят	Third person Plural
насчитываются	Third person Plural
отделяет	Third person Singular
точками	None
отработке	None
компенсируется	Third person Singular
сворачиваетесь	Second person Plural
отзываю	First person Singular
разносят	Third person Plural
автомашинами	None
поли	Second person Singular
насущной	None
поваляет	Third person Singular
морочь	Second person Singular
стапливавший	None
обгложем	First person Plural
минирует	Third person Singular
мариинским	None
полем	First person Plural
экстремальном	None
акклиматизируйся	Second person Singular
тантала	None
рухнет	Third person Singular
веруют	Third person Plural
запинаетесь	Second person Plural
анализируй	Second person Singular
истребляют	Third person Plural
отшвырну	First person Singular
маникюра	None
обрасти	Second person Singular
присматривает	Third person Singular
подхватило	None
смешивается	Third person Singular
марай	Second person Singular
вырисовываются	Third person Plural
приобщают	Third person Plural
спутаюсь	First person Singular
треножник	None
вяжи	Second person Singular
будильники	None
ровняем	First person Plural
проваливает	Third person Singular
комплектовали	None
оттисками	None
люмену	None
нацеливается	Third person Singular
приостанавливают	Third person Plural
аллофонов	None
мачеха	None
кормит	Third person Singular
глянете	Second person Plural
сбегают	Third person Plural
поступает	Third person Singular
принимается	Third person Singular
равняются	Third person Plural
материт	Third person Singular
дорабатываем	First person Plural
помечают	Third person Plural
вмешаются	Third person Plural
великанов	None
высокогорная	None
непосредственному	None
укрывают	Third person Plural
закладывается	Third person Singular
освоится	Third person Singular
биографическая	None
обостряется	Third person Singular
гомосексуальному	None
демпинге	None
затопляет	Third person Singular
пластмассам	None
приютить	None
затормаживай	Second person Singular
рудная	None
бессмысленность	None
обретет	Third person Singular
ухватится	Third person Singular
метрополитенов	None
раскинутся	Third person Plural
подсылает	Third person Singular
прочтению	None
декламируют	Third person Plural
залепляю	First person Singular
используетесь	Second person Plural
похищает	Third person Singular
боснийскому	None
загибаются	Third person Plural
подтвердится	Third person Singular
небосклоне	None
опричнине	None
затевает	Third person Singular
подкармливают	Third person Plural
формализмом	None
подпускает	Third person Singular
осложняешь	Second person Singular
сравнится	Third person Singular
гуглю	First person Singular
разгребаю	First person Singular
поднимаю	First person Singular
удалятся	Third person Plural
дублирую	First person Singular
копаются	Third person Plural
исходным	None
насыщается	Third person Singular
воздействует	Third person Singular
проливается	Third person Singular
разбивается	Third person Singular
упрощаете	Second person Plural
восстановятся	Third person Plural
припритесь	Second person Plural
неправедного	None
белю	First person Singular
забьет	Third person Singular
работает	Third person Singular
проистекает	Third person Singular
нервничаю	First person Singular
махал	None
рукодельницу	None
гну	First person Singular
волнолому	None
вихри	Second person Singular
варшавским	None
портит	Third person Singular
сторожу	First person Singular
последует	Third person Singular
опираюсь	First person Singular
проглатывает	Third person Singular
радуют	Third person Plural
усиливается	Third person Singular
разместятся	Third person Plural
отправляется	Third person Singular
упоминайте	Second person Plural
разумной	None
достраивается	Third person Singular
вонзается	Third person Singular
ископаемая	None
прекратятся	Third person Plural
братию	None
критикуют	Third person Plural
сделается	Third person Singular
обогащается	Third person Singular
виляй	Second person Singular
космонавтов	None
заказное	None
путает	Third person Singular
потрёпанном	None
санскритским	None
твержу	First person Singular
довёлся	None
побери	Second person Singular
доработайте	Second person Plural
сплющу	First person Singular
западу	First person Singular
раскладывают	Third person Plural
покушаетесь	Second person Plural
выпадают	Third person Plural
агитируют	Third person Plural
вивисекции	None
перекидывается	Third person Singular
почерней	Second person Singular
похмеляется	Third person Singular
провоцируете	Second person Plural
крестником	None
напевают	Third person Plural
трескается	Third person Singular
включатся	Third person Plural
пну	First person Singular
соловейку	None
выливаются	Third person Plural
удостаивают	Third person Plural
заедаете	Second person Plural
бейся	Second person Singular
автобусами	None
вынудит	Third person Singular
кусаются	Third person Plural
ожидаются	Third person Plural
срубают	Third person Plural
шелохнете	Second person Plural
сочиняйте	Second person Plural
настраивает	Third person Singular
заделывают	Third person Plural
озаглавишь	Second person Singular
упрекаете	Second person Plural
горби	Second person Singular
ворчит	Third person Singular
разгребет	Third person Singular
индивидуальное	None
пододвигав	None
буеве	None
градусником	None
отсвечивайте	Second person Plural
сбудутся	Third person Plural
заменятся	Third person Plural
колдует	Third person Singular
завышает	Third person Singular
бросаюсь	First person Singular
вымрет	Third person Singular
потребуйся	Second person Singular
решаются	Third person Plural
заплывает	Third person Singular
перерастают	Third person Plural
подкидывайте	Second person Plural
удит	Third person Singular
выставляйте	Second person Plural
смажем	First person Plural
пришибают	Third person Plural
продлит	Third person Singular
лечебнице	None
отпугивает	Third person Singular
студент	None
процессором	None
высасывают	Third person Plural
стреляйтесь	Second person Plural
звучаниям	None
анонимов	None
оповещают	Third person Plural
запоздаю	First person Singular
свистни	Second person Singular
переигрывает	Third person Singular
иракском	None
мобилизуют	Third person Plural
сбрось	Second person Singular
предвкушает	Third person Singular
разогрело	None
пожалею	First person Singular
провоцируют	Third person Plural
огрызаемся	First person Plural
подправьте	Second person Plural
сыром	None
снизят	Third person Plural
щелкнем	First person Plural
прямик	None
приезжает	Third person Singular
умилениях	None
заворачивай	Second person Singular
проясняет	Third person Singular
просуществуй	Second person Singular
суммировать	None
среднестатистических	None
откидывается	Third person Singular
шевельну	First person Singular
заслонишь	Second person Singular
постыдным	None
взмётываются	Third person Plural
сонетах	None
пожирают	Third person Plural
выдаю	First person Singular
выращивает	Third person Singular
варится	Third person Singular
уверь	Second person Singular
процитируется	Third person Singular
подзывает	Third person Singular
постройте	Second person Plural
понаблюдаем	First person Plural
пересаживают	Third person Plural
закатись	Second person Singular
вырисовывается	Third person Singular
утихнут	Third person Plural
желательной	None
засуньте	Second person Plural
ручается	Third person Singular
выговоришься	Second person Singular
обстроишь	Second person Singular
выявится	Third person Singular
копируем	First person Plural
подозреваю	First person Singular
выстраивавшись	None
соскочу	First person Singular
глубинным	None
участливому	None
корешками	None
идёте	Second person Plural
мальчишник	None
правишь	Second person Singular
слывёт	Third person Singular
бездействуете	Second person Plural
забудутся	Third person Plural
воссоздают	Third person Plural
шубы	None
заряжает	Third person Singular
расположи	Second person Singular
ацтеков	None
замполита	None
веришь	Second person Singular
переместись	Second person Singular
перенимает	Third person Singular
перепугай	Second person Singular
вешается	Third person Singular
зарубежье	None
затрагивались	None
подмечая	None
съедает	Third person Singular
прохождением	None
разъясняет	Third person Singular
усаживает	Third person Singular
придавливает	Third person Singular
шлейфа	None
киши	Second person Singular
первого	None
загружает	Third person Singular
вскипятит	Third person Singular
прославленном	None
накачивает	Third person Singular
бросается	Third person Singular
долинами	None
жуют	Third person Plural
помяни	Second person Singular
рули	Second person Singular
отталкивает	Third person Singular
загадывает	Third person Singular
арканы	None
спасение	None
покорит	Third person Singular
наслышусь	First person Singular
вздумает	Third person Singular
полую	None
отвлекают	Third person Plural
деяниями	None
сдержишься	Second person Singular
согласуются	Third person Plural
отслеживаю	First person Singular
заслоняет	Third person Singular
испарятся	Third person Plural
компрометирует	Third person Singular
туристический	None
прилагает	Third person Singular
ускользает	Third person Singular
разлагаются	Third person Plural
просчитывает	Third person Singular
выдвигаюсь	First person Singular
вваливайтесь	Second person Plural
горюем	First person Plural
подразделял	None
безболезненны	None
налетела	None
скорбев	None
взгляните	Second person Plural
апеллирует	Third person Singular
оспаривают	Third person Plural
заинтересованность	None
исцелит	Third person Singular
синапсу	None
смотрим	First person Plural
получи	Second person Singular
закачается	Third person Singular
нажимают	Third person Plural
скручивают	Third person Plural
плетутся	Third person Plural
устанавливается	Third person Singular
намечаются	Third person Plural
распластывали	None
господствует	Third person Singular
гримасы	None
коптят	Third person Plural
немку	None
предпринимается	Third person Singular
царская	None
разыщет	Third person Singular
прописывают	Third person Plural
привязываются	Third person Plural
дарованиях	None
горелой	None
обосновывают	Third person Plural
поработаете	Second person Plural
экономией	None
подбадривает	Third person Singular
сменяют	Third person Plural
подстрочный	None
насосов	None
бесхитростно	None
грядите	Second person Plural
планкам	None
произрастают	Third person Plural
трещит	Third person Singular
благородную	None
предвещают	Third person Plural
посмеиваются	Third person Plural
работоспособности	None
недолюбливает	Third person Singular
робкие	None
сбылась	None
скажет	Third person Singular
щуримся	First person Plural
вложится	Third person Singular
бесит	Third person Singular
забивает	Third person Singular
определись	Second person Singular
скачивает	Third person Singular
трапов	None
многочисленны	None
негодует	Third person Singular
усечет	Third person Singular
подкрепляют	Third person Plural
выволакивайте	Second person Plural
платит	Third person Singular
дуете	Second person Plural
ахаете	Second person Plural
упрощают	Third person Plural
переворачивает	Third person Singular
шествует	Third person Singular
забавляйся	Second person Singular
поборют	Third person Plural
толпятся	Third person Plural
добавятся	Third person Plural
кинусь	First person Singular
вкрадчивому	None
приветствуют	Third person Plural
захвати	Second person Singular
позаботьтесь	Second person Plural
крой	Second person Singular
сооружают	Third person Plural
дисциплинирует	Third person Singular
укорам	None
затемнишь	Second person Singular
брильянты	None
транслитерация	None
заживают	Third person Plural
квадранты	None
конфликтуют	Third person Plural
инквизитора	None
завладев	None
отливают	Third person Plural
присуждает	Third person Singular
прибери	Second person Singular
новорожденная	None
учтут	Third person Plural
оттаскивает	Third person Singular
совместит	Third person Singular
повредит	Third person Singular
соборе	None
корю	First person Singular
перехватать	None
подсчитывая	None
стрессовыми	None
ковыряем	First person Plural
пилит	Third person Singular
присваивают	Third person Plural
скорблю	First person Singular
сурьмой	None
недостойной	None
земледелия	None
награбят	Third person Plural
пой	Second person Singular
толкуете	Second person Plural
приветствует	Third person Singular
допускаются	Third person Plural
архивирует	Third person Singular
порадуйте	Second person Plural
запрошу	First person Singular
населяем	First person Plural
выползти	None
выскажетесь	Second person Plural
соперничает	Third person Singular
гравитонами	None
зеленям	None
взметнитесь	Second person Plural
раскинут	Third person Plural
просторный	None
подкормят	Third person Plural
увенчается	Third person Singular
делящий	None
стыках	None
злит	Third person Singular
приглядывать	None
рапорт	None
махну	First person Singular
припомнят	Third person Plural
тромбами	None
засадила	None
изучались	None
прокомментирует	Third person Singular
передвинут	Third person Plural
валентностью	None
мадоннах	None
пересказываю	First person Singular
африканцем	None
кругленькой	None
изображает	Third person Singular
фресках	None
подскакивает	Third person Singular
богатствами	None
налу	None
вопи	Second person Singular
заявишься	Second person Singular
резвится	Third person Singular
нервничают	Third person Plural
обогащает	Third person Singular
лучи	Second person Singular
англицизации	None
грыже	None
конструктором	None
половцы	None
вырубают	Third person Plural
пожимают	Third person Plural
обрисуете	Second person Plural
обескураживает	Third person Singular
маскируют	Third person Plural
излечивает	Third person Singular
рисую	First person Singular
стел	None
выставил	None
выкуете	Second person Plural
хозяйничают	Third person Plural
уклонюсь	First person Singular
выглядывает	Third person Singular
вою	First person Singular
оборудует	Third person Singular
отмахивается	Third person Singular
поправим	First person Plural
заключаются	Third person Plural
застелило	None
попечителя	None
толкования	None
повышает	Third person Singular
формируем	First person Plural
заспоришь	Second person Singular
отягощает	Third person Singular
выскажется	Third person Singular
дорой	Second person Singular
эскадрилье	None
запрещаются	Third person Plural
отвергай	Second person Singular
портится	Third person Singular
ввязываются	Third person Plural
контролируемая	None
опубликуйте	Second person Plural
придерживают	Third person Plural
возьметесь	Second person Plural
тычьтесь	Second person Plural
многословную	None
стекают	Third person Plural
рассеется	Third person Singular
пленяет	Third person Singular
проверками	None
досчитываются	Third person Plural
опустеет	Third person Singular
поработает	Third person Singular
испиши	Second person Singular
хватит	Third person Singular
выделывают	Third person Plural
загромождает	Third person Singular
дарую	First person Singular
блокируем	First person Plural
эвакуирует	Third person Singular
удостаивается	Third person Singular
захлопывается	Third person Singular
комбинированное	None
коагулирую	First person Singular
определимся	First person Plural
атаксией	None
любимую	None
расставляю	First person Singular
обливают	Third person Plural
автокефальных	None
питаю	First person Singular
посчитывают	Third person Plural
перекидывает	Third person Singular
тратьтесь	Second person Plural
спецслужбу	None
кофейней	None
поршнем	None
кубинок	None
кофеин	None
гармонируют	Third person Plural
гастролируют	Third person Plural
ввалишься	Second person Singular
пересказ	None
абсорбтивном	None
затыкает	Third person Singular
поселится	Third person Singular
построит	Third person Singular
подключусь	First person Singular
экзотический	None
реализуем	First person Plural
растит	Third person Singular
шли	Second person Singular
последуют	Third person Plural
накопится	Third person Singular
растягивает	Third person Singular
взлетает	Third person Singular
поразительного	None
однокурсника	None
прочь	Second person Singular
эйсе	None
повествует	Third person Singular
выселит	Third person Singular
всходишь	Second person Singular
квалифицирует	Third person Singular
выливаете	Second person Plural
анчоусам	None
морских	None
фиксируемся	First person Plural
зайдемся	First person Plural
воздвигнут	Third person Plural
глянцем	None
допускается	Third person Singular
предотвращает	Third person Singular
безналичном	None
застают	Third person Plural
расширится	Third person Singular
спрыгивает	Third person Singular
зашлют	Third person Plural
саваннах	None
текстильного	None
обустраивает	Third person Singular
скрываются	Third person Plural
наклоняй	Second person Singular
судятся	Third person Plural
шалят	Third person Plural
разрушается	Third person Singular
загромождают	Third person Plural
вдавливается	Third person Singular
воздержусь	First person Singular
заглядывает	Third person Singular
противоположностей	None
полиглотов	None
парализует	Third person Singular
тайскую	None
психическую	None
постукивайте	Second person Plural
пропишем	First person Plural
гастролируем	First person Plural
невольниками	None
красавице	None
медведей	None
помечаем	First person Plural
израильском	None
поддерживался	None
введут	Third person Plural
обрываю	First person Singular
втискаете	Second person Plural
хольте	Second person Plural
рушитесь	Second person Plural
придерживаетесь	Second person Plural
транснационального	None
гнёт	Third person Singular
чинуши	None
котловин	None
подрочит	Third person Singular
петуху	None
посредственная	None
обращаете	Second person Plural
литого	None
поговаривают	Third person Plural
подглядываешь	Second person Singular
приглашается	Third person Singular
сравню	First person Singular
покоятся	Third person Plural
искорки	None
захлёбывайся	Second person Singular
примащивая	None
сверило	None
пытают	Third person Plural
зависимой	None
сродни	Second person Singular
перелетает	Third person Singular
ждёшь	Second person Singular
скорректирую	First person Singular
двигательные	None
удлиняя	None
дочитаешь	Second person Singular
рисуется	Third person Singular
вскипает	Third person Singular
тройные	None
докопайтесь	Second person Plural
испортится	Third person Singular
разоблачается	Third person Singular
процитируйте	Second person Plural
завернут	Third person Plural
создаётся	Third person Singular
эталонным	None
скородила	None
топчут	Third person Plural
соблазнителя	None
наблюдаются	Third person Plural
отзовитесь	Second person Plural
домогается	Third person Singular
разносить	None
спаслось	None
осложнилась	None
осознанному	None
чувашскую	None
сионистам	None
привязывают	Third person Plural
прикрепиться	None
дружат	Third person Plural
испортишь	Second person Singular
вменяет	Third person Singular
вопрошает	Third person Singular
пересекаюсь	First person Singular
осложняют	Third person Plural
передвигает	Third person Singular
этнонимии	None
тачке	None
скидывайте	Second person Plural
декламирует	Third person Singular
испортит	Third person Singular
высказывается	Third person Singular
сгладишь	Second person Singular
яичком	None
мотивирует	Third person Singular
живёте	Second person Plural
целостному	None
услужливое	None
царапают	Third person Plural
исполняется	Third person Singular
ткёт	Third person Singular
настаёт	Third person Singular
чесноков	None
предлогу	None
ограбь	Second person Singular
загоняют	Third person Plural
накачивай	Second person Singular
заколдовала	None
уездные	None
вертолётные	None
отыгрывает	Third person Singular
оправится	Third person Singular
вооружаетесь	Second person Plural
оттягивают	Third person Plural
комнатным	None
покойся	Second person Singular
скорчусь	First person Singular
развеять	None
ездят	Third person Plural
превозносят	Third person Plural
дели	Second person Singular
изрыгает	Third person Singular
запутаемся	First person Plural
крестишь	Second person Singular
ухватываем	First person Plural
траншея	None
гостит	Third person Singular
вологодского	None
несётся	Third person Singular
сатанизма	None
упростит	Third person Singular
дирижирует	Third person Singular
менталитет	None
региону	None
ржавого	None
рванет	Third person Singular
идентифицируйте	Second person Plural
переписываем	First person Plural
компенсации	None
выдыхаетесь	Second person Plural
распростираете	Second person Plural
склоняется	Third person Singular
поселятся	Third person Plural
реви	Second person Singular
переселяются	Third person Plural
затихает	Third person Singular
стела	None
отмывают	Third person Plural
преображаются	Third person Plural
опрокинусь	First person Singular
затянут	Third person Plural
отыскивается	Third person Singular
вкладываются	Third person Plural
застрелит	Third person Singular
разоримся	First person Plural
скрипача	None
кавалерийской	None
перевожу	First person Singular
закончатся	Third person Plural
осенний	None
птиц	None
растворится	Third person Singular
зачёркиваю	First person Singular
отвлекается	Third person Singular
запомнится	Third person Singular
предпринимаются	Third person Plural
дежурит	Third person Singular
греческая	None
рассаживает	Third person Singular
воспрещает	Third person Singular
потолкуют	Third person Plural
мусорная	None
восстанавливаются	Third person Plural
трётся	Third person Singular
переписываете	Second person Plural
отзовется	Third person Singular
выкрошу	First person Singular
побывает	Third person Singular
упоение	None
размахиваешься	Second person Singular
подбирает	Third person Singular
стилистическая	None
инициируя	None
претендуете	Second person Plural
оборвется	Third person Singular
гляну	First person Singular
мыслим	First person Plural
контролирую	First person Singular
убедится	Third person Singular
забиваю	First person Singular
транслитерирую	First person Singular
кроем	First person Plural
исчерпает	Third person Singular
аналогами	None
повзрослеет	Third person Singular
светят	Third person Plural
запутываешь	Second person Singular
высаживает	Third person Singular
труднодоступная	None
задумавшись	None
скрещивают	Third person Plural
перевозят	Third person Plural
прославляется	Third person Singular
жительницу	None
скажи	Second person Singular
дыми	Second person Singular
волочём	First person Plural
проектах	None
выносят	Third person Plural
выедают	Third person Plural
прогуливаются	Third person Plural
медиками	None
гаремах	None
выведи	Second person Singular
приплываете	Second person Plural
врите	Second person Plural
мешаются	Third person Plural
изгибаешь	Second person Singular
уравновешивают	Third person Plural
подносимый	None
давится	Third person Singular
дружим	First person Plural
проповедуют	Third person Plural
склоняю	First person Singular
изученных	None
наклоняйтесь	Second person Plural
прибивают	Third person Plural
бездействуют	Third person Plural
ханьское	None
подвёрнутый	None
загрязнённый	None
щёлкает	Third person Singular
учтите	Second person Plural
ознакомляет	Third person Singular
эстетическом	None
удались	Second person Singular
школьницей	None
заковывают	Third person Plural
македонский	None
параметров	None
дунем	First person Plural
обобщает	Third person Singular
коринфянине	None
лопай	Second person Singular
предрекая	None
плачь	Second person Singular
посмеялась	None
рулит	Third person Singular
заговариваюсь	First person Singular
адаптируют	Third person Plural
раскроет	Third person Singular
стряхиваю	First person Singular
остригает	Third person Singular
высокоточных	None
сжимается	Third person Singular
стрессовую	None
предвидятся	Third person Plural
прижимаются	Third person Plural
запасу	First person Singular
вырубает	Third person Singular
вставляют	Third person Plural
акцентируют	Third person Plural
повреждают	Third person Plural
подчиняемся	First person Plural
кормушек	None
воздели	None
распространятся	Third person Plural
хлестка	None
стихийного	None
златопёром	None
набегут	Third person Plural
насаждает	Third person Singular
литую	None
апатичную	None
стройная	None
поклоняются	Third person Plural
облегает	Third person Singular
простреливают	Third person Plural
подводят	Third person Plural
фотографируется	Third person Singular
замахиваюсь	First person Singular
зальет	Third person Singular
нахождения	None
экипажа	None
дорастает	Third person Singular
опечалившись	None
приберут	Third person Plural
распространяющийся	None
затрагиваются	Third person Plural
отнесут	Third person Plural
приравняешь	Second person Singular
накладывает	Third person Singular
коснется	Third person Singular
сердит	Third person Singular
сцепляйте	Second person Plural
усматриваете	Second person Plural
проплывает	Third person Singular
набрось	Second person Singular
переставлю	First person Singular
кормлю	First person Singular
рассеются	Third person Plural
вынесите	Second person Plural
растягивается	Third person Singular
буксует	Third person Singular
холим	First person Plural
обустройством	None
ворвутся	Third person Plural
заменяйся	Second person Singular
волокут	Third person Plural
протестую	First person Singular
дирижируют	Third person Plural
ацетилена	None
изготовлюсь	First person Singular
майте	Second person Plural
ингибитором	None
вакцинировать	None
упорядочивай	Second person Singular
подвергаете	Second person Plural
проскользнем	First person Plural
понаблюдаю	First person Singular
местечками	None
срастается	Third person Singular
запрячь	Second person Singular
зубчатое	None
ослабляет	Third person Singular
кончился	None
утрирую	First person Singular
задыхается	Third person Singular
попали	Second person Singular
желтеет	Third person Singular
унимаются	Third person Plural
срослось	None
полированные	None
расставлю	First person Singular
поднимают	Third person Plural
вдовам	None
догорает	Third person Singular
скоморох	None
пугает	Third person Singular
отгрузил	None
аптеке	None
человечек	None
соблазнит	Third person Singular
имитирует	Third person Singular
претит	Third person Singular
подгоняйте	Second person Plural
зачёркивает	Third person Singular
судейский	None
гуляет	Third person Singular
научит	Third person Singular
переделайте	Second person Plural
балансируют	Third person Plural
формулирую	First person Singular
испаряются	Third person Plural
опустошает	Third person Singular
высадится	Third person Singular
экземпляре	None
укусит	Third person Singular
публикую	First person Singular
боязливыми	None
осаждают	Third person Plural
нервным	None
съязвим	First person Plural
откровении	None
цитируют	Third person Plural
прозревают	Third person Plural
раскроют	Third person Plural
распахнусь	First person Singular
запасается	Third person Singular
увянь	Second person Singular
идите	Second person Plural
пристреливают	Third person Plural
ткните	Second person Plural
сгорают	Third person Plural
даётся	Third person Singular
бытовала	None
увязли	None
натянут	Third person Plural
сочтете	Second person Plural
лезут	Third person Plural
уважением	None
устареваешь	Second person Singular
громят	Third person Plural
активизируется	Third person Singular
спрашиваешь	Second person Singular
три	Second person Singular
устраиваются	Third person Plural
выключавший	None
мотыжьте	Second person Plural
заснежённом	None
подыгрывает	Third person Singular
огрызут	Third person Plural
напирают	Third person Plural
взгляну	First person Singular
хачкарах	None
колбас	None
дискутирует	Third person Singular
тусуются	Third person Plural
работодателям	None
порнографические	None
формулируйте	Second person Plural
басим	First person Plural
покрывается	Third person Singular
разукрашиваемый	None
кажу	First person Singular
веселей	Second person Singular
шумное	None
отомстят	Third person Plural
подчинюсь	First person Singular
ерошишь	Second person Singular
ликвидируют	Third person Plural
затягиваемся	First person Plural
дразнишь	Second person Singular
обезвреживает	Third person Singular
затеряется	Third person Singular
бессильными	None
подберут	Third person Plural
доползут	Third person Plural
шалей	Second person Singular
простим	First person Plural
генерирует	Third person Singular
рисуете	Second person Plural
рекурсия	None
монетку	None
изымает	Third person Singular
Владиславе	None
бритвы	None
лихорадит	Third person Singular
гоняется	Third person Singular
извещаю	First person Singular
вставляйте	Second person Plural
стягивают	Third person Plural
побуждаемый	None
стихает	Third person Singular
сдвинулась	None
утеряют	Third person Plural
выискивают	Third person Plural
пожалеет	Third person Singular
подсчитывают	Third person Plural
неслыханных	None
слышатся	Third person Plural
порадует	Third person Singular
луковичный	None
встревожьте	Second person Plural
опирается	Third person Singular
приговаривался	None
упорствует	Third person Singular
пересекается	Third person Singular
евразийскому	None
туннели	None
целую	First person Singular
ловлю	First person Singular
разумею	First person Singular
выискивали	None
славится	Third person Singular
хамит	Third person Singular
настрочим	First person Plural
прикрикнешь	Second person Singular
подбирается	Third person Singular
питает	Third person Singular
демонстрируются	Third person Plural
искривит	Third person Singular
обслуживают	Third person Plural
атакуют	Third person Plural
огляжу	First person Singular
пощадишь	Second person Singular
промывает	Third person Singular
публикуем	First person Plural
взглянешь	Second person Singular
испражняется	Third person Singular
вменяем	First person Plural
навевает	Third person Singular
опоясывают	Third person Plural
интернациональные	None
захлёбывается	Third person Singular
улаживает	Third person Singular
оживляйте	Second person Plural
НЭПом	None
исходят	Third person Plural
отмерь	Second person Singular
именуется	Third person Singular
печатавшийся	None
сдвигает	Third person Singular
горячи	Second person Singular
близится	Third person Singular
серебрят	Third person Plural
выстраивает	Third person Singular
загребай	Second person Singular
конторах	None
наполняются	Third person Plural
злятся	Third person Plural
кровоточит	Third person Singular
просвечивает	Third person Singular
упомяну	First person Singular
упорствуют	Third person Plural
выведу	First person Singular
поникают	Third person Plural
завладеет	Third person Singular
обустройство	None
сдавливают	Third person Plural
опасностью	None
добавляется	Third person Singular
мигрантом	None
ставится	Third person Singular
зарегистрируйте	Second person Plural
ощущаются	Third person Plural
минут	Third person Plural
обличают	Third person Plural
крестит	Third person Singular
заводи	Second person Singular
слетают	Third person Plural
опознаёт	Third person Singular
заражается	Third person Singular
уполномочиваешь	Second person Singular
кафтаном	None
упрекает	Third person Singular
сталкивает	Third person Singular
продавят	Third person Plural
имитируют	Third person Plural
разложимся	First person Plural
казнят	Third person Plural
пробиваются	Third person Plural
замерзает	Third person Singular
отстраивает	Third person Singular
накладывай	Second person Singular
памятовав	None
посчитаю	First person Singular
осуществится	Third person Singular
досадной	None
запекаюсь	First person Singular
случившихся	None
брезгуем	First person Plural
соседствуют	Third person Plural
разнится	Third person Singular
уродуют	Third person Plural
смиренным	None
разъяснением	None
ужасающим	None
регуляцию	None
необъяснимое	None
кренится	Third person Singular
стерегут	Third person Plural
рассылают	Third person Plural
хулиганит	Third person Singular
исправлюсь	First person Singular
человеконенавистническом	None
фехтует	Third person Singular
дистрибьютером	None
вспыхивают	Third person Plural
подвергает	Third person Singular
расписывают	Third person Plural
задаются	Third person Plural
летим	First person Plural
влага	None
песчаная	None
выложат	Third person Plural
успокоимся	First person Plural
объективному	None
контролирует	Third person Singular
бесспорно	None
влепляй	Second person Singular
собьются	Third person Plural
наступают	Third person Plural
разливаются	Third person Plural
путаетесь	Second person Plural
набитого	None
ассоциативный	None
каютах	None
закрывается	Third person Singular
свистит	Third person Singular
выступаете	Second person Plural
скромность	None
распарываю	First person Singular
воспроизведет	Third person Singular
стригут	Third person Plural
заменяется	Third person Singular
чередуйтесь	Second person Plural
миротворческая	None
комфортов	None
приложу	First person Singular
исповедуется	Third person Singular
царю	First person Singular
подумывает	Third person Singular
вершит	Third person Singular
мучаются	Third person Plural
прицельный	None
проваливаю	First person Singular
переселишь	Second person Singular
яри	Second person Singular
захлопнувшийся	None
караваны	None
попугаем	First person Plural
взламывают	Third person Plural
безлюдной	None
сотвори	Second person Singular
обзывают	Third person Plural
пуповины	None
деверя	None
угомонится	Third person Singular
уверим	First person Plural
подмени	Second person Singular
сторожат	Third person Plural
выключает	Third person Singular
ровесником	None
снимается	Third person Singular
бургомистров	None
неоспоримые	None
блокирует	Third person Singular
углубляется	Third person Singular
сочувствую	First person Singular
угольщиком	None
шекель	None
пропитывает	Third person Singular
соотечественнику	None
винит	Third person Singular
хромает	Third person Singular
поправится	Third person Singular
ужасный	None
бельгийском	None
рухну	First person Singular
дружит	Third person Singular
очисти	Second person Singular
гадкий	None
повоженный	None
содомизирую	First person Singular
чаем	First person Plural
баженовскими	None
шлепну	First person Singular
убеждены	None
провоцирую	First person Singular
грабарь	None
отзываются	Third person Plural
удовольствия	None
смыслит	Third person Singular
плетёт	Third person Singular
месторождения	None
усугубит	Third person Singular
приложится	Third person Singular
отстраивают	Third person Plural
ковбоя	None
укрывает	Third person Singular
ценятся	Third person Plural
прослеживает	Third person Singular
запишется	Third person Singular
расширенную	None
холестеринов	None
всероссийском	None
взаимодействует	Third person Singular
квазаров	None
узорах	None
вылавливает	Third person Singular
анализирует	Third person Singular
насторожишь	Second person Singular
вопят	Third person Plural
вкладываем	First person Plural
расспрашивает	Third person Singular
спорим	First person Plural
вепсская	None
снизойду	First person Singular
вмешается	Third person Singular
погляди	Second person Singular
настоятеле	None
отвернув	None
пробираются	Third person Plural
толки	Second person Singular
облагаются	Third person Plural
оглашают	Third person Plural
сольются	Third person Plural
формируются	Third person Plural
посчиталось	None
обогащаются	Third person Plural
катятся	Third person Plural
бородач	None
катают	Third person Plural
пробурчит	Third person Singular
дискутируйте	Second person Plural
ткачом	None
импортируют	Third person Plural
условимся	First person Plural
настораживают	Third person Plural
воздерживается	Third person Singular
объехал	None
предок	None
зачисляет	Third person Singular
активизируются	Third person Plural
достроят	Third person Plural
создаются	Third person Plural
уличи	Second person Singular
приватизируйте	Second person Plural
закончилось	None
отмечусь	First person Singular
жатвы	None
понеслись	None
вырабатываются	Third person Plural
дорабатываете	Second person Plural
восторженные	None
ропщешь	Second person Singular
привяжем	First person Plural
скользят	Third person Plural
пробегу	First person Singular
вычищаю	First person Singular
набросят	Third person Plural
поступай	Second person Singular
кораблекрушения	None
налагает	Third person Singular
развлекателен	None
окатит	Third person Singular
беспорядке	None
хуячите	Second person Plural
опрокиньтесь	Second person Plural
работай	Second person Singular
крыше	None
расследуют	Third person Plural
заколачиваю	First person Singular
нагоняет	Third person Singular
земледельческой	None
промывают	Third person Plural
обзывает	Third person Singular
ругается	Third person Singular
смешавшееся	None
кресло	None
наделяют	Third person Plural
клубится	Third person Singular
пойте	Second person Plural
раздвигает	Third person Singular
разумеют	Third person Plural
коменданта	None
затронут	Third person Plural
назреваете	Second person Plural
опроси	Second person Singular
тормозят	Third person Plural
проиллюстрирует	Third person Singular
искореним	First person Plural
психологической	None
выворачивают	Third person Plural
отсылаю	First person Singular
закрепляет	Third person Singular
неустойчивости	None
хохочет	Third person Singular
встряхивайте	Second person Plural
считывают	Third person Plural
прямоугольной	None
оправляемый	None
обереги	Second person Singular
заговаривает	Third person Singular
раскалывайте	Second person Plural
закончиться	None
невиданное	None
утихнет	Third person Singular
берусь	First person Singular
влюбляет	Third person Singular
включится	Third person Singular
засветится	Third person Singular
последуешь	Second person Singular
катает	Third person Singular
выезжают	Third person Plural
повелеваю	First person Singular
перевязываете	Second person Plural
смолкнет	Third person Singular
откройся	Second person Singular
католическому	None
султанату	None
складывают	Third person Plural
создатель	None
сервисам	None
спину	None
ржу	First person Singular
опережают	Third person Plural
ошеломляет	Third person Singular
завознях	None
выкладываю	First person Singular
неизрекомым	None
пробивает	Third person Singular
выпасаю	First person Singular
возносят	Third person Plural
прислушиваюсь	First person Singular
перекрывает	Third person Singular
препятствуете	Second person Plural
дорабатывают	Third person Plural
разбазариваем	First person Plural
помолись	Second person Singular
преподнесет	Third person Singular
застрянете	Second person Plural
обогну	First person Singular
обозначьтесь	Second person Plural
прижимает	Third person Singular
бомбардируешь	Second person Singular
выдаёт	Third person Singular
мучит	Third person Singular
убывают	Third person Plural
отличу	First person Singular
обязывается	Third person Singular
расти	Second person Singular
перетаскивает	Third person Singular
рекламируем	First person Plural
допоем	First person Plural
уменьшаемого	None
навязывайте	Second person Plural
шагали	None
степенным	None
оглашает	Third person Singular
всемерно	None
койкой	None
тепловатыми	None
дочитаю	First person Singular
ночуют	Third person Plural
тиснула	None
кричит	Third person Singular
помещаем	First person Plural
уместится	Third person Singular
подразделяются	Third person Plural
исправятся	Third person Plural
заготавливают	Third person Plural
отвлечение	None
неуловима	None
отыщутся	Third person Plural
коммуникативно	None
приземляется	Third person Singular
талмуды	None
сохранялись	None
закрепляют	Third person Plural
дрожи	Second person Singular
отпугнула	None
огород	None
затягивает	Third person Singular
зависимы	None
надпилу	None
смещаются	Third person Plural
списывает	Third person Singular
избивают	Third person Plural
выгорает	Third person Singular
занеси	Second person Singular
вышибает	Third person Singular
светлеет	Third person Singular
занижают	Third person Plural
отдачей	None
слипаются	Third person Plural
спешка	None
пересаживает	Third person Singular
перескажите	Second person Plural
оспорят	Third person Plural
приступают	Third person Plural
удостаивает	Third person Singular
недооцениваете	Second person Plural
превалируют	Third person Plural
выходным	None
припрятываете	Second person Plural
насыпь	Second person Singular
программируют	Third person Plural
перенимаем	First person Plural
откликаются	Third person Plural
воспроизводят	Third person Plural
бунтуйтесь	Second person Plural
сливает	Third person Singular
замораживают	Third person Plural
оробей	Second person Singular
учиняет	Third person Singular
обучатся	Third person Plural
маши	Second person Singular
максимальное	None
подчёркиваются	Third person Plural
перевозчиках	None
освещаются	Third person Plural
поджигают	Third person Plural
снесем	First person Plural
освещённостью	None
смелем	First person Plural
презумпциям	None
пропитаюсь	First person Singular
преувеличивает	Third person Singular
токийке	None
соблюдаются	Third person Plural
сравнятся	Third person Plural
осваивающий	None
сравняются	Third person Plural
промышляли	None
заебетесь	Second person Plural
пораженца	None
перекидывало	None
набросаю	First person Singular
мчится	Third person Singular
белеют	Third person Plural
вьются	Third person Plural
удваивает	Third person Singular
превзойдет	Third person Singular
окутывайте	Second person Plural
тяготит	Third person Singular
зажигается	Third person Singular
очерчивают	Third person Plural
платим	First person Plural
воображаемое	None
озабочивает	Third person Singular
побеспокоишь	Second person Singular
изволь	Second person Singular
бронепоездов	None
заготовляют	Third person Plural
мирятся	Third person Plural
аккомпанируют	Third person Plural
растягиваешься	Second person Singular
переработайте	Second person Plural
ясновидящем	None
всемирную	None
смирной	None
оплакивает	Third person Singular
застреливает	Third person Singular
сгоняет	Third person Singular
соперничаю	First person Singular
приучают	Third person Plural
рекомендуемся	First person Plural
виноторговцем	None
овальный	None
подножек	None
излучают	Third person Plural
поражаются	Third person Plural
ухмыляется	Third person Singular
альтруистическому	None
фонарей	Second person Singular
вершат	Third person Plural
сенатского	None
различениях	None
тренируем	First person Plural
общепринятому	None
отождествляете	Second person Plural
суну	First person Singular
грянет	Third person Singular
ваз	None
клюёт	Third person Singular
истреплю	First person Singular
загрязняют	Third person Plural
изумляем	First person Plural
штемпель	None
утоляет	Third person Singular
примиряется	Third person Singular
цитируется	Third person Singular
формулируете	Second person Plural
удостоверится	Third person Singular
сочетать	None
вечна	None
заполняются	Third person Plural
орудуют	Third person Plural
лева	None
анализирующий	None
удивлюсь	First person Singular
инфицируете	Second person Plural
подстрекнешь	Second person Singular
афтозную	None
бледнеет	Third person Singular
рекорда	None
раскрашивают	Third person Plural
химика	None
церебральные	None
остановятся	Third person Plural
поройтесь	Second person Plural
путаются	Third person Plural
предпочту	First person Singular
неприемлемая	None
вскрывают	Third person Plural
аргументов	None
крушит	Third person Singular
неверующие	None
заскакивайте	Second person Plural
увлажнил	None
удочеряет	Third person Singular
обновляется	Third person Singular
небезопасные	None
неотложку	None
преступник	None
грядой	None
мещанская	None
нежных	None
режимах	None
спасется	Third person Singular
хвораю	First person Singular
выяснимся	First person Plural
ступенчат	None
подсовывают	Third person Plural
укорачивают	Third person Plural
редеет	Third person Singular
трубопроводным	None
живём	First person Plural
подослали	None
разукрашиваем	First person Plural
идём	First person Plural
забираются	Third person Plural
мучения	None
пикселями	None
разъясняют	Third person Plural
многодетные	None
отклоняется	Third person Singular
представляемся	First person Plural
освещённостей	None
роднимый	None
кланяется	Third person Singular
познаёте	Second person Plural
катя	None
перешлите	Second person Plural
разгуливаю	First person Singular
упоминается	Third person Singular
отлетают	Third person Plural
наркоманки	None
славься	Second person Singular
очевидно	None
позаботятся	Third person Plural
заразило	None
документе	None
вовлекаю	First person Singular
хохочут	Third person Plural
националистический	None
развешивает	Third person Singular
платятся	Third person Plural
гуманным	None
настигают	Third person Plural
щёлкни	Second person Singular
доверься	Second person Singular
сковывает	Third person Singular
поразительными	None
целуется	Third person Singular
выжигают	Third person Plural
кате	None
первоначального	None
ловят	Third person Plural
чисти	Second person Singular
заплатой	None
забредает	Third person Singular
кудрявом	None
компрометируют	Third person Plural
зарегистрируют	Third person Plural
судьями	None
гогочем	First person Plural
построишь	Second person Singular
обращал	None
словацкую	None
заигрывает	Third person Singular
предписать	None
проголосуете	Second person Plural
греется	Third person Singular
медали	None
дёргаемся	First person Plural
преступает	Third person Singular
оконном	None
денешься	Second person Singular
телезрители	None
подтягивается	Third person Singular
рассудят	Third person Plural
угощайся	Second person Singular
анализируете	Second person Plural
запущенного	None
подводишь	Second person Singular
остерегла	None
выталкивают	Third person Plural
скачет	Third person Singular
изымают	Third person Plural
нарекает	Third person Singular
вундеркинда	None
затянется	Third person Singular
припоминает	Third person Singular
карманная	None
доплывете	Second person Plural
кидается	Third person Singular
подкупаю	First person Singular
вытирает	Third person Singular
вернете	Second person Plural
ссылайтесь	Second person Plural
присвою	First person Singular
трамплинами	None
покаетесь	Second person Plural
проистекают	Third person Plural
затекаю	First person Singular
восточноевропейском	None
доживает	Third person Singular
бронировано	None
районированием	None
вынуждает	Third person Singular
старт	None
срубает	Third person Singular
нюхает	Third person Singular
гранитной	None
поклонятся	Third person Plural
учитывают	Third person Plural
теснит	Third person Singular
расшифруйте	Second person Plural
пируют	Third person Plural
брызгает	Third person Singular
ветфельдшерами	None
выкладываются	Third person Plural
пеночка-теньковка	None
характеризуются	Third person Plural
гонятся	Third person Plural
проломленный	None
упоминает	Third person Singular
определятся	Third person Plural
прикрепляют	Third person Plural
откликнитесь	Second person Plural
катись	Second person Singular
одноглазого	None
лезем	First person Plural
отошли	Second person Singular
безудержно	None
прыжку	None
фиксируют	Third person Plural
постановляю	First person Singular
напускает	Third person Singular
осеняем	First person Plural
подведомственными	None
расцениваю	First person Singular
сливаетесь	Second person Plural
поглядим	First person Plural
пробуждай	Second person Singular
подбираем	First person Plural
зрительский	None
убедила	None
перекати	Second person Singular
обуздываем	First person Plural
благослови	Second person Singular
поработаю	First person Singular
запутывает	Third person Singular
овощем	None
насмехался	None
плюнь	Second person Singular
вставляем	First person Plural
добываются	Third person Plural
повреждает	Third person Singular
гидравликой	None
спросился	None
лезь	Second person Singular
зальешь	Second person Singular
льстила	None
статуй	None
вензаболеваниям	None
покрываются	Third person Plural
ночует	Third person Singular
примолк	None
отсекаешь	Second person Singular
сушатся	Third person Plural
теснят	Third person Plural
высушенный	None
растопыришь	Second person Singular
беговых	None
светлым	None
повинуйтесь	Second person Plural
верю	First person Singular
перистую	None
разочаровываются	Third person Plural
реально	None
достраивавшись	None
подменяете	Second person Plural
оплодотворяют	Third person Plural
опутываем	First person Plural
колыбельной	None
поправляют	Third person Plural
тяжёлого	None
шагай	Second person Singular
загрохочи	Second person Singular
трёхэтажным	None
помахиваем	First person Plural
полыхает	Third person Singular
ратифицирует	Third person Singular
эллипсов	None
прикинуть	None
капризничаешь	Second person Singular
протаскивает	Third person Singular
юлить	None
умалчиваем	First person Plural
реклам	None
подгоняет	Third person Singular
езидам	None
штепсель	None
смеет	Third person Singular
заношу	First person Singular
проигнорируют	Third person Plural
перекрещиваться	None
умоляют	Third person Plural
скитаются	Third person Plural
высвобождают	Third person Plural
страшится	Third person Singular
коробе	None
залетай	Second person Singular
облетавший	None
врут	Third person Plural
мышеловка	None
занимательный	None
переработаю	First person Singular
вписывайте	Second person Plural
протирают	Third person Plural
весовом	None
кивнешь	Second person Singular
абразивной	None
матери	Second person Singular
непростительные	None
толкует	Third person Singular
разрастись	Second person Singular
яйцеклетке	None
флиртует	Third person Singular
повенчай	Second person Singular
гаснет	Third person Singular
прысните	Second person Plural
складывает	Third person Singular
побаивается	Third person Singular
минируем	First person Plural
оживляет	Third person Singular
розовеете	Second person Plural
именуем	First person Plural
схватит	Third person Singular
прикладываемся	First person Plural
клонит	Third person Singular
транслитерирует	Third person Singular
просторных	None
впиваются	Third person Plural
хэше	None
плачешь	Second person Singular
приоткрывает	Third person Singular
нагоняют	Third person Plural
побудит	Third person Singular
слабеют	Third person Plural
распрямляется	Third person Singular
розоватых	None
отравляет	Third person Singular
берутся	Third person Plural
присягает	Third person Singular
работаешь	Second person Singular
задумывают	Third person Plural
ориентируемся	First person Plural
прибавляет	Third person Singular
раскалывает	Third person Singular
выхватим	First person Plural
приживаемся	First person Plural
выдёргивает	Third person Singular
лазает	Third person Singular
бронному	None
пристраивают	Third person Plural
разраститесь	Second person Plural
полоний	None
умолкает	Third person Singular
сравнительное	None
подверну	First person Singular
гениальное	None
корит	Third person Singular
яви	Second person Singular
осложняется	Third person Singular
сепаратистов	None
непривычное	None
созывает	Third person Singular
водружу	First person Singular
остережетесь	Second person Plural
обезвреживая	None
выскальзываем	First person Plural
форсируют	Third person Plural
зажигалок	None
безалкогольный	None
бородавки	None
выставляю	First person Singular
начнусь	First person Singular
шути	Second person Singular
щелкнет	Third person Singular
правительственному	None
сосуществуют	Third person Plural
перерастут	Third person Plural
проделывают	Third person Plural
балтийскую	None
одаривает	Third person Singular
ломаной	None
страхую	First person Singular
приедешь	Second person Singular
выработает	Third person Singular
тамбовской	None
перечисляем	First person Plural
наблюдениям	None
взойдет	Third person Singular
откапывай	Second person Singular
реализуется	Third person Singular
катят	Third person Plural
революционерах	None
консолидированным	None
гаркну	First person Singular
раздувают	Third person Plural
заноют	Third person Plural
надувных	None
гремели	None
шагаем	First person Plural
мыслительного	None
рукополагает	Third person Singular
властвует	Third person Singular
подплывают	Third person Plural
замедляет	Third person Singular
дублирует	Third person Singular
траурного	None
заподозрят	Third person Plural
скачивайте	Second person Plural
горит	Third person Singular
переоценивают	Third person Plural
танцуйте	Second person Plural
греши	Second person Singular
разыгрываются	Third person Plural
раскаиваюсь	First person Singular
выступаешь	Second person Singular
обогревают	Third person Plural
абулия	None
шатается	Third person Singular
рекламируют	Third person Plural
крепнут	Third person Plural
погостит	Third person Singular
самоуверенный	None
пропажей	None
вымираете	Second person Plural
кажет	Third person Singular
губернии	None
изобретают	Third person Plural
стрельнут	Third person Plural
словенки	None
стреляем	First person Plural
уничтожаются	Third person Plural
живёшь	Second person Singular
дополнение	None
доверяется	Third person Singular
жаловать	None
сидром	None
перечислим	First person Plural
штурмуют	Third person Plural
прозвенят	Third person Plural
громит	Third person Singular
придушат	Third person Plural
стерильное	None
постанавливаешь	Second person Singular
продемонстрируйте	Second person Plural
скапливаются	Third person Plural
захватывает	Third person Singular
вторгается	Third person Singular
взлететь	None
отпугивая	None
обяжет	Third person Singular
сравнивается	Third person Singular
обобщённому	None
несогласиям	None
обвяжешь	Second person Singular
перегнись	Second person Singular
фауной	None
развозит	Third person Singular
граничат	Third person Plural
оступается	Third person Singular
лесбийские	None
обломке	None
рекурсиях	None
насыпаешь	Second person Singular
заканчивается	Third person Singular
удивляйтесь	Second person Plural
стандартизирует	Third person Singular
воздержатся	Third person Plural
присвоит	Third person Singular
генитальная	None
давки	None
сочинял	None
уверую	First person Singular
запоминаются	Third person Plural
профсоюзе	None
чеканят	Third person Plural
встречаюсь	First person Singular
ленинградскими	None
выступаю	First person Singular
поболтав	None
пучка	None
трестами	None
повторяются	Third person Plural
брачное	None
разгружают	Third person Plural
настрочивший	None
мешаете	Second person Plural
невиданны	None
хмурые	None
импровизацию	None
сбудется	Third person Singular
печатаются	Third person Plural
просветлённый	None
выстрелит	Third person Singular
лавинами	None
прокладывает	Third person Singular
светится	Third person Singular
принимайся	Second person Singular
досаждают	Third person Plural
дочитает	Third person Singular
побудь	Second person Singular
разворачивает	Third person Singular
задвинешь	Second person Singular
зацепится	Third person Singular
комбинируют	Third person Plural
бугры	None
прибирает	Third person Singular
таятся	Third person Plural
расспроси	Second person Singular
отстоим	First person Plural
затеряет	Third person Singular
саженцами	None
подталкивают	Third person Plural
цитируйте	Second person Plural
крадёт	Third person Singular
баклажаны	None
кастрюльками	None
гадаем	First person Plural
сформулирую	First person Singular
отрастает	Third person Singular
оссуарий	None
подкрадывается	Third person Singular
соединяйтесь	Second person Plural
дробит	Third person Singular
гигроскопичные	None
приволоки	Second person Singular
томится	Third person Singular
иссякнет	Third person Singular
увеличивалось	None
скажете	Second person Plural
раскачивает	Third person Singular
трансформировал	None
отброшу	First person Singular
пробудись	Second person Singular
антропохория	None
доносчиком	None
валимся	First person Plural
загрязняет	Third person Singular
загибается	Third person Singular
готовит	Third person Singular
риск	None
заплыви	Second person Singular
предпочтет	Third person Singular
притягивают	Third person Plural
обзывать	None
издевается	Third person Singular
обновляю	First person Singular
смешиваются	Third person Plural
голосуй	Second person Singular
подвергаю	First person Singular
запрещается	Third person Singular
пополнится	Third person Singular
заканчиваются	Third person Plural
отправлениях	None
склоняются	Third person Plural
жаркому	None
вешаются	Third person Plural
пробивал	None
упаковывают	Third person Plural
блистают	Third person Plural
взыщите	Second person Plural
высушивают	Third person Plural
выскальзывай	Second person Singular
прокатывается	Third person Singular
прижмись	Second person Singular
лаптя	None
райкомом	None
русифицируются	Third person Plural
малороссиянин	None
портативным	None
переодевают	Third person Plural
причешу	First person Singular
повстречайся	Second person Singular
абалону	None
взглянул	None
сгодятся	Third person Plural
стибиумом	None
глохнет	Third person Singular
подставит	Third person Singular
крякает	Third person Singular
слушает	Third person Singular
опознает	Third person Singular
вздумается	Third person Singular
влетает	Third person Singular
голубятню	None
паши	Second person Singular
косынок	None
усматриваемый	None
развлекают	Third person Plural
бунтованный	None
припрячут	Third person Plural
витает	Third person Singular
обморок	None
почерпнут	Third person Plural
плетётся	Third person Singular
подвергают	Third person Plural
поживаешь	Second person Singular
похвалит	Third person Singular
тулупе	None
подтверждается	Third person Singular
императоров	None
ровесница	None
желатином	None
цитируем	First person Plural
чеканим	First person Plural
стриги	Second person Singular
унывает	Third person Singular
покатит	Third person Singular
архипелаги	None
выравнивают	Third person Plural
угадывают	Third person Plural
установится	Third person Singular
удобоваримом	None
расцветают	Third person Plural
роднит	Third person Singular
кнопок	None
надстройках	None
стипендии	None
сковывавший	None
надвигается	Third person Singular
мастерит	Third person Singular
развернутся	Third person Plural
подстрели	Second person Singular
хлопотное	None
кодирует	Third person Singular
посветлейте	Second person Plural
простят	Third person Plural
сравняется	Third person Singular
тестирует	Third person Singular
весят	Third person Plural
скопируйте	Second person Plural
спихивают	Third person Plural
исполняются	Third person Plural
сбросит	Third person Singular
смущало	None
сотрясается	Third person Singular
питают	Third person Plural
контролируются	Third person Plural
выплёскивает	Third person Singular
проследует	Third person Singular
разлагается	Third person Singular
папахи	None
равняйся	Second person Singular
запекайтесь	Second person Plural
манят	Third person Plural
увернется	Third person Singular
идёт	Third person Singular
растаскивают	Third person Plural
присвистываете	Second person Plural
запаздывают	Third person Plural
флигелями	None
выстрели	Second person Singular
варьируете	Second person Plural
брокеру	None
ищите	Second person Plural
разрушатся	Third person Plural
лукавьте	Second person Plural
обосновываемся	First person Plural
заблуждается	Third person Singular
предполагаются	Third person Plural
приберите	Second person Plural
оттащила	None
копируйте	Second person Plural
показываются	Third person Plural
гражданско-правового	None
мешают	Third person Plural
блуждает	Third person Singular
помрите	Second person Plural
заливаем	First person Plural
абрикосом	None
усаживаете	Second person Plural
накалываете	Second person Plural
обнаружится	Third person Singular
крепит	Third person Singular
ознакомлюсь	First person Singular
роняют	Third person Plural
умоляю	First person Singular
сопернице	None
выдыхаю	First person Singular
возложит	Third person Singular
нагружают	Third person Plural
сачок	None
штопал	None
смешиваете	Second person Plural
поработайте	Second person Plural
загляните	Second person Plural
прибавляется	Third person Singular
соприкосновениям	None
отправителем	None
осведомлю	First person Singular
суммируем	First person Plural
раздуются	Third person Plural
засидишься	Second person Singular
наделываю	First person Singular
выложу	First person Singular
модифицируют	Third person Plural
отскачи	Second person Singular
канули	None
оседает	Third person Singular
швартуешь	Second person Singular
встрепенетесь	Second person Plural
ищет	Third person Singular
пережитками	None
обёрнутый	None
зарегистрируетесь	Second person Plural
сражайтесь	Second person Plural
экстремизму	None
развращает	Third person Singular
подговаривает	Third person Singular
вселится	Third person Singular
бяками	None
румынок	None
выбираются	Third person Plural
решится	Third person Singular
прыгающий	None
метрополитене	None
воскресает	Third person Singular
облаках	None
отыщи	Second person Singular
администратором	None
интригах	None
отсылает	Third person Singular
пневмонией	None
абелевых	None
обороняются	Third person Plural
сложившиеся	None
проскочит	Third person Singular
уди	Second person Singular
вычтем	First person Plural
созерцаете	Second person Plural
стреляет	Third person Singular
полистайте	Second person Plural
склоках	None
негласной	None
снимете	Second person Plural
расселяйте	Second person Plural
завлекают	Third person Plural
христианку	None
закладываешься	Second person Singular
злится	Third person Singular
фиксирую	First person Singular
попугавший	None
вписывают	Third person Plural
нарушается	Third person Singular
базируются	Third person Plural
запущены	None
одаряет	Third person Singular
одаряйте	Second person Plural
достанутся	Third person Plural
демонстративные	None
расплавляет	Third person Singular
разнимаешь	Second person Singular
обделяет	Third person Singular
обрывает	Third person Singular
веселит	Third person Singular
отделаешься	Second person Singular
отлучает	Third person Singular
нагрузкам	None
межэтнической	None
играется	Third person Singular
отшвырнете	Second person Plural
обводит	Third person Singular
вложит	Third person Singular
выломлю	First person Singular
влечёт	Third person Singular
сражает	Third person Singular
торчит	Third person Singular
отъезжает	Third person Singular
побоится	Third person Singular
трудолюбивого	None
выводится	Third person Singular
миномётам	None
аргументированиями	None
вулканолога	None
населяете	Second person Plural
оборонительная	None
оводу	None
модно	None
ездим	First person Plural
обрядов	None
нагибаюсь	First person Singular
командуете	Second person Plural
недолюбливают	Third person Plural
отстраивается	Third person Singular
региональные	None
грядёт	Third person Singular
нажимаем	First person Plural
хромым	None
слоняется	Third person Singular
перекидывают	Third person Plural
озлобляют	Third person Plural
шутит	Third person Singular
высокопоставленному	None
умалчивает	Third person Singular
смотрит	Third person Singular
повинуется	Third person Singular
долу	None
долетает	Third person Singular
подвешивает	Third person Singular
дозволяешь	Second person Singular
выдвигаем	First person Plural
тружусь	First person Singular
экспериментирует	Third person Singular
сгрудишься	Second person Singular
подменяйте	Second person Plural
дурам	None
нащупывает	Third person Singular
выводятся	Third person Plural
агитации	None
обретаются	Third person Plural
назначается	Third person Singular
стырь	Second person Singular
нагнетает	Third person Singular
откладывается	Third person Singular
почт	None
проголосуем	First person Plural
шагаю	First person Singular
ошеломляемый	None
заполняется	Third person Singular
ухмыльнетесь	Second person Plural
правнуках	None
проконтролируй	Second person Singular
увлажняют	Third person Plural
штурмует	Third person Singular
вставьте	Second person Plural
искривляю	First person Singular
переворачиваются	Third person Plural
импонируют	Third person Plural
академикам	None
остынет	Third person Singular
изнемогли	None
спасаются	Third person Plural
синтезирует	Third person Singular
раскидывает	Third person Singular
родин	None
надстраивающийся	None
оздорови	Second person Singular
гражданско-правовом	None
прилагаешься	Second person Singular
выцветает	Third person Singular
заворачивает	Third person Singular
личном	None
предостерегаю	First person Singular
отвратят	Third person Plural
ройте	Second person Plural
удивительных	None
затевают	Third person Plural
сосредоточится	Third person Singular
записывается	Third person Singular
огорчу	First person Singular
прикинетесь	Second person Plural
истребляет	Third person Singular
зарубежьем	None
явственных	None
реализовывает	Third person Singular
лупи	Second person Singular
полыхнул	None
подкупают	Third person Plural
отгоняют	Third person Plural
вынудят	Third person Plural
смыкается	Third person Singular
кинематографистом	None
схватывают	Third person Plural
оснащает	Third person Singular
регламентирует	Third person Singular
выплывает	Third person Singular
исходит	Third person Singular
мается	Third person Singular
порочит	Third person Singular
швыряет	Third person Singular
позитив	None
едкий	None
проведают	Third person Plural
грозится	Third person Singular
подбираются	Third person Plural
глянцевым	None
поддаются	Third person Plural
излечить	None
практикуются	Third person Plural
прилегающего	None
распирает	Third person Singular
забейте	Second person Plural
очищаются	Third person Plural
радиационные	None
толкает	Third person Singular
единичные	None
ассистируй	Second person Singular
усыпляет	Third person Singular
выдадим	First person Plural
возлагаются	Third person Plural
стелы	None
озвучу	First person Singular
присудишь	Second person Singular
поётся	Third person Singular
жрецу	None
улаживая	None
задаюсь	First person Singular
самокритике	None
подправил	None
перекатишься	Second person Singular
ловкостью	None
контузим	First person Plural
суживается	Third person Singular
разумением	None
ношусь	First person Singular
рулят	Third person Plural
компенсируют	Third person Plural
цитирую	First person Singular
нагоняй	Second person Singular
отклоняем	First person Plural
способностями	None
фонологией	None
скажешь	Second person Singular
генов	None
пляшут	Third person Plural
обезвредил	None
ценю	First person Singular
перерасти	Second person Singular
лесорубам	None
технолога	None
покончить	None
оспаривайте	Second person Plural
обуславливает	Third person Singular
пациента	None
выпячивает	Third person Singular
мерю	First person Singular
дробят	Third person Plural
выводят	Third person Plural
хороним	First person Plural
говорится	Third person Singular
свёртков	None
осуществляются	Third person Plural
своротим	First person Plural
поместим	First person Plural
разыскивающий	None
правит	Third person Singular
виню	First person Singular
высказываюсь	First person Singular
влипший	None
расправляет	Third person Singular
вбегает	Third person Singular
цепляет	Third person Singular
надели	Second person Singular
скульптурную	None
предотвратит	Third person Singular
сознается	Third person Singular
афазиям	None
утрачивает	Third person Singular
сдвигается	Third person Singular
кадмия	None
разбавляет	Third person Singular
ухудшит	Third person Singular
плюётся	Third person Singular
бойкотирует	Third person Singular
подпрыгивает	Third person Singular
сними	Second person Singular
отвлекаюсь	First person Singular
заклинаю	First person Singular
однокурсники	None
предпочтут	Third person Plural
утаишь	Second person Singular
тяготеет	Third person Singular
возродит	Third person Singular
расписал	None
различают	Third person Plural
озвучьте	Second person Plural
проговаривает	Third person Singular
перекладывает	Third person Singular
похолодеешь	Second person Singular
особняке	None
оспариваю	First person Singular
разделятся	Third person Plural
санаторием	None
поживаю	First person Singular
нагнетая	None
заволакивают	Third person Plural
запечатлеет	Third person Singular
улавливает	Third person Singular
избавьте	Second person Plural
мелет	Third person Singular
отваливаются	Third person Plural
охранись	Second person Singular
выскажутся	Third person Plural
делайте	Second person Plural
месячной	None
потускнеем	First person Plural
побывают	Third person Plural
тинами	None
отклоняйте	Second person Plural
сожалею	First person Singular
благоустраивались	None
цитируются	Third person Plural
сбежит	Third person Singular
проводится	Third person Singular
врастают	Third person Plural
трубами	None
простит	Third person Singular
файл	None
невыполнимыми	None
добавились	None
цистерну	None
выручит	Third person Singular
выменяв	None
увядают	Third person Plural
матерится	Third person Singular
чешем	First person Plural
загружаю	First person Singular
прославит	Third person Singular
вскакивает	Third person Singular
проанализируйте	Second person Plural
безвизовом	None
рушит	Third person Singular
австралийцами	None
лично	None
застревать	None
примкнут	Third person Plural
взвиваясь	None
кажете	Second person Plural
приостанавливает	Third person Singular
поясни	Second person Singular
капут	None
притроньтесь	Second person Plural
прей	Second person Singular
средства	None
взрывается	Third person Singular
умножьте	Second person Plural
упавших	None
насылает	Third person Singular
свечу	First person Singular
скидка	None
мучают	Third person Plural
вытягивается	Third person Singular
иди	Second person Singular
голодают	Third person Plural
поясню	First person Singular
волынян	None
вынесем	First person Plural
распевайте	Second person Plural
шлёпает	Third person Singular
усложнит	Third person Singular
сшибаю	First person Singular
оповещу	First person Singular
чипсу	None
изобретательной	None
патрулируют	Third person Plural
оттолкнусь	First person Singular
нижнему	None
натирают	Third person Plural
разжигают	Third person Plural
размещаются	Third person Plural
петлям	None
вагоны-рестораны	None
взбирались	None
представьтесь	Second person Plural
светлей	Second person Singular
подгоняют	Third person Plural
наследуют	Third person Plural
потеснившись	None
аэронавигационному	None
разваливается	Third person Singular
профессиональному	None
колдовские	None
помещу	First person Singular
вокала	None
грезьте	Second person Plural
процеживают	Third person Plural
оговаривая	None
вставят	Third person Plural
волокнами	None
пускайся	Second person Singular
закупоривают	Third person Plural
беспокойно	None
исполнятся	Third person Plural
одолеют	Third person Plural
подпирает	Third person Singular
отработавший	None
подводит	Third person Singular
прошедшей	None
оголённые	None
долби	Second person Singular
попортишь	Second person Singular
переключает	Third person Singular
высказываетесь	Second person Plural
обсуждалась	None
исхожу	First person Singular
перевязывает	Third person Singular
посчитайте	Second person Plural
палимпсестов	None
ждём	First person Plural
вертится	Third person Singular
интегрируют	Third person Plural
скиньте	Second person Plural
сознательным	None
порицают	Third person Plural
мелите	Second person Plural
исчерпываемый	None
достанься	Second person Singular
опровергают	Third person Plural
машет	Third person Singular
приковывают	Third person Plural
пройдись	Second person Singular
звёздочка	None
сболтни	Second person Singular
изоляций	None
брось	Second person Singular
издания	None
отменяется	Third person Singular
озаботится	Third person Singular
сочту	First person Singular
создайся	Second person Singular
усаживают	Third person Plural
пускается	Third person Singular
приложат	Third person Plural
побредете	Second person Plural
двоим	First person Plural
уной	Second person Singular
предместьях	None
умещается	Third person Singular
торцом	None
дуй	Second person Singular
держись	Second person Singular
подаётся	Third person Singular
запечатлевает	Third person Singular
сорю	First person Singular
промах	None
общий	None
горшки	None
оспорьте	Second person Plural
отодвигаются	Third person Plural
водохранилищ	None
откусывает	Third person Singular
рождают	Third person Plural
обителью	None
новозеландским	None
прилепляем	First person Plural
вынь	Second person Singular
оскорбляют	Third person Plural
похмелья	None
токарю	None
небесная	None
спрашиваем	First person Plural
мальчишками	None
босанской	None
крени	Second person Singular
благословляют	Third person Plural
оседают	Third person Plural
вымывает	Third person Singular
погляжу	First person Singular
октябрьскую	None
марсели	None
маршрутизаторам	None
прикроет	Third person Singular
поручусь	First person Singular
взорвутся	Third person Plural
восходит	Third person Singular
воспевает	Third person Singular
умножим	First person Plural
узаконила	None
закладках	None
подбираю	First person Singular
компьютеризацию	None
сдадимся	First person Plural
метонимией	None
импортировали	None
ручаетесь	Second person Plural
помрет	Third person Singular
пышными	None
поставляются	Third person Plural
угадываются	Third person Plural
историографиями	None
увозит	Third person Singular
даруют	Third person Plural
розовеет	Third person Singular
филантропом	None
закатайте	Second person Plural
пыхтит	Third person Singular
отталкиваюсь	First person Singular
базирует	Third person Singular
выведет	Third person Singular
думается	Third person Singular
восстанавливается	Third person Singular
поедает	Third person Singular
воткнут	Third person Plural
прорастают	Third person Plural
скручивает	Third person Singular
держу	First person Singular
фосфорные	None
ожидается	Third person Singular
солью	First person Singular
значит	Third person Singular
учитывается	Third person Singular
кидает	Third person Singular
ожидайтесь	Second person Plural
чеканит	Third person Singular
отражают	Third person Plural
вздыхает	Third person Singular
лотке	None
знаменовавший	None
минем	First person Plural
воспроизвожу	First person Singular
шаровые	None
прильните	Second person Plural
закладывают	Third person Plural
надувными	None
здание	None
определится	Third person Singular
организовываются	Third person Plural
иностранка	None
сторонятся	Third person Plural
обретут	Third person Plural
побоюсь	First person Singular
температура	None
путешествует	Third person Singular
выигрышную	None
танцовщица	None
флибустьер	None
кормятся	Third person Plural
опередят	Third person Plural
капелланов	None
жизнеспособного	None
дросселей	None
вдыхает	Third person Singular
переплетает	Third person Singular
минет	Third person Singular
норильская	None
прислушаетесь	Second person Plural
уличное	None
свешивавшись	None
ласкает	Third person Singular
отпирает	Third person Singular
зевает	Third person Singular
дорожу	First person Singular
освещается	Third person Singular
объединится	Third person Singular
заикается	Third person Singular
ловчим	First person Plural
энцефалитов	None
вставит	Third person Singular
почивают	Third person Plural
обматывают	Third person Plural
предпримись	Second person Singular
просвещает	Third person Singular
водолазами	None
ушли	Second person Singular
дей	Second person Singular
отстаивают	Third person Plural
экспедиционным	None
выложит	Third person Singular
калечит	Third person Singular
мерещатся	Third person Plural
концентрируют	Third person Plural
одноногом	None
публицистическими	None
мошенничество	None
расшифровывают	Third person Plural
хвалят	Third person Plural
дури	Second person Singular
отбрасываем	First person Plural
отзываешь	Second person Singular
источает	Third person Singular
зафиксируйте	Second person Plural
проникаются	Third person Plural
вышвыривает	Third person Singular
ольшаники	None
демонстрирует	Third person Singular
обезглавливает	Third person Singular
отбивают	Third person Plural
подпрыгивают	Third person Plural
пеняют	Third person Plural
полуботинки	None
осмелится	Third person Singular
испугаются	Third person Plural
подступил	None
вынашивает	Third person Singular
переполняйте	Second person Plural
сохнешь	Second person Singular
зачеркнем	First person Plural
генерал-полковниками	None
укорачивает	Third person Singular
улучшатся	Third person Plural
поджидает	Third person Singular
вытягивает	Third person Singular
увеличатся	Third person Plural
кровоточат	Third person Plural
бросят	Third person Plural
неприятен	None
картавь	Second person Singular
пушками	None
пришибут	Third person Plural
возимся	First person Plural
владений	None
вурдалака	None
скончается	Third person Singular
клянёмся	First person Plural
вербует	Third person Singular
китолове	None
подводим	First person Plural
получаются	Third person Plural
отягощающий	None
надстроите	Second person Plural
рассеиваются	Third person Plural
раздуюсь	First person Singular
наслаждаемся	First person Plural
вышивает	Third person Singular
прогуляй	Second person Singular
продавщицу	None
набивает	Third person Singular
сближается	Third person Singular
прикасается	Third person Singular
гарантируем	First person Plural
опровергнут	Third person Plural
умудряетесь	Second person Plural
помечает	Third person Singular
выпрошу	First person Singular
присваиваем	First person Plural
бездарное	None
раздразнивает	Third person Singular
возрождает	Third person Singular
глушители	None
увлекись	Second person Singular
плети	Second person Singular
морочьте	Second person Plural
треножься	Second person Singular
шкотов	None
сломается	Third person Singular
славятся	Third person Plural
набеги	Second person Singular
доит	Third person Singular
предотвратили	None
подплывает	Third person Singular
выявит	Third person Singular
святыне	None
порывается	Third person Singular
возвратятся	Third person Plural
прислушиваемся	First person Plural
сливаются	Third person Plural
унеситесь	Second person Plural
отбрасывают	Third person Plural
порядочному	None
отталкивается	Third person Singular
разместится	Third person Singular
предваряет	Third person Singular
благодеяние	None
кислородные	None
вкладывается	Third person Singular
нанимателях	None
увлечемся	First person Plural
трудоёмкости	None
стыдливого	None
выстрелят	Third person Plural
веселятся	Third person Plural
олимпиадах	None
излечивают	Third person Plural
работаете	Second person Plural
адресную	None
предоставится	Third person Singular
авантюристке	None
сузит	Third person Singular
предыдущую	None
трансплантируем	First person Plural
благословит	Third person Singular
наматывают	Third person Plural
засади	Second person Singular
переделаю	First person Singular
воителем	None
зависимых	None
огорчает	Third person Singular
дословные	None
потребуется	Third person Singular
сливаться	None
ищешь	Second person Singular
разлагает	Third person Singular
разгоняют	Third person Plural
выкладывается	Third person Singular
выдам	First person Singular
дотация	None
прозрачность	None
традиционной	None
визирями	None
прыгает	Third person Singular
спадается	Third person Singular
похоронит	Third person Singular
самаритяне	None
противоположными	None
стихают	Third person Plural
разрываются	Third person Plural
вытесняют	Third person Plural
впивается	Third person Singular
хореографии	None
секирами	None
подслушивают	Third person Plural
отвергают	Third person Plural
слушаете	Second person Plural
залетают	Third person Plural
сменяет	Third person Singular
выкладываем	First person Plural
переместив	None
силовые	None
подвозят	Third person Plural
выпрашивает	Third person Singular
парамеций	None
хихикает	Third person Singular
шантажируют	Third person Plural
вернем	First person Plural
переносов	None
вонзает	Third person Singular
простейшему	None
заботят	Third person Plural
фосфорную	None
ожесточай	Second person Singular
теплообменника	None
концерны	None
упорядочивают	Third person Plural
бреет	Third person Singular
приготавливает	Third person Singular
выслушивают	Third person Plural
дополняете	Second person Plural
портятся	Third person Plural
сочиняем	First person Plural
озвучивайте	Second person Plural
производится	Third person Singular
заведение	None
наветы	None
обрекают	Third person Plural
перерывом	None
мечу	First person Singular
ерошите	Second person Plural
уделяю	First person Singular
прозрачностью	None
чередуются	Third person Plural
добавится	Third person Singular
воскреснут	Third person Plural
тапкой	None
посерьёзней	Second person Singular
водокачку	None
снимется	Third person Singular
паровоза	None
рационализм	None
взрослеет	Third person Singular
осядет	Third person Singular
остатку	None
импровизируют	Third person Plural
сознаётся	Third person Singular
угодьем	None
бледнеют	Third person Plural
интерфейсами	None
затруднит	Third person Singular
захватчиками	None
обозначит	Third person Singular
получается	Third person Singular
сбалансированны	None
поправляете	Second person Plural
дисплеем	None
защищаются	Third person Plural
отговаривают	Third person Plural
навешивают	Third person Plural
раскрывается	Third person Singular
путаешь	Second person Singular
растворяемся	First person Plural
родительный	None
принюхиваемся	First person Plural
побаиваются	Third person Plural
бодри	Second person Singular
закодирую	First person Singular
отступаюсь	First person Singular
звенит	Third person Singular
развейте	Second person Plural
беритесь	Second person Plural
копит	Third person Singular
кузнецкого	None
переплетать	None
светятся	Third person Plural
недооценивают	Third person Plural
винодельческих	None
средневековый	None
высохнет	Third person Singular
уговариваемся	First person Plural
потри	Second person Singular
покачиваю	First person Singular
присоединяюсь	First person Singular
вдаются	Third person Plural
прогрессирует	Third person Singular
ознакомили	None
переделает	Third person Singular
заполнится	Third person Singular
княжон	None
меркнут	Third person Plural
очевидцами	None
утрачивают	Third person Plural
предварит	Third person Singular
пугни	Second person Singular
упавшую	None
вырисуй	Second person Singular
очередном	None
подберу	First person Singular
шотландский	None
тащат	Third person Plural
заносит	Third person Singular
подчинимся	First person Plural
картофелины	None
дудках	None
хватаются	Third person Plural
отрубаем	First person Plural
сновидениях	None
инициируйте	Second person Plural
вариантов	None
воздействуя	None
берись	Second person Singular
удержусь	First person Singular
сдавливаешь	Second person Singular
приглядывает	Third person Singular
восседают	Third person Plural
воображает	Third person Singular
реализую	First person Singular
призри	Second person Singular
спрыгиваем	First person Plural
выстаивают	Third person Plural
шпионите	Second person Plural
осветление	None
воззрениями	None
позорно	None
притихните	Second person Plural
выкидывают	Third person Plural
употребляются	Third person Plural
крестьянским	None
обзываете	Second person Plural
стукни	Second person Singular
медлит	Third person Singular
открою	First person Singular
галерее	None
пододвигай	Second person Singular
формирование	None
оскорблении	None
намечают	Third person Plural
вставите	Second person Plural
расшифровывает	Third person Singular
эксплуатируются	Third person Plural
встройся	Second person Singular
лесостепных	None
тормоша	None
неспособного	None
разочарует	Third person Singular
крутые	None
упрашивает	Third person Singular
ушибами	None
вывесишь	Second person Singular
прикасайтесь	Second person Plural
датирует	Third person Singular
рубят	Third person Plural
священников	None
выдвигает	Third person Singular
буксуйте	Second person Plural
всаживает	Third person Singular
закупит	Third person Singular
станется	Third person Singular
воздержится	Third person Singular
заявлениями	None
обязывают	Third person Plural
банкирах	None
содействуют	Third person Plural
опалами	None
лужайки	None
умирает	Third person Singular
облаве	None
перевернут	Third person Plural
причинила	None
повелевают	Third person Plural
утри	Second person Singular
представляется	Third person Singular
дикарей	None
дразнит	Third person Singular
нажимаю	First person Singular
отрицательном	None
выключишь	Second person Singular
подлаживает	Third person Singular
коренастая	None
доживет	Third person Singular
отравляют	Third person Plural
пожимает	Third person Singular
обваливается	Third person Singular
засовывает	Third person Singular
подведем	First person Plural
карманного	None
ванными	None
обижаются	Third person Plural
пластаешь	Second person Singular
высвобождайте	Second person Plural
устройствах	None
согласовывается	Third person Singular
укладываются	Third person Plural
оптимизирует	Third person Singular
ленинце	None
собрат	None
драный	None
сглотнешь	Second person Singular
болтают	Third person Plural
наделяло	None
страничке	None
отодвигают	Third person Plural
гармониками	None
иронизируете	Second person Plural
распишем	First person Plural
развернется	Third person Singular
выплывет	Third person Singular
радую	First person Singular
закалывают	Third person Plural
завершится	Third person Singular
причитается	Third person Singular
мидия	None
тренирует	Third person Singular
ныряя	None
пожирающий	None
темах	None
раскручивают	Third person Plural
стеку	First person Singular
сошлем	First person Plural
запрокидывают	Third person Plural
осекусь	First person Singular
изгоняют	Third person Plural
леки	None
последняя	None
проанализируют	Third person Plural
зажаришь	Second person Singular
пори	Second person Singular
перечисляете	Second person Plural
дельце	None
пожалуй	Second person Singular
подстраивают	Third person Plural
обороняется	Third person Singular
вселяются	Third person Plural
скинут	Third person Plural
угадай	Second person Singular
пусти	Second person Singular
коте	None
обрезывая	None
задумываемся	First person Plural
мани	Second person Singular
ведомственный	None
переключаются	Third person Plural
обвалятся	Third person Plural
навещаете	Second person Plural
получит	Third person Singular
вытащит	Third person Singular
лжёт	Third person Singular
мышиного	None
эрозии	None
графствам	None
рудничное	None
штольню	None
распевают	Third person Plural
жестокую	None
обязывает	Third person Singular
плывут	Third person Plural
отличай	Second person Singular
закладываются	Third person Plural
скворца	None
нацизмом	None
мафией	None
жени	Second person Singular
альфа-спиралям	None
закручивается	Third person Singular
будоражат	Third person Plural
мысль	None
тяготей	Second person Singular
приучал	None
прикидывается	Third person Singular
инициативами	None
пассивную	None
приличной	None
подними	Second person Singular
стрясай	Second person Singular
пустят	Third person Plural
поперхнись	Second person Singular
качайте	Second person Plural
военрука	None
сдерживается	Third person Singular
выявляет	Third person Singular
возвышается	Third person Singular
осознает	Third person Singular
маскируется	Third person Singular
агонизирует	Third person Singular
раскрываются	Third person Plural
заклял	None
минируют	Third person Plural
выкладываете	Second person Plural
выплывают	Third person Plural
проливает	Third person Singular
враждует	Third person Singular
высушивается	Third person Singular
плывёт	Third person Singular
кондоры	None
сматывай	Second person Singular
спорь	Second person Singular
отнесем	First person Plural
смазывают	Third person Plural
помещайте	Second person Plural
разгоняет	Third person Singular
помните	Second person Plural
оживаем	First person Plural
брякнет	Third person Singular
отсеки	Second person Singular
выдвигайте	Second person Plural
совершается	Third person Singular
зеленеет	Third person Singular
заулыбаемся	First person Plural
склоняем	First person Plural
отдаляется	Third person Singular
дивное	None
играете	Second person Plural
межгалактической	None
соборному	None
тихие	None
отвлекаются	Third person Plural
благоустроюсь	First person Singular
отзывав	None
угасает	Third person Singular
всходят	Third person Plural
иностранный	None
органическое	None
рассматриваются	Third person Plural
доверюсь	First person Singular
свожу	First person Singular
разносится	Third person Singular
наращивает	Third person Singular
выхватывают	Third person Plural
удаляется	Third person Singular
злосчастного	None
преем	First person Plural
реалистом	None
прославим	First person Plural
присмотрит	Third person Singular
опережает	Third person Singular
ослепляют	Third person Plural
поощряется	Third person Singular
медянка	None
выдвинутся	Third person Plural
вертись	Second person Singular
хлорофилла	None
процеживав	None
поработают	Third person Plural
оракулах	None
шарит	Third person Singular
подведите	Second person Plural
чудесным	None
учреждают	Third person Plural
гривенничками	None
вовлекает	Third person Singular
неограниченных	None
обзаводится	Third person Singular
чужеземцев	None
освободились	None
умудряется	Third person Singular
финансируй	Second person Singular
дичает	Third person Singular
ходовых	None
стоянием	None
реконструируют	Third person Plural
транссексуальности	None
расшатывают	Third person Plural
выбывает	Third person Singular
приобщаются	Third person Plural
придерживается	Third person Singular
прибавится	Third person Singular
поскрипываем	First person Plural
букваря	None
мой	Second person Singular
михайловском	None
голосуют	Third person Plural
изготовят	Third person Plural
спинам	None
атомный	None
произвольному	None
сентябре	None
вытаскивает	Third person Singular
повышается	Third person Singular
оттекаете	Second person Plural
превысят	Third person Plural
подгруппам	None
ревут	Third person Plural
осилит	Third person Singular
ткнул	None
симпатизирует	Third person Singular
теизмам	None
ювелирного	None
прочувствуете	Second person Plural
созданиям	None
сушит	Third person Singular
отставанием	None
возносится	Third person Singular
заклинивай	Second person Singular
заражает	Third person Singular
флегматичной	None
развалю	First person Singular
сужаются	Third person Plural
рождаются	Third person Plural
прокурорская	None
вздымается	Third person Singular
багровею	First person Singular
потемнеют	Third person Plural
соперниками	None
помолодею	First person Singular
обуевавший	None
треплет	Third person Singular
гляжу	First person Singular
исходно	None
пумам	None
усугубляется	Third person Singular
засвидетельствует	Third person Singular
приими	Second person Singular
уклоняетесь	Second person Plural
подслушивающий	None
выставляем	First person Plural
культивируют	Third person Plural
разносит	Third person Singular
немолодым	None
взимает	Third person Singular
обтягивает	Third person Singular
удостоится	Third person Singular
скатывается	Third person Singular
приподнимает	Third person Singular
приставай	Second person Singular
построят	Third person Plural
министерское	None
лодкам	None
обижаюсь	First person Singular
туркменом	None
колотит	Third person Singular
перелезаешь	Second person Singular
богатей	Second person Singular
предчувствую	First person Singular
кусает	Third person Singular
обустраивайтесь	Second person Plural
ограбьте	Second person Plural
присвоят	Third person Plural
навязывает	Third person Singular
исповедальнях	None
рефлексий	None
затянет	Third person Singular
обливается	Third person Singular
копну	First person Singular
высовывается	Third person Singular
петлей	None
совмещает	Third person Singular
мыльном	None
предостерегают	Third person Plural
рыжеватая	None
резюмирую	First person Singular
подпал	None
изнывает	Third person Singular
израсходуем	First person Plural
снизит	Third person Singular
марле	None
обосновывается	Third person Singular
перетаскивают	Third person Plural
задумывает	Third person Singular
вычищают	Third person Plural
растреплете	Second person Plural
обрисуй	Second person Singular
втыкает	Third person Singular
прокручивает	Third person Singular
третьяковском	None
луковичной	None
нейтрализуют	Third person Plural
выхухолям	None
офшорно	None
сокрушит	Third person Singular
бьются	Third person Plural
кляну	First person Singular
исполненные	None
проката	None
отваживаем	First person Plural
опалим	First person Plural
сочиняю	First person Singular
погрузочные	None
дарует	Third person Singular
смущает	Third person Singular
хозяйствуй	Second person Singular
сбывается	Third person Singular
мясоперерабатывающее	None
оборонительное	None
горн	None
закуривает	Third person Singular
дописываем	First person Plural
лоббировал	None
заткнись	Second person Singular
гуляй	Second person Singular
подведете	Second person Plural
берёшься	Second person Singular
замаскируйся	Second person Singular
шарю	First person Singular
уговаривались	None
атакую	First person Singular
ищете	Second person Plural
преуспевают	Third person Plural
гаражами	None
шпионит	Third person Singular
экономим	First person Plural
работки	None
сбывайся	Second person Singular
нагибался	None
ссорой	None
рижские	None
разъедает	Third person Singular
плюй	Second person Singular
делают	Third person Plural
мни	Second person Singular
игорный	None
познает	Third person Singular
поясним	First person Plural
внутримышечных	None
обтягиваете	Second person Plural
мифологическая	None
наживает	Third person Singular
подключатся	Third person Plural
приезжими	None
обрастает	Third person Singular
рекомендуются	Third person Plural
пашут	Third person Plural
обосновывает	Third person Singular
автоматизируют	Third person Plural
сочетают	Third person Plural
обрисовывает	Third person Singular
комбинированной	None
мемориальный	None
ревёт	Third person Singular
констатируют	Third person Plural
редактируете	Second person Plural
молоканах	None
воскрешают	Third person Plural
варятся	Third person Plural
регистрируйтесь	Second person Plural
слушаю	First person Singular
изолирует	Third person Singular
чует	Third person Singular
аллегорический	None
перечтите	Second person Plural
разжимай	Second person Singular
вянет	Third person Singular
смоет	Third person Singular
оглянет	Third person Singular
зацепит	Third person Singular
сдержись	Second person Singular
посвящение	None
вносится	Third person Singular
корпорациях	None
выявят	Third person Plural
голодает	Third person Singular
выпивает	Third person Singular
зазывает	Third person Singular
голубей	Second person Singular
встревает	Third person Singular
оживает	Third person Singular
отчаивается	Third person Singular
стремятся	Third person Plural
потупляйся	Second person Singular
помету	None
машешь	Second person Singular
посинеют	Third person Plural
интерпретирую	First person Singular
формируют	Third person Plural
чает	Third person Singular
ограничимся	First person Plural
проиллюстрирую	First person Singular
выкладывает	Third person Singular
отговаривает	Third person Singular
пьяни	Second person Singular
отстаиваю	First person Singular
математическое	None
набрасываются	Third person Plural
нарядной	None
побеседовать	None
перетягивает	Third person Singular
выкладывайте	Second person Plural
неприемлемого	None
формулировке	None
спущусь	First person Singular
уймитесь	Second person Plural
путайте	Second person Plural
высадятся	Third person Plural
терпима	None
присоединяются	Third person Plural
расстраивайте	Second person Plural
долгота	None
возрождают	Third person Plural
любовником	None
приложит	Third person Singular
шмыгни	Second person Singular
встретитесь	Second person Plural
огибает	Third person Singular
бостона	None
дистрибьютеру	None
сыграются	Third person Plural
расстыковке	None
концентрируются	Third person Plural
выкипая	None
передёргивает	Third person Singular
перерастает	Third person Singular
укладываешься	Second person Singular
старятся	Third person Plural
нарушаются	Third person Plural
отбиваясь	None
транслируют	Third person Plural
освещаюсь	First person Singular
затею	First person Singular
гадай	Second person Singular
избираются	Third person Plural
реформируешь	Second person Singular
шипит	Third person Singular
расправляют	Third person Plural
судорога	None
перерабатываю	First person Singular
зачитывает	Third person Singular
пощёлкало	None
тощую	None
влипаешь	Second person Singular
хулиганю	First person Singular
взрывчатку	None
трудись	Second person Singular
кейс	None
расширяются	Third person Plural
греем	First person Plural
погустеют	Third person Plural
конуре	None
отслуживаете	Second person Plural
сводится	Third person Singular
базируют	Third person Plural
наступает	Third person Singular
усаживается	Third person Singular
геометрии	None
субтитры	None
последую	First person Singular
верь	Second person Singular
воскресают	Third person Plural
краснеет	Third person Singular
знаменательное	None
загони	Second person Singular
тапирам	None
отбивает	Third person Singular
этнонимах	None
пособию	None
переоцени	Second person Singular
безмятежными	None
завещаю	First person Singular
раскаляйте	Second person Plural
рассматривается	Third person Singular
сторонится	Third person Singular
переверчу	First person Singular
сушат	Third person Plural
абонементов	None
специализируется	Third person Singular
опускайся	Second person Singular
инкуб	None
расступаются	Third person Plural
печалит	Third person Singular
одолевают	Third person Plural
ослабевают	Third person Plural
насаживает	Third person Singular
неприкрытые	None
тарифном	None
присоединяйтесь	Second person Plural
выдержат	Third person Plural
приснится	Third person Singular
падежам	None
устоится	Third person Singular
пересыхают	Third person Plural
встрепенется	Third person Singular
уполномочивает	Third person Singular
ужасают	Third person Plural
оттаивает	Third person Singular
жду	First person Singular
нанимаются	Third person Plural
продуцируют	Third person Plural
обнаруживаемся	First person Plural
рушатся	Third person Plural
раскройте	Second person Plural
ширококолейной	None
раскину	First person Singular
накидываешь	Second person Singular
багровеют	Third person Plural
переносную	None
проделывает	Third person Singular
комментируйте	Second person Plural
бездействует	Third person Singular
урнах	None
наклонной	None
пролежим	First person Plural
поглощает	Third person Singular
прислушивайтесь	Second person Plural
сочувствует	Third person Singular
наглядится	Third person Singular
прокурят	Third person Plural
выдавайте	Second person Plural
охлаждает	Third person Singular
стригольники	None
бытуют	Third person Plural
ругаются	Third person Plural
экзотика	None
ледниковое	None
водогрейней	None
прицеплю	First person Singular
бодрствуйте	Second person Plural
подыскивают	Third person Plural
весели	Second person Singular
изображают	Third person Plural
выращивай	Second person Singular
часиков	None
тону	First person Singular
обидится	Third person Singular
именуемый	None
прибегут	Third person Plural
непотизм	None
заплывают	Third person Plural
прибавит	Third person Singular
тренируют	Third person Plural
изготавливает	Third person Singular
губят	Third person Plural
свирепствует	Third person Singular
выстраивается	Third person Singular
снобы	None
воспитываются	Third person Plural
сгустим	First person Plural
ударяется	Third person Singular
пригодятся	Third person Plural
продлим	First person Plural
сохраняется	Third person Singular
предвещает	Third person Singular
иссякнут	Third person Plural
разрешится	Third person Singular
рапортует	Third person Singular
крути	Second person Singular
колем	First person Plural
баллотируясь	None
шахтёром	None
хрущёвском	None
слыл	None
националистической	None
полога	None
разгуляй	Second person Singular
укрепляются	Third person Plural
закрепляясь	None
засеки	Second person Singular
улучат	Third person Plural
делит	Third person Singular
удивляется	Third person Singular
древностями	None
отменные	None
загадаете	Second person Plural
прояснится	Third person Singular
окружающее	None
вдумайтесь	Second person Plural
печётся	Third person Singular
натянем	First person Plural
придирайтесь	Second person Plural
опомнившийся	None
созданную	None
большегрузную	None
оживешь	Second person Singular
занесете	Second person Plural
восьмёрку	None
предлагается	Third person Singular
сибирскими	None
жэке	None
знаменуя	None
поднимем	First person Plural
перегораживают	Third person Plural
поклонов	None
страхуют	Third person Plural
обычаями	None
прослушиваем	First person Plural
нарушался	None
дендрарием	None
отворачивают	Third person Plural
пропитывается	Third person Singular
прикрывает	Third person Singular
практикуется	Third person Singular
болгары	None
отделаешь	Second person Singular
затаскивают	Third person Plural
отравляя	None
ссылаюсь	First person Singular
обвиняется	Third person Singular
слепнет	Third person Singular
литовского	None
разубеждайте	Second person Plural
ненавистны	None
надвигались	None
выдерживает	Third person Singular
величает	Third person Singular
затруднюсь	First person Singular
наставляют	Third person Plural
заинтересовывается	Third person Singular
вмешивается	Third person Singular
удостоверьтесь	Second person Plural
сгусток	None
претерпевая	None
ономастика	None
засчитают	Third person Plural
модернизируют	Third person Plural
запрашивает	Third person Singular
раздавит	Third person Singular
прекратится	Third person Singular
держит	Third person Singular
отравляемся	First person Plural
вечеринками	None
кончи	Second person Singular
упростят	Third person Plural
решается	Third person Singular
экономит	Third person Singular
стукнет	Third person Singular
смущённые	None
модальная	None
аэрозольное	None
продавливает	Third person Singular
настанут	Third person Plural
сделались	None
плещут	Third person Plural
перекрывают	Third person Plural
насмотримся	First person Plural
стороны	None
поёт	Third person Singular
компрессорами	None
анаграмма	None
жалуетесь	Second person Plural
предельный	None
зажмуривается	Third person Singular
метровую	None
вселим	First person Plural
дрозда	None
завораживал	None
заживает	Third person Singular
зарегистрируйтесь	Second person Plural
диагоналях	None
допишут	Third person Plural
перекликаются	Third person Plural
компактно	None
выбывают	Third person Plural
воспитаются	Third person Plural
обгоняют	Third person Plural
решаюсь	First person Singular
роются	Third person Plural
отъявленных	None
перерос	None
распускают	Third person Plural
приручайся	Second person Singular
гремела	None
углубляются	Third person Plural
громоздить	None
избирается	Third person Singular
скандалит	Third person Singular
омерзения	None
родни	Second person Singular
прядёшь	Second person Singular
присягают	Third person Plural
подберет	Third person Singular
вышагнуло	None
пролегает	Third person Singular
бушует	Third person Singular
тролли	None
слыхал	None
вводим	First person Plural
играем	First person Plural
предвидит	Third person Singular
проскальзывают	Third person Plural
жалуется	Third person Singular
регулируется	Third person Singular
переплетается	Third person Singular
прилипают	Third person Plural
поднимает	Third person Singular
оттачивает	Third person Singular
продумывает	Third person Singular
противоположна	None
поклоняемся	First person Plural
щёлок	None
выбирается	Third person Singular
рисуем	First person Plural
идентифицируют	Third person Plural
просуществуют	Third person Plural
стони	Second person Singular
бледнейте	Second person Plural
кидайте	Second person Plural
подстерегут	Third person Plural
нудной	None
протягивается	Third person Singular
отбросьте	Second person Plural
неправомерное	None
несогласна	None
расследующий	None
пусковым	None
утёса	None
волнует	Third person Singular
сохнут	Third person Plural
упоминаем	First person Plural
докатывается	Third person Singular
передумай	Second person Singular
уделимся	First person Plural
далёкая	None
сунемся	First person Plural
исцеляет	Third person Singular
обновляют	Third person Plural
утопическое	None
пролейся	Second person Singular
взыскатели	None
подразделяет	Third person Singular
перекатываются	Third person Plural
продуманной	None
изнемогал	None
забывчивости	None
перегибает	Third person Singular
обгоняет	Third person Singular
несподручных	None
адаптируете	Second person Plural
обжалует	Third person Singular
перебьют	Third person Plural
кончатся	Third person Plural
разделится	Third person Singular
разорившийся	None
жидко	None
трите	Second person Plural
свободами	None
германцами	None
стрижёт	Third person Singular
втыкайте	Second person Plural
буквенной	None
щелкнут	Third person Plural
обыгрываешь	Second person Singular
приговору	None
усаживаются	Third person Plural
редактирует	Third person Singular
уделяет	Third person Singular
авиационными	None
стекает	Third person Singular
рассылай	Second person Singular
успокоитесь	Second person Plural
надстройтесь	Second person Plural
подведу	First person Singular
удивляемся	First person Plural
позорит	Third person Singular
изводит	Third person Singular
подкладывает	Third person Singular
вопросительным	None
акцией	None
безличном	None
прицеливается	Third person Singular
пробирается	Third person Singular
идёшь	Second person Singular
самодеятельными	None
сопоставим	First person Plural
годового	None
раздует	Third person Singular
уголкам	None
засаживаю	First person Singular
запрягают	Third person Plural
сформируется	Third person Singular
крепится	Third person Singular
сменяется	Third person Singular
изобретательное	None
трансформирует	Third person Singular
припевами	None
обосновываете	Second person Plural
чубами	None
причини	Second person Singular
утверждаются	Third person Plural
покоряют	Third person Plural
расставляйте	Second person Plural
командную	None
притихнут	Third person Plural
сконфузишься	Second person Singular
вляпайся	Second person Singular
присуждают	Third person Plural
переименовывай	Second person Singular
земляной	None
перемещают	Third person Plural
склоняюсь	First person Singular
дорвите	Second person Plural
зажмурьте	Second person Plural
сшибает	Third person Singular
подведет	Third person Singular
вставляете	Second person Plural
подкидывает	Third person Singular
отпугнет	Third person Singular
протягиваются	Third person Plural
оглушает	Third person Singular
непосилен	None
объясняются	Third person Plural
напрягает	Third person Singular
долетит	Third person Singular
язычник	None
разбегутся	Third person Plural
черепицу	None
рассмотрению	None
сбросьте	Second person Plural
смахивают	Third person Plural
систематизируют	Third person Plural
знакомят	Third person Plural
наезжают	Third person Plural
сожрал	None
раскатывают	Third person Plural
референдумов	None
смелей	Second person Singular
поломает	Third person Singular
простонайте	Second person Plural
засели	Second person Singular
наращивают	Third person Plural
опубликуют	Third person Plural
сужают	Third person Plural
обнаружатся	Third person Plural
подвернемся	First person Plural
выглядывают	Third person Plural
гласят	Third person Plural
гадит	Third person Singular
арендует	Third person Singular
осваивают	Third person Plural
намечает	Third person Singular
залп	None
стеллажа	None
охарактеризуй	Second person Singular
плодоносят	Third person Plural
переписывают	Third person Plural
плюнет	Third person Singular
басмачам	None
обучает	Third person Singular
прослеживают	Third person Plural
крёстной	None
акцентируете	Second person Plural
взглянет	Third person Singular
щеночках	None
размещает	Third person Singular
выдерживают	Third person Plural
обеспечивается	Third person Singular
разочаровывает	Third person Singular
зададимся	First person Plural
уразумею	First person Singular
сенсации	None
блюду	First person Singular
прёт	Third person Singular
рои	Second person Singular
зарой	Second person Singular
шведками	None
приостанавливаю	First person Singular
ускоренно	None
пробного	None
проглатывают	Third person Plural
архитекторами	None
вышусь	First person Singular
базируете	Second person Plural
пыли	Second person Singular
выкинут	Third person Plural
подберите	Second person Plural
журнальчик	None
кинозвездой	None
забавляет	Third person Singular
осознаёте	Second person Plural
перекроет	Third person Singular
вбирает	Third person Singular
журналистка	None
духовенством	None
потакают	Third person Plural
швырнула	None
выявляется	Third person Singular
априорной	None
гнётся	Third person Singular
поступайте	Second person Plural
сворачиваются	Third person Plural
поддастся	Third person Singular
конторской	None
дополню	First person Singular
подправим	First person Plural
мочат	Third person Plural
мыслит	Third person Singular
выпиливают	Third person Plural
прельщаем	First person Plural
напеваешь	Second person Singular
информирует	Third person Singular
дополним	First person Plural
увеличиваются	Third person Plural
смешивайте	Second person Plural
зависает	Third person Singular
осуши	Second person Singular
задирает	Third person Singular
блудные	None
сутулится	Third person Singular
читается	Third person Singular
наброске	None
выбегают	Third person Plural
смородинами	None
раскроить	None
лупит	Third person Singular
взбегу	First person Singular
констатирует	Third person Singular
просматривается	Third person Singular
переводятся	Third person Plural
отличают	Third person Plural
подделывают	Third person Plural
живётся	Third person Singular
разбрасывают	Third person Plural
выражусь	First person Singular
ввязывается	Third person Singular
отдались	Second person Singular
мучается	Third person Singular
захватят	Third person Plural
продвинется	Third person Singular
допрашивает	Third person Singular
выстраивают	Third person Plural
сдаётся	Third person Singular
сглотну	First person Singular
шампанское	None
ассоциируется	Third person Singular
сдамся	First person Singular
вибрируют	Third person Plural
дочитайте	Second person Plural
политологов	None
комментирую	First person Singular
предсказывает	Third person Singular
простаивайте	Second person Plural
ориентируйтесь	Second person Plural
несоответствий	None
штрихкодов	None
толкай	Second person Singular
прививают	Third person Plural
уделяйте	Second person Plural
застигает	Third person Singular
аквариумом	None
осення	None
посвистываем	First person Plural
амстердамцы	None
отмеривает	Third person Singular
накидывает	Third person Singular
иллюзиях	None
подымается	Third person Singular
вкладывают	Third person Plural
чуй	Second person Singular
загорится	Third person Singular
сузится	Third person Singular
проистекайте	Second person Plural
распахиваются	Third person Plural
мокрого	None
криви	Second person Singular
натаскайте	Second person Plural
изобилуют	Third person Plural
хмелейте	Second person Plural
перемещается	Third person Singular
сообщниками	None
вскричал	None
потенциалу	None
сопутствующая	None
искореняйте	Second person Plural
взлетают	Third person Plural
горьким	None
определяется	Third person Singular
коллекционирования	None
зажимает	Third person Singular
простоит	Third person Singular
стужу	First person Singular
мну	First person Singular
затопать	None
ознакомятся	Third person Plural
кусается	Third person Singular
намечалась	None
лечи	Second person Singular
исчерпывает	Third person Singular
сдастся	Third person Singular
объезжают	Third person Plural
пошатывают	Third person Plural
водоносная	None
меркнете	Second person Plural
разгадывают	Third person Plural
слезает	Third person Singular
подслушивание	None
выдвинем	First person Plural
вводится	Third person Singular
реставраторам	None
резьбе	None
отвяжется	Third person Singular
вдумчиво	None
отправляйся	Second person Singular
сгущается	Third person Singular
поведает	Third person Singular
нагрейтесь	Second person Plural
славят	Third person Plural
восхитительный	None
поблёскиваем	First person Plural
переместит	Third person Singular
колется	Third person Singular
перепрыгивает	Third person Singular
извлёкший	None
расслабляется	Third person Singular
цепляется	Third person Singular
пустит	Third person Singular
печатают	Third person Plural
раздувает	Third person Singular
сдаюсь	First person Singular
проекцией	None
оговаривают	Third person Plural
уделяется	Third person Singular
движителем	None
буява	None
поколеблем	First person Plural
оскорбительной	None
практикует	Third person Singular
адриатическими	None
носится	Third person Singular
чту	First person Singular
царапни	Second person Singular
согласуется	Third person Singular
оснастят	Third person Plural
желтеют	Third person Plural
зажимать	None
пощекочете	Second person Plural
опадают	Third person Plural
заболевает	Third person Singular
заклею	First person Singular
анализируют	Third person Plural
сбрасывают	Third person Plural
контролируют	Third person Plural
прикладывают	Third person Plural
шлите	Second person Plural
подытожим	First person Plural
ограждаемый	None
сознает	Third person Singular
оговариваются	Third person Plural
рудные	None
разрушительный	None
вывешивает	Third person Singular
вонзайся	Second person Singular
понижают	Third person Plural
оправдываются	Third person Plural
привязать	None
ищут	Third person Plural
даруй	Second person Singular
пинают	Third person Plural
вскиплю	First person Singular
доводится	Third person Singular
выхватываю	First person Singular
смеем	First person Plural
намекает	Third person Singular
командую	First person Singular
отвоёвывает	Third person Singular
зоопарков	None
выспрашивайте	Second person Plural
конфискуют	Third person Plural
решусь	First person Singular
подделай	Second person Singular
извилистую	None
маются	Third person Plural
снисходит	Third person Singular
раскусываешь	Second person Singular
удостоверяют	Third person Plural
прогулок	None
впитывает	Third person Singular
возрасту	First person Singular
подпирают	Third person Plural
подносит	Third person Singular
умираю	First person Singular
сходится	Third person Singular
угасают	Third person Plural
взлетит	Third person Singular
обеспечилась	None
стрельну	First person Singular
незаконную	None
кроватями	None
разгоняются	Third person Plural
сгинет	Third person Singular
оживут	Third person Plural
истребят	Third person Plural
раздразнит	Third person Singular
обособленной	None
символизируют	Third person Plural
разламывает	Third person Singular
гниёт	Third person Singular
предостережения	None
наносные	None
неотъемлемый	None
выкрикивайте	Second person Plural
чиркало	None
иерархическими	None
садятся	Third person Plural
сменится	Third person Singular
превалирует	Third person Singular
осчастливит	Third person Singular
щука	None
фетишем	None
кокетничает	Third person Singular
вступается	Third person Singular
совершится	Third person Singular
запутается	Third person Singular
декселю	None
намекаете	Second person Plural
подозреваем	First person Plural
возрасти	Second person Singular
повторятся	Third person Plural
внедряется	Third person Singular
обыскивают	Third person Plural
сопереживает	Third person Singular
задвинь	Second person Singular
особенной	None
купель	None
равнобедрен	None
корректирую	First person Singular
задайтесь	Second person Plural
настройте	Second person Plural
поживает	Third person Singular
контрактов	None
вводя	None
найдетесь	Second person Plural
выталкивает	Third person Singular
удлиняет	Third person Singular
ускоряется	Third person Singular
эксплуатирует	Third person Singular
крепи	Second person Singular
улавливаю	First person Singular
подвозим	First person Plural
совладали	None
преклоняется	Third person Singular
завышай	Second person Singular
ровесниками	None
легковыми	None
нашаривавший	None
последуем	First person Plural
сварийся	Second person Singular
цивилизованный	None
пульсаром	None
судно	None
подбирают	Third person Plural
разрешатся	Third person Plural
приготовляют	Third person Plural
парчей	None
углубляют	Third person Plural
запишитесь	Second person Plural
кораллах	None
приспосабливает	Third person Singular
киснешь	Second person Singular
доносятся	Third person Plural
двинешь	Second person Singular
гляньте	Second person Plural
соизволите	Second person Plural
этнонимами	None
запасает	Third person Singular
затрагивает	Third person Singular
возводятся	Third person Plural
боливарианской	None
основываюсь	First person Singular
нефу	None
подстраивается	Third person Singular
высекай	Second person Singular
укушенный	None
сплету	First person Singular
обретайся	Second person Singular
стариковское	None
значат	Third person Plural
валяется	Third person Singular
содержатся	Third person Plural
упрекают	Third person Plural
отворачивается	Third person Singular
жалит	Third person Singular
умирают	Third person Plural
дополняйте	Second person Plural
мужние	None
растопят	Third person Plural
заглянешь	Second person Singular
переименовывайте	Second person Plural
анонимно	None
ориентируетесь	Second person Plural
хостингов	None
побуждает	Third person Singular
поспевают	Third person Plural
постигают	Third person Plural
аннексирует	Third person Singular
отпочкуйтесь	Second person Plural
предреки	Second person Singular
выпивают	Third person Plural
демонстрируется	Third person Singular
воняешь	Second person Singular
опросов	None
кредиту	None
охотится	Third person Singular
дистанционная	None
стека	None
иду	First person Singular
трудоёмки	None
связывайтесь	Second person Plural
смягчает	Third person Singular
танцуют	Third person Plural
сигнальным	None
укороченный	None
утрачивала	None
ускорится	Third person Singular
сражайся	Second person Singular
жаждущая	None
переплывают	Third person Plural
осложняются	Third person Plural
шарахаются	Third person Plural
защищается	Third person Singular
корректирует	Third person Singular
зазеваемся	First person Plural
сокращённые	None
продвигает	Third person Singular
хуеют	Third person Plural
хавает	Third person Singular
затихают	Third person Plural
монтирует	Third person Singular
свисают	Third person Plural
эсхатологии	None
гречек	None
эмбрионом	None
глютене	None
опробуйте	Second person Plural
настраиваются	Third person Plural
парусный	None
господствующего	None
научат	Third person Plural
распластываетесь	Second person Plural
району	None
декларация	None
пугнете	Second person Plural
остынут	Third person Plural
рыбачит	Third person Singular
радеет	Third person Singular
пристраивается	Third person Singular
тросы	None
сочтет	Third person Singular
впитало	None
умножает	Third person Singular
нырнет	Third person Singular
беднейте	Second person Plural
окиньте	Second person Plural
кипятят	Third person Plural
получишь	Second person Singular
Бронксе	None
поправляется	Third person Singular
залежи	None
увенчиваемся	First person Plural
выставляются	Third person Plural
купят	Third person Plural
балансирует	Third person Singular
затрем	First person Plural
размещу	First person Singular
обдумываю	First person Singular
девичья	None
напитках	None
ссылаешься	Second person Singular
чередуется	Third person Singular
модифицирует	Third person Singular
взаимовыгодному	None
цитируете	Second person Plural
облекается	Third person Singular
вспотеете	Second person Plural
нарастишь	Second person Singular
расчленяет	Third person Singular
выбиралось	None
карабинов	None
оберегает	Third person Singular
импорте	None
бухгалтерских	None
кроет	Third person Singular
изъясняются	Third person Plural
превышает	Third person Singular
свяжусь	First person Singular
мгновенью	None
разъезжают	Third person Plural
лоббирую	First person Singular
передвигается	Third person Singular
прикрывают	Third person Plural
числюсь	First person Singular
поются	Third person Plural
струится	Third person Singular
утаивает	Third person Singular
возносил	None
останкам	None
трепещет	Third person Singular
восточноевропейская	None
определюсь	First person Singular
вставишь	Second person Singular
озаряет	Third person Singular
светит	Third person Singular
внутрисекреторный	None
раскапывает	Third person Singular
записную	None
систематизирует	Third person Singular
потягиваемся	First person Plural
напитаем	First person Plural
объясняется	Third person Singular
большевистских	None
садись	Second person Singular
подпевает	Third person Singular
гитаристках	None
мансийском	None
утонет	Third person Singular
блокируют	Third person Plural
обижайся	Second person Singular
бросим	First person Plural
расселяются	Third person Plural
словаку	None
вычислим	First person Plural
хлопочет	Third person Singular
нерешительные	None
донимает	Third person Singular
слежу	First person Singular
удерживается	Third person Singular
провожу	First person Singular
иссякает	Third person Singular
планируйтесь	Second person Plural
помечаю	First person Singular
сочиняют	Third person Plural
проанализирую	First person Singular
неугодными	None
исходим	First person Plural
закрытию	None
довольствуются	Third person Plural
расписывает	Third person Singular
отворачиваются	Third person Plural
решёток	None
компактным	None
стонет	Third person Singular
прожорливый	None
целуют	Third person Plural
шарахнутся	Third person Plural
поощряются	Third person Plural
свешиваются	Third person Plural
пискнут	Third person Plural
исчерпываются	Third person Plural
вдыхающий	None
фантазируйте	Second person Plural
выливает	Third person Singular
ореховое	None
мотивирую	First person Singular
тявкаем	First person Plural
ругайте	Second person Plural
стирает	Third person Singular
пейзаж	None
утонешь	Second person Singular
возвышают	Third person Plural
возрождается	Third person Singular
карает	Third person Singular
укоряете	Second person Plural
сожалеют	Third person Plural
вставляет	Third person Singular
госдепартамент	None
задавливай	Second person Singular
промахивайтесь	Second person Plural
переместится	Third person Singular
различим	First person Plural
приезжаю	First person Singular
армией	None
разрушится	Third person Singular
предопределяя	None
координируют	Third person Plural
плати	Second person Singular
ипотекой	None
шали	Second person Singular
цифровых	None
вытянут	Third person Plural
бритве	None
спасусь	First person Singular
усовершенствует	Third person Singular
махни	Second person Singular
чёркайте	Second person Plural
упоминаются	Third person Plural
поджимает	Third person Singular
пустишься	Second person Singular
папирусы	None
обоссутся	Third person Plural
отсеивает	Third person Singular
скопившийся	None
оборони	Second person Singular
умалчиваете	Second person Plural
катеру	None
чудищем	None
определяются	Third person Plural
нерешённые	None
окончится	Third person Singular
шевелятся	Third person Plural
соблюди	Second person Singular
спортсменами	None
возместит	Third person Singular
подвой	Second person Singular
проанализирует	Third person Singular
являя	None
бросится	Third person Singular
совхозам	None
приподнимите	Second person Plural
поражаюсь	First person Singular
распорядится	Third person Singular
минфине	None
прядёт	Third person Singular
несостоятельность	None
наговаривает	Third person Singular
кусают	Third person Plural
спросится	Third person Singular
субстратов	None
неестественную	None
компенсирует	Third person Singular
реактивах	None
шлифуй	Second person Singular
дугообразной	None
нанимают	Third person Plural
скопирую	First person Singular
подкладывают	Third person Plural
освоит	Third person Singular
лисят	None
поджидают	Third person Plural
штурмом	None
очерчивает	Third person Singular
чешет	Third person Singular
оскверняют	Third person Plural
изучаются	Third person Plural
посвящают	Third person Plural
уязвим	First person Plural
захочется	Third person Singular
бездельничай	Second person Singular
надвигаются	Third person Plural
вписывайся	Second person Singular
публикует	Third person Singular
полируют	Third person Plural
наладится	Third person Singular
бунтовать	None
заправляют	Third person Plural
грешит	Third person Singular
наслаждается	Third person Singular
разыскивают	Third person Plural
вскрытии	None
заверяем	First person Plural
лишайниками	None
сало	None
груши	None
фотографической	None
валится	Third person Singular
противопоставляет	Third person Singular
свёртку	None
поглотит	Third person Singular
бросит	Third person Singular
закидают	Third person Plural
реестрам	None
извещает	Third person Singular
отомстим	First person Plural
катит	Third person Singular
почту	First person Singular
бранит	Third person Singular
выявляются	Third person Plural
ювелирному	None
лазерный	None
расистская	None
хоккеисту	None
приеду	First person Singular
семантикам	None
отзывает	Third person Singular
девственником	None
вписываем	First person Plural
маскируются	Third person Plural
спешный	None
претендуем	First person Plural
насчитывают	Third person Plural
запейте	Second person Plural
мадемуазель	None
напрашиваются	Third person Plural
наклоняются	Third person Plural
дерзайте	Second person Plural
рассмотрениях	None
задумайтесь	Second person Plural
подыщешь	Second person Singular
повалится	Third person Singular
абстракционистского	None
женственное	None
лучиной	None
затащи	Second person Singular
любительницей	None
осмеливаюсь	First person Singular
пристальному	None
гремит	Third person Singular
ужасается	Third person Singular
твердеет	Third person Singular
пальмовых	None
транслирует	Third person Singular
несогласными	None
содействуй	Second person Singular
интерферонов	None
освящению	None
зайдись	Second person Singular
обозрим	First person Plural
декларирует	Third person Singular
перескакивать	None
рулить	None
пирайями	None
выцветай	Second person Singular
префектурами	None
встречаемся	First person Plural
пересылают	Third person Plural
многограннику	None
инородца	None
предугадывало	None
привередливое	None
гляди	Second person Singular
ебись	Second person Singular
колышется	Third person Singular
питомцу	None
заливаю	First person Singular
промежутки	None
выяснится	Third person Singular
подкрепили	None
смазывает	Third person Singular
заверяю	First person Singular
прославляются	Third person Plural
выдать	None
студит	Third person Singular
опоражнивайте	Second person Plural
занижает	Third person Singular
потомственного	None
прозвища	None
прекращаются	Third person Plural
дискутируют	Third person Plural
субсидирует	Third person Singular
мобильные	None
разливается	Third person Singular
юнгам	None
проговаривается	Third person Singular
жалят	Third person Plural
рентгеновскими	None
отделяю	First person Singular
апатеизмов	None
боготворило	None
злостные	None
натыкается	Third person Singular
поправляю	First person Singular
неадекватные	None
угодишь	Second person Singular
спросим	First person Plural
детекторов	None
настрою	First person Singular
вставляю	First person Singular
бутырскую	None
заливает	Third person Singular
полет	Third person Singular
сморщивайся	Second person Singular
разделяется	Third person Singular
неполадками	None
подсчитывайте	Second person Plural
измучит	Third person Singular
прейдет	Third person Singular
воздерживаюсь	First person Singular
располагаем	First person Plural
мстим	First person Plural
перехватывает	Third person Singular
стрижа	None
сдавливает	Third person Singular
воскреснет	Third person Singular
вмешаюсь	First person Singular
подделывает	Third person Singular
готовь	Second person Singular
переберутся	Third person Plural
предвосхищает	Third person Singular
подвывает	Third person Singular
цельном	None
придаётесь	Second person Plural
неизбежности	None
превозносит	Third person Singular
игнорируют	Third person Plural
холодят	Third person Plural
съезжает	Third person Singular
комплиментом	None
поместит	Third person Singular
приоткроетесь	Second person Plural
побуждают	Third person Plural
облетают	Third person Plural
улучшаются	Third person Plural
налаживает	Third person Singular
возлагается	Third person Singular
подхватывают	Third person Plural
цепляюсь	First person Singular
чай	Second person Singular
выгружаются	Third person Plural
командируют	Third person Plural
лиственницами	None
грызунах	None
рудным	None
прибейте	Second person Plural
западет	Third person Singular
обрушим	First person Plural
запишусь	First person Singular
автоматизируешь	Second person Singular
метят	Third person Plural
напрягается	Third person Singular
думского	None
воссоздаёт	Third person Singular
спасутся	Third person Plural
бригадами	None
ипотечные	None
критикует	Third person Singular
преподносят	Third person Plural
отвадилась	None
раскрашивает	Third person Singular
наклоняешь	Second person Singular
камертонов	None
обучаю	First person Singular
слабенькому	None
уделяете	Second person Plural
зевай	Second person Singular
обозревала	None
противогаза	None
одерживают	Third person Plural
соблазняли	None
сойдутся	Third person Plural
дотягивают	Third person Plural
сунь	Second person Singular
оглядит	Third person Singular
зарегистрирует	Third person Singular
простится	Third person Singular
болтай	Second person Singular
прицепов	None
концепция	None
слеза	None
употребляется	Third person Singular
демонстрируют	Third person Plural
лукавит	Third person Singular
возобновится	Third person Singular
осознаёт	Third person Singular
вляпываем	First person Plural
вписывает	Third person Singular
раскаивалось	None
навязывают	Third person Plural
манипуляции	None
монтажным	None
следят	Third person Plural
оправдан	None
озабоченных	None
кривишься	Second person Singular
покушается	Third person Singular
обучается	Third person Singular
мерцает	Third person Singular
отключает	Third person Singular
сексуальным	None
вышагай	Second person Singular
карают	Third person Plural
опухнете	Second person Plural
пленит	Third person Singular
покачаете	Second person Plural
красноваты	None
жите	None
конфронтация	None
безоблачными	None
слить	None
вылечивает	Third person Singular
берегитесь	Second person Plural
многотысячные	None
вонзимся	First person Plural
краснеют	Third person Plural
посмею	First person Singular
распевает	Third person Singular
сосредоточивает	Third person Singular
переберете	Second person Plural
снимем	First person Plural
предстанет	Third person Singular
обожаемый	None
заворотит	Third person Singular
понос	None
нехорошие	None
даются	Third person Plural
сбегает	Third person Singular
безукоризненное	None
обставить	None
бандикутов	None
алмазную	None
вызовется	Third person Singular
покрывают	Third person Plural
обоснованные	None
дополнят	Third person Plural
лифчика	None
пройдемся	First person Plural
недоступная	None
сплетничают	Third person Plural
заклинает	Third person Singular
отплатят	Third person Plural
липни	Second person Singular
крепнет	Third person Singular
активностью	None
баллотируются	Third person Plural
преуспеть	None
охарактеризуйте	Second person Plural
селятся	Third person Plural
спорному	None
джентльменов	None
добавляюсь	First person Singular
инвестора	None
затворяю	First person Singular
возвещают	Third person Plural
обобщаете	Second person Plural
вписывается	Third person Singular
армада	None
слышится	Third person Singular
посчастливится	Third person Singular
сформулируйте	Second person Plural
завершатся	Third person Plural
извести	Second person Singular
иронизирует	Third person Singular
превысишь	Second person Singular
лоббируют	Third person Plural
вывёртывайте	Second person Plural
отработает	Third person Singular
смутн	None
компенсируйтесь	Second person Plural
широкомасштабный	None
суживаются	Third person Plural
присматриваете	Second person Plural
юдофобию	None
разблокируют	Third person Plural
вычисляют	Third person Plural
разлагаешь	Second person Singular
нерушим	None
накипеишь	Second person Singular
предназначаются	Third person Plural
хот-доги	None
спишите	Second person Plural
клеточка	None
продвижений	None
дрожит	Third person Singular
сублимирует	Third person Singular
стыдится	Third person Singular
журналистским	None
опровергайте	Second person Plural
повествуют	Third person Plural
развеивает	Third person Singular
упрекаю	First person Singular
вырастит	Third person Singular
откликается	Third person Singular
замерзают	Third person Plural
бейсболу	None
схороню	First person Singular
начислю	First person Singular
противостоишь	Second person Singular
абстинента	None
небоскрёба	None
плачем	First person Plural
купим	First person Plural
перну	First person Singular
прихрамывает	Third person Singular
затягивают	Third person Plural
натягивают	Third person Plural
ровесники	None
выставляете	Second person Plural
возится	Third person Singular
покопаюсь	First person Singular
озвучивают	Third person Plural
завершаешься	Second person Singular
уличает	Third person Singular
пригородное	None
построю	First person Singular
овладеет	Third person Singular
изволит	Third person Singular
ухитряются	Third person Plural
оттягивает	Third person Singular
манипулирует	Third person Singular
приковали	None
выезжает	Third person Singular
докатимся	First person Plural
запекаешься	Second person Singular
мобилизует	Third person Singular
прибавьте	Second person Plural
австрийское	None
перевозит	Third person Singular
инициируют	Third person Plural
циркулирует	Third person Singular
чередует	Third person Singular
мятежную	None
втягивают	Third person Plural
переплывая	None
делаете	Second person Plural
убираются	Third person Plural
церковнославянской	None
посеешь	Second person Singular
пачкает	Third person Singular
отсылаете	Second person Plural
возвысится	Third person Singular
непокорств	None
выползает	Third person Singular
специализируетесь	Second person Plural
возбуждаются	Third person Plural
отключают	Third person Plural
завершается	Third person Singular
замолкают	Third person Plural
палеоантрополог	None
вызревает	Third person Singular
лечится	Third person Singular
подрастает	Third person Singular
досаждает	Third person Singular
гравюре	None
сукновальня	None
придется	Third person Singular
оазисов	None
осечется	Third person Singular
авангардах	None
сдирает	Third person Singular
склеивают	Third person Plural
поспевает	Third person Singular
вырасти	Second person Singular
кути	Second person Singular
различаешься	Second person Singular
суживай	Second person Singular
наваливают	Third person Plural
затрудняетесь	Second person Plural
утоплюсь	First person Singular
подводный	None
пересматривают	Third person Plural
поджигает	Third person Singular
привносит	Third person Singular
обсуждается	Third person Singular
заинтересует	Third person Singular
вторишь	Second person Singular
каблучок	None
присвойте	Second person Plural
кусай	Second person Singular
покроется	Third person Singular
умиротворят	Third person Plural
подчинится	Third person Singular
разъясняю	First person Singular
ульяновским	None
анализирую	First person Singular
расстроюсь	First person Singular
воздвигаешь	Second person Singular
тундр	None
имеются	Third person Plural
слагает	Third person Singular
добивает	Third person Singular
приблизит	Third person Singular
вытянет	Third person Singular
причалах	None
придерживаюсь	First person Singular
снимешь	Second person Singular
праславянские	None
пожелтеем	First person Plural
резкая	None
мобилизационна	None
атеизмы	None
алфавита	None
моргнув	None
проецируют	Third person Plural
продлеваем	First person Plural
лижет	Third person Singular
перемещает	Third person Singular
переименовывают	Third person Plural
распознав	None
утопический	None
ныряют	Third person Plural
поклянешься	Second person Singular
зомбируйте	Second person Plural
екнут	Third person Plural
чеши	Second person Singular
спрашивается	Third person Singular
приживается	Third person Singular
запрячешь	Second person Singular
мешает	Third person Singular
фотографируетесь	Second person Plural
греми	Second person Singular
слиняйте	Second person Plural
пенсионеркам	None
липовых	None
подведут	Third person Plural
синтаксическими	None
столетнему	None
бульварных	None
свинья	None
дежурят	Third person Plural
оградах	None
интерпретируете	Second person Plural
ботинку	None
присвоим	First person Plural
меряет	Third person Singular
нарушится	Third person Singular
справочнике	None
осложняет	Third person Singular
излишней	None
оттягивавший	None
запишутся	Third person Plural
манеже	None
накинут	Third person Plural
насвистывает	Third person Singular
презрения	None
завербовало	None
перетекают	Third person Plural
ограждению	None
передвигаются	Third person Plural
приводится	Third person Singular
поправь	Second person Singular
синтетического	None
электроэнергетике	None
воротничкам	None
сводятся	Third person Plural
выпадут	Third person Plural
преобразовывает	Third person Singular
попирают	Third person Plural
вылезает	Third person Singular
оборудуют	Third person Plural
комментируете	Second person Plural
устанавливаются	Third person Plural
исключается	Third person Singular
хронического	None
сгибается	Third person Singular
пальцевого	None
подправив	None
небылицы	None
выпирает	Third person Singular
подразделяется	Third person Singular
рисуйте	Second person Plural
комдив	None
загрузит	Third person Singular
связывается	Third person Singular
выработается	Third person Singular
разносим	First person Plural
сахара	None
молись	Second person Singular
выложим	First person Plural
убавим	First person Plural
обстреливаете	Second person Plural
дорожат	Third person Plural
соединяясь	None
грамматиками	None
свергнут	Third person Plural
желаемой	None
мчатся	Third person Plural
поддаётся	Third person Singular
вторгнется	Third person Singular
приплывает	Third person Singular
отравляйтесь	Second person Plural
захлёбываются	Third person Plural
выводит	Third person Singular
абиосестонов	None
брезгуют	Third person Plural
спортивное	None
посвятим	First person Plural
мечусь	First person Singular
бьюсь	First person Singular
покоряю	First person Singular
съездами	None
режиссёре	None
трактатов	None
снимаются	Third person Plural
списывают	Third person Plural
волоку	First person Singular
изменятся	Third person Plural
насыщаются	Third person Plural
образуются	Third person Plural
трансформируется	Third person Singular
камуфляж	None
обвивают	Third person Plural
подползает	Third person Singular
багровеет	Third person Singular
пропишешь	Second person Singular
развеваются	Third person Plural
юли	Second person Singular
промеров	None
пошлиной	None
вытирают	Third person Plural
базируется	Third person Singular
разведка	None
забиравшись	None
восторжествует	Third person Singular
слезоточивого	None
планетарным	None
вымена	None
выучивает	Third person Singular
возрастет	Third person Singular
предаётся	Third person Singular
трогает	Third person Singular
электричество	None
танцую	First person Singular
угадаешь	Second person Singular
разбуди	Second person Singular
грей	Second person Singular
приподнимают	Third person Plural
приспособите	Second person Plural
укореняешься	Second person Singular
ограничиваются	Third person Plural
получат	Third person Plural
каучукового	None
пилигримами	None
различает	Third person Singular
перемещу	First person Singular
приветствую	First person Singular
вытеснят	Third person Plural
инициативную	None
обменивает	Third person Singular
перекинут	Third person Plural
развозят	Third person Plural
обменивают	Third person Plural
доползаю	First person Singular
сравнит	Third person Singular
оккупирует	Third person Singular
ущельем	None
обжам	None
просачивается	Third person Singular
съедобных	None
блестят	Third person Plural
обхватывает	Third person Singular
похолодеете	Second person Plural
гонец	None
отклонит	Third person Singular
просуществует	Third person Singular
снабжает	Third person Singular
транслитерируем	First person Plural
населяют	Third person Plural
искажайте	Second person Plural
остановись	Second person Singular
сознаём	First person Plural
ссорит	Third person Singular
переработаете	Second person Plural
подымаются	Third person Plural
заблуждаются	Third person Plural
осваиваются	Third person Plural
различаются	Third person Plural
протона	None
прогуляйся	Second person Singular
штанги	None
отключит	Third person Singular
смешной	None
нагнетают	Third person Plural
очаровывает	Third person Singular
растворятся	Third person Plural
хвастается	Third person Singular
подливают	Third person Plural
привнесите	Second person Plural
ныряет	Third person Singular
оторопейте	Second person Plural
ленятся	Third person Plural
экспоната	None
машут	Third person Plural
получателя	None
апеллирую	First person Singular
откидывает	Third person Singular
руководствуются	Third person Plural
приспосабливается	Third person Singular
завёз	None
соляными	None
наивное	None
вложу	First person Singular
англосфер	None
приземлится	Third person Singular
программирует	Third person Singular
процитирую	First person Singular
заражаются	Third person Plural
вымирает	Third person Singular
подбросим	First person Plural
паспортному	None
изогнешь	Second person Singular
навешаете	Second person Plural
сниму	First person Singular
сорвешься	Second person Singular
мает	Third person Singular
подчинятся	Third person Plural
скрепляет	Third person Singular
гигиенического	None
составляется	Third person Singular
морщится	Third person Singular
отстраняется	Third person Singular
легитимное	None
противовирусные	None
среднестатистическое	None
треугольников	None
складывайте	Second person Plural
теряется	Third person Singular
унаследуют	Third person Plural
угадает	Third person Singular
лечебный	None
примечательном	None
расплющишь	Second person Singular
поклоняюсь	First person Singular
окаймлённым	None
бинту	None
прорывается	Third person Singular
потесним	First person Plural
фиксирует	Third person Singular
пасхой	None
разводи	Second person Singular
обоснуете	Second person Plural
баррикадах	None
легки	None
прорываются	Third person Plural
зарывайте	Second person Plural
повисает	Third person Singular
скажу	First person Singular
субсидирование	None
набив	None
станциях	None
пестиков	None
подкармливает	Third person Singular
покается	Third person Singular
растянется	Third person Singular
оговаривается	Third person Singular
поправлюсь	First person Singular
развёртывается	Third person Singular
присоединяется	Third person Singular
тверди	Second person Singular
ожесточённого	None
манжетах	None
вырывается	Third person Singular
регентши	None
хулиганят	Third person Plural
сочного	None
нерешительно	None
взбудоражит	Third person Singular
исполнится	Third person Singular
лепит	Third person Singular
торможу	First person Singular
режет	Third person Singular
оглядывается	Third person Singular
нанимается	Third person Singular
сплачивать	None
подготовлял	None
коровников	None
особыми	None
организуются	Third person Plural
отяготишь	Second person Singular
зевнув	None
попутный	None
командует	Third person Singular
встраивает	Third person Singular
извиняйте	Second person Plural
передёргивайте	Second person Plural
возобновит	Third person Singular
буллах	None
упаковывает	Third person Singular
придворные	None
обновится	Third person Singular
тру	First person Singular
законопослушную	None
охотишься	Second person Singular
созвучная	None
дослушает	Third person Singular
слагают	Third person Plural
подглядим	First person Plural
балакаешь	Second person Singular
венчается	Third person Singular
претерпит	Third person Singular
приостанавливается	Third person Singular
моют	Third person Plural
паллиативная	None
недопустимым	None
переменится	Third person Singular
полюбопытствуйте	Second person Plural
пустует	Third person Singular
кинь	Second person Singular
возможному	None
поднимут	Third person Plural
забросят	Third person Plural
подсчитаем	First person Plural
трудятся	Third person Plural
расчистим	First person Plural
дремлет	Third person Singular
невежественными	None
расслоением	None
выроете	Second person Plural
согласовывают	Third person Plural
излишествами	None
нашли	Second person Singular
засовываешь	Second person Singular
сложат	Third person Plural
пните	Second person Plural
определишься	Second person Singular
ампер-часа	None
мыслят	Third person Plural
волосков	None
расширятся	Third person Plural
позорят	Third person Plural
пополнит	Third person Singular
гниют	Third person Plural
подлетает	Third person Singular
астрономическим	None
отмериваем	First person Plural
зампред	None
обдайте	Second person Plural
райцентрах	None
жалуем	First person Plural
мимике	None
блистает	Third person Singular
заявка	None
отрыгивает	Third person Singular
обматывает	Third person Singular
втянут	Third person Plural
спроси	Second person Singular
проскальзывает	Third person Singular
ведущими	None
докучаю	First person Singular
выставляй	Second person Singular
спорное	None
выплеснут	Third person Plural
озабочиваюсь	First person Singular
цистернами	None
бакинском	None
трём	First person Plural
крушат	Third person Plural
расстреливают	Third person Plural
пожалеете	Second person Plural
гребут	Third person Plural
ругаюсь	First person Singular
наихудшего	None
ройся	Second person Singular
конфуз	None
передаётся	Third person Singular
верившийся	None
помолимся	First person Plural
выдержи	Second person Singular
сотворят	Third person Plural
умолчу	First person Singular
закладывает	Third person Singular
побьют	Third person Plural
отваливавшийся	None
наталкивает	Third person Singular
варьируются	Third person Plural
передвижные	None
грядут	Third person Plural
позаботится	Third person Singular
повторится	Third person Singular
счётного	None
огорчайтесь	Second person Plural
возлагает	Third person Singular
лазают	Third person Plural
непривычны	None
месят	Third person Plural
лезете	Second person Plural
боготворит	Third person Singular
прибьет	Third person Singular
поощряюсь	First person Singular
архивируют	Third person Plural
накидывайтесь	Second person Plural
окопам	None
вывести	None
приюте	None
регламентируют	Third person Plural
уляжется	Third person Singular
голубчик	None
отвязывалась	None
путешествуем	First person Plural
повешусь	First person Singular
удосужится	Third person Singular
передаются	Third person Plural
принудит	Third person Singular
преуспевать	None
приходов	None
калим	First person Plural
посвящу	First person Singular
четырёхзвёздным	None
первоочередному	None
помеха	None
ослабит	Third person Singular
репродукциям	None
прикладывается	Third person Singular
марширует	Third person Singular
отслуживаемый	None
посоветуюсь	First person Singular
рею	First person Singular
пронизывают	Third person Plural
плетут	Third person Plural
обветри	Second person Singular
соизволит	Third person Singular
отразим	First person Plural
поршня	None
веруем	First person Plural
белей	Second person Singular
пугайте	Second person Plural
распространяется	Third person Singular
продолжатся	Third person Plural
усложняет	Third person Singular
африканец	None
чутьём	None
резонному	None
синей	Second person Singular
глотает	Third person Singular
вывешивают	Third person Plural
противопоставления	None
оговорку	None
спрашивают	Third person Plural
затронет	Third person Singular
приседает	Third person Singular
горюй	Second person Singular
оговаривает	Third person Singular
остановимся	First person Plural
криминальна	None
размазывает	Third person Singular
налаживается	Third person Singular
испускает	Third person Singular
удостоверяешься	Second person Singular
возымеет	Third person Singular
уплачивает	Third person Singular
воплотится	Third person Singular
агитирует	Third person Singular
путеводителем	None
стишок	None
житейскую	None
мякинами	None
скатывался	None
гармонирует	Third person Singular
внешнеэкономического	None
выстрадаем	First person Plural
пояснив	None
очерти	Second person Singular
проецирует	Third person Singular
готовлю	First person Singular
передумает	Third person Singular
прадедом	None
округляет	Third person Singular
хуйнёй	None
сглаживает	Third person Singular
прикалываются	Third person Plural
верую	First person Singular
осуществляясь	None
склоняют	Third person Plural
зачислением	None
спрашиваю	First person Singular
вышивают	Third person Plural
выдерживай	Second person Singular
сорви	Second person Singular
вянут	Third person Plural
настройках	None
начисляет	Third person Singular
строятся	Third person Plural
кольцевым	None
рангоутом	None
примется	Third person Singular
слопайте	Second person Plural
славянках	None
кройтесь	Second person Plural
связующему	None
смешивает	Third person Singular
повстречаешься	Second person Singular
конкурируют	Third person Plural
сравним	First person Plural
посоветуетесь	Second person Plural
зиждемся	First person Plural
подкрепляет	Third person Singular
ослабеем	First person Plural
скрою	First person Singular
проткнул	None
фашистскому	None
гармошек	None
дострою	First person Singular
возносилось	None
бурунов	None
греет	Third person Singular
прибивает	Third person Singular
рейхах	None
восприятиями	None
выводим	First person Plural
езжу	First person Singular
ухает	Third person Singular
сжимает	Third person Singular
недоумённых	None
русификации	None
наслаждаются	Third person Plural
каной	None
отмечаюсь	First person Singular
допрашиваем	First person Plural
пристрой	Second person Singular
заложи	Second person Singular
королевств	None
снесет	Third person Singular
тревожит	Third person Singular
подбрасывает	Third person Singular
несторианство	None
ураган	None
гордостью	None
перекроют	Third person Plural
заглавиях	None
ядовитую	None
выпадешь	Second person Singular
нагорное	None
хвалю	First person Singular
сражается	Third person Singular
отвешивает	Third person Singular
выслушаю	First person Singular
спустится	Third person Singular
зверинцев	None
доработаю	First person Singular
квалификационным	None
соотносят	Third person Plural
прослушивает	Third person Singular
тони	Second person Singular
ознобом	None
промежуточного	None
проповедникам	None
продвигаются	Third person Plural
белогвардейца	None
наделяет	Third person Singular
вваливается	Third person Singular
откладываются	Third person Plural
сурьмы	None
рецензий	None
синтезаторами	None
возродилось	None
осиротейте	Second person Plural
заядлой	None
смажь	Second person Singular
клевещут	Third person Plural
оживет	Third person Singular
экологом	None
мучает	Third person Singular
вскрывает	Third person Singular
стесняешь	Second person Singular
отравив	None
отступления	None
потягивают	Third person Plural
резной	None
аккомпанирует	Third person Singular
разнимают	Third person Plural
всплывает	Third person Singular
препятствуют	Third person Plural
обдумывает	Third person Singular
насыщает	Third person Singular
позабочусь	First person Singular
циркулируют	Third person Plural
дозволят	Third person Plural
поженимся	First person Plural
объявляется	Third person Singular
клубную	None
обрушится	Third person Singular
запасы	None
освящает	Third person Singular
прислушивается	Third person Singular
прибавлю	First person Singular
резвятся	Third person Plural
цари	Second person Singular
экспрессию	None
просветлейте	Second person Plural
изгоняет	Third person Singular
финансируется	Third person Singular
локализует	Third person Singular
вскрикивает	Third person Singular
угадывает	Third person Singular
постановщика	None
пересели	Second person Singular
вычитывает	Third person Singular
укореняются	Third person Plural
разногласием	None
затолкаем	First person Plural
делай	Second person Singular
тегов	None
заправь	Second person Singular
стерпит	Third person Singular
созреем	First person Plural
эксцентрик	None
беспорядок	None
подступов	None
кортежей	None
мешали	None
иссякают	Third person Plural
влаги	None
переливается	Third person Singular
отвязываетесь	Second person Plural
отнеси	Second person Singular
делаем	First person Plural
оздоровлять	None
хамят	Third person Plural
заколдовывает	Third person Singular
благословляет	Third person Singular
регистрирует	Third person Singular
минимизирует	Third person Singular
малокровия	None
привлекаются	Third person Plural
смещает	Third person Singular
анкета	None
воплощается	Third person Singular
протаскивать	None
носящий	None
запечатывают	Third person Plural
заменится	Third person Singular
тяготеют	Third person Plural
сочетаются	Third person Plural
охранники	None
воспроизводит	Third person Singular
закалывает	Third person Singular
розоватый	None
одумается	Third person Singular
делят	Third person Plural
переключатся	Third person Plural
избавляет	Third person Singular
вибрирует	Third person Singular
ухудшат	Third person Plural
болтается	Third person Singular
скорректирует	Third person Singular
размещаю	First person Singular
завещает	Third person Singular
примечаем	First person Plural
вселяется	Third person Singular
общими	None
разрез	None
татар	None
параллельной	None
логистической	None
лечению	None
смени	Second person Singular
изуми	Second person Singular
подпадаете	Second person Plural
обусловленному	None
дёшево	None
аутингам	None
отменяются	Third person Plural
инвесторов	None
высвобождаю	First person Singular
отвратителен	None
выдвинет	Third person Singular
отстраняет	Third person Singular
выключают	Third person Plural
пролезает	Third person Singular
упрощает	Third person Singular
забрызжи	Second person Singular
измеришься	Second person Singular
разбрасывает	Third person Singular
повтором	None
разгоняется	Third person Singular
грибными	None
затягивается	Third person Singular
реем	First person Plural
фобией	None
развеет	Third person Singular
тревожат	Third person Plural
пустеет	Third person Singular
покрышкой	None
приспосабливаются	Third person Plural
цепляют	Third person Plural
достанется	Third person Singular
княжества	None
перешагивали	None
маячками	None
перечислишь	Second person Singular
помещаю	First person Singular
возобновят	Third person Plural
рассыпается	Third person Singular
радиоаппарата	None
притягивает	Third person Singular
умолкнет	Third person Singular
проскользнете	Second person Plural
протёрший	None
предчувствуете	Second person Plural
втыкают	Third person Plural
уведомляю	First person Singular
претендентов	None
иллюстрирую	First person Singular
законность	None
ввезут	Third person Plural
явствует	Third person Singular
предсказываю	First person Singular
зажигаются	Third person Plural
удивятся	Third person Plural
отъявленному	None
возродится	Third person Singular
слейте	Second person Plural
опустился	None
высвобождает	Third person Singular
незамеченная	None
регистрируйте	Second person Plural
подшучивают	Third person Plural
упомяните	Second person Plural
кормят	Third person Plural
связываются	Third person Plural
выползают	Third person Plural
пожертвует	Third person Singular
проясняется	Third person Singular
госпитализируют	Third person Plural
трогаю	First person Singular
конфликтна	None
обозначу	First person Singular
преобразится	Third person Singular
активную	None
прикрепляются	Third person Plural
затыкай	Second person Singular
усовершенствуешь	Second person Singular
набредешь	Second person Singular
меряем	First person Plural
подступают	Third person Plural
мантрой	None
набегу	First person Singular
соотносится	Third person Singular
вникает	Third person Singular
концепт	None
фреска	None
свирепствуют	Third person Plural
иллюстрируют	Third person Plural
дискретна	None
бекасы	None
убийственного	None
кровати	None
избивает	Third person Singular
правь	Second person Singular
виднеется	Third person Singular
запасался	None
броды	None
взойди	Second person Singular
транссексуале	None
снимутся	Third person Plural
разоряются	Third person Plural
подрабатывает	Third person Singular
отпугни	Second person Singular
финишируют	Third person Plural
вырабатывается	Third person Singular
отправляйтесь	Second person Plural
наводка	None
оботру	First person Singular
работаем	First person Plural
ищем	First person Plural
развращайте	Second person Plural
доросший	None
ездит	Third person Singular
персональными	None
обвенчались	None
неисчерпаемую	None
крестят	Third person Plural
развратила	None
взваливаете	Second person Plural
выдаст	Third person Singular
этруском	None
отблагодарила	None
отведётся	Third person Singular
заводятся	Third person Plural
исключаются	Third person Plural
валяются	Third person Plural
навязываю	First person Singular
врей	Second person Singular
прослежу	First person Singular
мыслителей	None
удостаивались	None
сочи	Second person Singular
габаритами	None
додумается	Third person Singular
меркнем	First person Plural
констатирую	First person Singular
уделяем	First person Plural
горячность	None
затрагиваетесь	Second person Plural
годного	None
обновляет	Third person Singular
проскакивают	Third person Plural
вбейте	Second person Plural
переигрывают	Third person Plural
гусиными	None
умещаются	Third person Plural
смахивает	Third person Singular
разблокируйте	Second person Plural
высчитайте	Second person Plural
наткнутся	Third person Plural
остудят	Third person Plural
растекаешься	Second person Singular
дополненный	None
ухмыльнусь	First person Singular
берегут	Third person Plural
усматривает	Third person Singular
тревожь	Second person Singular
расчётные	None
постановляют	Third person Plural
втекает	Third person Singular
голодай	Second person Singular
увязывают	Third person Plural
жрецов	None
познаёт	Third person Singular
вздымаются	Third person Plural
отобьюсь	First person Singular
кожную	None
расчётливая	None
примыкающее	None
налепляли	None
руководствуетесь	Second person Plural
оправляется	Third person Singular
хирургий	None
приближает	Third person Singular
ссылают	Third person Plural
молодеет	Third person Singular
посоветуйтесь	Second person Plural
усадьбам	None
простою	First person Singular
выворачивается	Third person Singular
скомбинируют	Third person Plural
вменяя	None
устраивается	Third person Singular
скопируй	Second person Singular
налетают	Third person Plural
отыщется	Third person Singular
расцвету	First person Singular
предвидите	Second person Plural
склоняетесь	Second person Plural
преграждают	Third person Plural
заточают	Third person Plural
выпускаются	Third person Plural
грузятся	Third person Plural
ускользни	Second person Singular
перенаселением	None
пустим	First person Plural
дописываю	First person Singular
манит	Third person Singular
выжидают	Third person Plural
развяжет	Third person Singular
разрывается	Third person Singular
консенсус	None
излучение	None
воображают	Third person Plural
опроса	None
упирают	Third person Plural
вспоминаются	Third person Plural
прикоснись	Second person Singular
скребётся	Third person Singular
прогуливает	Third person Singular
сплачивает	Third person Singular
чтит	Third person Singular
стрелковыми	None
прикрепляешь	Second person Singular
казнит	Third person Singular
отстреливается	Third person Singular
дорожит	Third person Singular
вытряхнет	Third person Singular
наделении	None
жевательному	None
надстраиваются	Third person Plural
разгуливает	Third person Singular
обостряет	Third person Singular
отпрашиваюсь	First person Singular
пивным	None
колетесь	Second person Plural
собственноручным	None
выхлопа	None
внедрятся	Third person Plural
проигнорирует	Third person Singular
переименовывает	Third person Singular
зверинца	None
сломаются	Third person Plural
удостаиваются	Third person Plural
теплится	Third person Singular
ювелирное	None
Хезболла	None
своднях	None
кройся	Second person Singular
недосчитывает	Third person Singular
слежку	None
поболтаете	Second person Plural
обосновываю	First person Singular
разгуливают	Third person Plural
суспензориям	None
моделируют	Third person Plural
пройдитесь	Second person Plural
возносит	Third person Singular
садимся	First person Plural
спешиться	None
дымовое	None
доживут	Third person Plural
тлей	Second person Singular
судьбоносных	None
прорезываете	Second person Plural
онтологий	None
прихватывает	Third person Singular
мажет	Third person Singular
толкают	Third person Plural
инициализирует	Third person Singular
сменяются	Third person Plural
коллекционируют	Third person Plural
чистят	Third person Plural
наслаждайтесь	Second person Plural
суммирую	First person Singular
видимая	None
кроешь	Second person Singular
бастион	None
волнуют	Third person Plural
потонет	Third person Singular
кормится	Third person Singular
советоваться	None
влипает	Third person Singular
ослабят	Third person Plural
зеленеют	Third person Plural
греются	Third person Plural
озвучит	Third person Singular
пересылает	Third person Singular
цыгану	None
осваиваю	First person Singular
вероломствами	None
байдара	None
помашем	First person Plural
капает	Third person Singular
изготавливаются	Third person Plural
выберется	Third person Singular
повалятся	Third person Plural
властвуй	Second person Singular
прядут	Third person Plural
лихорадите	Second person Plural
урной	None
варьирует	Third person Singular
расплачиваются	Third person Plural
наклоняют	Third person Plural
затаиваешь	Second person Singular
прижимается	Third person Singular
микробиология	None
разнимает	Third person Singular
угоняет	Third person Singular
моавитянам	None
тайных	None
рычит	Third person Singular
засчитывают	Third person Plural
патрулирует	Third person Singular
прорастает	Third person Singular
прикинь	Second person Singular
обрывов	None
сагитирует	Third person Singular
звени	Second person Singular
закручиваются	Third person Plural
заверещат	Third person Plural
контрразведку	None
выравнивает	Third person Singular
издеваетесь	Second person Plural
тошнит	Third person Singular
подменяет	Third person Singular
наказывается	Third person Singular
держусь	First person Singular
маскирует	Third person Singular
выдаётся	Third person Singular
порочат	Third person Plural
учти	Second person Singular
целует	Third person Singular
простреливаете	Second person Plural
толку	First person Singular
удивляюсь	First person Singular
повергаете	Second person Plural
пробаси	Second person Singular
взимаются	Third person Plural
составляются	Third person Plural
грею	First person Singular
симпатизирую	First person Singular
обстреливают	Third person Plural
соотнесите	Second person Plural
насморкам	None
обыгрывают	Third person Plural
претворяй	Second person Singular
достаюсь	First person Singular
сгоняют	Third person Plural
пребудет	Third person Singular
шалим	First person Plural
раздают	Third person Plural
раскалываются	Third person Plural
затаивается	Third person Singular
заглядываете	Second person Plural
одинаковой	None
дорабатываю	First person Singular
регулируются	Third person Plural
оглобли	None
отнесите	Second person Plural
дремлют	Third person Plural
напечатают	Third person Plural
рижский	None
утапливаете	Second person Plural
трутся	Third person Plural
обретают	Third person Plural
спрашивает	Third person Singular
усиленно	None
подвешивают	Third person Plural
выращивают	Third person Plural
мироощущения	None
исландским	None
исправится	Third person Singular
свершится	Third person Singular
иллюстрирует	Third person Singular
жокейская	None
изготавливают	Third person Plural
сочтите	Second person Plural
хвастаются	Third person Plural
смести	Second person Singular
трогают	Third person Plural
простуде	None
замедлит	Third person Singular
разблокирует	Third person Singular
раздуется	Third person Singular
трезвых	None
самодержавной	None
бол	None
расставляете	Second person Plural
покиваю	First person Singular
форсирует	Third person Singular
удваивают	Third person Plural
крупнокалиберный	None
маршал	None
величавший	None
колосса	None
бережёт	Third person Singular
сочувствуют	Third person Plural
рубахе	None
пощади	Second person Singular
отделим	First person Plural
подошва	None
хихикаете	Second person Plural
выцветут	Third person Plural
цилиндрическую	None
пожилое	None
убудет	Third person Singular
отмораживая	None
тёлках	None
настраивают	Third person Plural
учитываются	Third person Plural
стыдятся	Third person Plural
печорами	None
поднимайте	Second person Plural
переделают	Third person Plural
лелей	Second person Singular
верни	Second person Singular
добреем	First person Plural
карликовы	None
прилягу	First person Singular
расходуйтесь	Second person Plural
критикуете	Second person Plural
самодостаточными	None
подстранице	None
пороюсь	First person Singular
восстановится	Third person Singular
отваживаю	First person Singular
выливается	Third person Singular
концентрирует	Third person Singular
графическими	None
лоббирует	Third person Singular
переполнен	None
Бронкса	None
распишет	Third person Singular
скорби	Second person Singular
реет	Third person Singular
застревают	Third person Plural
охладели	None
наталкивается	Third person Singular
критикуйте	Second person Plural
профильного	None
подпускаете	Second person Plural
обстоит	Third person Singular
восполняют	Third person Plural
сформулируете	Second person Plural
баллотируюсь	First person Singular
протестует	Third person Singular
притвора	None
дробовики	None
переоцениваете	Second person Plural
азов	None
земляками	None
застлали	None
удаляюсь	First person Singular
выменяли	None
построй	Second person Singular
прихлопнув	None
предстанут	Third person Plural
выдохнемся	First person Plural
замучаюсь	First person Singular
вливают	Third person Plural
созерцает	Third person Singular
опубликую	First person Singular
воздвигает	Third person Singular
предопределяют	Third person Plural
навреди	Second person Singular
производятся	Third person Plural
поспособствует	Third person Singular
обоснует	Third person Singular
анофелесы	None
затаивайте	Second person Plural
напяливай	Second person Singular
протисните	Second person Plural
перегибаюсь	First person Singular
объявится	Third person Singular
нанимает	Third person Singular
поглощают	Third person Plural
возношусь	First person Singular
вызываются	Third person Plural
ознакомится	Third person Singular
сужает	Third person Singular
исцарапайте	Second person Plural
отпихнешь	Second person Singular
пересекаемся	First person Plural
нащупывай	Second person Singular
озираются	Third person Plural
отстреливаются	Third person Plural
прослойками	None
муравьиными	None
прокомментирую	First person Singular
затвердевает	Third person Singular
летит	Third person Singular
ткачам	None
катав	None
пакту	None
предоставляются	Third person Plural
терпимой	None
уволились	None
мобилизуешь	Second person Singular
набитую	None
аятолле	None
расцениваете	Second person Plural
мшим	First person Plural
работают	Third person Plural
пополнилось	None
косишься	Second person Singular
седле	None
изобретаем	First person Plural
додумывает	Third person Singular
виртуозная	None
маоизма	None
цитирует	Third person Singular
изобретали	None
люцернам	None
союзное	None
магазином	None
разбудит	Third person Singular
лезьте	Second person Plural
реальности	None
амбулаторным	None
поэмой	None
сгибает	Third person Singular
безудержное	None
претворяются	Third person Plural
хочется	Third person Singular
процитируете	Second person Plural
высаживают	Third person Plural
предсказуемыми	None
продирайтесь	Second person Plural
свиснет	Third person Singular
педелях	None
возносились	None
воссоединяет	Third person Singular
товарищ	None
пропали	Second person Singular
претенциозная	None
позабудь	Second person Singular
господствуют	Third person Plural
договаривается	Third person Singular
стремится	Third person Singular
якорных	None
гладит	Third person Singular
осложнит	Third person Singular
гуглим	First person Plural
отвлекут	Third person Plural
окрестная	None
выкидывает	Third person Singular
винодельческие	None
влюбчивом	None
оборачивают	Third person Plural
пробежит	Third person Singular
прибавляются	Third person Plural
кишечного	None
расставим	First person Plural
смотришь	Second person Singular
покрывает	Third person Singular
достраивают	Third person Plural
генсеков	None
машем	First person Plural
кляни	Second person Singular
рогачей	None
выполняется	Third person Singular
присоединяют	Third person Plural
инициирует	Third person Singular
издеваются	Third person Plural
напряжённом	None
обрушиваешься	Second person Singular
подставляют	Third person Plural
сгоняем	First person Plural
неложного	None
отрубят	Third person Plural
титульному	None
вытесняет	Third person Singular
верши	Second person Singular
перистым	None
прощу	First person Singular
подвозит	Third person Singular
продержится	Third person Singular
ближневосточного	None
полномочный	None
относительную	None
заполошные	None
заливай	Second person Singular
проголосует	Third person Singular
конфликтует	Third person Singular
познаем	First person Plural
карай	Second person Singular
договаривай	Second person Singular
надумаете	Second person Plural
мерит	Third person Singular
крутившись	None
придерживаются	Third person Plural
аддонах	None
неточностям	None
снегопад	None
претворяется	Third person Singular
импортирует	Third person Singular
покаюсь	First person Singular
рассеивают	Third person Plural
растекись	Second person Singular
устареют	Third person Plural
ознакомитесь	Second person Plural
поправят	Third person Plural
трясут	Third person Plural
распределятся	Third person Plural
анализируется	Third person Singular
отделит	Third person Singular
сломит	Third person Singular
витайте	Second person Plural
являют	Third person Plural
узакониваете	Second person Plural
соединительным	None
сошлется	Third person Singular
прикидывать	None
делает	Third person Singular
исцели	Second person Singular
погаснет	Third person Singular
интерпретирует	Third person Singular
стирайте	Second person Plural
выкрикивает	Third person Singular
свергнешь	Second person Singular
подозревает	Third person Singular
назрело	None
стремлюсь	First person Singular
сократятся	Third person Plural
приставляют	Third person Plural
полощут	Third person Plural
прогони	Second person Singular
неизмеримых	None
звавшись	None
наврежу	First person Singular
пропускная	None
отлетает	Third person Singular
навещают	Third person Plural
расценивает	Third person Singular
вравший	None
продвинутся	Third person Plural
приязнях	None
расправляется	Third person Singular
расслабьтесь	Second person Plural
сократится	Third person Singular
увивается	Third person Singular
запятую	None
выпускается	Third person Singular
пережидают	Third person Plural
дрека	None
бытует	Third person Singular
диспутируют	Third person Plural
застилаем	First person Plural
возмещает	Third person Singular
боксирует	Third person Singular
развеивают	Third person Plural
преувеличивают	Third person Plural
фламандскими	None
просчитывай	Second person Singular
взимается	Third person Singular
замороженный	None
взыщешь	Second person Singular
сжалься	Second person Singular
изумляет	Third person Singular
трепещу	First person Singular
взорвется	Third person Singular
разваливаются	Third person Plural
подглядывает	Third person Singular
красит	Third person Singular
лицевое	None
заботит	Third person Singular
преувеличиваю	First person Singular
советуются	Third person Plural
выпрыгивают	Third person Plural
взвейтесь	Second person Plural
части	Second person Singular
трактуем	First person Plural
присоединюсь	First person Singular
накладывают	Third person Plural
вооружаются	Third person Plural
внятную	None
расходовал	None
вырабатывают	Third person Plural
предчувствует	Third person Singular
битумов	None
придерживаю	First person Singular
обдирает	Third person Singular
лизнет	Third person Singular
разгораются	Third person Plural
упираемся	First person Plural
бесят	Third person Plural
гадает	Third person Singular
гнётесь	Second person Plural
распишитесь	Second person Plural
выкидываем	First person Plural
убирайтесь	Second person Plural
расстилаю	First person Singular
подыскивать	None
проследовал	None
погоди	Second person Singular
улучшается	Third person Singular
прижимались	None
дремлю	First person Singular
зазовите	Second person Plural
обдумаю	First person Singular
обрекает	Third person Singular
ослабляют	Third person Plural
термоядерной	None
ничтожные	None
пугают	Third person Plural
утекает	Third person Singular
перерабатывайте	Second person Plural
отвергаю	First person Singular
невмешательства	None
индексирует	Third person Singular
списка	None
скатится	Third person Singular
командирует	Third person Singular
отважен	None
отяготят	Third person Plural
новаторского	None
сдувает	Third person Singular
дотягивает	Third person Singular
парапета	None
спорит	Third person Singular
ловит	Third person Singular
четырёхручная	None
прокручиваешь	Second person Singular
высится	Third person Singular
ждёт	Third person Singular
лапой	None
вопросительной	None
гнилом	None
ресурсное	None
насекомому	None
обтекать	None
вепс	None
отдали	Second person Singular
смягчала	None
вытащишь	Second person Singular
подключает	Third person Singular
санатория	None
высыхает	Third person Singular
антибиотику	None
мусульманам	None
поживем	First person Plural
обслуживаете	Second person Plural
сверяют	Third person Plural
коченевший	None
отвлекаете	Second person Plural
заблокирует	Third person Singular
чувствуются	Third person Plural
карбюратора	None
облагается	Third person Singular
нацеливаешь	Second person Singular
бомбардируют	Third person Plural
присматривается	Third person Singular
отрекаюсь	First person Singular
опрокинут	Third person Plural
сумасшедшим	None
листает	Third person Singular
приёмок	None
прибавим	First person Plural
дернется	Third person Singular
промышляет	Third person Singular
оскорбляешь	Second person Singular
изгибаются	Third person Plural
перерыве	None
зияют	Third person Plural
подсластитель	None
горнякам	None
пасхальные	None
зияет	Third person Singular
менталитета	None
требовался	None
сразится	Third person Singular
зарастают	Third person Plural
прислушайтесь	Second person Plural
перечёркивает	Third person Singular
сообщается	Third person Singular
выжигает	Third person Singular
характеризует	Third person Singular
ортодоксальным	None
обстреливает	Third person Singular
обязывайтесь	Second person Plural
рубленный	None
перекинулось	None
ухаете	Second person Plural
фонетического	None
влекло	None
гранит	Third person Singular
прибавляют	Third person Plural
переработает	Third person Singular
разоришься	Second person Singular
простоят	Third person Plural
раскольник	None
ростовщицах	None
тускнеют	Third person Plural
отвергаете	Second person Plural
австралам	None
обломит	Third person Singular
воющий	None
ковыляй	Second person Singular
копается	Third person Singular
провалит	Third person Singular
распишите	Second person Plural
версия	None
плюёт	Third person Singular
инкубирует	Third person Singular
архивируй	Second person Singular
помещают	Third person Plural
обогащают	Third person Plural
заблокирую	First person Singular
копирует	Third person Singular
опрокидывается	Third person Singular
сочно	None
сольному	None
знаменует	Third person Singular
характеризуете	Second person Plural
покусится	Third person Singular
приспособление	None
сражаются	Third person Plural
раздуваются	Third person Plural
фельетонам	None
введите	Second person Plural
соединятся	Third person Plural
набиваются	Third person Plural
увядает	Third person Singular
живу	First person Singular
калмыцкие	None
заслоняют	Third person Plural
завезет	Third person Singular
суммирует	Third person Singular
извиняю	First person Singular
вымирают	Third person Plural
орудуем	First person Plural
свергают	Third person Plural
возвысишь	Second person Singular
подрастают	Third person Plural
разоряют	Third person Plural
прохрипит	Third person Singular
затолкните	Second person Plural
смотрятся	Third person Plural
мерзости	None
подходах	None
мели	Second person Singular
развязывает	Third person Singular
отстоит	Third person Singular
помолчу	First person Singular
погружают	Third person Plural
водружает	Third person Singular
совладала	None
кивают	Third person Plural
заглохнет	Third person Singular
заставы	None
пою	First person Singular
удостоверяю	First person Singular
очищается	Third person Singular
выбиваются	Third person Plural
бедуинами	None
смутит	Third person Singular
оберегаешь	Second person Singular
обостряют	Third person Plural
сбываются	Third person Plural
сошлитесь	Second person Plural
погубит	Third person Singular
перевезу	First person Singular
смысловым	None
хлещет	Third person Singular
жизнеспособная	None
кастрациях	None
испарится	Third person Singular
оглядимся	First person Plural
маршируют	Third person Plural
пристрелю	First person Singular
опубликовывает	Third person Singular
мотает	Third person Singular
месит	Third person Singular
оттесняет	Third person Singular
прикреплю	First person Singular
коренном	None
зажарим	First person Plural
бросаетесь	Second person Plural
штемпелем	None
втягиваются	Third person Plural
хитростях	None
корректируйте	Second person Plural
мерещится	Third person Singular
отвлекает	Third person Singular
тешит	Third person Singular
лопаются	Third person Plural
тяжелел	None
моем	First person Plural
пекутся	Third person Plural
спазмотологию	None
подмигивает	Third person Singular
неудержимым	None
подправлю	First person Singular
подготавливаюсь	First person Singular
талантами	None
наедете	Second person Plural
прослеживаются	Third person Plural
приготовляется	Third person Singular
шевельнет	Third person Singular
картёжником	None
причинят	Third person Plural
ругает	Third person Singular
заступив	None
пропагандирует	Third person Singular
отслеживают	Third person Plural
замещают	Third person Plural
формулированием	None
почтили	None
блесну	First person Singular
чащу	First person Singular
разбухнет	Third person Singular
оранжерею	None
окатываю	First person Singular
ссылается	Third person Singular
смеете	Second person Plural
задумываюсь	First person Singular
въезжают	Third person Plural
печалься	Second person Singular
играются	Third person Plural
инвентарём	None
разлетается	Third person Singular
верните	Second person Plural
верите	Second person Plural
формализмов	None
неприязни	None
подсовываете	Second person Plural
похвалишь	Second person Singular
вини	Second person Singular
дрейфуют	Third person Plural
вставив	None
чихает	Third person Singular
оформляются	Third person Plural
отлучается	Third person Singular
энергичность	None
досчитываемся	First person Plural
обоснованию	None
ужесточают	Third person Plural
перекликает	Third person Singular
передёргивай	Second person Singular
ознаменует	Third person Singular
диви	Second person Singular
мелькает	Third person Singular
носятся	Third person Plural
мстят	Third person Plural
посмеются	Third person Plural
заинтересуются	Third person Plural
ракового	None
покатаются	Third person Plural
дадимся	First person Plural
спотыкается	Third person Singular
квантовую	None
акцентирую	First person Singular
нарастает	Third person Singular
серотонином	None
донос	None
мочится	Third person Singular
переселяется	Third person Singular
прогоняет	Third person Singular
погостишь	Second person Singular
свети	Second person Singular
высыхают	Third person Plural
обгладывайте	Second person Plural
начнутся	Third person Plural
преувеличивайте	Second person Plural
бросаются	Third person Plural
расправь	Second person Singular
отличим	First person Plural
перерабатывал	None
имбецил	None
приклеивается	Third person Singular
играешь	Second person Singular
начальнице	None
подставляет	Third person Singular
узаконивает	Third person Singular
заклинивает	Third person Singular
сохнет	Third person Singular
стеснительные	None
отметится	Third person Singular
