fasadami	Noun
wątkiem	Noun
połączeniach	Noun
żab	Noun
szukajcie	Verb
rozważana	Participle
hutami	Noun
karałyby	Verb
karłach	Noun
piłeczek	Noun
naczyniem	Noun
wyglądasz	Verb
trzaskałam	Verb
wielorybów	Noun
bladymi	Adjective
parabola	Noun
nosa	Noun
malutcy	Adjective
akacjami	Noun
podaliśmy	Verb
pszczelarzach	Noun
patologią	Noun
eksperymentami	Noun
wkrętu	Noun
pozwalałaby	Verb
faktach	Noun
lakierami	Noun
rybkę	Noun
aldehydem	Noun
działaczkami	Noun
iskałam	Verb
Duńczykami	Noun
wyrzuci	Verb
wymyślałem	Verb
daj	Verb
kłamią	Verb
prowitamina	Noun
sypialnia	Noun
obudów	Noun
grzbietów	Noun
zbierając	Converb
kultach	Noun
fioletom	Noun
dziobią	Verb
koncertami	Noun
miazgą	Noun
sakramentowi	Noun
przeczytamy	Verb
grabach	Noun
zrabowałabym	Verb
wskażesz	Verb
innowacjom	Noun
bramą	Noun
opróżniłby	Verb
łóżkom	Noun
stawiałaby	Verb
przekwitania	Noun
narciarz	Noun
przepisów	Noun
złożyłaby	Verb
słysz	Verb
prostytutkom	Noun
mijają	Verb
kawiarenek	Noun
odpadami	Noun
rozruszników	Noun
zaproś	Verb
adresach	Noun
latać	Verb
martenzytami	Noun
najodpowiedniejsza	Adjective
pustyniach	Noun
promocję	Noun
skurwysynami	Noun
gałkę	Noun
biurowcach	Noun
skrótowca	Noun
delegatowi	Noun
budowami	Noun
trawko	Noun
pomagał	Verb
poganom	Noun
androidów	Noun
radiowymi	Adjective
odpoczywałeś	Verb
grzbietem	Noun
słuchałybyśmy	Verb
chrabąszczach	Noun
żelbetowymi	Adjective
kroplą	Noun
pieśnią	Noun
flotą	Noun
razowi	Noun
gruntu	Noun
pamiętaj	Verb
tygrysem	Noun
elipsę	Noun
myśliwca	Noun
żółtawymi	Adjective
wyjaśniany	Participle
szczerząc	Participle
topolą	Noun
Macedończykom	Noun
fabułę	Noun
łamałby	Verb
pralinami	Noun
rozpuszczalnikach	Noun
kochani	Participle
podany	Participle
przysłowiami	Noun
zwymyślało	Verb
poprzedzała	Verb
poproszenie	Masdar
szkop	Noun
przygotuj	Verb
gotowałybyśmy	Verb
wyrzuciło	Verb
rasistką	Noun
upokorzeń	Noun
szczypiornisty	Noun
przekonaniem	Noun
stanikiem	Noun
puszkami	Noun
kleiła	Verb
wspólnotami	Noun
kompasami	Noun
miska	Noun
elit	Noun
unikatowymi	Adjective
rekonstrukcję	Noun
płynąłeś	Verb
gadająca	Participle
milsza	Adjective
psychologio	Noun
subtropikalna	Adjective
obserwowani	Participle
rozważać	Verb
bankomatem	Noun
szampanem	Noun
barwami	Noun
eposem	Noun
pomagamy	Verb
turystą	Noun
ekspert	Noun
żyrafą	Noun
mrozami	Noun
prozopagnozją	Noun
tautologią	Noun
wyłudzam	Verb
służbom	Noun
procesu	Noun
wymyśliły	Verb
relacja	Noun
Szwedom	Noun
Kanadyjczykami	Noun
wazelino	Noun
jednostka	Noun
suriekcją	Noun
drażniło	Verb
wdychany	Participle
energiach	Noun
kotu	Noun
kolcach	Noun
oszukiwać	Verb
skakanką	Noun
dziobakach	Noun
broszurą	Noun
jasnożółtymi	Adjective
powiekach	Noun
wierzyli	Verb
unika	Verb
trzustkami	Noun
oddałam	Verb
porozmawiałbym	Verb
dioptrię	Noun
bawołami	Noun
odlotów	Noun
kanarkami	Noun
paczko	Noun
raciborscy	Adjective
kwestionujemy	Verb
złupienie	Masdar
płacąc	Converb
pękała	Verb
urzędów	Noun
tuzinów	Noun
belka	Noun
kwadratu	Noun
pytając	Converb
gejszą	Noun
dudek	Noun
potopem	Noun
rowerzystę	Noun
apoteoza	Noun
podpaleniami	Noun
bliźnięciem	Noun
rytmami	Noun
cielskom	Noun
wyłączników	Noun
ruszałybyście	Verb
dawszy	Converb
zbiegało	Verb
partykułach	Noun
wiecznymi	Adjective
wywiadu	Noun
kopca	Noun
widziałem	Verb
rzekli	Verb
suszyłyby	Verb
antykowi	Noun
piórach	Noun
naradka	Noun
noszy	Noun
pniach	Noun
kimam	Verb
przeżuję	Verb
odwiedzała	Verb
diodami	Noun
gamajdo	Noun
pożyczyłeś	Verb
errata	Noun
palmą	Noun
poliestru	Noun
zapaliłabyś	Verb
tubo	Noun
teściowi	Noun
podzbiorach	Noun
notowały	Verb
śmiertelna	Adjective
składałabyś	Verb
klikają	Verb
filiżankach	Noun
szkliwem	Noun
granicach	Noun
kosztami	Noun
brukselka	Noun
biochemicznymi	Adjective
statuetka	Noun
skrótowców	Noun
kanapa	Noun
wpływa	Verb
diamentów	Noun
ratowała	Verb
rozkładów	Noun
atakowany	Participle
karmienie	Masdar
kelnerka	Noun
feministką	Noun
starać	Verb
użytkownik	Noun
psianka	Noun
afgańska	Adjective
ślozami	Noun
fragmentom	Noun
teatrami	Noun
katapultami	Noun
bogaczom	Noun
stanowiłaby	Verb
tworem	Noun
dostają	Verb
zasłużysz	Verb
kapelan	Noun
edytujesz	Verb
ogonków	Noun
poetkę	Noun
używamy	Verb
zostawiło	Verb
drużyn	Noun
małżeństwom	Noun
jonizując	Converb
szpieg	Noun
ścianach	Noun
monarchista	Noun
odpadem	Noun
marudziliśmy	Verb
kołaczami	Noun
melis	Noun
bystrzy	Adjective
przywódcami	Noun
szprotom	Noun
bieguna	Noun
małpach	Noun
strać	Verb
aferą	Noun
sprawiałybyśmy	Verb
plastrowi	Noun
rzeczą	Noun
rozmywali	Verb
przyjęła	Verb
załączników	Noun
pozwalali	Verb
słonina	Noun
wyrzucą	Verb
pedrylowi	Noun
zaprzeczy	Verb
kationem	Noun
bezpłatna	Adjective
forach	Noun
kitajcom	Noun
porozmawiać	Verb
wirusowymi	Adjective
flagami	Noun
antycząstkami	Noun
grawitonach	Noun
autochtonicznymi	Adjective
głębsza	Adjective
przeproszony	Participle
bójko	Noun
połączył	Verb
zadzwonili	Verb
odchodziła	Verb
herbaciarnia	Noun
znacznymi	Adjective
rozwiązali	Verb
płać	Verb
kolektywizmu	Noun
solę	Noun
kryteriami	Noun
pseudonimach	Noun
kolebką	Noun
rzemieślnik	Noun
hasowi	Noun
tworzyłam	Verb
gazelami	Noun
kolejarzem	Noun
kochaj	Verb
monarchiami	Noun
maratonach	Noun
gumowa	Adjective
Pepikom	Noun
eksperymentów	Noun
prędkościach	Noun
pielgrzymką	Noun
przeprosisz	Verb
nimf	Noun
podatnymi	Adjective
zdradzania	Noun
lokalami	Noun
ukrywamy	Verb
wstrząsom	Noun
kłopotów	Noun
krawata	Noun
skarbem	Noun
ignorując	Converb
arkusza	Noun
bullo	Noun
drukarkach	Noun
jaskółkami	Noun
sprawiał	Verb
fakturach	Noun
okrągłymi	Adjective
hierarchę	Noun
podnosiłby	Verb
kwestionować	Verb
bojam	Verb
potencją	Noun
złapałabym	Verb
półfinalisty	Noun
pasterzowi	Noun
wpływalibyście	Verb
sąsiedzcy	Adjective
żądał	Verb
odmową	Noun
wesprzesz	Verb
armią	Noun
gwiezdna	Adjective
asemblerem	Noun
ubóstwiać	Verb
galaktykami	Noun
stygnęła	Verb
konsolidatora	Noun
wymiarom	Noun
igła	Noun
współpracę	Noun
stuleciach	Noun
promieniowi	Noun
jadać	Verb
zbyłeś	Verb
używałyśmy	Verb
opatentowałbyś	Verb
weganom	Noun
asparaginę	Noun
myliłyśmy	Verb
pięknością	Noun
korpusów	Noun
klękałem	Verb
bieługa	Noun
bliższa	Adjective
dźwigając	Converb
promocjach	Noun
wątroba	Noun
straciłem	Verb
niebezpiecznymi	Adjective
wiosłowaniem	Noun
uczestniczyłaby	Verb
fretkę	Noun
gonienie	Masdar
szczepionka	Noun
ministerstwie	Noun
szacunkiem	Noun
spać	Verb
oporu	Noun
prała	Verb
andorscy	Adjective
pytali	Verb
kroplach	Noun
informacyjna	Adjective
cydrom	Noun
budownictwie	Noun
kupowałem	Verb
złota	Noun
rekonstrukcją	Noun
sokowirówkach	Noun
uratujcie	Verb
niepotrzebni	Adjective
kilometra	Noun
grzebiąc	Converb
jętka	Noun
wspomnę	Verb
septymę	Noun
hrabiów	Noun
cedzę	Verb
miauczenie	Masdar
wzgórzach	Noun
płotu	Noun
strzelań	Noun
mechanikami	Noun
wronami	Noun
naukach	Noun
grilla	Noun
najczarniejsza	Adjective
kosztowała	Verb
księżniczką	Noun
jawiłoby	Verb
rekurencją	Noun
wałachów	Noun
przysięgała	Verb
olcha	Noun
kurtką	Noun
pojmując	Converb
pediatrą	Noun
częściowa	Adjective
zapomniała	Verb
górni	Adjective
wrzodu	Noun
zaganiaczy	Noun
pytany	Participle
szczepionką	Noun
fruwali	Verb
zapłać	Verb
pojedynkach	Noun
uciekałybyście	Verb
edycję	Noun
szafach	Noun
krzyża	Noun
miewa	Verb
kaplic	Noun
lubiąc	Converb
unikasz	Verb
tłumaczyć	Verb
miewają	Verb
kolczykami	Noun
pirolizyn	Noun
labializacjami	Noun
pocztówkami	Noun
szczegółach	Noun
obserwowano	Participle
diagnozować	Verb
tokiem	Noun
porażkami	Noun
stalówkami	Noun
muru	Noun
wyłączana	Participle
zapożyczeń	Noun
iloczynowi	Noun
anionami	Noun
corocznymi	Adjective
historykach	Noun
lemieszami	Noun
kompletni	Adjective
okradałbyś	Verb
opróżnimy	Verb
octanem	Noun
wołali	Verb
zdarzeń	Noun
dziewczynkę	Noun
mieszankach	Noun
infekcją	Noun
wetem	Noun
goryczek	Noun
belkom	Noun
szajsu	Noun
napisana	Participle
anilina	Noun
zrozumiana	Participle
rozważyłem	Verb
dając	Converb
pozytywką	Noun
przodkiniach	Noun
biogazach	Noun
rzeczami	Noun
gaźnikami	Noun
konstruktywizmu	Noun
carach	Noun
kanałom	Noun
kalendarzami	Noun
boksytów	Noun
gaworzyłbym	Verb
mrugalibyśmy	Verb
stypendiów	Noun
stalowa	Adjective
pożądać	Verb
chował	Verb
minerałem	Noun
pugilaresów	Noun
kamizelkę	Noun
pisanek	Noun
baobabów	Noun
gruzach	Noun
sprawdzaliście	Verb
koziorożców	Noun
maślanką	Noun
paruje	Verb
halabardach	Noun
zachowaniach	Noun
dynamitu	Noun
pojawiać	Verb
współczynnika	Noun
szablonem	Noun
piłami	Noun
mamutom	Noun
słonecznikami	Noun
wymówi	Verb
morwa	Noun
lansowali	Verb
pocztówka	Noun
zbieganie	Masdar
tyrozynami	Noun
torpedę	Noun
naprawiała	Verb
bijekcjami	Noun
zatrzymał	Verb
zaćmieniami	Noun
słyszalnymi	Adjective
gumom	Noun
cieńszymi	Adjective
gruchotach	Noun
pinda	Noun
edyl	Noun
szantażowałybyście	Verb
ateistę	Noun
śluzem	Noun
rąbiąca	Participle
arbuza	Noun
krzaków	Noun
zamknęli	Verb
dedykowałeś	Verb
kontroluje	Verb
piżama	Noun
brodów	Noun
propozycją	Noun
rysunkami	Noun
śmieszkując	Converb
techniką	Noun
borówka	Noun
pachnącymi	Adjective
kometę	Noun
helikopterów	Noun
obwodem	Noun
szkicach	Noun
Celt	Noun
trzymająca	Participle
talizmanem	Noun
rób	Verb
połkną	Verb
wuj	Noun
kobro	Noun
bogaczowi	Noun
szczęką	Noun
rekurencjami	Noun
oświetlały	Verb
kopycie	Noun
hydraulik	Noun
lontami	Noun
finalistek	Noun
kip	Verb
łączem	Noun
kryptografią	Noun
zakochanymi	Adjective
aresztem	Noun
trąbach	Noun
tulipanami	Noun
łaziłybyście	Verb
wstawaj	Verb
odpoczywa	Verb
wzięty	Participle
platyna	Noun
pamiątek	Noun
ujebałyby	Verb
wylany	Participle
kurczętom	Noun
żywotna	Adjective
odważni	Adjective
gościńcem	Noun
organizowała	Verb
pacjentkami	Noun
włókien	Noun
ręczników	Noun
zniknął	Verb
tężcowi	Noun
kłamałabyś	Verb
wykorzystywano	Participle
dawek	Noun
przeżyłyśmy	Verb
wspomnieliśmy	Verb
czynnościach	Noun
bilo	Noun
barometrach	Noun
tymczasowa	Adjective
aspektów	Noun
borówek	Noun
buchałby	Verb
okazaliście	Verb
sytuacjom	Noun
studiująca	Participle
klipra	Noun
delikwent	Noun
rozrywek	Noun
centymetra	Noun
karmanów	Noun
skrzydełkami	Noun
czaszami	Noun
farmakologicznymi	Adjective
kumpel	Noun
pierdoła	Noun
siarkowodorem	Noun
zwierzętom	Noun
zbyty	Participle
konserw	Noun
ruszałem	Verb
połykania	Noun
nicieniami	Noun
radonu	Noun
jazu	Noun
dworami	Noun
kasynem	Noun
obrazom	Noun
mąciciel	Noun
etapu	Noun
podmiotem	Noun
darów	Noun
bandyty	Noun
przychodem	Noun
basenem	Noun
parodią	Noun
pchłę	Noun
oporami	Noun
dezodorantami	Noun
obserwatorowi	Noun
ignorował	Verb
pijak	Noun
bocianami	Noun
rozterek	Noun
czasowników	Noun
warzywem	Noun
listwach	Noun
gruntom	Noun
wołając	Converb
chłopakiem	Noun
kornetowi	Noun
korzysta	Verb
internistą	Noun
poetyccy	Adjective
kaskaderom	Noun
pudeł	Noun
filiżaneczka	Noun
dajemy	Verb
agresja	Noun
skalę	Noun
rekurencjom	Noun
stawał	Verb
klęcz	Verb
demonstrantami	Noun
wtorków	Noun
przekomarza	Verb
otoczakom	Noun
chińczyków	Noun
procesorowi	Noun
zniszczę	Verb
analfabetą	Noun
narządach	Noun
momentu	Noun
zakazana	Participle
wymyślam	Verb
warszawo	Noun
dyplomach	Noun
spadochronów	Noun
plebanią	Noun
abonamentów	Noun
zajączkiem	Noun
zewnętrznymi	Adjective
wynajęła	Verb
karało	Verb
kruszczykom	Noun
dinar	Noun
uśpiona	Participle
puszysta	Adjective
drzewostanami	Noun
wymówek	Noun
zweryfikujmy	Verb
szatnią	Noun
śliwkę	Noun
nastawił	Verb
podniesiono	Participle
woskiem	Noun
urodził	Verb
niebezpieczna	Adjective
funkcjami	Noun
dyskietek	Noun
ciotkami	Noun
rycerzach	Noun
latawca	Noun
rzecznikowi	Noun
fregatą	Noun
ropuchą	Noun
opadu	Noun
talonu	Noun
płciami	Noun
szczepionek	Noun
dusiłabym	Verb
dokumentu	Noun
kawiorami	Noun
zniszczeń	Noun
najczarniejsi	Adjective
dowodzi	Verb
należysz	Verb
dziwmy	Verb
jedwabna	Adjective
tańczony	Participle
afrykańscy	Adjective
farmaceuty	Noun
wierzbom	Noun
odstawiłabyś	Verb
przełącznikami	Noun
politechnikach	Noun
miejsc	Noun
duszo	Noun
studiowałem	Verb
egzaminowałoby	Verb
zabijać	Verb
przypuszczano	Participle
wymagasz	Verb
czajkami	Noun
twardzi	Adjective
spowiednikiem	Noun
odradzały	Verb
starająca	Participle
katalizatorach	Noun
szansa	Noun
muszkietów	Noun
wezyrem	Noun
pestka	Noun
babilońscy	Adjective
wartościami	Noun
jaworem	Noun
skałach	Noun
nadprzewodników	Noun
furanach	Noun
ekosystemu	Noun
skłamałaś	Verb
biegało	Verb
kształtowi	Noun
fałszem	Noun
zakładką	Noun
modom	Noun
lekarkę	Noun
poznał	Verb
unicestwiło	Verb
usuniecie	Verb
szukałbym	Verb
glukozę	Noun
gwałcą	Verb
chłeptało	Verb
pracowita	Adjective
standardowymi	Adjective
makler	Noun
satanizmem	Noun
bułka	Noun
niżów	Noun
rzuciliśmy	Verb
uprowadzeniem	Noun
żartować	Verb
głosujemy	Verb
spotkają	Verb
referendów	Noun
lusterek	Noun
oskarżałby	Verb
pokrzywą	Noun
odpowiednimi	Adjective
dzięciołach	Noun
sarkazmem	Noun
trupów	Noun
szyneczkę	Noun
odbijamy	Verb
sekund	Noun
zerwana	Participle
kształtem	Noun
śródziemnomorskimi	Adjective
wszelka	Adjective
psychuszkami	Noun
wieprzowinę	Noun
wyborca	Noun
kładła	Verb
studiowało	Verb
humanistę	Noun
przegrać	Verb
Holenderka	Noun
obserwuję	Verb
śródmózgowi	Noun
ram	Noun
wybierało	Verb
karmiłaś	Verb
klubowi	Noun
przyprawia	Verb
żaglowcach	Noun
cudza	Adjective
pożarły	Verb
szlafrokowi	Noun
reprodukcją	Noun
zasobu	Noun
doktoratu	Noun
arsenu	Noun
gilami	Noun
denerwowała	Verb
hipotek	Noun
Polko	Noun
ukryłby	Verb
symulować	Verb
radościami	Noun
plemionach	Noun
otwarto	Participle
bez	Noun
wojsk	Noun
urokach	Noun
popcornu	Noun
nadawca	Noun
górska	Adjective
sprawna	Adjective
dumało	Verb
zwyciężało	Verb
mangusta	Noun
doliną	Noun
Norwegowi	Noun
zastrzeżonymi	Adjective
stygną	Verb
torpeda	Noun
ołtarzowi	Noun
głogów	Noun
tlejąca	Participle
tekściarzach	Noun
podniosłybyśmy	Verb
strofę	Noun
sędzinę	Noun
schnęłabyś	Verb
orędziem	Noun
najbliższymi	Adjective
granitu	Noun
jarami	Noun
występował	Verb
krain	Noun
eksplozjach	Noun
serwerach	Noun
wyżłom	Noun
tempie	Noun
dźwigają	Verb
tulipanów	Noun
uciekinierem	Noun
nicieni	Noun
dziecięcia	Noun
fransem	Noun
biurokracją	Noun
kosiliście	Verb
strategiczni	Adjective
krzywdami	Noun
pantografem	Noun
kusił	Verb
prześcieradeł	Noun
zakonów	Noun
toreb	Noun
sitkom	Noun
krzewach	Noun
odbudowawszy	Converb
kaczkach	Noun
dokładniejsi	Adjective
kotwicę	Noun
hien	Noun
podróżowało	Verb
rozważałbym	Verb
narciarzem	Noun
przestrzegają	Verb
klinga	Noun
lawinę	Noun
centymetrów	Noun
certyfikatu	Noun
wrzosowiskami	Noun
wybrzeżem	Noun
alpaga	Noun
przeczytacie	Verb
uczelnio	Noun
zatrzymanie	Masdar
wierchuszkach	Noun
listka	Noun
wstążką	Noun
kwartetom	Noun
brązowymi	Adjective
chciały	Verb
pacjent	Noun
próbowała	Verb
opuchlizna	Noun
karmnika	Noun
szczygłem	Noun
jamajska	Adjective
zaległościom	Noun
ptasimi	Adjective
wyzwaniem	Noun
staję	Verb
wybrałyście	Verb
stronami	Noun
mól	Noun
oficer	Noun
miedzom	Noun
diamentowymi	Adjective
zakrętkę	Noun
odbierał	Verb
pasterkę	Noun
zerżnijcie	Verb
odwiedzany	Participle
waranów	Noun
wulgaryzmach	Noun
kuchenka	Noun
żaluzjami	Noun
widokami	Noun
endonimom	Noun
transseksualistą	Noun
podniosłoby	Verb
flotom	Noun
zrozumiałymi	Adjective
szwami	Noun
głosowalibyśmy	Verb
głupotę	Noun
kopani	Participle
wstawałaś	Verb
bada	Verb
ideologiem	Noun
manatów	Noun
lutetowi	Noun
bezpiecznikami	Noun
gajem	Noun
piekarek	Noun
kabylscy	Adjective
apopleksją	Noun
posłuchawszy	Converb
istotom	Noun
polowały	Verb
karać	Verb
przegraliśmy	Verb
gabinetami	Noun
dzid	Noun
zjadłabym	Verb
sracie	Verb
band	Noun
oceniałyby	Verb
nieomylna	Adjective
podkrada	Verb
tropami	Noun
uchodźca	Noun
straszna	Adjective
baranków	Noun
awarią	Noun
wstawałyście	Verb
cerkwiom	Noun
zmienicie	Verb
kołysankach	Noun
altówek	Noun
podały	Verb
policjantkę	Noun
palili	Verb
flotę	Noun
pamiętacie	Verb
organizując	Converb
enklawę	Noun
kurtkami	Noun
matryca	Noun
kopytach	Noun
wyrazów	Noun
niebezpieczeństwie	Noun
deskach	Noun
przyjęta	Participle
spódnicą	Noun
przezimowały	Verb
sznurkiem	Noun
tłusta	Adjective
snycerzem	Noun
oddziałom	Noun
rzuciłem	Verb
podanie	Masdar
łydek	Noun
pułków	Noun
insurekcję	Noun
archidiecezję	Noun
bananowa	Adjective
ręczna	Adjective
najświętsza	Adjective
pirsem	Noun
kłusowałybyście	Verb
masochistą	Noun
igrzysk	Noun
odradzałbym	Verb
podchodziliśmy	Verb
fotografem	Noun
freskami	Noun
chińczyk	Noun
monarchy	Noun
męczy	Verb
popiołach	Noun
zastanawiała	Verb
wspominać	Verb
popieraniem	Noun
widowiskom	Noun
pałką	Noun
zawrze	Verb
bogactwem	Noun
marakuja	Noun
obserwował	Verb
amnestią	Noun
dworcom	Noun
mierzyli	Verb
prenumerata	Noun
całko	Noun
pieprzyłabyś	Verb
zauważyłybyśmy	Verb
kwotami	Noun
moskit	Noun
płacąca	Participle
wyjąłbym	Verb
martwiąc	Converb
fizjoterapeuta	Noun
sierpem	Noun
rydlowi	Noun
zabierz	Verb
parodiach	Noun
chatach	Noun
dawkę	Noun
Portugalczykami	Noun
niepoważni	Adjective
proponowałam	Verb
wzgórzem	Noun
krokusa	Noun
obejmująca	Participle
siadów	Noun
lasków	Noun
jeźdźmy	Verb
kormoranów	Noun
powieka	Noun
splądrowały	Verb
kaznodziejom	Noun
wkurwieni	Adjective
sosnach	Noun
błądzę	Verb
acetonu	Noun
data	Noun
babilońska	Adjective
turkawek	Noun
otrzymana	Participle
ławeczko	Noun
teleskopami	Noun
chmurę	Noun
opuszczana	Participle
psina	Noun
dramatach	Noun
parkach	Noun
współczesna	Adjective
wywoływałem	Verb
płatnością	Noun
pozytywka	Noun
kochał	Verb
pobierzesz	Verb
tarkom	Noun
anegdot	Noun
parzydełkowcem	Noun
cieśnino	Noun
tarka	Noun
typowi	Adjective
luźniejsza	Adjective
jebadłu	Noun
krystalografią	Noun
przypomnimy	Verb
akacjach	Noun
pośladków	Noun
budynków	Noun
kodeina	Noun
zmieniła	Verb
lizałeś	Verb
fetą	Noun
pomyj	Noun
obiecali	Verb
profesorowi	Noun
otrzymania	Noun
trwałaby	Verb
zjemy	Verb
działką	Noun
artystką	Noun
paprykę	Noun
szczepionkach	Noun
koktajli	Noun
zupę	Noun
żałobą	Noun
wierzbach	Noun
znamienia	Noun
skręcony	Participle
złom	Noun
kapitulację	Noun
przodowałeś	Verb
stylowi	Noun
parzydełkowców	Noun
gąbek	Noun
rombem	Noun
szlachcianką	Noun
targach	Noun
zamarzać	Verb
cebulkę	Noun
pustułkom	Noun
humorystycznymi	Adjective
poufna	Adjective
beztroska	Adjective
wolę	Noun
rodzenie	Masdar
złamani	Participle
gramatyk	Noun
chipsach	Noun
widokiem	Noun
bitwami	Noun
gospodyń	Noun
terenom	Noun
alofonowi	Noun
filarem	Noun
pamięcią	Noun
puszczalskimi	Adjective
strupem	Noun
kongresów	Noun
Łotyszkę	Noun
budą	Noun
płozę	Noun
fasadą	Noun
złapały	Verb
nerkami	Noun
sypały	Verb
podażą	Noun
sakramentami	Noun
republiką	Noun
pasatem	Noun
śliną	Noun
dałyście	Verb
przedwojennymi	Adjective
przeleciał	Verb
rodzicach	Noun
jednospójni	Adjective
równiejsi	Adjective
woskach	Noun
bibliotekom	Noun
narzędnika	Noun
kochając	Converb
wybraliśmy	Verb
Celtach	Noun
mruczałem	Verb
krzemionkę	Noun
alegoria	Noun
jezdnią	Noun
telegraficzni	Adjective
wszystkimi	Adjective
traumatyczna	Adjective
cyborgami	Noun
balkonu	Noun
wymyślał	Verb
wielcy	Adjective
Jurkowi	Noun
malinowa	Adjective
podniosłem	Verb
olszo	Noun
oświatę	Noun
szczelinach	Noun
statua	Noun
żłobem	Noun
kroiłaś	Verb
psalmu	Noun
kelwinach	Noun
kręgowcach	Noun
śledziennica	Noun
zestawiłybyśmy	Verb
chirurgom	Noun
prał	Verb
rodzinni	Adjective
bodźcach	Noun
Sejmowi	Noun
orderem	Noun
wnioskiem	Noun
zagrożeń	Noun
lekarstwami	Noun
kwililibyśmy	Verb
rozróżnimy	Verb
odbudowałem	Verb
wozu	Noun
rozbiło	Verb
szczeniętach	Noun
głosujcie	Verb
widnokręgów	Noun
karamboli	Noun
zagrożeniami	Noun
próbowany	Participle
mrówkę	Noun
matrycach	Noun
kredkami	Noun
buntownik	Noun
hydrostatyczna	Adjective
bawełną	Noun
odbudowalibyście	Verb
ignorowała	Verb
ekosystemami	Noun
ufali	Verb
abonowaliście	Verb
endonimów	Noun
jen	Noun
traćmy	Verb
uczniem	Noun
cukrami	Noun
trzymani	Participle
filtru	Noun
jędza	Noun
występowaliby	Verb
krzyżówkami	Noun
wersach	Noun
jokerem	Noun
lądowisk	Noun
zapominamy	Verb
gruszach	Noun
amfiteatrom	Noun
halom	Noun
suszarkach	Noun
otrzymując	Converb
drukarnię	Noun
przedostatnia	Adjective
zabrać	Verb
brygami	Noun
miesięcy	Noun
błyskawic	Noun
zachciankę	Noun
pisani	Participle
literami	Noun
najzieleńsza	Adjective
kapłaństwa	Noun
podasz	Verb
piętru	Noun
winem	Noun
nazywałaby	Verb
zaruchałbym	Verb
oddziałów	Noun
częstymi	Adjective
wiorstę	Noun
imponowały	Verb
zrozumiemy	Verb
guziczkami	Noun
ornatów	Noun
wydarzeniami	Noun
minimalistom	Noun
zwyciężaliby	Verb
międzygwiezdna	Adjective
akademio	Noun
organizatorom	Noun
kolekcję	Noun
Uzbekami	Noun
fabuł	Noun
nadepnęła	Verb
raportu	Noun
uzdę	Noun
spieprzały	Verb
pierdzielibyście	Verb
podpisałem	Verb
plotkowałoby	Verb
rozmawiałam	Verb
rodakiem	Noun
gilotynę	Noun
wojenna	Adjective
dżunglą	Noun
stożkach	Noun
wielkopolscy	Adjective
zniszczyły	Verb
ocenieni	Participle
pragnieniem	Noun
plebanię	Noun
kabaretów	Noun
deuterem	Noun
kordom	Noun
szczęk	Noun
znajdziemy	Verb
całował	Verb
cywilizacjami	Noun
ostrzegało	Verb
rozczarowała	Verb
historykowi	Noun
drzewostanem	Noun
podejrzewałbym	Verb
zauważył	Verb
terroryzmem	Noun
grzebałbyś	Verb
wołem	Noun
katedrami	Noun
gniłbym	Verb
warczysz	Verb
dymalibyście	Verb
radiowa	Adjective
cukiernię	Noun
jeżowcem	Noun
futrzak	Noun
niszczona	Participle
zostawiono	Participle
demograficzna	Adjective
sadami	Noun
polecając	Converb
siedzeniem	Noun
mundurem	Noun
wyhaftowawszy	Converb
tłuszczem	Noun
basztę	Noun
złapią	Verb
zamordowania	Noun
pluralizmu	Noun
krzemionka	Noun
biznesmen	Noun
sami	Adjective
siejcie	Verb
drzewach	Noun
odczyniłbyś	Verb
złamałeś	Verb
światłem	Noun
penisów	Noun
kandydatami	Noun
niewiast	Noun
jawicie	Verb
kangurów	Noun
oddadzą	Verb
zabrani	Participle
definicję	Noun
połączyły	Verb
gąsienicami	Noun
miauczałbym	Verb
nurkowałyście	Verb
spotkamy	Verb
kniahiń	Noun
diabłom	Noun
niebieskawa	Adjective
astrologicznymi	Adjective
bluzę	Noun
niknęli	Verb
kochankiem	Noun
uparci	Adjective
dźwięczna	Adjective
robinia	Noun
makrelą	Noun
eksportował	Verb
drukarkom	Noun
zbierał	Verb
gorczycę	Noun
pajęczakami	Noun
adapterem	Noun
lustrzankach	Noun
czesałem	Verb
jesionów	Noun
mieszałybyśmy	Verb
spieszyła	Verb
boleśni	Adjective
luźni	Adjective
bojów	Noun
odbierają	Verb
drgają	Verb
jednostkom	Noun
felga	Noun
zapomina	Verb
zapominam	Verb
kluczowi	Noun
saletry	Noun
szarlotkach	Noun
przydomkiem	Noun
artystą	Noun
marynarkach	Noun
rzekłyby	Verb
zamkną	Verb
gałązkami	Noun
wspomnieni	Participle
chatek	Noun
tracąca	Participle
gryzło	Verb
szczotka	Noun
wziąć	Verb
odebraliby	Verb
żelazkami	Noun
zerowa	Adjective
seryną	Noun
wracałyśmy	Verb
wybierze	Verb
kobieta	Noun
ogniowi	Noun
lipa	Noun
wiedźmą	Noun
roztrzepałyście	Verb
chwalą	Verb
zabrali	Verb
przesadzał	Verb
ofiara	Noun
piłkarzem	Noun
chłeptana	Participle
spójników	Noun
felietonami	Noun
syta	Adjective
fiołkowi	Noun
protektoratów	Noun
prezentacjach	Noun
kolców	Noun
dręczylibyśmy	Verb
grabić	Verb
rodzajach	Noun
duch	Noun
traktowałaś	Verb
usuwałyśmy	Verb
refowanie	Masdar
hiszpańska	Adjective
fruktozy	Noun
gadałbym	Verb
edukacją	Noun
przędziw	Noun
przezimowaliście	Verb
czelesta	Noun
oceanach	Noun
arsenianów	Noun
startu	Noun
gwarancja	Noun
nibynóżek	Noun
przeżuliby	Verb
kulonowi	Noun
komorą	Noun
garnuszka	Noun
dziobów	Noun
rybołowów	Noun
pieseczkowi	Noun
zlewów	Noun
epitafiami	Noun
chanami	Noun
wyglądać	Verb
zeszli	Adjective
wyniosło	Verb
haubic	Noun
twórcą	Noun
dojenie	Masdar
wykorzystujecie	Verb
zapłacić	Verb
wydumanymi	Adjective
bezwstydna	Adjective
rozczarowały	Verb
fortepianu	Noun
blendą	Noun
zmienialiście	Verb
laktonów	Noun
przyniesiono	Participle
włościach	Noun
dwujęzyczni	Adjective
palacz	Noun
pięt	Noun
kaskad	Noun
śpiewajcie	Verb
tuneli	Noun
wymiarów	Noun
zaczynalibyście	Verb
wskazałyby	Verb
serwatka	Noun
fazom	Noun
kongresu	Noun
poprawiam	Verb
wzięci	Participle
grzebałabym	Verb
strasznymi	Adjective
oszukujmy	Verb
saksofonista	Noun
kontem	Noun
kierów	Noun
dorzeczami	Noun
ambulatoriach	Noun
krzyżma	Noun
gościńców	Noun
kapelach	Noun
złożeniach	Noun
nauk	Noun
szumom	Noun
wyrokach	Noun
wilg	Noun
fasad	Noun
odami	Noun
zrozumienie	Masdar
monopolistę	Noun
czajką	Noun
markizę	Noun
gromu	Noun
ładuj	Verb
mastektomia	Noun
kszyk	Noun
organizujecie	Verb
strzałkami	Noun
drogówki	Noun
starałyśmy	Verb
rzuceni	Participle
sołectwami	Noun
temperaturami	Noun
skąpcach	Noun
ruszałaby	Verb
planu	Noun
cosinusowi	Noun
stacja	Noun
wydmowa	Adjective
niebezpieczeństwu	Noun
toyota	Noun
wyuzdana	Adjective
tektura	Noun
tunelami	Noun
wybuchała	Verb
spuszczałbym	Verb
dziwili	Verb
wygarnięcie	Masdar
odpoczywalibyśmy	Verb
żołądka	Noun
płatkach	Noun
zagadką	Noun
holenderskimi	Adjective
pożycza	Verb
bosman	Noun
wahać	Verb
iberyjskimi	Adjective
najkrąglejsi	Adjective
Francuzom	Noun
żądz	Noun
podnosiliście	Verb
zrozumieją	Verb
bajglowi	Noun
wyzwaniom	Noun
baobabu	Noun
obrono	Noun
Bałt	Noun
zebr	Noun
produkuj	Verb
waćpan	Noun
wyprasowałeś	Verb
rozstajom	Noun
obulibyśmy	Verb
źrenica	Noun
trzebiłbyś	Verb
dodana	Participle
przypuściliście	Verb
wymiotowałbyś	Verb
uczęszczanie	Masdar
przeglądarkę	Noun
szukałabym	Verb
hierarchia	Noun
poiłam	Verb
mądrością	Noun
literatura	Noun
maklerami	Noun
śmierdząca	Participle
oglądania	Noun
napisał	Verb
dachowcom	Noun
połknęłybyśmy	Verb
cofacie	Verb
olbrzymkami	Noun
kuzynem	Noun
berberyjskimi	Adjective
pożyczać	Verb
cytoplazmatycznymi	Adjective
komina	Noun
maszynami	Noun
myśliwcami	Noun
glicynę	Noun
braciach	Noun
większościom	Noun
parowcem	Noun
eksportowali	Verb
gwiazdozbioru	Noun
poetek	Noun
ateistami	Noun
atakowaliście	Verb
rzeczach	Noun
pcheł	Noun
węgorzom	Noun
świadkami	Noun
bójkach	Noun
roślinami	Noun
parabolę	Noun
dzielnicę	Noun
dachem	Noun
wymyśliło	Verb
chodników	Noun
szybkościach	Noun
czyniłem	Verb
motocyklami	Noun
nagłymi	Adjective
tańczyły	Verb
pasiekach	Noun
łamałbyś	Verb
drganiami	Noun
ichtiologowi	Noun
hemolizę	Noun
dodany	Participle
rozróżniałybyśmy	Verb
szantą	Noun
odpocznę	Verb
rzeknij	Verb
kompiluje	Verb
dialektów	Noun
bruzdo	Noun
szpitalom	Noun
nowościach	Noun
zasadom	Noun
bidetem	Noun
uchwytach	Noun
odpocząłby	Verb
płynęła	Verb
hydraulikach	Noun
płonęłybyście	Verb
dałaś	Verb
metodystyczna	Adjective
róża	Noun
szyszek	Noun
placom	Noun
dziennikarką	Noun
bażantem	Noun
ekonomistami	Noun
roślinę	Noun
zamarzaniem	Noun
rzekniecie	Verb
zasłużona	Participle
ratują	Verb
posłuchałaś	Verb
licytację	Noun
siódemka	Noun
wybierałem	Verb
pandę	Noun
obojczykiem	Noun
personifikacją	Noun
kroję	Verb
czarnuszkami	Noun
ruchowi	Noun
kardiochirurg	Noun
śmieszkowałbyś	Verb
listwami	Noun
karawanami	Noun
tankowców	Noun
łosiach	Noun
dwutlenkiem	Noun
wyłącznikiem	Noun
zołzą	Noun
dżokej	Noun
domówka	Noun
czyściłaś	Verb
ręcznikami	Noun
pobrałaś	Verb
meksykami	Noun
algebr	Noun
dzióbmy	Verb
Murzynem	Noun
czekająca	Participle
dzięcielina	Noun
zasobami	Noun
kasjer	Noun
denerwująca	Participle
świątynię	Noun
myślach	Noun
gałęzią	Noun
traktuj	Verb
skarbonka	Noun
zaczekałoby	Verb
Europejczyk	Noun
narodem	Noun
cynamonowa	Adjective
brudni	Adjective
robią	Verb
skończy	Verb
ginekolog	Noun
obgadać	Verb
kilometrach	Noun
pian	Noun
proroctwie	Noun
kupienie	Masdar
stadami	Noun
mieszkańcach	Noun
cepami	Noun
łaskom	Noun
okrętu	Noun
ścierwu	Noun
matkojebcą	Noun
oskarża	Verb
kukurydza	Noun
krachem	Noun
egzaminowałaś	Verb
żniwom	Noun
reliefach	Noun
kaszalotem	Noun
szarogęsiła	Verb
prawnymi	Adjective
kodeksowi	Noun
rogala	Noun
pudłach	Noun
mazurscy	Adjective
mebli	Noun
kibicuje	Verb
obrabujmy	Verb
żytnia	Adjective
gramów	Noun
grzywną	Noun
egzorcyzmowi	Noun
kopcowi	Noun
przedmiotowi	Noun
buchacie	Verb
stryjek	Noun
wniosków	Noun
stanowiłabyś	Verb
autoportretem	Noun
rodzinna	Adjective
nakrętko	Noun
osobą	Noun
celę	Noun
wiatraków	Noun
szympans	Noun
kantat	Noun
wynajęłybyście	Verb
opowieściach	Noun
dziennikami	Noun
zaprosić	Verb
klatkami	Noun
przodowała	Verb
zaufajcie	Verb
śniadałyby	Verb
aparatowi	Noun
dyplomatom	Noun
wstęg	Noun
chemikom	Noun
denaturatu	Noun
siedzisz	Verb
dochodząc	Converb
groźnymi	Adjective
zabawko	Noun
cofana	Participle
słynnymi	Adjective
jokerami	Noun
kłosach	Noun
jambom	Noun
strzałą	Noun
pokażcie	Verb
konus	Noun
kompilowalibyśmy	Verb
muszlami	Noun
rachunkiem	Noun
pietruszką	Noun
wirów	Noun
bajka	Noun
artystyczna	Adjective
modlili	Verb
chartem	Noun
roszada	Noun
przyjmowaliśmy	Verb
najzdolniejsi	Adjective
odmianach	Noun
rozmyślając	Converb
susłów	Noun
napisanie	Masdar
wrażliwymi	Adjective
ginę	Verb
ogonem	Noun
sprawiająca	Participle
szpiegach	Noun
koptyjskimi	Adjective
męczennica	Noun
wiktorię	Noun
notowano	Participle
krążownikami	Noun
wołami	Noun
cyfrowymi	Adjective
uraninitach	Noun
płyną	Verb
antywodorowi	Noun
zwyczajna	Adjective
dowiedziałby	Verb
szarawi	Adjective
tańczona	Participle
wytłumaczyć	Verb
nowotworom	Noun
wstrzemięźliwymi	Adjective
chcecie	Verb
felietonem	Noun
posiadaliście	Verb
wygrano	Participle
zjawiskami	Noun
skrzynkach	Noun
daliście	Verb
reniferami	Noun
ładowania	Noun
kredka	Noun
epidemia	Noun
pięknościom	Noun
nazisty	Noun
Serbom	Noun
kłosem	Noun
portrecistą	Noun
nazywały	Verb
aligatorami	Noun
architekt	Noun
rzepką	Noun
olimpiadę	Noun
płetwonurkami	Noun
decymetra	Noun
pochwą	Noun
ikebanom	Noun
ówczesna	Adjective
zapaliły	Verb
krzyczałby	Verb
haftowałam	Verb
strzykawkami	Noun
grozić	Verb
przyjmowały	Verb
komplementem	Noun
zabijmy	Verb
odpowiadam	Verb
zgliszczach	Noun
napadom	Noun
bezalkoholowi	Adjective
złożono	Participle
brudziłybyśmy	Verb
leksykografia	Noun
fretkach	Noun
zamieszkami	Noun
męk	Noun
patentów	Noun
burzylibyśmy	Verb
muzą	Noun
polowała	Verb
rozrywkach	Noun
dochodzą	Verb
kruchymi	Adjective
strzech	Noun
kastrowałybyśmy	Verb
najcięższa	Adjective
podręczników	Noun
kwestionowały	Verb
obrabowana	Participle
lesbijka	Noun
dziedzicowi	Noun
szczerbo	Noun
ambulansów	Noun
wisi	Verb
różyczkami	Noun
rozpusta	Noun
przegralibyście	Verb
wąskimi	Adjective
różniczkowaniem	Noun
literówkach	Noun
cyborg	Noun
radom	Noun
laotańska	Adjective
mangą	Noun
dziecinnymi	Adjective
nieboskłonu	Noun
plonu	Noun
tęskniłybyście	Verb
łapałabym	Verb
pancerzach	Noun
umarłam	Verb
przebieralnia	Noun
jadały	Verb
ładowałybyście	Verb
humorem	Noun
alejo	Noun
absorbuje	Verb
garbami	Noun
przygotowanie	Masdar
wpływała	Verb
kosmonautką	Noun
oślica	Noun
labiryntu	Noun
wycieraczkom	Noun
błędnymi	Adjective
konstantynopolitańczykom	Noun
akceleracja	Noun
obciążać	Verb
cywilna	Adjective
służba	Noun
właścicielach	Noun
przeszkadzają	Verb
kursami	Noun
psuję	Verb
dmuchać	Verb
ruszona	Participle
ujadałyby	Verb
podkreślałem	Verb
rodzinnymi	Adjective
ogona	Noun
łokci	Noun
anteną	Noun
pobrać	Verb
pysków	Noun
trzonach	Noun
elfia	Adjective
brzoskwiniowa	Adjective
listków	Noun
kwiliłbyś	Verb
logopedy	Noun
grzebanie	Masdar
złotem	Noun
działaniach	Noun
miechach	Noun
stref	Noun
wkurwia	Verb
nawo	Noun
ubezpieczeniami	Noun
korabi	Noun
smażyć	Verb
płoń	Verb
kolanem	Noun
wiklina	Noun
szczygieł	Noun
najpodobniejszymi	Adjective
spróbowany	Participle
kinowymi	Adjective
czarodziejach	Noun
sypialniami	Noun
obciążacie	Verb
krajowi	Noun
dementujecie	Verb
dokonaliśmy	Verb
rozmylibyście	Verb
śmiertelnymi	Adjective
łatwiejsza	Adjective
słabszymi	Adjective
pozostawałam	Verb
stanowiłyby	Verb
analizom	Noun
Japonka	Noun
holownikiem	Noun
cytatem	Noun
kosmonautka	Noun
przeleceni	Participle
wejściach	Noun
petem	Noun
duś	Verb
urodzą	Verb
parlamentami	Noun
hamulcowi	Noun
ciałkiem	Noun
oddawano	Participle
resztką	Noun
bursztynom	Noun
kazachskimi	Adjective
weźmy	Verb
warunkiem	Noun
parapsychologia	Noun
terenach	Noun
banglałbyś	Verb
składnikami	Noun
tragediach	Noun
wywołująca	Participle
paznokciami	Noun
konformistach	Noun
współpracownikami	Noun
rozważano	Participle
umrzecie	Verb
zapaliłybyście	Verb
zrozumieć	Verb
goździkiem	Noun
piktogramu	Noun
filcowi	Noun
bakach	Noun
właśni	Adjective
czekano	Participle
bolidami	Noun
kociątkiem	Noun
przytulić	Verb
tolerowano	Participle
hipopotamem	Noun
męczyć	Verb
chałko	Noun
peryheliom	Noun
procesom	Noun
zadajmy	Verb
ukryła	Verb
falangami	Noun
centrów	Noun
baletowi	Noun
bywalcowi	Noun
bukietu	Noun
bojająca	Participle
czułoby	Verb
przeczytać	Verb
cenzurą	Noun
kwestionowano	Participle
ceną	Noun
Albankami	Noun
pląsano	Participle
gnilibyśmy	Verb
kwaśnymi	Adjective
garnizonów	Noun
małpkę	Noun
zniknęło	Verb
mózgów	Noun
germańska	Adjective
geografowi	Noun
pustyń	Noun
żebrakiem	Noun
rozmaitością	Noun
mitu	Noun
deistą	Noun
cennika	Noun
tworzyłybyśmy	Verb
zagiąwszy	Converb
marznął	Verb
wrogach	Noun
wzięłam	Verb
złotnikami	Noun
czytali	Verb
teodolitom	Noun
logopedia	Noun
zburzyć	Verb
kocurów	Noun
skałom	Noun
dodekanom	Noun
wymagajcie	Verb
oszuka	Verb
dzwonkowi	Noun
sroką	Noun
rzeźnik	Noun
czytaniach	Noun
piekarnią	Noun
lądowaniami	Noun
mrugałybyście	Verb
poprowadziło	Verb
fałszerstwach	Noun
komentowało	Verb
zadzwonić	Verb
biedniejsi	Adjective
środowiskami	Noun
umówił	Verb
klopom	Noun
oświata	Noun
zabijały	Verb
nazywali	Verb
artystkami	Noun
masztami	Noun
grzęda	Noun
drogowskazach	Noun
grzędą	Noun
oregan	Noun
pudełkach	Noun
zakazała	Verb
bezczelna	Adjective
baryłka	Noun
parowowi	Noun
władzo	Noun
chusteczka	Noun
endorfina	Noun
potwierdzamy	Verb
puryfikaterzom	Noun
lazurowi	Noun
marnujesz	Verb
patriarchatowi	Noun
wybierałyście	Verb
dostarczała	Verb
płynem	Noun
niezależnymi	Adjective
kurnikowi	Noun
padniętymi	Adjective
bajką	Noun
ichtiolog	Noun
cytowaliście	Verb
wdzięcznością	Noun
protektoratem	Noun
poproszony	Participle
prądem	Noun
brewiarza	Noun
stromymi	Adjective
koalicję	Noun
miotłą	Noun
należałaś	Verb
walców	Noun
Ukraińcami	Noun
abonentami	Noun
nakryj	Verb
lęka	Verb
autoportretach	Noun
rama	Noun
drogowskazu	Noun
gwałtem	Noun
zwierciadeł	Noun
puchem	Noun
pszczelarz	Noun
hipopotamami	Noun
aut	Noun
debiutowi	Noun
kipiałabyś	Verb
wierzyłyście	Verb
jonizujmy	Verb
Majem	Noun
spałyście	Verb
spiesz	Verb
zdrajcę	Noun
rabin	Noun
słuchałem	Verb
obrączka	Noun
pogadasz	Verb
latarnikach	Noun
masażystom	Noun
milczy	Verb
ubikacjami	Noun
sprzęgły	Verb
kopiować	Verb
sprawdziłbym	Verb
grzebać	Verb
budżetówką	Noun
antykach	Noun
drapały	Verb
dekadą	Noun
znakach	Noun
srebra	Noun
otrzymałaby	Verb
aortami	Noun
dodają	Verb
naprawiałam	Verb
kresowi	Noun
grawitonu	Noun
mechanizmach	Noun
źródłosłowem	Noun
gapił	Verb
żargonów	Noun
lumenów	Noun
weselsi	Adjective
dokonywanie	Masdar
delegatom	Noun
zdementowałyśmy	Verb
łyskach	Noun
dziennymi	Adjective
bohatyrniecie	Verb
preclach	Noun
haubicami	Noun
awarię	Noun
obszaru	Noun
zabijaliśmy	Verb
jajnika	Noun
mijana	Participle
lipni	Adjective
Węgierkę	Noun
roztrzepaliście	Verb
usterkami	Noun
chwilach	Noun
poprawni	Adjective
pazurom	Noun
przyszłymi	Adjective
cytuję	Verb
czapka	Noun
meduz	Noun
kontrastach	Noun
jawi	Verb
gościnnością	Noun
hrywna	Noun
znała	Verb
jeżdżą	Verb
pojedynkami	Noun
piekarniach	Noun
doprowadzali	Verb
szansach	Noun
bezsenni	Adjective
administrator	Noun
konkurowali	Verb
bursztynu	Noun
hierarchy	Noun
magiczni	Adjective
uczęszczam	Verb
kumano	Participle
spektrometrem	Noun
parzydełkowcami	Noun
Etruskach	Noun
stawiali	Verb
magnetowidach	Noun
ruchała	Verb
kanibalizmu	Noun
słyszałam	Verb
suszona	Participle
dotykanie	Masdar
głoskami	Noun
opisu	Noun
ciążach	Noun
krucjatą	Noun
skandaliczna	Adjective
pierścieniowi	Noun
pobożna	Adjective
schować	Verb
republikom	Noun
wykorzystywałyśmy	Verb
przedsiębiorcę	Noun
niedzielami	Noun
węglowodorami	Noun
jarzynowymi	Noun
dodawałybyśmy	Verb
obszarach	Noun
mylony	Participle
protonem	Noun
bezwzględni	Adjective
transkrypcję	Noun
założycielowi	Noun
zabili	Verb
futuryzmowi	Noun
rataj	Noun
wynajęli	Verb
zakonnikach	Noun
upuściły	Verb
ulubiona	Adjective
skracamy	Verb
interesami	Noun
bodźców	Noun
fabryka	Noun
bibliotek	Noun
Hiszpanką	Noun
sekundę	Noun
uczelnia	Noun
głodówką	Noun
nacjonalistyczna	Adjective
hangarem	Noun
archeologami	Noun
gotowali	Verb
statuetkom	Noun
mocniejszymi	Adjective
Indianka	Noun
marzyciel	Noun
trójkątów	Noun
identyfikowały	Verb
gromadzili	Verb
czerwi	Noun
bagażników	Noun
kwarkami	Noun
idiomów	Noun
flagach	Noun
grzbietu	Noun
najbujniejsi	Adjective
broszurę	Noun
przewodowi	Noun
wózkami	Noun
kartkówek	Noun
przynosiła	Verb
absolwentkom	Noun
egzaminem	Noun
interlingua	Noun
asteroidę	Noun
jeżdżono	Participle
przyjęć	Noun
ruszy	Verb
szwabami	Noun
wiertarek	Noun
spermy	Noun
gejszach	Noun
przedrostkach	Noun
rumowi	Noun
oddaje	Verb
chcieliście	Verb
dyskretniejsza	Adjective
spieprz	Verb
obciążeń	Noun
rozważyliśmy	Verb
centralizmu	Noun
zwrotami	Noun
blondynkę	Noun
biegać	Verb
pęknięty	Participle
znająca	Participle
sonatach	Noun
mową	Noun
iskałyby	Verb
dziura	Noun
ślusarzach	Noun
karał	Verb
ripostowałaby	Verb
neuronem	Noun
postradajmy	Verb
magazynem	Noun
ładowarkom	Noun
ofiarę	Noun
podtytułów	Noun
przypuściły	Verb
sklepom	Noun
wierzchowcem	Noun
skłamały	Verb
deseczek	Noun
skarpetkami	Noun
wskazywać	Verb
naprawach	Noun
modliło	Verb
drzemałybyście	Verb
nogawkami	Noun
forami	Noun
targiem	Noun
macicą	Noun
migrenami	Noun
prośbą	Noun
Polkach	Noun
surrealisty	Noun
poprosiłyby	Verb
rachunkowością	Noun
brojlerem	Noun
znajdujesz	Verb
gazach	Noun
konfliktów	Noun
morderczynią	Noun
materiałami	Noun
afgańskimi	Adjective
zaćmieniom	Noun
urzędom	Noun
obligacjo	Noun
trzymany	Participle
magnetofonu	Noun
ujadać	Verb
gronami	Noun
piszę	Verb
miazga	Noun
kusicie	Verb
płaczesz	Verb
zabalsamują	Verb
tropików	Noun
upustem	Noun
chwalilibyśmy	Verb
chowanie	Masdar
matkami	Noun
przydawkami	Noun
pensją	Noun
nowościami	Noun
poetach	Noun
karłom	Noun
pączkami	Noun
odbiornikach	Noun
opowiadacie	Verb
ignorowali	Verb
zostawił	Verb
spuszczono	Participle
żbikiem	Noun
oknie	Noun
strefa	Noun
karmił	Verb
karasiem	Noun
twardsza	Adjective
lwica	Noun
malowidle	Noun
obron	Noun
oddani	Participle
niedorzecznikami	Noun
szkłem	Noun
Sejmów	Noun
żubr	Noun
dziewczynę	Noun
ekwilibrystykami	Noun
polnymi	Adjective
jambem	Noun
kroić	Verb
mądrymi	Adjective
mieszka	Verb
najpotężniejsza	Adjective
jagódko	Noun
laryngologom	Noun
woniejąca	Participle
sposobach	Noun
ława	Noun
działaczami	Noun
brylantowa	Adjective
wystarczałoby	Verb
urodziliśmy	Verb
klimatem	Noun
kopo	Noun
nęci	Verb
dupek	Noun
absorbowałbym	Verb
kornikami	Noun
gardziłabyś	Verb
wyglądała	Verb
wzrokiem	Noun
tańcząc	Converb
administratorek	Noun
okradania	Noun
wielokropkiem	Noun
szparach	Noun
dwuwymiarowa	Adjective
biedroneczkom	Noun
uciekałyby	Verb
kamykami	Noun
glazurą	Noun
bluzą	Noun
zweryfikowani	Participle
grożąca	Participle
ślimakach	Noun
jajników	Noun
zabierzesz	Verb
podpisany	Participle
medalistę	Noun
rysunkiem	Noun
najfajniejsi	Adjective
polowałybyśmy	Verb
kwartałów	Noun
tajscy	Adjective
ikoną	Noun
zakonnicę	Noun
kredytach	Noun
odebranie	Masdar
sierścią	Noun
aulo	Noun
dodałyby	Verb
pranie	Masdar
tundrami	Noun
saun	Noun
włosia	Noun
wyświetlały	Verb
daszka	Noun
rozważmy	Verb
zabijali	Verb
rudo	Noun
nadchodziłam	Verb
wskazywała	Verb
książętami	Noun
uprawiajcie	Verb
mangach	Noun
rozproszył	Verb
epitafiów	Noun
kominków	Noun
Japończykowi	Noun
kilograma	Noun
ściągnij	Verb
tancerka	Noun
dymiąca	Participle
golona	Participle
Ruskiem	Noun
gwałtami	Noun
przymierzalnią	Noun
złotnikiem	Noun
alfabetami	Noun
odległością	Noun
okazany	Participle
motocyklowi	Noun
lutetu	Noun
opiekowałbym	Verb
wiesiołka	Noun
limę	Noun
relacją	Noun
gustami	Noun
wisiało	Verb
pistoletom	Noun
pełzaliby	Verb
posiadałby	Verb
Wandalach	Noun
socjalizmu	Noun
nieumarła	Adjective
półkulom	Noun
kokainę	Noun
grudą	Noun
literówka	Noun
biodrze	Noun
schlebiałabyś	Verb
denerwował	Verb
kolejkami	Noun
dementował	Verb
pomocnikiem	Noun
planuj	Verb
Grześkiem	Noun
jądru	Noun
trakcyjna	Adjective
zerują	Verb
turystyko	Noun
grzeczni	Adjective
wahaniom	Noun
odwiedzał	Verb
niszcząc	Converb
pokaż	Verb
równoległobokach	Noun
odkrywa	Verb
aresztów	Noun
pismu	Noun
głosował	Verb
humanistom	Noun
łechtaczkę	Noun
slupom	Noun
orzechowymi	Adjective
staramy	Verb
doradcą	Noun
wektorów	Noun
nieszkodliwa	Adjective
sojuszom	Noun
analogowymi	Adjective
kuprach	Noun
wstążkę	Noun
podkreślaliście	Verb
widzicie	Verb
wskazywały	Verb
francuscy	Adjective
batem	Noun
spódnicę	Noun
klimatach	Noun
sezonu	Noun
butelką	Noun
deseczką	Noun
dzików	Noun
drzewostanu	Noun
poligamistą	Noun
wysokością	Noun
cielęciem	Noun
kubka	Noun
sokołów	Noun
przekłamań	Noun
hierarchami	Noun
czynem	Noun
podkreślało	Verb
flagę	Noun
nigeryjska	Adjective
najcieńsi	Adjective
jagódek	Noun
organizmom	Noun
getrami	Noun
wspólna	Adjective
przezimujcie	Verb
zapłaciłem	Verb
przewodami	Noun
fransu	Noun
łasko	Noun
sztandarach	Noun
Baskami	Noun
mutantem	Noun
biogazu	Noun
agatu	Noun
tymolowi	Noun
wersetach	Noun
manifestami	Noun
śmieciarka	Noun
dnia	Noun
wilcza	Adjective
trojańska	Adjective
kaskadami	Noun
kukałem	Verb
chromosomem	Noun
trzymałbym	Verb
gromadził	Verb
dysydentom	Noun
psychologami	Noun
wokalistom	Noun
używając	Converb
szprotem	Noun
sprzeciwach	Noun
pierdołami	Noun
chwilami	Noun
animacjach	Noun
kamykiem	Noun
moczowodem	Noun
biletu	Noun
łoś	Noun
rejestrowi	Noun
rojach	Noun
zaczęta	Participle
bezpieczniejsi	Adjective
menuetów	Noun
pismach	Noun
ginęło	Verb
miastem	Noun
sportowa	Adjective
doda	Verb
stosami	Noun
zmieniały	Verb
masturbację	Noun
nieodpowiednia	Adjective
tworzylibyśmy	Verb
wielościanami	Noun
prałabyś	Verb
ślepa	Adjective
nazizmowi	Noun
sfałszowanie	Masdar
skazańcowi	Noun
popełniłam	Verb
ksylofonach	Noun
trójkąta	Noun
wziąłby	Verb
ofert	Noun
dromader	Noun
skryptom	Noun
pułkownikowi	Noun
brukowcach	Noun
mydle	Noun
badowi	Noun
podaliście	Verb
piszczenie	Masdar
adresat	Noun
daktylowca	Noun
półkolista	Adjective
głupcem	Noun
głoską	Noun
pieczarka	Noun
sklepu	Noun
kostucha	Noun
laptopów	Noun
zostawi	Verb
wstążek	Noun
cenobity	Noun
szybkimi	Adjective
edycja	Noun
wykopmy	Verb
podpisu	Noun
robiłem	Verb
klubów	Noun
szaleństwu	Noun
uciekinierom	Noun
biedronkę	Noun
zakrystiami	Noun
mezuza	Noun
szumem	Noun
aramejska	Adjective
sufitem	Noun
balom	Noun
żeli	Noun
kryłeś	Verb
silnikami	Noun
wpływały	Verb
ocenom	Noun
bibliotekarzom	Noun
nakrętka	Noun
wstawionymi	Adjective
bezdzietna	Adjective
wytryskują	Verb
starością	Noun
pomocnikowi	Noun
trącić	Verb
murkami	Noun
niska	Adjective
płacić	Verb
kądzielach	Noun
dumasz	Verb
ruchałabym	Verb
zamrażarka	Noun
wiolonczelach	Noun
rozważaniami	Noun
pękali	Verb
wielbłądach	Noun
nazwiskiem	Noun
lewicowa	Adjective
zdaniem	Noun
sprzętowi	Noun
sprawdziły	Verb
systemach	Noun
blaskiem	Noun
kolejnymi	Adjective
własna	Adjective
schlebiałam	Verb
płaz	Noun
ślubowi	Noun
spacerach	Noun
kopalnią	Noun
kikutów	Noun
masywu	Noun
lucernom	Noun
katapult	Noun
marychą	Noun
Xboxami	Noun
cenzurę	Noun
wielokropkom	Noun
liczebników	Noun
nirwanę	Noun
lumenach	Noun
organistą	Noun
inwalidę	Noun
sojuszem	Noun
powodziom	Noun
kalina	Noun
usuwali	Verb
sępowi	Noun
lupa	Noun
odstępem	Noun
pierwsi	Adjective
telegrafem	Noun
hitem	Noun
hokejowi	Adjective
gorczycą	Noun
kuzynom	Noun
skończył	Verb
kierowałabyś	Verb
fula	Noun
orania	Noun
palindromem	Noun
próżnię	Noun
mięczakami	Noun
dawałyśmy	Verb
jaskółkę	Noun
siołem	Noun
szyszynek	Noun
żyli	Verb
matur	Noun
gumach	Noun
sprawdzały	Verb
erytrocytach	Noun
zatrzymani	Participle
błotniakowi	Noun
schorzeniach	Noun
usuwaj	Verb
zdrajcach	Noun
obrotowi	Noun
mordował	Verb
występuj	Verb
kopałbym	Verb
Japonkę	Noun
pidżama	Noun
przodowali	Verb
czynnikach	Noun
lich	Noun
realistami	Noun
pierników	Noun
osuwiskami	Noun
westernów	Noun
przedmową	Noun
wymagam	Verb
wyłudzimy	Verb
chłodni	Adjective
osuwiskiem	Noun
wiatrowi	Noun
kwestionowała	Verb
wiatrów	Noun
supłem	Noun
batatów	Noun
agatów	Noun
pozostają	Verb
marionetek	Noun
polska	Adjective
alergenem	Noun
jednogłośna	Adjective
zabijam	Verb
niebieskawymi	Adjective
małżeństwach	Noun
przestępcom	Noun
ścieżkami	Noun
grzeszyliśmy	Verb
skrótach	Noun
zaprzeczyli	Verb
kołtunach	Noun
nożach	Noun
rozmyślałybyśmy	Verb
bełtem	Noun
ziomkom	Noun
oniryczna	Adjective
wertykalnymi	Adjective
renegat	Noun
piersiom	Noun
przypałem	Noun
pociskiem	Noun
wskazały	Verb
Wietnamczyk	Noun
onomatopeją	Noun
ateuszach	Noun
Czeszko	Noun
ostrzegali	Verb
szpinakiem	Noun
stratosferę	Noun
sumienna	Adjective
staram	Verb
meblami	Noun
klawiszom	Noun
najświętsi	Adjective
botaniczna	Adjective
wojskowa	Adjective
kwietniów	Noun
palach	Noun
turbina	Noun
posłucha	Verb
domem	Noun
reżyser	Noun
widział	Verb
wspomnij	Verb
aberracjami	Noun
obrzezaniem	Noun
lubelskimi	Adjective
kreskówkę	Noun
werbla	Noun
proponowałbyś	Verb
ilustrację	Noun
jodu	Noun
jeżdżę	Verb
trójek	Noun
moczarami	Noun
pionowa	Adjective
okopów	Noun
siarczanem	Noun
parskałaby	Verb
zeznaniom	Noun
egzaminował	Verb
wyżmie	Verb
odlewem	Noun
skuterów	Noun
energia	Noun
wosków	Noun
podali	Verb
iPhone'ach	Noun
popołudniem	Noun
sylabach	Noun
kierowca	Noun
łechtaczkami	Noun
antologię	Noun
demontowali	Verb
kierowanie	Masdar
niszczysz	Verb
akademię	Noun
lew	Noun
arkad	Noun
kawa	Noun
miewał	Verb
gwarancjami	Noun
oświetlanie	Masdar
metafora	Noun
czadu	Noun
maszyna	Noun
reizmu	Noun
trzebiłam	Verb
ropę	Noun
sanskycka	Adjective
poiła	Verb
majówka	Noun
kąsają	Verb
czaszkami	Noun
budziło	Verb
dumałby	Verb
odpowiednia	Adjective
kamera	Noun
betonowalibyście	Verb
identyfikowania	Noun
znaleziono	Participle
tuńczyk	Noun
jedynakiem	Noun
używaliśmy	Verb
szmaragdem	Noun
najrozsądniejsza	Adjective
podrywałabyś	Verb
krótka	Adjective
właściwościom	Noun
nastawiło	Verb
pomocach	Noun
biletów	Noun
komedio	Noun
sauna	Noun
taczka	Noun
klępa	Noun
atakowi	Noun
orędzi	Noun
naukowcom	Noun
dyskotek	Noun
krótsza	Adjective
dalsi	Adjective
bankiem	Noun
kaszlałaby	Verb
neptunowi	Noun
milicjant	Noun
otrzymani	Participle
karząc	Converb
pamiętanie	Masdar
iloczynami	Noun
synonimu	Noun
robakiem	Noun
odkryją	Verb
mleczanu	Noun
autentyczna	Adjective
genetyczna	Adjective
zmrokowi	Noun
wymiksuję	Verb
głoska	Noun
lakierem	Noun
ostrzeżeń	Noun
orderom	Noun
diamentach	Noun
nocnymi	Adjective
sprzężona	Participle
izotopami	Noun
wstążka	Noun
astronomem	Noun
somalijskimi	Adjective
czytelnikach	Noun
infekcję	Noun
poprawiałem	Verb
szczytami	Noun
wylogować	Verb
grodowi	Noun
nękałyśmy	Verb
przekwita	Verb
gniliby	Verb
dochodziłybyśmy	Verb
bywa	Verb
filmowano	Participle
terminalach	Noun
bałałajkami	Noun
sługom	Noun
kolażem	Noun
poronilibyście	Verb
kastruje	Verb
weberem	Noun
popełniło	Verb
przygotowałem	Verb
blokom	Noun
mnożeniem	Noun
pluć	Verb
Holendrami	Noun
rycerzami	Noun
enterom	Noun
oddanie	Masdar
technicznymi	Adjective
optymistami	Noun
point	Noun
seksualnymi	Adjective
surrealizmu	Noun
syrena	Noun
rozmyśla	Verb
pulpitami	Noun
męka	Noun
koparkę	Noun
huśtawkę	Noun
edytowany	Participle
wcześniejsza	Adjective
wyglądam	Verb
podlewają	Verb
spadochronem	Noun
dziękowali	Verb
gwiazdkę	Noun
twarogów	Noun
słuchałybyście	Verb
dubeltówek	Noun
basom	Noun
wracało	Verb
rozwiążę	Verb
zasługiwać	Verb
kontrprzykładom	Noun
szczudłu	Noun
portretami	Noun
kompilowano	Participle
podtytułach	Noun
wybrałby	Verb
podejrzewały	Verb
rozważą	Verb
śledzioną	Noun
czytelni	Adjective
imitacją	Noun
wywołałabyś	Verb
barwę	Noun
księgach	Noun
ekspertom	Noun
termostatu	Noun
brokułów	Noun
miarach	Noun
podpal	Verb
kłamaliście	Verb
szala	Noun
pestycydu	Noun
septym	Noun
ospą	Noun
kajakiem	Noun
cero	Noun
bytom	Noun
jąkałaś	Verb
grzeszyłem	Verb
wyrocznia	Noun
zimowałbyś	Verb
gazowa	Adjective
rabanu	Noun
ciężarów	Noun
Brytyjczykach	Noun
systematyczniejsza	Adjective
doprowadzajcie	Verb
hadisach	Noun
sposobom	Noun
pojawilibyście	Verb
czcionek	Noun
kolanie	Noun
przyjęciach	Noun
wymógł	Verb
nożownikowi	Noun
rylca	Noun
otrzymywanie	Masdar
fałszywek	Noun
radiologia	Noun
skarbom	Noun
egiptologiem	Noun
poprawiłem	Verb
podstawowi	Adjective
kamieniarzowi	Noun
zrozumiałoby	Verb
olch	Noun
oddychająca	Participle
urządzeniem	Noun
czynami	Noun
wybrało	Verb
uczestniczysz	Verb
zaprzeczylibyście	Verb
burzami	Noun
algebrą	Noun
Koreańczykami	Noun
kwiatostanach	Noun
karykaturach	Noun
macką	Noun
domom	Noun
druhom	Noun
zauważyłem	Verb
hipopotamach	Noun
bogiń	Noun
wdychaniem	Noun
horyzontowi	Noun
jagodę	Noun
umieram	Verb
symulowałyśmy	Verb
sprawami	Noun
sprzątnąłbyś	Verb
trzaskająca	Participle
jabłkach	Noun
leziesz	Verb
zapamiętali	Verb
wodociągach	Noun
akumulatorami	Noun
zakładami	Noun
zadany	Participle
marchio	Noun
paszportu	Noun
nakryłbyś	Verb
ścięgnie	Noun
wymyślali	Verb
lakierowi	Noun
abonować	Verb
onanizmu	Noun
kichacie	Verb
dewoty	Noun
woltach	Noun
zamożni	Adjective
piórze	Noun
starajcie	Verb
pasażerowi	Noun
lepszymi	Adjective
zapamiętałeś	Verb
Czech	Noun
ciężka	Adjective
rytuałami	Noun
opuszczano	Participle
kraść	Verb
szpinetów	Noun
żartował	Verb
miesiączek	Noun
fasada	Noun
afrykatami	Noun
zbyła	Verb
rozmawiałyby	Verb
sługach	Noun
odbudowanie	Masdar
brodaci	Adjective
ruszało	Verb
korporacją	Noun
tenisowa	Adjective
ławek	Noun
wydmę	Noun
straciła	Verb
potakiwałem	Verb
rada	Noun
zagiąć	Verb
naprawiali	Verb
biegam	Verb
szynkę	Noun
inwalida	Noun
dziobaków	Noun
odbiornikowi	Noun
pomagałbyś	Verb
glinę	Noun
ciufcia	Noun
malarką	Noun
szybowców	Noun
rzymskimi	Adjective
piszczał	Verb
zapałek	Noun
mierźcie	Verb
idiotoodpornymi	Adjective
osobom	Noun
wahań	Noun
chochelko	Noun
hokeistą	Noun
biuru	Noun
krawędziom	Noun
częstochowscy	Adjective
kwazicząstek	Noun
zimują	Verb
wilczycami	Noun
kupują	Verb
sakramentów	Noun
pokonana	Participle
górom	Noun
bałałajkę	Noun
sceptycyzmu	Noun
szkodzę	Verb
stypendiami	Noun
uważałyśmy	Verb
brudzenie	Masdar
uparta	Adjective
Amerykanami	Noun
żeglowania	Noun
salamandrą	Noun
egoistycznymi	Adjective
podgrupą	Noun
dostajemy	Verb
zrzuciło	Verb
rażąca	Participle
pelikanem	Noun
płaćmy	Verb
szczekali	Verb
wykresów	Noun
pojawiłyby	Verb
adrenaliną	Noun
spojówką	Noun
czwórek	Noun
korsarzom	Noun
rosyjska	Adjective
szczur	Noun
akację	Noun
cierniach	Noun
sikasz	Verb
wydawnictwami	Noun
stolicę	Noun
eksportowany	Participle
kajmanach	Noun
wandalizmach	Noun
szachisto	Noun
macocha	Noun
architektem	Noun
fabrykom	Noun
przygodach	Noun
pokora	Noun
randek	Noun
ujebiemy	Verb
ciekłymi	Adjective
swastykami	Noun
stetoskopem	Noun
podziwiania	Noun
filtrami	Noun
tętnicą	Noun
biurowca	Noun
latawcem	Noun
identyfikowaniem	Noun
tęskniliście	Verb
eucharystia	Noun
bisu	Noun
gruda	Noun
spieszy	Verb
demografem	Noun
ściągnęły	Verb
głazów	Noun
gutację	Noun
karpiami	Noun
piędziami	Noun
poleca	Verb
ściemom	Noun
szczeniąt	Noun
uwielbiają	Verb
barometrami	Noun
koszykarek	Noun
wibrafonu	Noun
działkę	Noun
strzelałybyśmy	Verb
gwałciłybyście	Verb
poziomicę	Noun
główna	Adjective
Chinkom	Noun
resztek	Noun
ulewami	Noun
miałem	Noun
wygnańcach	Noun
włączany	Participle
weberach	Noun
łużyckimi	Adjective
kameruńska	Adjective
nazywaj	Verb
ciąża	Noun
fotosyntezę	Noun
mątwom	Noun
czerpie	Verb
występuje	Verb
słyszy	Verb
zawiedziony	Participle
emocjonalnymi	Adjective
napojem	Noun
skręciliśmy	Verb
zachętom	Noun
autokarem	Noun
odcieniach	Noun
garnka	Noun
Chińczyk	Noun
frank	Noun
sinusów	Noun
carami	Noun
hongkońska	Adjective
tur	Noun
pędząc	Converb
dochodzi	Verb
sudecka	Adjective
otworzyłem	Verb
opuszczany	Participle
pełna	Adjective
festiwalami	Noun
fragmentach	Noun
aneksem	Noun
opisywały	Verb
halibutów	Noun
umawialibyśmy	Verb
kapusto	Noun
macedońskimi	Adjective
cepem	Noun
cokołami	Noun
urodzona	Participle
ścignęliście	Verb
dotknięta	Participle
nastawiłbyś	Verb
kibicował	Verb
anglistą	Noun
pszczółka	Noun
fosforanu	Noun
sopla	Noun
klęka	Verb
lotów	Noun
siedmiokątem	Noun
widzą	Verb
ruszałyśmy	Verb
oglądałaś	Verb
szali	Noun
Białorusinom	Noun
cyrylica	Noun
halach	Noun
zaczął	Verb
starobułgarska	Adjective
upokarzania	Noun
słuchały	Verb
sferą	Noun
wyborom	Noun
cisowa	Adjective
opiekunami	Noun
prolinę	Noun
wstają	Verb
ubóstwiająca	Participle
ketonami	Noun
studiując	Converb
marynarzach	Noun
wracano	Participle
sikor	Noun
poczekajcie	Verb
haremów	Noun
teczka	Noun
wezyrowi	Noun
pokażę	Verb
wyżęłaby	Verb
kapa	Noun
buchała	Verb
rzeczka	Noun
dźwięczni	Adjective
czyni	Verb
partner	Noun
naprawiałbyś	Verb
słyszałem	Verb
przypomniałaby	Verb
wilga	Noun
samurajowi	Noun
dłużnikowi	Noun
infekcjami	Noun
rdzeniach	Noun
farmami	Noun
plusem	Noun
apetytem	Noun
tkanką	Noun
najwęższa	Adjective
żartowała	Verb
rekordu	Noun
zaczekalibyśmy	Verb
oczojebnymi	Adjective
chodnikiem	Noun
rozbita	Participle
szklarnię	Noun
smarowania	Noun
powtarzałybyście	Verb
sabotowania	Noun
rozmawialibyście	Verb
śpi	Verb
wyspa	Noun
krata	Noun
cielętach	Noun
krajobrazami	Noun
biogazem	Noun
kukałyby	Verb
pismakowi	Noun
troska	Noun
zarezerwowały	Verb
przesadzasz	Verb
termostatem	Noun
szczając	Converb
ścianami	Noun
torbą	Noun
płótnem	Noun
silnikom	Noun
wycieczkami	Noun
dokonuję	Verb
kaukascy	Adjective
najpoważniejsza	Adjective
mordo	Noun
ślubom	Noun
rodzina	Noun
słabościach	Noun
kieruje	Verb
radiokompasów	Noun
klawiaturę	Noun
operacjom	Noun
czworokątem	Noun
paznokcia	Noun
opiekunowi	Noun
czytaliście	Verb
otworom	Noun
sekunda	Noun
wymogłaś	Verb
sądzą	Verb
hasał	Verb
foka	Noun
bąbelkowi	Noun
pumeksem	Noun
ciągnikiem	Noun
Włoch	Noun
jazem	Noun
fiołkami	Noun
łódek	Noun
koniugację	Noun
cedzidłom	Noun
celuloza	Noun
prawideł	Noun
suknią	Noun
basista	Noun
zagrodami	Noun
obrażajmy	Verb
nizinach	Noun
septyma	Noun
przeglądarką	Noun
organizmu	Noun
dziadkowi	Noun
cezu	Noun
używałybyście	Verb
urzędnikach	Noun
drgałabym	Verb
brutalni	Adjective
firmom	Noun
porcelanowa	Adjective
medalowi	Noun
gryzoniami	Noun
czasopiśmie	Noun
angielscy	Adjective
zbieżnością	Noun
wyrzucić	Verb
galą	Noun
dąsałoby	Verb
narzekało	Verb
chomik	Noun
półkulami	Noun
surrealistami	Noun
gronostaj	Noun
parkowałoby	Verb
wiolonczelo	Noun
bagnetowi	Noun
brudzić	Verb
podpaleniach	Noun
ziemianka	Noun
szakalem	Noun
portrecista	Noun
krtanią	Noun
czytań	Noun
wymiksować	Verb
gabinetem	Noun
zajętymi	Adjective
czerpano	Participle
ściegów	Noun
zwycięzcą	Noun
wilgotnością	Noun
księże	Noun
rurą	Noun
armatami	Noun
dworu	Noun
potwierdzająca	Participle
gniazdem	Noun
trzaska	Verb
szprychami	Noun
ziębnęła	Verb
wędrowałaś	Verb
jesionem	Noun
kapturem	Noun
zakładkę	Noun
suszarkę	Noun
pracą	Noun
ruszyłem	Verb
rycin	Noun
migrenom	Noun
cegiełkę	Noun
granicz	Verb
bułką	Noun
maltańskimi	Adjective
zdumiewająca	Adjective
morela	Noun
Słowakami	Noun
grabów	Noun
prewencja	Noun
mieszało	Verb
dżumę	Noun
planowałabym	Verb
najwierniejsi	Adjective
poznajcie	Verb
odpocząć	Verb
śmietników	Noun
stropami	Noun
deptakiem	Noun
wyżeł	Noun
kompilowali	Verb
następnikiem	Noun
braćmi	Noun
blondyn	Noun
matrycami	Noun
doktorem	Noun
futer	Noun
molekułach	Noun
złapano	Participle
więźnięto	Participle
zbierać	Verb
hitu	Noun
dodawałam	Verb
kłębach	Noun
zamknęła	Verb
spieszycie	Verb
opierdoliłybyście	Verb
Grzesiek	Noun
chałka	Noun
wyjaśnianiem	Noun
spiskach	Noun
odjebaliście	Verb
sypią	Verb
tajfunom	Noun
ćwicz	Verb
leworęczna	Adjective
sądziłem	Verb
wdepnie	Verb
wylana	Participle
słuchająca	Participle
przymiotowi	Noun
spichlerzach	Noun
portretowi	Noun
ogrodnik	Noun
jajowodach	Noun
nieparzystymi	Adjective
pupo	Noun
lękali	Verb
kiełbasę	Noun
wahałem	Verb
palmę	Noun
wydawnictwom	Noun
telegramach	Noun
cenników	Noun
żałujecie	Verb
chwilka	Noun
kosztujcie	Verb
uczniami	Noun
trzymało	Verb
anonsach	Noun
półeczkę	Noun
potwierdzałaby	Verb
kosiły	Verb
lemoniada	Noun
skakaliby	Verb
Żydówko	Noun
nogawek	Noun
katafalkach	Noun
muzo	Noun
związkom	Noun
ziać	Verb
wyjaśnią	Verb
macew	Noun
oddycha	Verb
miedza	Noun
śmieją	Verb
rozrywkę	Noun
edytujemy	Verb
gruszka	Noun
dworcami	Noun
pies	Noun
rozmaitościach	Noun
ofiarami	Noun
szczeliną	Noun
neologizmami	Noun
popełniłyśmy	Verb
wiła	Noun
notowany	Participle
jajnikowi	Noun
absurdami	Noun
modrzewia	Noun
promu	Noun
drukarka	Noun
Fenicjanami	Noun
głupia	Adjective
zgromadzeniami	Noun
aneksami	Noun
plemnikiem	Noun
bullach	Noun
statuetką	Noun
heksametrem	Noun
kradnę	Verb
liczebnikach	Noun
łódkę	Noun
śmiałem	Verb
arię	Noun
plastra	Noun
kusi	Verb
konkordatem	Noun
pszczółkę	Noun
śniadałoby	Verb
wybierały	Verb
wierszowi	Noun
obgadacie	Verb
krążownikom	Noun
otrzymam	Verb
ukryj	Verb
szumami	Noun
paprykami	Noun
umierałbyś	Verb
kanapach	Noun
biskupem	Noun
faktu	Noun
obiecadle	Noun
czytelnikom	Noun
wymówiłyście	Verb
cmentarzom	Noun
informatyk	Noun
dżelada	Noun
notujecie	Verb
strukturom	Noun
odraczamy	Verb
stołówką	Noun
lubiąca	Participle
dedykuję	Verb
odradzał	Verb
wełną	Noun
pioruna	Noun
hermeneutyką	Noun
cena	Noun
polowaliśmy	Verb
rzemiośle	Noun
wpływają	Verb
szpiegom	Noun
ubek	Noun
powodziami	Noun
akordeonem	Noun
gałom	Noun
planowi	Noun
rosołów	Noun
wisząca	Participle
ludu	Noun
szermierki	Noun
przyniósłby	Verb
rzeczownikach	Noun
przekładem	Noun
siedzicie	Verb
odrazą	Noun
wiosłach	Noun
koktajlem	Noun
flirtu	Noun
znajduję	Verb
budzikom	Noun
kropeczek	Noun
jeżem	Noun
zachowają	Verb
lepiłeś	Verb
wierchuszko	Noun
numerujemy	Verb
piór	Noun
inteligentnymi	Adjective
gwałtach	Noun
rozwiązałby	Verb
filmują	Verb
nowojorscy	Adjective
brzóz	Noun
używana	Participle
zjadło	Verb
kierownic	Noun
liderami	Noun
szkieletu	Noun
unicestwił	Verb
kuprem	Noun
woniałybyście	Verb
proroctw	Noun
odradzano	Participle
samicom	Noun
odpoczęłyście	Verb
uliczka	Noun
ścięgnem	Noun
szprych	Noun
robak	Noun
skrzydle	Noun
wywołany	Participle
klawiszy	Noun
chwastu	Noun
zbóż	Noun
komorę	Noun
zapaleniami	Noun
iBooków	Noun
sąsiadkę	Noun
mandatami	Noun
potężna	Adjective
kondygnacja	Noun
liszko	Noun
dropiami	Noun
majem	Noun
tyłami	Noun
dinozaurami	Noun
gryzły	Verb
zesrałabym	Verb
wyjec	Noun
republikami	Noun
pretorem	Noun
umycie	Masdar
podkradało	Verb
ładuję	Verb
szachownicę	Noun
kołowrotu	Noun
ław	Noun
odwrotnością	Noun
heksanami	Noun
przeleciałaby	Verb
mas	Noun
dzida	Noun
niebytom	Noun
piega	Noun
łacińska	Adjective
chadzał	Verb
ramach	Noun
marudziły	Verb
życz	Verb
trosk	Noun
wyglądają	Verb
sprzątnąłby	Verb
kwiaciarkach	Noun
symulowałeś	Verb
sympatię	Noun
maciejek	Noun
oddychać	Verb
odcieni	Noun
cytujesz	Verb
płomykówkę	Noun
wymyślałyby	Verb
satrapy	Noun
wyświetlał	Verb
odchodzili	Verb
chroni	Verb
opowiadań	Noun
świerzbią	Verb
przenośnymi	Adjective
papierośnica	Noun
kondensatora	Noun
ukrywano	Participle
znaleźliście	Verb
stadiów	Noun
wojnom	Noun
wołaj	Verb
krzycząca	Participle
misję	Noun
suszyłaby	Verb
pielgrzymach	Noun
odraczania	Noun
milicjach	Noun
oknem	Noun
bizmutu	Noun
bawarskimi	Adjective
prostopadłościanem	Noun
dziobu	Noun
robocizn	Noun
ćwiczeniom	Noun
logopedyczna	Adjective
zamówieniem	Noun
myślnikiem	Noun
akrobatką	Noun
biaława	Adjective
stołowi	Noun
wazeliną	Noun
psułyśmy	Verb
ryjówka	Noun
portugalska	Adjective
luno	Noun
zwrotników	Noun
tolerujemy	Verb
hydraulikom	Noun
wielojęzyczna	Adjective
fotograf	Noun
ładnymi	Adjective
czescy	Adjective
świerzbiałyby	Verb
cytoplazma	Noun
zapachach	Noun
napastnik	Noun
trupami	Noun
szpitala	Noun
gruchot	Noun
albatrosów	Noun
pijająca	Participle
naparstnica	Noun
więźniem	Noun
aresztach	Noun
monetach	Noun
zapraszałaś	Verb
symulują	Verb
idiomach	Noun
hufnalami	Noun
tolerowani	Participle
zburzyłby	Verb
winogronach	Noun
jednowymiarowa	Adjective
urzędach	Noun
otworzę	Verb
alfabetu	Noun
termostatom	Noun
zabijała	Verb
porcję	Noun
wyłudzałybyście	Verb
tenis	Noun
drapieżnikowi	Noun
dzidziusiem	Noun
idol	Noun
podnosić	Verb
zwymyśla	Verb
negatywami	Noun
potwierdzałby	Verb
cieczami	Noun
procentami	Noun
tostów	Noun
zaczynał	Verb
zeszytu	Noun
wyłączałaś	Verb
schlebiać	Verb
skutkowi	Noun
wywołało	Verb
nazwę	Noun
maskują	Verb
skurczami	Noun
daru	Noun
wynajął	Verb
substancją	Noun
barnem	Noun
katarynkami	Noun
wskazują	Verb
jadeitem	Noun
polonu	Noun
kandydatach	Noun
higienicznymi	Adjective
izoleucyna	Noun
krynico	Noun
charakterach	Noun
pisałam	Verb
sierpami	Noun
obułyśmy	Verb
głosujesz	Verb
wiara	Noun
eksportowało	Verb
szaleństwem	Noun
spieszenie	Masdar
wtorkami	Noun
chciałam	Verb
robotnik	Noun
łąką	Noun
jeździłaby	Verb
sernika	Noun
maściach	Noun
hipotezach	Noun
wrzosu	Noun
kradziona	Participle
urlopów	Noun
zniszczyłbym	Verb
mewo	Noun
księgom	Noun
podziwiała	Verb
uczyłem	Verb
reprodukcję	Noun
zeszytami	Noun
łąkę	Noun
arka	Noun
doradcom	Noun
karetką	Noun
wioskę	Noun
wygarnąwszy	Converb
amperomierza	Noun
robociznę	Noun
drgałybyście	Verb
janczar	Noun
matematyką	Noun
jenów	Noun
dajesz	Verb
pragnień	Noun
gospodami	Noun
samochodowa	Adjective
istot	Noun
kwasach	Noun
działaczach	Noun
publiczna	Adjective
przecinkowi	Noun
saksofonistę	Noun
uwielbia	Verb
kopalniach	Noun
grzechem	Noun
ogonowi	Noun
sarna	Noun
wyłudzisz	Verb
grzechotka	Noun
potwierdzisz	Verb
psychuszka	Noun
śmiałbym	Verb
lepsi	Adjective
straganów	Noun
licznikami	Noun
dyszach	Noun
rogalikom	Noun
sprzężono	Participle
śpiewakom	Noun
stawiałem	Verb
falochronu	Noun
pokrzyw	Noun
uznawałbym	Verb
oszczepów	Noun
trudna	Adjective
prasach	Noun
akapitem	Noun
deszczykami	Noun
akcelerację	Noun
zachęt	Noun
sonetach	Noun
paczkami	Noun
kołowrotem	Noun
pasożytniczymi	Adjective
planowana	Participle
sromów	Noun
pach	Noun
robimy	Verb
wymyślałabym	Verb
drumlom	Noun
opatentowano	Participle
ciocię	Noun
ficzerom	Noun
poroniłeś	Verb
zwrotnymi	Adjective
otworzą	Verb
kibicowałybyście	Verb
listew	Noun
antygenów	Noun
torebkach	Noun
rękodziełem	Noun
zajebałabyś	Verb
wskazałeś	Verb
oszustwu	Noun
zaworem	Noun
aldehydów	Noun
utworami	Noun
informacjo	Noun
kontynentem	Noun
zamachowi	Noun
polanowi	Noun
niesprawiedliwymi	Adjective
fanatykach	Noun
lubczyków	Noun
wspomniana	Participle
poróżniły	Verb
kimałabym	Verb
dotyka	Verb
przeprosiłybyśmy	Verb
czaszka	Noun
drylowaniem	Noun
goździk	Noun
krzyczałoby	Verb
powtarzali	Verb
zwrotnicach	Noun
płacisz	Verb
manicure'om	Noun
frankom	Noun
szkodnikowi	Noun
zawciągów	Noun
tekstem	Noun
obalałby	Verb
drogę	Noun
Południowoafrykańczyk	Noun
rarytasom	Noun
rąbać	Verb
kontaktu	Noun
socjologię	Noun
wyrządziłam	Verb
gołymi	Adjective
wodni	Adjective
mięsożernymi	Adjective
kopnięciem	Noun
paliłby	Verb
mandragorę	Noun
rzeżączki	Noun
eposowi	Noun
ryżowymi	Adjective
rządowi	Adjective
sądziłby	Verb
praporządkiem	Noun
puchaczy	Noun
pędzą	Verb
czeznąłbyś	Verb
używajmy	Verb
wielorybami	Noun
zabrano	Participle
położną	Noun
ekskrementami	Noun
lemurami	Noun
stygnie	Verb
fitopatologia	Noun
gramach	Noun
wąwozu	Noun
zmieniliśmy	Verb
jaźwiec	Noun
kolejach	Noun
opowiadały	Verb
biedroneczka	Noun
dbam	Verb
niedźwiedziowi	Noun
hamulcem	Noun
rzeszom	Noun
maszynistą	Noun
miejscownikowi	Noun
renta	Noun
twarda	Adjective
dzięciołami	Noun
porażeń	Noun
konserwacją	Noun
dowodzono	Participle
lekarstwach	Noun
ulicom	Noun
rządzilibyśmy	Verb
wstępu	Noun
lantanowców	Noun
pojono	Participle
czerpaliście	Verb
rymami	Noun
maklerowi	Noun
zwięzłymi	Adjective
różnobarwnymi	Adjective
najbanalniejsi	Adjective
kryteriom	Noun
sągom	Noun
opisują	Verb
dzierżenie	Masdar
tęsknili	Verb
ukraińska	Adjective
bohatyrnijcie	Verb
zakładnikami	Noun
zmieniałbym	Verb
pelikan	Noun
łaknąć	Verb
potrzebowałybyśmy	Verb
odpoczynkiem	Noun
kłamcami	Noun
skrzydłach	Noun
trzymajmy	Verb
pożre	Verb
gejzerem	Noun
mieszkać	Verb
plątanina	Noun
pozorach	Noun
nożami	Noun
katedrę	Noun
usznymi	Adjective
Islandczykiem	Noun
dalach	Noun
zgubiły	Verb
zazdrościli	Verb
piołunem	Noun
kawaler	Noun
parzystymi	Adjective
getrów	Noun
charakteru	Noun
bemola	Noun
rewolwerem	Noun
znałam	Verb
alpejskimi	Adjective
heliocentryzmem	Noun
bezdzietni	Adjective
przystawek	Noun
Polakiem	Noun
lustrowi	Noun
półfinalistką	Noun
cofało	Verb
środka	Noun
mrę	Verb
soból	Noun
województwami	Noun
kartonowymi	Adjective
słodyczy	Noun
dokonanymi	Adjective
uważni	Adjective
nadzorująca	Participle
nazwom	Noun
notuje	Verb
dziewczyn	Noun
kierami	Noun
konserwantem	Noun
rezultatem	Noun
traszek	Noun
krystalografię	Noun
robiniom	Noun
muzyk	Noun
zapalniczek	Noun
tkaczkę	Noun
umywalkę	Noun
lotniskowcami	Noun
odbijałbyś	Verb
pokazywałem	Verb
edytowały	Verb
blizną	Noun
niedopałka	Noun
kołpakiem	Noun
mastektomio	Noun
budźcie	Verb
reputacjami	Noun
zimowi	Adjective
pejoratywnymi	Adjective
przeszczepach	Noun
bluzgałoby	Verb
Persach	Noun
przyjmowano	Participle
dyń	Noun
sprawom	Noun
kasiarzami	Noun
pluj	Verb
rosę	Noun
pułapek	Noun
zrobiło	Verb
krytyczna	Adjective
peruk	Noun
katalogów	Noun
puszczani	Participle
rodów	Noun
wykładnią	Noun
zbrodnię	Noun
poznałeś	Verb
skracał	Verb
łaźnię	Noun
cyklem	Noun
gazet	Noun
złamie	Verb
opisowi	Noun
mleczarz	Noun
tajska	Adjective
grahamom	Noun
wybrani	Participle
dziękują	Verb
ocalili	Verb
przestępcach	Noun
dostarcza	Verb
złapana	Participle
dokona	Verb
planowali	Verb
uczciwsza	Adjective
dąsałyście	Verb
pomidorami	Noun
najmniejszymi	Adjective
fabryko	Noun
akademiach	Noun
dziadkiem	Noun
przesadzają	Verb
turniejach	Noun
oszukały	Verb
nieobecna	Adjective
lizaków	Noun
trawieniem	Noun
dudach	Noun
amnestię	Noun
strumieniom	Noun
antropologach	Noun
padliny	Noun
szukaniem	Noun
personifikację	Noun
tonęły	Verb
marami	Noun
leczono	Participle
piętrze	Noun
uprzedziły	Verb
celnikowi	Noun
glinianymi	Adjective
asturyjskimi	Adjective
doceniamy	Verb
umysłach	Noun
potencjalni	Adjective
gdańska	Adjective
zbiorach	Noun
studniami	Noun
znajdowałaby	Verb
strajkach	Noun
życzyłbym	Verb
Szwedkom	Noun
marnościami	Noun
biegunowi	Noun
gówniak	Noun
cesarstwem	Noun
wstrząsem	Noun
wdzięczni	Adjective
jokerów	Noun
sabotowali	Verb
fregata	Noun
atmosferę	Noun
maślanko	Noun
jawna	Adjective
nagonek	Noun
majerankiem	Noun
płaczę	Verb
wiatru	Noun
złamanie	Masdar
korsykańska	Adjective
świń	Noun
dżdżownicę	Noun
zaniechali	Verb
zbyli	Verb
piekielnik	Noun
rzeszę	Noun
urzędasach	Noun
podniesieni	Participle
chórami	Noun
pigułek	Noun
montownię	Noun
zachowaliśmy	Verb
mąkami	Noun
siedzą	Verb
ujebana	Participle
wyjaśniani	Participle
włączając	Converb
napierdalaj	Verb
tragicznymi	Adjective
wzrostom	Noun
nartom	Noun
zapraszał	Verb
bazaltu	Noun
ziębnęliby	Verb
kłócimy	Verb
tomowi	Noun
żałowałem	Verb
mapą	Noun
podpisami	Noun
zimowała	Verb
podpaliłby	Verb
zakonnik	Noun
egzorcysty	Noun
wkurwiacie	Verb
kozicą	Noun
banknotu	Noun
kropkami	Noun
lewę	Noun
bezpieczeństwu	Noun
morfinę	Noun
apiolowi	Noun
barwach	Noun
zorza	Noun
trzcinami	Noun
przyciskami	Noun
rowerami	Noun
łazi	Verb
głodówka	Noun
spektrometru	Noun
neutronach	Noun
ekierkę	Noun
krzyków	Noun
rozkładach	Noun
kolorowa	Adjective
wątpliwością	Noun
jamach	Noun
obciąża	Verb
Atarynka	Noun
strumieniowi	Noun
dowodzeni	Participle
zaprzeczył	Verb
parkowaniem	Noun
restauracjach	Noun
obrabujcie	Verb
dźwigami	Noun
prawnik	Noun
zadasz	Verb
gazetowymi	Adjective
pępowina	Noun
kosztuje	Verb
przeczytajcie	Verb
petach	Noun
herbat	Noun
wylały	Verb
stajemy	Verb
klatka	Noun
Islandczykach	Noun
filmując	Converb
torebko	Noun
pęknięta	Participle
liczbę	Noun
latarkę	Noun
samotnikiem	Noun
haftowany	Participle
pisany	Participle
wzorach	Noun
zamykały	Verb
wrzecionom	Noun
tatuażami	Noun
oddało	Verb
westernach	Noun
wypiekami	Noun
żałuję	Verb
uderzy	Verb
spróbował	Verb
dokonywałyście	Verb
płytom	Noun
zrzuciła	Verb
podczerwonymi	Adjective
falangą	Noun
wywołują	Verb
abażurów	Noun
łgarzem	Noun
uchwytami	Noun
antygenu	Noun
bicepsów	Noun
hamulca	Noun
strzelcowi	Noun
tyłyby	Verb
fotek	Noun
hołdem	Noun
spustem	Noun
rybakiem	Noun
ogarnia	Verb
legionistą	Noun
Austriakiem	Noun
Niemka	Noun
scenę	Noun
odrzuciła	Verb
opierdoliłoby	Verb
tragediami	Noun
działajcie	Verb
cytrynami	Noun
toponimach	Noun
chwalilibyście	Verb
porą	Noun
zdolni	Adjective
fermionów	Noun
abchaska	Adjective
tylda	Noun
opierdolić	Verb
mądrzyłoby	Verb
ubekach	Noun
kupowałyby	Verb
ratowali	Verb
administrację	Noun
warzyw	Noun
komunistami	Noun
diecezją	Noun
czasownikowi	Noun
utylitaryzmu	Noun
karabinowi	Noun
rogówką	Noun
plemion	Noun
okopie	Noun
liczniejsi	Adjective
godziną	Noun
zabije	Verb
złotówami	Noun
liro	Noun
zawiedziona	Participle
ławkami	Noun
lakoniczna	Adjective
widzieliby	Verb
poduszeczka	Noun
krojona	Participle
googlowałbyś	Verb
blizna	Noun
roztrzepałam	Verb
samotnością	Noun
tyranozaurowi	Noun
stawała	Verb
dotykałoby	Verb
słyszałaś	Verb
rzeczywistościach	Noun
estetyzmu	Noun
łaziłyście	Verb
regułą	Noun
przerwą	Noun
koparką	Noun
sprzyjałaś	Verb
czarnuch	Noun
wykładnia	Noun
brzemienia	Noun
krążownikach	Noun
obciążało	Verb
słowików	Noun
potwierdziłyby	Verb
pierwotniakiem	Noun
szewcem	Noun
fioletowymi	Adjective
awangardy	Noun
psuliby	Verb
jaworami	Noun
elementowi	Noun
muzeom	Noun
dałeś	Verb
schlebiałyśmy	Verb
gumami	Noun
dziwiło	Verb
bratem	Noun
lipcowa	Adjective
kazaniem	Noun
piwnicach	Noun
wymyślisz	Verb
jednoręcy	Adjective
mordujcie	Verb
wygram	Verb
płotek	Noun
chlebem	Noun
duszona	Participle
mitologię	Noun
katedra	Noun
przesmykiem	Noun
procesowi	Noun
zapomniałbym	Verb
podpierdoliwszy	Converb
kolejkach	Noun
stadzie	Noun
przeinaczyliście	Verb
strażakiem	Noun
nieboskłonem	Noun
szerokimi	Adjective
znoszę	Verb
skalpelem	Noun
sterburt	Noun
sylabą	Noun
patologiami	Noun
chłopiec	Noun
wodorem	Noun
trzymać	Verb
sznurem	Noun
ratowałem	Verb
perzyna	Noun
zamieszkach	Noun
mazurskimi	Adjective
szkopułu	Noun
brzegom	Noun
labiryntów	Noun
dziobiemy	Verb
bankietach	Noun
milczały	Verb
bierni	Adjective
hektarem	Noun
struktur	Noun
widoczna	Adjective
półwyspem	Noun
mediolańskimi	Adjective
zburzy	Verb
spadały	Verb
czerwieńsi	Adjective
komentuj	Verb
pociechą	Noun
unikająca	Participle
Chorwatowi	Noun
teleskopem	Noun
meteorem	Noun
boscy	Adjective
rzeżączkę	Noun
histologią	Noun
biegunka	Noun
wyjebaliście	Verb
kondomem	Noun
pomyłkami	Noun
szafami	Noun
łyżwach	Noun
spichlerzami	Noun
kwadrygę	Noun
orko	Noun
termosu	Noun
psuć	Verb
przymiotom	Noun
palców	Noun
kramach	Noun
solidni	Adjective
czekajcie	Verb
listowi	Noun
doradca	Noun
gwizdałbym	Verb
karpackimi	Adjective
sarkałbym	Verb
rozwodami	Noun
niewyobrażalna	Adjective
zagięli	Verb
chrzczony	Participle
łojów	Noun
niełupka	Noun
wirnikach	Noun
dworców	Noun
jodoformu	Noun
rozważając	Converb
kat	Noun
planszówkami	Noun
statystą	Noun
bransoletkami	Noun
egzorcyzmu	Noun
mańkutowi	Noun
pojazdów	Noun
współcześni	Adjective
ciałkach	Noun
napisów	Noun
protestantyzmem	Noun
dostarczał	Verb
absorbowały	Verb
dodałabym	Verb
pocieszono	Participle
kochankowi	Noun
ufałbyś	Verb
powtarzania	Noun
kapitalistami	Noun
ćwiczyłyśmy	Verb
filmować	Verb
haczyka	Noun
bańkę	Noun
starymi	Adjective
zrzucił	Verb
krowami	Noun
biszkoptów	Noun
wybierzcie	Verb
niepokojom	Noun
zbiegały	Verb
wynalazcami	Noun
żebrakami	Noun
składnikom	Noun
Białorusin	Noun
ciężarówkami	Noun
wykresem	Noun
maską	Noun
łąkach	Noun
dermatolog	Noun
tytoniowa	Adjective
widziałeś	Verb
gorączka	Noun
hamowała	Verb
osiedlach	Noun
murzynami	Noun
onanizmem	Noun
gwiżdże	Verb
chóru	Noun
kadzidle	Noun
papierośnicę	Noun
suszyłaś	Verb
ciągników	Noun
szefem	Noun
aborcjom	Noun
syndykalista	Noun
malinę	Noun
wymagany	Participle
montażystka	Noun
doniczkach	Noun
morałem	Noun
odpowiedziach	Noun
Bułgarom	Noun
łbach	Noun
orężach	Noun
manometru	Noun
goniłbym	Verb
brązowa	Adjective
suriekcjo	Noun
płynąca	Participle
narządami	Noun
fag	Noun
technikiem	Noun
zrozumiano	Participle
chłopcze	Noun
sałatkami	Noun
rozmyślaliby	Verb
kukał	Verb
aromatu	Noun
mrugałabym	Verb
tolerowałbym	Verb
klubem	Noun
pisał	Verb
wstążeczka	Noun
salamandrę	Noun
utlenić	Verb
warszawiak	Noun
gniła	Verb
płatka	Noun
smołę	Noun
fizykę	Noun
zmartwychwstawałyśmy	Verb
dusząca	Participle
wezmą	Verb
socjalistyczna	Adjective
kretynem	Noun
kreska	Noun
czasz	Noun
występowało	Verb
pałacami	Noun
spragnieni	Adjective
wyjściami	Noun
angolscy	Adjective
wsiami	Noun
wyznaczyły	Verb
rzeziach	Noun
księżom	Noun
pękająca	Participle
tacę	Noun
kasami	Noun
odbijałybyście	Verb
wannę	Noun
produkuję	Verb
rozbiły	Verb
notatnika	Noun
mieszajcie	Verb
należałyby	Verb
burzyli	Verb
wyznaczą	Verb
wskazywało	Verb
polaczkami	Noun
sześćdziesięciolatkach	Noun
rzutów	Noun
zdarzeniem	Noun
wspominania	Noun
papa	Noun
łunom	Noun
sypie	Verb
baskijska	Adjective
gorzeliście	Verb
działajmy	Verb
pochodząca	Participle
bliznami	Noun
liniejąca	Participle
busom	Noun
brzegami	Noun
ślimakom	Noun
izbach	Noun
pokonamy	Verb
biernikiem	Noun
czka	Noun
serwerownia	Noun
wyrokom	Noun
serynami	Noun
maszyn	Noun
płynąc	Converb
zachowaniom	Noun
niedźwiedzicę	Noun
hasłami	Noun
koreańska	Adjective
realisty	Noun
zasługiwał	Verb
prano	Participle
traumatycznymi	Adjective
wykopią	Verb
obywatelami	Noun
politykiem	Noun
nawiasu	Noun
opiekowałyśmy	Verb
czulsza	Adjective
dzierżylibyście	Verb
zwrotką	Noun
napiszemy	Verb
prośbach	Noun
kłótnią	Noun
homarem	Noun
owadom	Noun
plebania	Noun
krogulców	Noun
tajfunami	Noun
żubroń	Noun
nieodpowiedzialna	Adjective
podbródkom	Noun
przedsiębiorcom	Noun
nędz	Noun
obrzękniecie	Verb
uderzyliby	Verb
kontrolowany	Participle
oceanowi	Noun
sprawdzania	Noun
osobowa	Adjective
cudzołożyłby	Verb
myślnikowi	Noun
biegunom	Noun
wyborcza	Adjective
mordowano	Participle
diademami	Noun
obserwowałam	Verb
dębach	Noun
szalikiem	Noun
próbowało	Verb
apostołowi	Noun
hedonistę	Noun
mięsie	Noun
wędruje	Verb
rozruchów	Noun
bohaterka	Noun
świerzbiałbyś	Verb
relacjami	Noun
chrzcić	Verb
zapamiętałyśmy	Verb
troposfera	Noun
eksperymentowały	Verb
pożarłbyś	Verb
dochodzimy	Verb
pustka	Noun
poprawiali	Verb
sajgonu	Noun
szkołami	Noun
szantażowanie	Masdar
zaiwaniłybyśmy	Verb
rzygałem	Verb
papierka	Noun
zrozumiałem	Verb
kamykach	Noun
robili	Verb
chronił	Verb
wybierają	Verb
sprawiałoby	Verb
kuchnią	Noun
licznikach	Noun
protokołowi	Noun
pacjentka	Noun
metodologię	Noun
pożarto	Participle
wyjaśniliśmy	Verb
skrzyżowań	Noun
pieczęcią	Noun
żarowi	Noun
nazywa	Verb
głosowały	Verb
lingwisty	Noun
imponowałaby	Verb
magowi	Noun
antywodoru	Noun
bawół	Noun
gadaj	Verb
Amerykankach	Noun
przeczytaj	Verb
klasę	Noun
papierem	Noun
wahając	Converb
poprzednimi	Adjective
biskupach	Noun
rozróżnisz	Verb
trąciłam	Verb
słodkowodna	Adjective
chałwami	Noun
parskała	Verb
e-mailom	Noun
wymuszeń	Noun
półwyspom	Noun
wymówią	Verb
szabatami	Noun
połknięty	Participle
marskością	Noun
zaprzeczyłem	Verb
dwujęzycznymi	Adjective
miewano	Participle
wojennymi	Adjective
anatomiczna	Adjective
pederastami	Noun
ojczyznę	Noun
celowników	Noun
babilońskimi	Adjective
dziennikarzowi	Noun
wyłączany	Participle
przekonaniom	Noun
grzywno	Noun
horyzontów	Noun
wymusiłyśmy	Verb
introligatorom	Noun
charakterami	Noun
rusza	Verb
dzierżyłybyście	Verb
zaprosiwszy	Converb
pesymista	Noun
krzesłom	Noun
mikrokontrolerom	Noun
duchem	Noun
najmłodszymi	Adjective
hokejowa	Adjective
zabrałoby	Verb
unikany	Participle
muzułmaninem	Noun
niemowlętach	Noun
kanastę	Noun
rozmyślanie	Masdar
tatuażach	Noun
budżetu	Noun
poziomic	Noun
klatką	Noun
fragmentów	Noun
dawajcie	Verb
podróżować	Verb
tubom	Noun
dzikami	Noun
chwil	Noun
mydlnicą	Noun
uciekinierami	Noun
runęło	Verb
googlował	Verb
draniem	Noun
sprawdźcie	Verb
ocaleni	Participle
cezem	Noun
tubę	Noun
weranda	Noun
zasługująca	Participle
pytonem	Noun
seniorami	Noun
makiem	Noun
atakowało	Verb
marzył	Verb
wymiarowa	Adjective
dosięgnąć	Verb
szmalcownikiem	Noun
śpiewało	Verb
kaszle	Verb
nerwami	Noun
pigwa	Noun
latają	Verb
mieszanka	Noun
pokazywał	Verb
meteorolog	Noun
radością	Noun
płaszczkom	Noun
pielęgniarkę	Noun
śliwkami	Noun
rzepakiem	Noun
pało	Noun
tomom	Noun
upustów	Noun
okoń	Noun
miękłoby	Verb
meduza	Noun
przeczytały	Verb
korpusami	Noun
grozą	Noun
ogr	Noun
cząsteczkami	Noun
nektarynami	Noun
poprzedzałbyś	Verb
inflacją	Noun
gościem	Noun
szatę	Noun
spinką	Noun
kroczem	Noun
światem	Noun
terminalowi	Noun
wschodnimi	Adjective
malowań	Noun
tradycyjnymi	Adjective
śniłem	Verb
zapamiętaliby	Verb
ozdobom	Noun
błotnista	Adjective
jajnikach	Noun
zaciążylibyście	Verb
internistom	Noun
znalazłbym	Verb
piętkom	Noun
sprzątnie	Verb
teologiczna	Adjective
rozsadza	Verb
myląca	Participle
polując	Converb
czaplą	Noun
zostawcie	Verb
ujadanie	Masdar
bankietów	Noun
odchodząc	Converb
spodkowi	Noun
nadużywał	Verb
figuro	Noun
wytłumaczono	Participle
sarkalibyście	Verb
portfelach	Noun
sadu	Noun
szałwią	Noun
grzmiał	Verb
zestawilibyśmy	Verb
namawiany	Participle
stylów	Noun
senna	Adjective
przeszkadzała	Verb
odbieracie	Verb
torbaczem	Noun
bumerangiem	Noun
parując	Converb
zamykam	Verb
chatami	Noun
zweryfikowali	Verb
haftujcie	Verb
bidetu	Noun
zweryfikuje	Verb
spódniczką	Noun
starając	Converb
stożkiem	Noun
gzach	Noun
adoracja	Noun
larw	Noun
wyhaftowałabyś	Verb
kurem	Noun
sprzedażą	Noun
bóstwu	Noun
bazylikach	Noun
zapalona	Participle
rozwiązany	Participle
Rzymianom	Noun
świtem	Noun
usuwałeś	Verb
zauważycie	Verb
bryło	Noun
kłykciem	Noun
sterowników	Noun
spałaszowałyście	Verb
okultyzmu	Noun
dymała	Verb
wybieramy	Verb
ściągnęłybyśmy	Verb
akapitami	Noun
termodynamiką	Noun
głowicami	Noun
kierunkiem	Noun
chełpiłybyśmy	Verb
siałyby	Verb
chruścikami	Noun
altówka	Noun
potężnymi	Adjective
łamało	Verb
dotykała	Verb
sław	Noun
kaszubska	Adjective
zyskom	Noun
oddająca	Participle
cukrowa	Adjective
matkom	Noun
olsz	Noun
siła	Noun
urugwajskimi	Adjective
traumatolog	Noun
surówkach	Noun
pniecie	Verb
przyczynom	Noun
rozróżniali	Verb
zbyta	Participle
lobelia	Noun
przędz	Noun
markizą	Noun
krzyżówkę	Noun
peruka	Noun
sprzątnęłabym	Verb
turystką	Noun
szczygłami	Noun
kruków	Noun
kolejowa	Adjective
fotografami	Noun
naczyniom	Noun
otaczano	Participle
pocieszyć	Verb
miotłę	Noun
abonująca	Participle
tilak	Noun
korków	Noun
dopływowi	Noun
złoczyńcą	Noun
przemówień	Noun
wystawą	Noun
żeglarzowi	Noun
wierzymy	Verb
dolnołużycka	Adjective
radosna	Adjective
podbiałem	Noun
wyjmowania	Noun
kolebkami	Noun
tłumaczyłem	Verb
napięciach	Noun
czapkach	Noun
kieliszkami	Noun
teksowi	Noun
zniszczeniom	Noun
zapominała	Verb
ostrowami	Noun
próżnią	Noun
genu	Noun
półkulach	Noun
rękawów	Noun
animację	Noun
systemów	Noun
kandelabrowi	Noun
lustrzanka	Noun
tapetę	Noun
rento	Noun
spróbowałbyś	Verb
opowiadaniami	Noun
brązowawymi	Adjective
dokonywałabyś	Verb
emirowi	Noun
tulipanach	Noun
armię	Noun
nakryjmy	Verb
wombatami	Noun
maro	Noun
bankrutowałbym	Verb
iskali	Verb
senni	Adjective
przedwojenni	Adjective
wskazało	Verb
papugą	Noun
smugami	Noun
refowałyśmy	Verb
odcinkach	Noun
występujesz	Verb
notując	Converb
cząstką	Noun
oliwkę	Noun
odwiedzająca	Participle
utleniłybyście	Verb
wyszukiwarkę	Noun
wielomianach	Noun
relikwiarzami	Noun
szkliwami	Noun
dojrzelibyśmy	Verb
ściągaliście	Verb
aktywniejszymi	Adjective
ćmom	Noun
bażynach	Noun
rzemieniom	Noun
ostateczni	Adjective
kresach	Noun
obeliskami	Noun
headshotowi	Noun
krzyczeli	Verb
pokusa	Noun
paliło	Verb
wschodu	Noun
hrywien	Noun
mil	Noun
wiosłowania	Noun
biografiom	Noun
fajni	Adjective
giez	Noun
elitą	Noun
rydwanach	Noun
przeszkadzam	Verb
lodowca	Noun
przytuliło	Verb
filologia	Noun
podróżnik	Noun
świńskimi	Adjective
kupiło	Verb
zasadami	Noun
niewystarczająca	Adjective
przegapiłeś	Verb
wyniosłyśmy	Verb
zestawić	Verb
znasz	Verb
nieprzyjemna	Adjective
wykopał	Verb
broiłeś	Verb
katodami	Noun
spotkałeś	Verb
urzędami	Noun
rąbał	Verb
wyłudzać	Verb
bilą	Noun
stanami	Noun
uśpic	Verb
kandydatom	Noun
fuga	Noun
ładowano	Participle
tłumaczeni	Participle
sejfami	Noun
przegrała	Verb
gwieździści	Adjective
szanował	Verb
Szkot	Noun
tworzyli	Verb
głupcowi	Noun
pojawiały	Verb
zielenią	Noun
wieją	Verb
kibicując	Converb
mnożnika	Noun
pianistami	Noun
astronomami	Noun
gorączek	Noun
magnesach	Noun
kołami	Noun
wykładnikami	Noun
marynarz	Noun
flaga	Noun
sękach	Noun
dziwka	Noun
tymczasowymi	Adjective
pokonalibyście	Verb
głośnikach	Noun
wynalazcą	Noun
ziemniakom	Noun
korkociągom	Noun
nadawcę	Noun
zamordowała	Verb
wyłącza	Verb
chłopakowi	Noun
kosarz	Noun
wracamy	Verb
czynowi	Noun
internista	Noun
lokator	Noun
dzwonków	Noun
wyznawcę	Noun
wyświetlanie	Masdar
zbrojarz	Noun
zachodzenie	Masdar
beretem	Noun
brudna	Adjective
wymyśliłam	Verb
zapraszając	Converb
krowianko	Noun
czesalibyście	Verb
zagraniczna	Adjective
wymagaj	Verb
płonęło	Verb
toporami	Noun
blogach	Noun
lutu	Noun
ogarniało	Verb
spotkana	Participle
roślinożercę	Noun
taflach	Noun
stanowiło	Verb
cielskiem	Noun
arginina	Noun
chcielibyście	Verb
życzył	Verb
prezentami	Noun
dzięcielino	Noun
nadzieją	Noun
obrzękowi	Noun
wichurami	Noun
antyklina	Noun
maneli	Noun
kołu	Noun
elitach	Noun
jedynek	Noun
dziejmy	Verb
fosą	Noun
odwzajemniła	Verb
oszustwach	Noun
atrapę	Noun
napierdalankami	Noun
cnotach	Noun
uprawiająca	Participle
konstytucją	Noun
Serbem	Noun
próbowali	Verb
zwyciężałaby	Verb
borowiną	Noun
kokosowa	Adjective
zrobili	Verb
spożywczymi	Adjective
podnosił	Verb
latarnia	Noun
chórowi	Noun
schnęły	Verb
badała	Verb
oszustw	Noun
wyborczymi	Adjective
proponująca	Participle
czekałem	Verb
studiować	Verb
lipę	Noun
chłopczyk	Noun
agresor	Noun
tabela	Noun
szczepionkę	Noun
fosforem	Noun
wiertarkę	Noun
murzynem	Noun
wybuchniecie	Verb
wymuszeniami	Noun
samolotowi	Noun
żarłokami	Noun
gimnazjów	Noun
znajdująca	Participle
niżami	Noun
abonuje	Verb
kontu	Noun
obserwują	Verb
skurczowi	Noun
potrzebuje	Verb
obiecała	Verb
australijskimi	Adjective
cerkwiami	Noun
dziennikarzem	Noun
umywalko	Noun
zacznie	Verb
mionu	Noun
wąż	Noun
wykopanie	Masdar
akronimom	Noun
rozczaruj	Verb
zasłużyłam	Verb
kardiologicznymi	Adjective
popełnienie	Masdar
windą	Noun
silniejszymi	Adjective
DJ-owi	Noun
domator	Noun
ogranicza	Verb
wydm	Noun
bransoleta	Noun
szalom	Noun
gankiem	Noun
paląc	Converb
synach	Noun
ortopeda	Noun
potopów	Noun
kuś	Verb
boiskach	Noun
czerwiami	Noun
afinicznymi	Adjective
wysyłamy	Verb
cerkwią	Noun
sprawdzam	Verb
trolejbusu	Noun
fałszywa	Adjective
chadzalibyśmy	Verb
regularnymi	Adjective
wygarniemy	Verb
bałtycka	Adjective
kumanie	Masdar
mordercę	Noun
pogrzebałybyśmy	Verb
iloczynów	Noun
amplituda	Noun
alpagami	Noun
łośkach	Noun
pogromach	Noun
złamała	Verb
fosa	Noun
pokonałby	Verb
klęskom	Noun
złotówko	Noun
pojawił	Verb
obszerniejsza	Adjective
błyskamy	Verb
wymówilibyśmy	Verb
ruszą	Verb
lochem	Noun
dawali	Verb
platynowymi	Adjective
inżynierom	Noun
podcastów	Noun
dewotka	Noun
schowaj	Verb
kaszlałabyś	Verb
zawiedziecie	Verb
przypomni	Verb
najbanalniejszymi	Adjective
wyłudzałem	Verb
tchórzliwa	Adjective
obserwuje	Verb
archeologiczna	Adjective
wyglądająca	Participle
opisując	Converb
Albańczykami	Noun
krwawiłyście	Verb
grobami	Noun
gestów	Noun
wszami	Noun
szastali	Verb
parowozownią	Noun
pochodził	Verb
piszemy	Verb
gładka	Adjective
japonkom	Noun
dalszymi	Adjective
strzałkach	Noun
łato	Noun
równoważnikiem	Noun
wyjęta	Participle
branżę	Noun
lotniskom	Noun
pianinie	Noun
pokonałybyście	Verb
otwórz	Verb
optyk	Noun
brązowawa	Adjective
muszlą	Noun
rozmyłam	Verb
zerżnęłybyście	Verb
geodeta	Noun
jerzyk	Noun
morw	Noun
podwójnymi	Adjective
projektom	Noun
tuńczykiem	Noun
próbowałaby	Verb
junakach	Noun
wężem	Noun
dorszy	Noun
budź	Verb
semestru	Noun
przyrostkami	Noun
pająków	Noun
podróżując	Converb
fanatykami	Noun
ciężarach	Noun
sprawiałaś	Verb
krewetka	Noun
dobycie	Masdar
krzyżowi	Noun
kosaćcach	Noun
Amerykankom	Noun
grzechom	Noun
spróbujcie	Verb
potom	Noun
uciekinier	Noun
pozwalałby	Verb
bułgarscy	Adjective
kiczem	Noun
jajowodu	Noun
podlewano	Participle
twardówkę	Noun
śni	Verb
podziwiałyby	Verb
żelaznymi	Adjective
uwiedzie	Verb
carycą	Noun
wynalazcach	Noun
tracą	Verb
przyjmowanie	Masdar
mandatu	Noun
zburzono	Participle
lemoniadę	Noun
echem	Noun
otrzymalibyśmy	Verb
marzeniami	Noun
brodu	Noun
dopływach	Noun
instytutowi	Noun
depresją	Noun
wysokościami	Noun
precli	Noun
kangurowi	Noun
leukocytu	Noun
wilkołakowi	Noun
kadłuba	Noun
hawajska	Adjective
grzesznikami	Noun
medalionów	Noun
herbicydami	Noun
czasówka	Noun
opowiadali	Verb
siadałam	Verb
mundiali	Noun
studiuje	Verb
przesadzaj	Verb
poduszek	Noun
zmieniłby	Verb
wybielaczowi	Noun
wikipedysty	Noun
alergia	Noun
płoną	Verb
koryt	Noun
cyfrom	Noun
czekając	Converb
swetrach	Noun
supermarketowi	Noun
komora	Noun
wiązłeś	Verb
zaciążą	Verb
jedwabnikach	Noun
odczyniłybyście	Verb
bandaża	Noun
chromosomu	Noun
głodem	Noun
doradcę	Noun
nieorganicznymi	Adjective
tekstów	Noun
pierścienia	Noun
kapą	Noun
eksperymentować	Verb
pewnikiem	Noun
radiowozem	Noun
wyjrzałbym	Verb
przęśle	Noun
somnambulizmu	Noun
zadało	Verb
przelecimy	Verb
przyrodniczymi	Adjective
włócznią	Noun
moczyłyby	Verb
skowronkami	Noun
szeregach	Noun
panną	Noun
stracimy	Verb
zastrzeżona	Adjective
marskościach	Noun
najmniejsi	Adjective
zamawiaczek	Noun
lepią	Verb
zrobić	Verb
dowolnymi	Adjective
suszeni	Participle
zmieniło	Verb
dziedzinach	Noun
atakowani	Participle
demontowałabyś	Verb
fizykowi	Noun
łosiem	Noun
wyłączałybyście	Verb
liniowymi	Adjective
prądom	Noun
pieskowi	Noun
absorbujcie	Verb
rodzi	Verb
promieniem	Noun
zniknęliśmy	Verb
ścignięty	Converb
wspaniała	Adjective
konsensusem	Noun
poczwarka	Noun
mianami	Noun
ulotkę	Noun
partia	Noun
rozmiarami	Noun
wysyłałybyście	Verb
dziurką	Noun
nozdrzy	Noun
majsterkowałaby	Verb
ślubami	Noun
bywalec	Noun
cwałem	Noun
czcionką	Noun
świdrami	Noun
kasjerom	Noun
Rosjanin	Noun
chłodnymi	Adjective
odbierajmy	Verb
dodaje	Verb
lewicowymi	Adjective
momentów	Noun
spróbowałabym	Verb
mosiężna	Adjective
ocalisz	Verb
wygarnięto	Participle
sokiem	Noun
podstaw	Noun
organizuje	Verb
jedwabnikowi	Noun
reprezentant	Noun
pisarkami	Noun
rozbitkom	Noun
ciepłymi	Adjective
wdychać	Verb
cytowany	Participle
wstrętem	Noun
posłańcem	Noun
zaczną	Verb
grupę	Noun
ukryły	Verb
dodzwoniłaś	Verb
poprawię	Verb
zorzo	Noun
dud	Noun
pomagająca	Participle
prezydentami	Noun
andyjska	Adjective
chemik	Noun
rur	Noun
katalogiem	Noun
czarownicę	Noun
oceniana	Participle
maltozę	Noun
koparko	Noun
łodzią	Noun
niedźwiedzicą	Noun
kijów	Noun
zębach	Noun
polonijni	Adjective
kopciuszkowi	Noun
kieruję	Verb
zniknąć	Verb
sekundach	Noun
poczwarkach	Noun
maskowałabym	Verb
dżulowi	Noun
tarczom	Noun
czerpakom	Noun
dębami	Noun
wspominam	Verb
turystyką	Noun
leukocytów	Noun
druhami	Noun
zawodom	Noun
tuńczyków	Noun
śledzę	Verb
pniem	Noun
roślibyśmy	Verb
żarem	Noun
ostrzegał	Verb
upadkiem	Noun
lodówkach	Noun
wstępami	Noun
moczarem	Noun
siedzi	Verb
trawami	Noun
kompilatora	Noun
mżawkę	Noun
dłońmi	Noun
dereniami	Noun
premierem	Noun
mierzymy	Verb
kociąt	Noun
szkodzili	Verb
dziupla	Noun
przeciągowi	Noun
ropy	Noun
kominach	Noun
ogierem	Noun
spadochronowi	Noun
ulgę	Noun
profilowi	Noun
furtka	Noun
bębnami	Noun
pachniecie	Verb
głośników	Noun
mądrzyło	Verb
oddychałbym	Verb
symulacją	Noun
blenda	Noun
chrzcielnicę	Noun
świdrów	Noun
golfistą	Noun
faktami	Noun
łokciach	Noun
kształtom	Noun
sprzętach	Noun
piekarzom	Noun
grindwalami	Noun
lessowi	Noun
najwybitniejsza	Adjective
neutronów	Noun
ketchupem	Noun
napierdalałyśmy	Verb
hierarchą	Noun
odkryłem	Verb
prosa	Noun
żółwiowi	Noun
przestrzegacie	Verb
istotach	Noun
przełęczą	Noun
lizałybyście	Verb
aksjomatami	Noun
bezwzględnymi	Adjective
oddziałowi	Noun
wskazywałem	Verb
razów	Noun
oskarżała	Verb
alfabetem	Noun
biesów	Noun
koprolitowi	Noun
pszczelarzem	Noun
Japończyk	Noun
budach	Noun
analfabeta	Noun
koenzymów	Noun
przyspieszeniem	Noun
dodzwoniliście	Verb
obrażeni	Participle
znalazłam	Verb
pluralizmów	Noun
obozu	Noun
obywatelką	Noun
czynach	Noun
dojarka	Noun
wędrowiec	Noun
ruszaliby	Verb
enterów	Noun
wkrętów	Noun
kasta	Noun
owsiana	Adjective
wiązem	Noun
kosmonautom	Noun
wybrały	Verb
mańkut	Noun
identyfikowałeś	Verb
nieruchomi	Adjective
rentach	Noun
bronami	Noun
absolwentem	Noun
gęstwą	Noun
itru	Noun
obserwuj	Verb
małżonkiem	Noun
jonizowaliśmy	Verb
powtórzona	Participle
getcie	Noun
wyraźnymi	Adjective
przynoszenie	Masdar
globusem	Noun
maluchów	Noun
panno	Noun
hodowcą	Noun
leźlibyśmy	Verb
birmańska	Adjective
hałasu	Noun
przypominała	Verb
produkowała	Verb
skręcić	Verb
umięśnieni	Adjective
pomiarem	Noun
serwetka	Noun
omach	Noun
naparstnicach	Noun
kinie	Noun
kuźniami	Noun
cytadelą	Noun
wymyślono	Participle
kelnerką	Noun
odkryliby	Verb
rasom	Noun
skłotach	Noun
chochla	Noun
jeźdźcu	Noun
eremitą	Noun
wanadu	Noun
widocznymi	Adjective
rybom	Noun
makowcami	Noun
uznająca	Participle
nierównością	Noun
rzuciło	Verb
pierdzielibyśmy	Verb
otaczam	Verb
olejmy	Verb
poligamicznymi	Adjective
wadach	Noun
herbatkę	Noun
tuszem	Noun
pochodnym	Noun
woltyżerka	Noun
regułach	Noun
rosła	Verb
awaria	Noun
dostajesz	Verb
zdolnymi	Adjective
arystokratom	Noun
zachorować	Verb
chwalili	Verb
przemyśleć	Verb
antropomorfizmu	Noun
poznaliby	Verb
topolo	Noun
proszków	Noun
biurokrację	Noun
metalowymi	Adjective
pseudonimami	Noun
dziękowaliby	Verb
wokalistami	Noun
sinologię	Noun
nazwach	Noun
sanitariuszem	Noun
rózga	Noun
uprawiasz	Verb
karczma	Noun
księżniczek	Noun
szumu	Noun
dwuręczna	Adjective
najbiedniejsi	Adjective
córko	Noun
prawosławnymi	Adjective
pytaniami	Noun
dodatkiem	Noun
pomagalibyście	Verb
oszukała	Verb
pogrzebałem	Verb
parlamentem	Noun
nęka	Verb
nieodpowiednimi	Adjective
tańczyliście	Verb
smutałyśmy	Verb
bąbelków	Noun
bambusowymi	Adjective
runąć	Verb
dziękowałoby	Verb
działało	Verb
skałę	Noun
rzuci	Verb
podniosłabyś	Verb
fizyko	Noun
Czechem	Noun
zaczynanie	Masdar
tenisisto	Noun
akuszerek	Noun
wampir	Noun
prasę	Noun
miękcy	Adjective
pannami	Noun
pożyczenie	Masdar
skłam	Verb
wewnętrzna	Adjective
pojmowania	Noun
kradziono	Participle
stygnęliście	Verb
schizofrenia	Noun
wspomnieć	Verb
winu	Noun
kobrą	Noun
przyniosłeś	Verb
przeczytali	Verb
rycerz	Noun
zapamiętałem	Verb
żłobkach	Noun
kartografowi	Noun
wrzosów	Noun
oszołomom	Noun
mierzysz	Verb
podróbkę	Noun
wyloguj	Verb
studiowałam	Verb
szynszyla	Noun
bazaltów	Noun
podgrzybkiem	Noun
tęsknię	Verb
obrokami	Noun
samico	Noun
filmoteką	Noun
czarów	Noun
zatrzymaj	Verb
Rumunkom	Noun
kontrola	Noun
kradziony	Participle
posiadaliśmy	Verb
krążownika	Noun
wiatrakach	Noun
rydwanami	Noun
kondygnacjami	Noun
przoduje	Verb
drapani	Participle
zięciowi	Noun
cytując	Converb
zrobiłby	Verb
dyskotekę	Noun
kwasem	Noun
goryczko	Noun
dotykowi	Noun
rumaków	Noun
witaminami	Noun
karykaturami	Noun
posłuchania	Noun
haruje	Verb
Serb	Noun
czytamy	Verb
egzystencja	Noun
sterowca	Noun
zazdrosna	Adjective
esencję	Noun
zrabowałby	Verb
gadolinu	Noun
gotowała	Verb
kokoszkę	Noun
obejmuję	Verb
maszerowałyście	Verb
mordowały	Verb
profesję	Noun
metalurgiczna	Adjective
listonoszy	Noun
mocnymi	Adjective
okolicami	Noun
komitetów	Noun
odchodziłyście	Verb
zachować	Verb
liczni	Adjective
zrabowana	Participle
siedzib	Noun
przedmieściom	Noun
stycznymi	Noun
Słowak	Noun
śmiertelni	Adjective
kamienica	Noun
mostem	Noun
coroczna	Adjective
okresowa	Adjective
niania	Noun
liderach	Noun
samcach	Noun
ziarnem	Noun
sercami	Noun
den	Noun
siąknęli	Verb
piżamach	Noun
kramowi	Noun
łanią	Noun
wsparło	Verb
rato	Noun
ezoterycznymi	Adjective
przodująca	Participle
pszczółkach	Noun
wirusach	Noun
impotencja	Noun
terenami	Noun
dzieję	Verb
armatę	Noun
egzystencję	Noun
zwymyślałem	Verb
wymiarach	Noun
zamożnymi	Adjective
ratujmy	Verb
hamująca	Participle
potomkowi	Noun
bankrutuje	Verb
kalinę	Noun
gospodarstwach	Noun
spali	Verb
okazu	Noun
warszawianek	Noun
deskorolką	Noun
zauważą	Verb
bezlitosna	Adjective
sennymi	Adjective
rozmywałybyśmy	Verb
kulturach	Noun
łopato	Noun
placków	Noun
źródłach	Noun
krajobrazów	Noun
notowali	Verb
powietrzni	Adjective
chujowi	Adjective
bandami	Noun
cytadelami	Noun
fiordowi	Noun
skaz	Noun
arystokratycznymi	Adjective
fosę	Noun
wymyśla	Verb
klękano	Participle
olaliby	Verb
rzeźba	Noun
czapeczką	Noun
męczę	Verb
aniołek	Noun
biblioteka	Noun
hutą	Noun
topolach	Noun
tęczówek	Noun
otworzyły	Verb
równinę	Noun
wiertarka	Noun
fizycznymi	Adjective
rzucił	Verb
eksportowaliśmy	Verb
strzałem	Noun
koszmarami	Noun
ściągała	Verb
wyłączając	Converb
lubczykami	Noun
mozaika	Noun
stewardessą	Noun
wychowaniem	Noun
węgorzowi	Noun
kabaretami	Noun
kokoszek	Noun
esencjami	Noun
kwiaciarkę	Noun
obcasami	Noun
wizerunkowi	Noun
wymienia	Noun
gwintami	Noun
mar	Noun
opinia	Noun
chowano	Participle
serów	Noun
bibliografiami	Noun
kolca	Noun
kamieniom	Noun
monada	Noun
wielkościach	Noun
jogą	Noun
chwileczką	Noun
afera	Noun
alfom	Noun
dzierż	Verb
chciałbyś	Verb
poprawiło	Verb
wołałoby	Verb
obciążał	Verb
sosną	Noun
ujemna	Adjective
golenia	Noun
atrybutem	Noun
rzutach	Noun
turystyczna	Adjective
przepraszaliście	Verb
diagramem	Noun
poprawiłoby	Verb
wiszą	Verb
filmotekę	Noun
wąwozami	Noun
amin	Noun
szarogęszą	Verb
sikorę	Noun
pozostająca	Participle
wymusić	Verb
bywałem	Verb
melinom	Noun
sąsiedzkimi	Adjective
usuniemy	Verb
dodawaj	Verb
płaczem	Noun
tektoniki	Noun
prababcią	Noun
pozorna	Adjective
odpoczynkom	Noun
bluszczami	Noun
akrobatycznymi	Adjective
przeszkadzając	Converb
kołowrotkami	Noun
mordę	Noun
rozważa	Verb
smażylibyście	Verb
ochroniarzami	Noun
geograf	Noun
przytulono	Participle
wygrało	Verb
hrabia	Noun
jeździłem	Verb
parowców	Noun
jabłkami	Noun
konkursów	Noun
cząstkom	Noun
ceremonię	Noun
dworzaninem	Noun
tatarom	Noun
cienka	Adjective
przewidywalna	Adjective
mniejszością	Noun
kwotom	Noun
kontrolach	Noun
esemesowałeś	Verb
jaźwcem	Noun
ramionami	Noun
woskowiny	Noun
klasyfikacjom	Noun
otrujmy	Verb
kapelanowi	Noun
rozważałem	Verb
sycylijska	Adjective
sławę	Noun
sadzą	Noun
żołnierzom	Noun
opuszczająca	Participle
mokradeł	Noun
męczennikach	Noun
katoda	Noun
wymuszony	Participle
opiekunom	Noun
chamem	Noun
stokrotkę	Noun
polaną	Noun
ula	Noun
skurczy	Noun
stanowiąc	Converb
zapytaniem	Noun
prysznicem	Noun
listopadowa	Adjective
kontrolom	Noun
markerem	Noun
wkurwiamy	Verb
licealista	Noun
wytłumaczyli	Verb
włócznię	Noun
edredon	Noun
baskijscy	Adjective
słuchajcie	Verb
propagandą	Noun
dyskusjach	Noun
wymagamy	Verb
nadużywałyby	Verb
pokus	Noun
hołdu	Noun
ogórkowa	Adjective
aktywistką	Noun
bratanek	Noun
dyplomatą	Noun
widmie	Noun
kompaktowa	Adjective
kłótniach	Noun
anagramem	Noun
miasteczkami	Noun
beatyfikacjami	Noun
śmietaną	Noun
indem	Noun
tkanek	Noun
Ukraińcom	Noun
geometryczni	Adjective
docentach	Noun
stylom	Noun
opiniami	Noun
cesarko	Noun
fuksami	Noun
ciężarówek	Noun
lotniskowców	Noun
dedykowałby	Verb
konfliktach	Noun
wrotami	Noun
wąsa	Noun
płonąć	Verb
przeziębieniach	Noun
kurę	Noun
poczwarko	Noun
żuje	Verb
dotykał	Verb
kaszubscy	Adjective
żagla	Noun
zmieniłoby	Verb
drobiazgami	Noun
płaskowyży	Noun
zwiastunami	Noun
normę	Noun
maskując	Converb
poprawili	Verb
jezdnia	Noun
chemiczna	Adjective
czaszek	Noun
odszkodowaniami	Noun
wahaliśmy	Verb
ryczałyście	Verb
bezwarunkowymi	Adjective
bolidu	Noun
biurowcem	Noun
wydarzeniem	Noun
lizałybyśmy	Verb
zrzuci	Verb
myszami	Noun
arek	Noun
nazywał	Verb
hrywnę	Noun
biblioteką	Noun
smakująca	Participle
chausów	Noun
nawozami	Noun
spirytusem	Noun
klasom	Noun
głodna	Adjective
lokalach	Noun
cysterną	Noun
sępami	Noun
krycie	Masdar
współczynnikom	Noun
życiorysowi	Noun
pentanom	Noun
leszczyn	Noun
zawrzeć	Verb
zweryfikuję	Verb
zazdrością	Noun
kaszlałybyśmy	Verb
cholewą	Noun
umiarem	Noun
turniejom	Noun
gąska	Noun
norwescy	Adjective
altówkę	Noun
rączką	Noun
wazelinę	Noun
zasłoną	Noun
szczuł	Verb
kapela	Noun
opisywałaby	Verb
rzucany	Participle
opisywać	Verb
skorupkę	Noun
wylaszczyłyście	Verb
żartowałaby	Verb
rozgrzeszyłabym	Verb
tępa	Adjective
prezentację	Noun
lawenda	Noun
tasaka	Noun
psychologia	Noun
sową	Noun
cnotliwa	Adjective
akordeonistą	Noun
robić	Verb
wytłumaczysz	Verb
głowom	Noun
apoteozę	Noun
nizino	Noun
banglajmy	Verb
słyszeniem	Noun
harowali	Verb
reakcjach	Noun
grotach	Noun
konsekwencjami	Noun
fantastyczna	Adjective
umierało	Verb
geolog	Noun
kapusta	Noun
bić	Noun
wywołałby	Verb
marzyłem	Verb
czytelniejsza	Adjective
tajałoby	Verb
basior	Noun
światłościami	Noun
połowami	Noun
zarabiać	Verb
rozważały	Verb
nieciekawa	Adjective
wielka	Adjective
sandaczy	Noun
kategoria	Noun
szefom	Noun
trawnikach	Noun
prorokiem	Noun
histydyna	Noun
podbródka	Noun
kłamstwie	Noun
sercach	Noun
ewangeliarzami	Noun
pozycjom	Noun
wadera	Noun
napastnikami	Noun
dwumianowi	Noun
druhowi	Noun
pozwalasz	Verb
grzmotu	Noun
siada	Verb
gwałciłaby	Verb
siewnikiem	Noun
proponuj	Verb
wierzy	Verb
pasażerem	Noun
Hiszpankę	Noun
przekwitają	Verb
rozpadu	Noun
sanitariuszach	Noun
twarzami	Noun
dziuplo	Noun
prozodię	Noun
dekli	Noun
kuro	Noun
gwałcenie	Masdar
żarłokiem	Noun
sznurkom	Noun
ukryjecie	Verb
błonami	Noun
archipelagami	Noun
metod	Noun
okrucieństwu	Noun
okresom	Noun
arcybiskupem	Noun
finałowi	Noun
żołnierz	Noun
czekasz	Verb
ważek	Noun
skąpiec	Noun
dbano	Participle
grzeszył	Verb
idealizmowi	Noun
lodówka	Noun
łowcą	Noun
zabawom	Noun
dyplomu	Noun
balastami	Noun
dramatami	Noun
szczecinę	Noun
ruczajowi	Noun
aniołkiem	Noun
śpiewał	Verb
łucznikiem	Noun
plemionami	Noun
psychoterapeutom	Noun
opuszczam	Verb
ceremoniom	Noun
kolekcjonowałbyś	Verb
sterburtach	Noun
kajają	Verb
car	Noun
biskup	Noun
przyjmuje	Verb
samba	Noun
ciastkami	Noun
obserwujcie	Verb
storczykami	Noun
luźna	Adjective
podchodziłbym	Verb
szparagach	Noun
pylnika	Noun
jadowita	Adjective
dodałam	Verb
patentach	Noun
tułowia	Noun
sokół	Noun
calowi	Noun
iskałbym	Verb
kamizelkach	Noun
lipniejszymi	Adjective
nękają	Verb
ścięgnu	Noun
ćwiartkę	Noun
Holendrach	Noun
uzda	Noun
wymyślają	Verb
ukrywająca	Participle
perfekcją	Noun
bananem	Noun
pisarkę	Noun
eucharystyczna	Adjective
wagonem	Noun
dzierżyłem	Verb
zawilca	Noun
pielgrzymem	Noun
myszek	Noun
kopalnię	Noun
kataraktami	Noun
attyk	Noun
malinkę	Noun
pustynię	Noun
piłkarzowi	Noun
chwal	Verb
Szwed	Noun
wyżąłbyś	Verb
kawiarniach	Noun
niezrozumiała	Adjective
wiarygodnością	Noun
indonezyjscy	Adjective
kurzem	Noun
komputerowa	Adjective
anionem	Noun
utworowi	Noun
okrętom	Noun
podpierdoliłeś	Verb
mangami	Noun
hamulcami	Noun
motyk	Noun
rodzic	Noun
bilardem	Noun
wydra	Noun
autobusu	Noun
napojami	Noun
żądało	Verb
zapomniana	Participle
wydupczą	Verb
zapalono	Participle
krokodylami	Noun
lwicę	Noun
atmosfer	Noun
pluliście	Verb
egoistyczna	Adjective
kaznodzieja	Noun
wyżłów	Noun
datą	Noun
wjazdach	Noun
kołodziej	Noun
strun	Noun
stwór	Noun
dałbyś	Verb
bratankami	Noun
pieprzyłybyście	Verb
wierszem	Noun
plotkę	Noun
księgę	Noun
ekshibicjonistach	Noun
latarniami	Noun
kasowników	Noun
karmanom	Noun
kanonierka	Noun
korytach	Noun
katom	Noun
cierpliwi	Adjective
numerowana	Participle
złem	Noun
niszczyliście	Verb
przesadzajcie	Verb
święconka	Noun
nurkowało	Verb
wskazano	Participle
dokonywali	Verb
elektronów	Noun
moczowodami	Noun
halerz	Noun
bursztynach	Noun
zabiłabym	Verb
jonosferę	Noun
zabiłeś	Verb
badalibyśmy	Verb
zaliczkę	Noun
litewskimi	Adjective
pieprzymy	Verb
castingach	Noun
fałszywi	Adjective
konkurowania	Noun
półprzewodnikami	Noun
zdobiła	Verb
taborem	Noun
dżunglę	Noun
kurhanu	Noun
zastanawiali	Verb
kulturystą	Noun
trzaskajmy	Verb
uważająca	Participle
kosiarką	Noun
myszom	Noun
kanałów	Noun
żołnę	Noun
podróżom	Noun
grzęźną	Verb
procesorem	Noun
zapomnienie	Masdar
bies	Noun
najsilniejsi	Adjective
wilkami	Noun
karetę	Noun
pospolita	Adjective
podobni	Adjective
spotkaliśmy	Verb
panoramą	Noun
zegarmistrzem	Noun
podpisałbym	Verb
cebulowymi	Adjective
Amerykanka	Noun
akomodację	Noun
kromka	Noun
dodasz	Verb
potężniejszymi	Adjective
pośmiertnymi	Adjective
stawonogom	Noun
taonach	Noun
delegatami	Noun
promów	Noun
ruchom	Noun
pikaw	Noun
pługów	Noun
bobslejach	Noun
konarów	Noun
ogolilibyśmy	Verb
orlimi	Adjective
szkodnikami	Noun
zrozumiawszy	Converb
eksportowalibyśmy	Verb
oporom	Noun
czytelniczek	Noun
praktykę	Noun
łzą	Noun
wstrętowi	Noun
kupili	Verb
skręciłyście	Verb
koiłbym	Verb
błądzą	Verb
chwalił	Verb
chrzciłyśmy	Verb
lniani	Adjective
piorą	Verb
łyżeczką	Noun
żartuj	Verb
sarną	Noun
muzułmanin	Noun
senior	Noun
rzeczownikiem	Noun
muchami	Noun
tłach	Noun
funkcja	Noun
sterowców	Noun
przeżujecie	Verb
drogowi	Adjective
śniłbyś	Verb
kwadratami	Noun
bagażami	Noun
podkradać	Verb
maskuję	Verb
spalacja	Noun
spekulantami	Noun
cyborgów	Noun
sałatę	Noun
diecezję	Noun
kotko	Noun
Żydowi	Noun
fazami	Noun
nosić	Verb
ślusarzem	Noun
zygotą	Noun
pasterz	Noun
słomę	Noun
imperator	Noun
wydaniach	Noun
skokami	Noun
znamion	Noun
brudziłbyś	Verb
półkolami	Noun
dzwonkami	Noun
pędami	Noun
osiągnięciami	Noun
podnieśli	Verb
kontynentalna	Adjective
metropolity	Noun
algorytmach	Noun
identyfikował	Verb
bydgoskimi	Adjective
spora	Adjective
nikczemna	Adjective
okazało	Verb
prosiak	Noun
czyniło	Verb
strachowi	Noun
złotnikach	Noun
akcjonariuszach	Noun
przypominałeś	Verb
akronimach	Noun
fizjoterapeuty	Noun
tarasowi	Noun
alfabetach	Noun
czarownicom	Noun
śledzeni	Participle
słynna	Adjective
Celtem	Noun
ostrogach	Noun
zapłonowi	Noun
wyniosły	Verb
hebrajskimi	Adjective
skonu	Noun
umarłeś	Verb
odrzuci	Verb
ćmę	Noun
pistoletach	Noun
barwinka	Noun
uprzedziłeś	Verb
inwestycję	Noun
podróżowaliście	Verb
fotosyntezo	Noun
wodzowi	Noun
wizyt	Noun
medalionach	Noun
krzewów	Noun
włączać	Verb
dyrektor	Noun
mundialem	Noun
jarzm	Noun
karabinem	Noun
prezerwatywa	Noun
etnologia	Noun
mniejsi	Adjective
zmianom	Noun
leń	Noun
głosować	Verb
wierzycielem	Noun
pestkami	Noun
kołysanek	Noun
pozwalając	Converb
etapom	Noun
okolic	Noun
pieprz	Verb
składu	Noun
skrzynię	Noun
rublach	Noun
satrapię	Noun
opisywanie	Masdar
głupek	Noun
pałkę	Noun
szyją	Noun
trudnościami	Noun
zostawisz	Verb
iskanie	Masdar
robocizna	Noun
mistycyzmu	Noun
aptekarzach	Noun
genów	Noun
poprosi	Verb
gejem	Noun
chusteczkę	Noun
śmigłowców	Noun
krzyczałabym	Verb
słomkę	Noun
młota	Noun
rózgę	Noun
objawami	Noun
kryzysu	Noun
furmankę	Noun
spałaszowalibyśmy	Verb
stadionami	Noun
kłamałyśmy	Verb
mięśniowa	Adjective
rzeszami	Noun
ponadprzeciętnymi	Adjective
dedykowaliście	Verb
potomek	Noun
ratę	Noun
czyścił	Verb
omanu	Noun
wiankiem	Noun
adwersarzowi	Noun
filozofowi	Noun
poprawiają	Verb
salamander	Noun
bransolet	Noun
przywództwa	Noun
imion	Noun
dymnicami	Noun
kadłubów	Noun
globalna	Adjective
weekendów	Noun
sylaba	Noun
czapkami	Noun
wyniesie	Verb
spieprzyli	Verb
jedwabnik	Noun
pieczęciach	Noun
narzędziami	Noun
kleszczach	Noun
tramwajach	Noun
cytowali	Verb
pozostawałyby	Verb
sercem	Noun
pogromami	Noun
bojały	Verb
spojrzeń	Noun
puściły	Verb
szaleje	Verb
sicie	Noun
Grekiem	Noun
gospodarzach	Noun
kapowałeś	Verb
dyskusją	Noun
umówiono	Participle
spadało	Verb
polietylenu	Noun
trójkątem	Noun
inwestycją	Noun
rosołem	Noun
otworzyłoby	Verb
płynęło	Verb
bandaży	Noun
kseruję	Verb
żyją	Verb
skrzynka	Noun
twierdzeń	Noun
czworokąta	Noun
Polką	Noun
synowi	Noun
prawnikiem	Noun
kserowała	Verb
zającami	Noun
krup	Noun
fonologia	Noun
reputację	Noun
apopleksja	Noun
wyłaś	Verb
badałyście	Verb
tenisem	Noun
obciążeniom	Noun
pacynkom	Noun
znoszono	Participle
syropu	Noun
szachistom	Noun
medalisty	Noun
ciśnień	Noun
błotniaków	Noun
mistrzowi	Noun
rozwiązaliśmy	Verb
dzianie	Masdar
psalmem	Noun
nękał	Verb
kotków	Noun
najpodlejszymi	Adjective
fundacją	Noun
kosztach	Noun
pasierb	Noun
markerów	Noun
gnać	Verb
wymyśliłby	Verb
klasach	Noun
opiekunem	Noun
złapani	Participle
uczyłam	Verb
kryształem	Noun
przegrałeś	Verb
wyjęlibyście	Verb
wiatrem	Noun
bogaci	Adjective
mżawkom	Noun
kwintę	Noun
latałyśmy	Verb
Macedonkach	Noun
tapetą	Noun
wózkiem	Noun
wracajcie	Verb
peptydów	Noun
podpaskach	Noun
biedronkach	Noun
gryzłam	Verb
dialektologię	Noun
pokazujemy	Verb
przedramionach	Noun
arkadom	Noun
pozdrowień	Noun
frytek	Noun
trzebił	Verb
rzemieślnikiem	Noun
bezdźwięcznymi	Adjective
szafka	Noun
kryjąc	Converb
zwykłymi	Adjective
żałować	Verb
różowawa	Adjective
naw	Noun
relikwiarzem	Noun
kanapka	Noun
wiktoria	Noun
przedsiębiorcami	Noun
bibułą	Noun
świerzbisz	Verb
cytrom	Noun
kwestionowałbym	Verb
przyimkami	Noun
kopię	Verb
miliarderem	Noun
kosiarz	Noun
budżetowi	Noun
szkoło	Noun
ciżba	Noun
zamówiono	Participle
ikona	Noun
talizmanu	Noun
łączy	Noun
rejestrach	Noun
notatka	Noun
kandela	Noun
brzozach	Noun
riposta	Noun
hachamami	Noun
przedmówcę	Noun
wołałyście	Verb
uczeniem	Noun
despotą	Noun
trawa	Noun
fonetyką	Noun
synonimach	Noun
bandera	Noun
gminami	Noun
biolog	Noun
smół	Noun
powtórzyłyby	Verb
monogamia	Noun
uraninitu	Noun
poluję	Verb
przedmówcom	Noun
liderowi	Noun
Kopt	Noun
szukająca	Participle
ziębnął	Verb
broiliśmy	Verb
królikiem	Noun
dystansów	Noun
konstantynopolitańczykach	Noun
przypuszczasz	Verb
uprawiając	Converb
aktorek	Noun
przedmiotach	Noun
próbuję	Verb
wylogujesz	Verb
wymówka	Noun
bolcem	Noun
wybuchnęlibyście	Verb
tęczą	Noun
ministerstwem	Noun
dworek	Noun
chloru	Noun
przedsionkowi	Noun
molekuł	Noun
zaciążony	Participle
tundrę	Noun
mięsożercą	Noun
przemyślmy	Verb
dowiedziały	Verb
zaprzeczmy	Verb
cofalibyście	Verb
świadkiem	Noun
dumali	Verb
inflacjami	Noun
podano	Participle
ojczyzn	Noun
pytają	Verb
strupowi	Noun
kasynie	Noun
prorokami	Noun
skóra	Noun
efektowi	Noun
kołyskę	Noun
ratajami	Noun
rzucać	Verb
pokazem	Noun
egzaminu	Noun
liczebnością	Noun
uwiedliśmy	Verb
lansu	Noun
włosów	Noun
warek	Noun
tyrozynę	Noun
zwyciężamy	Verb
korkiem	Noun
kremem	Noun
gwałciłyśmy	Verb
zwycięstwu	Noun
pnączem	Noun
wyżyna	Noun
seminarzystami	Noun
kwiatostanów	Noun
zerkasz	Verb
łódką	Noun
bredziłoby	Verb
hibernacja	Noun
powojennymi	Adjective
nakrylibyście	Verb
zamówmy	Verb
upuścić	Verb
drażnią	Verb
obrzezaniom	Noun
patykami	Noun
funkcją	Noun
pracownikowi	Noun
dodałem	Verb
wiosłująca	Participle
potencjałowi	Noun
gruzińska	Adjective
krucjat	Noun
pogadaliście	Verb
odbudowany	Participle
rozróżniamy	Verb
uprawiana	Participle
ćwierćdolarówka	Noun
wygrać	Verb
rozeta	Noun
raportem	Noun
zachodzą	Verb
kogut	Noun
skarbonek	Noun
zachowana	Participle
jonosferą	Noun
cegiełka	Noun
ciału	Noun
słoneczkiem	Noun
olać	Verb
żywca	Noun
pnia	Noun
kałamarzach	Noun
urlopem	Noun
butelkom	Noun
zacząłem	Verb
alfa	Noun
oddałeś	Verb
zastanawiałbym	Verb
kilogramów	Noun
beleczka	Noun
stojanem	Noun
czółnem	Noun
babkę	Noun
solniczkami	Noun
przeciwwagę	Noun
rozproszenie	Masdar
jawiło	Verb
zgniła	Adjective
pada	Verb
Amerykankami	Noun
połączeń	Noun
bezpieczeństwem	Noun
kapturom	Noun
identyfikuję	Verb
strefą	Noun
postarzania	Noun
badałabym	Verb
strażach	Noun
rozmyślałeś	Verb
genewska	Adjective
melancholikowi	Noun
refowalibyśmy	Verb
fioletem	Noun
zasobom	Noun
afiksu	Noun
żelazobetonu	Noun
tafla	Noun
sypaliście	Verb
kamerom	Noun
scenariuszach	Noun
kameleonem	Noun
telefonujcie	Verb
Koreańczykowi	Noun
deszczowymi	Adjective
ściągnięci	Participle
podkreślałoby	Verb
tamę	Noun
hamowani	Participle
znalibyśmy	Verb
scenarzystach	Noun
klaksonu	Noun
solo	Noun
osłach	Noun
zwięźli	Adjective
świetlówko	Noun
eterach	Noun
łuczniczka	Noun
hojna	Adjective
napisawszy	Converb
prześcieradłu	Noun
młotków	Noun
krawcowi	Noun
mydłu	Noun
kotłownią	Noun
wędlina	Noun
przeszczepem	Noun
ciężarem	Noun
znajdziesz	Verb
dźwigała	Verb
przymiotnikami	Noun
spójnikiem	Noun
sympatiom	Noun
obojętni	Adjective
mieszkaniach	Noun
kupowałaby	Verb
żywopłotach	Noun
strzelało	Verb
kondygnacją	Noun
kryptonu	Noun
ślimakami	Noun
ćwieka	Noun
polowaniach	Noun
Duńczyk	Noun
stadach	Noun
zabójstwach	Noun
pluralizmem	Noun
sądziliśmy	Verb
sensom	Noun
kantonów	Noun
przeszkadzały	Verb
brodę	Noun
bila	Noun
daktylowcami	Noun
atakowały	Verb
szarlatan	Noun
mirtu	Noun
ponczowi	Noun
cyfrowa	Adjective
skrzypkach	Noun
miewałaby	Verb
graniczy	Verb
nacią	Noun
kijanką	Noun
ćwiczeni	Participle
ramę	Noun
próbuj	Verb
anarchistą	Noun
stratosfera	Noun
żałowali	Verb
twierdzom	Noun
usuwana	Participle
antymonu	Noun
znaczeń	Noun
szczeniętami	Noun
kierowi	Noun
sfer	Noun
poziomem	Noun
rogówko	Noun
nalewania	Noun
rydlom	Noun
operację	Noun
roślinożercom	Noun
wykopalisk	Noun
protokołem	Noun
małpowaliście	Verb
obrazić	Verb
wyje	Verb
plew	Noun
drukujemy	Verb
sprzeciwów	Noun
seniorach	Noun
łękami	Noun
chodnikom	Noun
równoważników	Noun
grzęzły	Verb
dekoracyjnymi	Adjective
baranami	Noun
wielokątem	Noun
wygnańcem	Noun
kanałowi	Noun
długowieczni	Adjective
dowiemy	Verb
wypędziła	Verb
broili	Verb
ćwiczyć	Verb
fretką	Noun
płaciła	Verb
okazjach	Noun
dedykować	Verb
krucjatę	Noun
uwiodłoby	Verb
kolekcjach	Noun
konserwantami	Noun
kawałowi	Noun
rozmawiałem	Verb
buzią	Noun
przełącznika	Noun
fabrykami	Noun
stewardessami	Noun
marynarzowi	Noun
ukrywałam	Verb
czekać	Verb
sióstr	Noun
przeproszę	Verb
marzycielem	Noun
kań	Noun
czarnuszka	Noun
śpiesz	Verb
gotujemy	Verb
wagonu	Noun
autami	Noun
zachowali	Verb
konfliktem	Noun
rurociągach	Noun
garbarz	Noun
włościami	Noun
obojów	Noun
papierowymi	Adjective
laleczka	Noun
nadobnymi	Adjective
szkodzisz	Verb
socjalizmowi	Noun
znoszona	Participle
kanar	Noun
wykopany	Participle
cywilizację	Noun
sinusa	Noun
skakała	Verb
hamburger	Noun
zespołów	Noun
prac	Noun
oddawaj	Verb
zwrotowi	Noun
skrzyżowaniach	Noun
milczysz	Verb
przepraszałabym	Verb
nauczycielowi	Noun
jeżowców	Noun
praworęczna	Adjective
umierać	Verb
ciągnikami	Noun
kompozytorami	Noun
bosymi	Adjective
pisarzowi	Noun
kucharek	Noun
szyba	Noun
wymiocin	Noun
atakujemy	Verb
schował	Verb
mózgowi	Noun
wyrazach	Noun
zapraszać	Verb
szałem	Noun
mitoz	Noun
swobodna	Adjective
dyrekcjami	Noun
przypomniałbym	Verb
przegracie	Verb
splotów	Noun
przyjmiemy	Verb
błona	Noun
zołza	Noun
unikaj	Verb
papug	Noun
kwadratowa	Adjective
doceniana	Participle
pokazuję	Verb
znosi	Verb
otrzymywał	Verb
nazywało	Verb
jednoczesna	Adjective
poprawiano	Participle
ścignęłybyśmy	Verb
ogromna	Adjective
trójką	Noun
dżungla	Noun
akupunktura	Noun
przypomniana	Participle
fosforanów	Noun
rumuńskimi	Adjective
brazylijskimi	Adjective
bitew	Noun
pustkowi	Noun
nakryci	Participle
kuflem	Noun
próbowały	Verb
grzesznik	Noun
zniszczyli	Verb
pytacie	Verb
sąsiedztwie	Noun
Szwajcarom	Noun
fragmentami	Noun
sądziły	Verb
plułabym	Verb
korporacjach	Noun
kasyn	Noun
niedziel	Noun
wersów	Noun
lizynę	Noun
korzystasz	Verb
słyszenia	Noun
wzrostami	Noun
fluoru	Noun
Belgowi	Noun
otrzymasz	Verb
wymagać	Verb
lustrzanymi	Adjective
orkiestra	Noun
nadzorowałam	Verb
zakażeniami	Noun
rekordowi	Noun
okapu	Noun
rozproszycie	Verb
internetowymi	Adjective
dopalaczach	Noun
jebakami	Noun
bierna	Adjective
grzebię	Verb
myszkom	Noun
wsparłabyś	Verb
undekanów	Noun
dupczyłam	Verb
pochodziły	Verb
oszukiwałbym	Verb
archidiecezjami	Noun
kontynentu	Noun
bykami	Noun
umowa	Noun
podatniejsza	Adjective
skrócona	Participle
skazały	Verb
kociakom	Noun
inteligencja	Noun
guzikach	Noun
kwasami	Noun
krawcowym	Noun
zarezerwowano	Participle
dekretu	Noun
egipskimi	Adjective
odkryjesz	Verb
organizowałaś	Verb
szminkami	Noun
pyszni	Adjective
owadzimi	Adjective
działałyby	Verb
dzwoniec	Noun
falangę	Noun
obserwowania	Noun
alpago	Noun
dedykując	Converb
maczuga	Noun
homoseksualistę	Noun
rzucamy	Verb
testem	Noun
żaglówką	Noun
macko	Noun
rzeszą	Noun
jeż	Noun
kul	Noun
pięknymi	Adjective
glukoza	Noun
rozsądkom	Noun
parowaliby	Verb
biegunkami	Noun
endemiczni	Adjective
czytając	Converb
humorów	Noun
dwunastnicą	Noun
baniami	Noun
kompowi	Noun
prawdziwa	Adjective
cytuj	Verb
krążownikowi	Noun
sznurków	Noun
zaimka	Noun
karoserią	Noun
seksuologią	Noun
innowacją	Noun
godzin	Noun
kupowało	Verb
rzucalibyście	Verb
pniakiem	Noun
złupmy	Verb
oskarżałoby	Verb
fotonów	Noun
piktogramami	Noun
teleskopowi	Noun
wiadrem	Noun
czyniony	Participle
