kavárnám	Noun
datlující	Participle
duším	Noun
psychóz	Noun
autobusech	Noun
příznivými	Adjective
dokumentem	Noun
bytů	Noun
strome	Noun
snopem	Noun
Rumunů	Noun
ostrově	Noun
asteroidů	Noun
zásobách	Noun
tma	Noun
octech	Noun
fetišů	Noun
kopírkám	Noun
výtahů	Noun
slovenskými	Adjective
mažete	Verb
lékárník	Noun
Rakušanem	Noun
žádostmi	Noun
pozorovanou	Adjective
bahnech	Noun
aramejskými	Adjective
vtipů	Noun
očkování	Converb
alelu	Noun
scénu	Noun
organizacích	Noun
stěhuje	Verb
stykům	Noun
proudů	Noun
spánků	Noun
napadající	Participle
implementuj	Verb
střelcích	Noun
dabuji	Verb
třískaje	Converb
účinkem	Noun
archami	Noun
pastami	Noun
atomovými	Adjective
životem	Noun
sestra	Noun
řetězcem	Noun
futuristickou	Adjective
lvech	Noun
map	Noun
hloubkou	Noun
kružítkem	Noun
hnilobu	Noun
krutém	Adjective
bezpečnou	Adjective
dlouhodobými	Adjective
svědcích	Noun
nezbytnou	Adjective
flétnou	Noun
Rakušan	Noun
útěkem	Noun
územích	Noun
biskup	Noun
překrásnou	Adjective
kozám	Noun
basistech	Noun
poslouchání	Converb
emigruje	Verb
důležitou	Adjective
Izraelec	Noun
lukostřelec	Noun
skříňku	Noun
darebáku	Noun
transponuje	Verb
pitev	Noun
prudkými	Adjective
mužskými	Adjective
středo	Noun
kontaktologům	Noun
vozovkou	Noun
sněhovými	Adjective
formálními	Adjective
mrkvím	Noun
mravech	Noun
dovolují	Verb
ročenkách	Noun
kundu	Noun
muslim	Noun
absurditou	Noun
drsnými	Adjective
tankem	Noun
vesmírem	Noun
metronomů	Noun
hřebenech	Noun
jízdu	Noun
medů	Noun
prvočíslem	Noun
obchvatem	Noun
hláskám	Noun
párů	Noun
víl	Noun
potřeb	Noun
řekou	Noun
dobry	Noun
fotografiím	Noun
binecem	Noun
psavše	Converb
puškou	Noun
tich	Noun
pomlouvání	Converb
aférku	Noun
alkalózou	Noun
doluješ	Verb
odpore	Noun
ručníků	Noun
lécích	Noun
surovinu	Noun
daty	Noun
stonků	Noun
akanštinou	Noun
granátů	Noun
střetů	Noun
dávejme	Verb
pochybami	Noun
konkuruje	Verb
křížům	Noun
Rumunkou	Noun
malujme	Verb
látka	Noun
integrován	Participle
spacácích	Noun
podkova	Noun
sídlím	Verb
sadistickými	Adjective
názvům	Noun
úhlů	Noun
Srbem	Noun
stopař	Noun
mlh	Noun
propiskách	Noun
čajovou	Adjective
elektřinách	Noun
tehdejšími	Adjective
trhavou	Adjective
seznamem	Noun
kupujíc	Converb
značkou	Noun
rozpočtech	Noun
krásnou	Adjective
úřednících	Noun
oknech	Noun
dcerami	Noun
rozhovorům	Noun
kogo	Noun
znepokojujíc	Converb
zámcích	Noun
suchou	Adjective
prodáván	Participle
zubr	Noun
tašku	Noun
potřebami	Noun
módám	Noun
skluzavku	Noun
prstýnků	Noun
mezioborovou	Adjective
upoutávek	Noun
Gruzínců	Noun
telefonech	Noun
obvaze	Noun
voják	Noun
lampu	Noun
příkladech	Noun
oslava	Noun
kandidátech	Noun
ligami	Noun
termínem	Noun
věčnými	Adjective
deprimují	Verb
misek	Noun
ampulkám	Noun
alternativ	Noun
ztrátou	Noun
doplňovav	Converb
veverkách	Noun
náladám	Noun
novinářům	Noun
vědu	Noun
protestujíc	Converb
mítinků	Noun
Dánem	Noun
republiku	Noun
hlavičkách	Noun
prostředků	Noun
akronymům	Noun
turistickou	Adjective
pochybách	Noun
vojáků	Noun
peněženka	Noun
elastickou	Adjective
budících	Noun
banko	Noun
spojenců	Noun
ainština	Noun
hornatinami	Noun
vstřícnými	Adjective
žvýkavši	Converb
tancovavše	Converb
poruchami	Noun
elektromechanickými	Adjective
kouříš	Verb
zásobami	Noun
obsahovat	Verb
složkami	Noun
lokomotivu	Noun
semenem	Noun
poroste	Noun
občanů	Noun
otravám	Noun
klokanů	Noun
erodují	Verb
zajímavými	Adjective
bouřku	Noun
mláďatech	Noun
polic	Noun
kruciát	Noun
medvědech	Noun
koalicím	Noun
zásuvkách	Noun
zásadními	Adjective
soukromou	Adjective
kibicováno	Participle
filmování	Converb
vepř	Noun
vlků	Noun
jedeme	Verb
souladům	Noun
čtvercovými	Adjective
doporučovavši	Converb
prozaickém	Adjective
náhradám	Noun
sirkou	Noun
kotců	Noun
čolků	Noun
zhoršuje	Verb
zvířatům	Noun
traumatech	Noun
touha	Noun
Vikingem	Noun
vozech	Noun
kosmonaut	Noun
dvojtečku	Noun
středu	Noun
figurkami	Noun
kládu	Noun
královstvích	Noun
dán	Participle
absťákem	Noun
extrapolován	Participle
čarodějům	Noun
pilot	Noun
zlatými	Noun
losovat	Verb
fotografujeme	Verb
místnostmi	Noun
kostlivec	Noun
kupec	Noun
ulička	Noun
marmeládou	Noun
anonymními	Adjective
psychedelickými	Adjective
lhářem	Noun
rajčatům	Noun
blízkými	Adjective
protiletadlovou	Adjective
lyrou	Noun
menstruováni	Participle
vězeň	Noun
cepů	Noun
komickou	Adjective
akupresura	Noun
svatbo	Noun
rubem	Noun
vílám	Noun
uragáne	Noun
sprchu	Noun
přečti	Verb
příslušník	Noun
závodům	Noun
krocanů	Noun
chtěj	Verb
kopám	Verb
oblastech	Noun
křížovka	Noun
učitelkám	Noun
rozkoším	Noun
přezdívkami	Noun
spalující	Participle
vegan	Noun
uvolněnou	Adjective
věšákem	Noun
klávesnic	Noun
hlasech	Noun
semenu	Noun
zásuvko	Noun
okounech	Noun
ekonomickém	Adjective
krávou	Noun
lachtan	Noun
prodavaček	Noun
dehydrujíc	Converb
kontaktologu	Noun
botou	Noun
přechodů	Noun
hvězdami	Noun
symbolem	Noun
odchodům	Noun
identickými	Adjective
muzei	Noun
přečta	Converb
ovlivnitelnými	Adjective
vápencem	Noun
střetech	Noun
Lotyš	Noun
fungují	Verb
zábranou	Noun
nacistech	Noun
spotřebitelům	Noun
družstvem	Noun
pruhům	Noun
botanizovav	Converb
skříňkami	Noun
dvanáctými	Adjective
soucite	Noun
vědomích	Noun
diagramech	Noun
stánků	Noun
spekulacím	Noun
nemocnic	Noun
tundru	Noun
náhradu	Noun
kyselinách	Noun
kázním	Noun
antén	Noun
sloupkem	Noun
smlouva	Noun
domovům	Noun
čtečkách	Noun
letováni	Participle
porodnic	Noun
městskou	Adjective
delfínům	Noun
detailech	Noun
konzervováno	Participle
hlídat	Verb
pracuji	Verb
předlohou	Noun
činů	Noun
napodobovavši	Converb
mouchám	Noun
davem	Noun
připomínáme	Verb
kultivován	Participle
stávku	Noun
děvám	Noun
kontrolování	Converb
jedná	Verb
vězněm	Noun
spekulacích	Noun
dráhách	Noun
sportovcích	Noun
slevám	Noun
bankám	Noun
algebru	Noun
chorobou	Noun
kandidujíc	Converb
soudcem	Noun
neopakovatelnou	Adjective
divizích	Noun
konzerva	Noun
ropami	Noun
pliván	Participle
otravuje	Verb
bradám	Noun
odpovídám	Verb
sardinka	Noun
diskutujeme	Verb
povolává	Verb
slovenskou	Adjective
skvostnými	Adjective
metrickou	Adjective
organickými	Adjective
sklárnách	Noun
hrdlem	Noun
působíš	Verb
slevami	Noun
pepřenkám	Noun
zkouškou	Noun
štírech	Noun
vozovkám	Noun
odpovědnou	Adjective
loděnicích	Noun
bábovičku	Noun
měnu	Noun
barbarskými	Adjective
kapku	Noun
údajů	Noun
zrakem	Noun
vlčákům	Noun
detailními	Adjective
libanonskými	Adjective
náušnicích	Noun
žampionům	Noun
navrhuješ	Verb
střecho	Noun
blogují	Verb
popelech	Noun
procházkách	Noun
Kubánec	Noun
asistovat	Verb
odměnou	Noun
stupních	Noun
idealizujíc	Converb
vlasteneckými	Adjective
kryje	Verb
osobnostmi	Noun
rákoska	Noun
skvrnám	Noun
botanizovavše	Converb
tematickou	Adjective
studentkami	Noun
vada	Noun
obhajován	Participle
žolíkem	Noun
nachovou	Adjective
následkům	Noun
hruškách	Noun
šťastném	Adjective
koktavše	Converb
empirickou	Adjective
hledavši	Converb
tukům	Noun
disků	Noun
titulků	Noun
zlými	Adjective
Češích	Noun
jedem	Noun
nožích	Noun
kořenech	Noun
svačina	Noun
admirálů	Noun
bundo	Noun
Brazilcem	Noun
slepičku	Noun
kytaristu	Noun
kalkuluje	Verb
kodifikuje	Verb
biologickými	Adjective
beznohými	Adjective
srážkách	Noun
převodovka	Noun
rafinací	Noun
olovech	Noun
ztuhlou	Adjective
řezech	Noun
infikují	Verb
mnichů	Noun
dirigovat	Verb
hláškou	Noun
bakteriologickými	Adjective
vojna	Noun
meruňko	Noun
pozdravováno	Participle
koledami	Noun
hektickými	Adjective
mede	Noun
svitkem	Noun
rop	Noun
posilovnou	Noun
excitovav	Converb
elektrárnám	Noun
agentur	Noun
věčnou	Adjective
chodidel	Noun
obrem	Noun
boxování	Converb
otcem	Noun
turistu	Noun
korigovav	Converb
mimien	Noun
pravděpodobnou	Adjective
plavou	Verb
zásaditou	Adjective
slupku	Noun
slovesy	Noun
věžím	Noun
pálku	Noun
díra	Noun
tornády	Noun
nik	Noun
slávkou	Noun
kulomete	Noun
pozemků	Noun
cílech	Noun
aktivují	Verb
větrem	Noun
čejku	Noun
datováno	Participle
slávu	Noun
pepřem	Noun
děrovačkách	Noun
finskou	Adjective
východům	Noun
mytologickou	Adjective
vedete	Verb
kategorizováni	Participle
uděláme	Verb
hrobem	Noun
kuřátkám	Noun
automobilem	Noun
monitorech	Noun
řádkům	Noun
exportovat	Verb
genetickými	Adjective
policistu	Noun
poutníkem	Noun
řádům	Noun
symetrickou	Adjective
krystalizuje	Verb
tisákem	Noun
prodejům	Noun
zastávkách	Noun
sirotek	Noun
funkcemi	Noun
subarachnoidálními	Adjective
ovocnou	Adjective
brzdách	Noun
kabelkách	Noun
obchodech	Noun
význame	Noun
kroucenou	Adjective
porostem	Noun
lhář	Noun
antihistaminiky	Noun
vozíků	Noun
slzou	Noun
čepicích	Noun
pecemi	Noun
křesel	Noun
tečku	Noun
střelec	Noun
ponesou	Verb
vřískáno	Participle
strašidly	Noun
dávám	Verb
poslouchej	Verb
diriguješ	Verb
furiantům	Noun
premisou	Noun
bednou	Noun
nesmyslnou	Adjective
potřebovav	Converb
účelem	Noun
kapkami	Noun
onemocněními	Noun
náhradnících	Noun
továrnám	Noun
bydlech	Noun
odehráván	Participle
letištím	Noun
loňskou	Adjective
architekturu	Noun
tajgu	Noun
pilku	Noun
knihami	Noun
kazatelům	Noun
plánem	Noun
stovka	Noun
třídách	Noun
napětích	Noun
amatérskými	Adjective
amnestiemi	Noun
brdem	Noun
řádka	Noun
mistře	Noun
lichou	Adjective
kmitám	Verb
menstruujíc	Converb
čelem	Noun
aklimatizovavši	Converb
pokračujme	Verb
padáni	Participle
algebrou	Noun
otvorů	Noun
brankářům	Noun
reklam	Noun
čtečkami	Noun
hřebíkem	Noun
patrem	Noun
poruchách	Noun
bože	Noun
atomovou	Adjective
kamaráde	Noun
letovav	Converb
káčetem	Noun
jestřáby	Noun
telefonáte	Noun
pálek	Noun
vtipům	Noun
smíš	Verb
student	Noun
vín	Noun
formulujme	Verb
akustika	Noun
úrokovou	Adjective
nabídkou	Noun
psech	Noun
tématem	Noun
továren	Noun
koukají	Verb
vstupenek	Noun
vzpomínkám	Noun
loutek	Noun
obav	Noun
programuje	Verb
jihem	Noun
dáváme	Verb
způsobům	Noun
chemickou	Adjective
praktickou	Adjective
ukrajinskými	Adjective
regulují	Verb
koupelnách	Noun
tetovavše	Converb
koncovkách	Noun
nudíš	Verb
vhazováních	Noun
mekáčích	Noun
neobvyklém	Adjective
trhům	Noun
traumatickou	Adjective
hněvem	Noun
doktorů	Noun
marmelád	Noun
zprávám	Noun
koruna	Noun
bednami	Noun
okresů	Noun
sušenka	Noun
humornou	Adjective
definují	Verb
bičuji	Verb
jitry	Noun
maticí	Noun
výnosem	Noun
prodejnu	Noun
vystavování	Converb
psaními	Noun
garantováno	Participle
chlapec	Noun
abecedou	Noun
technikou	Noun
požadováno	Participle
teroristickými	Adjective
publicista	Noun
snovou	Adjective
nálado	Noun
kolébku	Noun
avizovavše	Converb
následuji	Verb
velbloud	Noun
pláněmi	Noun
krupic	Noun
okresem	Noun
dráždivými	Adjective
řečištěm	Noun
důstojníkům	Noun
okurko	Noun
vzduchoprázdnech	Noun
surovin	Noun
terasu	Noun
kmitat	Verb
spadavše	Converb
mořskou	Adjective
podnikáni	Participle
demoralizující	Participle
napjatou	Adjective
navrhování	Converb
poskytovatel	Noun
bourajíce	Converb
bratrstvech	Noun
šibenic	Noun
knihovnám	Noun
trafikách	Noun
apologetika	Noun
oblečeními	Noun
libou	Adjective
posle	Noun
kapelách	Noun
druhém	Adjective
čepic	Noun
umře	Verb
brvo	Noun
podmnožino	Noun
zvěrolékařem	Noun
vazeb	Noun
zajímavou	Adjective
přístavem	Noun
citováni	Participle
histologickou	Adjective
chodidlům	Noun
gólech	Noun
antikami	Noun
jedlou	Adjective
kopre	Noun
bezplatnými	Adjective
věnujeme	Verb
statusem	Noun
aklimatizován	Participle
tundrách	Noun
rákosník	Noun
univerzitními	Adjective
souputník	Noun
citech	Noun
herečkám	Noun
sněhuláků	Noun
překlade	Noun
skicách	Noun
pravda	Noun
valnými	Adjective
dekretem	Noun
sémantickými	Adjective
skicou	Noun
odpadků	Noun
cituješ	Verb
prodejů	Noun
kryjí	Verb
gejzírech	Noun
obrazovkami	Noun
přátelskou	Adjective
rybou	Noun
perlorodek	Noun
nenasytnou	Adjective
ionizujíc	Converb
kudlanek	Noun
architektům	Noun
sledováni	Participle
datem	Noun
chodidle	Noun
stabilita	Noun
chlorům	Noun
banka	Noun
královno	Noun
módu	Noun
kmitají	Verb
notu	Noun
dolování	Converb
aritu	Noun
svobodám	Noun
ekonomickou	Adjective
odhlodlanou	Adjective
jednají	Verb
hlídačem	Noun
pochodech	Noun
kódem	Noun
programovat	Verb
křesťanech	Noun
penaltu	Noun
pozicemi	Noun
ilustračními	Adjective
bubínkem	Noun
křížích	Noun
pizd	Noun
tenkými	Adjective
pizdách	Noun
hospitalizuješ	Verb
číslovkách	Noun
odpuzováno	Participle
satelitech	Noun
kulometům	Noun
kukuřičnou	Adjective
telefonům	Noun
cizincům	Noun
manželstvích	Noun
kraťasů	Noun
humrů	Noun
muzeích	Noun
oslavu	Noun
hotelech	Noun
modlitba	Noun
víte	Verb
čekání	Converb
nudo	Noun
australskými	Adjective
datlů	Noun
značku	Noun
kunami	Noun
moudrými	Adjective
chováme	Verb
hodnoceními	Noun
příležitostmi	Noun
kolaborující	Participle
anket	Noun
sudou	Adjective
rambajze	Noun
dražba	Noun
kapelou	Noun
víš	Verb
centimetre	Noun
vojen	Noun
hodnostem	Noun
semenících	Noun
vrhcábů	Noun
charakterem	Noun
koupelnu	Noun
zárukami	Noun
kolaborujme	Verb
ambasádu	Noun
lyžemi	Noun
krotíš	Verb
čokoládu	Noun
karikovavše	Converb
elektřinám	Noun
sardinkách	Noun
sním	Verb
hrdly	Noun
taškách	Noun
argumentování	Converb
chatami	Noun
královnách	Noun
půdami	Noun
amplitudou	Noun
padat	Verb
lebka	Noun
style	Noun
faraonem	Noun
kamarádů	Noun
aplikují	Verb
mapou	Noun
současnými	Adjective
předběžnou	Adjective
rozlišováno	Participle
opakovavši	Converb
ježkům	Noun
pahorkatin	Noun
loukou	Noun
grilovat	Verb
kloktající	Participle
radostnou	Adjective
škrabek	Noun
atletem	Noun
turista	Noun
fyzikám	Noun
srážkami	Noun
dršťko	Noun
kanadskou	Adjective
apendicitida	Noun
rozlišován	Participle
látkám	Noun
narcisech	Noun
revidování	Converb
spirálnou	Adjective
zubrů	Noun
přijatelnou	Adjective
mimořádnými	Adjective
gymnastikou	Noun
zvoláních	Noun
sledují	Verb
rokům	Noun
neutrin	Noun
hastrman	Noun
oblečeních	Noun
taktickými	Adjective
předložku	Noun
hrůza	Noun
přístupů	Noun
stěhováno	Participle
salamandrem	Noun
neoprávněnou	Adjective
modlitbami	Noun
velryb	Noun
pytlů	Noun
sopka	Noun
nekrolozích	Noun
slovníků	Noun
chodníkem	Noun
tyrkysovou	Adjective
sladkostmi	Noun
slovnících	Noun
odpovídají	Verb
fanouškem	Noun
řádkou	Noun
zlou	Adjective
hlízami	Noun
očními	Adjective
terapeutickou	Adjective
drobíme	Verb
vážném	Adjective
poslancem	Noun
policemi	Noun
nazývám	Verb
jezech	Noun
menstruují	Verb
knihoven	Noun
diskvalifikováni	Participle
napětími	Noun
těžkém	Adjective
sebevraždou	Noun
kousajíc	Converb
chybují	Verb
dluzích	Noun
chodem	Noun
hrnků	Noun
baletka	Noun
porotou	Noun
mamutů	Noun
parcelami	Noun
značkami	Noun
motivováno	Participle
rwandskou	Adjective
stehen	Noun
služkou	Noun
plaveb	Noun
kopající	Participle
artritid	Noun
kandiduj	Verb
mluvíte	Verb
správa	Noun
Američanů	Noun
premiérou	Noun
kontaminuješ	Verb
dát	Verb
definuje	Verb
kameru	Noun
krabic	Noun
klasifikování	Converb
bizon	Noun
Somálcům	Noun
scénám	Noun
Čechů	Noun
chráme	Noun
většinou	Noun
čtivou	Adjective
zemím	Noun
díván	Participle
premiérách	Noun
architektek	Noun
muslimech	Noun
nacionalistickou	Adjective
nevěst	Noun
tlapách	Noun
kolejnicí	Noun
analogickou	Adjective
odstraňují	Verb
lampách	Noun
dáno	Participle
kategorizujeme	Verb
biskupům	Noun
přístupům	Noun
městem	Noun
ladem	Noun
plátků	Noun
chtěje	Converb
sekeru	Noun
kruhovou	Adjective
něžnou	Adjective
pampeliškou	Noun
arších	Noun
dřevěnou	Adjective
turistům	Noun
cizincem	Noun
řep	Noun
beznadějném	Adjective
názorech	Noun
čekat	Verb
stopami	Noun
faraonům	Noun
odporech	Noun
selaty	Noun
mapu	Noun
kultivovavše	Converb
nacistu	Noun
sasanek	Noun
nevýhodnými	Adjective
budovou	Noun
kamero	Noun
opakujeme	Verb
kole	Noun
urážku	Noun
žárovka	Noun
basou	Noun
střechám	Noun
pragmatickou	Adjective
úhoř	Noun
škrabkami	Noun
larvami	Noun
garantuji	Verb
mužském	Adjective
netopýr	Noun
učitelskou	Adjective
zpěvákům	Noun
účtech	Noun
tepnu	Noun
pracují	Verb
návrhem	Noun
masitými	Adjective
mrtvolu	Noun
neandrtálcům	Noun
darovat	Verb
mlýnovek	Noun
Ukrajincem	Noun
porucha	Noun
akordem	Noun
ředitelem	Noun
radiolokátorem	Noun
markách	Noun
dosahují	Verb
důsledcích	Noun
pitváme	Verb
automatizuj	Verb
dovolování	Converb
levitovav	Converb
interpolujíc	Converb
přívětivou	Adjective
dají	Verb
rozpakům	Noun
mikrofonů	Noun
spalování	Converb
bojištěm	Noun
zelenookou	Adjective
stropě	Noun
účelovými	Adjective
manipulujeme	Verb
žirafami	Noun
píchají	Verb
kalkulačka	Noun
pluhem	Noun
državám	Noun
dudlíků	Noun
krkavec	Noun
zpravodajů	Noun
lípa	Noun
aktivitami	Noun
haváriích	Noun
výtahem	Noun
básníků	Noun
dražbu	Noun
robotem	Noun
samými	Adjective
stoupu	Noun
neziskovek	Noun
minoritu	Noun
smím	Verb
hanba	Noun
hlavičkami	Noun
hovorem	Noun
známkách	Noun
vagína	Noun
pianin	Noun
ostružin	Noun
modifikovav	Converb
mottům	Noun
jízdám	Noun
sněžnou	Adjective
diářích	Noun
Brazilec	Noun
kontaktech	Noun
kopírování	Converb
palcem	Noun
vezmu	Verb
vysočinou	Noun
barvivy	Noun
nepřátel	Noun
zastrašování	Converb
verších	Noun
nabídka	Noun
naslouchavši	Converb
aerodynamickou	Adjective
odpočíván	Participle
adjektivy	Noun
odčítej	Verb
koledách	Noun
trpaslíkem	Noun
tlumočníkem	Noun
československou	Adjective
nalepují	Verb
plivavše	Converb
dobudete	Verb
pumpováno	Participle
mrtvolou	Noun
poslancům	Noun
Slovenka	Noun
důstojníků	Noun
křesťanů	Noun
idealizuje	Verb
kil	Noun
tchořem	Noun
divácích	Noun
ignoruji	Verb
vrtech	Noun
povahu	Noun
zámkům	Noun
omítek	Noun
popelem	Noun
modlím	Verb
kafrán	Participle
ležíme	Verb
píská	Verb
držav	Noun
nakupuj	Verb
pětkou	Noun
razítky	Noun
amylázu	Noun
hloubka	Noun
legracích	Noun
datlíme	Verb
sledující	Participle
odmítav	Converb
klávesách	Noun
cituj	Verb
okurek	Noun
dohodu	Noun
geodetickými	Adjective
armádách	Noun
touhou	Noun
kariéru	Noun
hněvů	Noun
píscích	Noun
pohlavích	Noun
lyru	Noun
lirách	Noun
vyléčitelnou	Adjective
listujíc	Converb
džemech	Noun
počítačem	Noun
strategickou	Adjective
filozofujíc	Converb
poloostrovích	Noun
laťkám	Noun
podobáno	Participle
vesnicí	Noun
metoda	Noun
excituj	Verb
animozito	Noun
kosmonautech	Noun
Němek	Noun
angličtinou	Noun
zavlažujme	Verb
topič	Noun
přízích	Noun
nudnou	Adjective
úředníkům	Noun
dívku	Noun
úpalem	Noun
sirotků	Noun
ševcích	Noun
týdnem	Noun
pilkou	Noun
demokraciemi	Noun
osudech	Noun
skvělými	Adjective
kapesníků	Noun
flambuji	Verb
pohořími	Noun
stabilními	Adjective
kadeřník	Noun
hrade	Noun
pinzetou	Noun
rouchem	Noun
vodo	Noun
povah	Noun
dodávkách	Noun
kousej	Verb
ctitelem	Noun
esejů	Noun
relativními	Adjective
křtů	Noun
agresivitou	Noun
tlap	Noun
kousám	Verb
kolečky	Noun
jistotu	Noun
socinián	Noun
beranem	Noun
zkouška	Noun
otrocích	Noun
indexován	Participle
diskvalifikující	Participle
okázalou	Adjective
příležitostem	Noun
vysokými	Adjective
kreveta	Noun
čel	Noun
informuji	Verb
dezertujíc	Converb
sousedem	Noun
dirigujíc	Converb
výška	Noun
knihách	Noun
názorem	Noun
džemem	Noun
radarech	Noun
povolávání	Converb
výstižnou	Adjective
užovkách	Noun
doporučování	Converb
pojedou	Verb
drátů	Noun
poslouchající	Participle
číslovkami	Noun
malbami	Noun
rovnoměrnými	Adjective
krádežemi	Noun
neoblíbenou	Adjective
děly	Noun
silám	Noun
vesnic	Noun
parkuje	Verb
cestují	Verb
nozdrou	Noun
motorem	Noun
standardizovanou	Adjective
stovkách	Noun
angíno	Noun
plynem	Noun
rajónem	Noun
skladatelů	Noun
sporákům	Noun
dohodami	Noun
bude	Verb
sasankami	Noun
poznávejme	Verb
postojem	Noun
dluhem	Noun
dragoune	Noun
modřin	Noun
tenistech	Noun
diskusemi	Noun
obojkům	Noun
minerálek	Noun
komprese	Noun
náhodu	Noun
koláčů	Noun
moucha	Noun
davům	Noun
ionizován	Participle
oxidováni	Participle
výkladů	Noun
tajemnou	Adjective
ofenziv	Noun
vůl	Noun
citem	Noun
narozeninách	Noun
Dáne	Noun
chybnými	Adjective
améba	Noun
dodatků	Noun
kvalitám	Noun
analýza	Noun
anglistika	Noun
zmíněnými	Adjective
ajmarštinou	Noun
ančoviček	Noun
velikou	Adjective
dbají	Verb
svíčkami	Noun
arteritidám	Noun
organizacím	Noun
berlích	Noun
součástem	Noun
výletům	Noun
poloostrovem	Noun
polovodičem	Noun
písniček	Noun
vyrážka	Noun
půjdu	Verb
podplukovníku	Noun
cenzurováno	Participle
bombardování	Converb
čirými	Adjective
chybuje	Verb
majitelích	Noun
dolovat	Verb
plotů	Noun
kolcích	Noun
trupů	Noun
dětí	Noun
houbám	Noun
přehradám	Noun
těžkými	Adjective
banku	Noun
narkomane	Noun
ryje	Verb
vole	Noun
lékařích	Noun
nádražích	Noun
rozpočtem	Noun
bazofilními	Adjective
mýdlovou	Adjective
jevům	Noun
popela	Noun
soustav	Noun
kachniček	Noun
zobecněnou	Adjective
rejstříků	Noun
vodítky	Noun
auty	Noun
pátkem	Noun
darebákem	Noun
optickou	Adjective
pouzdrem	Noun
glazura	Noun
můrou	Noun
kandiduje	Verb
předpisů	Noun
týmů	Noun
závěrem	Noun
zvířete	Noun
nepřátelům	Noun
hranicemi	Noun
straku	Noun
očkován	Participle
únavou	Noun
hlísticí	Noun
dědíš	Verb
stínech	Noun
obchodník	Noun
dirigován	Participle
učitelem	Noun
tvořivou	Adjective
vlčácích	Noun
báněmi	Noun
hezkém	Adjective
slůňatech	Noun
faraonů	Noun
ignorující	Participle
kyselinou	Noun
uličkách	Noun
umělcem	Noun
žába	Noun
absolventů	Noun
obsahováni	Participle
optikou	Noun
kopech	Noun
kritikách	Noun
kytarám	Noun
doporučuji	Verb
pozdravuj	Verb
občanům	Noun
mateřskými	Adjective
reproduktorem	Noun
společnostmi	Noun
antikvariátech	Noun
čočkách	Noun
myslitelem	Noun
řízků	Noun
nazývají	Verb
lekcemi	Noun
keramikou	Noun
ledoborců	Noun
kořenem	Noun
reraisovavše	Converb
obrázků	Noun
slamácích	Noun
mešitu	Noun
skvrnách	Noun
žábrách	Noun
datuji	Verb
pilotů	Noun
těly	Noun
pianinech	Noun
céva	Noun
eurech	Noun
akváriím	Noun
debat	Noun
Rumunku	Noun
Lotyšů	Noun
mincemi	Noun
bronchodilatancia	Noun
vzorcích	Noun
schránka	Noun
lednovými	Adjective
chemička	Noun
kartáčů	Noun
odměna	Noun
nepřítel	Noun
angažující	Participle
exotickou	Adjective
dramatizován	Participle
odchodů	Noun
prstům	Noun
dač	Noun
jednotkách	Noun
mocním	Verb
ovládajíce	Converb
nikami	Noun
polokoulemi	Noun
kmenech	Noun
pohybům	Noun
lípou	Noun
dosahuje	Verb
pokračujíc	Converb
bóra	Noun
jednotu	Noun
vztahů	Noun
slupkách	Noun
archeologickými	Adjective
hlasuješ	Verb
parlamentech	Noun
přírodu	Noun
udělá	Verb
hrobů	Noun
torpédoborcům	Noun
městy	Noun
miluje	Verb
Američanem	Noun
surovinou	Noun
chřipek	Noun
hlídač	Noun
diskusím	Noun
strakách	Noun
stranami	Noun
blogujíc	Converb
hodinami	Noun
sektou	Noun
živinami	Noun
chuťovku	Noun
šípem	Noun
charakteristickou	Adjective
vulkanickými	Adjective
chlapům	Noun
pastelka	Noun
postava	Noun
Češka	Noun
ochutnáváno	Participle
poslech	Noun
služeb	Noun
uvozovka	Noun
plánováno	Participle
kobrou	Noun
táborů	Noun
Keňanům	Noun
pusou	Noun
spravuje	Verb
krevetách	Noun
lžící	Noun
sekaček	Noun
díváš	Verb
houbách	Noun
šestými	Adjective
chodců	Noun
blatnících	Noun
budkách	Noun
drsnou	Adjective
excitují	Verb
vdovu	Noun
zdrojem	Noun
smíte	Verb
dereguluji	Verb
mimozemšťan	Noun
memorující	Participle
inervujíc	Converb
říkáš	Verb
aktovku	Noun
ostrovů	Noun
sleduji	Verb
bádej	Verb
krádežím	Noun
řemeslům	Noun
hrubou	Adjective
opacích	Noun
kanálech	Noun
poneseme	Verb
oceánům	Noun
podílem	Noun
ochotám	Noun
krupicích	Noun
napadajíce	Converb
projektem	Noun
litrem	Noun
formátování	Converb
hříček	Noun
křižníkem	Noun
rozdílech	Noun
nepříjemnou	Adjective
neustálou	Adjective
kvalita	Noun
garnátem	Noun
zpochybňováno	Participle
odstraňování	Converb
sluha	Noun
kašleš	Verb
pronásleduješ	Verb
filozofiích	Noun
maska	Noun
zemětřeseními	Noun
inervovavše	Converb
matematikami	Noun
vrtulníkům	Noun
vyčpělými	Adjective
nika	Noun
sebereflexemi	Noun
rovinu	Noun
šroubovácích	Noun
káčátkům	Noun
dbáme	Verb
vlnovek	Noun
poločase	Noun
výpovědím	Noun
zpěvačka	Noun
obdivují	Verb
šokům	Noun
modlíme	Verb
sochám	Noun
uliček	Noun
rodinou	Noun
integruješ	Verb
lavinu	Noun
svědkem	Noun
vidličkám	Noun
údajích	Noun
modlíš	Verb
rada	Noun
oltářích	Noun
oslů	Noun
mistrem	Noun
gumu	Noun
investorům	Noun
léčba	Noun
jacht	Noun
genitáliích	Noun
misemi	Noun
částka	Noun
akvarelem	Noun
pohárech	Noun
navrhujeme	Verb
importuješ	Verb
myslemi	Noun
štěňaty	Noun
obale	Noun
modlitbách	Noun
vegetariánem	Noun
kačerem	Noun
improviyuji	Verb
kružítkům	Noun
alternativu	Noun
světců	Noun
truhlářů	Noun
záplavách	Noun
brýlím	Noun
diagnostikujíc	Converb
demografiemi	Noun
dokladům	Noun
zpráv	Noun
plášťů	Noun
ostuda	Noun
acidóza	Noun
kyselinu	Noun
agenturách	Noun
dětem	Noun
kytarách	Noun
příděmi	Noun
křižníků	Noun
parkují	Verb
blogováni	Participle
obličejovými	Adjective
kořenům	Noun
korunám	Noun
plesů	Noun
pokrmem	Noun
peklu	Noun
milencích	Noun
ran	Noun
veřejnými	Adjective
mluvčími	Noun
odvahou	Noun
krasavče	Noun
prtích	Noun
hlavičkou	Noun
krabicí	Noun
obsahováno	Participle
amygdala	Noun
rudou	Noun
tetuj	Verb
jednotkám	Noun
smutnou	Adjective
literaturami	Noun
chat	Noun
skokem	Noun
žalmům	Noun
sprchami	Noun
nepříjemnými	Adjective
tepnám	Noun
botu	Noun
barevnými	Adjective
jídlům	Noun
česnecích	Noun
žízním	Noun
debatami	Noun
homofone	Noun
komorách	Noun
alergiemi	Noun
násobíme	Verb
jedničkám	Noun
slaninou	Noun
baskickými	Adjective
vlkem	Noun
elektřino	Noun
informatikou	Noun
piš	Verb
jdeš	Verb
obhajování	Converb
císařů	Noun
jazycích	Noun
horninou	Noun
Rumun	Noun
kulturou	Noun
filozofovat	Verb
lokomotivami	Noun
elektřinami	Noun
barevnou	Adjective
mrtvol	Noun
délkami	Noun
měsícům	Noun
implementujme	Verb
scén	Noun
klubům	Noun
otrokům	Noun
jaguárem	Noun
tramvajemi	Noun
vatou	Noun
rinzích	Noun
litují	Verb
hlavou	Noun
lžičku	Noun
mravům	Noun
zastávek	Noun
dělbách	Noun
několikanásobnými	Adjective
formulujeme	Verb
pralesům	Noun
náhradními	Adjective
opicí	Noun
muž	Noun
atletiku	Noun
souhláskám	Noun
keramickou	Adjective
testovat	Verb
pštrosem	Noun
přístrojům	Noun
námořníkem	Noun
novinářem	Noun
dojmech	Noun
červenců	Noun
ochotami	Noun
vanami	Noun
činnými	Adjective
bankovkou	Noun
jádrům	Noun
tátu	Noun
vystavujeme	Verb
posílá	Verb
Litevců	Noun
závislou	Adjective
napadej	Verb
postýlkami	Noun
zásobníků	Noun
tajemstvích	Noun
atrakcí	Noun
bavorskou	Adjective
papoušek	Noun
pomerančů	Noun
argumentech	Noun
inervuje	Verb
mazánek	Noun
vaječnou	Adjective
odděleních	Noun
řetězče	Noun
penězokaze	Noun
libými	Adjective
cévách	Noun
člen	Noun
dezertujme	Verb
věd	Noun
vztažnými	Adjective
manažerů	Noun
řádkám	Noun
ctem	Noun
spravují	Verb
následující	Participle
hrncem	Noun
stěhováni	Participle
koukám	Verb
příjemcích	Noun
olivo	Noun
definován	Participle
dača	Noun
klíšťatům	Noun
gumám	Noun
propisku	Noun
kuchařkách	Noun
úsměvem	Noun
diagramem	Noun
poznávám	Verb
lukostřelcem	Noun
agenturu	Noun
certifikátem	Noun
kavárnou	Noun
spojkou	Noun
albánském	Adjective
režimech	Noun
prdům	Noun
klávesnicích	Noun
písmolijcům	Noun
spermatem	Noun
tělech	Noun
klasifikovavši	Converb
mezerách	Noun
zálohou	Noun
setkávají	Verb
podivínech	Noun
plamenů	Noun
gratulovavše	Converb
činnou	Adjective
štěňat	Noun
bavorskými	Adjective
plísním	Noun
admirál	Noun
soupeřů	Noun
oblaků	Noun
červu	Noun
kouříte	Verb
aktivem	Noun
očekáváno	Participle
osušek	Noun
báchorkou	Noun
keřích	Noun
kabelku	Noun
rudo	Noun
transponují	Verb
dělající	Participle
torba	Noun
ostrove	Noun
rube	Noun
vztahům	Noun
kolibříků	Noun
bába	Noun
doufav	Converb
mátu	Noun
pozdravují	Verb
táta	Noun
sešívačkám	Noun
přeháňkami	Noun
naslouchající	Participle
amyláz	Noun
množinám	Noun
rozšiřitelnými	Adjective
orgánech	Noun
stavebními	Adjective
snah	Noun
lhůtou	Noun
tektonickými	Adjective
dějepisům	Noun
obědvají	Verb
příčinami	Noun
arterioskleróza	Noun
spravován	Participle
krátkodobou	Adjective
vápenců	Noun
dabován	Participle
kandidovavše	Converb
balónů	Noun
tlakoměrem	Noun
losující	Participle
kapitáne	Noun
restartování	Converb
básníci	Noun
vodítek	Noun
edituji	Verb
hloupostech	Noun
následováno	Participle
modelku	Noun
pachů	Noun
neznámými	Adjective
zrcadlovku	Noun
chlape	Noun
ledovou	Adjective
niko	Noun
zprávami	Noun
ryskami	Noun
adoptovat	Verb
srandou	Noun
posílavši	Converb
rošádou	Noun
duhám	Noun
kritik	Noun
hračkami	Noun
sirku	Noun
dílů	Noun
arkád	Noun
děláno	Participle
děvčátkem	Noun
projektům	Noun
čelech	Noun
koulemi	Noun
kalhot	Noun
vráskám	Noun
rasami	Noun
taktovkou	Noun
lahvích	Noun
pahorkatinu	Noun
příloh	Noun
závodech	Noun
půdou	Noun
krkavcům	Noun
potopou	Noun
škvor	Noun
pěchotách	Noun
ochutnává	Verb
psát	Verb
vyrážku	Noun
věžemi	Noun
obsahují	Verb
bedlách	Noun
hurikánů	Noun
cihlovými	Adjective
pojišťovnou	Noun
nastupováno	Participle
boranů	Noun
míčem	Noun
proslulou	Adjective
sestává	Verb
přezdívko	Noun
zmrzlinu	Noun
hýžděmi	Noun
kodifikujeme	Verb
stěno	Noun
kapsou	Noun
dej	Verb
dodávkami	Noun
Londýňan	Noun
měřím	Verb
koga	Noun
katedrál	Noun
vstupů	Noun
věta	Noun
cytotoxickými	Adjective
slívám	Noun
připomínej	Verb
eur	Noun
archeoložko	Noun
dávání	Converb
lednem	Noun
flint	Noun
babu	Noun
lednech	Noun
huspenitou	Adjective
automatizování	Converb
značek	Noun
čarodějích	Noun
zpívá	Verb
ostrovu	Noun
Arménku	Noun
bůh	Noun
jevištěm	Noun
jízdenkám	Noun
náboženskou	Adjective
polosamohláskách	Noun
věnuješ	Verb
holkám	Noun
děvčat	Noun
bárkou	Noun
pralesu	Noun
oblíbenou	Adjective
kvalifikující	Participle
víkendech	Noun
švábem	Noun
politickou	Adjective
torpédům	Noun
sarkastickou	Adjective
palačinkou	Noun
norština	Noun
hmot	Noun
patrech	Noun
svobodami	Noun
velkém	Adjective
omáčka	Noun
strakami	Noun
potřebách	Noun
pneumatikách	Noun
bronzovými	Adjective
uhre	Noun
chatám	Noun
poutnících	Noun
analgetickou	Adjective
očekávavši	Converb
nadvládami	Noun
kontrolou	Noun
nebožtíkem	Noun
školám	Noun
kvasinkách	Noun
barvivem	Noun
příjmům	Noun
pumpováni	Participle
houpačka	Noun
infikováno	Participle
kasami	Noun
psino	Noun
polštářích	Noun
řezem	Noun
krajinám	Noun
mapami	Noun
buřtům	Noun
antilopou	Noun
kocouři	Noun
hotelů	Noun
příběhem	Noun
máma	Noun
potravinám	Noun
kafráni	Participle
bídu	Noun
šťávou	Noun
třídám	Noun
kakán	Participle
antihistaminik	Noun
čvachtavše	Converb
vlaštovku	Noun
touhami	Noun
hledám	Verb
vrstvami	Noun
bedlovými	Adjective
kopírku	Noun
ještěrko	Noun
minonosek	Noun
Argentinců	Noun
pusa	Noun
ilustrován	Participle
konzervách	Noun
skotem	Noun
papouškům	Noun
odpadcích	Noun
krách	Noun
hezounkům	Noun
Afričankami	Noun
vedrem	Noun
opakováno	Participle
hochů	Noun
hymnám	Noun
sobech	Noun
moudrostmi	Noun
souběžném	Adjective
diakritickém	Adjective
barvivům	Noun
pokračuji	Verb
začneme	Verb
malují	Verb
psem	Noun
Tibeťan	Noun
poznámkách	Noun
spravujíc	Converb
sudetskou	Adjective
železnicích	Noun
metastázu	Noun
dovolující	Participle
elektrárna	Noun
obědů	Noun
sebereflexích	Noun
vraždám	Noun
zpětnými	Adjective
katedrálách	Noun
pólech	Noun
urážka	Noun
setkávajíce	Converb
úsměve	Noun
deskám	Noun
statickou	Adjective
listovavše	Converb
bankovkám	Noun
automobilech	Noun
dehydruješ	Verb
osin	Noun
myslitelům	Noun
elektrikářů	Noun
kartáčem	Noun
kontaminováni	Participle
prvokem	Noun
noto	Noun
metodám	Noun
taxících	Noun
Švédkou	Noun
bulharském	Adjective
loukách	Noun
úkazů	Noun
ladím	Verb
vědomými	Adjective
akcionářích	Noun
vzkříšeních	Noun
definicích	Noun
hloubkách	Noun
doporučují	Verb
arabeskám	Noun
expedičními	Adjective
adopcím	Noun
eurem	Noun
množinách	Noun
krávu	Noun
stylům	Noun
skvělostmi	Noun
celerů	Noun
pinzetách	Noun
změnu	Noun
definujeme	Verb
peněženkou	Noun
kontrastující	Participle
bankách	Noun
sluhu	Noun
náladami	Noun
děláš	Verb
datování	Converb
skicami	Noun
chován	Participle
vědám	Noun
vládám	Noun
beztvarou	Adjective
spornou	Adjective
milenko	Noun
interiérech	Noun
zavlažováno	Participle
řemeslnících	Noun
brado	Noun
polibkem	Noun
nakupujeme	Verb
nosorožců	Noun
minerálkami	Noun
tlaků	Noun
Čechům	Noun
ropu	Noun
Amazonkách	Noun
zvířaty	Noun
centimetrů	Noun
rajko	Noun
levitovat	Verb
moravskými	Adjective
plochém	Adjective
ubrouscích	Noun
lovů	Noun
oblakem	Noun
obsluhovat	Verb
dragounem	Noun
demokratickou	Adjective
pamatuješ	Verb
hodin	Noun
arabistikám	Noun
truhlách	Noun
agresivitu	Noun
špičkami	Noun
palivech	Noun
rádii	Noun
nápojích	Noun
šál	Noun
vozovek	Noun
neštěstích	Noun
rasou	Noun
vyhovuji	Verb
jachtou	Noun
amatér	Noun
pádech	Noun
kosmetickými	Adjective
rovina	Noun
konkurující	Participle
bárku	Noun
řidičem	Noun
kvádrech	Noun
mečům	Noun
křídlech	Noun
schránek	Noun
porotám	Noun
kobercem	Noun
vrstev	Noun
dílům	Noun
úmyslech	Noun
lopatkami	Noun
závažnou	Adjective
sovu	Noun
záhadám	Noun
výraznou	Adjective
bikinách	Noun
zhoršovat	Verb
řečech	Noun
citlivou	Adjective
nazývání	Converb
vorvaňů	Noun
požadováni	Participle
dívko	Noun
malbám	Noun
jehlami	Noun
mozkem	Noun
kolmými	Adjective
lopatkám	Noun
falzifikují	Verb
hmotách	Noun
panenkám	Noun
knih	Noun
pedopsychologem	Noun
maximalizují	Verb
ignoruj	Verb
srpnem	Noun
nikou	Noun
popelů	Noun
entitách	Noun
zbraněmi	Noun
rodinách	Noun
baletními	Adjective
adresát	Noun
trpícími	Adjective
kapkách	Noun
keramickými	Adjective
kruciáta	Noun
adresami	Noun
polovodičů	Noun
diskutovat	Verb
rakem	Noun
záplavou	Noun
křídle	Noun
voskem	Noun
spadav	Converb
jazykozpytcům	Noun
hnědák	Noun
dolujme	Verb
čtyřicetiletou	Adjective
předlohu	Noun
ohništím	Noun
kodifikováno	Participle
brdy	Noun
bydlíte	Verb
vanilkovou	Adjective
marku	Noun
přijímačích	Noun
nemocném	Adjective
obranou	Noun
umírá	Verb
veganku	Noun
čtvercovém	Adjective
kotnících	Noun
důsledkům	Noun
zeťů	Noun
marmeláda	Noun
textem	Noun
bezmocnou	Adjective
pasují	Verb
věnováno	Participle
střela	Noun
plemenech	Noun
Holanďan	Noun
lingvistika	Noun
jachtách	Noun
hledav	Converb
koriguje	Verb
dobrot	Noun
pochlebovav	Converb
plakátů	Noun
vražda	Noun
islandštinou	Noun
lyonskou	Adjective
inženýrů	Noun
vrtošivými	Adjective
náboženstvími	Noun
alkoholikem	Noun
mlhu	Noun
zavlažují	Verb
fungováních	Noun
vidlička	Noun
jezerům	Noun
stupňující	Participle
dolů	Noun
perkutánními	Adjective
schématům	Noun
omlouváme	Verb
zrcadlovkou	Noun
poslušnou	Adjective
bezejmennou	Adjective
arménském	Adjective
půdám	Noun
fjordů	Noun
kosmickou	Adjective
malovat	Verb
střed	Noun
hlasům	Noun
pilou	Noun
bazénech	Noun
záloha	Noun
včel	Noun
slánku	Noun
ponese	Verb
tvarů	Noun
šumů	Noun
výnosů	Noun
aktualizují	Verb
živote	Noun
mrzíš	Verb
ještěrkou	Noun
kosatkou	Noun
koncovku	Noun
ledovými	Adjective
nálepkování	Converb
okupuje	Verb
memoruji	Verb
myješ	Verb
znaků	Noun
signálům	Noun
bando	Noun
setkává	Verb
žemličku	Noun
slyšitelnými	Adjective
demagogickou	Adjective
korunami	Noun
hlasů	Noun
skluzavek	Noun
Finů	Noun
nebí	Noun
rajčaty	Noun
třískav	Converb
epidemiím	Noun
dáváno	Participle
telefonátů	Noun
adresovat	Verb
lodyh	Noun
samozřejmými	Adjective
mnou	Noun
motýlům	Noun
plavkám	Noun
kótováno	Participle
vysvětlován	Participle
psychedelickou	Adjective
světlušku	Noun
účtem	Noun
genovými	Adjective
stolem	Noun
žalmů	Noun
brambore	Noun
boltcovitkotvarými	Noun
letovavši	Converb
uzlům	Noun
dovolenými	Noun
seznamech	Noun
vodníkem	Noun
jablek	Noun
botanizování	Converb
technikám	Noun
ploutvím	Noun
týdenními	Adjective
minc	Noun
chórem	Noun
puška	Noun
bokem	Noun
boto	Noun
vyder	Noun
příbězích	Noun
hnilobo	Noun
špičku	Noun
bělobu	Noun
ložnicích	Noun
jeptiško	Noun
já	Noun
čočku	Noun
rosolozubů	Noun
cévám	Noun
teplotu	Noun
zpochybňovav	Converb
kolejnicím	Noun
hymna	Noun
kormidlech	Noun
derivovat	Verb
mávat	Verb
dovedeme	Verb
vráskami	Noun
testující	Participle
abecedu	Noun
raketovou	Adjective
pumpovat	Verb
abcházština	Noun
stylech	Noun
koutu	Noun
naslouchání	Converb
hláškách	Noun
nazývat	Verb
školo	Noun
koupelna	Noun
karikující	Participle
blůza	Noun
starostům	Noun
flamendr	Noun
vládou	Noun
esejemi	Noun
komentářům	Noun
odemykat	Verb
kategorizování	Converb
kobrám	Noun
mourech	Noun
vozovkách	Noun
jazykům	Noun
kup	Noun
sardinkám	Noun
schůzích	Noun
neziskovými	Adjective
lad	Noun
osobnostem	Noun
knihám	Noun
tramvajím	Noun
valaších	Noun
pěchotou	Noun
rozhlasem	Noun
představo	Noun
snahu	Noun
papoušků	Noun
břehů	Noun
alpak	Noun
derivuj	Verb
optimalizuji	Verb
středa	Noun
přímočarými	Adjective
vyhrazenými	Adjective
katodám	Noun
hrdinou	Noun
otroku	Noun
revidovavše	Converb
host	Noun
melodiích	Noun
pochybnostmi	Noun
povoláními	Noun
pravidlu	Noun
heuristickou	Adjective
lavicích	Noun
vznešenými	Adjective
bělobám	Noun
glazurou	Noun
fikanou	Adjective
slabikou	Noun
předpisem	Noun
dárkem	Noun
dave	Noun
hořkém	Adjective
podrobnou	Adjective
vodovodů	Noun
extrahováni	Participle
čirou	Adjective
výkladem	Noun
zločinem	Noun
drobnou	Adjective
Arméncích	Noun
archivovavši	Converb
letišť	Noun
saky	Noun
kancelářím	Noun
dámskými	Adjective
chladnička	Noun
dráždivou	Adjective
výhodách	Noun
plotech	Noun
absolvováni	Participle
eroduje	Verb
odvážnými	Adjective
radistů	Noun
plynech	Noun
násadám	Noun
únavu	Noun
světech	Noun
trpělivou	Adjective
skladbám	Noun
osobám	Noun
oken	Noun
plechovku	Noun
archivován	Participle
egem	Noun
kalamitu	Noun
pil	Noun
broukům	Noun
západem	Noun
teplota	Noun
střelách	Noun
hoříš	Verb
absolvován	Participle
přítelkyním	Noun
sněžnicemi	Noun
důkaze	Noun
ropa	Noun
mačkám	Noun
výstupům	Noun
svatbám	Noun
horečka	Noun
Peršan	Noun
lebkám	Noun
faraon	Noun
rajek	Noun
omlouvejme	Verb
žebřících	Noun
novinář	Noun
hyenách	Noun
cytoplasmatickou	Adjective
násadou	Noun
prodejem	Noun
kulturám	Noun
úředník	Noun
pískat	Verb
skříňkách	Noun
silnicím	Noun
mluvíš	Verb
náladou	Noun
housenkám	Noun
žonglovavše	Converb
obyvatelům	Noun
hlasuje	Verb
deklinacemi	Noun
výškami	Noun
zamykat	Verb
částicích	Noun
angažuješ	Verb
výtazích	Noun
Somálců	Noun
kvalitou	Noun
interpoluješ	Verb
Fin	Noun
lžu	Verb
připisují	Verb
závislém	Adjective
plaváku	Noun
biochemickou	Adjective
pramenům	Noun
konzervování	Converb
nepochybnými	Adjective
oponu	Noun
sublimujme	Verb
zubařům	Noun
zápisům	Noun
básníkům	Noun
demokratickými	Adjective
nocím	Noun
banánů	Noun
náušnicí	Noun
Maďarů	Noun
zásobníkem	Noun
pivoňko	Noun
zrcadlem	Noun
samotu	Noun
dramatizuje	Verb
podílů	Noun
umřete	Verb
krabů	Noun
mulate	Noun
potopa	Noun
zácpám	Noun
propiskou	Noun
objemem	Noun
kobylek	Noun
bouráno	Participle
aramejštinu	Noun
troubou	Noun
slzu	Noun
povolávej	Verb
heslech	Noun
dome	Noun
výletech	Noun
válkách	Noun
foukat	Verb
širokospektrou	Adjective
pamatovavši	Converb
nadávat	Verb
švýcarskými	Adjective
postojích	Noun
dvojkou	Noun
utopickou	Adjective
laťku	Noun
tatínku	Noun
informuje	Verb
kokosů	Noun
starostu	Noun
optiku	Noun
adjektiv	Noun
obrů	Noun
adres	Noun
rozkazů	Noun
šířek	Noun
vegetativními	Adjective
vesnickými	Adjective
Slovenku	Noun
zastaralými	Adjective
jízdenku	Noun
urozenou	Adjective
skvělou	Adjective
hříšníkem	Noun
trenérům	Noun
výrobkům	Noun
pilníků	Noun
slovy	Noun
kalkulačku	Noun
předsedou	Noun
mošte	Noun
rejstřících	Noun
škraboško	Noun
rákosnících	Noun
čvachtáme	Verb
všudypřítomnou	Adjective
vrahem	Noun
akrobatickou	Adjective
alternativách	Noun
stolům	Noun
fanoušek	Noun
doufajíc	Converb
udělám	Verb
botám	Noun
larvám	Noun
syntetickými	Adjective
impozantními	Adjective
milujme	Verb
příčin	Noun
účtovavše	Converb
rozhovorů	Noun
účelovou	Adjective
ohňostrojem	Noun
vychytávek	Noun
rájích	Noun
scénami	Noun
turistickými	Adjective
kečupů	Noun
sluchovými	Adjective
nabídko	Noun
hadů	Noun
nepřátelskou	Adjective
idylickou	Adjective
směnek	Noun
omítka	Noun
dělu	Noun
Portugalců	Noun
Němče	Noun
osobu	Noun
chrochtání	Converb
koncovek	Noun
praxím	Noun
zrcadel	Noun
vodám	Noun
obtěžovavše	Converb
dobrodruh	Noun
blokují	Verb
ampulka	Noun
křižovatka	Noun
vilách	Noun
anténa	Noun
váženými	Adjective
optika	Noun
spadá	Verb
zastrašující	Participle
psaních	Noun
vzduších	Noun
vacích	Noun
rýžovou	Adjective
čolek	Noun
příšeru	Noun
potem	Noun
kloubů	Noun
stánkem	Noun
podmětem	Noun
aktualizovanou	Adjective
saunou	Noun
modravými	Adjective
kokosovou	Adjective
kládami	Noun
plenou	Noun
živina	Noun
amygdalách	Noun
bodat	Verb
obtěžujíc	Converb
satirickou	Adjective
háčkům	Noun
despotickými	Adjective
diskutování	Converb
květech	Noun
zmrzlina	Noun
starající	Participle
orgánů	Noun
snahám	Noun
přitahování	Converb
přímočarou	Adjective
chováno	Participle
jednorázovou	Adjective
dívají	Verb
arteritidu	Noun
příchodech	Noun
časů	Noun
biskupech	Noun
Francouzů	Noun
zpožděních	Noun
čarodějnic	Noun
glazuru	Noun
cucá	Verb
jazyků	Noun
nástrojům	Noun
pojistkou	Noun
drogám	Noun
vážkou	Noun
kotěte	Noun
spotřebitelem	Noun
administrativou	Noun
kontaminující	Participle
brzdám	Noun
kmitající	Participle
ateistů	Noun
plodinám	Noun
součástku	Noun
šířko	Noun
kober	Noun
laťkou	Noun
památka	Noun
hlídáni	Participle
implantuje	Verb
průhlednou	Adjective
zákonům	Noun
šířkami	Noun
kůzletem	Noun
biolog	Noun
šiků	Noun
křižnících	Noun
letadel	Noun
ledna	Noun
orel	Noun
nehtů	Noun
rádlu	Noun
dámském	Adjective
angažovat	Verb
mysem	Noun
abcházštino	Noun
nohu	Noun
antihmotu	Noun
elektrikářích	Noun
gejša	Noun
fotek	Noun
krabe	Noun
železnicí	Noun
taxíků	Noun
ančovičku	Noun
mícháš	Verb
pozemcích	Noun
oxidováno	Participle
informován	Participle
nespecifickými	Adjective
kláveso	Noun
psina	Noun
pivovarům	Noun
stranám	Noun
řezů	Noun
maskující	Participle
rybách	Noun
adaptacemi	Noun
kritiku	Noun
vědrům	Noun
nezávislými	Adjective
obsluhují	Verb
stou	Adjective
klientů	Noun
papežům	Noun
fantastickou	Adjective
kocour	Noun
mandátů	Noun
policí	Noun
panákem	Noun
ctižádostech	Noun
okupující	Participle
chovat	Verb
žen	Noun
chřestýšům	Noun
foukáni	Participle
tričkách	Noun
granátem	Noun
pannám	Noun
směrům	Noun
velrybám	Noun
potravin	Noun
mamut	Noun
shodách	Noun
náhrada	Noun
odehrávavši	Converb
vidinou	Noun
luno	Noun
artritidu	Noun
pondělími	Noun
panenku	Noun
sérem	Noun
dvojtečkou	Noun
velryba	Noun
ukazovákem	Noun
pracovníku	Noun
chřestýšem	Noun
dcero	Noun
indexujeme	Verb
spánkovou	Adjective
salámů	Noun
maďarském	Adjective
tuleň	Noun
zkušenostmi	Noun
kóde	Noun
stykem	Noun
litrům	Noun
mlýnů	Noun
betlémem	Noun
bradou	Noun
zebrami	Noun
pólům	Noun
kůro	Noun
plavbami	Noun
kobylou	Noun
laickými	Adjective
brodům	Noun
pláten	Noun
lásek	Noun
nahou	Adjective
nepodstatnou	Adjective
tvářemi	Noun
diskutováno	Participle
volů	Noun
básním	Noun
hejně	Noun
plemenem	Noun
nedostatečnou	Adjective
korigující	Participle
aktualizuje	Verb
matrika	Noun
kšiltovek	Noun
defragmentujme	Verb
albem	Noun
vrstvám	Noun
věda	Noun
akcionářem	Noun
adaptacích	Noun
dosahujíc	Converb
přečtení	Converb
zubařem	Noun
mosaznou	Adjective
automatem	Noun
medituje	Verb
obdivuj	Verb
velikém	Adjective
časovačů	Noun
toaletami	Noun
povstáních	Noun
padá	Verb
sportů	Noun
vozovka	Noun
dehydratuje	Verb
vlacích	Noun
souostrovími	Noun
brýlí	Noun
Tibeťanům	Noun
poměrem	Noun
pýchavka	Noun
básnířek	Noun
pozorovatelnou	Adjective
žánrů	Noun
náměstích	Noun
balónem	Noun
dokumentům	Noun
nástupů	Noun
modlíte	Verb
příšer	Noun
raftů	Noun
kuno	Noun
kině	Noun
štědrými	Adjective
vápně	Noun
sviní	Noun
čtouce	Converb
růžemi	Noun
zraněních	Noun
skluzavka	Noun
kurýrem	Noun
jevíme	Verb
zvukem	Noun
formo	Noun
ypsilonům	Noun
rodům	Noun
kapilárami	Noun
zájmenech	Noun
ubrusem	Noun
ponorkách	Noun
modelek	Noun
plánuješ	Verb
vrabcům	Noun
nezaměstnanostech	Noun
vazbu	Noun
čtvrtku	Noun
křížků	Noun
podpažími	Noun
vědou	Noun
fyzikou	Noun
vlkům	Noun
kupující	Participle
bizarními	Adjective
lepíme	Verb
letadlech	Noun
pastách	Noun
cestu	Noun
premiérami	Noun
dávej	Verb
Bulharech	Noun
stopách	Noun
pokladnou	Noun
hrušek	Noun
slušnou	Adjective
bujnými	Adjective
pracovnách	Noun
melancholiím	Noun
vizitka	Noun
nedostupnými	Adjective
upoutávkami	Noun
antihmot	Noun
úhlednou	Adjective
šípech	Noun
předkům	Noun
akomodacím	Noun
formulujíc	Converb
hurikánům	Noun
záhadou	Noun
skladbu	Noun
zábavu	Noun
somatickými	Adjective
dudami	Noun
osobou	Noun
křídlům	Noun
domů	Noun
ilustrováni	Participle
prvoků	Noun
palcích	Noun
parlamentů	Noun
překladů	Noun
tabletách	Noun
emigrovat	Verb
datují	Verb
diskutující	Participle
praček	Noun
bleskem	Noun
arcibiskup	Noun
Uruguayců	Noun
interagovat	Verb
čočka	Noun
králům	Noun
lakrosech	Noun
planetu	Noun
acetaminofenům	Noun
drog	Noun
halami	Noun
jmen	Noun
stop	Noun
plivající	Participle
modliteb	Noun
šťastnou	Adjective
jmelími	Noun
dokumentovat	Verb
děvčatech	Noun
Češkám	Noun
hymnou	Noun
nepřátelskými	Adjective
dobrem	Noun
výrobu	Noun
světcům	Noun
ztroskotáních	Noun
trub	Noun
nepřijatelnými	Adjective
množstvích	Noun
převažují	Verb
abeced	Noun
šváb	Noun
navrhující	Participle
vojskem	Noun
pozemskou	Adjective
skvrnu	Noun
údajům	Noun
pracovnou	Noun
metodou	Noun
umíte	Verb
morovými	Adjective
pitomec	Noun
židech	Noun
změnách	Noun
dřevem	Noun
jdou	Verb
motorům	Noun
účastníku	Noun
kanálům	Noun
remíza	Noun
penalt	Noun
odštěpování	Converb
protestují	Verb
umřu	Verb
slánkami	Noun
sunnitskou	Adjective
roků	Noun
raketoplánem	Noun
autoškola	Noun
dívek	Noun
sova	Noun
studentech	Noun
padán	Participle
nedělím	Noun
kódům	Noun
kapes	Noun
neporazitelnou	Adjective
couvám	Verb
hřbitovem	Noun
oblepujeme	Verb
rojnících	Noun
achátů	Noun
sil	Noun
cibulemi	Noun
bohoslužeb	Noun
dárků	Noun
ropucha	Noun
matrik	Noun
kamerách	Noun
sušenou	Adjective
jachtu	Noun
slizkými	Adjective
alemánštinách	Noun
šperkem	Noun
znělkách	Noun
boltcovitek	Noun
laboratořích	Noun
soutěžím	Noun
masku	Noun
blechám	Noun
postýlkou	Noun
kompostování	Converb
lelek	Noun
obecními	Adjective
diářům	Noun
ságu	Noun
majorů	Noun
pokutou	Noun
pochlebováni	Participle
bourám	Verb
erodující	Participle
širokou	Adjective
soubojům	Noun
ofenzivám	Noun
perónem	Noun
pokračujeme	Verb
parcelách	Noun
kalamitou	Noun
lebkou	Noun
pohledům	Noun
tetujíc	Converb
dostaneš	Verb
jich	Noun
remízami	Noun
pahorkatina	Noun
vážnými	Adjective
neviditelnými	Adjective
noteboocích	Noun
loutka	Noun
čteš	Verb
ukázkám	Noun
lákům	Noun
televizích	Noun
šablonami	Noun
bažant	Noun
albatrosům	Noun
švandách	Noun
živin	Noun
zastrašováno	Participle
částkami	Noun
aklimatizací	Noun
spalujíc	Converb
bříz	Noun
budovám	Noun
sekundami	Noun
torpédem	Noun
nadáváš	Verb
spojkách	Noun
semeny	Noun
torpédech	Noun
plaváků	Noun
kurýrů	Noun
čárek	Noun
argumentuješ	Verb
sekat	Verb
jehel	Noun
krátkou	Adjective
kanálem	Noun
lisů	Noun
časoprostorovou	Adjective
svobod	Noun
napodobujíc	Converb
pracovníků	Noun
holkou	Noun
pohárů	Noun
dodávku	Noun
délkám	Noun
stěžuješ	Verb
vazbou	Noun
Slezanů	Noun
kvalifikován	Participle
podrážděnou	Adjective
volbou	Noun
broukem	Noun
smaženkám	Noun
odstraňovat	Verb
kůrou	Noun
nikám	Noun
motorku	Noun
hromadíme	Verb
postýlek	Noun
zpěvák	Noun
cenu	Noun
brodech	Noun
zpěvačkám	Noun
kormidly	Noun
figurek	Noun
želvími	Adjective
cévou	Noun
pořádkům	Noun
pralesem	Noun
švejkováno	Participle
blátům	Noun
odpuzování	Converb
zastávka	Noun
inervujme	Verb
fonetickou	Adjective
testech	Noun
kmenem	Noun
slabém	Adjective
požaduje	Verb
sestávaje	Converb
poznámek	Noun
svobodném	Adjective
zločinům	Noun
rozpočte	Noun
žolících	Noun
urážek	Noun
hokejích	Noun
souběžnou	Adjective
Eskymák	Noun
surovinách	Noun
cen	Noun
adaptacím	Noun
ateisto	Noun
bodrou	Adjective
záložníkem	Noun
skvělém	Adjective
plavíme	Verb
batohů	Noun
malin	Noun
náboženstvích	Noun
mešita	Noun
spojku	Noun
plavba	Noun
významnou	Adjective
příjemnými	Adjective
ledovcem	Noun
dokumentováni	Participle
hasičskou	Adjective
hřebene	Noun
obvodům	Noun
inervovav	Converb
rohům	Noun
krátkodobými	Adjective
vlasem	Noun
zásobám	Noun
metastáza	Noun
školníkem	Noun
květináčích	Noun
Slovák	Noun
kamerami	Noun
rejnocích	Noun
aktivními	Adjective
záhada	Noun
světcích	Noun
houbou	Noun
židem	Noun
zpívám	Verb
děvčaty	Noun
koněm	Noun
bažinatými	Adjective
zprávu	Noun
vlakem	Noun
košem	Noun
dědiců	Noun
javorů	Noun
citujeme	Verb
kulimu	Noun
Bulharům	Noun
kvasinkám	Noun
číslovka	Noun
badatelů	Noun
nesmyslů	Noun
třmínkem	Noun
oxiduješ	Verb
živočichům	Noun
věnující	Participle
střev	Noun
ropuchu	Noun
definicím	Noun
pásem	Noun
palpovavši	Converb
pivoňka	Noun
bojům	Noun
obhajovat	Verb
existován	Participle
kuchařkou	Noun
garantovavši	Converb
zamračenou	Adjective
vévodou	Noun
laťka	Noun
třídami	Noun
zlem	Noun
Alžířan	Noun
abscesech	Noun
výstředními	Adjective
národa	Noun
očumují	Verb
dosahován	Participle
popínavými	Adjective
nepodstatnými	Adjective
onanovavši	Converb
pokožkou	Noun
kamene	Noun
bizonů	Noun
dovedou	Verb
veteránech	Noun
markytánech	Noun
částkou	Noun
odmítající	Participle
deštivými	Adjective
kuchyní	Noun
smečařům	Noun
fotografům	Noun
žákem	Noun
meto	Noun
inženýrem	Noun
rádiovou	Adjective
metodu	Noun
kládou	Noun
námořníkům	Noun
raketovými	Adjective
ostroretka	Noun
věnu	Noun
pitomostem	Noun
tankům	Noun
stupňování	Converb
čůzo	Noun
lunou	Noun
píšťala	Noun
miska	Noun
zápase	Noun
smečkách	Noun
kandiduješ	Verb
tundrou	Noun
blokováni	Participle
stornován	Participle
metronome	Noun
satelitem	Noun
mrazech	Noun
hejnu	Noun
kontaminován	Participle
obličejem	Noun
zásobu	Noun
dermatologickými	Adjective
hranicím	Noun
lidstvem	Noun
kaprům	Noun
architektem	Noun
oslavami	Noun
číslovku	Noun
pannami	Noun
nadpisem	Noun
kybernetikou	Noun
‎vzrušenými	Adjective
fotkách	Noun
litinu	Noun
Slovinku	Noun
bankovek	Noun
kraválů	Noun
prostorům	Noun
trhavými	Adjective
rýma	Noun
galoších	Noun
podniká	Verb
lir	Noun
pozoruji	Verb
semestrů	Noun
statistickými	Adjective
skladbou	Noun
ankylózu	Noun
plánování	Converb
Rakušanům	Noun
hovězími	Noun
víkendů	Noun
shod	Noun
charakterech	Noun
kolébkám	Noun
propagující	Participle
kafrejme	Verb
Vietnamců	Noun
zrcadlech	Noun
okupováno	Participle
románem	Noun
člověkem	Noun
křeslu	Noun
tenistou	Noun
háčkem	Noun
Keňanů	Noun
výkladům	Noun
pralesích	Noun
tabulek	Noun
poloostrově	Noun
drozdem	Noun
podkovami	Noun
tažnými	Adjective
pavoucích	Noun
améb	Noun
příčestími	Noun
soudcích	Noun
převodovkami	Noun
maskuje	Verb
šatníků	Noun
soubojích	Noun
studentku	Noun
nespornými	Adjective
klouzání	Converb
navrhováni	Participle
vědcích	Noun
pachem	Noun
následovavše	Converb
memorování	Converb
vorvaních	Noun
mlhami	Noun
kavárnami	Noun
moudrou	Adjective
tocích	Noun
rukávů	Noun
hračkám	Noun
Pražákem	Noun
autorem	Noun
členům	Noun
širokém	Adjective
kosovskými	Adjective
umělými	Adjective
budovami	Noun
pohovku	Noun
textů	Noun
archivem	Noun
rovnoměrnou	Adjective
střetem	Noun
námořnictvy	Noun
blech	Noun
úřadech	Noun
importování	Converb
Slovan	Noun
dělbou	Noun
vyhovovat	Verb
autorů	Noun
vodováhu	Noun
obrázcích	Noun
analytickými	Adjective
párem	Noun
hospodářskou	Adjective
jistot	Noun
ochotu	Noun
ďábelskými	Adjective
derivování	Converb
odbíhav	Converb
bratrstvem	Noun
krátkém	Adjective
argumentuje	Verb
křídou	Noun
rasám	Noun
peněženek	Noun
domem	Noun
včela	Noun
jamkou	Noun
pánů	Noun
lidmi	Noun
binárními	Adjective
policista	Noun
komárech	Noun
ledničku	Noun
územími	Noun
raků	Noun
azalek	Noun
následcích	Noun
fórech	Noun
borůvkou	Noun
detektivem	Noun
hádavši	Converb
kajaků	Noun
hladkém	Adjective
jeh	Noun
byvše	Converb
poznávaje	Converb
přílohou	Noun
spravuji	Verb
kritickými	Adjective
zálohách	Noun
citů	Noun
starejme	Verb
adresuji	Verb
poznámkám	Noun
masírujeme	Verb
sadami	Noun
urážkami	Noun
vzorech	Noun
obratlovec	Noun
zisků	Noun
srn	Noun
žity	Noun
oltářem	Noun
křeslem	Noun
genovou	Adjective
přístupem	Noun
nákladů	Noun
bouřkou	Noun
pouštěmi	Noun
ilustruje	Verb
badatel	Noun
bite	Noun
angažován	Participle
konverzují	Verb
laťkách	Noun
oslavách	Noun
účte	Noun
aminokyselina	Noun
veverkou	Noun
napíši	Verb
poutích	Noun
očumuje	Verb
občanem	Noun
lebkami	Noun
výbuších	Noun
katech	Noun
uzda	Noun
listování	Converb
maskujíc	Converb
minerálka	Noun
knížetem	Noun
klidem	Noun
diskvalifikuje	Verb
poslouchá	Verb
aktualizovanými	Adjective
časem	Noun
antilop	Noun
maskovat	Verb
premiérů	Noun
potenciálům	Noun
mluvnicí	Noun
dívající	Participle
spoustou	Noun
předlohám	Noun
architektů	Noun
analyzováni	Participle
chlorech	Noun
arteritida	Noun
pivovarech	Noun
hostin	Noun
zrcadlovkách	Noun
povrchům	Noun
sžíravými	Adjective
oplatka	Noun
papouškem	Noun
srážkou	Noun
startem	Noun
ohnišť	Noun
toalet	Noun
jazykověda	Noun
sebevraždách	Noun
prosím	Verb
cenzurujme	Verb
kritizován	Participle
synchronizováno	Participle
chorobami	Noun
útesů	Noun
hlasitou	Adjective
nočníkem	Noun
volbu	Noun
fungováními	Noun
blokem	Noun
žurnalistou	Noun
arteriosklerózám	Noun
krajích	Noun
žonglovat	Verb
žánrech	Noun
patem	Noun
srbskou	Adjective
párům	Noun
jeďme	Verb
travnatou	Adjective
drob	Noun
výhodnou	Adjective
patům	Noun
souhlasem	Noun
angažuji	Verb
mšemi	Noun
řek	Noun
chvílí	Noun
zmrzlinou	Noun
maskách	Noun
čárou	Noun
indickou	Adjective
sadám	Noun
soucitech	Noun
dragomanů	Noun
bohům	Noun
kládách	Noun
trapnou	Adjective
architekturám	Noun
maskou	Noun
aplikačními	Adjective
vejcovodem	Noun
pilujeme	Verb
faktur	Noun
vyděláme	Verb
kapsami	Noun
kvalifikováno	Participle
bylinnými	Adjective
imputování	Converb
pivoňkami	Noun
kořeními	Noun
vápny	Noun
infarktem	Noun
nazýváš	Verb
bezchybnou	Adjective
vědmou	Noun
sádlem	Noun
existujíc	Converb
torbám	Noun
automatizuje	Verb
želvách	Noun
ofsajde	Noun
veselými	Adjective
indexováni	Participle
holku	Noun
plátnech	Noun
účincích	Noun
vzdálenostech	Noun
škála	Noun
orlech	Noun
průmysle	Noun
sahající	Participle
žízních	Noun
ledvina	Noun
chudobami	Noun
marabuech	Noun
básnířkami	Noun
troska	Noun
amputují	Verb
vředovými	Adjective
skvrn	Noun
opakuje	Verb
jazykem	Noun
farma	Noun
věnovavše	Converb
pěstován	Participle
Francouz	Noun
holemi	Noun
jeslí	Noun
čokolád	Noun
grupou	Noun
sportech	Noun
pivoňkou	Noun
omlouvajíce	Converb
kontrolujeme	Verb
medicínou	Noun
bydly	Noun
importován	Participle
pozoruje	Verb
bankou	Noun
amplitudu	Noun
druhými	Adjective
divadly	Noun
plánováni	Participle
častými	Adjective
jamka	Noun
postrojů	Noun
upoutávkou	Noun
sahání	Converb
zhoršování	Converb
úmyslem	Noun
chirurgickém	Adjective
mezera	Noun
edituje	Verb
veteránům	Noun
vyhrazenou	Adjective
destiluj	Verb
výročními	Adjective
zkouškách	Noun
ochotou	Noun
varlatech	Noun
násobím	Verb
trenér	Noun
testem	Noun
plátkům	Noun
bydlíš	Verb
hrozeb	Noun
Němec	Noun
Židovku	Noun
opicemi	Noun
kastrován	Participle
libanonskou	Adjective
rób	Noun
pátou	Adjective
bryndácích	Noun
volejbalistů	Noun
polemickou	Adjective
Švédů	Noun
synagoga	Noun
znepokojuji	Verb
blokařích	Noun
troubami	Noun
bór	Noun
učitelka	Noun
boxer	Noun
obsluhováno	Participle
odmítání	Converb
stěhují	Verb
rado	Noun
grupa	Noun
znající	Participle
losujme	Verb
dávat	Verb
konvicích	Noun
demoralizujeme	Verb
buddhistou	Noun
apokalypsu	Noun
anketu	Noun
popravčímu	Noun
saní	Noun
novou	Adjective
fichtovskou	Adjective
tónem	Noun
koukavši	Converb
církvích	Noun
chrochtající	Participle
pročíst	Verb
ropuchách	Noun
katedrálou	Noun
plátkem	Noun
Argentincích	Noun
kastruj	Verb
hostitelskou	Adjective
aukcím	Noun
globalizací	Noun
křížovku	Noun
obsluhující	Participle
kachnu	Noun
vran	Noun
ligou	Noun
simulován	Participle
radostem	Noun
džínami	Noun
lisech	Noun
kvádrem	Noun
nelidskými	Adjective
špinavém	Adjective
papírem	Noun
nespecifickou	Adjective
kalkulují	Verb
lžiček	Noun
odzbrojíme	Verb
kalhotek	Noun
kyselina	Noun
gotickou	Adjective
anglickými	Adjective
káv	Noun
zavádějícími	Adjective
fanouškům	Noun
českou	Adjective
stopařem	Noun
zlodějů	Noun
facku	Noun
právům	Noun
plotic	Noun
okrajem	Noun
židů	Noun
světů	Noun
učitelku	Noun
klubovna	Noun
remíz	Noun
flirtujeme	Verb
krkavců	Noun
komentářích	Noun
předložkách	Noun
ubrusů	Noun
tubami	Noun
panen	Noun
rýčem	Noun
bratrech	Noun
kytaru	Noun
pomlouvá	Verb
rybníkem	Noun
liberem	Noun
srážek	Noun
met	Noun
vzbuzuje	Verb
majorech	Noun
celkem	Noun
mučím	Verb
pahorkatinou	Noun
zahrnování	Converb
gorilami	Noun
matrikách	Noun
vidíš	Verb
pamětích	Noun
panujíc	Converb
dvojkovou	Adjective
sýrů	Noun
obsahovav	Converb
love	Noun
pávů	Noun
apokalyps	Noun
donem	Noun
chyba	Noun
kachničkou	Noun
dámu	Noun
broucích	Noun
slivovicemi	Noun
požadují	Verb
skica	Noun
psychózami	Noun
hloubku	Noun
komunikacemi	Noun
zaměstnancům	Noun
podnikající	Participle
barvitými	Adjective
cvoku	Noun
mešitou	Noun
višeň	Noun
nepřítelem	Noun
seker	Noun
rybář	Noun
hláškami	Noun
absolvování	Converb
svíčkách	Noun
mandlovou	Adjective
manažer	Noun
silnicích	Noun
guma	Noun
vysvětluji	Verb
encyklopedickými	Adjective
hlasitém	Adjective
kojotů	Noun
tvarem	Noun
pštrosům	Noun
přítelem	Noun
příslušníkem	Noun
poslouchat	Verb
trenérů	Noun
špičkou	Noun
přečtu	Verb
pěšců	Noun
faktickou	Adjective
vanou	Noun
kafrej	Verb
smečích	Noun
ženám	Noun
jistota	Noun
pracující	Participle
okrajům	Noun
kruhem	Noun
úřadů	Noun
nesou	Verb
králík	Noun
konkurováni	Participle
sněhům	Noun
hračku	Noun
rozlišujeme	Verb
zapalovačům	Noun
slovinskou	Adjective
chybnou	Adjective
kloubovými	Adjective
kinestetickou	Adjective
průvodcem	Noun
řemeslem	Noun
marnotratnou	Adjective
dvoře	Noun
poloostrovu	Noun
předmanželskou	Adjective
nora	Noun
stěžujeme	Verb
modelko	Noun
akademickou	Adjective
dovolujeme	Verb
následování	Converb
šermuješ	Verb
mrtvolách	Noun
ukázko	Noun
trychtýřů	Noun
úhlům	Noun
aciditou	Noun
hřívou	Noun
míchán	Participle
kontrastuji	Verb
državu	Noun
roládou	Noun
agnosticismusem	Noun
lokomotivám	Noun
analýz	Noun
kupu	Noun
úderem	Noun
paroduje	Verb
parlamentům	Noun
kůrami	Noun
prachovku	Noun
věžích	Noun
dinosaurem	Noun
překvapeních	Noun
krokem	Noun
rafinac	Noun
bouřkách	Noun
existování	Converb
japonskou	Adjective
mexickou	Adjective
průsvitnými	Adjective
garantován	Participle
vyrážek	Noun
krásném	Adjective
chvástavši	Converb
ženeme	Verb
podgrupa	Noun
narozeninám	Noun
jídelna	Noun
vlascích	Noun
srdcem	Noun
dubnovou	Adjective
gólům	Noun
mobile	Noun
planet	Noun
napíší	Verb
snahou	Noun
fotografováno	Participle
nahrávač	Noun
oceánech	Noun
tombola	Noun
prutem	Noun
logickými	Adjective
výrazem	Noun
pochybující	Participle
zázrakem	Noun
kolonizuj	Verb
Židovek	Noun
niku	Noun
náhradách	Noun
pásům	Noun
minerálku	Noun
fyziologickou	Adjective
názvů	Noun
hravou	Adjective
plivejme	Verb
dámskou	Adjective
datovou	Adjective
proslulými	Adjective
bandu	Noun
šermuje	Verb
síty	Noun
pokladnách	Noun
katedrála	Noun
nešvarů	Noun
dámám	Noun
poznávají	Verb
čichovou	Adjective
svůdnou	Adjective
vlhkostem	Noun
pračeštino	Noun
anketách	Noun
masturbovat	Verb
přemrštěnou	Adjective
pohybem	Noun
výroba	Noun
smyslů	Noun
žebříkem	Noun
horkém	Adjective
střelám	Noun
modlitbou	Noun
okamžiků	Noun
navrhujíc	Converb
ševcem	Noun
vilami	Noun
krtků	Noun
jízdenek	Noun
postaveními	Noun
pilote	Noun
vano	Noun
lin	Noun
filosofiím	Noun
politiků	Noun
bedlovou	Adjective
cizincích	Noun
zpravodajem	Noun
zpěvákem	Noun
kadeřníkem	Noun
dobrodružnou	Adjective
absolventech	Noun
papežem	Noun
nadějích	Noun
ovládání	Converb
královnou	Noun
kapko	Noun
obdobích	Noun
lovíš	Verb
kobliha	Noun
sobů	Noun
kradou	Verb
souborů	Noun
dámou	Noun
policistou	Noun
zátoka	Noun
pracujme	Verb
doufejme	Verb
amalgámů	Noun
tuleních	Noun
kodifikován	Participle
volbami	Noun
vědců	Noun
prosincem	Noun
beran	Noun
říkáte	Verb
předznamenáními	Noun
nevrlými	Adjective
nádobím	Noun
marketér	Noun
koktá	Verb
zeleninu	Noun
chce	Verb
báchorko	Noun
vedoucími	Noun
angažuje	Verb
albatrosem	Noun
aktivistů	Noun
oknům	Noun
vadou	Noun
dogmatům	Noun
mrzíme	Verb
couvat	Verb
hru	Noun
návrzích	Noun
krizím	Noun
kazet	Noun
úrokovými	Adjective
otcovskou	Adjective
křižovatkou	Noun
rybu	Noun
vztažnou	Adjective
leknínem	Noun
třídu	Noun
povstáními	Noun
sasankách	Noun
foukavše	Converb
kvasinek	Noun
chtíčem	Noun
hodnostmi	Noun
pohřbe	Noun
plodinu	Noun
úředníků	Noun
ornou	Adjective
zahrnován	Participle
hádáno	Participle
spadají	Verb
paleb	Noun
ubrousků	Noun
amylázám	Noun
papouškujeme	Verb
aplikujeme	Verb
pravdách	Noun
medvědů	Noun
hlízách	Noun
akuzativem	Noun
filozofovavše	Converb
amharštinou	Noun
kaplemi	Noun
přehrada	Noun
bokům	Noun
brýlemi	Noun
tetujme	Verb
klapkou	Noun
osobami	Noun
lesklou	Adjective
odpovídá	Verb
radnicemi	Noun
únorů	Noun
hladomorem	Noun
vrchovin	Noun
blátem	Noun
kabelkám	Noun
perlorodka	Noun
kolébkou	Noun
číslům	Noun
Čech	Noun
předběžnými	Adjective
dudám	Noun
zrcadle	Noun
krků	Noun
pyžam	Noun
oříškem	Noun
sójou	Noun
právními	Adjective
průplavem	Noun
hodím	Verb
nizozemštinu	Noun
obore	Noun
úkolech	Noun
popravčími	Noun
Srbů	Noun
hoblovat	Verb
Rumunkami	Noun
pozic	Noun
couvá	Verb
Turek	Noun
tchoř	Noun
borůvkami	Noun
bělovlnnými	Adjective
uhrů	Noun
kolům	Noun
sprosťák	Noun
faxující	Participle
vulkanickou	Adjective
liberech	Noun
románům	Noun
sešívačku	Noun
autobusům	Noun
překladem	Noun
blokující	Participle
výletů	Noun
deleguje	Verb
hlasovavši	Converb
pozemskými	Adjective
mravem	Noun
pracích	Noun
jedničkami	Noun
pozdravuješ	Verb
čekanka	Noun
jedničku	Noun
Alžířanko	Noun
holubů	Noun
kontaktů	Noun
absolutními	Adjective
poslanec	Noun
jetí	Converb
světem	Noun
alergiích	Noun
mutuj	Verb
kotníkům	Noun
vařenou	Adjective
honbám	Noun
bratře	Noun
sekunda	Noun
studenou	Adjective
vztekem	Noun
okoun	Noun
ananasů	Noun
béžovou	Adjective
událostmi	Noun
ajťácích	Noun
drahokamem	Noun
prstenů	Noun
hercem	Noun
ohledem	Noun
ňadrům	Noun
aktivismusů	Noun
herečkách	Noun
manévrovat	Verb
osob	Noun
ryba	Noun
okupování	Converb
ionizují	Verb
osobo	Noun
loděnic	Noun
kloubovou	Adjective
kulometech	Noun
hrůzami	Noun
čekám	Verb
islandskou	Adjective
směrů	Noun
bolestem	Noun
pytlům	Noun
orlům	Noun
synchronními	Adjective
sestávat	Verb
očkujeme	Verb
zábavám	Noun
dobách	Noun
tepna	Noun
adoptuj	Verb
jménem	Noun
člověk	Noun
telegrafem	Noun
zajíců	Noun
dělajíce	Converb
arkádou	Noun
předsedů	Noun
infikován	Participle
brašen	Noun
kilometre	Noun
filozofování	Converb
supercela	Noun
dobrotou	Noun
jádry	Noun
poledníkům	Noun
stěhujeme	Verb
ramenům	Noun
píchající	Participle
ona	Noun
sněhulák	Noun
lehkou	Adjective
pochode	Noun
Slovenkám	Noun
mající	Participle
praporech	Noun
víla	Noun
gum	Noun
cigošů	Noun
muzeí	Noun
baba	Noun
sněžnic	Noun
teplotách	Noun
hláskovavši	Converb
zájmech	Noun
volbo	Noun
mstíš	Verb
Slovákům	Noun
ovocnými	Adjective
nárazů	Noun
ruku	Noun
rasovými	Adjective
vojácích	Noun
milenku	Noun
klávesám	Noun
studentkou	Noun
ilustrujíc	Converb
souhlasů	Noun
bídou	Noun
směšnou	Adjective
tětivu	Noun
krokodýl	Noun
malířů	Noun
tisáku	Noun
motty	Noun
kožichů	Noun
špercích	Noun
pramenech	Noun
přechodem	Noun
oběde	Noun
pláčem	Noun
kopírko	Noun
diskům	Noun
pampeliška	Noun
motorickými	Adjective
vosu	Noun
klamnou	Adjective
smečka	Noun
náhlými	Adjective
dosahovavše	Converb
hlasují	Verb
bohoslužbu	Noun
dvojtečkami	Noun
akronymů	Noun
adaptérem	Noun
dubem	Noun
kůzlatům	Noun
kachnami	Noun
dojmům	Noun
lavicím	Noun
středisek	Noun
rýžovými	Adjective
očumuji	Verb
atopickými	Adjective
klíšťaty	Noun
přílivech	Noun
republik	Noun
bujnou	Adjective
magickou	Adjective
dvojčatům	Noun
obsluhován	Participle
malující	Participle
kýchání	Converb
strojů	Noun
masem	Noun
diskutuji	Verb
mořím	Noun
důvěřivými	Adjective
minolovek	Noun
kamenů	Noun
nárazům	Noun
sekundách	Noun
kobercům	Noun
brankářem	Noun
běda	Noun
blokuje	Verb
brad	Noun
zpívajíc	Converb
písničku	Noun
přečten	Participle
sérům	Noun
buddhista	Noun
gratuluji	Verb
mezilidskou	Adjective
šperků	Noun
restartuje	Verb
mažu	Verb
panáků	Noun
střechách	Noun
květnatými	Adjective
prodávání	Converb
ofenzivu	Noun
Litevcům	Noun
píča	Noun
pláních	Noun
lišek	Noun
sousedech	Noun
klasifikuje	Verb
synagogách	Noun
peřino	Noun
mírem	Noun
náboženskými	Adjective
kritizuje	Verb
nedělích	Noun
dortem	Noun
podstatnými	Adjective
integrovavši	Converb
baletek	Noun
ničíš	Verb
rasistickými	Adjective
kanců	Noun
vinou	Noun
pronásledující	Participle
pěstujeme	Verb
pneumatikám	Noun
zamyká	Verb
ubožáků	Noun
šablonám	Noun
děvčete	Noun
výbuchem	Noun
flamendře	Noun
voskovka	Noun
dravců	Noun
regulující	Participle
botelem	Noun
Němkou	Noun
pohřbech	Noun
chórech	Noun
šnek	Noun
filozofující	Participle
váhách	Noun
analyzování	Converb
zastávku	Noun
bineců	Noun
dostanete	Verb
toaletou	Noun
veverko	Noun
tabulka	Noun
oblastmi	Noun
tancování	Converb
týmům	Noun
rohovka	Noun
jachta	Noun
much	Noun
dělbo	Noun
zdrojů	Noun
druhou	Adjective
vězňům	Noun
žvýkají	Verb
pravou	Adjective
nárokuje	Verb
dešťům	Noun
táto	Noun
deskou	Noun
rána	Noun
jednota	Noun
hákováni	Participle
odpovídavše	Converb
ukázka	Noun
nakupují	Verb
křížem	Noun
dešťovek	Noun
koled	Noun
spravování	Converb
baleními	Noun
dráha	Noun
jezer	Noun
předcích	Noun
dáme	Verb
tělesech	Noun
heřmánkem	Noun
molekulárními	Adjective
stohem	Noun
podnikat	Verb
odmítáš	Verb
obvyklou	Adjective
foukán	Participle
pumpuje	Verb
divizím	Noun
miskám	Noun
raménkům	Noun
řezníků	Noun
satelitů	Noun
balíčcích	Noun
kroutím	Verb
pozorovav	Converb
pojmem	Noun
faxe	Noun
měkkém	Adjective
zabráníme	Verb
vzorům	Noun
řidičích	Noun
slánkám	Noun
existují	Verb
národnostech	Noun
vodováho	Noun
pražskou	Adjective
hláskou	Noun
lžicím	Noun
básnířkám	Noun
způsobů	Noun
inervovavši	Converb
chodeb	Noun
bádání	Converb
děkují	Verb
důvěrách	Noun
cílovými	Adjective
pochlebovavši	Converb
činorodými	Adjective
naběračkami	Noun
stoupa	Noun
názvem	Noun
paprika	Noun
ochutnávající	Participle
lišku	Noun
masakrovavše	Converb
pokračuj	Verb
minolovka	Noun
bečkám	Noun
poloměrech	Noun
Brňák	Noun
velkými	Adjective
brodem	Noun
avizuje	Verb
Evropan	Noun
podprsenek	Noun
delegován	Participle
pumpovavši	Converb
klasifikují	Verb
vratnou	Adjective
zátkám	Noun
kloktáme	Verb
útěků	Noun
imputuješ	Verb
zrny	Noun
žíla	Noun
reproduktorů	Noun
jmény	Noun
pamatováno	Participle
řetězcích	Noun
souběžnými	Adjective
Evropanem	Noun
fenoménech	Noun
děkuji	Verb
sametům	Noun
nedůležitou	Adjective
jezerech	Noun
rozkoukáni	Participle
kroupu	Noun
parodující	Participle
zpochybňující	Participle
synchronizováni	Participle
instalováno	Participle
vidliček	Noun
chřipka	Noun
obchodníkům	Noun
troskách	Noun
jehličnatými	Adjective
rasistickou	Adjective
automatech	Noun
přirovnáními	Noun
ratifikuješ	Verb
obchvatech	Noun
smečařem	Noun
synagogu	Noun
ušlechtilém	Adjective
literatur	Noun
chodidlem	Noun
chodíme	Verb
kojencem	Noun
doktorům	Noun
kořenáčích	Noun
důkazům	Noun
slabými	Adjective
mluvíme	Verb
útokům	Noun
kartáčích	Noun
vysvětluje	Verb
garantování	Converb
dnu	Noun
mouchu	Noun
povinnostech	Noun
průmyslem	Noun
rybám	Noun
kopírka	Noun
šípům	Noun
pamatování	Converb
odborném	Adjective
brázda	Noun
vysavačem	Noun
axiomatickou	Adjective
štír	Noun
pojmů	Noun
vedoucímu	Noun
zábavách	Noun
paprikách	Noun
lénem	Noun
atmosférách	Noun
modlitbám	Noun
bezpečnostmi	Noun
přečte	Verb
vedeme	Verb
formulování	Converb
nepřáteli	Noun
povodním	Noun
nylone	Noun
soupeřům	Noun
alb	Noun
mačkami	Noun
žaludcích	Noun
humr	Noun
hlubokými	Adjective
působím	Verb
bedla	Noun
úderech	Noun
Raku	Noun
archivujme	Verb
prodává	Verb
pořádkem	Noun
jedinou	Adjective
tabuizováno	Participle
rizikem	Noun
četnými	Adjective
komína	Noun
neúspěších	Noun
kočkodanem	Noun
továrnu	Noun
slovem	Noun
dědicem	Noun
nezaměnitelnou	Adjective
admirále	Noun
pernými	Adjective
kalkulačkám	Noun
pardubickou	Adjective
bulharskou	Adjective
memorovat	Verb
žesti	Noun
čarodějnicemi	Noun
atakou	Noun
podpisů	Noun
kopíruji	Verb
vědomou	Adjective
tancuješ	Verb
fyzickými	Adjective
kuchařku	Noun
arcibiskupů	Noun
salámům	Noun
fjordech	Noun
elektrone	Noun
naslouchají	Verb
kuchyním	Noun
markytánku	Noun
čtvrtou	Adjective
kinu	Noun
rambajzům	Noun
skříních	Noun
piča	Noun
přehradu	Noun
potřebující	Participle
sebeúctami	Noun
pilotům	Noun
dostaneme	Verb
alela	Noun
jednoduchém	Adjective
neziskovkách	Noun
‎poválečnou	Adjective
společnými	Adjective
ježků	Noun
centry	Noun
smůlo	Noun
choreografickou	Adjective
vidíte	Verb
cvakavše	Converb
ochabovat	Verb
prodávají	Verb
kupovat	Verb
řemeslech	Noun
staveními	Noun
mrazům	Noun
ročenek	Noun
rachotem	Noun
almužnou	Noun
dobrodruhem	Noun
míchat	Verb
lišejnících	Noun
marek	Noun
ploutvích	Noun
lachtanům	Noun
klientem	Noun
báječnou	Adjective
buď	Verb
sadech	Noun
střechou	Noun
mluvčímu	Noun
přeháňkách	Noun
debatou	Noun
datlujme	Verb
klasickými	Adjective
koblihu	Noun
jedinečnými	Adjective
cvokům	Noun
chodbu	Noun
obvazem	Noun
řádem	Noun
dvorem	Noun
osle	Noun
kožiších	Noun
instalují	Verb
náhradníku	Noun
berou	Verb
mdlobách	Noun
transkraniálními	Adjective
tautomeriemi	Noun
představu	Noun
setkáváme	Verb
lékařů	Noun
plivat	Verb
šokem	Noun
ledem	Noun
květů	Noun
tvorům	Noun
tabulkami	Noun
malba	Noun
postupů	Noun
neozbrojenou	Adjective
novými	Adjective
ňader	Noun
lustre	Noun
ubohými	Adjective
slz	Noun
kótujíc	Converb
přezdívkou	Noun
víčkem	Noun
výpisů	Noun
vodováhou	Noun
požárníkem	Noun
hladomorům	Noun
důvěru	Noun
postelích	Noun
horoskopů	Noun
jednoletými	Adjective
obsluhujme	Verb
dokumentů	Noun
odčítání	Converb
podprsenkou	Noun
antilopu	Noun
rostlinnými	Adjective
okolích	Noun
darování	Converb
hostech	Noun
soustrastmi	Noun
přirozenou	Adjective
trpaslíkům	Noun
programujme	Verb
pomůcek	Noun
kolegům	Noun
pastu	Noun
pytlem	Noun
Bulharem	Noun
šestou	Adjective
zábavou	Noun
mastnou	Adjective
analyzující	Participle
strašidlech	Noun
masakrování	Converb
šířkách	Noun
krušnějšími	Adjective
moštem	Noun
vodami	Noun
rozsáhlými	Adjective
stávkách	Noun
číšníkem	Noun
maximalizování	Converb
desítkám	Noun
pavouk	Noun
podkov	Noun
asistuješ	Verb
čepicí	Noun
propagují	Verb
bankovku	Noun
dělat	Verb
činem	Noun
mravencem	Noun
sublimující	Participle
pochybnou	Adjective
panovat	Verb
pokutu	Noun
sada	Noun
napiš	Verb
japonskými	Adjective
hala	Noun
rošádami	Noun
učím	Verb
zajícem	Noun
hodnostech	Noun
prosíme	Verb
interagovav	Converb
hejny	Noun
definovat	Verb
bubnem	Noun
korigovavši	Converb
kobylu	Noun
podgrupou	Noun
kójích	Noun
archivují	Verb
termínům	Noun
programovavši	Converb
telefonů	Noun
svéráznými	Adjective
dálnicemi	Noun
schránku	Noun
ránou	Noun
sestru	Noun
informováno	Participle
dívkou	Noun
glazurami	Noun
ložnic	Noun
mutacím	Noun
liber	Noun
akvárií	Noun
poslanče	Noun
asistováni	Participle
stanicím	Noun
sporadickými	Adjective
mezer	Noun
kure	Noun
doufám	Verb
spolehlivou	Adjective
političkou	Noun
bombarduje	Verb
mrtvolám	Noun
běloruština	Noun
křečkem	Noun
foukání	Converb
nábojích	Noun
povolávajíce	Converb
pokračující	Participle
dospěje	Verb
atletickou	Adjective
bednu	Noun
reraisuje	Verb
dotykem	Noun
bohoslužbou	Noun
gymnastiko	Noun
sjezdů	Noun
rozpočtům	Noun
předložkami	Noun
adresuje	Verb
zálivech	Noun
vráska	Noun
pokojů	Noun
obchode	Noun
ústupnou	Adjective
Američankami	Noun
chrochtán	Participle
žralokům	Noun
boudami	Noun
vraždách	Noun
driblovavši	Converb
nadnárodními	Adjective
číslicí	Noun
doktorem	Noun
biochemickými	Adjective
potomkem	Noun
dílem	Noun
sleduje	Verb
přeháňka	Noun
vévodo	Noun
chudinskými	Adjective
diskvalifikováno	Participle
žide	Noun
protestuješ	Verb
orba	Noun
zásuvkou	Noun
slyšitelnou	Adjective
arabštinou	Noun
užovka	Noun
mladickou	Adjective
herečkami	Noun
centrům	Noun
krumpáčem	Noun
vosami	Noun
kaplích	Noun
dřevech	Noun
sestávají	Verb
bída	Noun
bahenními	Adjective
pasovat	Verb
entomologiím	Noun
stěnám	Noun
nástrojích	Noun
oříšků	Noun
modifikují	Verb
pokračují	Verb
nudnými	Adjective
ledů	Noun
architektech	Noun
pronásledováno	Participle
hudebnících	Noun
hasíme	Verb
sobotu	Noun
multikiny	Noun
opylovačů	Noun
heterocyklickou	Adjective
mulat	Noun
Londýňanem	Noun
licencích	Noun
korigování	Converb
arcibiskupe	Noun
porotách	Noun
vegetariánkou	Noun
píšťalách	Noun
konzervovat	Verb
tancuj	Verb
převodovku	Noun
minorito	Noun
idealizujme	Verb
soudcům	Noun
dějepise	Noun
kotníkem	Noun
automatickými	Adjective
zrně	Noun
obdivujeme	Verb
jídlech	Noun
veganů	Noun
nacista	Noun
inervující	Participle
kůru	Noun
Srb	Noun
adresováni	Participle
abeceda	Noun
životními	Adjective
šablonou	Noun
kontaminuji	Verb
obrům	Noun
mase	Noun
poslouchají	Verb
odmítavše	Converb
malichernou	Adjective
vodu	Noun
metod	Noun
cesto	Noun
ptakopysků	Noun
kobylám	Noun
knězem	Noun
kopírovat	Verb
firmám	Noun
chvástaje	Converb
komentuje	Verb
pneumatik	Noun
snů	Noun
bzučákům	Noun
služku	Noun
chovám	Verb
medicínu	Noun
nesmyslnými	Adjective
výstupem	Noun
družicemi	Noun
společnou	Adjective
topinek	Noun
pilotem	Noun
křížů	Noun
učebnicemi	Noun
baletku	Noun
kloubem	Noun
fyzikem	Noun
rudám	Noun
ukázek	Noun
bombardérům	Noun
matematik	Noun
barvitou	Adjective
kánoích	Noun
procházko	Noun
mávám	Verb
generále	Noun
zvykem	Noun
římském	Adjective
koktat	Verb
převažovat	Verb
dbajíc	Converb
součástech	Noun
restauracemi	Noun
snídají	Verb
řepa	Noun
císařem	Noun
fascinováno	Participle
loktech	Noun
dvojkám	Noun
zdmi	Noun
kategorizován	Participle
Uruguaycích	Noun
orchestrech	Noun
studují	Verb
losování	Converb
tyčinku	Noun
dinosaurech	Noun
podivínem	Noun
Polákům	Noun
pečováno	Participle
planeta	Noun
spoustu	Noun
skutečnostech	Noun
nutíte	Verb
statečnou	Adjective
hradů	Noun
biliardách	Noun
potřebuješ	Verb
sledujíc	Converb
implementují	Verb
brázdami	Noun
poznávej	Verb
hoven	Noun
osuško	Noun
zátka	Noun
panácích	Noun
akordech	Noun
reklamu	Noun
jeskyněmi	Noun
výpovědmi	Noun
akustickými	Adjective
výkupnému	Noun
armádo	Noun
mozcích	Noun
kytarista	Noun
sadům	Noun
novinářích	Noun
jsoucen	Noun
sousede	Noun
ochabování	Converb
poznámka	Noun
existováno	Participle
sklepě	Noun
lžičkami	Noun
opovrhují	Verb
hojíme	Verb
singulárům	Noun
tundro	Noun
mikrofonům	Noun
bábovek	Noun
oceánem	Noun
kopej	Verb
prodavačku	Noun
kolonizován	Participle
svící	Noun
kodifikuj	Verb
smrtek	Noun
umírají	Verb
posmrtnými	Adjective
falzifikovat	Verb
kale	Noun
umístěními	Noun
slabikách	Noun
chobotnicemi	Noun
hlaholech	Noun
asteroidem	Noun
modelka	Noun
překvapivými	Adjective
rozumnými	Adjective
tatínk	Noun
prudkém	Adjective
scénou	Noun
beder	Noun
kolibříkům	Noun
kancem	Noun
případem	Noun
podnicích	Noun
prášků	Noun
brankám	Noun
bzučáků	Noun
obálka	Noun
komárů	Noun
topinka	Noun
uličku	Noun
domova	Noun
kormidel	Noun
hus	Noun
alternativou	Noun
účtujeme	Verb
lakomou	Adjective
kroupa	Noun
káčatům	Noun
výhodnými	Adjective
předložka	Noun
poradám	Noun
jeptiškami	Noun
liste	Noun
miláčku	Noun
pláštěm	Noun
službu	Noun
pochybuji	Verb
polokoulích	Noun
zubař	Noun
otroctvími	Noun
hodnoceních	Noun
potomkům	Noun
úderů	Noun
sudetoněmeckou	Adjective
stávkám	Noun
miluj	Verb
akcionář	Noun
výsledcích	Noun
přezdívka	Noun
pomlázkou	Noun
věcech	Noun
oblázkům	Noun
Islanďanů	Noun
hlasující	Participle
kadidlem	Noun
dravče	Noun
ropou	Noun
ančovičkami	Noun
věnován	Participle
pracovník	Noun
sestrou	Noun
implantován	Participle
pokusem	Noun
nálad	Noun
zvonků	Noun
zákazníků	Noun
výsledovek	Noun
koberců	Noun
rozlišovat	Verb
studován	Participle
výkonům	Noun
empirickými	Adjective
doporučováno	Participle
souborech	Noun
lampou	Noun
potopám	Noun
spojeních	Noun
záloh	Noun
postaveních	Noun
hastrmanem	Noun
pravověrnou	Adjective
trik	Noun
axiomatizujeme	Verb
kokotech	Noun
povodních	Noun
úžasnou	Adjective
koleny	Noun
kasa	Noun
anketo	Noun
kolaborujíc	Converb
sopko	Noun
škálách	Noun
jestřábů	Noun
jogurtem	Noun
drastickými	Adjective
kluzkou	Adjective
satirickými	Adjective
minolovku	Noun
Amazonko	Noun
bezvýznamnými	Adjective
usmrcuje	Verb
modálními	Adjective
flirtování	Converb
úkolem	Noun
zlomyslnými	Adjective
zobákům	Noun
tvárnou	Adjective
pulče	Noun
vdovám	Noun
úspěchům	Noun
diskuzím	Noun
ságo	Noun
připomínáni	Participle
kraťasech	Noun
výjimečnými	Adjective
vztazích	Noun
stovkou	Noun
milencům	Noun
dobrák	Noun
horninu	Noun
brzd	Noun
hromadím	Verb
jahoda	Noun
bezplatnou	Adjective
hovorech	Noun
svalům	Noun
knihovna	Noun
semaforům	Noun
jednoznačnou	Adjective
Norech	Noun
tesácích	Noun
námořnících	Noun
královnu	Noun
ředkvičkou	Noun
voleb	Noun
volitelnými	Adjective
Albánkou	Noun
rozměrem	Noun
Izraelcům	Noun
nozdrách	Noun
bouráš	Verb
menšinami	Noun
salamandre	Noun
bezbarvou	Adjective
robaty	Noun
trestanec	Noun
všeobecném	Adjective
ledovců	Noun
kloktáš	Verb
vegetariánskou	Adjective
kachnám	Noun
sloves	Noun
důvěryhodnými	Adjective
mzdu	Noun
děrovaček	Noun
odpovídat	Verb
mnichům	Noun
léčíš	Verb
dribluje	Verb
tlapou	Noun
dosahování	Converb
překážkám	Noun
obuvích	Noun
pomocnících	Noun
kultivovat	Verb
soudě	Noun
společenskou	Adjective
boltcovitku	Noun
únava	Noun
čelovek	Noun
mudrcům	Noun
komunikacích	Noun
napsán	Participle
gólem	Noun
spornými	Adjective
památkám	Noun
mostů	Noun
můra	Noun
zaměstnáních	Noun
vilo	Noun
Slovincům	Noun
kuřaty	Noun
jasnozřivými	Adjective
složitými	Adjective
talířům	Noun
daruj	Verb
parkujíc	Converb
ignorován	Participle
adekvátními	Adjective
plechovko	Noun
zbraních	Noun
vzpomínka	Noun
půjde	Verb
cílům	Noun
boxerům	Noun
patře	Noun
demotivovat	Verb
patami	Noun
tyčinko	Noun
koruno	Noun
dejme	Verb
masírování	Converb
faerskou	Adjective
bordelům	Noun
rozprav	Noun
kalhotami	Noun
kouzlech	Noun
akustikách	Noun
kandidující	Participle
sluncí	Noun
krutou	Adjective
hospodářskými	Adjective
kýtami	Noun
citrónů	Noun
pytlích	Noun
otrav	Noun
alkalózám	Noun
mixérem	Noun
poradách	Noun
důkazech	Noun
miláček	Noun
encyklopedickou	Adjective
hlaholům	Noun
nebezpečích	Noun
pedopsychologů	Noun
obráncům	Noun
dvojčatech	Noun
desítka	Noun
chorob	Noun
pote	Noun
Němcích	Noun
pluhů	Noun
ostudou	Noun
tloušťkou	Noun
brašno	Noun
ptákům	Noun
nožem	Noun
vodopádem	Noun
zábavami	Noun
občanech	Noun
pólů	Noun
ulehčíte	Verb
veganka	Noun
pitvá	Verb
studenými	Adjective
liberálními	Adjective
ponorkám	Noun
norštinu	Noun
norami	Noun
hornictvími	Noun
druhořadníkům	Noun
excitovat	Verb
štítovka	Noun
netopýrů	Noun
dilematy	Noun
pila	Noun
metropolitními	Adjective
vodovodem	Noun
metafor	Noun
životě	Noun
barbarském	Adjective
islandštino	Noun
tajgou	Noun
pražském	Adjective
sírou	Noun
pásech	Noun
řádkem	Noun
sláva	Noun
koleda	Noun
panenkou	Noun
sluhům	Noun
křižovatku	Noun
kýta	Noun
společenskými	Adjective
tečkami	Noun
špenátem	Noun
stranou	Noun
baletkou	Noun
klepety	Noun
přijdouce	Converb
půjdeš	Verb
hostů	Noun
přeslička	Noun
písečnou	Adjective
ledech	Noun
táborům	Noun
podpisech	Noun
lístcích	Noun
životech	Noun
etnografickou	Adjective
arkádami	Noun
hymnách	Noun
hubeňourem	Noun
pitvou	Noun
kosatku	Noun
antikou	Noun
knihu	Noun
zahrnuje	Verb
lahvemi	Noun
okrajích	Noun
vrabcem	Noun
klávesu	Noun
logiku	Noun
feministickými	Adjective
června	Noun
archivům	Noun
peklem	Noun
síla	Noun
pizzou	Noun
hřištích	Noun
loutkou	Noun
furiantů	Noun
holích	Noun
amharštino	Noun
trubců	Noun
obtěžováni	Participle
křídlovek	Noun
klasickou	Adjective
manžel	Noun
hroších	Noun
Rakem	Noun
předpise	Noun
pasážím	Noun
dramatiků	Noun
semestrům	Noun
výbornými	Adjective
materiálem	Noun
pilovavši	Converb
oxidují	Verb
kategoriích	Noun
holubem	Noun
ionizuje	Verb
razítkách	Noun
geodynamickými	Adjective
talířích	Noun
žábu	Noun
transvestita	Noun
anaforami	Noun
maratonům	Noun
ještěrkami	Noun
sníš	Verb
bohoslužbami	Noun
sžíravou	Adjective
pochybám	Noun
veršů	Noun
kompresům	Noun
příšerami	Noun
pasiv	Noun
vitamínům	Noun
válko	Noun
prostředkům	Noun
budeš	Verb
stupňuji	Verb
alkoholiků	Noun
tažnou	Adjective
křídlovkách	Noun
sdílenými	Adjective
diriguje	Verb
zahradník	Noun
zpravodaj	Noun
reraisovav	Converb
dražbách	Noun
kopírek	Noun
kupa	Noun
analýzu	Noun
tamními	Adjective
napíšeš	Verb
tuků	Noun
prasat	Noun
dvojicích	Noun
zasedáních	Noun
bratrstvu	Noun
holením	Noun
kultivují	Verb
větrům	Noun
vysvětlovavši	Converb
kalhotkám	Noun
železnic	Noun
manipulování	Converb
výbojem	Noun
muzeím	Noun
indickými	Adjective
matkami	Noun
ušlechtilou	Adjective
loukám	Noun
akciovou	Adjective
osciluješ	Verb
kapr	Noun
starej	Verb
švejkujeme	Verb
argumentům	Noun
tématy	Noun
mysů	Noun
Ukrajinců	Noun
předsíních	Noun
dlátům	Noun
otravovavši	Converb
doporučujeme	Verb
aférko	Noun
povaha	Noun
bojují	Verb
mamute	Noun
vegetariánko	Noun
pěstovat	Verb
režisére	Noun
hláska	Noun
akupresuru	Noun
komunikují	Verb
obsahem	Noun
‎požadovanou	Adjective
tetující	Participle
vnitrozemskými	Adjective
předloh	Noun
řezům	Noun
brokovnic	Noun
smeček	Noun
stěžující	Participle
Bulhar	Noun
úkolů	Noun
plastem	Noun
směrovku	Noun
chybou	Noun
trestech	Noun
krajinami	Noun
obyvatelích	Noun
asistuje	Verb
anglistkám	Noun
jelenek	Noun
kůžích	Noun
luna	Noun
plátny	Noun
pilníkům	Noun
nástrojem	Noun
číslech	Noun
Britem	Noun
obsazích	Noun
olivách	Noun
tandemů	Noun
polévkám	Noun
katolickou	Adjective
potravinách	Noun
ziskovými	Adjective
rádiovku	Noun
přehradou	Noun
interpoluje	Verb
balících	Noun
jevech	Noun
opakující	Participle
vnitrozemích	Noun
pestrými	Adjective
plavák	Noun
penalta	Noun
vah	Noun
sedačkách	Noun
lokte	Noun
achátem	Noun
částek	Noun
severoamerickými	Adjective
rozlišování	Converb
vodováhám	Noun
zapalovačem	Noun
řasou	Noun
slonům	Noun
shodám	Noun
vírou	Noun
jahodami	Noun
postavách	Noun
hledej	Verb
komentářem	Noun
hereček	Noun
lhářů	Noun
administrativa	Noun
děkuje	Verb
manévrech	Noun
božskými	Adjective
teploměrů	Noun
meditovavše	Converb
slunečníků	Noun
špiček	Noun
vlasců	Noun
saních	Noun
zmrzlinám	Noun
levou	Adjective
kamarádech	Noun
žalářů	Noun
mravenců	Noun
pádlům	Noun
orlů	Noun
brouk	Noun
Japonec	Noun
vysokou	Adjective
alelou	Noun
mottem	Noun
konecům	Noun
parními	Adjective
cestou	Noun
stoickou	Adjective
předpisech	Noun
tričkem	Noun
mlýnům	Noun
prozaickou	Adjective
poznává	Verb
věšáků	Noun
mzdami	Noun
zásuvek	Noun
hejn	Noun
nálepkovat	Verb
synchronizujíc	Converb
čarodějnicích	Noun
kyselinám	Noun
místnostech	Noun
klíšťatech	Noun
bezpečnostech	Noun
ďáblů	Noun
popleta	Noun
maximalizuje	Verb
vylučuji	Verb
rudách	Noun
trestanců	Noun
rozměrnou	Adjective
ilustrujme	Verb
slavnostem	Noun
dekretů	Noun
ovcím	Noun
neobvyklými	Adjective
stručnou	Adjective
chvástajíce	Converb
velkou	Adjective
botách	Noun
robotech	Noun
umělcích	Noun
Slovanů	Noun
trávu	Noun
plavbu	Noun
lásku	Noun
krevetami	Noun
Italům	Noun
valachů	Noun
rukám	Noun
řemesly	Noun
agonistou	Noun
housek	Noun
hodina	Noun
přátelskými	Adjective
dehydratovat	Verb
akronymem	Noun
hrozbám	Noun
architekturami	Noun
aukcí	Noun
kuchařko	Noun
můstcích	Noun
děr	Noun
příslušnících	Noun
listujeme	Verb
skryješ	Verb
tužku	Noun
lavina	Noun
užitečnými	Adjective
agresivito	Noun
filozofickou	Adjective
pánvích	Noun
firmách	Noun
látkou	Noun
odpovídavši	Converb
ryb	Noun
larvu	Noun
obloucích	Noun
kulovou	Adjective
komárům	Noun
šťávu	Noun
rychlostem	Noun
váhou	Noun
holínkám	Noun
marabuem	Noun
kopajíc	Converb
fóry	Noun
srpnů	Noun
pse	Noun
směrech	Noun
pravdami	Noun
filozofickými	Adjective
lingvistikou	Noun
pánech	Noun
detailů	Noun
sauna	Noun
hříčku	Noun
kancelářemi	Noun
dělnících	Noun
skládačka	Noun
Australan	Noun
desítku	Noun
adoptování	Converb
garantuje	Verb
otrokem	Noun
flagrantními	Adjective
pomůcka	Noun
kandidovat	Verb
ovládáno	Participle
krade	Verb
stranickou	Adjective
příšerám	Noun
jiter	Noun
rokem	Noun
experimentujeme	Verb
potravinami	Noun
sledován	Participle
chobotnic	Noun
hlediskách	Noun
antisymetrickou	Adjective
pečovat	Verb
Argentinec	Noun
parnících	Noun
bagrů	Noun
majore	Noun
dráždím	Verb
stěžování	Converb
tětivám	Noun
ovládám	Verb
država	Noun
obecnými	Adjective
abcházštinu	Noun
toaletám	Noun
množinami	Noun
změnou	Noun
ohňů	Noun
vazbám	Noun
slabiko	Noun
příjmeními	Noun
průvodcům	Noun
slánka	Noun
obranách	Noun
Gruzínko	Noun
lakrose	Noun
šátků	Noun
obdivováno	Participle
příbuzném	Adjective
mozků	Noun
jednoduchými	Adjective
sandre	Noun
botanizuji	Verb
ohništěm	Noun
zdravotnickou	Adjective
koriguji	Verb
vejcem	Noun
dotekem	Noun
ionizovav	Converb
násad	Noun
vodítkům	Noun
ptákem	Noun
národe	Noun
píču	Noun
čtěme	Verb
hříčka	Noun
čistou	Adjective
aritmetikou	Noun
ratifikován	Participle
švábů	Noun
mýdlech	Noun
bojujeme	Verb
alejemi	Noun
klucích	Noun
záruk	Noun
ponožkami	Noun
umístěních	Noun
kubistickou	Adjective
šroubem	Noun
afrikánština	Noun
moří	Noun
křesle	Noun
latentními	Adjective
obchodníků	Noun
chobotnicí	Noun
infikovat	Verb
nemocnicí	Noun
přesličkami	Noun
dělníků	Noun
neozbrojenými	Adjective
čistém	Adjective
dačami	Noun
domkem	Noun
úchvatnou	Adjective
bund	Noun
zácpa	Noun
ostrova	Noun
flinta	Noun
nozdrám	Noun
premisách	Noun
masakruji	Verb
diplomatickými	Adjective
bádaje	Converb
doplňuji	Verb
vrtem	Noun
změn	Noun
skříňkou	Noun
amnestiím	Noun
zánětem	Noun
průlivů	Noun
vydrách	Noun
přečtiv	Converb
dráho	Noun
poutník	Noun
zbožnou	Adjective
mikrofonech	Noun
kontaminovavši	Converb
studuji	Verb
autentizačními	Adjective
střelcům	Noun
kontinentů	Noun
kunda	Noun
dětmi	Noun
palbou	Noun
teplotami	Noun
srdcí	Noun
komunikujme	Verb
hlínou	Noun
balíků	Noun
norách	Noun
poloměrem	Noun
řemeslník	Noun
mísách	Noun
zákona	Noun
šneku	Noun
anaforo	Noun
divokou	Adjective
překážka	Noun
panují	Verb
vychytávkami	Noun
hyenou	Noun
cvakání	Converb
flétna	Noun
pecku	Noun
zdem	Noun
vzorků	Noun
troskami	Noun
kakay	Noun
basistům	Noun
miluješ	Verb
kaze	Noun
amerikanistik	Noun
prosíš	Verb
pánskou	Adjective
ratifikujeme	Verb
bojujme	Verb
hlavami	Noun
blafován	Participle
světě	Noun
svorkami	Noun
očkuješ	Verb
napadáni	Participle
saláte	Noun
kamarádem	Noun
odpuzuje	Verb
mažou	Verb
tepen	Noun
kobru	Noun
obsluhuje	Verb
experimentujete	Verb
úrazem	Noun
chudobám	Noun
sekyrou	Noun
achátům	Noun
systéme	Noun
moštů	Noun
mším	Noun
tepnách	Noun
plánují	Verb
bouřích	Noun
koncovkou	Noun
vedu	Verb
příkladům	Noun
kupo	Noun
pracovat	Verb
editují	Verb
energiích	Noun
mastnými	Adjective
povidel	Noun
úterými	Noun
křižníkům	Noun
množinu	Noun
obchvatů	Noun
plenu	Noun
člunech	Noun
tabulkách	Noun
argumentován	Participle
memorován	Participle
brána	Noun
otrava	Noun
obchodem	Noun
divočáků	Noun
lípách	Noun
zvěrstvům	Noun
útoků	Noun
minu	Verb
požadovat	Verb
délkách	Noun
panenkami	Noun
datovými	Adjective
znepokojovat	Verb
úřadům	Noun
zátokách	Noun
propagování	Converb
kapitán	Noun
zásaditými	Adjective
chudobu	Noun
složkách	Noun
trpaslících	Noun
pitvání	Converb
kůzlaty	Noun
minerálko	Noun
adresářům	Noun
papež	Noun
zebro	Noun
telecího	Noun
vchodů	Noun
rozprava	Noun
herečkou	Noun
smířlivou	Adjective
opic	Noun
sado	Noun
bramborách	Noun
dláty	Noun
kariérách	Noun
mís	Noun
vizitko	Noun
koutě	Noun
únosech	Noun
obratlovcích	Noun
korunováno	Participle
odborům	Noun
iterováni	Participle
chybu	Noun
kladku	Noun
almužno	Noun
plící	Noun
volavkou	Noun
obdobími	Noun
blafuj	Verb
pádem	Noun
švestkou	Noun
satelitům	Noun
plánován	Participle
stávka	Noun
vouse	Noun
tichém	Adjective
reviduje	Verb
triky	Noun
měnách	Noun
chytlavou	Adjective
balónům	Noun
řídkou	Adjective
obálkách	Noun
tmou	Noun
slávo	Noun
senzacechtivými	Adjective
metre	Noun
melodiím	Noun
radarem	Noun
stavbou	Noun
svatbu	Noun
falzifikuje	Verb
bojácnou	Adjective
asynchronními	Adjective
půda	Noun
kýchavši	Converb
doupěte	Noun
duhovkách	Noun
kytaristech	Noun
dostatečnými	Adjective
pušek	Noun
boudám	Noun
znáš	Verb
pokračuje	Verb
manažerem	Noun
loutkovými	Adjective
škraboškám	Noun
meruňku	Noun
kravami	Noun
luteránskou	Adjective
vrstvách	Noun
milovat	Verb
díru	Noun
boxerů	Noun
kruhovými	Adjective
kopytem	Noun
buddhistům	Noun
obličejovou	Adjective
aerodynamika	Noun
větami	Noun
klientům	Noun
kreativními	Adjective
posílajíc	Converb
slávou	Noun
pěnou	Noun
přečteš	Verb
dokumentuje	Verb
tanecem	Noun
vystavující	Participle
listopadů	Noun
kultivuje	Verb
hrdinů	Noun
živočišnými	Adjective
ledničkou	Noun
senzitivními	Adjective
příčinnou	Adjective
ohýbání	Converb
tučňákem	Noun
alpaka	Noun
čokoláda	Noun
majitelem	Noun
víru	Noun
licencím	Noun
medovino	Noun
příbuznou	Adjective
titulem	Noun
kriminalitou	Noun
autoritářskou	Adjective
diskvalifikován	Participle
plavíš	Verb
chybovat	Verb
přesličkách	Noun
lednička	Noun
legitimací	Noun
vorvaň	Noun
archive	Noun
puzzlů	Noun
polopřímek	Noun
logickou	Adjective
máš	Verb
dáváni	Participle
bota	Noun
pořadích	Noun
oxidující	Participle
listům	Noun
taktovku	Noun
rafinacemi	Noun
stupňů	Noun
voskovku	Noun
sedadlech	Noun
větu	Noun
chytrými	Adjective
překladům	Noun
plánuje	Verb
účtovat	Verb
síru	Noun
koncertům	Noun
Maďarech	Noun
měkkou	Adjective
stříbrům	Noun
letounům	Noun
algeber	Noun
práškem	Noun
maticím	Noun
tajga	Noun
komunikovav	Converb
akciích	Noun
kroupou	Noun
pětkami	Noun
kolegu	Noun
úvěrech	Noun
skladbách	Noun
archivování	Converb
rovnostářskou	Adjective
poutěmi	Noun
krizemi	Noun
meruněk	Noun
žraloků	Noun
Rumunech	Noun
želvám	Noun
hmotném	Adjective
lituji	Verb
garnátech	Noun
přitahuj	Verb
ořechovou	Adjective
ocasem	Noun
horečkou	Noun
plodů	Noun
paprikou	Noun
řeku	Noun
ptácích	Noun
hrochů	Noun
vápnících	Noun
bombardují	Verb
břehem	Noun
údolích	Noun
královen	Noun
elastickými	Adjective
borče	Noun
záchodem	Noun
chemičkou	Noun
kočkami	Noun
rosa	Noun
pročtouc	Converb
tátou	Noun
kódech	Noun
důvěrou	Noun
bramborem	Noun
dokumentován	Participle
výrobou	Noun
dekretům	Noun
stěhujíc	Converb
žákům	Noun
veslováno	Participle
parodují	Verb
angloamerickou	Adjective
mechem	Noun
jednáních	Noun
cituji	Verb
hlasuj	Verb
hnilobám	Noun
nadějnými	Adjective
povídek	Noun
poruch	Noun
reguluj	Verb
metách	Noun
semaforech	Noun
tetuji	Verb
studentů	Noun
brokovnicím	Noun
mocnou	Adjective
oscilují	Verb
uzlů	Noun
mláďat	Noun
postavám	Noun
vod	Noun
královnám	Noun
pásů	Noun
biskupem	Noun
opicím	Noun
rakvemi	Noun
budova	Noun
hrůzou	Noun
jehla	Noun
kontrolách	Noun
vážko	Noun
stávkami	Noun
tlacích	Noun
sekyra	Noun
protestovav	Converb
bráním	Verb
moudrostech	Noun
chovavše	Converb
hovězího	Noun
pravými	Adjective
politikům	Noun
zpochybňovat	Verb
dunu	Noun
můstků	Noun
studentům	Noun
nedostatcích	Noun
omáčkám	Noun
profesorem	Noun
náhodám	Noun
pěchota	Noun
staráno	Participle
argumentováni	Participle
vraždou	Noun
skocích	Noun
plastickými	Adjective
cucavši	Converb
velikostmi	Noun
synonymními	Adjective
připomínavše	Converb
chemickými	Adjective
typech	Noun
budku	Noun
palců	Noun
pochlebujíc	Converb
králích	Noun
připomínám	Verb
ohlasech	Noun
obrana	Noun
účtům	Noun
Litevec	Noun
vydělají	Verb
vakem	Noun
porad	Noun
architektura	Noun
pomůcku	Noun
prodejnách	Noun
kachničkami	Noun
štěňatům	Noun
kopírují	Verb
bohatými	Adjective
účtenko	Noun
cukrovími	Noun
chybám	Noun
stovku	Noun
chirurgickou	Adjective
samete	Noun
hrami	Noun
záhad	Noun
dírám	Noun
fanatickými	Adjective
znakem	Noun
flámem	Noun
tropickými	Adjective
ohních	Noun
přesličkám	Noun
tyčinka	Noun
převodovkách	Noun
krokům	Noun
vejcím	Noun
válku	Noun
kupců	Noun
aférka	Noun
celcích	Noun
modifikující	Participle
ampulku	Noun
směrovkou	Noun
Lotyšem	Noun
epidemickou	Adjective
stopám	Noun
páde	Noun
sametem	Noun
píčovinami	Noun
veršem	Noun
zrcadlům	Noun
stabilizuje	Verb
podmnožinách	Noun
hlínách	Noun
motorkami	Noun
doupat	Noun
flirtovat	Verb
taburetům	Noun
ohlasům	Noun
Norkou	Noun
hlísticemi	Noun
obchoduj	Verb
lekcích	Noun
doporučovat	Verb
matrikou	Noun
afghánskými	Adjective
levém	Adjective
kontrastují	Verb
manipulovavši	Converb
mícháme	Verb
chřipku	Noun
diváků	Noun
celkovém	Adjective
tabuizují	Verb
vdov	Noun
krami	Noun
pronásledovat	Verb
nesmyslům	Noun
budování	Converb
restartováni	Participle
obezřetnou	Adjective
příležitostech	Noun
souladem	Noun
televizorů	Noun
hledíme	Verb
pustinu	Noun
vede	Verb
housat	Noun
lžete	Verb
vápníkům	Noun
výhoda	Noun
neústupnými	Adjective
mísíš	Verb
lakrosů	Noun
kladkami	Noun
stávek	Noun
tramvajenkami	Noun
sarančatech	Noun
stupněm	Noun
doupatech	Noun
pokusech	Noun
argumentů	Noun
kontaminují	Verb
jezery	Noun
hořkou	Adjective
lékařům	Noun
pavoukům	Noun
mluvnic	Noun
dějem	Noun
tubou	Noun
kybernetikám	Noun
bordelů	Noun
implantování	Converb
střechami	Noun
rozlišuje	Verb
průvodců	Noun
žralocích	Noun
omáčko	Noun
ledvinami	Noun
otékat	Verb
svazků	Noun
váha	Noun
zátok	Noun
ideologickými	Adjective
padej	Verb
hladomore	Noun
krajin	Noun
knížatům	Noun
pizza	Noun
koktáno	Participle
trampolína	Noun
vládu	Noun
vysvětlování	Converb
úmyslnou	Adjective
valach	Noun
trhem	Noun
vírách	Noun
boranům	Noun
souhlásek	Noun
pohybů	Noun
vagínou	Noun
památek	Noun
aforizmuse	Noun
sníženin	Noun
agonistům	Noun
bábovku	Noun
regulováno	Participle
kulturu	Noun
kluků	Noun
vzduchů	Noun
podlou	Adjective
samotách	Noun
frázích	Noun
Ital	Noun
vajíčkách	Noun
klamnými	Adjective
goril	Noun
cestováni	Participle
děláme	Verb
koloběžka	Noun
filmovavši	Converb
hospitalizováno	Participle
zvykům	Noun
milenců	Noun
plocho	Noun
panování	Converb
vznešenou	Adjective
žonglováni	Participle
volavkám	Noun
příloho	Noun
stvolem	Noun
fouká	Verb
Slováku	Noun
žílami	Noun
vílu	Noun
cestování	Converb
armádními	Adjective
šifrou	Noun
reguluje	Verb
softem	Noun
smečku	Noun
poznávat	Verb
analytičkách	Noun
biskupů	Noun
pochodů	Noun
modelkám	Noun
lstivou	Adjective
abecedami	Noun
hurikánem	Noun
dělech	Noun
vchodům	Noun
deska	Noun
implantovavše	Converb
hymen	Noun
manévrem	Noun
dívkách	Noun
plesem	Noun
slovesem	Noun
potomek	Noun
shodu	Noun
hlavu	Noun
osinách	Noun
řečnickou	Adjective
odvahu	Noun
stolech	Noun
vlnovkách	Noun
absurdita	Noun
omáčku	Noun
alpako	Noun
haploidními	Adjective
skutečnostmi	Noun
aktivitu	Noun
implementovat	Verb
vážek	Noun
čekanko	Noun
vojínem	Noun
chatu	Noun
zámkem	Noun
vstupenka	Noun
písčitou	Adjective
žebry	Noun
stropů	Noun
pozorující	Participle
čirůvek	Noun
maleb	Noun
světe	Noun
zápalnou	Adjective
pumpovavše	Converb
oponou	Noun
předkem	Noun
mrtvolo	Noun
taburetů	Noun
třískají	Verb
myšleních	Noun
platanů	Noun
hniloba	Noun
běžnou	Adjective
jemnými	Adjective
dovoleným	Noun
běhounů	Noun
včelu	Noun
listován	Participle
ženách	Noun
mlčím	Verb
mzdou	Noun
mrakodrapem	Noun
branka	Noun
aklimatizovavše	Converb
mokrými	Adjective
lavinám	Noun
zemětřeseních	Noun
argumentováno	Participle
sílo	Noun
vrzáních	Noun
adreso	Noun
termínech	Noun
chybování	Converb
snům	Noun
pomlouvat	Verb
dělníkem	Noun
hudebními	Adjective
pálkami	Noun
alobalům	Noun
vodník	Noun
olivu	Noun
chorobám	Noun
hloubek	Noun
prodáváno	Participle
krátkými	Adjective
kabaretů	Noun
ráno	Noun
grupu	Noun
vlídnou	Adjective
restartujme	Verb
pamatující	Participle
vyautovanou	Adjective
ochabuj	Verb
cedulemi	Noun
Belgičanem	Noun
monitorem	Noun
přečíst	Verb
tesařů	Noun
travnatými	Adjective
hláskuje	Verb
ubožák	Noun
lidí	Noun
hospitalizovat	Verb
ředkviček	Noun
hlasovavše	Converb
specifickými	Adjective
laním	Noun
bodání	Converb
parkování	Converb
multikinu	Noun
sníženinou	Noun
stovek	Noun
čele	Noun
zanedbatelnou	Adjective
Švédkami	Noun
fanoušků	Noun
tišíte	Verb
fyzikům	Noun
letujíc	Converb
řezník	Noun
zálivů	Noun
pate	Noun
švestkách	Noun
jamkách	Noun
přijatelnými	Adjective
plameňáku	Noun
radostech	Noun
lidem	Noun
životaschopnou	Adjective
představa	Noun
detektivům	Noun
slunéček	Noun
gramatickými	Adjective
mobilem	Noun
ježovko	Noun
neúspěchům	Noun
jestřáb	Noun
kokosovými	Adjective
vrchovinách	Noun
oltářům	Noun
katů	Noun
křeslům	Noun
importováno	Participle
antikvariáte	Noun
větvemi	Noun
tětivách	Noun
čoček	Noun
nadějnou	Adjective
nalepovavši	Converb
vdovec	Noun
gejšu	Noun
kapat	Verb
malbou	Noun
dortům	Noun
biometrickými	Adjective
konzervovavše	Converb
mužích	Noun
samota	Noun
žehlička	Noun
nekonečnem	Noun
debata	Noun
sazemi	Noun
přečteno	Participle
ohýbajíce	Converb
namáhavou	Adjective
hříčkách	Noun
rozměrech	Noun
výsledků	Noun
miskách	Noun
adresám	Noun
styků	Noun
vazácích	Noun
saunu	Noun
tématech	Noun
sublimujeme	Verb
motivujeme	Verb
spojkami	Noun
památkou	Noun
moderujíc	Converb
aktuálními	Adjective
námořnictvech	Noun
ohnivými	Adjective
krajinu	Noun
mikroprocesorů	Noun
korunováni	Participle
Češko	Noun
vláda	Noun
vážka	Noun
hodnota	Noun
skryje	Verb
grilujíc	Converb
zápornými	Adjective
houpaček	Noun
důkazem	Noun
synchronizujme	Verb
jeptiškám	Noun
spalovat	Verb
banánovou	Adjective
demografickými	Adjective
ukrajinskou	Adjective
zájmenům	Noun
láků	Noun
složkám	Noun
pekař	Noun
semenech	Noun
tělesům	Noun
mečích	Noun
scénářům	Noun
výnosům	Noun
ateistickou	Adjective
podivín	Noun
odpočinkem	Noun
nor	Noun
rákosovecích	Noun
pozicím	Noun
filmů	Noun
citovou	Adjective
stěhuj	Verb
papírna	Noun
tabulkou	Noun
obálku	Noun
třetími	Adjective
samou	Adjective
plavbách	Noun
odlivem	Noun
dělníkům	Noun
koalicí	Noun
naléhavou	Adjective
nutíš	Verb
pasuje	Verb
znělek	Noun
píčovinu	Noun
medovinám	Noun
chemikem	Noun
nestátními	Adjective
kozách	Noun
čárku	Noun
kvádrům	Noun
procese	Noun
jeptiškách	Noun
borcích	Noun
pneumatikami	Noun
sedmikrásek	Noun
architekturách	Noun
napišme	Verb
manévrů	Noun
argumente	Noun
vanách	Noun
hledající	Participle
poměrech	Noun
hasičskými	Adjective
podstatnou	Adjective
anafylaktickými	Adjective
ironickými	Adjective
kolmou	Adjective
odstraňováni	Participle
borůvek	Noun
vědí	Verb
sirotku	Noun
přeháňku	Noun
smutkem	Noun
báchorka	Noun
pih	Noun
rozlišujme	Verb
ekologickou	Adjective
bydlím	Verb
míst	Noun
kontem	Noun
vdova	Noun
balíčkům	Noun
filmuješ	Verb
regulován	Participle
telefonem	Noun
předlohami	Noun
premiérám	Noun
kašlem	Noun
informovat	Verb
polosamohlásku	Noun
tráva	Noun
pilotech	Noun
Eskymácích	Noun
průdušnicím	Noun
zprávách	Noun
akvarelech	Noun
plameňáků	Noun
sleděm	Noun
duna	Noun
akademickými	Adjective
adresovavši	Converb
styluse	Noun
žádostech	Noun
kolem	Noun
cítíš	Verb
ctitelích	Noun
postojů	Noun
předložko	Noun
prasetem	Noun
milenec	Noun
tekutou	Adjective
komár	Noun
hladomorů	Noun
grup	Noun
hlaviček	Noun
ročenka	Noun
byte	Noun
porotu	Noun
atrakcemi	Noun
poskytovatelem	Noun
nehoda	Noun
programování	Converb
strachů	Noun
pihami	Noun
silou	Noun
lokomotivo	Noun
melodickou	Adjective
pánům	Noun
nadšencích	Noun
zpěvácích	Noun
reakcemi	Noun
kyselin	Noun
kulturách	Noun
typem	Noun
elektronů	Noun
buduje	Verb
nabídkám	Noun
typickou	Adjective
stanicích	Noun
diagnostikováno	Participle
drobnými	Adjective
hřištěm	Noun
funkcím	Noun
hudebník	Noun
čočkami	Noun
Češku	Noun
technickou	Adjective
afektivními	Adjective
dogmatem	Noun
malířem	Noun
křečkům	Noun
úrovním	Noun
předmětech	Noun
strojích	Noun
křižovatek	Noun
rákosoveců	Noun
blízkou	Adjective
čelistech	Noun
člunům	Noun
slevou	Noun
počtů	Noun
bezpodmínečnou	Adjective
fotko	Noun
teoretickou	Adjective
islandskými	Adjective
kakaem	Noun
telefonátech	Noun
entitami	Noun
bobr	Noun
odchodem	Noun
křídlovka	Noun
vážkám	Noun
odbíhá	Verb
hledím	Verb
rwandskými	Adjective
soustava	Noun
hrozbou	Noun
hluků	Noun
řidič	Noun
doubím	Noun
prasatech	Noun
malbách	Noun
vědách	Noun
pitvat	Verb
oliva	Noun
bagrovavše	Converb
manažerům	Noun
bouráni	Participle
kočkodanům	Noun
sochami	Noun
ignorovat	Verb
pomocích	Noun
padající	Participle
nárokují	Verb
trpaslík	Noun
krizích	Noun
blechu	Noun
krup	Noun
kartu	Noun
střelami	Noun
bobrem	Noun
zdech	Noun
směji	Verb
vypínačem	Noun
myčkou	Noun
trampolínách	Noun
působíme	Verb
velezradou	Noun
lip	Noun
driblovat	Verb
množstvími	Noun
moudrém	Adjective
Londýňanech	Noun
univerzál	Noun
Amazonka	Noun
arménštinám	Noun
infarktů	Noun
spalují	Verb
liro	Noun
dlouhodobou	Adjective
smyšlenou	Adjective
malinou	Noun
klasifikováno	Participle
mších	Noun
adresován	Participle
stupňuje	Verb
očekávaje	Converb
skupina	Noun
pouzdry	Noun
skly	Noun
krymskou	Adjective
argentinskou	Adjective
ekumenickou	Adjective
trouba	Noun
forem	Noun
paragrafů	Noun
byv	Converb
svíčko	Noun
uzd	Noun
brýlích	Noun
má	Verb
prodávavše	Converb
samotami	Noun
sebeúcta	Noun
kontaktologem	Noun
listuje	Verb
napadá	Verb
včelám	Noun
hlásíte	Verb
sirotkem	Noun
blokováno	Participle
teoriích	Noun
kategorizují	Verb
nálepkovavši	Converb
zlozvyků	Noun
ústřic	Noun
mažeš	Verb
kytarami	Noun
oblouků	Noun
paragrafech	Noun
stíne	Noun
várku	Noun
dehtem	Noun
markytáne	Noun
povznášejícími	Adjective
pravdou	Noun
družnou	Adjective
salámem	Noun
stabilizujíc	Converb
naběračkou	Noun
donů	Noun
potomků	Noun
kalkulujme	Verb
testuje	Verb
pozorem	Noun
žehliček	Noun
nešťastnými	Adjective
tyčinek	Noun
rostlinou	Noun
kate	Noun
vážkami	Noun
stavem	Noun
drátech	Noun
boudou	Noun
aerodynamik	Noun
bank	Noun
bodavši	Converb
toxickou	Adjective
napodobuješ	Verb
svalů	Noun
hyen	Noun
markytánům	Noun
rákosníku	Noun
neobvyklou	Adjective
pokožku	Noun
zhoršující	Participle
láskám	Noun
kvalitu	Noun
studentka	Noun
ubrouskem	Noun
indexování	Converb
nepřirozenými	Adjective
revidovat	Verb
štíhlou	Adjective
křeslech	Noun
sponu	Noun
lososů	Noun
polévka	Noun
křižovatkách	Noun
dvojek	Noun
poskytovatelů	Noun
obavách	Noun
politicích	Noun
lampo	Noun
houbami	Noun
porostům	Noun
chorobách	Noun
jsa	Converb
nutnou	Adjective
částicím	Noun
anodách	Noun
publicistů	Noun
spalován	Participle
mámo	Noun
neřestem	Noun
peptidů	Noun
zákoníků	Noun
tabuizovat	Verb
ohebnými	Adjective
balkónů	Noun
křížíme	Verb
kopů	Noun
bezdětnou	Adjective
sémantickou	Adjective
minutkami	Noun
příchodů	Noun
věznic	Noun
podnikání	Converb
žaludům	Noun
štědrou	Adjective
radarům	Noun
tvrzeními	Noun
aerodynamikou	Noun
buněčnými	Adjective
bójích	Noun
radostmi	Noun
mladickými	Adjective
formulovat	Verb
axiomatizujme	Verb
třískajíce	Converb
polí	Noun
přístavech	Noun
pinzeta	Noun
snídán	Participle
blokuješ	Verb
připomínáno	Participle
faerskými	Adjective
zásuvku	Noun
začneš	Verb
dobrodružnými	Adjective
soustavách	Noun
pokladnami	Noun
lišíme	Verb
svícemi	Noun
housaty	Noun
tuleňů	Noun
zařízeních	Noun
hřbitově	Noun
opovrhujme	Verb
podobající	Participle
šekům	Noun
doprava	Noun
léčbou	Noun
světel	Noun
urážkou	Noun
listovav	Converb
námořnictev	Noun
simulování	Converb
prášcích	Noun
názvech	Noun
průměrnou	Adjective
vrahů	Noun
imputovavši	Converb
semestrech	Noun
mostech	Noun
zácpou	Noun
kuřatech	Noun
čvachtání	Converb
bažantů	Noun
motorů	Noun
klášterů	Noun
elementárními	Adjective
oblacích	Noun
pěstováno	Participle
kočko	Noun
smluv	Noun
sluchovou	Adjective
Italů	Noun
eurům	Noun
císařům	Noun
poloměrům	Noun
dubech	Noun
ptáčatech	Noun
vina	Noun
blogování	Converb
rajčatech	Noun
dělbu	Noun
lidovými	Adjective
škrabka	Noun
kostelu	Noun
mamutům	Noun
scénářů	Noun
mrazem	Noun
orle	Noun
zahrnujíc	Converb
naslouchej	Verb
pokračování	Converb
lovem	Noun
mobilům	Noun
pizzách	Noun
dělán	Participle
mužům	Noun
pojedeme	Verb
domům	Noun
nabídek	Noun
výnose	Noun
lochách	Noun
zájmeny	Noun
kvádrů	Noun
boxovat	Verb
koukání	Converb
baronko	Noun
horkými	Adjective
špendlíků	Noun
broskvím	Noun
sestrách	Noun
citujme	Verb
říkáme	Verb
kilogramech	Noun
uvolněními	Noun
pláštích	Noun
smyslům	Noun
pohledem	Noun
objevem	Noun
vystavují	Verb
minimalizují	Verb
pamatovat	Verb
klíšťat	Noun
spadající	Participle
dědů	Noun
výškou	Noun
nám	Noun
zubařů	Noun
hlínami	Noun
nadšencům	Noun
terapeutickými	Adjective
čelistem	Noun
hlav	Noun
ruskou	Adjective
příkrou	Adjective
pochyb	Noun
hlavních	Noun
slonem	Noun
pocitech	Noun
archivuje	Verb
milovav	Converb
kapelám	Noun
argumentují	Verb
rasismech	Noun
vzpomínek	Noun
lednovou	Adjective
dušemi	Noun
skladatel	Noun
droba	Noun
francouzském	Adjective
chvílemi	Noun
opovrhovat	Verb
dovednostmi	Noun
optimalizuje	Verb
kilometrem	Noun
náznaků	Noun
Dvořákovými	Adjective
maximalizovat	Verb
pitomcem	Noun
fotografiích	Noun
pivoňkám	Noun
artikuluj	Verb
cév	Noun
arteritido	Noun
svačino	Noun
borůvku	Noun
nuda	Noun
odčítat	Verb
ledvinou	Noun
alergenům	Noun
červů	Noun
tekutém	Adjective
dare	Noun
náhrobními	Adjective
sklem	Noun
nastaveních	Noun
detailem	Noun
drogou	Noun
vteřinách	Noun
udělají	Verb
drozd	Noun
králíkům	Noun
stranickými	Adjective
severoamerickou	Adjective
kytara	Noun
podsvětními	Adjective
pakážemi	Noun
zárodečnými	Adjective
kabaretech	Noun
mandátům	Noun
Amazonkám	Noun
bojkotem	Noun
spravedlivými	Adjective
smůlu	Noun
lodyhu	Noun
střelou	Noun
zapalovačů	Noun
křížovek	Noun
rádiovkou	Noun
detektivů	Noun
pěšec	Noun
basisto	Noun
robinzonádu	Noun
parohů	Noun
automatizovat	Verb
funguje	Verb
existuje	Verb
rybníka	Noun
částech	Noun
literaturám	Noun
dilematem	Noun
zdravotnickými	Adjective
Švéd	Noun
alegoriemi	Noun
ránám	Noun
plastech	Noun
plave	Verb
tichem	Noun
závěrech	Noun
Keňanem	Noun
artikulovat	Verb
připisujeme	Verb
obsahů	Noun
jeho	Noun
Belgičane	Noun
civilizovanou	Adjective
mrazíte	Verb
šumem	Noun
staženou	Adjective
diskusích	Noun
osudů	Noun
brdech	Noun
svitků	Noun
strojovou	Adjective
dravcem	Noun
pomocníkům	Noun
řasa	Noun
sebevraždám	Noun
kritizuji	Verb
brankářů	Noun
aktivům	Noun
stranu	Noun
nozder	Noun
výkonech	Noun
jedničkou	Noun
nadávajíc	Converb
onanován	Participle
komíně	Noun
mísa	Noun
měsíců	Noun
dáma	Noun
mexickými	Adjective
křtech	Noun
poloměrů	Noun
vojsky	Noun
nezcizitelnými	Adjective
selat	Noun
uhrem	Noun
koupelnám	Noun
terminologickou	Adjective
deklinacích	Noun
umírám	Verb
levnou	Adjective
obrazům	Noun
střevem	Noun
historickými	Adjective
dodávka	Noun
obtěžující	Participle
kobylkou	Noun
pracovníkem	Noun
davů	Noun
škálami	Noun
zasedáními	Noun
Mongole	Noun
delegovavši	Converb
pasažér	Noun
procházek	Noun
mrakodrapů	Noun
klávesnicí	Noun
zpívající	Participle
odmítáni	Participle
shromážděními	Noun
lékař	Noun
hákují	Verb
interiérů	Noun
loděnicí	Noun
lnem	Noun
čísel	Noun
zázraků	Noun
odehrávající	Participle
cítíte	Verb
tříčtvrtek	Noun
posilovna	Noun
daňovou	Adjective
příšerách	Noun
peróne	Noun
peřinou	Noun
rak	Noun
odpuzujíc	Converb
fjordem	Noun
brokovnicích	Noun
zpochybňují	Verb
informující	Participle
závodů	Noun
budu	Verb
směrem	Noun
čísly	Noun
politickými	Adjective
měníte	Verb
světlými	Adjective
hlídání	Converb
požárem	Noun
témat	Noun
čekankám	Noun
lochů	Noun
lesklém	Adjective
krajem	Noun
hovnem	Noun
projektech	Noun
omlouvat	Verb
stolkům	Noun
orlojem	Noun
schopnostem	Noun
korunu	Noun
trestancům	Noun
pitvo	Noun
vyslancem	Noun
taktovkami	Noun
nadvládu	Noun
prodáváni	Participle
vinu	Noun
kmitavši	Converb
vánočka	Noun
bicyklům	Noun
truhlář	Noun
rozporuplnými	Adjective
oxidování	Converb
záložníkům	Noun
léčbo	Noun
obručím	Noun
straka	Noun
následuje	Verb
semaforem	Noun
hornina	Noun
náhradou	Noun
lebek	Noun
pěstmi	Noun
motivován	Participle
výrazech	Noun
salamandr	Noun
major	Noun
milém	Adjective
berane	Noun
teplotou	Noun
pohlavími	Noun
vaječnících	Noun
garážemi	Noun
žirafa	Noun
ořeších	Noun
obědváme	Verb
školníkům	Noun
zácpách	Noun
podnikům	Noun
hutěmi	Noun
otče	Noun
poutníků	Noun
svoboda	Noun
hříchům	Noun
atakách	Noun
shoda	Noun
klíčům	Noun
šátkům	Noun
zná	Verb
titulech	Noun
antihmotách	Noun
automatickém	Adjective
oblastem	Noun
obsahuji	Verb
ředitelů	Noun
bačkor	Noun
jsouce	Converb
optimem	Noun
charakterům	Noun
Italem	Noun
svazkům	Noun
vteřina	Noun
kolega	Noun
koutech	Noun
hledisky	Noun
orbu	Noun
číslicích	Noun
premisami	Noun
ratifikováno	Participle
lístků	Noun
kosmonautů	Noun
hřbitova	Noun
rutinou	Noun
kalkulován	Participle
rojníku	Noun
výstupe	Noun
lóžemi	Noun
obdivován	Participle
taxíkem	Noun
dražbou	Noun
tupými	Adjective
tundra	Noun
rajčete	Noun
pojmech	Noun
plivání	Converb
letušek	Noun
povolávejme	Verb
vzpomínkách	Noun
kandidátů	Noun
plážím	Noun
postojům	Noun
autonomními	Adjective
orlojích	Noun
hrdinech	Noun
tvarech	Noun
podzimními	Adjective
britonskou	Adjective
pozorováno	Participle
trpaslíků	Noun
pávem	Noun
ryjí	Verb
dálnicích	Noun
máta	Noun
obsluhu	Noun
chvatů	Noun
zákazníkem	Noun
horečku	Noun
příkrými	Adjective
hýždích	Noun
lesa	Noun
komoru	Noun
chlapců	Noun
důstojnících	Noun
zubem	Noun
mečů	Noun
nemakačenkem	Noun
nosičem	Noun
arita	Noun
dívání	Converb
výrocích	Noun
myšlenko	Noun
matku	Noun
druhovou	Adjective
kyselinami	Noun
židlích	Noun
kurtech	Noun
kopat	Verb
klasifikovat	Verb
židovskými	Adjective
travestiemi	Noun
vílou	Noun
pecek	Noun
zdravými	Adjective
miminkem	Noun
houpačkách	Noun
certifikátech	Noun
láskách	Noun
instalování	Converb
mravenec	Noun
nemakačenkům	Noun
ochutnávají	Verb
štírů	Noun
kategoriím	Noun
aerodynamiku	Noun
ledovcům	Noun
