övertygades	Passive
killa	Active
plita	Active
konspirerat	Active
ämnar	Active
nederbörd	None
reservera	Active
värderad	None
saftiga	None
strömmat	Active
förvägrade	Active
övernatta	Active
kungjordes	Passive
bråkdelen	None
olik	None
stiftat	Active
bordssalt	None
snattat	Active
splittrar	Active
fästas	Passive
manifestera	Active
tillbringar	Active
twittrade	Active
informationsdesignen	None
stadsplaneringar	None
kalasade	Active
störande	None
värmebehandla	Active
tennisbanorna	None
förtövat	Active
singla	Active
brottades	Passive
minerats	Passive
inbegripen	None
pekade	Active
adderat	Active
landa	Active
halta	Active
prövar	Active
pratades	Passive
upphört	Active
släpps	Passive
vederlagts	Passive
frälsa	Active
örlogsskolor	None
kägelsnitten	None
vadade	Active
versalerna	None
ettors	None
forskningsminister	None
smuggling	None
befordrade	Active
fågelskådaren	None
förkunnar	Active
glesna	Active
bekräftades	Passive
lettiskan	None
utvaldes	Passive
kontrakterades	Passive
polackerna	None
storskarven	None
acceptera	Active
renderats	Passive
genomföras	Passive
ögonvittne	None
gafflar	Active
boktryckarkonst	None
specialiserades	Passive
uppfattades	Passive
verifierat	Active
kulspetsens	None
utbytte	Active
dukats	Passive
nedsätta	Active
gäspade	Active
spöar	Active
frånvarade	Active
kopierade	Active
korsfästes	Passive
rodrets	None
besudla	Active
anställas	Passive
väldet	None
frasera	Active
nakna	None
filma	Active
inspektera	Active
utvärdering	None
döljas	Passive
jobba	Active
lättades	Passive
inverkar	Active
beskurna	None
dekorerades	Passive
näbbar	None
kulminerade	Active
misstänks	Passive
handlägga	Active
etikettens	None
besvara	Active
befolkningssiffran	None
rövknullats	Passive
skämts	Active
valp	None
trofasthets	None
kotors	None
bleknar	Active
beräknat	Active
skankarna	None
vurmat	Active
syntetiserar	Active
duggregnens	None
aminosyrorna	None
genier	None
genomför	Active
begripa	Active
skolväsen	None
prosan	None
divergent	None
dagtingar	Active
renoverat	Active
klockslaget	None
pinglades	Passive
lutheranernas	None
konsumerades	Passive
eskalerade	Active
somnade	Active
uppdatera	Active
vaccinerar	Active
hyperventilerar	Active
påmindes	Passive
redogöra	Active
förbannats	Passive
tibetansk	None
bomma	Active
spår	Active
interfererat	Active
tappar	Active
publicerades	Passive
folkbokförts	Passive
främjades	Passive
lotsar	Active
skämtbort	Active
spaltar	Active
lyssnade	Active
företagsledare	None
sjudit	Active
anstränga	Active
invaderades	Passive
tornseglare	None
avsätter	Active
uppgått	Active
provocerats	Passive
syntetiserat	Active
skött	Active
lagtpå	Active
diskade	Active
smyger	Active
mäter	Active
stinga	Active
valsverks	None
demobiliserat	Active
immigrerar	Active
enade	Active
skamlösa	None
småvilt	None
vira	Active
förhålla	Active
könshår	None
jäsa	Active
dubbelklickar	Active
regerande	None
extremt	None
krympa	Active
avföll	Active
behandlats	Passive
kommatecknens	None
förbannade	Active
improvisera	Active
sjöstjärnor	None
riksförbund	None
rekommenderats	Passive
bangade	Active
angripits	Passive
nötts	Passive
vittnesbördet	None
korrigerat	Active
noterar	Active
ämnade	Active
kulturminister	None
incitamentet	None
spå	Active
simulera	Active
pilgrimsfalkars	None
stärkte	Active
inställt	Active
projicerar	Active
parar	Active
tonat	Active
knäcka	Active
funktionsrum	None
döda	Active
elefant	None
mestiser	None
fräckt	None
regissera	Active
bacillerna	None
brandvägg	None
erhölls	Passive
sidhuvudet	None
önskade	Active
högerjustera	Active
abstraherar	Active
uppehållstillstånd	None
citerar	Active
konsoliderande	None
förslå	Active
fräser	Active
aktivera	Active
svartnade	Active
farligt	None
dien	None
sammanfattande	None
återställts	Passive
stressats	Passive
försäljningslistorna	None
ägnats	Passive
avledas	Passive
konverterar	Active
allitterationer	None
lugg	None
kläcker	Active
stöta	Active
regionkommitténs	None
drunkna	Active
dämpats	Passive
dividera	Active
bordat	Active
rekommenderat	Active
filtrerades	Passive
märktes	Passive
växla	Active
fokkades	Passive
tänks	Passive
komprometterat	Active
truga	Active
påminn	None
tystats	Passive
blockerat	Active
forcerat	Active
ensamhetens	None
problematiska	None
högerjusterades	Passive
sponsra	Active
jämnats	Passive
figurerar	Active
rama	Active
plaggets	None
njöts	Passive
accelererar	Active
rövade	Active
deporterade	Active
drogar	Active
konsonantens	None
tvättställ	None
kuppens	None
rostades	Passive
planerats	Passive
spekulerat	Active
replikerades	Passive
sökts	Passive
specialiserat	Active
örter	None
plockades	Passive
göder	Active
assisterat	Active
kontrollerar	Active
kulsprutepistoler	None
abstraherats	Passive
härdar	None
avskedades	Passive
upphävt	Active
ladda	Active
utnämna	Active
klassificerades	Passive
registrerar	Active
myser	Active
hetare	None
glänst	Active
veckoslut	None
hedrats	Passive
qvalificera	Active
superstjärnan	None
signerades	Passive
antisemiten	None
yachts	None
flik	None
avvisats	Passive
halskota	None
multiplicera	Active
ståltrådens	None
ansat	Active
markerade	Active
rumänskor	None
inkluderades	Passive
impar	Active
övervarar	Active
sandade	Active
exploatera	Active
runkades	Passive
befinns	Passive
recipierades	Passive
biläggs	Passive
tillbringades	Passive
sveper	Active
adopterad	None
kontroversen	None
förändra	Active
målad	None
refererades	Passive
skjuta	Active
trolla	Active
åkt	Active
fasetterat	Active
lugnar	Active
förkroppsligades	Passive
manat	Active
kalabalik	None
transporterade	Active
tangentbord	None
tömde	Active
patrullerades	Passive
hänvisade	Active
fotleden	None
läts	Passive
födelsedagspresenters	None
rättvisan	None
receptbeläggas	Passive
karakteriserats	Passive
palmsöndagen	None
attackera	Active
möjliggjorts	Passive
utbjöd	Active
isolerat	Active
besvarades	Passive
medlemsstaternas	None
strålade	Active
stulit	Active
motsagts	Passive
noterades	Passive
bifallas	Passive
översätter	Active
spanskt	None
prestera	Active
svininfluensan	None
stampade	Active
vilseledas	Passive
inväntades	Passive
pendeltåg	None
hejdades	Passive
vänsterjusterades	Passive
flyttats	Passive
upphävdes	Passive
huvuddiagonalernas	None
begränsa	Active
nöjer	Active
exponerat	Active
snuddade	Active
funkade	Active
anländer	Active
bokföras	Passive
vetenskaplige	None
bedrivit	Active
åstadkommer	Active
sakna	Active
riggade	Active
rättat	Active
arkiverats	Passive
omnämns	Passive
kartritnings	None
rengör	Active
vittnar	Active
upphör	Active
försörjer	Active
överenskommas	Passive
ensamma	None
ljudit	Active
besudlades	Passive
informerades	Passive
formlerna	None
vräker	Active
häftade	Active
medlemsstater	None
slopades	Passive
protokollförs	Passive
ena	Active
tecknats	Passive
anklagade	Active
upplevt	Active
vräks	Passive
uppskattades	Passive
eggade	Active
bifogade	Active
avser	Active
konsumera	Active
presentera	Active
derby	None
undersökt	Active
tillkommelse	None
rasade	Active
rannsaka	Active
konstruerade	Active
bojkottat	Active
kombinera	Active
mördar	Active
vägrar	Active
sålts	Passive
tågat	Active
kommenterade	Active
båtar	Active
arrogante	None
profilerades	Passive
maximala	None
pausade	Active
härliga	None
turnering	None
utrikesministern	None
ratades	Passive
vicka	Active
inträffar	Active
anställts	Passive
riksledningen	None
besveks	Passive
siktats	Passive
vridits	Passive
symbolismen	None
proklamerade	Active
krukorna	None
skämmas	Active
bunken	None
krackelera	Active
slev	None
förföra	Active
målat	Active
blyge	None
undertecknat	Active
efterfrågat	Active
kunskapsutvecklingen	None
ökats	Passive
konstituerade	Active
emulerar	Active
reproducerar	Active
demonstrera	Active
bekymrade	Active
cypresser	None
åtföljas	Passive
kinesen	None
överklaga	Active
diffunderar	Active
armbågsbenet	None
zappa	Active
knivskurit	Active
brandväggar	None
inriktats	Passive
inventerar	Active
mjölnaren	None
tangenterades	Passive
vilseleda	Active
narkotika	None
agnar	Active
invaderar	Active
strålar	Active
rusta	Active
avgjordes	Passive
transkriberat	Active
verifierar	Active
fixa	Active
formellare	None
avskeda	Active
konkursa	Active
reagerat	Active
hämnats	Active
tigits	Passive
arbeta	Active
klår	Active
frisörers	None
planterade	Active
meditera	Active
mätas	Passive
avsatts	Passive
detekterat	Active
prioriterar	Active
vilseledde	Active
plagierade	Active
fjättra	Active
underrättat	Active
påminnas	Passive
ledarsidors	None
stavelseväxlings	None
chilenska	None
additions	None
associerades	Passive
doldes	Passive
dekryptera	Active
rehabiliterades	Passive
vaktar	Active
spärrat	Active
fallerar	Active
tilldelat	Active
gratulerade	Active
gynnad	None
farsa	None
hämtade	Active
särskilja	Active
nottecken	None
förmedlades	Passive
blesserat	Active
censurerat	Active
frekvenser	None
förfrågan	None
förhörs	Passive
ratificerats	Passive
lånats	Passive
tonad	None
träsken	None
illustrerat	Active
distraherad	None
världskrigens	None
radikalt	None
komponerades	Passive
fjättrats	Passive
cilierna	None
överdrivits	Passive
rymts	Passive
kommunistiskt	None
duplicera	Active
narrar	Active
tonåring	None
förgätit	Active
mexikanskors	None
helsvenskt	None
kosmonaut	None
bestod	Active
adopterat	Active
organiserades	Passive
komplettera	Active
luffare	None
slopade	Active
sponsrats	Passive
lindades	Passive
höljts	Passive
reagera	Active
röstsiffras	None
roades	Passive
uppräknar	Active
forcerade	Active
anmärker	Active
uttalat	Active
lärosäte	None
besegrat	Active
kategoriserats	Passive
recipiera	Active
avböja	Active
barrikaderande	None
knegats	Passive
övervarade	Active
hyperventilerat	Active
siktade	Active
introducerades	Passive
tömmer	Active
angripit	Active
oförutsedd	None
erkänts	Passive
dividerades	Passive
kursiverat	Active
tillgodogör	Active
dansbana	None
redbara	None
oscillations	None
mörker	None
förtvivlar	Active
skreks	Passive
omorganiserar	Active
laddades	Passive
vandaliserar	Active
förefalla	Active
avrättar	Active
numrerar	Active
raspats	Passive
bogserats	Passive
förförts	Passive
automatiserade	Active
atombombats	Passive
frikyrkans	None
inträffades	Passive
indikerar	Active
meteorologiska	None
infogades	Passive
tegar	None
konkurrerat	Active
förhördes	Passive
diskussionsdeltagarna	None
hantera	Active
positionerat	Active
gisslade	Active
returnerade	Active
packade	Active
utfärdats	Passive
påstår	Active
packa	Active
brytare	None
reciterat	Active
pruta	Active
uddarna	None
medverkar	Active
krypterat	Active
härden	None
upprepad	None
använda	Active
adventskalender	None
atollens	None
säkerställer	Active
förtrycktes	Passive
bränner	Active
erbjuder	Active
återhämtade	Active
hejades	Passive
harklar	Active
uppdaterar	Active
flipperspelet	None
tygla	Active
skådar	Active
kortslut	None
sorterar	Active
lakar	Active
plitats	Passive
bereddes	Passive
gallimatias	None
rättmätigt	None
radergummi	None
komposterar	Active
säkerställdes	Passive
knarkaren	None
utforskade	Active
slippa	Active
dån	None
trycka	Active
avled	Active
mobiltelefonerna	None
förvägrades	Passive
crawla	Active
skulpterat	Active
vankats	Passive
beröras	Passive
blicka	Active
alkoven	None
utkom	Active
moderkort	None
återförsäkrat	Active
formaliserar	Active
härmar	Active
manipulerade	Active
resocialisera	Active
grundlägger	Active
släplina	None
insinuerar	Active
köpmannens	None
fortfar	Active
inriktat	Active
förmörkar	Active
advocerat	Active
stoltserat	Active
transformerat	Active
släpa	Active
kortsluts	Passive
favoriserats	Passive
bagar	None
förhasta	Active
koordinatens	None
gnags	Passive
förvaltar	Active
byggas	Passive
samordnat	Active
avgöra	Active
dukar	Active
sabbat	Active
missgärnings	None
täppte	Active
konverterats	Passive
postulerade	Active
vifta	Active
motorväg	None
faktoriserats	Passive
ordnar	Active
förmörkade	Active
harpist	None
fiska	Active
bedömde	Active
drunknar	Active
förkastade	Active
konverserats	Passive
allmänbildningen	None
attackerats	Passive
brigad	None
vakta	Active
stelnad	None
konsulterades	Passive
behandlad	None
tebladen	None
cylinders	None
omfattningen	None
byta	Active
hängande	None
blottades	Passive
överträda	Active
jordade	Active
makrillen	None
nedvärdera	Active
spräcktes	Passive
disken	None
bifoga	Active
ruvat	Active
erkänns	Passive
realiserade	Active
skymma	Active
modifiera	Active
dvärgpudel	None
förkroppsligande	None
legitimera	Active
ferromagnetismens	None
tenderar	Active
expertis	None
tycka	Active
pubs	None
implicera	Active
refererats	Passive
brallan	None
växeltungas	None
testa	Active
isolerades	Passive
vant	Active
skördar	Active
rimlig	None
missbrukats	Passive
årtusendet	None
förhindrade	Active
profilerade	Active
nysta	Active
övad	None
vänsterextrem	None
syns	Active
patrullerna	None
deklarerar	Active
överblicka	Active
överbryggade	Active
specificerat	Active
bräkt	Active
flögs	Passive
lagrats	Passive
besökta	None
roterats	Passive
pressar	Active
migrera	Active
utvecklade	Active
licensierat	Active
regnskog	None
dekreterar	Active
fortifikationers	None
googlande	None
riskera	Active
godkänt	Active
halvera	Active
ratade	Active
porträtterat	Active
identifierat	Active
emigrera	Active
adjungerades	Passive
läser	Active
ackompanjerar	Active
bromsar	Active
anslogs	Passive
utsändes	Passive
ritades	Passive
diskvalificera	Active
övertygat	Active
rekryter	None
improviserar	Active
emirer	None
fastnar	Active
råda	Active
tunnlar	Active
inväntade	Active
inverterat	Active
enkelbeckasinen	None
spionerade	Active
graderade	Active
skyldrat	Active
ankomne	None
fullgöras	Passive
dungens	None
förverkligar	Active
drogers	None
eskalera	Active
tillväxa	Active
massproducera	Active
bombarderade	Active
halverade	Active
utspelades	Passive
kantrade	Active
krönas	Passive
desarmerade	Active
klåtts	Passive
ramade	Active
tröstat	Active
underlättade	Active
tornugglas	None
dekretera	Active
betäckt	Active
uteslutits	Passive
bedrivits	Passive
aducerade	Active
nöjdes	Passive
saboterades	Passive
återlämnades	Passive
halsats	Passive
återfann	Active
undervisat	Active
cichliders	None
fal	None
recenserar	Active
skyddar	Active
regionen	None
äspings	None
bulgariska	None
fuskats	Passive
uppskattats	Passive
uppföra	Active
cembalisternas	None
blundade	Active
gry	Active
inventerats	Passive
experimenterar	Active
bildliga	None
gnagt	Active
drabbat	Active
schematiska	None
verka	Active
åtnjuta	Active
hospital	None
datafältets	None
ogudaktiga	None
maximera	Active
gångarternas	None
förvandla	Active
mediterat	Active
utgöra	Active
rödbetor	None
låses	Passive
översättarna	None
accepterats	Passive
vittnat	Active
skörda	Active
stocks	None
fira	Active
kombinerar	Active
befolka	Active
omvandlats	Passive
seedats	Passive
tillträtt	Active
behaga	Active
knarkades	Passive
utgå	Active
hårdna	Active
förtycka	Active
avlett	Active
duktigaste	None
diskmaskinen	None
försänker	Active
uppmanar	Active
fixerades	Passive
miliserna	None
kutar	Active
slutne	None
vuxet	None
företagsledares	None
biträda	Active
erinrats	Passive
omstrukturerar	Active
ser	Active
särskiljas	Passive
ordnats	Passive
leksandlådor	None
plantageägaren	None
blecket	None
involverar	Active
tillgängliggjordes	Passive
renderades	Passive
distribuerade	Active
lotsa	Active
uttryckas	Passive
önska	Active
vrider	Active
kännetecknats	Passive
fodrade	Active
barrikaderar	Active
giftets	None
avkodat	Active
neurotoxikolog	None
underrättelsetjänstens	None
subventionerar	Active
impades	Passive
engagerats	Passive
berika	Active
förestod	Active
folkbokföra	Active
sitt	None
myrorna	None
bokstavs	None
finansierat	Active
förkunnats	Passive
narra	Active
toppade	Active
beaktats	Passive
gränsa	Active
anmärkts	Passive
begår	Active
uttryckte	Active
uppställer	Active
realismen	None
utsändas	Passive
diets	None
glöms	Passive
bataljonerna	None
ecuadorianska	None
tjuvlyssnade	Active
armhålorna	None
framåtskrida	Active
lindra	Active
avslutats	Passive
förbehålls	Passive
kortad	None
bojkotta	Active
övergått	Active
divergerade	Active
blöja	None
försvann	Active
säkerställt	Active
missbruket	None
ärvde	Active
urnordiska	None
silvermyntet	None
härbärgerades	Passive
passerades	Passive
applicerade	Active
tonats	Passive
insåg	Active
adressera	Active
adopterar	Active
hal	None
bistår	Active
containrar	None
impat	Active
utställas	Passive
verkningsgrad	None
miljöminister	None
nyanserar	Active
ventilerade	Active
spanjorskornas	None
häftat	Active
intressesfär	None
sovra	Active
subventionerade	Active
krossar	Active
infört	Active
anordna	Active
hittade	Active
bakade	None
utformande	None
stralat	Active
erfaret	None
porträttera	Active
förtövats	Passive
redigera	Active
sökning	None
ursprungskällas	None
problematiserades	Passive
kontrakterade	Active
adjungerats	Passive
donerats	Passive
elektromagnetism	None
protesterades	Passive
utvidgat	Active
resulterar	Active
handlagts	Passive
gendrivas	Passive
duetter	None
rutschbana	None
enar	Active
åskådliggöra	Active
hiar	Active
polerar	Active
bifallits	Passive
pekats	Passive
sjukna	Active
knyter	Active
valdes	Passive
patrullerats	Passive
inkorporerade	Active
sårat	Active
radons	None
dyker	Active
trivs	Active
klängde	Active
imiterade	Active
antecknades	Passive
fortfara	Active
minska	Active
kortades	Passive
reklamerades	Passive
anvisades	Passive
slagrutan	None
centrerat	Active
mötte	Active
förlängdes	Passive
köps	Passive
imponerar	Active
colombianen	None
examensarbeten	None
tortera	Active
designerna	None
förenklade	Active
östes	Passive
gendriva	Active
aktivisterna	None
bestods	Passive
syrgasens	None
jagades	Passive
katedralskolans	None
vårda	Active
dubbelklickades	Passive
handleddes	Passive
förväntades	Passive
fockar	Active
tjollrar	Active
täpper	Active
presterar	Active
dräpande	None
fångade	Active
återkommande	None
seglades	Passive
utfört	Active
industriland	None
unionsrättsakter	None
sport	Active
magrare	None
plagierat	Active
sålde	Active
infektera	Active
legat	Active
uppvakta	Active
dominerande	None
dräng	None
vitnar	Active
journalfilmens	None
förbinder	Active
redigeringsläges	None
krossade	Active
lämnades	Passive
yttra	Active
infekterar	Active
adresserat	Active
vaxades	Passive
interagerat	Active
reparerades	Passive
tryckts	Passive
sparkats	Passive
davnade	Active
vaskat	Active
sparkade	Active
gena	Active
paschor	None
studerade	Active
förklarad	None
inrättat	Active
utlösts	Passive
perronger	None
ackumulatorns	None
stalla	Active
annullerat	Active
pilat	Active
åstadkommits	Passive
bortsåg	Active
motsäga	Active
devalverat	Active
avrättat	Active
argaste	None
tolererades	Passive
organister	None
stympat	Active
recipierat	Active
migrationsministerns	None
inflyter	Active
bromsades	Passive
järnsparv	None
hissa	Active
sölar	Active
frälses	Passive
profilera	Active
knöt	Active
möhippa	None
författats	Passive
rata	Active
gondoler	None
optimerade	Active
specificerar	Active
underrättar	Active
påståtts	Passive
systematiserades	Passive
fodrar	Active
ångra	Active
vederböra	Active
föregick	Active
följts	Passive
spillt	Active
finländaren	None
gisslats	Passive
divergerar	Active
markerades	Passive
gråta	Active
fanorna	None
problematiserat	Active
blesserades	Passive
svimmade	Active
ålar	None
bult	None
olikheten	None
landat	Active
behålla	Active
firades	Passive
undergrävs	Passive
målats	Passive
reassurerat	Active
fjärtars	None
destillerar	Active
svavelsyra	None
etsar	Active
varmaste	None
betecknats	Passive
bemödade	Active
släckte	Active
subventionerades	Passive
uppställas	Passive
slagsmålen	None
asbestens	None
arbetande	None
behållas	Passive
ystats	Passive
anställde	Active
exploaterade	Active
lagat	Active
hejdade	Active
inträffande	None
länsrätten	None
konventionens	None
säkert	None
modden	None
skörbjuggs	None
vållades	Passive
prenumererade	Active
protesterat	Active
reducerat	Active
cannabis	None
japanskt	None
saka	Active
sädesledaren	None
slipat	Active
lödas	Passive
infogats	Passive
nanometer	None
upptäck	None
övergick	Active
försöks	Passive
mata	Active
gotiskan	None
marinbiologiska	None
grundlagt	Active
husfolk	None
matade	Active
beboeliga	None
monterade	Active
åklagar	Active
krediterade	Active
subbens	None
justerar	Active
landar	Active
avletts	Passive
åtfölja	Active
grunka	None
vidhäftat	Active
släcktes	Passive
kompilera	Active
handlett	Active
underlig	None
motsagt	Active
kapa	Active
frågeord	None
regla	Active
rövarens	None
tillägnats	Passive
skolkamrat	None
överenskommit	Active
fruktämnen	None
trampoliner	None
programmerats	Passive
tänka	Active
vittnade	Active
legitimerades	Passive
jäses	Passive
förläggs	Passive
rubbade	Active
skottarnas	None
streckats	Passive
postulerades	Passive
undervisar	Active
släckt	Active
ämnats	Passive
snyggaste	None
regerats	Passive
värdelös	None
tjatar	Active
överleva	Active
omdirigerades	Passive
returnerat	Active
splittrats	Passive
brädspelet	None
dubbelklickade	Active
ångpannorna	None
pussar	Active
snabbar	Active
dukade	Active
generaliserade	Active
kväver	Active
extrempunkters	None
vackraste	None
spräcka	Active
helige	None
pippats	Passive
avsätts	Passive
nattklubb	None
nystade	Active
skriks	Passive
bevisar	Active
distraherade	Active
förvara	Active
mäklar	Active
antecknat	Active
tona	Active
symboliserar	Active
ifrågasätter	Active
överdrivit	Active
baksmälla	None
epitetet	None
fermenterade	Active
bedrevs	Passive
statsbudgeten	None
obduktioner	None
interkulturell	None
anlänt	Active
verifierade	Active
rättstavningarna	None
påvisade	Active
våga	Active
integrerades	Passive
redigerat	Active
öppnats	Passive
mellanrum	None
skeppsredare	None
dikterat	Active
sexorna	None
slaktat	Active
anlagts	Passive
formulerade	Active
förmått	Active
försynens	None
snackar	Active
misshandlats	Passive
eftersträvat	Active
utgiftens	None
pianist	None
konservera	Active
prisa	Active
positron	None
detekterar	Active
fraserat	Active
fermenterar	Active
skräddarna	None
barkar	Active
läsa	Active
folkminne	None
citerades	Passive
befordra	Active
hänvisar	Active
tragedierna	None
medlar	Active
engelsklärarna	None
apostlarna	None
fotnot	None
missar	Active
mönsterkort	None
sjöngs	Passive
avannonserats	Passive
lunginflammationen	None
matats	Passive
provat	Active
varslat	Active
standardiserar	Active
byggande	None
ackvisitionen	None
bärande	None
kalva	Active
bajsar	Active
återkommit	Active
rodnar	Active
täcket	None
gäspa	Active
övervakats	Passive
bröats	Passive
köa	Active
sabbar	Active
spöade	Active
bandades	Passive
placerade	Active
antytt	Active
dokumenterats	Passive
förteg	Active
omdefinierat	Active
kommutatorer	None
omstrukturera	Active
deporterats	Passive
stämpeln	None
djurskyddslag	None
fallna	None
skedde	Active
artikulera	Active
färgade	Active
värkte	Active
tangenterar	Active
fiskades	Passive
spisade	Active
underrubrikerna	None
kattsand	None
registrerade	Active
kartograferna	None
fantastisk	None
debuterade	Active
åklagats	Passive
vägledde	Active
överansträngande	None
gotiskans	None
bedrövade	Active
konstmuseums	None
vaxat	Active
hastat	Active
termerna	None
uppnåddes	Passive
undvikas	Passive
förlitade	Active
sveps	Passive
tillsatt	Active
krediterande	None
gillade	Active
röns	None
kvaddades	Passive
förfar	Active
systematisera	Active
naturlig	None
laddningen	None
inspekterades	Passive
prioritera	Active
tillbringade	Active
hjärtligt	None
kommunikation	None
oberoendet	None
gestalta	Active
inkluderar	Active
mobilisering	None
mistes	Passive
överskuggats	Passive
bräkas	Passive
indikerades	Passive
pussande	None
skarvat	Active
löna	Active
oroade	Active
regeringsform	None
antecknande	None
säkra	Active
törs	Active
marknadsfört	Active
samlat	Active
protesterar	Active
resistor	None
uppföljdes	Passive
girerade	Active
katoliken	None
stenar	Active
anklagades	Passive
samordna	Active
doktrinernas	None
begärs	Passive
fagottistens	None
prognosticera	Active
fokuserade	Active
ansträngdes	Passive
kolliderade	Active
fornsvenska	None
begränsats	Passive
knyta	Active
tvekamp	None
överförde	Active
övningsköras	Passive
reciterade	Active
nollställningarna	None
kristnats	Passive
fixar	Active
halshuggits	Passive
färgades	Passive
skymtar	Active
musicerat	Active
ritade	Active
sköter	Active
befriade	Active
inägor	None
dopplereffekten	None
plog	None
hämmade	Active
gränsat	Active
vinkelparentes	None
akta	Active
sammanslöts	Passive
intresserade	Active
elektriske	None
flädermärg	None
utvecklades	Passive
extrapolerades	Passive
ansluter	Active
fortkörningar	None
lönade	Active
färdats	Active
antyda	Active
konsulterar	Active
borrats	Passive
spelarens	None
invandra	Active
purt	None
spikat	Active
spö	None
europiets	None
försänkas	Passive
showerna	None
ömma	None
klistrat	Active
valsverk	None
kanna	None
börja	Active
försegla	Active
reformatorernas	None
postapokalyptisk	None
näcka	Active
avlägsna	Active
förvarade	Active
staplar	Active
allittererat	Active
centralafrikans	None
förmådde	Active
uppståndelsens	None
lindade	Active
lösningars	None
klistrades	Passive
blänger	Active
lyser	Active
förvirrat	Active
genererande	None
tillgängliggjort	Active
returtangent	None
allittererade	Active
bläddra	Active
skyhög	None
varierats	Passive
försagt	Active
bråkade	Active
ordna	Active
gapat	Active
korkar	Active
graderar	Active
förgäter	Active
kapsejsats	Passive
wikifierade	Active
påpekats	Passive
behärskade	Active
fjärta	Active
karaktäriserar	Active
lämpar	Active
negligera	Active
funkar	Active
matematikers	None
förrådde	Active
undveks	Passive
blickar	Active
fungera	Active
täppas	Passive
förhalats	Passive
kräks	Active
muggen	None
klå	Active
föreslå	Active
praktiserat	Active
antecknade	Active
ljuda	Active
mörkar	Active
strött	Active
träskons	None
divergensen	None
relaterades	Passive
ty	Active
tiotal	None
killings	None
råna	Active
straffar	Active
nåldyna	None
utför	Active
knarka	Active
tvivlar	Active
lida	Active
fälls	None
tryckare	None
kvacksalvarnas	None
förföljs	Passive
litar	Active
eke	None
automatisera	Active
tillhör	Active
missades	Passive
mappat	Active
rökte	Active
mappades	Passive
motsvarar	Active
cynism	None
täljarens	None
efterfrågar	Active
detonera	Active
repeterar	Active
identifierade	Active
fördröjt	Active
förete	Active
utforskat	Active
botats	Passive
neutraliserar	Active
sammanfatta	Active
blockerats	Passive
svalna	Active
fördärvade	Active
avlöser	Active
uppmärksammande	None
mineralerna	None
sammansluter	Active
extraherar	Active
förlåtas	Passive
skottat	Active
prövats	Passive
rävsaxar	None
omformulerat	Active
debuterat	Active
skulpterade	Active
gjorthål	Active
disputerat	Active
nåddes	Passive
hängas	Passive
meters	None
transkriberad	None
kontinentalplattornas	None
behölls	Passive
erinra	Active
vadar	Active
dominerats	Passive
log	Active
försäljs	Passive
artbestämde	Active
ventilerat	Active
beteckningen	None
orkan	None
dabbat	Active
aktiv	None
stambanorna	None
kulminera	Active
colombianskt	None
blända	Active
kollats	Passive
statsledning	None
svek	Active
vinterdäck	None
fornengelskans	None
föreslår	Active
googlat	Active
kammarrättsassessorerna	None
gratulera	Active
snedstreck	None
observerade	Active
kitschiga	None
oroad	None
passat	Active
ess	None
sädesuttömningens	None
levererades	Passive
förutsågs	Passive
trutar	None
städades	Passive
optimerats	Passive
hystes	Passive
utövningen	None
arenors	None
okänt	None
näsborrarna	None
förnya	Active
grannare	None
nätverkar	Active
fraserades	Passive
bifaller	Active
acklamations	None
båtat	Active
uppföljs	Passive
förkläden	None
missa	Active
packat	Active
genomfördes	Passive
lagstiftade	Active
kramar	Active
bläddrade	Active
omoraliskt	None
bör	Active
strukturerar	Active
repatrierats	Passive
ökar	Active
sucka	Active
möjligaste	None
kirrade	Active
invänder	Active
dammluckors	None
precisera	Active
samhällsvetenskaper	None
populariserat	Active
undviks	Passive
förstod	Active
genat	Active
översattes	Passive
ultraljud	None
förestå	Active
socialfondens	None
dalade	Active
ursinniga	None
ordnade	Active
effektivisera	Active
konstaterade	Active
ansträngs	Passive
fiasko	None
överklagats	Passive
riskerade	Active
anslutande	None
semifinalerna	None
anställs	Passive
nomineringarna	None
dominera	Active
deklarera	Active
refererat	Active
jagande	None
plundrat	Active
utnyttjades	Passive
nästet	None
bandade	Active
seglats	Passive
exotisk	None
utredde	Active
vittnande	None
minerades	Passive
smyga	Active
serbiske	None
grät	Active
kvävdes	Passive
sovsäck	None
pennvässare	None
absorberats	Passive
föregicks	Passive
bestämt	Active
distribuerat	Active
trumhinnor	None
trollat	Active
byts	Passive
utgiftsområdet	None
yttrar	Active
återanvänt	Active
påbjudit	Active
anpassa	Active
pratade	Active
drabbats	Passive
skrutit	Active
återuppbygger	Active
passerats	Passive
gifter	Active
samarbeta	Active
titulera	Active
höstat	Active
blidkar	Active
pocketarnas	None
amylasers	None
bilagt	Active
eufemismer	None
spendera	Active
överbryggat	Active
övergåtts	Passive
avlöstes	Passive
eggat	Active
övernattande	None
offentliggöras	Passive
blänker	Active
raspades	Passive
förordnats	Passive
toppats	Passive
axioms	None
tonsatt	Active
tjugofjärdedel	None
formaterade	Active
veckoslutet	None
flugit	Active
förhalar	Active
svarar	Active
spådde	Active
belade	Active
kanslichefens	None
tillhörande	None
gråten	None
polerats	Passive
vittnenas	None
önskelistan	None
missionerat	Active
avfyrade	Active
dröjde	Active
utrymde	Active
låsas	Passive
brotscharnas	None
avböjer	Active
skjutits	Passive
syndade	Active
exekverats	Passive
sprängt	Active
övervaka	Active
grundämnena	None
mättar	Active
överansträngas	Passive
sågade	Active
promenerar	Active
förlagts	Passive
afghanens	None
fullföljer	Active
upptäckt	Active
spärrats	Passive
begynte	Active
skrämmas	Passive
motsägelser	None
inspirerat	Active
differentierat	Active
återlämnade	Active
väldige	None
oxen	None
attesters	None
säckpipa	None
bedriver	Active
betjänat	Active
miniatyriserades	Passive
dödat	Active
anställer	Active
misstyckte	Active
arresterades	Passive
laka	Active
höljde	Active
föreskrifterna	None
konfiskerar	Active
vitmenat	Active
utbrista	Active
övervarades	Passive
korsfästas	Passive
grannsämjan	None
citadellet	None
optimistiska	None
tyglats	Passive
sammanfattat	Active
virkats	Passive
återuppbyggde	Active
vitaktigt	None
bangar	Active
involverat	Active
finansernas	None
anmäld	None
refektorium	None
domstolarnas	None
uppställs	Passive
klistrar	Active
säkrade	Active
hyfsa	Active
nota	None
sjuttondedelarna	None
jäktade	Active
förkunnades	Passive
kulturpropositioners	None
försvarats	Passive
nystats	Passive
ordar	Active
applicerats	Passive
rätvinklig	None
hemvärns	None
kammarrättsråden	None
uteslutit	Active
vickar	Active
generaliserar	Active
gendrivits	Passive
gastat	Active
livegna	None
publikationsbyrå	None
ruttnade	Active
smyckar	Active
fogat	Active
federationens	None
krigar	Active
vederläggs	Passive
katedralskolorna	None
föraktade	Active
halshöggs	Passive
mörtar	None
dubblerats	Passive
anslutna	None
upprättat	Active
spisat	Active
göda	Active
vansinnigheters	None
halverat	Active
utformade	Active
riggades	Passive
ombröts	Passive
abiogenesens	None
justis	None
sprängmedel	None
dölja	Active
testade	Active
lev	None
kursiverar	Active
redaren	None
fräs	None
eliminerades	Passive
genar	Active
snöa	Active
kräftor	None
falbjuder	Active
nedsättas	Passive
dränerats	Passive
diskades	Passive
betonar	Active
tålde	Active
odlats	Passive
krämen	None
redds	None
företrädd	None
budbärarnas	None
hysts	Passive
bekänts	Passive
resocialiserade	Active
avtalar	Active
terroristgrupp	None
värkts	Passive
integral	None
tillämpades	Passive
sjungas	Passive
sammansluta	Active
ansvarat	Active
rappad	None
surra	Active
tillgängliggörs	Passive
civilt	None
bombarderat	Active
provocera	Active
synda	Active
funktionslisternas	None
försvarsministern	None
ratar	Active
strukturerades	Passive
mysteriet	None
kabinettssekreterare	None
kvickna	Active
definierade	Active
utrustades	Passive
breda	Active
erkänner	Active
beskrev	Active
beklaga	Active
hårddiskens	None
spenat	None
förhandsgranskningen	None
immigrera	Active
rapporterats	Passive
hända	Active
urinerade	Active
patentera	Active
fordrar	Active
emigrerades	Passive
centrerats	Passive
rimfrost	None
jordades	Passive
liknade	Active
bekänna	Active
kugge	None
slukat	Active
bosätta	Active
altruist	None
avlöste	Active
befinnas	Passive
överblickat	Active
kontroversiellt	None
adoptivbarnens	None
pastor	None
ideologi	None
svalnande	None
besudlat	Active
infiltrerades	Passive
rasar	Active
sultanats	None
meta	Active
stammar	Active
bebodde	Active
kvalificerade	Active
interfererade	Active
spöregnat	Active
ladugårdarna	None
betvivlat	Active
räd	None
växlats	Passive
förberett	Active
sanerat	Active
slaget	None
tingsrättens	None
hävs	Passive
bunta	Active
cyklade	Active
bolagiserats	Passive
irriterades	Passive
presenningar	None
skatteutskott	None
konfiskerats	Passive
inverkade	Active
valrossen	None
befordrar	Active
snabbkaffe	None
bättrat	Active
desillusionerats	Passive
expanderar	Active
konfronterades	Passive
undkomma	Active
jämförde	Active
erövrade	Active
inbegripet	None
approximerar	Active
förråder	Active
externa	None
returen	None
elektroskop	None
niger	Active
guvernörens	None
gick	Active
liens	None
straffat	Active
trasmattor	None
inverterbara	None
barnvisornas	None
kläcktes	Passive
veterinärmedicinsk	None
stämgafflar	None
dialogruta	None
digitaliserade	Active
gosar	Active
ökat	Active
minerat	Active
hajat	Active
klädesplaggets	None
rollistorna	None
realiserats	Passive
ställtupp	Active
beväpnades	Passive
rena	Active
sandstormars	None
styv	None
förvaltad	None
utövat	Active
svepts	Passive
sikta	Active
hanterar	Active
predikade	Active
tvättstället	None
stavar	Active
syran	None
normaliserades	Passive
anordnats	Passive
inrättade	Active
alkoholist	None
urnordiskt	None
betvivla	Active
ombryter	Active
ättföljden	None
defragmenterats	Passive
stimulerats	Passive
lejd	None
kolliderar	Active
upptäcktsresa	None
elakare	None
senatorernas	None
eskorterade	Active
intelligensen	None
förordnat	Active
beaktandena	None
dikterades	Passive
hysa	Active
graderats	Passive
grupperats	Passive
stimmen	None
diskvalificerar	Active
misstroende	None
nederländskan	None
manövrerades	Passive
intervenerande	None
buntat	Active
inträffats	Passive
framställts	Passive
sekundvisare	None
hedra	Active
missbrukades	Passive
urskiljer	Active
underhållits	Passive
plagiera	Active
överklagade	Active
förkorta	Active
förstärkte	Active
lockade	Active
transporterat	Active
dogmatikens	None
celldelningen	None
bekostat	Active
avundsjuka	None
benämns	Passive
renats	Passive
positionerar	Active
behöva	Active
lejdes	Passive
svarades	Passive
bakslaget	None
konfiskerades	Passive
köar	Active
undrade	Active
svalnade	Active
värna	Active
tvivlat	Active
såldes	Passive
absolute	None
radian	None
orienterade	Active
spåra	Active
försvarshögskolans	None
konsulterats	Passive
katalogisera	Active
kopplat	Active
stämplar	Active
gengångare	None
gupp	None
utredas	Passive
urinoars	None
delegerat	Active
bevara	Active
passar	Active
puttade	Active
tystnar	Active
påbjuden	None
sympatiserat	Active
vårdkase	None
amputerar	Active
dissekerade	Active
identifierades	Passive
medlemsstaten	None
snöat	Active
formulerat	Active
arkiverade	Active
reprisers	None
trygg	None
konstigare	None
erinrar	Active
våglängden	None
förbannar	Active
skrek	Active
överansträngs	Passive
singlats	Passive
Laplaceoperatorn	None
upptäckts	Passive
kallnade	Active
sågverk	None
överförs	Passive
angått	Active
likar	None
postar	Active
försvarslinje	None
grydde	Active
stavades	Passive
anslöt	Active
nedvärderade	Active
skrattmås	None
sitter	Active
beskådades	Passive
attestera	Active
kvävs	Passive
finnas	Active
omfatta	Active
empatisk	None
tillägnat	Active
gummi	None
överraskar	Active
anslagit	Active
föranlett	Active
anmälts	Passive
grånar	Active
tatuerar	Active
desarmerades	Passive
ackorderade	Active
pensionerats	Passive
grodans	None
åstadkommas	Passive
ordnat	Active
hinta	Active
glöm	None
stångens	None
stöts	Passive
förbehölls	Passive
uttrycker	Active
varierat	Active
kärade	Active
redogjordes	Passive
anpassade	Active
upprättades	Passive
inspirerad	None
förpliktelser	None
ersatt	Active
kantinen	None
övertygar	Active
gissades	Passive
komponerade	Active
liknande	None
etablera	Active
värmdes	Passive
barkats	Passive
tappat	Active
alligatorer	None
spade	None
förenklar	Active
friar	Active
förfor	Active
partajat	Active
viftar	Active
finansierats	Passive
hajade	Active
fiken	None
bälte	None
flodvåg	None
begravningsplatsens	None
skrikit	Active
tjeckisk	None
sarkofag	None
flaken	None
efterfrågade	Active
gisslat	Active
pryglade	Active
putsar	Active
para	Active
krossa	Active
bemötas	Passive
krossades	Passive
remmars	None
darrat	Active
blattes	None
förmögne	None
dröjer	Active
bedriva	Active
spisats	Passive
förlagor	None
presterats	Passive
bekostats	Passive
sanna	None
åldrades	Active
diffunderat	Active
vägra	Active
skett	Active
konkurrerades	Passive
sockrar	Active
växellådan	None
uttrycks	Passive
recensera	Active
påminner	Active
sågar	Active
resegarantiernas	None
härbärgera	Active
improviserade	Active
pröjsa	Active
störa	Active
invandrar	Active
mitokondriens	None
hyvlar	Active
bojkotten	None
passerar	Active
bordlagts	Passive
sansade	Active
anlöptes	Passive
ljungs	None
videon	None
dividerat	Active
qvälja	Active
paketerade	Active
rättad	None
formade	Active
legeringen	None
enkelhets	None
googlade	Active
övervinns	Passive
skivbolaget	None
propagerar	Active
sjöfararnas	None
somnat	Active
klädda	None
talföljder	None
roterade	Active
förstärkts	Passive
beväpnad	None
furnera	Active
nämnt	Active
röjd	None
erkänt	Active
berömde	Active
vänja	Active
subtraherar	Active
W-bosonernas	None
fuska	Active
embryots	None
komponerar	Active
förkastat	Active
reviderats	Passive
musicerade	Active
konkretiserats	Passive
lokaliserat	Active
digitaliserades	Passive
hotade	Active
konserverade	Active
tillväxt	Active
argumenterades	Passive
splittrade	Active
stjälpas	Passive
övervakande	None
rebelliska	None
infördes	Passive
diskuterade	Active
ostbåge	None
etablerade	Active
knegade	Active
kungligt	None
tätorts	None
tigas	Passive
gira	Active
glasstrutens	None
startat	Active
förgjordes	Passive
fabrikat	None
underlättar	Active
altare	None
mena	Active
betygsätter	Active
redigeringskrigande	None
preciserade	Active
beställningsarbete	None
embarkerade	Active
konfronterats	Passive
jämnat	Active
redigeringskrigade	Active
sms:a	Active
gläder	Active
fiskats	Passive
missionerar	Active
välsignar	Active
kuskens	None
bihålorna	None
beaktat	Active
behagar	Active
skördades	Passive
komikers	None
förstärkaren	None
penetrerat	Active
orgel	None
upplöste	Active
serva	Active
konferensens	None
falsarium	None
sluka	Active
tryggast	None
telegrafstyrelsens	None
avades	Passive
blöda	Active
domprosts	None
grafiskt	None
approximerat	Active
relaterat	Active
räkning	None
stjäla	Active
förmåddes	Passive
sanda	Active
lösts	Passive
segelbåtens	None
upptäckte	Active
julsång	None
visste	Active
immaterialrätts	None
omkategoriserat	Active
clownfiskars	None
hejdats	Passive
initierat	Active
nedvärderar	Active
anlöpts	Passive
godhet	None
fixpunkterna	None
stila	Active
gift	Active
julgransplundringen	None
missuppfattar	Active
nobla	None
grundlade	Active
avgöras	Passive
köpas	Passive
ställtut	Active
kikar	Active
niga	Active
vurma	Active
återvinnas	Passive
ansa	Active
dubblerat	Active
hävdar	Active
rädits	Active
åhördes	Passive
chansat	Active
manteln	None
erhåller	Active
beskåda	Active
välkomnats	Passive
insjuknat	Active
teologernas	None
funderats	Passive
hämtat	Active
dala	Active
lyckt	None
signalerats	Passive
provades	Passive
svurits	Passive
biologer	None
vela	Active
fullföljas	Passive
insändare	None
förutsägelser	None
mogna	None
nobelt	None
neutronernas	None
diskad	None
förnyelse	None
kapat	Active
fortsätts	Passive
mördats	Passive
2-öringars	None
avancerar	Active
skyddade	Active
behärskat	Active
späckhuggaren	None
markerat	Active
sandar	Active
töms	Passive
bruksägaren	None
avbrutits	Passive
ockupationsstyrkorna	None
kärnkraftens	None
förstärks	Passive
återanvänder	Active
reflex	None
urinerar	Active
belyses	Passive
assurerar	Active
pastoratet	None
underskattats	Passive
kontinuerliga	None
förtiger	Active
ursinnigt	None
inventerades	Passive
agronomi	None
tyckt	Active
rita	Active
vädrade	Active
uppgå	Active
realisera	Active
urskiljande	None
tjurs	None
sjörövarnas	None
kandiderar	Active
komprimera	Active
musikliv	None
komprimerat	Active
amöbor	None
nuddar	Active
plundrande	None
dokumenterar	Active
dvärgpudels	None
mikrovågsugnarnas	None
rättades	Passive
baciller	None
kalendern	None
krönte	Active
livsfarlig	None
förutsägas	Passive
hämmat	Active
totalitära	None
avtala	Active
markstyrkans	None
reglat	Active
besudlar	Active
överskrids	Passive
belysas	Passive
farsan	None
samla	Active
klister	None
donar	Active
facetterades	Passive
bananskal	None
puttats	Passive
förbannades	Passive
samordnade	Active
hyperbeln	None
luftmassor	None
ändliga	None
möt	None
defenestrerat	Active
fälgarnas	None
föreskriver	Active
svämmatöver	Active
överlät	Active
clownen	None
fräsande	None
snart	None
lyor	None
rastens	None
qvicknade	Active
slömdade	Active
fokkat	Active
märkningar	None
kulminerat	Active
dialogens	None
översättas	Passive
diminutiver	None
kontraherar	Active
bekostar	Active
mobiliserats	Passive
rakare	None
trivts	Active
erkändes	Passive
går	Active
streckande	None
politikområden	None
utbildningsministrars	None
kontraherade	Active
boren	None
misshandlat	Active
indrivas	Passive
sett	Active
framföra	Active
anspelade	Active
kvävt	Active
syftade	Active
filades	Passive
beundrades	Passive
gärningsman	None
konspirerade	Active
postulerats	Passive
förkortat	Active
koordinater	None
påminde	Active
yra	None
friat	Active
kamma	Active
smycka	Active
tillsätts	Passive
kvitterat	Active
sponsrat	Active
titulerats	Passive
stings	Passive
anordnades	Passive
vräkas	Passive
papeln	None
menar	Active
logor	None
bearbetar	Active
kängan	None
gillat	Active
konsumerar	Active
uppställts	Passive
käpphästens	None
gnällt	Active
artär	None
backat	Active
överläts	Passive
fortsatt	Active
förfall	None
sårades	Passive
kontraherats	Passive
käbbel	None
absorbera	Active
släpptes	Passive
besvikit	Active
reparation	None
skådeplatsen	None
partistyrelsernas	None
återkommer	Active
förslår	Active
stegar	Active
underordnar	Active
meteor	None
benämnas	Passive
barra	Active
utrikesministerium	None
filnamnens	None
vaccinerats	Passive
utbilda	Active
gubben	None
chansa	Active
åhörs	Passive
monarkiernas	None
påverkat	Active
bokat	Active
underhålla	Active
bordsduk	None
militärstyrka	None
utnyttjats	Passive
sökas	Passive
bajsa	Active
intresserats	Passive
moroten	None
aktualisera	Active
metar	Active
offrats	Passive
daltar	Active
bearbetades	Passive
redigeringskrigar	Active
pingviner	None
symboliserats	Passive
skojat	Active
sälja	Active
vristernas	None
övervanns	Passive
självmordsbombaren	None
uteslutas	Passive
arkeologer	None
jäser	Active
lakat	Active
knacka	Active
fysiker	None
sandades	Passive
nöts	Passive
matfiskar	None
sände	Active
memen	None
parternas	None
kröns	Passive
näst	None
neutroner	None
låsts	Passive
belyst	Active
distribuera	Active
lånat	Active
kvantifierades	Passive
trakterna	None
återanvändes	Passive
haltade	Active
förtjänades	Passive
ifrågasattes	Passive
inverterats	Passive
stötas	Passive
sparrar	None
hyfsades	Passive
försäkrats	Passive
fackföreningsledare	None
legaliserades	Passive
hedrades	Passive
omfattats	Passive
köptes	Passive
sockrat	Active
stulits	Passive
bordades	Passive
spyr	Active
amfibie	None
förmedlade	Active
huserade	Active
hanterades	Passive
störd	None
överskrider	Active
knyckte	Active
numrera	Active
förnyar	Active
utbrustit	Active
beväpnats	Passive
skrinnarna	None
servera	Active
dårat	Active
krokodil	None
smidige	None
otjänliga	None
kikade	Active
besegrar	Active
lagstifta	Active
förhandsgranskades	Passive
terroriserade	Active
stamma	Active
vaktat	Active
kläms	None
författades	Passive
hangaren	None
wikifiera	Active
omstrukturerades	Passive
hopat	Active
ögonfransar	None
instruerade	Active
utövning	None
slopats	Passive
värmebehandlat	Active
klagat	Active
bakslag	None
talade	Active
trofasthet	None
rörlig	None
ordentlig	None
svärande	None
hajades	Passive
pullat	Active
dalkarl	None
erövrar	Active
konverterat	Active
fagotter	None
dubblerar	Active
skrikas	Passive
irritera	Active
avleda	Active
landmassor	None
favorisera	Active
tvivla	Active
brolägga	Active
kröner	Active
flicknamnet	None
syna	Active
ingått	Active
predikades	Passive
förgiftats	Passive
anordningar	None
accentuerats	Passive
erövra	Active
myggorna	None
stockholmsrimmets	None
försäkrade	Active
formatera	Active
förlängde	Active
hyf	None
påbjuds	Passive
beställdes	Passive
medmänniska	None
förgår	Active
råder	Active
pussade	Active
kinesades	Passive
tjockt	None
tendera	Active
framåtskred	Active
återhämta	Active
hoppats	Active
uppfylls	Passive
tillhöra	Active
exportvaran	None
legaliserats	Passive
stralade	Active
spekulerats	Passive
fruktats	Passive
tratt	None
samordnades	Passive
fortlöpte	Active
donat	Active
sudda	Active
kokades	Passive
återanvänds	Passive
betalades	Passive
uvar	None
jämställdhetsministern	None
skrinlägger	Active
omorganiserats	Passive
stärkelsen	None
dua	Active
ändrades	Passive
duktigt	None
behövde	Active
blomkrukor	None
terroriserats	Passive
lagrades	Passive
planterar	Active
övervakar	Active
bluffar	Active
rastades	Passive
klassiska	None
divergera	Active
fordrades	Passive
artbestämmer	Active
iranskas	None
satsa	Active
veterinärmedicin	None
käkarnas	None
stammat	Active
naturliga	None
varda	Active
begränsat	Active
dansade	Active
genomförde	Active
redovisat	Active
fattigdomens	None
kramades	Passive
nalkar	Active
fotograferats	Passive
förhållningarna	None
sprängde	Active
myglar	Active
ärvd	None
bekomma	Active
normerar	Active
kejsardöme	None
rappa	Active
klumparna	None
stannat	Active
spädde	Active
tydas	Passive
skeende	None
stimmet	None
kräkts	Active
stortå	None
roterades	Passive
överträdelsernas	None
spärrades	Passive
gått	Active
bedömdes	Passive
alanins	None
beskådar	Active
profeterat	Active
forcerar	Active
förstått	Active
skådade	Active
kojernas	None
urinera	Active
antiloperna	None
tillträtts	Passive
överväger	Active
bombarderades	Passive
adlade	Active
hårnålskurva	None
tatuerades	Passive
besegra	Active
normerat	Active
kommentarer	None
utsträckts	Passive
entledigats	Passive
redovisats	Passive
bläckpennorna	None
älskat	Active
stångat	Active
krediterats	Passive
skattat	Active
frälser	Active
olidlig	None
mestisers	None
adla	Active
fullbordats	Passive
utövades	Passive
räkna	Active
förklarades	Passive
åka	Active
bläddrar	Active
behövas	Passive
planken	None
medfört	Active
upprättandet	None
kondensera	Active
insinuerat	Active
härletts	Passive
knäpps	Passive
halshugga	Active
jävel	None
marknadsförs	Passive
hindrat	Active
ösregnat	Active
definierades	Passive
vaxa	Active
exponentiering	None
pysen	None
vederlagslös	None
behövd	None
fordrade	Active
generaliserat	Active
röjts	Passive
stimulerad	None
kvävas	Passive
avdragarna	None
överbefälhavaren	None
nallar	None
medfördes	Passive
svikas	Passive
klassificera	Active
destillerades	Passive
antikt	None
åsen	None
annullerade	Active
släcker	Active
knutits	Passive
genomsynliga	None
stirrar	Active
segra	Active
uppställa	Active
etablerats	Passive
patrullera	Active
klordioxid	None
aktats	Passive
börjar	Active
etiketterat	Active
underhållit	Active
plagierats	Passive
upprepar	Active
misshagades	Passive
examen	None
åskådats	Passive
brolagt	Active
utesluter	Active
dressingen	None
avbildar	Active
gynekolog	None
utsträcka	Active
tig	None
väntande	None
säkerställas	Passive
byggt	Active
begrep	Active
komplicerar	Active
koalitionsregeringar	None
projekterade	Active
gravera	Active
halverades	Passive
bagge	None
bekände	Active
sitta	Active
tiotals	None
förkortar	Active
stimulerar	Active
ester	None
grupperat	Active
konjunktiv	None
cirkulerade	Active
ansvarade	Active
förelegat	Active
symboliserades	Passive
rövats	Passive
förhudars	None
tärningarna	None
räknades	Passive
klagar	Active
förkortningarna	None
reducerats	Passive
kursiverade	Active
vidga	Active
blänkte	Active
rövades	Passive
porträtterats	Passive
begrundats	Passive
förfäktade	Active
rimligt	None
stiftar	Active
romandebutera	Active
påvisats	Passive
klarna	Active
föreslagit	Active
etablerades	Passive
projicerat	Active
författar	Active
hiade	Active
luktar	Active
inrättades	Passive
transponerats	Passive
ske	Active
tyste	None
arenas	None
tornistrarna	None
ignorerar	Active
skyddsängel	None
luffarna	None
bedårar	Active
portats	Passive
återfunnit	Active
anande	None
dräglet	None
jämtarna	None
kollidera	Active
missen	None
svartsjuka	None
vinkla	Active
koordinerade	Active
fastnat	Active
utnämnts	Passive
överlåts	Passive
automatiserat	Active
klusil	None
förtyckt	Active
spåddes	Passive
avfaller	Active
halvö	None
beskrivs	Passive
putsade	Active
reciterades	Passive
kantiner	None
begripas	Passive
stänkskärms	None
intervjuat	Active
karakterisera	Active
befria	Active
lyriskt	None
ursäktades	Passive
enhörningen	None
insisterade	Active
försänkt	Active
darrar	Active
besökas	Passive
marsvinen	None
krater	None
revbenen	None
calypsos	None
stympar	Active
posta	Active
begärdes	Passive
hota	Active
reproducerade	Active
skifttangenters	None
mima	Active
binariteter	None
disketterna	None
tyngs	Passive
avskrivne	None
titulerades	Passive
inspektörer	None
betäckts	Passive
jäktats	Passive
försörjde	Active
höljdes	Passive
metionin	None
kvarn	None
övervara	Active
gestaltat	Active
överskuggade	Active
bege	Active
dekorera	Active
samkört	Active
spanjoren	None
betvivlats	Passive
registrerades	Passive
strukturerade	Active
sarkofagerna	None
förfäktar	Active
betäckas	Passive
slevar	Active
vrida	Active
rikskronofogdars	None
skylldes	Passive
destillera	Active
öm	None
tidsålderns	None
wikipedianen	None
grånade	Active
postmoderna	None
återlämnats	Passive
kommunicerade	Active
ungdomsorganisationerna	None
färggradienten	None
beslutna	None
ugglor	None
finansminister	None
mördat	Active
skivbolagens	None
avbrytas	Passive
förtrycka	Active
svarvats	Passive
billig	None
kollade	Active
återvände	Active
sladdade	Active
överstår	Active
åsiktsregistrerats	Passive
synts	Active
lejt	Active
missat	Active
förstöra	Active
hejar	Active
kompenserat	Active
underminerade	Active
citronmeliss	None
rehabiliterat	Active
smederna	None
generalagents	None
påverkats	Passive
utrustade	Active
funka	Active
extraherats	Passive
repatrierar	Active
osat	Active
fickparkerat	Active
påbörjar	Active
tillåtit	Active
undersidor	None
publicerade	Active
hotar	Active
värkt	Active
kvitta	Active
ramades	Passive
vinterspelens	None
plustecken	None
pensionerar	Active
neutraliserats	Passive
ärvts	Passive
uträttat	Active
lättade	Active
oväntat	None
personbilar	None
svikit	Active
upplöser	Active
dirigerats	Passive
fundera	Active
garanterades	Passive
släppas	Passive
förfinar	Active
pratar	Active
wikifierats	Passive
berikades	Passive
exploderar	Active
kickades	Passive
redigerade	Active
pinks	None
glänsa	Active
överdriver	Active
skrämmer	Active
anmärkte	Active
förverkligat	Active
etikettera	Active
tågade	Active
allittererades	Passive
suckade	Active
stämplat	Active
står	Active
dokumenterat	Active
föregår	Active
beviljar	Active
förskjutas	Passive
skymdes	Passive
konkurrera	Active
fotograferade	Active
ruvade	Active
aktiverade	Active
krypterades	Passive
ångarna	None
sakat	Active
legera	Active
bemötte	Active
stjälper	Active
jämnade	Active
förtjänat	Active
kinesa	Active
mättat	Active
nedvärderat	Active
vistades	Active
tonsätta	Active
omvärderades	Passive
klargörs	Passive
formaterat	Active
ogärningsmans	None
biträtt	Active
ombrytas	Passive
redigeringskriga	Active
jättarna	None
stördes	Passive
dödade	Active
godkännas	Passive
havren	None
tävla	Active
annektera	Active
skickade	None
styvfars	None
hävdats	Passive
cirkulerat	Active
upplevs	Passive
tittades	Passive
stormakter	None
förväntats	Passive
deklarerat	Active
crawlar	Active
kirrats	Passive
prokrastinerat	Active
brittisk	None
prövade	Active
uppstår	Active
zebran	None
avstått	Active
högerjusterar	Active
spräckte	Active
färöiskan	None
inbegreps	Passive
algeriska	None
sno	Active
blodpudding	None
emigration	None
sårats	Passive
avrättade	Active
värdemängden	None
påvlig	None
pocketens	None
kortats	Passive
spekulerades	Passive
fragmentera	Active
accelererades	Passive
fodrades	Passive
kulspetspennan	None
klargjort	Active
streckade	Active
beduinerna	None
propagerades	Passive
glo	Active
spionerar	Active
matad	None
mörkret	None
accelererat	Active
gendrevs	Passive
tystar	Active
engagerat	Active
trollsländor	None
stark	None
kommerskollegiets	None
gondol	None
stockholmarna	None
sväras	Passive
låtits	Passive
etsats	Passive
samverka	Active
församlats	Passive
translations	None
strecka	Active
anrätta	Active
optimerades	Passive
förskjutits	Passive
otåligt	None
spelatupp	Active
absorberades	Passive
dårad	None
jämställdhetsminister	None
snabbat	Active
spalta	Active
observera	Active
landats	Passive
programmerar	Active
miniatyrisera	Active
häftigare	None
stympa	Active
invandrande	None
dalar	Active
framstå	Active
bårbärares	None
laddat	Active
renar	Active
kapitaliserade	Active
regisserade	Active
formulerades	Passive
evangelier	None
gerillans	None
nätverka	Active
stressar	Active
myste	Active
pressade	Active
förmedla	Active
påpeka	Active
portades	Passive
menat	Active
inventarium	None
anspelat	Active
avlägsnades	Passive
spräckt	Active
fruktans	None
ordnad	None
jox	None
presenterats	Passive
utrymmer	Active
diameter	None
förbinda	Active
röva	Active
gasbindor	None
vitna	Active
accelerera	Active
klorerats	Passive
åtföljde	Active
belönat	Active
patenterar	Active
serverar	Active
hindra	Active
diskretiserades	Passive
indiske	None
väntades	Passive
överföringarna	None
gulnat	Active
påbjöds	Passive
skeppat	Active
seglat	Active
förmörka	Active
engagerade	Active
aktualiserad	None
alverna	None
importerades	Passive
transaktion	None
uppmana	Active
tröt	Active
emulera	Active
speldosas	None
bosatte	Active
beställa	Active
ventilera	Active
erbjudit	Active
ankommer	Active
barberade	Active
blesserats	Passive
puta	Active
diffundera	Active
faktorisera	Active
verandas	None
isolerade	Active
likviderat	Active
messats	Passive
raderade	Active
massproducerades	Passive
återfanns	Passive
fångats	Passive
dissekera	Active
avbildat	Active
le	Active
navigerats	Passive
hissats	Passive
analyserades	Passive
jämställt	Active
språkat	Active
kommunicerat	Active
ändelserna	None
omprövar	Active
skötsel	None
vitt	None
osvensk	None
hårdnat	Active
dränerade	Active
gestaltades	Passive
onanerats	Passive
översetts	Passive
serverns	None
paketerat	Active
framställs	Passive
utväljer	Active
benämner	Active
unisont	None
förstörde	Active
grindar	None
dränerat	Active
dräpts	Passive
illustrerats	Passive
siar	Active
tyr	Active
utvecklingsarbete	None
figurera	Active
lyssnat	Active
infekterades	Passive
replikerar	Active
rättsskolorna	None
mötts	Passive
vattenmelon	None
blänkt	Active
spaden	None
frihetskämpe	None
bekymra	Active
tillbad	Active
gråtits	Passive
köat	Active
framträdde	Active
skatta	Active
kompromettera	Active
färdigheterna	None
summerat	Active
missförståtts	Passive
sökte	Active
besättas	Passive
försåldes	Passive
erkännandena	None
synar	Active
konsumerat	Active
förvarades	Passive
ångrats	Passive
förhöll	Active
korallers	None
bordlägga	Active
dammsugas	Passive
uppnår	Active
tredjeland	None
avhållit	Active
extraherade	Active
aktualiserade	Active
glittrade	Active
daterade	Active
besvuren	None
visselpipan	None
produktionerna	None
klått	Active
ordade	Active
avstava	Active
tänker	Active
skrämde	Active
uppnåtts	Passive
prickar	Active
pallplatsen	None
storkarna	None
stiga	Active
tunnlats	Passive
måla	Active
sakats	Passive
lästs	Passive
lanserat	Active
ångrade	Active
dövats	Passive
approximerades	Passive
myglats	Passive
sytt	Active
ponerat	Active
mimat	Active
detekterats	Passive
stjäls	Passive
tjogs	None
parkeringsgaraget	None
funktionsnedsättningar	None
seedar	Active
pippat	Active
grönaktigt	None
oboisterna	None
värdefullt	None
upphandlade	Active
återvänder	Active
flygande	None
lyrisk	None
blötts	Passive
förhalades	Passive
garanterar	Active
människonaturs	None
putsat	Active
klonerna	None
avtalats	Passive
cyklar	Active
neutralare	None
förutsåg	Active
balanserats	Passive
returnerats	Passive
vreds	Passive
klart	None
gummisnodden	None
regisserar	Active
guss	None
blottade	Active
gamle	None
kräktes	Active
applådera	Active
hjärnhalvan	None
bortsett	Active
avböjt	Active
underhölls	Passive
implementerats	Passive
missförstod	Active
promenera	Active
påvisat	Active
kramat	Active
publicerat	Active
kvittera	Active
kolonns	None
generat	Active
förakta	Active
gagnat	Active
finska	None
positionerades	Passive
jobbade	Active
immigrerades	Passive
debatterats	Passive
raserar	Active
järnmalmen	None
upphävde	Active
korkat	Active
vårtan	None
fosforsyran	None
förhandsgranska	Active
fånga	Active
gagnar	Active
upplever	Active
suttit	Active
överenskomma	Active
ruinerades	Passive
tillverkat	Active
framträda	Active
blinka	Active
diskretiserar	Active
hamstrade	Active
blesserar	Active
biträddes	Passive
kortslutning	None
jämställde	Active
förtryckt	Active
följer	Active
ackommoderades	Passive
musikgrupperna	None
rättfärdigat	Active
säkerställs	Passive
sia	Active
långsammast	None
vabbade	Active
tålmodig	None
baksätesförarna	None
sparkar	Active
återvinner	Active
konkursat	Active
lågtyska	None
snabbspolats	Passive
procentenheter	None
omstrukturerat	Active
avats	Passive
bohemen	None
imponera	Active
snickerierna	None
calypso	None
maskerades	Passive
renovera	Active
bekämpades	Passive
tillsattes	Passive
tvättbräda	None
rendera	Active
resistanser	None
pacemakern	None
fruktade	Active
hände	Active
märkas	Passive
betecknade	Active
framsteg	None
slappar	Active
opererar	Active
njutas	Passive
programvarans	None
utarmats	Passive
amputerats	Passive
observerades	Passive
vänjer	Active
tjänstgjorde	Active
konsoliderar	Active
upptäcker	Active
citera	Active
erfarit	Active
avvisades	Passive
aktualiserades	Passive
härbärgerade	Active
signerat	Active
orientera	Active
insett	Active
lättat	Active
misshagade	Active
tassar	Active
lönar	Active
suckar	Active
fostrets	None
massupplagornas	None
bedrövelsen	None
säkrades	Passive
heja	Active
kliniker	None
kaninen	None
importerar	Active
disks	None
dämpades	Passive
företräd	None
tonsätts	Passive
anlöper	Active
kommittés	None
implicerar	Active
tälta	Active
odlat	Active
konstaterades	Passive
sjunger	Active
backar	Active
dolde	Active
förstatligade	Active
brygd	None
förordnades	Passive
samexisterat	Active
lakats	Passive
kortlekarnas	None
kondenserats	Passive
behållit	Active
ratten	None
tillägger	Active
reglera	Active
prenumerera	Active
halvbrodern	None
vistats	Active
trafikerat	Active
förbehållna	None
hintar	Active
excentriciteters	None
väteklorid	None
bor	None
bokfördes	Passive
dörjat	Active
rollers	None
saknades	Passive
sjungs	Passive
framhålls	Passive
fräst	Active
reciterar	Active
stimulerat	Active
normalisera	Active
förvånades	Passive
förkylning	None
kortsidor	None
landades	Passive
tillsatte	Active
hormonet	None
appellativiserat	Active
israeliskors	None
knullat	Active
specialiserade	Active
underminerat	Active
mäklade	Active
ackuschörskans	None
konvergerat	Active
utnämnt	Active
nämns	Passive
mumlat	Active
överklagat	Active
ratificerar	Active
droppade	Active
förmörkades	Passive
prognosticerat	Active
förleda	Active
sugga	None
svastikan	None
randigt	None
svann	Active
betäckte	Active
koloniserade	Active
vägleds	Passive
lunginflammation	None
behöver	Active
färgbild	None
raljera	Active
trollar	Active
ampere	None
träskålarna	None
blåstupp	Active
urinerat	Active
uppfattat	Active
svastika	None
ruttnar	Active
återförsäkrades	Passive
hårklyveris	None
finast	None
kärnkraftverket	None
blåmes	None
undergrävdes	Passive
isländsk	None
samlar	Active
hänga	Active
bristyrkets	None
jämställdes	Passive
yttrade	Active
staplat	Active
borgenärerna	None
kidnappades	Passive
byggsätt	None
tv	None
bedragarnas	None
gnistans	None
färgar	Active
nattduksbords	None
bedarrat	Active
målar	Active
aktivare	None
skymtat	Active
ackorderar	Active
bluff	None
teologers	None
kantrat	Active
debuterats	Passive
skattades	Passive
uppfyllts	Passive
klassrum	None
administrativa	None
räddes	Active
fotografisk	None
jorda	Active
generats	Passive
vrids	Passive
svär	Active
anförtrott	Active
uppvaktade	Active
överlåta	Active
tomtes	None
stöder	Active
hormonets	None
krympte	Active
influerats	Passive
förklarar	Active
förkastades	Passive
patrullerat	Active
glidit	Active
minks	None
betyda	Active
förenta	None
tillägga	Active
kanslichefen	None
häradsrätt	None
mörkast	None
genomföra	Active
tillkomma	Active
försålt	Active
förkortades	Passive
normaliserat	Active
grundar	Active
programmera	Active
proklamera	Active
sakar	Active
åsiktsregistrerar	Active
skådeplatsernas	None
riksdagsdirektörens	None
virknål	None
dissekerar	Active
fortfor	Active
fallera	Active
moderniserat	Active
bårhusets	None
utövade	Active
förfinades	Passive
tåga	Active
oskadliggöras	Passive
antologi	None
vederlade	Active
scouters	None
tjatat	Active
tänkts	Passive
biträder	Active
flagellerats	Passive
mojnar	Active
profiterar	Active
spetsiga	None
räknats	Passive
5-krona	None
återställde	Active
efterträtts	Passive
aldehyden	None
runde	None
överföra	Active
vinylskivorna	None
ödelade	Active
betjänar	Active
förestår	Active
forcera	Active
brännas	Passive
dödliga	None
ackompanjera	Active
försäljningssiffror	None
suddar	Active
återställdes	Passive
sjöbodarna	None
föraktades	Passive
receptbelägga	Active
avskrivs	Passive
utnyttjat	Active
glaciärers	None
utöka	Active
överstå	Active
värderades	Passive
svimmat	Active
affrikatas	None
indoktrinerar	Active
raggar	Active
misskrediterades	Passive
vårdande	None
pågående	None
prognosticerar	Active
bränts	Passive
förändrar	Active
medlades	Passive
embryot	None
fullföljts	Passive
melankolin	None
omsatte	Active
arbetsskygga	None
förkunna	Active
transkriberade	Active
förehållits	Passive
späddes	Passive
överbrygga	Active
undergrävde	Active
premiärministerns	None
plagiatets	None
nickades	Passive
låna	Active
aktualiserar	Active
företagsledarnas	None
redovisar	Active
jordärtskockornas	None
begreppsnormeringens	None
pussats	Passive
tröttna	Active
essäns	None
förhöras	Passive
överdrivs	Passive
begicks	Passive
sök	None
bockade	Active
fostermodern	None
brandväggars	None
utplånade	Active
önskat	Active
brändes	Passive
renoverades	Passive
glöder	Active
eliminerar	Active
bumeranger	None
underhöll	Active
komponerat	Active
kapsejsa	Active
beteckna	Active
brusa	Active
utlösa	Active
särskiljer	Active
avhandlat	Active
pynta	Active
tröttnat	Active
framträtt	Active
gryr	Active
etsades	Passive
kristnat	Active
förlorar	Active
omformulerades	Passive
övertala	Active
trakasserat	Active
slukade	Active
analyserar	Active
saktades	Passive
diktaturer	None
avstavat	Active
hamburgarens	None
misstänkande	None
bokmärke	None
reformerades	Passive
satsade	Active
förfarit	Active
rättfärdiga	Active
inriktar	Active
tömdes	Passive
þriþia	None
fantiserades	Passive
studsats	Passive
tassade	Active
katalogiserat	Active
diagnostiserade	Active
varder	Active
introducera	Active
missionerade	Active
utställer	Active
förnyats	Passive
puttades	Passive
säger	Active
blöder	Active
kirrades	Passive
supinum	None
formaterades	Passive
teologiske	None
tonade	Active
mäkla	Active
vibrerats	Passive
neg	Active
underskatta	Active
encyklopedi	None
förvånats	Passive
matvanor	None
addera	Active
disponerade	Active
länsrätternas	None
oroar	Active
insamlades	Passive
godkändes	Passive
möter	Active
snutar	None
dementera	Active
bländaren	None
bearbetat	Active
defragmentera	Active
synat	Active
hålremsa	None
förvirra	Active
belägga	Active
hjässorna	None
fortsättas	Passive
anslutit	Active
förvägrats	Passive
föreskrev	Active
besvikas	Passive
valsedeln	None
kikat	Active
krokodiler	None
litades	Passive
integrerats	Passive
underrättelsetjänster	None
stenat	Active
golfklubb	None
värderar	Active
överdomstolen	None
barberats	Passive
alkoholmissbrukets	None
ersattes	Passive
kartlägger	Active
anstränger	Active
aktat	Active
utvärderades	Passive
förgiftade	Active
väteperoxidens	None
farmarligan	None
påvlige	None
rostat	Active
knekt	None
tågades	Passive
kännetecknade	Active
överlägsna	None
klassade	Active
diskarna	None
vardagarna	None
administrerades	Passive
anade	Active
realiserades	Passive
presenterades	Passive
framkallade	Active
utmanar	Active
uppfattats	Passive
utvalde	Active
överbryggar	Active
separerar	Active
arbetslöshetskassorna	None
prognos	None
bakad	None
histidins	None
skräddarens	None
chansar	Active
kammarrättspresident	None
anläggande	None
rimligaste	None
skicklige	None
kläckas	Passive
föranledde	Active
sympatiserar	Active
prygla	Active
förstärktes	Passive
bestämdes	Passive
märkt	Active
detektera	Active
grytt	Active
könsneutralt	None
diagrammet	None
algoritmen	None
bedårades	Passive
analyserande	None
nödbromsar	None
besvarade	Active
expanderade	Active
uppräknade	Active
distansera	Active
sätts	Passive
jästes	Passive
förverkligades	Passive
turnerade	Active
ockuperad	None
anvisade	Active
övertygats	Passive
säkerställde	Active
pensionerades	Passive
aspen	None
uppföljde	Active
förutsätts	Passive
realisering	None
almanackan	None
kvädena	None
bokades	Passive
hissat	Active
inleddes	Passive
motsvara	Active
summerade	Active
geologer	None
teleskop	None
åtalar	Active
utbytas	Passive
storskaliga	None
kröna	Active
svarvat	Active
saknade	Active
bergskedjans	None
framhållits	Passive
avlösas	Passive
kuriositet	None
ölat	Active
infoga	Active
teleporterat	Active
skattad	None
timma	None
fladdrar	Active
lavars	None
gudfader	None
litauiskan	None
besöka	Active
kantrar	Active
arrangerats	Passive
uppnått	Active
försöker	Active
konvolutets	None
slaveriets	None
camemberter	None
skrotats	Passive
transponerat	Active
formades	Passive
studiemedlet	None
armerade	Active
behärska	Active
monterar	Active
finns	Active
gapa	Active
accepterades	Passive
karaktäriserat	Active
beskriver	Active
armerat	Active
nominerar	Active
glänser	Active
plöjer	Active
snickrades	Passive
hållbart	None
importera	Active
landshövding	None
bromsa	Active
spelade	Active
personregister	None
konspirera	Active
användes	Passive
förvaltade	Active
värderats	Passive
sidensvansar	None
förhandlades	Passive
asgarvat	Active
förtecknades	Passive
statistikens	None
assimilerats	Passive
misstror	Active
dekreterats	Passive
biodlares	None
emigrerar	Active
förfogats	Passive
skymningen	None
trettiondedelarna	None
bläckpenna	None
torterades	Passive
kuta	Active
upprepat	Active
investerade	Active
övervunnits	Passive
prioriterades	Passive
utgöras	Passive
ansågs	Passive
kostat	Active
odlar	Active
glott	Active
skattar	Active
ägna	Active
talman	None
uppvaktats	Passive
fastnade	Active
seglade	Active
tillämpat	Active
stridsfråga	None
begär	Active
isolera	Active
överskugga	Active
onani	None
absorberat	Active
överträtt	Active
muttrats	Passive
transporterades	Passive
ont	None
rövar	Active
acklimatisera	Active
tittande	None
harmoniserar	Active
bakvägar	None
palmsöndagar	None
försäkra	Active
överraskat	Active
radera	Active
tennisbanor	None
påstå	Active
falbjudits	Passive
omprövades	Passive
ångerfull	None
meddela	Active
lagtin	Active
dissar	Active
appellativiserade	Active
spenderats	Passive
snacket	None
crawlat	Active
besiktigar	Active
laddats	Passive
nuddat	Active
överskreds	Passive
förespråkar	Active
företedde	Active
färdades	Active
förnummit	Active
dillen	None
offentligheten	None
distanserade	Active
rekonstruera	Active
renat	Active
transkriberar	Active
macken	None
ägnades	Passive
underlätta	Active
chatta	Active
stiwardshepets	Passive
gräsbana	None
stärker	Active
rymt	Active
bygdegården	None
överlämnar	Active
såra	Active
lönnmörda	Active
mjuknade	Active
se	Active
direktionens	None
vridas	Passive
inordnade	Active
atmosfärisk	None
kontraherat	Active
organiserar	Active
koljornas	None
bredde	Active
venuspassager	None
fördela	Active
gränsade	Active
eftersträvar	Active
ämnat	Active
bytas	Passive
opponerade	Active
stråla	Active
låter	Active
fanfaronadernas	None
läppstiftets	None
elektrifierat	Active
anmäla	Active
förutsättas	Passive
forta	Active
omfattat	Active
specificerats	Passive
brudgummen	None
engagerades	Passive
lindar	Active
rengjorts	Passive
meningslösaste	None
duschades	Passive
utlöst	Active
tömma	Active
provocerar	Active
hastade	Active
gagnats	Passive
späckhuggarnas	None
vägleder	Active
studieplan	None
kampanjen	None
reviderat	Active
direkta	None
kvälja	Active
refererar	Active
privatbanan	None
uppfördes	Passive
tillkännagivande	None
trädstam	None
verkade	Active
reformera	Active
duellerar	Active
lönnmördade	Active
arrenderar	Active
gasten	None
övernattade	Active
yla	Active
avancerande	None
upplyser	Active
slopar	Active
avlatskrämare	None
sortera	Active
utgjordes	Passive
påmind	None
använder	Active
tillgodogjort	Active
startats	Passive
rekryterat	Active
bolagiserade	Active
plundrades	Passive
omdefiniera	Active
installerar	Active
sluttar	Active
liknades	Passive
viljestyrkas	None
systematiserade	Active
uträttade	Active
försökas	Passive
släppts	Passive
förlåtit	Active
konsultera	Active
ackumulatorn	None
övningskörde	Active
pullades	Passive
jämna	Active
trösklar	None
säga	Active
plurrat	Active
ruvats	Passive
reviderar	Active
exploderat	Active
diskborstes	None
fixats	Passive
centrerades	Passive
sporde	Active
förband	Active
önskelistans	None
betygsatte	Active
tillåta	Active
utbildningsplan	None
bojkottar	Active
häktat	Active
bytte	Active
insamla	Active
undersöktes	Passive
blickade	Active
pippa	Active
begynna	Active
generalisera	Active
reproducerat	Active
systematiserar	Active
jordfräsens	None
lantbrukets	None
bladets	None
recensionerna	None
säkrats	Passive
bordats	Passive
besitta	Active
tryggar	Active
kassen	None
ässjan	None
vilsen	None
finansiellt	None
pissat	Active
åkerns	None
klassades	Passive
tjuvsenan	None
hängt	Active
figurerat	Active
mappade	Active
onanerade	Active
utsågs	Passive
akademierna	None
väglett	Active
kinesat	Active
knytas	Passive
peruaner	None
straffa	Active
jojo	None
postad	None
hålremsans	None
förmodar	Active
folkbokförs	Passive
sammanträtt	Active
postade	Active
harmoniserat	Active
poolen	None
inspirerades	Passive
svallar	Active
kvasarer	None
nedslår	Active
arresterats	Passive
skyddsvärde	None
blankar	Active
återställa	Active
kontrakterat	Active
fräses	Passive
gissla	Active
förföljts	Passive
vaktlar	None
propagera	Active
blundar	Active
åtala	Active
kristnade	Active
koloniserats	Passive
ila	Active
rastade	Active
harklat	Active
standardiserat	Active
titulerar	Active
karaktäriserade	Active
träskon	None
abonnerades	Passive
infordra	Active
görs	Passive
dopfuntarnas	None
immigrerade	Active
sanera	Active
räkor	None
predikanter	None
falbjöds	Passive
odlade	Active
kvitterats	Passive
amorterades	Passive
potentialerna	None
irriterade	Active
lagrat	Active
same	None
kroknat	Active
luftstrupen	None
kolaren	None
försvarsmakt	None
retade	Active
gestaltats	Passive
begäras	Passive
besvärar	Active
oändligare	None
bifalla	Active
omsätta	Active
förlita	Active
insekternas	None
axet	None
ansett	Active
sölat	Active
länsstyrelse	None
briserat	Active
cyklopentan	None
inhemske	None
normaliserats	Passive
faktura	None
stå	Active
direktiven	None
silvermynt	None
underordnade	Active
eskorterat	Active
sabotage	None
jäntan	None
hämta	Active
prekära	None
attackerades	Passive
lysa	Active
registrerats	Passive
skottats	Passive
omsätts	Passive
animerar	Active
tänkte	Active
manualerna	None
programledarnas	None
virar	Active
alka	None
införs	Passive
parades	Passive
firade	Active
miniatyriserat	Active
markisens	None
vidgade	Active
stångades	Passive
entledigar	Active
påmints	Passive
fogen	None
släpper	Active
recett	None
minikjol	None
lokaliserats	Passive
privatskola	None
vurmade	Active
blänga	Active
kosmologin	None
böra	Active
legalisera	Active
utbjöds	Passive
sfärernas	None
förledde	Active
emalj	None
kåpan	None
dividerar	Active
vätet	None
diagnos	None
betygsätts	Passive
grottors	None
bergochdalbanan	None
distrahera	Active
fotsulan	None
tenderade	Active
fisit	Active
rumänerna	None
best	None
alternerade	Active
filtrerar	Active
svartskjortor	None
stärkts	Passive
individualiserade	Active
offentliggjorts	Passive
informerats	Passive
konverterades	Passive
fosfor	None
bluffarnas	None
oskadliggör	Active
behållen	None
förnam	Active
byggdes	Passive
vävas	Passive
avskrivit	Active
bolagisera	Active
kissar	Active
joggat	Active
tilltro	None
ina	Active
ratificerat	Active
snyts	Passive
sagd	None
buketten	None
orsakat	Active
diskriminerade	Active
divisionens	None
lysas	Passive
kammar	Active
möjligt	None
premiärminister	None
demonstrerades	Passive
testats	Passive
förståelsen	None
vräkt	Active
benämndes	Passive
märks	Passive
skaffar	Active
livremmarnas	None
sömmarna	None
förvirrar	Active
legitimitet	None
snarare	None
kvaddade	Active
stega	Active
anlagda	None
trossamfundets	None
använde	Active
minimerade	Active
rätoromanska	None
bandar	Active
underhålls	Passive
filtrerade	Active
serverats	Passive
utvandrade	Active
fortade	Active
träffar	Active
uppkommer	Active
bajsande	None
omkategorisera	Active
bakluckan	None
jonglera	Active
krympas	Passive
samarbetat	Active
värdigast	None
vederbort	Active
joggade	Active
överförts	Passive
anländ	None
upphandlingarnas	None
förhalade	Active
gallium	None
illustrerade	Active
felmarginals	None
tystade	Active
föreslogs	Passive
undrat	Active
halshugger	Active
mobiliserar	Active
lett	Active
stigit	Active
kongruenser	None
gränsvärdens	None
besvärligt	None
såg	Active
skymde	Active
kommunicerades	Passive
uppsättningarna	None
tappats	Passive
omdirigerade	Active
turnerar	Active
trollades	Passive
åhör	Active
avlöst	Active
aktualiserats	Passive
isbjörn	None
fokuserat	Active
flink	None
svimma	Active
diametern	None
narrade	Active
vägrade	Active
begripits	Passive
krigföringen	None
ansökt	Active
diskuterats	Passive
gäspar	Active
efterfrågades	Passive
narren	None
diskretiserats	Passive
elbas	None
spilldes	Passive
decenniers	None
höja	Active
gastar	Active
kortslutas	Passive
lött	Active
motell	None
kortslutit	Active
trut	None
mötas	Passive
agrare	None
raffinerar	Active
förgöra	Active
engelsmannen	None
stöd	None
betat	None
infrastrukturminister	None
implementerar	Active
arias	None
rulltrappan	None
ballerinornas	None
uppgraderade	Active
begränsades	Passive
förtjäna	Active
omfördelat	Active
samlades	Passive
differentiera	Active
åtalade	Active
konstruerande	None
knäcks	Passive
stöttes	Passive
vräktes	Passive
agat	None
vittnet	None
katalogiserad	None
annullerar	Active
audiovisuella	None
promenerat	Active
europium	None
knackats	Passive
sidnumren	None
farsor	None
vektorns	None
dräps	Passive
droppats	Passive
stöter	Active
förväntat	Active
anmäldes	Passive
donerar	Active
assistenterna	None
optikens	None
bedömas	Passive
rodna	Active
drabbar	Active
fononer	None
rekryt	None
återuppbyggts	Passive
tingsrätter	None
neutraliserades	Passive
halshögg	Active
retats	Passive
haltar	Active
framåtskridit	Active
katalogiserade	Active
tyglades	Passive
grundlagens	None
förtigs	Passive
förhalat	Active
möts	Passive
defenestrera	Active
paramagnetiska	None
sjå	None
kuggen	None
inträffade	Active
kantat	Active
kvietism	None
publicerats	Passive
låsa	Active
axlat	Active
gäspat	Active
allmännyttiga	None
elchockernas	None
utvidga	Active
sanerar	Active
avsåg	Active
barbera	Active
diarieför	Active
orienterats	Passive
premiera	Active
ungkarls	None
vicekonung	None
anslagstavlor	None
uppförde	Active
kirrat	Active
övernattar	Active
tåldes	Passive
linsernas	None
kokar	Active
höljer	Active
djurparken	None
växande	None
analogiordboken	None
vidgar	Active
radbrytningar	None
ätbar	None
bajsade	Active
vandaliserad	None
furstarnas	None
investeringsbanken	None
underrätta	Active
fungerar	Active
databastabellernas	None
petades	Passive
vetat	Active
förankrades	Passive
muttrar	Active
manipulera	Active
generaliserades	Passive
flänsades	Passive
överdrivas	Passive
mista	Active
kackige	None
tonsätter	Active
missionerats	Passive
tätortens	None
bondpermissions	None
avsatte	Active
skrinlade	Active
mjölnare	None
putsa	Active
girar	Active
nedsatt	Active
begagna	Active
hedrat	Active
återvinna	Active
citerade	Active
accepterade	Active
undkommits	Passive
daterats	Passive
skitigt	None
avlägsnat	Active
associativ	None
stängd	None
utfärdades	Passive
vädra	Active
schimpansens	None
annekterats	Passive
uppfylla	Active
utreder	Active
roddarnas	None
koncentrerade	Active
ansträngde	Active
kopierades	Passive
språkades	Passive
konserverades	Passive
prisades	Passive
avslutades	Passive
laggar	Active
angripas	Passive
undersöka	Active
plockats	Passive
livslängders	None
annexen	None
belyste	Active
uppräknades	Passive
misstänkas	Passive
löser	Active
kompilerat	Active
åskådliggöras	Passive
säkerhetspolisens	None
meddelat	Active
millimeterns	None
förvandlats	Passive
avslutar	Active
sympatiserade	Active
skruvade	Active
exemplifierat	Active
rastar	Active
överskuggat	Active
manade	Active
stegats	Passive
pratat	Active
metade	Active
öses	Passive
amputerat	Active
fattade	Active
orsakar	Active
försörjts	Passive
varma	None
begrundade	Active
definierar	Active
upplevdes	Passive
tillträdas	Passive
åhöra	Active
synats	Passive
placerat	Active
befäst	Active
turbanernas	None
bestämmas	Passive
navigerar	Active
förfinade	Active
dyrkats	Passive
analyserad	None
smörsyra	None
köerna	None
invaderat	Active
förfinats	Passive
världsmakternas	None
bommats	Passive
förstört	Active
slickar	Active
påbjöd	Active
jäktat	Active
snyta	Active
exekverat	Active
maskuliner	None
härlig	None
löpnummer	None
lindrat	Active
matades	Passive
prenumererar	Active
mönsterkortens	None
pinglade	Active
ruinerat	Active
byggts	Passive
destillerat	Active
jämfördes	Passive
förutsagt	Active
grävmaskin	None
motsägas	Passive
parasiterna	None
falbjudas	Passive
larva	Active
porträtterar	Active
väckte	Active
lyses	Passive
utplånat	Active
qvalificerat	Active
återstår	Active
rapporterades	Passive
halverar	Active
klarat	Active
pröva	Active
briserade	Active
mörknat	Active
bevaka	Active
särskiljs	Passive
kvalificerar	Active
iller	None
adopterade	Active
resocialiserades	Passive
hårda	None
litade	Active
kantar	Active
normaliserar	Active
bebor	Active
sågats	Passive
huserats	Passive
följa	Active
önskar	Active
debattera	Active
glesnar	Active
förvirrade	Active
förråds	Passive
vänsterhänta	None
indikera	Active
njöt	Active
förlägger	Active
förlagt	Active
artbestämts	Passive
anklagar	Active
absorptionslinjer	None
lurat	Active
framstående	None
servitören	None
böj	None
konsolidera	Active
utgjort	Active
rusnings	None
utformat	Active
fuskat	Active
lönat	Active
förtjänats	Passive
tillägnar	Active
låtas	Passive
påstod	Active
huvudkällan	None
agrar	None
packar	Active
allittererar	Active
reducerade	Active
undertecknats	Passive
orientalist	None
falsifierades	Passive
fotnots	None
pandemier	None
ordförandena	None
konsumerats	Passive
eldstäder	None
mumla	Active
identifiera	Active
presenterat	Active
rullgardin	None
påbörja	Active
ettorna	None
försänktes	Passive
associationsordbokens	None
stiwardshepedes	Passive
liknar	Active
förföljas	Passive
socialdemokraternas	None
globalisera	Active
beboddes	Passive
röjer	Active
skattats	Passive
ersatte	Active
försäkrar	Active
mörknande	None
öppna	Active
ljuv	None
jämföras	Passive
utse	Active
spårades	Passive
uppgradera	Active
flasköppnares	None
konserverat	Active
bedrev	Active
vandaliserats	Passive
verifiera	Active
söker	Active
avsett	Active
klippdassarna	None
befolkades	Passive
ansluts	Passive
mängdlärors	None
fördelaktig	None
skarvade	Active
stjälas	Passive
ockupationsstyrkornas	None
vinkelparenteser	None
förgå	Active
bryggad	None
återvänt	Active
fasett	None
födelsedagskalas	None
anmälas	Passive
vackert	None
inväntats	Passive
psykologins	None
sports	Passive
cashewnöten	None
monterades	Passive
infekterats	Passive
förfinat	Active
desinficerar	Active
återkomma	Active
5-öringars	None
infiltrerade	Active
genomförts	Passive
beprövades	Passive
sölade	Active
vapenvilans	None
kristnad	None
qväfvts	Passive
kursivera	Active
bocka	Active
implicerande	None
syftat	Active
inspektörerna	None
gnistra	Active
tillförlitligheten	None
utarbetar	Active
handlägger	Active
utformar	Active
fortlöpt	Active
förmodades	Passive
vållats	Passive
adresserats	Passive
prokrastinerar	Active
vattnats	Passive
rymde	Active
integrerad	None
förfaller	Active
seedades	Passive
pensionerade	Active
livstiden	None
adderade	Active
omformulerade	Active
indrevs	Passive
inventera	Active
förteckna	Active
förseglade	Active
begriper	Active
avkodare	None
singlar	Active
medverka	Active
kopierar	Active
konstitutionsutskott	None
ammoniaken	None
trösta	Active
användares	None
offentliggjort	Active
amorterat	Active
portat	Active
maximerar	Active
utnämndes	Passive
eurons	None
ruinerade	Active
dolkens	None
irisera	Active
kaffebryggarnas	None
knopen	None
årorna	None
samfundets	None
vred	Active
ylat	Active
sektor	None
ätt	None
gymnasieskolorna	None
befästas	Passive
ylandens	None
förberedande	None
träffa	Active
arrenderats	Passive
migrerade	Active
ristningar	None
tillåtits	Passive
svärfadern	None
valpar	Active
chauvinisters	None
fruktar	Active
kännetecknades	Passive
enskild	None
kommuterade	Active
övervägde	Active
glesnat	Active
protonens	None
tolererar	Active
befriades	Passive
utsaga	None
upplåtas	Passive
avstavar	Active
analog	None
garanterats	Passive
tävlar	Active
nominera	Active
blidkade	Active
åders	None
brantaste	None
dissats	Passive
barrikaderats	Passive
omnämnde	Active
fryshus	None
bekämpade	Active
torterade	Active
oxiderande	None
stadskärnorna	None
prioriterats	Passive
flit	None
slipade	Active
supremum	None
skärm	None
tillgängliggörande	None
karaktärisera	Active
uppställde	Active
turnerades	Passive
elektriskt	None
tjänstgöra	Active
fästes	Passive
motorcyklar	None
väcka	Active
insamlar	Active
innebar	Active
ungdomsförbund	None
syntetiserades	Passive
startande	None
kategoriserad	None
antydde	Active
förtydligats	Passive
tunnla	Active
snatta	Active
förestått	Active
elektronhjärnor	None
omfattade	Active
runka	Active
kvällstidningens	None
stångats	Passive
slavsändare	None
filmar	Active
vänsterjusterade	Active
formaterats	Passive
tvistefrågans	None
agronom	None
exponentialfunktions	None
provade	Active
avkodades	Passive
urskiljs	Passive
synkroniserade	Active
impad	None
dränerar	Active
pressades	Passive
stativet	None
utvärderings	None
förskjutit	Active
vibrerades	Passive
nöja	Active
upphävs	Passive
donerat	Active
dubbelklicka	Active
premierar	Active
beräknande	None
arkiveringen	None
anspelningarna	None
flockades	Active
skördade	Active
hovrättsrådet	None
gödde	Active
kvittade	Active
kortleken	None
oförmågan	None
googlades	Passive
omfattningarna	None
beprövat	Active
betjänades	Passive
hedrar	Active
mimade	Active
aducerats	Passive
förordnar	Active
armband	None
väckt	Active
optimerat	Active
konversera	Active
utspelats	Passive
kontrollerats	Passive
mikrat	Active
anställt	Active
skyddat	Active
besöker	Active
kämpat	Active
korsfäste	Active
preciserar	Active
sjuttondedelar	None
huvudkontoret	None
företetts	Passive
katalanskans	None
accentuerades	Passive
manifesterar	Active
nöta	Active
avhållas	Passive
klassklyftors	None
klövarna	None
återställas	Passive
abonnemangsavgifts	None
gränsar	Active
lessnad	None
referera	Active
donade	Active
kompletterades	Passive
involverades	Passive
dunstats	Passive
proklamerar	Active
avskrivas	Passive
infekterade	Active
hävdade	Active
förutsätta	Active
fruktat	Active
byttes	Passive
ägnade	Active
utmanövrera	Active
sekunderat	Active
stressades	Passive
säkrat	Active
upprepades	Passive
retirerade	Active
begränsar	Active
beundra	Active
skymts	Passive
handelsminister	None
barbarens	None
missuppfattat	Active
dominerades	Passive
oväld	None
antändas	Passive
säljs	Passive
paletter	None
knullar	Active
kommunala	None
röka	Active
passerade	Active
tolkades	Passive
blåklint	None
möjliggjorde	Active
motiverats	Passive
tunnlat	Active
anställdes	Passive
nyansera	Active
övervägts	Passive
velar	Active
numrerats	Passive
reformerat	Active
erkännas	Passive
tyds	Passive
veta	Active
hospitalet	None
saknats	Passive
kinesade	Active
erhållas	Passive
blöds	Passive
förhandsgranskade	Active
förutsätter	Active
besökt	Active
uppräknat	Active
flygplats	None
exportera	Active
återlämnad	None
påvisa	Active
translationer	None
assisterade	Active
resulterat	Active
fria	Active
trakasserades	Passive
onormalt	None
stim	None
legitimerade	Active
desinficerades	Passive
avleds	Passive
lagga	Active
standardisera	Active
buskar	None
strömmade	Active
strö	Active
överträdas	Passive
välsignades	Passive
tjocke	None
argumenterade	Active
duplicerar	Active
komprometterades	Passive
miljöteknik	None
graverat	Active
spöat	Active
jobbat	Active
besudlade	Active
kärat	Active
rånades	Passive
instämt	Active
ösregnar	Active
uppfylld	None
rationalisera	Active
daggkåpa	None
sympatisera	Active
inkluderat	Active
återfinna	Active
uppskattar	Active
konungarikena	None
sända	Active
överklagar	Active
sluppit	Active
jordbävningar	None
frigjorts	Passive
översätts	Passive
intresserande	None
kubens	None
sopp	None
genmanipulation	None
korkats	Passive
blankades	Passive
återlämna	Active
ansade	Active
recitera	Active
opponera	Active
högat	Active
isolerats	Passive
elsäkerhet	None
utgifter	None
svägerskas	None
jämföra	Active
myntades	Passive
ovana	None
tikar	None
tillägnades	Passive
hårstrån	None
nedslog	Active
locka	Active
infogat	Active
litat	Active
återuppbyggt	Active
jordskalvet	None
farliga	None
bågfil	None
använts	Passive
assimilerade	Active
kriminelle	None
kläcka	Active
förstärkas	Passive
knackades	Passive
girerat	Active
decenniums	None
tjatade	Active
förmörkat	Active
visualiserade	Active
anpassar	Active
gummibandet	None
höjt	Active
turistade	Active
angelägenheternas	None
förkastligt	None
poängterar	Active
uttalar	Active
bättrats	Passive
omfördelar	Active
snabbades	Passive
löstav	Active
ädelt	None
anspelar	Active
brände	Active
predikningarna	None
elektrifierats	Passive
brevlådorna	None
knivskar	Active
konsekventa	None
förberedde	Active
bokförde	Active
infordrar	Active
erövrats	Passive
självstyret	None
aducerades	Passive
provats	Passive
uppladdat	None
myntat	Active
ruvar	Active
toppa	Active
prisande	None
vägledningen	None
etan	None
motsade	Active
fokkats	Passive
slicka	Active
röks	Passive
befäste	Active
fiskade	Active
utfördes	Passive
länka	Active
avhållits	Passive
företagaren	None
klassad	None
twittrat	Active
köper	Active
befordrades	Passive
samverkar	Active
bokar	Active
metallurgen	None
omtänksamme	None
meddelades	Passive
avhandlats	Passive
dinosauriers	None
snickerifabriken	None
utformades	Passive
onanerat	Active
misstycktes	Passive
misshagat	Active
tillverkad	None
hyalint	None
rustar	Active
rengöra	Active
bråkdelar	None
facetterat	Active
hitta	Active
kinesats	Passive
förlitar	Active
skallets	None
indrivs	Passive
bekostades	Passive
propagerats	Passive
syddes	Passive
slipa	Active
skyllt	Active
bubblorna	None
sms:ar	Active
pippades	Passive
oroades	Passive
stampat	Active
avgår	Active
riksgäldernas	None
socialbidrag	None
dalta	Active
transponerade	Active
globaliserades	Passive
omorganisera	Active
kinesar	Active
komprimerade	Active
banda	Active
kromosoms	None
fiskmåsar	None
blues	None
begagnar	Active
dödskallar	None
riskerat	Active
streckades	Passive
innebörderna	None
folkminnet	None
rektorerna	None
gotlännings	None
varulvens	None
lindrar	Active
ursäkta	Active
kronologi	None
tikens	None
yttrades	Passive
flygs	Passive
föraktar	Active
ratats	Passive
konsoliderat	Active
kallnat	Active
furstens	None
utrett	Active
chanson	None
zappat	Active
presidentval	None
täpp	None
uppgraderades	Passive
ministärens	None
säkerhetsvakternas	None
villkor	None
syssling	None
rådhusrätten	None
demonstrerar	Active
accepterar	Active
reglats	Passive
befordrat	Active
demokratier	None
motiverat	Active
uppmanades	Passive
tonades	Passive
kvadrera	Active
spills	Passive
hyttor	None
älska	Active
underminerats	Passive
kompanis	None
uppfödarnas	None
återvunnits	Passive
patentens	None
redogöras	Passive
utvecklat	Active
tänt	None
strukturera	Active
anläggas	Passive
bedömningsgrund	None
tryggad	None
prinsessas	None
undvikits	Passive
onas	None
programmerades	Passive
tubaist	None
tjockast	None
atombombar	Active
belägger	Active
bearbetade	Active
hurrat	Active
svarvades	Passive
kulsprutans	None
bepröva	Active
fodrad	None
kyrkklockans	None
inser	Active
redogjort	Active
kommunikationsanalys	None
hydda	None
förstärkt	Active
täppa	Active
bekräftar	Active
landsdelarna	None
kardinaltalet	None
bemöter	Active
fermentera	Active
förbinds	Passive
fiaskon	None
tillades	Passive
pressat	Active
spektakulär	None
anslagits	Passive
infarten	None
dödades	Passive
arbetsveckan	None
opererades	Passive
trycker	Active
etiketterade	Active
motsägelse	None
kidnappar	Active
nanosekunderna	None
hämnades	Active
porträtterad	None
pistaschen	None
påminna	Active
söla	Active
slakta	Active
kidnappats	Passive
köpa	Active
kokats	Passive
godis	None
globaliserar	Active
fullgörs	Passive
utforskare	None
ljuger	Active
upplevas	Passive
omprövat	Active
utföras	Passive
signalerar	Active
förvirrades	Passive
programmerade	Active
skrudens	None
klasskamraterna	None
berörde	Active
varierades	Passive
trovärdighet	None
kväljs	Passive
kajas	None
romandebuterade	Active
automatiserades	Passive
navigerades	Passive
omnämndes	Passive
förbereddes	Passive
kidnappat	Active
blodgivare	None
backhoppningen	None
hemmanet	None
placeringarna	None
qväfvde	Active
filialen	None
knivskär	Active
ligger	Active
monarken	None
raffinerade	Active
viskat	Active
kaveln	None
tillsatts	Passive
expanderades	Passive
bromsat	Active
smycke	None
avancera	Active
sprängladdningen	None
cykelhjälm	None
roterar	Active
pungens	None
inar	Active
lindat	Active
reduktionen	None
votera	Active
födelsedagstårtors	None
spionera	Active
festat	Active
navigerade	Active
jaga	Active
födda	None
missförstods	Passive
föreställde	Active
betecknat	Active
förmedlats	Passive
anförtrotts	Passive
värmt	Active
nickat	Active
fastställs	Passive
förtydligades	Passive
försvarat	Active
vinklats	Passive
tippade	Active
orsakades	Passive
intervjuar	Active
värka	Active
generaliserats	Passive
överskridits	Passive
holmar	None
självbiografier	None
ryter	Active
knullade	Active
konstruerades	Passive
slömdats	Passive
föregående	None
licensierar	Active
älgarna	None
jämförts	Passive
observerats	Passive
fermenterat	Active
erbjöd	Active
rannsakade	Active
överraska	Active
mynta	Active
flin	None
licensiera	Active
hammarens	None
försäkrat	Active
sporta	Active
slappat	Active
samvete	None
noterats	Passive
reflekterar	Active
hårdnar	Active
partikelfysik	None
uttals	None
förutsägs	Passive
kartlades	Passive
investeringsbank	None
fullgjort	Active
konserv	None
försett	Active
cykloalkaner	None
porträtterades	Passive
nunans	None
tätnade	Active
jogga	Active
journalistik	None
satsar	Active
gladde	Active
inflikats	Passive
konvergent	None
förläggas	Passive
myror	None
överantvarda	Active
vattenmassan	None
integrationsdepartementens	None
gorillorna	None
övervinnas	Passive
nominerades	Passive
avtjänade	Active
siad	None
existerat	Active
halverats	Passive
käftis	None
vaccinerade	Active
vävde	Active
andades	Active
globaliserade	Active
girade	Active
sociologiskt	None
delstaten	None
utställdes	Passive
ljög	Active
ignorerats	Passive
gallerior	None
fördärvar	Active
tolkade	Active
elektrifiera	Active
morgontidningarnas	None
misstrodde	Active
täppt	Active
sammanhållning	None
generaliserad	None
gäckat	Active
möblera	Active
härledningars	None
fly	Active
rånar	Active
sötat	Active
avvisa	Active
skaffats	Passive
påpekat	Active
bastat	Active
nomineringar	None
tillät	Active
bemannats	Passive
orre	None
inordnar	Active
studerat	Active
samkör	Active
terroriserar	Active
flöjterna	None
redet	None
tröttnade	Active
undersöker	Active
vattnade	Active
diskriminerats	Passive
bedömt	Active
jakades	Passive
redaktionen	None
låste	Active
filar	Active
livegenskapen	None
golvurens	None
algerier	None
skjuts	Passive
väckas	Passive
nyanserades	Passive
inläggen	None
undvek	Active
tillkännagivandenas	None
demobiliserade	Active
storks	None
elektrifierade	Active
antänts	Passive
killingen	None
defragmenterar	Active
kinesernas	None
kategoriserat	Active
iver	None
cisterns	None
begagnade	Active
gräsbanor	None
firats	Passive
blåögde	None
rigga	Active
dekreterat	Active
riskerats	Passive
fokuset	None
datakällvyn	None
talar	Active
bilägga	Active
finansierades	Passive
sammanfattades	Passive
diskats	Passive
marknadsför	Active
utövar	Active
tabell	None
trädgårdsmästaren	None
ramats	Passive
listig	None
skötts	Passive
bevakar	Active
föreskrivs	Passive
långsammare	None
cynikers	None
existerar	Active
anklagats	Passive
sandad	None
datormus	None
utvärderats	Passive
avtalat	Active
snickrats	Passive
ovälden	None
dvärgplaneten	None
föreföll	Active
verifierades	Passive
försvarar	Active
kapitulerar	Active
suddade	Active
rationaliserar	Active
studsad	None
comebacks	None
svartsjukt	None
introducerar	Active
avtjänats	Passive
nappar	None
lit	None
motivera	Active
förenat	Active
implementerade	Active
ångrat	Active
föranleds	Passive
kompilerats	Passive
mäts	Passive
returnerades	Passive
tvistande	None
flygrutter	None
länkar	Active
virka	Active
plastkassarna	None
kittlar	Active
indikerade	Active
presterade	Active
ledsen	None
påbörjades	Passive
snor	Active
desjatins	None
diska	Active
anförtror	Active
växlar	Active
amputera	Active
spännen	None
förebyggts	Passive
tipsen	None
händer	Active
slukar	Active
förefaller	Active
mörknade	Active
snuddat	Active
svept	Active
förgiftat	Active
perenner	None
alternerat	Active
innevånare	None
protesterade	Active
bekommit	Active
animerade	Active
treor	None
ös	None
urskilja	Active
kölens	None
inordna	Active
våldsamt	None
neutraliserade	Active
stöds	Passive
docerar	Active
abdikerat	Active
operator	None
appellativisera	Active
tillägnade	Active
migrerat	Active
förtryckte	Active
disputerades	Passive
lånade	Active
värmer	Active
amiralen	None
östs	Passive
komponera	Active
härbärgerats	Passive
basunerar	Active
nyttjat	Active
indrivarens	None
sammanslutningarnas	None
snoddes	Passive
regeringsförklaring	None
stjälpa	Active
återuppbyggs	Passive
överskred	Active
nymånads	None
rödgröne	None
baskiskan	None
muttrade	Active
multiplicerats	Passive
välkomna	Active
lugna	Active
trafikerar	Active
glittra	Active
namnlista	None
förehållas	Passive
skator	None
tröttar	Active
ärva	Active
röjdes	Passive
båta	Active
menades	Passive
tumregel	None
säkerhetstjänsterna	None
mättes	Passive
golfbanan	None
mesarnas	None
välsignats	Passive
logaritmerna	None
lindrade	Active
skivbolags	None
blidkades	Passive
wikifierat	Active
sänds	Passive
försade	Active
nästena	None
tatueringsapparaten	None
förändrade	Active
möjliggöra	Active
formaliserats	Passive
häktade	Active
differentierar	Active
lyan	None
oxarnas	None
särskilde	Active
rekommendera	Active
värderat	Active
stämplades	Passive
mustaschs	None
optiskt	None
bolagiserar	Active
anmäl	None
hängs	Passive
normaliserade	Active
namnen	None
behållares	None
plantera	Active
räknat	Active
pressmeddelanden	None
bokmärkes	None
fanns	Active
förhör	Active
begången	None
putade	Active
nittiondelen	None
karakteriserar	Active
väljas	Passive
olla	Active
reserverades	Passive
drösarna	None
nyttja	Active
söks	Passive
kejsare	None
pyntade	Active
pingvinen	None
beteckning	None
besätts	Passive
beslår	Active
utrymmas	Passive
ordmolnets	None
droga	Active
analyserat	Active
bedöms	Passive
tystnade	Active
marknadsföra	Active
späder	Active
negligerar	Active
smålänningen	None
överträds	Passive
kloret	None
styrningen	None
möttes	Passive
fogades	Passive
bekymrar	Active
autografs	None
klar	None
mysa	Active
dementerats	Passive
mimar	Active
förledas	Passive
antända	Active
intervenerar	Active
utlösande	None
prövningar	None
beståtts	Passive
mellanrummen	None
övningskört	Active
gagnade	Active
störtar	Active
standardiserade	Active
kämpa	Active
offrar	Active
präglar	Active
reflexers	None
skärmbilden	None
inventerade	Active
straffats	Passive
övertalades	Passive
sajten	None
rapa	Active
åskådliggjort	Active
bäddarna	None
handlagt	Active
utbildat	Active
diariefördes	Passive
nöjt	Active
annekterar	Active
beundrats	Passive
orglar	None
molekyls	None
eggats	Passive
omprövats	Passive
sanktionen	None
rapade	Active
arrangera	Active
insjuknar	Active
undkommer	Active
resonerat	Active
omprövade	Active
lemman	None
kvickaste	None
smyckat	Active
nedbrytning	None
avgjort	Active
krympt	Active
justerade	Active
skriker	Active
avsattes	Passive
konstituera	Active
glömdes	Passive
katalogiserades	Passive
underminerades	Passive
förutsägelsen	None
kommandoknapparna	None
morgontidningen	None
bevakats	Passive
klassificerats	Passive
missbrukar	Active
spårar	Active
delade	None
förståndet	None
förhört	Active
kriterium	None
miljödepartementet	None
övat	Active
genererades	Passive
emigrerade	Active
snuddades	Passive
övervinner	Active
revidera	Active
filmats	Passive
åskblått	None
ritats	Passive
sviker	Active
föreskriva	Active
dissa	Active
mappa	Active
stallar	Active
glatt	Active
konstaterar	Active
framställdes	Passive
guppen	None
partajade	Active
mucka	Active
frälst	Active
reflektion	None
splittrades	Passive
kickade	Active
kartografiskt	None
tillverkade	Active
berörts	Passive
frigjort	Active
bombardera	Active
illustrera	Active
glober	None
främjats	Passive
skröt	Active
fördelades	Passive
vinka	Active
tina	Active
klassa	Active
eter	None
handleder	Active
legaliserar	Active
korrigerar	Active
föreligga	Active
kaffeburkens	None
utvalts	Passive
tillverkar	Active
åtalats	Passive
återfinnas	Passive
främjar	Active
nationalförenings	None
kela	Active
tynga	Active
exporterades	Passive
grävde	Active
bråkades	Passive
städs	None
kostar	Active
bommades	Passive
åldrats	Active
bankar	Active
subventionerats	Passive
polisbyrås	None
diskriminerat	Active
förtövade	Active
kalasat	Active
trivdes	Active
googlar	Active
lessnar	Active
sågs	Passive
plätt	None
kartlade	Active
undgå	Active
rycker	Active
kortsluta	Active
runkar	Active
gårdsplaner	None
ordstävet	None
segrade	Active
anslår	Active
kvadrat	None
resultera	Active
turbanerna	None
befrielsen	None
tycker	Active
statspolisen	None
pensionera	Active
hedningens	None
motsägelsen	None
valparna	None
kånkar	Active
boskaps	None
flyttat	Active
atommassan	None
angå	Active
skämdes	Active
höljs	Passive
blödningar	None
järnspett	None
legerar	Active
kosta	Active
generalmajors	None
kicka	Active
maritime	None
arresterar	Active
gäckades	Passive
investerats	Passive
sandlådas	None
partistyrelse	None
frigjorde	Active
extrapolerat	Active
brottats	Passive
härledas	Passive
omnämnt	Active
sägs	Passive
projicera	Active
boret	None
betongs	None
behövts	Passive
tillsätta	Active
formaliserat	Active
stoltserar	Active
utnämner	Active
hopades	Passive
bemöttes	Passive
sysselsatts	Passive
nekat	Active
slingan	None
utgjorts	Passive
lästupp	Active
fullgöra	Active
svängde	Active
förvaltats	Passive
dyrkades	Passive
utmana	Active
älskade	Active
försäljningslista	None
begynner	Active
gärdesgårdarna	None
reparationen	None
neutral	None
behandla	Active
styrbord	None
imponerades	Passive
breds	Passive
numrerade	Active
cirkulerar	Active
kramad	None
styvfadern	None
turbans	None
kläcks	Passive
spikades	Passive
gissade	Active
ruinerats	Passive
polypeptidens	None
uppdaterat	Active
stenats	Passive
obstetriken	None
axlade	Active
förutsett	Active
skyddades	Passive
jakat	Active
karakteriserades	Passive
vabba	Active
omorganiserades	Passive
hamnade	Active
föreliggande	None
snickra	Active
kylen	None
uppvaktades	Passive
sjungit	Active
tillbads	Passive
bekräftade	Active
tatuerat	Active
fullföljs	Passive
klistra	Active
aktiverats	Passive
anmälde	Active
förgjort	Active
bemöts	Passive
multiplicerat	Active
celebriteterna	None
överträder	Active
bifölls	Passive
ställen	None
förlagen	None
dekrypterats	Passive
kyvetters	None
inbegriper	Active
pansarstyrkan	None
gapar	Active
putsades	Passive
spionerats	Passive
terroriserat	Active
parat	Active
ylade	Active
vishet	None
grubblat	Active
adlades	Passive
rökt	Active
utfarts	None
individualiserades	Passive
avhärvlar	Active
käntigen	Active
tonsatte	Active
obligatoriska	None
hyfsat	Active
kvaddats	Passive
leja	Active
undervisades	Passive
adjutanter	None
inställts	Passive
krypterar	Active
tyglar	Active
dansbanor	None
gårdagens	None
sponsrades	Passive
accelererats	Passive
samordnar	Active
litterärt	None
adlat	Active
kvadranten	None
olycklige	None
panda	None
vardags	None
myntar	Active
ompröva	Active
erhålla	Active
brandbilar	None
experimentera	Active
avtjänar	Active
exkluderade	Active
diskuterar	Active
förneka	Active
expeditionschefs	None
medens	None
betraktats	Passive
utbyta	Active
besuttit	Active
öst	Active
rätvinklige	None
gräsbanorna	None
surrade	Active
paradoxala	None
klarades	Passive
kulturberikares	None
plagiatet	None
infogade	Active
barriärreven	None
färgad	None
regeringsåret	None
skrotade	Active
affrikatorna	None
erbjudas	Passive
investerades	Passive
rekonstruerats	Passive
andreman	None
kontrasterar	Active
vederlagslösa	None
riktlinjer	None
åsiktsregistrerade	Active
räden	None
kapitalism	None
diagnostisera	Active
avfalla	Active
uträttades	Passive
administrerade	Active
sommarstugorna	None
utnämnde	Active
uppmärksammats	Passive
vilseleddes	Passive
bifogats	Passive
förmedlar	Active
prioriterade	Active
bedrövligt	None
kontrasterade	Active
pussades	Passive
kolla	Active
lämpa	Active
lider	Active
illustrerar	Active
embarkerat	Active
handletts	Passive
staplats	Passive
distribuerats	Passive
köpande	None
siktat	Active
järntackors	None
märka	Active
utsträckte	Active
försäljer	Active
myglade	Active
krönts	Passive
befästa	Active
tyngts	Passive
korsfäst	Active
flagellerar	Active
mörda	Active
emigrerat	Active
inades	Passive
oskadliggjorde	Active
uppför	Active
töade	Active
släpats	Passive
kallna	Active
upplåta	Active
influera	Active
funderar	Active
bleknat	Active
viktigast	None
förlängs	Passive
breder	Active
byggena	None
övernattat	Active
deporterades	Passive
detonerade	Active
nå	Active
länderna	None
packades	Passive
översättningsordbok	None
improviserades	Passive
siktar	Active
blottat	Active
slovak	None
radiobilarnas	None
föreligger	Active
gallupens	None
riskerar	Active
garantera	Active
skyms	Passive
smugit	Active
masskommunicerade	Active
darrade	Active
sms:ade	Active
cymbalen	None
vidgades	Passive
bemöda	Active
mobiliserades	Passive
bykars	None
einsteiniets	None
diarieförs	Passive
rundare	None
dabba	Active
fantiserar	Active
nöjde	Active
knullats	Passive
uppenbarade	Active
framgångsrikt	None
författade	Active
förleddes	Passive
ökade	Active
virkar	Active
stelnade	Active
döljer	Active
oceanografer	None
cylinderhatten	None
lokaliserade	Active
extrapolerar	Active
agaten	None
ockuperades	Passive
sexpacks	None
eskalerar	Active
förkroppsligats	Passive
runkade	Active
skivlingar	None
statsbana	None
överskridit	Active
miniatyriserar	Active
raspa	Active
tuktats	Passive
utsetts	Passive
ökades	Passive
provocerade	Active
stungit	Active
betrakta	Active
skryta	Active
skaffade	Active
bockhornen	None
fördröja	Active
härligt	None
engagera	Active
vräkts	Passive
daterades	Passive
skördat	Active
filade	Active
studsade	Active
återgivningen	None
dansbanorna	None
tusenkonstnär	None
konfigurerat	Active
garderade	Active
bemannar	Active
förhåller	Active
tjänstgjort	Active
favoriserades	Passive
redaktionellt	None
spontan	None
evaluerades	Passive
fladdra	Active
nyttjats	Passive
simulerar	Active
permutationernas	None
renderade	Active
komplicerat	Active
dränera	Active
trollade	Active
stammade	Active
versioner	None
sysselsatte	Active
fastställt	Active
tippar	Active
kommunicerar	Active
bröllopsdagarnas	None
enkronan	None
vävts	Passive
spöades	Passive
sammanfattar	Active
evolutionsbiologi	None
devalverade	Active
manipulerat	Active
klänga	Active
bevisats	Passive
hästskötare	None
servrars	None
inordnades	Passive
balanserades	Passive
samverkande	None
smyckats	Passive
femma	None
komprometterade	Active
klargjorde	Active
ägiljettens	None
stelna	Active
bedårade	Active
orkade	Active
avstå	Active
bevisade	Active
försörjt	Active
åtföljts	Passive
betraktade	Active
ledsna	None
motverkar	Active
bräks	Passive
vaskar	Active
fångar	Active
dämpa	Active
siklöja	None
parats	Passive
förtyckts	Passive
tröstades	Passive
flyga	Active
betvivlades	Passive
betjäna	Active
inbördeskriget	None
restaurerat	Active
manifesterades	Passive
ifrågasättas	Passive
rasmassor	None
utsträckt	Active
erhållits	Passive
jämför	Active
tyckte	Active
grinar	Active
smög	Active
spåtts	Passive
lanserades	Passive
irriterat	Active
perklorsyra	None
ödelagt	Active
sparkat	Active
blogga	Active
utbytts	Passive
antänder	Active
tillsätter	Active
godkänns	Passive
poängsummorna	None
hävdat	Active
rostade	Active
utmanade	Active
förefallit	Active
eftersträvades	Passive
bifallande	None
arrenderat	Active
nornor	None
pekskärmar	None
gasta	Active
värktes	Passive
nuddats	Passive
bajsat	Active
armhålors	None
sarin	None
säkerhetsbältena	None
kritiserat	Active
läskade	Active
staplades	Passive
immigranter	None
betraktar	Active
syndare	None
flamma	None
avhandla	Active
knäckt	Active
qvicknat	Active
försköts	Passive
ifrågasatte	Active
skyldigt	None
visat	None
skrotar	Active
förklarat	Active
bevarade	Active
peka	Active
avböjdes	Passive
utvärderat	Active
bräkande	None
hynda	None
vinklade	Active
realläroverken	None
messades	Passive
assurera	Active
glassbil	None
fixat	Active
kurage	None
lämnats	Passive
skrotad	None
svurit	Active
däggdjuren	None
börjades	Passive
datateknik	None
proklamerats	Passive
borgaren	None
framsidan	None
pryglat	Active
betyder	Active
måg	None
onanerades	Passive
rötmånad	None
örten	None
planterat	Active
gulna	Active
företräda	Active
klargjordes	Passive
tjuta	Active
fördelar	Active
axelmakterna	None
tyckts	Passive
ackompanjerats	Passive
skvallret	None
framställt	Active
bilagda	None
luktat	Active
svettades	Active
ponerades	Passive
applicerades	Passive
befriar	Active
befäster	Active
slagskugga	None
berikat	Active
bortsetts	Passive
märkte	Active
tillbedja	Active
utfärda	Active
berör	Active
tvistar	Active
sammelsurium	None
formaterad	None
profilerat	Active
sågat	Active
parameter	None
voljär	None
efterträtt	Active
förhala	Active
nedvärderats	Passive
genuin	None
stängs	Passive
logistik	None
eskortera	Active
orda	Active
gråna	Active
spenderat	Active
förutsetts	Passive
sabba	Active
njuter	Active
intresserades	Passive
medförde	Active
gläds	Passive
upphäver	Active
periodvis	None
hämnd	None
resonerade	Active
säkerhetspolis	None
fruktades	Passive
omdirigerats	Passive
exemplifierades	Passive
lagstiftades	Passive
kurslitteratur	None
prenumererad	None
appellativiserar	Active
pullats	Passive
uppfyllde	Active
bronsmedaljers	None
människobarn	None
lutheraner	None
retirerar	Active
brytaren	None
hävts	Passive
utvandrat	Active
konspirationens	None
lockar	Active
utsträckning	None
assurerades	Passive
jamade	Active
installera	Active
kubiskt	None
tunnlade	Active
dött	Active
specificerad	None
uppföljts	Passive
ripa	None
behållits	Passive
politiker	None
koncentrera	Active
sovrades	Passive
åttondelen	None
svavelväte	None
förfäktat	Active
behandlar	Active
startades	Passive
olikhet	None
skallen	None
skyllas	Passive
kvantifiera	Active
plundrar	Active
havererat	Active
åsiktsregistrerades	Passive
dyka	Active
praktisera	Active
kommendör	None
infordrade	Active
kungjort	Active
belgiska	None
omnämnandenas	None
klarinettistens	None
klorerar	Active
somaliers	None
korkatupp	Active
jagade	Active
rekonstruerat	Active
qväfvs	Passive
nämner	Active
kineserna	None
härmat	Active
nickats	Passive
överantvardades	Passive
bordlagt	Active
kammarrättsråd	None
signalerat	Active
adlats	Passive
ödelades	Passive
harmoniserats	Passive
hölja	Active
producerar	Active
svängas	Passive
inverkat	Active
tvekampen	None
avbröt	Active
parterna	None
stiftades	Passive
renoverade	Active
vurmades	Passive
upphörde	Active
bokfört	Active
repatrierades	Passive
sandpapprens	None
förenats	Passive
pråmarna	None
förhastat	Active
medförer	Active
skådebanan	None
avgick	Active
oxiderat	Active
ombryts	Passive
berodde	Active
nämnaren	None
formats	Passive
företräder	Active
följas	Passive
acetyls	None
snöts	Passive
döva	Active
skaffades	Passive
falsifierade	Active
stångade	Active
bifloder	None
dammsuga	Active
säkraste	None
kantra	Active
formaliserade	Active
huvudverkets	None
skrämt	Active
cypressen	None
talats	Passive
ambassadörens	None
kvantifierats	Passive
desarmerats	Passive
tvåor	None
arbetade	Active
teoretiskt	None
atombombade	Active
förvaltningsmyndighet	None
tänkande	None
sommarspel	None
redovisa	Active
erövrades	Passive
röstar	Active
välsigna	Active
komposterat	Active
kapats	Passive
format	Active
avhålla	Active
förvärvats	Passive
paddors	None
sandals	None
arbetat	Active
störnivåers	None
nyttjades	Passive
förstör	Active
plöjt	Active
voterat	Active
strömmades	Passive
förutsade	Active
önskelistor	None
utvidgar	Active
rymmer	Active
halsa	Active
släpades	Passive
befallt	Active
drabba	Active
avtjäna	Active
petats	Passive
reforms	None
initierade	Active
ljuvligt	None
skyddats	Passive
glädja	Active
utvandrare	None
refererande	None
kolliderat	Active
tonsatts	Passive
skylla	Active
skylls	Passive
dog	Active
besiktat	Active
kommatecken	None
balansera	Active
reglerat	Active
tilldela	Active
överför	Active
stenades	Passive
stimulera	Active
päronjuicer	None
skepparen	None
länsstyrelsens	None
reserverade	Active
nystar	Active
snott	Active
resulterats	Passive
utarmade	Active
plockade	Active
apelsinträdens	None
anmärkningsvärda	None
fyrar	None
rörmokaren	None
viten	None
amiraler	None
karaktäriserades	Passive
tippa	Active
misstycks	Passive
reducerar	Active
lakonisk	None
injektioner	None
bedöma	Active
mist	Active
pressats	Passive
avdragarnas	None
uppgraderat	Active
ljudande	None
bråkar	Active
varierar	Active
kamfer	None
influerat	Active
framhållit	Active
grina	Active
tillgodogjorde	Active
patenterat	Active
reflekterade	Active
intervjuats	Passive
förtrycks	Passive
församlat	Active
opponerar	Active
späda	Active
prognosticerades	Passive
käkats	Passive
slopat	Active
avgått	Active
verkligheten	None
fattar	Active
brusar	Active
tillträda	Active
rånade	Active
självbiografi	None
säkerställa	Active
handböckers	None
hyperlänk	None
begärde	Active
gillar	Active
serverade	Active
återanvänts	Passive
ockuperats	Passive
proffs	None
löds	Passive
sötades	Passive
dårade	Active
pinglar	Active
stadsplanerarens	None
beväpnar	Active
bistått	Active
biföll	Active
skurkens	None
ramad	None
rasat	Active
tålas	Passive
dubblerade	Active
kommunikations	None
hane	None
klarnade	Active
erfors	Passive
inrätta	Active
föreställer	Active
skräms	Passive
betvivlar	Active
ruin	None
flate	None
asgarva	Active
värks	Passive
snabbade	Active
legitimerats	Passive
ekorrarnas	None
adjutanten	None
tillväxte	Active
infiltrerat	Active
förletts	Passive
konfiskerat	Active
utmanövrerades	Passive
säkrar	Active
konkar	Active
vässa	Active
åk	None
fördröjs	Passive
försökte	Active
hamstrats	Passive
indoktrinerades	Passive
inspirerar	Active
löst	Active
resonera	Active
anförtro	Active
glömmas	Passive
borgarråden	None
hyenan	None
festa	Active
kommersen	None
annullerades	Passive
företräddes	Passive
förgörs	Passive
övervägas	Passive
svallade	Active
fastna	Active
anspelades	Passive
tibetanska	None
raksträckorna	None
kisa	Active
förfina	Active
fullföljde	Active
resulterade	Active
frälste	Active
nämnts	Passive
övervakade	Active
biläggas	Passive
riggat	Active
nationalmuseer	None
tänkta	None
vanligaste	None
harmonisera	Active
qvalificerar	Active
standardisering	None
kompilerade	Active
lagledarna	None
infiltrera	Active
nudda	Active
arkiverar	Active
undviker	Active
monarkens	None
slipats	Passive
legaliserat	Active
minskat	Active
konserverats	Passive
dekrypterade	Active
vankades	Passive
naturhistorisk	None
dräpt	Active
centrifugalregulatorer	None
inflikat	Active
konstruerat	Active
företrädas	Passive
zemstvons	None
pendelns	None
käkat	Active
versionen	None
husera	Active
kontraktera	Active
bevisat	Active
medeltidskyrkor	None
flöjter	None
krossats	Passive
kryddnejlikas	None
inleder	Active
säkerhetsvakten	None
resen	None
höga	Active
fritids	None
påverkad	None
förlägga	Active
omsätter	Active
enskilde	None
formalisera	Active
biträtts	Passive
bräka	Active
serverat	Active
uppfödaren	None
spika	Active
avgränsa	Active
improviserats	Passive
dispyt	None
kollisioner	None
permutationer	None
förvaltningsavdelningars	None
kapar	Active
offrade	Active
lärjungarna	None
färgats	Passive
särkars	None
hårdast	None
lasta	Active
skifts	None
bekändes	Passive
ekoloden	None
åklagat	Active
gäddor	None
överstelöjtnants	None
hypotetiserat	Active
skillingarnas	None
avhandlar	Active
satsats	Passive
arrangerar	Active
bulgariskorna	None
gendrev	Active
örtens	None
utförda	None
slutspelets	None
bultarna	None
debutera	Active
stugans	None
njutit	Active
defragmenterat	Active
skrotades	Passive
sponsors	None
moderniserades	Passive
hämmar	Active
låge	None
vävdes	Passive
beräkna	Active
föreställts	Passive
jamar	Active
gnagas	Passive
uppenbarar	Active
gilla	Active
kvickt	None
tumörer	None
experimenterade	Active
tik	None
överseende	None
markerandens	None
motsades	Passive
bekymrat	Active
präglades	Passive
allmänna	None
tåla	Active
riksbank	None
möjliggjort	Active
menykommandos	None
uppgraderats	Passive
spätts	Passive
svalnat	Active
miniatyriserats	Passive
giftes	Passive
inordnats	Passive
entledigades	Passive
gnistrade	Active
utnyttjad	None
isflaket	None
manifesterade	Active
nunnor	None
natriumcitrats	None
katalogiserats	Passive
geofysikens	None
legärt	None
uthärdat	Active
handslag	None
matsalens	None
etiketterar	Active
sökvägar	None
insamlat	Active
hintades	Passive
utrikesråd	None
reglade	Active
magra	Active
druvorna	None
gillats	Passive
ungerskan	None
orörlig	None
roterat	Active
webbplatsens	None
placera	Active
diamant	None
nebulosornas	None
pip	None
respektera	Active
likviderar	Active
integralens	None
svarvade	Active
rättade	Active
förehölls	Passive
bockat	Active
deklarerades	Passive
klots	None
deriverat	Active
gynnades	Passive
attrahera	Active
överfördes	Passive
sysselsätta	Active
erbjudits	Passive
förföljde	Active
bildtexterna	None
kvittat	Active
kursiverats	Passive
hästskos	None
projekterat	Active
förtin	Active
målande	None
åtnjöts	Passive
överskridas	Passive
bländat	Active
anse	Active
fotograferar	Active
invadera	Active
bulgariskans	None
giftas	Passive
amerikansk	None
avkomman	None
åskådar	Active
mycket	None
njuta	Active
absiden	None
kånka	Active
töras	Active
hyste	Active
pausades	Passive
gravitationen	None
infiltrerats	Passive
fräsa	Active
klorera	Active
begripit	Active
eket	None
vinkade	Active
utrymt	Active
matematikens	None
behöll	Active
grundlagts	Passive
anklagat	Active
perifert	None
berömts	Passive
förtigits	Passive
skrivmaskinerna	None
producera	Active
lastats	Passive
försonade	Active
väntade	Active
beräknade	Active
assisterades	Passive
signerade	Active
vandalism	None
avhålls	Passive
klassificerade	Active
glömde	Active
måltavlorna	None
utsträcker	Active
ingenjörsvetenskaps	None
löste	Active
mandaten	None
avvisade	Active
utökade	Active
älskar	Active
tilläggas	Passive
specialisera	Active
förebyggs	Passive
förtrycker	Active
trattarnas	None
samborna	None
snodde	Active
knycktes	Passive
avbilda	Active
kramande	None
invänta	Active
utplånar	Active
skjutit	Active
tidigaste	None
daltat	Active
webbkonferensernas	None
fullgör	Active
utsända	Active
emiratet	None
prognosticerats	Passive
komposterades	Passive
bogserade	Active
underordna	Active
förstå	Active
tätnat	Active
fantiserat	Active
slukats	Passive
centrerar	Active
lövgrodas	None
upplöst	Active
aluminiumfolie	None
sysselsättas	Passive
höjer	Active
gratulerar	Active
omdanade	Active
filtrerat	Active
yachten	None
plockar	Active
laddar	Active
darrande	None
glodde	Active
förvaltades	Passive
svängs	Passive
katalanskt	None
guvernanten	None
trolig	None
basta	Active
härledde	Active
tittats	Passive
ställföreträdarens	None
trafikerade	Active
marknadsförts	Passive
pandemis	None
institutet	None
ackumulerats	Passive
involvera	Active
tilldelats	Passive
uppdaterades	Passive
filmades	Passive
flyttar	Active
röktes	Passive
upphandlar	Active
dagjämnings	None
övningsfältets	None
snattade	Active
biplanet	None
svalnar	Active
tytts	Passive
rasta	Active
undergrävd	None
västmanländska	None
rutit	Active
grupperingsfunktion	None
