преживяващи	преживяващите	lemma
изплашвате	пишещата	Tense
авансираните	поотичаше	Tense
прехапва	обучихте	Mood
обзаведеше	създадат	Mood
наследявана	допичахте	Tense
уволняха	произнасяш	Mood
децилитри	гренландецо	Case
наплитало	слизам	Number
безвярното	по-безвярно	lemma
круши	глупави	Case
черни	арнаутки	Case
астероиди	най-модерни	Case
зверска	бие	Number
вожд	кралю	Number
създадеш	играеха	Mood
подпряхме	подпряно	lemma
изпий	отключи	Person
решава	създадем	Mood
полудях	доплитате	Mood
давала	поопичащите	Voice
отсякохме	произнасяш	Mood
обесили	изгубеното	Tense
изметено	обрекоха	Tense
по-мъртво	по-мъртви	lemma
коронясващото	предрекли	Voice
компетентни	въпросите	Number
обещаващи	заведохте	Number
обещая	обещалите	lemma
запиращия	наводнели	Voice
дадеше	обесвай	Person
разпростираните	разпростираха	lemma
произтичащ	гласувалите	Voice
изковаваните	купувах	Tense
изричаме	изрича	lemma
най-реалистична	кралю	Number
опасвала	поопичащите	Voice
чуй	доведе	Person
подкупят	пишещата	Tense
въвреният	въврялата	lemma
примирам	зареваваха	Mood
размени	арменски	Case
по-златните	по-златно	lemma
отвлече	плачехте	Mood
доказвахме	разходило	Tense
обесихме	обесехме	lemma
въвлечахте	озаглавена	Tense
комбинирало	навличаха	Tense
заслужи	погледни	Person
най-безбройна	влезех	Number
преживееше	обезсмърти	Person
изсичаха	авансиралият	Tense
донесете	подобрете	Person
срядо	радиоцентрове	Case
разболее	заковавахте	Mood
красиви	горелки	Case
загубиха	драки	Number
анулирахте	накаже	Mood
оцелееш	чухме	Mood
най-верни	лешове	Case
изсеченото	изсечено	lemma
счупилата	въоръжаващи	Voice
излезеш	сравняваха	Mood
извлеклият	крадеш	Number
унасяха	клюнове	Number
смазаното	начетохте	Tense
повярваха	въпросите	Number
дотичахте	загине	Mood
отлично	келнера	Number
бълхо	алебарди	Case
чуха	спасявалия	Tense
надебелееха	вдишвалата	Tense
убиваните	убиваха	lemma
арки	арменски	Case
насмитаният	насмитайки	lemma
построяващото	оцелеят	Tense
хеликоптери	арменски	Case
най-тежкия	четящо	Number
надвнесяла	обясняващите	Voice
подслушвало	бомбардиращите	Voice
овце	шипко	Case
допрочелият	прощаващи	Voice
провирането	провиралото	lemma
нанасяме	преведе	Mood
бихте	обучава	Mood
подклажда	поизметем	Mood
обречеш	начитаха	Mood
станеш	пуши	Person
анулирахте	пейте	Person
изсякло	посещаващите	Voice
причинявали	работещата	Voice
мишето	по-мише	lemma
купувай	стана	Person
надебелява	захапете	Mood
посъветвалото	посъветвало	lemma
болногледачки	овчарю	Case
простят	засече	Mood
доказвахме	лягало	Tense
превеждащият	подобряваме	Tense
вожд	носороже	Number
убедеше	полудеят	Mood
съчетаващият	напредваме	Tense
изпридал	създавахте	Tense
заслужиха	потичалият	Tense
презират	вдиша	Mood
тича	спряло	Number
вярваш	най-абстрактният	Number
загребвай	питаш	Person
разпростирахте	припаднете	Person
съзирахте	припаднете	Person
най-плешивата	най-плешивите	lemma
превеждано	превеждала	lemma
зачете	създадем	Mood
поднесен	по-решителната	Number
изгубвания-нета	изгубвате	lemma
загиващия	изпасвате	Tense
съобщаваме	съобщаващо	lemma
зачете	честваме	Mood
най-яйцевидно	припечи	Number
изкупил	отключващите	Voice
очаквах	затечели	Tense
наизлизащото	опасвали	Voice
убиващ	убиващи	lemma
монаси	осо	Case
ходели	по-уклончивите	Number
пекари	най-ароматни	Case
победиш	начетен	Number
напредвахте	свирайте	Person
изоравахме	грешенията-нетата	Number
подпряната	запалваха	Tense
опридащите	завеждала	Voice
лекцията	построявал	Number
колачко	адове	Case
най-абаносовият	узакони	Number
вземаха	господарстваш	Mood
презиращ	презират	lemma
главо	кошмари	Case
изнудехме	ушиваната	Tense
отвлече	чухме	Mood
обилни	цици	Case
мечтано	обезглавилите	Tense
подклаждах	подклажданото	lemma
охранявам	хапал	Number
възпира	казахте	Mood
превъзнесохте	спряно	Tense
създаваме	създава	lemma
давали	разлюбената	Tense
допрочитало	заподозираха	Tense
отваря	оскъдно	Number
отсичам	желаха	Mood
граничат	казва	Mood
допрочитащата	отхапвали	Voice
окрадена	въвираха	Tense
протеклото	начетохте	Tense
надвнесоха	преживееш	Mood
розо	алгоритми	Case
по-северозападно	по-северозападни	lemma
астероиди	котко	Case
героиньо	автоматистрали	Case
интересуващ	интересуват	lemma
построяващото	ранявате	Tense
окрадеш	съчетаха	Mood
прелъстеното	североизточни	Number
сравнената	аплодирахте	Tense
влезлия	съобщавани	Tense
бягаше	подпрете	Mood
обвинявано	пренасяхме	Tense
допрочетох	създадат	Mood
разплачехте	млъквайте	Person
заплитащата	заплитала	lemma
отхапваш	най-отрицателна	Number
боядисва	заплашат	Mood
търсим	търсещо	lemma
изслушай	изговаряше	Person
гущере	биокомпютри	Case
допринасялата	запалващи	Voice
чуват	наобличащият	Tense
най-очната	най-очните	lemma
почетях	безбожното	Number
причинявалата	въоръжаващи	Voice
аплодираме	получаваше	Mood
капеше	унесат	Mood
уплашвал	ушиха	Tense
инфантилни	венци	Case
убеждавате	вярвах	Mood
изреваваме	изревава	lemma
поборника	поглеждания-нета	Number
храно	воли	Case
принуденото	купувахме	Tense
ближехме	попитала	Tense
затрисащ	затрисат	lemma
препичахте	нанеса	Mood
счупвате	вижда	Mood
допичаният	опасвахте	Tense
оцеляхме	оцелеехме	lemma
псувньо	радиоцентрове	Case
разлюбилият	завличахте	Tense
най-невярна	невярно	lemma
заповядвали	снасяният	Tense
пуши	заплетохте	Mood
сънувайте	срещахте	Person
анатемосаха	дотеклото	Tense
предсказаха	започващите	Number
университете	венци	Case
злоупотребяват	поотичах	Mood
потресла	сврените	Tense
зидарки	германски	Case
втечняваната	бушували	Tense
безделничеха	вдишвалата	Tense
надонасяйте	наводнихте	Person
обясним	обясни	lemma
можа	пикаете	Mood
поотече	анатемосате	Mood
удовлетворявахме	драки	Number
поведи	потресеше	Person
обеси	взимало	Number
подобрена	чупехте	Tense
нанасящия	заповядвали	Voice
размени	енергични	Case
насичаше	възпрени	Tense
полудяващата	полудяваш	lemma
визи	най-големи	Case
набодохме	набодяхме	lemma
опеченият	затечели	Tense
обещаващи	чупиха	Number
ядат	навирах	Mood
примираше	съзрете	Mood
разходи	вдишахте	Mood
виелици	сило	Case
авиаторското	по-авиаторско	lemma
пекари	най-светли	Case
тръгваща	ушиете	Tense
разболее	заплетохте	Mood
наоблича	унищожавате	Mood
създаваният	отключваха	Tense
охраняваните	занасяло	Tense
размени	лесе	Case
поднесели	раняваше	Tense
избодеше	дадем	Mood
тресящото	опичали	Voice
италианци	котко	Case
по-високо	по-високи	lemma
изчетете	изгубех	Mood
дълго	произнесях	Number
изпитваните	изпитваха	lemma
университете	петаметри	Case
навличам	заведяха	Mood
абсорбиралото	съчетаха	Tense
подведени	спрях	Tense
сра	срания	lemma
поопичаха	изгубел	Tense
озаглавявахме	спрения	Tense
наплитало	най-любопитният	Number
глобете	закусите	Person
ограничавахте	изгребвалата	Tense
засичаната	купувахме	Tense
наплетем	дотечеше	Mood
пастири	италиански	Case
презира	нараняват	Mood
арестувалата	заспиваха	Tense
чуването	гвоздею	Number
богът	археоложка	Number
отрекохме	надебелее	Mood
попитващи	попитващите	lemma
попекоха	изплаша	Mood
недостатъчни	овни	Case
корели	ухапва	Tense
повтарящи	повтарящите	lemma
университете	глави	Case
заподозирали	изпасваше	Tense
търсехте	спася	Mood
най-учтивият	по-учтивата	lemma
наследявали	отключвания	Tense
най-абаносовият	заподозирано	Number
надебелявалото	корящи	Voice
дометат	засече	Mood
изсечени	избоде	Tense
стана	отключеха	Mood
лесна	пристига	Number
помитах	давалите	Tense
книги	жълъде	Case
италианци	плуже	Case
затеклият	затекъл	lemma
правите	захапете	Person
отбождахте	най-бесните	Number
черни	пуйки	Case
запалените	запалеха	lemma
окрадват	разплакваше	Mood
биете	протичащия	Tense
прощаваните	прощаваха	lemma
охраняваха	секлия	Tense
припиращ	припиращи	lemma
изминато	казваха	Tense
превеждаш	очакваха	Mood
назоваващо	привнасяме	Tense
попечели	работещата	Voice
превеждаш	играеха	Mood
уволняха	принеса	Mood
най-авторитарна	авторитарно	lemma
отхапеше	надебелей	Person
по-големите	по-голямо	lemma
заспа	прегърнат	Mood
уволняващи	плета	Tense
захапвана	най-реалистичният	Number
правещата	правиш	lemma
провира	продавахте	Mood
срещал	съчетахме	Tense
прости	близаното	Number
окрадеш	очакваха	Mood
телефониращ	изпасвате	Tense
чу	изречете	Mood
чака	полудеят	Mood
метящото	дотечели	Voice
надвнасяхте	събудено	Tense
най-бърза	изсеклият	Number
изревавало	предсказваха	Tense
полудявахме	втечнявалият	Tense
обсъди	потъващ	Number
удовлетворявах	удовлетворяваното	lemma
тресящото	заревавали	Voice
уволняващият	отвеждате	Tense
влизаш	изнеси	Person
омита	изковавахте	Mood
обсъди	очаквана	Number
по-продавачески	горелки	Case
отричай	ходиш	Person
причинявали	продаващият	Voice
алхимички	най-модерни	Case
понапичалите	нахапех	Tense
навеждан	купувахме	Tense
отмрялата	създаващи	Voice
изплитахме	отвежда	Mood
науко	бедняци	Case
анатемосах	разболеете	Mood
отворела	посещаващите	Voice
вертикално	слизам	Number
насечените	насечаха	lemma
обичаме	пристига	Mood
повярвате	повлечете	Person
заслужиха	счупилата	Tense
слънчевите	тухли	Number
повярваха	режа	Mood
повтарящите	загинало	Voice
автоблокировки	най-господарски	Case
извлече	плащали	Tense
единадесети	венци	Case
попитвала	навеждахте	Tense
най-авторитарната	саркастично	Number
подслушат	вярвах	Mood
наследявана	пренасяхме	Tense
ограничават	засече	Mood
неузрялото	по-неузряло	lemma
жабарю	понапече	Number
лопати	други	Case
убедим	допичаше	Mood
дете	загиналият	Number
посетели	господарствуващата	Voice
продължавалата	прощаващи	Voice
най-земетръсният	по-земетръсната	lemma
италианец	победата	Number
правителства	джамиите	Number
нанесях	нанесеното	lemma
чете	доплитате	Mood
снасялите	безделничеща	Voice
завлечало	засечените	Tense
препоръчваме	казва	Mood
нахапваха	напека	Mood
подчертавал	начитахте	Tense
нови	чупим	Number
вдишам	отечахте	Mood
слоници	победените	Number
купувала	изчитахте	Tense
понеслата	пристигнехме	Tense
прелъстяващата	прелъстявала	lemma
по-овчите	по-овче	lemma
по-абсолвентско	по-абсолвентски	lemma
най-батерийната	най-батерийните	lemma
предсказаният	опасвахте	Tense
изковаваха	авансиралият	Tense
желах	анатемосате	Mood
анатемосаха	насметяло	Tense
припеви	арменски	Case
най-алените	режели	Number
потичащите	завеждала	Voice
по-абхазката	най-абхазка	lemma
събуди	продължите	Mood
честващи	честващите	lemma
озадачавайте	доведяхте	Person
охраняваха	помитаното	Tense
прегърнем	птиците	Number
победим	отвежда	Mood
биеш	ограничаван	Number
правехме	помитаното	Tense
убитото	арестували	Tense
изсечени	купувах	Tense
изгубеното	изгубено	lemma
овцо	екзарси	Case
чапло	кълвачи	Case
наобличахте	серете	Person
надебелява	довличаме	Mood
уплашваше	надебелеят	Mood
замитащият	узаконявали	Voice
ползващи	ползващите	lemma
отваря	жена	Number
обезглавявам	обезсмъртяха	Mood
охранявам	по-железния	Number
полудявахме	възпираният	Tense
жестокото	по-жестоко	lemma
живеният	произнасяхме	Tense
апетити	други	Case
по-лястовичият	изговаряй	Number
алжирки	крамоло	Case
американска	кралю	Number
изслушан	аплодирахте	Tense
забравиш	произнасяй	Person
опиралия	попечахте	Tense
битпазари	по-други	Case
комбинирали	изплетената	Tense
извлечи	провреше	Person
недостатъчни	цици	Case
подклажда	опират	Mood
бихте	накаже	Mood
патриарси	снесените	Number
мачове	по-други	Case
водоизпускателя	подпиращи	Number
обсъден	навеждахте	Tense
посети	изречете	Mood
потичахме	потичайки	lemma
врящата	затичали	Voice
прозирано	пристигнехме	Tense
упрекнеш	адресирай	Person
търсела	търсех	lemma
препичащ	най-гърдестата	Number
отвеждали	плачещата	Voice
клади	потушава	Person
начитахте	презирайте	Person
бесела	бесех	lemma
пуши	прелъстявахме	Mood
най-североизточни	венци	Case
виелици	надколенни	Case
обосновава	понавлез	Person
решаваме	решаващо	lemma
овце	надколенни	Case
презира	сравнят	Mood
разпростирам	насякохте	Mood
пикаеш	казвай	Person
астролозите	режели	Number
пчеларю	венци	Case
ядосани	агрохимици	Case
доктора	запалват	Number
причинило	надонасящите	Voice
изпридали	поглеждах	Tense
лекарят	белгийка	Number
изтървава	разболеете	Mood
желах	захапете	Mood
по-невяращо	по-невяращи	lemma
събуди	купите	Mood
злоупотребят	пренасях	Mood
зидарки	котко	Case
засичаната	попечахте	Tense
играното	въвираха	Tense
подслушат	подмиташе	Mood
пикаещата	узаконявали	Voice
отваря	набожната	Number
убивали	драки	Number
пишеха	джамиите	Number
загубиха	икони	Number
проницателни	най-мъдрото	Number
зареждаща	засичат	Tense
изсичащ	изсичащи	lemma
посещаваните	протича	Tense
най-чудесно	узакони	Number
университете	родини	Case
потъвам	потъвала	lemma
чуваното	прегръщахме	Tense
попитаните	убило	Tense
уби	подчертаели	Tense
по-абаносови	анулирате	Number
здрави	документи	Case
паланко	отци	Case
изпитващ	изпитващи	lemma
нагризвала	въвличащите	Voice
мазаната	разлюбиш	Number
боядисва	дадем	Mood
най-низши	документи	Case
режещ	режещи	lemma
нанасяме	аплодира	Mood
озадачавайте	граничехте	Person
авансе	горелки	Case
предсказа	създадат	Mood
презира	довличаме	Mood
протичащо	протичах	lemma
анатемосваме	маза	Mood
оцелявай	прегърнеше	Person
обосновава	погледни	Person
надвнесяло	създавахте	Tense
изминало	кралю	Number
написаният	донасяли	Tense
плащаш	снесяхме	Mood
спасявахме	съобщеният	Tense
загиващата	обосновавали	Voice
астероиди	по-неузрели	Case
наемаха	зачета	Mood
бактериолози	гейовете	Number
навлечете	унищожихте	Person
повтаряха	печати	Number
виждаше	изнеси	Person
изслушай	протича	Person
подкупиш	надебелей	Person
чакания-нета	радеем	Number
попичали	убеждаващото	Voice
убиваща	убивалите	lemma
надебелявало	ползвахте	Tense
предсказвал	обрекоха	Tense
вечерят	убих	Mood
омита	зряхме	Mood
обяснихте	омете	Mood
по-възголемия	обезсмъртя	Number
подмитащи	подмитащите	lemma
свирано	избодяха	Tense
вожд	боядиса	Number
плача	плакалите	lemma
италианци	най-предпазливи	Case
изпридали	ухапваният	Tense
набоде	господаруваме	Mood
обречете	заплетох	Mood
по-адамовата	най-адамова	lemma
безбройни	камъни	Case
организмът	предскаже	Number
втечнявана	втечнявали	lemma
наранилият	плетяхте	Tense
сравнило	бомбардиращите	Voice
възпрели	принуждава	Tense
обезсмъртиш	запрело	Number
най-земетръсно	озадачи	Number
сънувайте	плащате	Person
озадачавало	изпичаха	Tense
монаси	други	Case
съществувалото	съществувало	lemma
нагризващият	навестят	Tense
недостатъчни	кошмари	Case
обещаващ	обещаващи	lemma
принуждаваха	наковавала	Tense
начиталите	предплащаща	Voice
съчетаващи	подчерталият	Voice
ползвахме	прозряло	Tense
опрете	маза	Mood
обезглавява	ограничаван	Number
предупреждавания-нета	предупреждавате	lemma
бягащ	бягащи	lemma
изгризвала	изгризваше	lemma
навестявали	осиновяващия	Voice
построявалата	навличаха	Tense
отхапеше	изнеси	Person
пушещи	оцветените	Number
отвеждали	обричащото	Voice
съветващия	авансирали	Voice
надонасям	зареждаха	Mood
по-низши	алебарди	Case
разболяващия	авансирали	Voice
прозирахте	смажете	Person
намекваме	припадали	Number
правя	казахте	Mood
замитащият	чупили	Voice
сило	испанският	Number
правите	подобрете	Person
единадесети	авантюристки	Case
предричайте	примрете	Person
изметено	оцветилите	Tense
спасели	надвнесеният	Tense
доказвахме	изгубеното	Tense
прочитаните	спирало	Tense
господарствалото	господарствалия	lemma
смазаното	начитахте	Tense
възпирахме	изсеклия	Tense
юнака	ебане	Number
по-жълти	арнаутки	Case
набодяхме	докаже	Mood
живеещите	съобщавал	Voice
отхапаните	занасяло	Tense
можа	поизметем	Mood
разплаче	напичане	Number
вечерят	прощава	Mood
допрочетох	продължите	Mood
заподозирали	спрях	Tense
спряха	влязъл	Tense
почването	почваната	lemma
покриви	бродяго	Case
замрях	препрочетете	Mood
надвнесяло	пренасяхме	Tense
изплитахме	грабиш	Mood
взема	аплодиран	Number
най-азотни	бакшиши	Case
отнесеше	понавлизаме	Mood
гърцизми	южняко	Case
посетели	затичащият	Voice
подчертали	наказа	Tense
превеждаш	гласуваха	Mood
корящия	заповядвали	Voice
ушилият	брани	Tense
най-отлични	кълвачи	Case
срещани	сестриците	Number
най-предпазливият	по-предпазливата	lemma
предящ	анатемосваме	Tense
обещаха	вярваш	Mood
насичалата	запалващи	Voice
подслушваше	адресирай	Person
допрочетох	навлекат	Mood
преживяването	преживяваната	lemma
пиявицата	най-анонимни	Number
прегърнах	зърно	Number
живеният	обрекоха	Tense
най-червената	най-червените	lemma
по-абаносовите	най-абаносов	lemma
примираш	преживявахме	Mood
навестявахте	затичайте	Person
по-възможните	най-възможен	lemma
повтарящите	измело	Voice
завлякъл	отключващите	Voice
ухапвали	счупваното	Tense
уволнявахме	омете	Mood
оцелялото	оцеляло	lemma
наводнявахме	въвлече	Mood
заметохме	замитало	Tense
набожданият	набождайки	lemma
простят	погледнах	Mood
бойци	арменски	Case
убедя	убедила	lemma
съветващия	слушали	Voice
втечнявай	по-вещия	Number
надебелееха	залязлото	Tense
бактериолози	запалват	Number
напреднели	нанесената	Tense
очакващия	очаквани	lemma
опридащите	възлизала	Voice
нагребвате	изковаващият	Tense
най-хоризонталния	пречупвало	Number
отсъстваше	казваме	Mood
недостатъчни	печати	Case
делящо	дели	lemma
ходели	раняванията-нетата	Number
безмилостна	узакони	Number
компетентни	джамиите	Number
преживееше	обесвай	Person
съществуваме	съществуващо	lemma
пренасяхме	тичаш	Mood
чуха	убило	Tense
произнесете	обезсмъртеше	Mood
наплелото	наплело	lemma
начитахте	затичайте	Person
кладеш	обезсмърти	Person
почитах	повтаряте	Mood
навреният	предсказваха	Tense
възпрели	изтичате	Number
закупувалото	закупувалия	lemma
изминаха	потичалият	Tense
дометат	допрочетеше	Mood
напредвах	изковавалите	Tense
по-надколенните	по-надколянно	lemma
играното	принесяха	Tense
изковаваните	ухапва	Tense
здрави	биволи	Case
по-действителни	биокомпютри	Case
пренасяният	пренасяйки	lemma
изпий	отнасяше	Person
студентстващи	подвеждалото	Voice
обвинят	чукундури	Number
най-водоравния	заподозирано	Number
отричай	пренасяше	Person
опиралия	заспиваха	Tense
живеният	изчитахме	Tense
извлечахме	подмиталия	Tense
поопичахте	възпираният	Tense
подслушва	вдишахте	Mood
изплетеният	изминеха	Tense
изслушан	злоупотребяхме	Tense
искащ	искат	lemma
давали	наемах	Tense
спираните	бегли	Number
допринеса	подвеждахте	Mood
здрави	глави	Case
предящ	повеждат	Tense
чуваш	изгубвалата	Number
пишещо	писа	lemma
поборника	язовеца	Number
запирайте	изпечахте	Person
закупените	поглежда	Tense
разплакват	ранеше	Mood
драки	решите	Number
написващите	ставал	Voice
надебелявало	избодяха	Tense
извлеклият	дециметър	Number
изчетете	надонесе	Mood
заоравахме	заоравано	lemma
потъналият	потънал	lemma
по-кукувичият	отбодеше	Number
надонесохме	затичала	Tense
вземаха	преживееш	Mood
важни	воли	Case
анулирах	унесат	Mood
най-глупава	глупаво	lemma
аксиоми	джамиите	Number
най-искрена	искрено	lemma
повтарящите	прочетяла	Voice
заспа	намекнат	Mood
алжирки	най-второразредни	Case
преведем	преведе	lemma
пренася	дадем	Mood
интересуваме	заплита	Mood
влезлия	завличахте	Tense
най-земетръсно	изпявалата	Number
алхимички	надколенни	Case
обезглавява	начетен	Number
кош	почитащата	Number
обзаведеше	разболеете	Mood
съветвала	надонасящите	Voice
наследяващо	наследява	lemma
изплитай	живя	Person
по-проницателно	по-проницателни	lemma
купуващ	купуващи	lemma
изпявана	шибахме	Tense
почитана	почитали	lemma
закусващите	навела	Voice
бушуващата	отключите	Tense
обезглавявам	съзирахте	Mood
заковаваме	простеше	Mood
зашития	чупехте	Tense
дебели	абсурдната	Number
зидарки	лесе	Case
университете	отци	Case
обесили	поглежда	Tense
преживееше	изгребвай	Person
падахте	господарувало	Tense
отсичало	довличаните	Tense
заредена	цупенето	Number
най-мускулни	алебарди	Case
снеса	снеслите	lemma
полето	скуо	Number
надвнесяхме	почете	Mood
бягай	отнасяше	Person
ставано	ставала	lemma
лекцията	ебане	Number
автономии	най-предпазливи	Case
срещащ	срещащи	lemma
продават	допринася	Mood
създаваше	оцелеем	Mood
въвлечахте	бесеното	Tense
попечели	продаващият	Voice
принуждавахме	тичаш	Mood
препичащ	радеех	Number
адмирали	германски	Case
по-аметистови	устни	Case
протечахте	коронясвайте	Person
уволнявало	убиващите	Voice
разбираше	пуши	Person
разбра	поднесат	Mood
ходих	плащали	Tense
изчитайте	удовлетворявате	Person
пастири	най-второразредни	Case
подпряната	обесехме	Tense
оцветяващият	оцветявалото	lemma
зидарки	осо	Case
обезглавиш	бойлерът	Number
нахапваха	кориш	Mood
будало	адове	Case
подчертали	биех	Tense
вдишвалото	вдишвалия	lemma
надвнесена	надвнесели	lemma
предричайте	заченехте	Person
използващия	използвани	lemma
зачитания-нета	зачитайте	lemma
наобличаш	заченеха	Mood
изпитваха	режа	Mood
граничат	потъва	Mood
подкладете	занесях	Mood
клади	възпреше	Person
обвинявали	спрения	Tense
презираш	тичаха	Mood
ушиваща	ушивалите	lemma
пуши	нахапят	Mood
изреваващо	изревава	lemma
заплетоха	зачета	Mood
по-разсъдителните	по-разсъдително	lemma
сънувахте	убивам	Mood
подведе	подведения	lemma
чу	казваме	Mood
омела	запридаха	Tense
поспирахме	поспирайки	lemma
изковавалият	изковаванията-нетата	lemma
отваря	изсеклият	Number
заоравания	свирахте	Tense
надвнесе	понавлез	Person
бойци	южняко	Case
обилни	пуйки	Case
уплашваше	намекнат	Mood
начитахте	повлечете	Person
бойци	сило	Case
смазаното	заподозираха	Tense
изминава	изминавания	lemma
измамо	чираци	Case
по-вертикалната	отбодеше	Number
по-изпълнимо	по-изпълними	lemma
изреваваме	абсолютизирания	Number
зими	глупави	Case
танцувай	изслуша	Person
предсказаха	мускули	Number
снасящите	обвиняло	Voice
пести	рачили	Tense
пронасящия	пронасяни	lemma
мажа	зъбеца	Number
американска	обича	Number
изгризвала	обрекоха	Tense
ползвана	предсказваха	Tense
заспа	завеждат	Mood
одобрихме	спрения	Tense
най-разсъдливи	надежди	Case
изневери	най-господарски	Case
измитаният	измитайки	lemma
клади	поотича	Person
сънувала	сънувах	lemma
наводни	понавлез	Person
построявалото	затекохте	Tense
дебели	убива	Number
простят	прегръща	Mood
по-македонските	най-македонски	lemma
безбройни	бъзли	Case
въвряхме	въвлече	Mood
допрочитало	преживяхме	Tense
препрочиталата	напредвахме	Tense
създавала	зъбеца	Number
препоръчваше	препрочетете	Mood
пристигнат	отсъствах	Mood
възляза	удовлетворявахте	Mood
преживеехме	нанасяш	Mood
безбройни	бедняци	Case
ближехме	наводнен	Tense
прехапвахме	чества	Mood
четящата	чела	lemma
запираше	зачитащото	Number
виждалите	узаконеше	Tense
изплетеният	съчетавахте	Tense
ядат	прелъстеше	Mood
бягай	мечтаеше	Person
закусим	използваше	Mood
бакалаври	котко	Case
уплашвахте	въвлече	Mood
предсказващи	наводниш	Tense
аргати	глупави	Case
казвалите	сприятеляващо	Voice
най-жълтият	по-жълтата	lemma
загива	честваме	Mood
алжирки	дворецо	Case
довлечеше	ебане	Number
пуши	лижат	Mood
анатемосат	наклаждах	Mood
засичаше	произнасяй	Person
извлечахме	изгубеното	Tense
загивал	обсъдихме	Tense
отрекохме	възпираният	Tense
пасена	давалите	Tense
обковавах	отхапалите	Tense
организмът	по-абсурдни	Number
агрохимичко	камъни	Case
охраняваха	насметяло	Tense
обрекли	ограничената	Tense
пронася	пронасяния	lemma
изминато	изминела	lemma
купувай	адресираш	Person
охраняваните	спрях	Tense
биете	забраняващ	Tense
отсичането	отсичаната	lemma
създадем	създаде	lemma
казвалите	разбирано	Tense
пожари	шофьоре	Case
излезете	пътуваше	Mood
изчитащия	изчитани	lemma
разнеслия	заспиваха	Tense
опиралия	заподозираха	Tense
заслужи	произнасяй	Person
втечняваната	принесяха	Tense
грешим	греши	lemma
подпираните	подпираха	lemma
поизметяло	въвличащите	Voice
поднесели	опечеше	Tense
бившето	по-бивше	lemma
отключи	разлюбваме	Mood
озадачавайте	изпридахте	Person
отбодени	мъже	Number
напичала	напичаше	lemma
прочели	плачещата	Voice
единадесети	овни	Case
изковаваха	унищожавалата	Tense
опиранията-нетата	опира	lemma
горите	съществуващия	Tense
прости	озаглавилият	Number
плашещи	плашещите	lemma
изминели	берящата	Voice
вземаха	подмета	Mood
обясните	присъствах	Mood
университети	аварко	Case
заченат	забрави	Mood
инфантилни	зъби	Case
дълго	бие	Number
посещаваните	разболявах	Tense
излезете	убих	Mood
замитаха	убивам	Mood
говоренето	говорилото	lemma
охраняваните	заведяла	Tense
преживеехме	господарстваш	Mood
разплаче	попичания	Number
продават	забрави	Mood
повярва	намекнат	Mood
клади	зачете	Person
пронасяща	заспивалите	Voice
интересуващия	интересувани	lemma
произтича	започнехме	Mood
гласуващият	довлекли	Voice
пастири	по-храбри	Case
понесяло	навличащите	Voice
опридана	наклаждащият	Number
принуждавахме	загине	Mood
красиви	устни	Case
най-възможни	венци	Case
написващите	избождал	Voice
заведеното	заведено	lemma
провира	плачехте	Mood
важни	венци	Case
свираме	изговореше	Mood
поопичаха	възпираният	Tense
предупреди	прочетени	Tense
победим	загубва	Mood
оцветели	нахапех	Tense
обучаваните	обучаваха	lemma
изплетеният	грешихте	Tense
убедеше	прегърнат	Mood
разлюбеното	пристигнехме	Tense
препичахте	зачета	Mood
озадачавало	предсказваха	Tense
инвестирах	унесат	Mood
вечерят	вярвах	Mood
получавайте	лизахте	Person
обсъжда	лижат	Mood
подробни	пуйки	Case
изреваващо	изревавах	lemma
препрочиталата	обесехме	Tense
въоръжаващо	въоръжавах	lemma
препоръчваме	пътуваше	Mood
избирал	надонасящите	Voice
комбинирало	преживяхме	Tense
пренасяното	обзаведе	Number
привнесеното	привнесено	lemma
принеслата	запалвани	Tense
вожд	по-железния	Number
написахте	почете	Mood
принудех	унесат	Mood
по-авторитарно	наклаждащият	Number
пристигне	прелъстявахме	Mood
въвлечахте	изгубеното	Tense
възпиране	убива	Number
подслушва	допирахте	Mood
убеждавате	отвежда	Mood
учила	боя	Number
отваря	счупвания	Number
попитвала	шибахме	Tense
повтарящите	ухапвало	Voice
по-ябълковото	уплашвал	Number
построяващ	насечете	Tense
соколе	змеици	Case
най-опитната	най-опитните	lemma
изплашвани	допиралото	Tense
обречените	обречаха	lemma
обвинят	сестриците	Number
надвнесоха	подмета	Mood
телефониращ	сядаме	Tense
аргати	енергични	Case
разболее	прелъстихме	Mood
небесносини	пристига	Number
пренасяхме	пренасяйки	lemma
изпиеш	захапващи	Tense
заковаваме	допичаше	Mood
най-автоматична	автоматично	lemma
горят	изпитваше	Mood
назоваващ	назовават	lemma
здрави	екзарси	Case
създаваше	господаруваме	Mood
чуваш	асириец	Number
обсъди	пристига	Number
съзирахте	обесвайте	Person
построявалото	начитахте	Tense
обвинявано	ушиха	Tense
авансе	шефове	Case
говорил	изминеха	Tense
гласувате	присъствах	Mood
отключващ	отключват	lemma
сило	насечах	Number
предсказа	казваме	Mood
изминато	грешихте	Tense
разпростирам	инвестираха	Mood
тресящото	започвали	Voice
компетентностите	победи	Number
обрекли	чупеното	Tense
набождаща	доведете	Tense
одобрявахме	довляклото	Tense
замитащият	закупили	Voice
отключи	унищожавате	Mood
отнасял	озаглавявахте	Tense
убеждаваха	кориш	Mood
навестявах	бастун	Number
ограничават	загиваше	Mood
втечняваната	изгубихте	Tense
най-некадърният	по-некадърната	lemma
обсъди	гневният	Number
получим	получи	lemma
плащаш	навирахме	Mood
отхапаха	създалият	Tense
децилитри	мравко	Case
убедим	реши	Mood
обясняха	злоупотребявало	Tense
обучаваното	озадачавахте	Tense
будещият	ебане	Number
залезела	благодарихме	Tense
избождащи	избождащите	lemma
прости	пречупваше	Number
американска	гласува	Number
заплелия	напредвахме	Tense
по-анасоновите	по-анасоново	lemma
най-испанският	по-испанската	lemma
домита	честваме	Mood
по-сеизмичните	по-сеизмично	lemma
използвания	комбинирали	Tense
чуваш	разболял	Number
допреш	снасяй	Person
визи	най-второразредни	Case
съществувал	посещаващите	Voice
круши	княже	Case
биеше	забременеете	Mood
завлече	вярвали	Tense
потушаващия	потушавани	lemma
полето	бастун	Number
нанасяме	заплита	Mood
недостатъчни	евнуси	Case
дълго	пелият	Number
по-доблестният	най-светлосиня	Number
затрисах	презрете	Mood
заши	обковаваме	Mood
изкупете	убедим	Number
изчитайте	граничехте	Person
зачеващ	анатемосваме	Tense
наизлизащият	желаят	Tense
обясните	затресе	Mood
мряхте	смажете	Person
метях	нараняват	Mood
възпирахме	потресеният	Tense
пасяха	обрека	Mood
заспиващо	омелите	Voice
поглеждаше	донасяли	Tense
кошульо	бъзли	Case
допрочитало	озаглавявахте	Tense
вожд	боя	Number
биеше	захапете	Mood
умното	по-умно	lemma
донасянето	донасялото	lemma
по-трето	по-трети	lemma
попичащо	абсурдната	Number
дай	по-топъл	Number
загубвало	въвираха	Tense
пречупвах	прегърнат	Mood
визи	лесе	Case
инвестирах	заревават	Mood
обучаваното	граничехме	Tense
вряхме	изплашеното	Tense
припирано	презряхме	Tense
започна	започналите	lemma
спиращ	спиращи	lemma
допреше	попечем	Mood
забравиш	снасяй	Person
окрадеш	дъвчехме	Mood
изтърваваха	наказвалият	Tense
построяващото	прегръщате	Tense
желаещ	желаещи	lemma
по-австралийски	бакшиши	Case
повтарящите	дометяло	Voice
закусващите	съобщавал	Voice
вярваш	снесеният	Number
предричащият	озадачи	Number
поопечеше	анатемосате	Mood
възлязлата	обрекоха	Tense
галицизми	отчитайте	Number
довеждащите	коронясам	Tense
извличана	извличали	lemma
забранявана	забранявали	lemma
небесносини	пейзажът	Number
чуй	адресираш	Person
лекарят	гласува	Number
вряхме	нанесената	Tense
виелици	глупави	Case
припирано	кладяха	Tense
съчетаващи	давалата	Voice
анакондо	глави	Case
изреваващият	започвали	Voice
граничат	вдиша	Mood
примираше	мечтаем	Mood
наплетем	припреше	Mood
доведохте	изсеклия	Tense
ограничават	зачитах	Mood
обезсмъртявания-нета	обезсмъртявате	lemma
обличахме	одобри	Mood
ограничавам	ограничавала	lemma
чуваш	обучавано	Number
преживяното	преживяно	lemma
пасени	бедничките	Number
арбитре	шипки	Case
премряхме	креативните	Number
искащият	искалото	lemma
озаглавявахме	занасяло	Tense
обсъден	отключваха	Tense
обличали	търтеи	Number
убеждавахте	подкупва	Mood
по-зелен	наобличалото	Number
мрелите	ушиеше	Tense
ядосани	пуйки	Case
чуха	говориш	Mood
обичащ	обичат	lemma
ограничаваха	спечеш	Mood
загиваща	счупвания	Number
причинилият	причинил	lemma
алжирки	авансови	Case
лесна	най-абстрактният	Number
най-съгласни	агрохимици	Case
анулирала	изминеха	Tense
даваше	казваме	Mood
живеният	съчетаха	Tense
здрави	камъни	Case
тичахме	тичайки	lemma
изковаваха	обричано	Tense
избирани	мечталият	Tense
визи	арменко	Case
нанасяме	прощава	Mood
най-съгласни	бели	Case
набоди	по-недостатъчна	Number
засичалият	засичанията-нетата	lemma
честитяла	честитях	lemma
интересуваме	препичаше	Mood
дебелях	саркастично	Number
наследявай	одобряваш	Person
най-хоризонталния	абсурдна	Number
драконе	автоматистрали	Case
търсещо	търси	lemma
презират	подписах	Mood
препоръчваше	доплитате	Mood
наводнявате	спасявайте	Person
доплитането	построявал	Number
захапехме	захапано	lemma
навестяхте	изплаша	Mood
близичките	по-важни	Number
адмиралите	котараци	Number
помагам	помагала	lemma
очаквала	очакваше	lemma
спрете	отвежда	Mood
прелъстявах	поотеклите	Tense
изсечени	надебелява	Tense
гвоздею	шипки	Case
избирана	избирали	lemma
черни	биволи	Case
гласуващото	довлекли	Voice
омитахме	омитайки	lemma
извлечахме	прочело	Tense
доказвахме	оцветила	Tense
накажело	убиващите	Voice
заспал	поопичащите	Voice
поизметяло	поопичащите	Voice
нови	въвряха	Number
охраняваните	поглежда	Tense
счупите	пейте	Person
университете	алгоритми	Case
заплашете	забодяхте	Person
танцувам	танцувала	lemma
намекнах	охранявате	Mood
опасъл	съчетахме	Tense
смазали	обличащото	Voice
засича	казваме	Mood
написаният	създавахте	Tense
най-сив	врабчето	Number
розо	езици	Case
окрадеш	глобихме	Mood
поопечели	съобщаваме	Number
наводнени	завлече	Tense
нараняващ	нараняващи	lemma
здрави	надежди	Case
най-възможни	глави	Case
доктора	затеклите	Number
изпридали	надонасяната	Tense
автоблокировки	най-ароматни	Case
аплодираме	гореше	Mood
обезсмъртявахте	смажете	Person
обяснявани	драки	Number
обилни	шипки	Case
обвинявали	изнесе	Tense
заповядвали	изречената	Tense
напича	най-анонимни	Number
отключващия	отключвани	lemma
предсказа	унищожавате	Mood
почитам	инвестираха	Mood
продавачки	бързички	Case
сприятеляваш	изчитай	Person
спирахте	срещайте	Person
причиняването	причинявалото	lemma
разплачехте	спасявайте	Person
извеждания-нета	извеждайте	lemma
уволняха	пронасям	Mood
изковавате	наклаждах	Mood
наклаждаха	подмета	Mood
шантажиращият	наобличаме	Tense
прозират	побеждава	Mood
най-бърза	по-железния	Number
поопичаме	поопича	lemma
прочитащо	прочита	lemma
живеещите	оцелявало	Voice
по-далечните	по-далечно	lemma
взема	бастун	Number
ползвахме	изгребвалата	Tense
изведяхте	одобри	Mood
наследяващ	наследяват	lemma
колачко	шефове	Case
работещо	работех	lemma
най-македонска	македонско	lemma
заслужавай	плати	Person
будало	биволи	Case
отваряния-нета	отваряте	lemma
най-земетръсно	попичания	Number
влизащ	влизащи	lemma
говорила	наведяхте	Tense
пиявицата	предсказва	Number
студентстващи	отичалата	Voice
купувай	отвори	Person
заченалият	заревавам	Number
заслужавай	зачете	Person
отмираха	пронасям	Mood
можещи	можещите	lemma
по-антипартийни	чираци	Case
по-бившата	най-бивша	lemma
подпишехте	убивам	Mood
сравнилото	прощаващи	Voice
влизали	двубоите	Number
по-анасонови	автоматистрали	Case
обичам	обичала	lemma
изтичам	изтичала	lemma
купувай	живя	Person
подмитаният	подмитайки	lemma
разбралото	разбралия	lemma
навестях	навестеното	lemma
южняци	германски	Case
възпирахме	лягало	Tense
потушах	подмиталите	Tense
измрем	измря	lemma
препоръчваше	изкупим	Mood
пекари	сило	Case
подобрена	намекнехме	Tense
забраняваха	ограничената	Tense
по-абатските	най-абатски	lemma
агенти	лесе	Case
пръчки	лесе	Case
стана	станала	lemma
бралите	опасваща	Voice
по-съвършените	най-съвършен	lemma
американска	боядиса	Number
арестуваният	арестувайки	lemma
примря	нагризвай	Person
прозират	назовавах	Mood
запряно	изминеха	Tense
предричащо	изковавалите	Voice
дебели	врабчето	Number
захапвана	изчезването	Number
потресла	намекнехме	Tense
чуха	оцветила	Tense
черни	горелки	Case
разболее	подклаждахме	Mood
тича	пейзажът	Number
превеждаш	наведяхме	Mood
построявахме	забодеш	Mood
подслушат	прелъстеше	Mood
обречете	изговореше	Mood
деляхме	делейки	lemma
пронесат	изпитваше	Mood
очакваща	припадалите	Voice
излезеш	гласуваха	Mood
обковаващата	обковавала	lemma
загребвай	припреш	Person
спряха	подобряла	Tense
заковаваме	подмиташе	Mood
продължаващият	навестят	Tense
храсти	сило	Case
опасъл	чупехте	Tense
премираме	премира	lemma
загива	препрочетете	Mood
донася	произлизахте	Mood
изковавате	поотечеше	Mood
изпридал	грешихте	Tense
изслушвалият	обсъдихме	Tense
втечняваната	попечахте	Tense
заповядан	затекохте	Tense
пращаше	унищожавате	Mood
южняци	петльо	Case
правите	пейте	Person
подобри	решиш	Person
най-водоравни	алгоритми	Case
забременялото	затекохте	Tense
препекохме	прочита	Mood
най-набожната	чакал	Number
заспал	отключващите	Voice
поизмиташе	по-усърдна	Number
зашива	създадем	Mood
ползва	обковаваме	Mood
най-неопитните	пушехте	Number
круши	северняко	Case
черни	номера	Case
пекари	енергични	Case
университети	германски	Case
сравнява	засечените	Tense
излезеше	заспивате	Mood
беряхте	коронясвайте	Person
отчитащ	отчитащи	lemma
гърцизми	осо	Case
повтаряхте	могло	Tense
омита	кървихте	Mood
изпичането	изпичалото	lemma
убиваме	убива	lemma
разплакващата	разплаквала	lemma
морковът	капал	Number
надвнасяхте	изсеклия	Tense
пристигал	обсъдихме	Tense
затичахме	говори	Mood
учила	узакони	Number
бежанки	наизлизахте	Number
повярвате	млъквайте	Person
източни	бие	Number
подкупвалият	пренасяхме	Tense
въвличах	биете	Mood
забравяло	пристига	Number
избирани	закусвах	Tense
унася	довличаните	Tense
взема	зъбеца	Number
обилни	змиорки	Case
заспа	препрочетем	Mood
сияела	сияех	lemma
побеждаващият	заповядвали	Voice
уби	арестували	Tense
измамо	нанолитри	Case
допринесяхте	въвлече	Mood
най-интересни	родини	Case
ограничават	заплита	Mood
взема	наеми	Number
обвинят	бегли	Number
полудявахме	сприятеленото	Tense
подкупващата	подкупвала	lemma
овце	лесе	Case
отмираме	отмиращо	lemma
понапичащите	ял	Voice
предплатеше	господаруваме	Mood
слизащ	слизат	lemma
прегърнем	клюнове	Number
разлюби	изпридате	Mood
принуденото	арестували	Tense
забодях	забоденото	lemma
пишеха	искрените	Number
жабарю	по-продаваческото	Number
припирано	зареклите	Tense
избола	убиващите	Voice
изплитай	изговаряше	Person
простря	прострения	lemma
обясните	заредеше	Mood
биеш	боя	Number
отведеш	благодаряха	Mood
падахте	прочело	Tense
ходих	арестували	Tense
спестяла	боя	Number
подчертали	изнесе	Tense
размени	италиански	Case
пристигнат	убих	Mood
помели	започваното	Tense
по-гребната	най-гребна	lemma
очаквах	комбинирали	Tense
спираните	тухли	Number
закупените	завлече	Tense
навестявах	келнера	Number
поопичаха	обосновавала	Tense
инвестирах	заплашат	Mood
адмиралите	нанесат	Number
засичахте	режа	Mood
овце	най-саркастични	Case
доведохте	отхапван	Tense
по-серните	по-сярно	lemma
доплитането	разпростреше	Number
заметохме	обосновавала	Tense
отрекохме	помитаното	Tense
прости	азербайджанец	Number
най-августейша	августейшо	lemma
центрове	чучулиги	Number
обесете	заченехте	Person
важни	пуйки	Case
вярваш	испанският	Number
по-възможните	по-възможно	lemma
монаси	арменски	Case
аплодираме	аплодира	lemma
обясните	разплаква	Mood
повярваха	чисти	Number
по-неизкусно	по-неизкусни	lemma
отварящите	коронясам	Tense
арки	мравко	Case
по-невярно	по-неверни	lemma
заредена	победата	Number
спиралият	спирал	lemma
виждалите	обричано	Tense
треторазредни	най-кратка	Number
слушахме	подкупва	Mood
продаващ	продаващи	lemma
арбитре	горелки	Case
надвнасяла	чувахте	Tense
биете	желаещия	Tense
загребваните	подобряла	Tense
благославяна	купувахме	Tense
принеси	забраняваш	Person
ушиващият	ушивалото	lemma
подчерта	подчертания	lemma
подмитащ	подмитат	lemma
понапичалата	мярко	Number
по-крив	наплитащата	Number
падате	закусваше	Mood
повлякло	чупехте	Tense
по-летни	печати	Case
по-коремно	по-коремни	lemma
тръгваща	желаят	Tense
забременявах	разбирани	Tense
припеви	шипко	Case
донесях	най-кадърни	Number
възлязлата	плетяха	Tense
виненията-нетата	вини	lemma
дебели	насмети	Number
принасям	принасялите	lemma
изкупи	пълен	Number
изчезвала	посещаващите	Voice
ограничават	отключех	Mood
съчетаващия	съчетавани	lemma
граничат	вярвах	Mood
подкупвалият	радееха	Tense
безделничеха	надвнесеният	Tense
продаваше	оцелеем	Mood
псувньо	шипки	Case
падането	падалото	lemma
помагали	завлече	Tense
изтечете	прелъстите	Person
заплашвахте	закуся	Mood
най-алените	икони	Number
италианци	енергични	Case
разплаче	по-вещия	Number
мачове	италиански	Case
бедуинки	бозайници	Number
отсичана	отсичали	lemma
кладе	изчезването	Number
пожари	враже	Case
заредяхте	презирайте	Person
спирахте	напечете	Person
по-земетръсното	убива	Number
начетяла	начетеше	lemma
погребвахте	боядисваната	Tense
пушещи	бозайници	Number
комунистко	горелки	Case
допечете	подобрете	Person
зачиташ	изпредохме	Mood
получавахте	чества	Mood
пикаещата	чупили	Voice
заричате	печати	Number
прегърнем	двубоите	Number
надвнасяла	аплодирахте	Tense
домитай	поотича	Person
зачиташ	дъвчехме	Mood
чуй	дои	Person
приятелки	най-предпазливи	Case
сравнява	плащали	Tense
лягащ	лягащи	lemma
превъзнесе	снесяхме	Mood
ограничете	бушувахте	Person
унищожавахме	преживееш	Mood
най-прясна	прясно	lemma
въвлече	поспирай	Person
узаконяхте	затичайте	Person
арестувалата	ушиха	Tense
заподозирали	заспа	Tense
надвнесе	произнасяй	Person
по-слабия	предсказва	Number
навличам	допирахте	Mood
примрелите	интересува	Tense
анулирала	пристигнехме	Tense
бягай	отключи	Person
отсъствай	залязваш	Person
сило	спряло	Number
сравняваха	закуся	Mood
захапвана	най-дяволския	Number
понавлезете	подобрете	Person
ограничаващ	ограничават	lemma
вертикално	игралият	Number
решаващ	решаващи	lemma
заспива	келнера	Number
врящата	заревавали	Voice
по-овчата	най-овча	lemma
изпридаме	изпридащо	lemma
вселена	гласува	Number
танцувай	провреше	Person
балкане	радиоцентрове	Case
главо	кълвачи	Case
по-дълбоко	по-дълбоки	lemma
подведат	забрави	Mood
повтарящите	желала	Voice
астероиди	шофьоре	Case
овцо	автоматистрали	Case
купувала	казваха	Tense
сило	боя	Number
виелици	авансови	Case
спряха	изгубеното	Tense
произтекохме	произтечахме	lemma
отлично	гласува	Number
пушите	запалваща	Tense
понеслата	наведяхте	Tense
ползването	ползваната	lemma
зашивалото	зашивало	lemma
бомбардирах	препрочетете	Mood
повлича	плащали	Tense
измитах	поднесат	Mood
вожд	плаша	Number
съветващия	закупили	Voice
пръчки	котко	Case
подвеждалото	подвеждалия	lemma
построяващ	сприятелявате	Tense
овце	сило	Case
центрове	снесените	Number
повторил	предскаже	Number
донесеш	обезсмърти	Person
зашивало	навличащите	Voice
допрочетох	отсъствате	Mood
въоръжат	забраняващ	Tense
анатемосате	въоръжаващ	Tense
вожд	пейзажът	Number
пристигне	обзаведохте	Mood
изминаващият	довлекли	Voice
по-болногледаческата	най-болногледаческа	lemma
прегърнем	търтеи	Number
озадачавало	шибахме	Tense
звере	змиорки	Case
извлечи	мечтаеше	Person
срядо	родини	Case
преживявано	най-неузрелия	Number
отбодени	мускули	Number
написахте	говори	Mood
изпивани	разнесях	Tense
потичаща	мъртви	Number
спрете	запече	Mood
заслужиха	авансиралият	Tense
изтечаха	отвличаш	Mood
изпасвахме	аблактации	Number
лекарят	североизточни	Number
построиш	изчитай	Person
уплашваше	унесат	Mood
зареваващ	заревават	lemma
чака	нараняват	Mood
купувай	пренасяше	Person
изметено	изминеха	Tense
вдишващо	вдишвах	lemma
виждащият	влезех	Number
изпивани	разболявах	Tense
небесносини	опираща	Number
спирахте	пейте	Person
благословяха	разпростра	Mood
заслужавахте	изберете	Person
спестяваме	разпростиращия	Tense
анатемосваме	побеждава	Mood
упреквалия	заметяха	Tense
привнеси	изслуша	Person
обсъждана	обсъждали	lemma
бягаше	презрете	Mood
даваше	създадат	Mood
заоравания	тръгваха	Tense
протечахте	допринасяйте	Person
арки	княже	Case
зарича	залязваме	Mood
поглеждал	отключващите	Voice
зачитаха	бозайници	Number
мразеща	мразилите	lemma
битият	биейки	lemma
най-лилава	насечах	Number
желайте	принуждавахте	Person
съществуващо	съществува	lemma
дебели	платено	Number
отнесеше	съзрете	Mood
недостатъчни	надежди	Case
решава	сравнят	Mood
пекари	осо	Case
по-студено	по-студени	lemma
изпиващо	написалите	Voice
инфантилни	бели	Case
доказвахте	припаднете	Person
навеждалият	кралю	Number
можа	закусваме	Mood
съчетаващи	рачилия	Voice
загива	повтаряте	Mood
по-чудесния	насечах	Number
поборника	запичаха	Number
наизлизащото	чупили	Voice
подкупилото	подкупило	lemma
повторехте	креативните	Number
срядо	алебарди	Case
въвирана	по-абсурдни	Number
преживеехме	надебелее	Mood
обяснявал	врабчето	Number
слушащата	слушаш	lemma
отсичащи	понавлизаш	Tense
арки	дъско	Case
абсорбиран	наеми	Number
красиви	евнуси	Case
понапичащите	прелъстила	Voice
изнудехме	опридано	Tense
навличала	навличаше	lemma
обещаващи	търтеи	Number
наричащ	наричащи	lemma
глобете	забранявахте	Person
обесили	помитаното	Tense
чуй	изслуша	Person
бомбардирахте	подвеждана	Tense
избодяхме	избодено	lemma
строим	строи	lemma
заподозирали	навираното	Tense
побеждаващият	ушивали	Voice
изпивани	донесеше	Tense
зачеваните	зачеваха	lemma
съчетаващият	съществувате	Tense
книги	по-други	Case
по-авиационните	най-авиационен	lemma
снеслият	снесъл	lemma
по-инфантилните	по-инфантилно	lemma
пренесеш	заповядахме	Mood
наплетем	зареваваше	Mood
размени	котко	Case
помагали	ограничената	Tense
прозират	забрави	Mood
кладящия	кладени	lemma
най-азотни	воли	Case
по-авантюристични	обезсмъртя	Number
разпростираният	разпростиралата	lemma
нанасящия	наводнели	Voice
завлечало	завличахте	Tense
алжирки	най-светли	Case
отвеждали	получаващия	Voice
автономии	беднички	Case
обвинят	режели	Number
разлюбеното	разнасяли	Tense
пръчки	гренландецо	Case
вожд	врабчето	Number
злоупотребят	заплита	Mood
бъбреко	по-топъл	Number
плетенето	плелото	lemma
изляза	излязла	lemma
назовавал	потушаващите	Voice
закусила	сврените	Tense
произлизах	прелъстените	Tense
злоупотребихме	зре	Mood
единадесети	чираци	Case
болногледачки	най-аборигенски	Case
желаех	желаното	lemma
напредвах	унасяли	Tense
нанасяме	забрави	Mood
източни	най-слабата	Number
победим	разплаква	Mood
запреният	запрялата	lemma
зареждащ	зареждащи	lemma
вечерящата	обезсмъртяват	Tense
инфантилни	цици	Case
виждаше	отмирай	Person
изковаваха	причинявано	Tense
опридана	скуо	Number
насичаше	обещавали	Tense
дълго	испанският	Number
заболото	заболия	lemma
съчетаващият	оцелеят	Tense
обричаха	драки	Number
давали	изчете	Tense
ставащият	обосновавали	Voice
опридащите	закупило	Voice
подведени	пронесеше	Tense
обясните	заврях	Mood
абсорбиран	змею	Number
пушите	запече	Mood
легализираният	съчетавахте	Tense
възлязлата	начетохте	Tense
най-доблестният	по-доблестната	lemma
закупените	принуждава	Tense
свираме	допрочетеше	Mood
полето	пълен	Number
розо	воли	Case
прочитаните	разходило	Tense
оцветиш	коронясваха	Mood
бягай	изслуша	Person
даваше	оцелеем	Mood
повтарялото	повтаряло	lemma
телефониращ	отключите	Tense
по-пълната	най-пълна	lemma
избодеше	опичате	Mood
загребваните	избоде	Tense
свираме	получаваше	Mood
възпиращите	протекло	Voice
подкупваният	кралю	Number
обвинявали	ограничената	Tense
красиви	документи	Case
потичащите	чуло	Voice
сравнилото	сравнилия	lemma
подслушвайте	нагризвахте	Person
обзаведа	повторихте	Mood
отсъстваше	изпридате	Mood
единадесети	пуйки	Case
намекналият	анилиново	Number
превежданият	превеждайки	lemma
спасявал	изминеха	Tense
пристигнахме	заспива	Mood
прочели	получаващия	Voice
балкане	глави	Case
честват	плетящо	Tense
съзирахте	повлечете	Person
университете	шипки	Case
гласувате	изпича	Mood
зареждах	изпридате	Mood
прозират	прощава	Mood
най-къртичият	по-къртичата	lemma
токсичните	нанесат	Number
отчитащи	отчитащите	lemma
пометете	срещайте	Person
овце	шофьоре	Case
говорените	заспа	Tense
университете	воли	Case
озадачавало	изминеха	Tense
озадачавало	злоупотребяхме	Tense
тръгва	обезсмърти	Person
смазаното	предсказваха	Tense
предсказа	биете	Mood
привнеси	прочетеше	Person
надвнасяхте	нагризвана	Tense
злоупотребяват	зашиех	Mood
пренасяното	шофьорка	Number
изчезнало	напредвахме	Tense
попитвала	обзавеждаха	Tense
коронясващото	потекли	Voice
раняваният	ранявайки	lemma
инфантилни	шефове	Case
по-гребни	биокомпютри	Case
произтичахте	допирала	Tense
скучни	гейовете	Number
най-яйцевидно	влезех	Number
нанасящия	заревавали	Voice
започнеш	погледни	Person
обезсмъртявали	принуждава	Tense
най-лилава	пречупваше	Number
поопичаха	запичаната	Tense
разбра	причиним	Mood
изслушващо	изслушва	lemma
сравнило	навличащите	Voice
най-неопитният	по-неопитната	lemma
питам	плачехте	Mood
обличайте	повярвахте	Person
най-летни	влезех	Number
надонесохме	спечеш	Mood
повлякло	шибахме	Tense
единадесети	езици	Case
по-австралийско	по-австралийски	lemma
обеси	по-алкохолната	Number
наводнени	ухапва	Tense
по-обилните	най-обилен	lemma
бедуинки	оцветените	Number
надвнасяла	запалваха	Tense
арестувалата	изпичаха	Tense
подобрена	писалите	Tense
доброто	съобщавана	Number
ядат	пренасях	Mood
осиновяваща	осиновявалите	lemma
глобете	пронасяхте	Person
зашивало	потушаващите	Voice
по-писателски	венци	Case
абаносовата	слизам	Number
изреваващият	излезели	Voice
подобри	свира	Person
измитащо	измитах	lemma
аргати	жълъде	Case
чуваш	кралю	Number
коронясвало	отсичахме	Tense
корящия	започвали	Voice
даващ	даващи	lemma
помагали	купуваното	Tense
отчетения	винящо	Number
снасящите	възлизала	Voice
скучни	отчитайте	Number
нанасяме	вижда	Mood
падахте	довляклото	Tense
мечтано	казваха	Tense
вряхме	наемания	Tense
напреднели	изчете	Tense
вратовръзка	по-решителната	Number
желаеше	отхапалите	Tense
препрочитащо	надонасялите	Voice
виждаше	изчитай	Person
чу	закусваме	Mood
отрека	отрекла	lemma
по-антипартийни	шипки	Case
пренесеш	оцветяхме	Mood
попичащо	наплитания	Number
гласуващото	препоръчали	Voice
чуй	изговаря	Person
запаля	абсурдна	Number
обичах	подметените	Tense
пречупващи	тичалия	Voice
обрекли	спрях	Tense
закупените	обещавал	Tense
опридането	опридалото	lemma
разбирали	моленията-нетата	Number
замираше	погледни	Person
лижете	бедничките	Number
домита	надебеляват	Mood
нанасяме	реши	Mood
закусващите	прочетяла	Voice
ставащ	стават	lemma
злоупотребят	упреквах	Mood
засичам	носороже	Number
заричате	доведени	Number
обезсмъртяваха	втечнявалият	Tense
възпиращите	обзаведяла	Voice
отсякохме	грабиш	Mood
нагризва	честваме	Mood
отвлече	оцветяхме	Mood
южняци	по-първоразредни	Case
по-батарейните	по-батарейно	lemma
окрадена	заспиваха	Tense
най-решителната	най-решителните	lemma
изпиеха	говориш	Mood
изнудваният	изнудвайки	lemma
по-разсъдливата	най-разсъдлива	lemma
пренасяна	пренасяли	lemma
помагащо	помага	lemma
счупвате	припечеше	Mood
наводнени	зачетох	Tense
решава	прегърнат	Mood
вряхме	наводнен	Tense
изговарям	ограничаван	Number
ядат	допринася	Mood
унесеното	унесено	lemma
доплитаха	нанеса	Mood
наклажда	зачитащото	Number
хомосексуално	студентстващата	Number
излезеш	дометяхме	Mood
отричахте	смажете	Person
зарича	изсичат	Mood
обличайте	забременявахте	Person
италианци	сило	Case
насичащото	изслушали	Voice
легализирах	прелъстените	Tense
учел	най-първоразрядното	Number
заслужавай	прочетеше	Person
получаваше	запалвани	Tense
загивал	граничехме	Tense
злоупотребявах	обзавеждат	Mood
очакваща	гласувалите	Voice
обесете	уволнихте	Person
университете	кълвачи	Case
четящ	четящи	lemma
отвличащ	отвличат	lemma
насмитам	насмиталите	lemma
обясни	възпрени	Tense
поднесете	реши	Mood
извлечахме	озаглавена	Tense
обеси	най-парадоксалната	Number
простят	вярвах	Mood
зрялото	зряло	lemma
най-североизточни	кълвачи	Case
надвнесяло	заспиваха	Tense
нараняваш	поспри	Person
подробни	змиорки	Case
спасявах	отхапалите	Tense
интересувалата	въоръжаващи	Voice
благословиш	заповядахме	Mood
розо	номера	Case
желаният	желаейки	lemma
изговарят	гейовете	Number
забоди	заповяда	Person
допрочелия	обесехме	Tense
припряхте	моленията-нетата	Number
запираше	по-сръбска	Number
построиш	надебелей	Person
поотече	продължите	Mood
създаващ	създаващи	lemma
обеся	обесилите	lemma
превъзнесе	чухме	Mood
по-валидно	по-валидни	lemma
свираме	прощава	Mood
изкупувахме	отхапван	Tense
засичалите	пронесеше	Tense
най-аналната	най-аналните	lemma
биеш	плакал	Number
доказали	мускули	Number
зашития	изгубихте	Tense
надвнесе	нагризвай	Person
нахапващи	нахапващите	lemma
козли	оцветените	Number
пчеларю	шефове	Case
изслушай	подпреше	Person
вковаваше	зареклите	Tense
дотечах	комбинирали	Tense
съчетавах	съчетаваното	lemma
безделничеха	изречената	Tense
прозирането	прозиралото	lemma
заченалите	прелъстяващо	Voice
препрочетох	прегърнат	Mood
граничат	продължи	Mood
влизахте	закуся	Mood
обилни	воли	Case
абразии	джамиите	Number
поизмитащи	поизмитащите	lemma
астролозите	мъже	Number
вземам	вземала	lemma
произтичахте	причинявано	Tense
обезглавиш	по-недостатъчна	Number
приятелки	котко	Case
дебели	изпявалата	Number
благодарящо	благодарях	lemma
абсорбиралото	замряхме	Tense
затичащи	затреслия	Voice
почвалият	корящи	Voice
чуват	отчитащо	Tense
капеше	полудеят	Mood
подведат	изпитваше	Mood
сравнената	заподозираха	Tense
въоръжаваният	изчитахме	Tense
казвате	съществуващия	Tense
най-морскосинята	най-морскосините	lemma
омита	омитания	lemma
безбройни	печати	Case
интересуваме	казва	Mood
най-непоколебима	непоколебимо	lemma
южняци	арменски	Case
чуват	забраняващ	Tense
опича	разнасяли	Tense
построявалото	изчитахме	Tense
автомобилът	забождах	Number
компетентностите	уплашели	Number
съобщаваният	съобщавалата	lemma
окрадват	побеждава	Mood
по-арогантната	запалващо	Number
зими	други	Case
храно	шипки	Case
северното	узакони	Number
препоръчвано	североизточни	Number
наплитало	крадеш	Number
ушилият	чувахте	Tense
боевете	най-пъргави	Number
режеше	обезглавилите	Tense
ближехте	спася	Mood
авансирано	авансирала	lemma
насичащото	забравяли	Voice
горят	опече	Mood
най-предпазливата	най-предпазливите	lemma
лесна	изневярата	Number
обречеш	желаха	Mood
окрал	заподозираха	Tense
героиньо	езици	Case
набоденото	набодено	lemma
запряно	изпичаха	Tense
граничило	припечи	Number
счупвате	заредеше	Mood
втечнявало	потушаващите	Voice
агенти	по-югозападни	Case
чуй	прочетеше	Person
по-земетръсното	най-анонимни	Number
абсорбиралото	грешихте	Tense
запираше	изневярата	Number
купувай	плати	Person
замитаха	подведа	Mood
вълци	двубоите	Number
допринеса	насякохте	Mood
пристигнат	поотекох	Mood
очакването	очакваната	lemma
комбинирали	изпиташе	Tense
съзрели	получаващия	Voice
кладеш	изчитай	Person
затресе	попечем	Mood
почващият	плашели	Voice
по-чудесния	слизам	Number
ползвахме	принесен	Tense
поопичахте	навираното	Tense
по-продаваческо	по-продавачески	lemma
анулирах	купите	Mood
разлюбилият	изпичаха	Tense
можех	купите	Mood
отвлечала	отвлечеше	lemma
подписаното	подписано	lemma
изтърваваха	мразилата	Tense
соколе	венци	Case
горят	вдиша	Mood
адмирали	гъркиньо	Case
посещаваните	принуждава	Tense
изтеклото	изтекло	lemma
отвлече	казахме	Mood
превъзнесохте	платилата	Tense
подслушат	побеждава	Mood
изчитате	спасявайте	Person
събуди	пуши	Person
пуших	благословят	Mood
уволните	пронасяйте	Person
бомбардиранията-нетата	бомбардира	lemma
изплашва	казахме	Mood
благословиш	начитаха	Mood
повярва	обзавеждат	Mood
подобри	изговаря	Person
подробни	печати	Case
можехме	можахме	lemma
излизащия	желаят	Tense
затичащи	въоръжавалия	Voice
можехте	отричам	Mood
телефониращ	съществувате	Tense
разпростирала	свирахте	Tense
запирайте	причинихте	Person
проницателното	по-проницателно	lemma
избирани	преде	Tense
нанасял	заподозираха	Tense
най-североизточни	камъни	Case
изведяхте	подведа	Mood
най-безбройна	врабчето	Number
помелите	пътуващо	Voice
абсорбиралото	намекнехме	Tense
простиралото	простирало	lemma
полудях	повтаряте	Mood
по-токсичен	дебелялата	Number
зачеващ	желаят	Tense
обезглавявам	вдишахте	Mood
по-парадоксалните	най-парадоксален	lemma
лесна	скуо	Number
влизам	влизала	lemma
дълго	бебешката	Number
прехапващият	привнасяте	Tense
обезглавяваният	обезглавявалата	lemma
пишеха	заплитащи	Number
клади	отвежда	Person
примрелите	заспа	Tense
заковаваме	продължи	Mood
наемеш	благодаряха	Mood
чуваше	поотеклите	Tense
ограничават	ранеше	Mood
донася	казахме	Mood
подкупят	изковаващият	Tense
единадесети	шефове	Case
благославяли	поизмете	Tense
секлият	слушани	Tense
децилитри	осо	Case
вярваш	археоложка	Number
окрадена	граничехме	Tense
университете	камъни	Case
оцеляващи	оцеляващите	lemma
въвряхме	заспива	Mood
ядохте	подкупва	Mood
поизмиташе	мярко	Number
разходила	навличащите	Voice
прощаваха	нанасяш	Mood
източни	построеното	Number
набоди	изневярата	Number
посетиш	поспирай	Person
обичаме	забрави	Mood
вдиша	запалвани	Tense
прелъстеното	боядиса	Number
излезете	поопечах	Mood
абсорбираше	изковавалите	Tense
въвряната	завличахте	Tense
анатемосат	засече	Mood
врабче	по-решителната	Number
изсичаха	подведа	Mood
клади	прочетеше	Person
убеждавате	провирах	Mood
обвинявано	подмиталите	Tense
презират	забрави	Mood
бежанки	запредяхме	Number
предупреждава	разнасяли	Tense
събуди	оцелеем	Mood
засичалите	зачетох	Tense
честващия	чествани	lemma
убедим	пристига	Mood
гласува	гласувания	lemma
обрекли	бесеното	Tense
допичам	построявал	Number
опеченият	пренасяхме	Tense
храсти	осо	Case
чорапогащнико	адове	Case
доказвахте	срещайте	Person
зареждах	създадат	Mood
опаслото	обезсмъртя	Number
изнуди	разнасяли	Tense
използвания	навличаха	Tense
университете	екзарси	Case
подслушвайте	обковавахте	Person
нагризва	благословят	Mood
обезсмъртях	обезсмъртеното	lemma
унищожавахме	полудееш	Mood
попичали	запалващата	Voice
убедим	плашеше	Mood
бръмбара	абсолютизирания	Number
пуших	намекнат	Mood
разлюбиш	изчитай	Person
круши	по-първоразредни	Case
преживеехме	омете	Mood
подведат	погледнах	Mood
подклажданият	подклаждалата	lemma
излезете	простеше	Mood
пронесат	втечнеше	Mood
обяснихте	напека	Mood
припекох	унесат	Mood
отнасял	изчитахме	Tense
пушения-нета	пушете	lemma
будиш	произнасяй	Person
правехме	залязвалото	Tense
посещаващия	измрат	Tense
заспим	побеждава	Mood
превъзнесохте	купуваното	Tense
стана	изговорихте	Mood
препоръчваме	комбинираше	Mood
гласуващото	чупили	Voice
по-възголемия	най-кратка	Number
поспряхме	заплаши	Mood
спестяла	най-аварийния	Number
обрекат	навлезех	Mood
зверска	мъртви	Number
мряща	доведете	Tense
доброто	мъртви	Number
пращахте	най-пъргави	Number
оцветяващ	оцветяващи	lemma
най-модерното	азиатко	Number
най-лекарския	опираща	Number
науко	бакшиши	Case
изплитай	честитиш	Person
недостатъчни	номера	Case
срещащата	срещала	lemma
интересуваме	продължи	Mood
написващите	телефонирала	Voice
пометена	пометели	lemma
заоравания	очаквали	Tense
полудях	надебелеят	Mood
важни	цици	Case
автономии	петльо	Case
заричате	навлизалите	Number
по-дивия	изсичаща	Number
доплетели	плачещата	Voice
обичаме	побеждава	Mood
съобщаващ	съобщават	lemma
мажещия	мазани	lemma
закусила	затекохте	Tense
залезеше	пуши	Person
изплита	повтаряте	Mood
анакондо	кошмари	Case
подобрявана	предскаже	Number
продължаването	продължаваната	lemma
продавано	продавала	lemma
вечерят	загубва	Mood
подклажда	казваме	Mood
рани	ранения	lemma
вечерят	гореше	Mood
наобличащият	най-отрицателна	Number
продължаващият	избодем	Tense
слоници	съществувахме	Number
най-старателният	по-старателната	lemma
пуяци	най-аборигенски	Case
по-летни	горелки	Case
опиращ	опират	lemma
въоръжавахме	обучава	Mood
изпридали	разбрания	Tense
унася	прелъстените	Tense
поопичахте	изплетената	Tense
южняци	гъркиньо	Case
по-бедни	адове	Case
обучили	простиращото	Voice
протечахте	презирайте	Person
обясните	разлюбваше	Mood
науко	шипки	Case
дъвчеш	отхапеха	Mood
почвания-нета	почвайте	lemma
пристигнахме	въвлече	Mood
черни	чираци	Case
допрочитало	наведяхте	Tense
учила	режа	Number
автономии	организме	Case
автоблокировки	котко	Case
танцувай	ходиш	Person
повлякло	отключваха	Tense
безбройни	лешове	Case
подклаждала	съчетахме	Tense
втечняваната	обещавали	Tense
круши	организме	Case
потушавалото	потушавало	lemma
разболее	оцветяхме	Mood
подкупваният	насмети	Number
произтеклите	бозайници	Number
очакваща	погледналите	Voice
бакалаври	най-ароматни	Case
започнеш	изнеси	Person
най-чешкият	по-чешката	lemma
побеждаващият	опичали	Voice
изгубваното	изгубвано	lemma
гвоздею	агрохимици	Case
говорените	изплете	Tense
посещаваните	изговаря	Tense
изговарящи	изговарящите	lemma
понапича	произнасяй	Person
дядовците	ягоди	Number
опиралия	взимаха	Tense
най-летни	по-детинското	Number
ходели	решите	Number
запалеше	изпридате	Mood
унасяха	най-бесните	Number
предсказаното	предсказано	lemma
шантажирам	коронясваха	Mood
обучаваното	обрекоха	Tense
правено	правела	lemma
бълхо	евнуси	Case
наизлизащият	предсказваме	Tense
дадеше	поспри	Person
опечахме	опечено	lemma
вдишваното	създавахте	Tense
ходихте	наемания	Tense
убедим	преведе	Mood
запираше	бастун	Number
бежанко	агрохимици	Case
излезете	заврях	Mood
ползва	благословят	Mood
пристигне	дометяхме	Mood
въвиращ	въвиращи	lemma
отнесеше	осиновявате	Mood
написахте	подкупва	Mood
отключи	честваме	Mood
протечахте	изберете	Person
принуждавахме	преживееш	Mood
обосновавай	прочетеше	Person
подпряната	съчетавахте	Tense
запечената	звяр	Number
понапичаните	понавлизал	Tense
чуй	живя	Person
посъветвания	тръгваха	Tense
даваше	подпрете	Mood
подведени	изчете	Tense
замитащият	удовлетворявали	Voice
изслушан	заподозираха	Tense
дете	наеми	Number
дядовците	мускули	Number
интересуващото	полудеели	Voice
по-широкият	потънех	Number
наводняването	наводнявалото	lemma
омела	сврените	Tense
хеликоптери	най-хомосексуални	Case
коронясалите	озаглавена	Tense
наобличаше	изпридате	Mood
зачетат	прозрях	Mood
казвате	плачещия	Tense
паланко	венци	Case
повторихме	повторехме	lemma
сънуващото	дебелеят	Tense
по-забранително	по-забранителни	lemma
потресла	учихме	Tense
допрочитащата	изковавали	Voice
съчетаващи	изчезналата	Voice
построявалата	взимаха	Tense
узаконяхте	спасявайте	Person
пушим	пуши	lemma
адмирали	дворецо	Case
построя	продължавахте	Mood
мечтано	опридахме	Tense
пуши	заплашат	Mood
пречупващи	въоръжавалия	Voice
опиралия	прочетени	Tense
прелъстяваното	обзавеждаха	Tense
запираните	запираха	lemma
мажа	зърно	Number
навреният	заметяха	Tense
живеещите	нагризвал	Voice
богът	разболял	Number
ближехме	отключвания	Tense
прегръщала	фемтолитре	Number
кървящият	оцелеят	Tense
обсъдените	отмряло	Tense
причиняваш	произнасяй	Person
полудях	продължавате	Mood
сиромахо	петаметри	Case
заповядвали	интересува	Tense
нагризва	дадем	Mood
създадяхме	създадено	lemma
отбождахте	подпиращи	Number
по-щастливо	по-щастливи	lemma
зареждаща	напредваме	Tense
съществувалото	съществувалия	lemma
битпазари	плуже	Case
мажа	по-абсурдни	Number
пикаех	подпрете	Mood
живееше	баща	Number
спирано	спирала	lemma
жабарю	авгиевия	Number
измитахме	забодеш	Mood
покриви	жълъде	Case
по-яйцевидните	по-яйцевидно	lemma
обричащи	обричащите	lemma
уволнявахме	прочита	Mood
примирам	пратихте	Mood
станеш	буди	Person
охранявам	платено	Number
събуди	подметем	Mood
обесехме	обесено	lemma
обличайте	господарствувате	Person
зачетената	шибахме	Tense
купувай	аплодира	Person
най-дебелата	най-дебелите	lemma
плачещ	плачат	lemma
по-състезателно	по-състезателни	lemma
виелици	най-аборигенски	Case
храно	зъби	Case
правя	играеха	Mood
обучили	играещият	Voice
ядосани	овни	Case
оцелееш	затресохме	Mood
оцветели	ухапваният	Tense
поспирам	поспиралите	lemma
бомбардирахте	секлия	Tense
забрано	биволи	Case
абдали	плуже	Case
подпишехте	пронасям	Mood
повлякло	попечахте	Tense
припряхте	режа	Mood
рача	рачила	lemma
земетръсното	по-земетръсно	lemma
заслужавах	завеждат	Mood
обезсмъртявали	започваното	Tense
обилни	горелки	Case
обсъди	баща	Number
обесван	бие	Number
заслужи	почитай	Person
свиращо	свирах	lemma
решеният	решилата	lemma
играното	преживяхме	Tense
закупените	заповядва	Tense
прозряхте	напечете	Person
напредвахте	серете	Person
вечерящата	напредваме	Tense
бръмбара	запалват	Number
изговарят	птиците	Number
анатемосат	прегръща	Mood
търсените	търсеха	lemma
чака	поднесат	Mood
изпредения	презряхме	Tense
слушащо	слуша	lemma
доплитащото	отвеждали	Voice
препичащ	пиканата	Number
пасена	напредвахме	Tense
автономии	германски	Case
по-ананасовите	най-ананасов	lemma
бихте	обрека	Mood
подвеждащ	подвеждат	lemma
обясняха	унищожавалата	Tense
занасящата	закупили	Voice
артикуле	радиоцентрове	Case
вертикално	най-анонимни	Number
засичалите	запридах	Tense
загубя	загубилите	lemma
доплитането	североизточни	Number
най-неопитните	по-важни	Number
адмирали	италиански	Case
прозират	премирах	Mood
морковът	обзаведе	Number
обосновавам	обосновавала	lemma
бомбардирах	доплитате	Mood
полудявахме	изчезвалото	Tense
най-бърза	отбодеше	Number
разлюбете	бозайници	Number
аксиоми	доведените	Number
плакало	навличащите	Voice
хората	икони	Number
заметяхте	спасявайте	Person
засичаната	съчетахме	Tense
понапичащите	презрял	Voice
заслужиш	произнасяй	Person
навреният	озадачавахте	Tense
заслужавай	забраняваш	Person
северното	разсъдлив	Number
кошульо	цици	Case
закусваха	убивам	Mood
победим	надонесе	Mood
берящ	заспивалите	Voice
обрекат	близах	Mood
подслушваше	изчитай	Person
възлязоха	довляклото	Tense
повтарящите	припаднал	Voice
главо	воли	Case
драконе	горелки	Case
чуваното	навличали	Tense
биеше	честваме	Mood
най-доверчивият	по-доверчивата	lemma
разнеслия	благодарихме	Tense
довличащата	довличала	lemma
по-слабия	нараняло	Number
по-крив	обзаведе	Number
лизал	сврените	Tense
разплакват	казва	Mood
пристигне	разхождахме	Mood
вярваш	начетен	Number
причиняващ	причиняващи	lemma
морковът	начетен	Number
нагребвала	нагребвах	lemma
арестувалата	намекнехме	Tense
шунки	по-анархични	Case
спасяхте	презирайте	Person
заповядвали	пронесеше	Tense
опридана	най-агресивното	Number
най-низши	отци	Case
изкупете	сравняхме	Number
сило	наеми	Number
обвини	казвай	Person
отворехме	бесиш	Mood
оцветели	изминех	Tense
припичащата	припичаш	lemma
здрави	номера	Case
компетентни	запалват	Number
капало	въвличащите	Voice
вертолете	глави	Case
запалващи	запалващите	lemma
унасяха	мускулните	Number
най-разумният	по-разумната	lemma
озадачавайте	падахте	Person
акордеоне	родини	Case
подкупят	изтърваващо	Tense
изминели	взимащият	Voice
одобрявахме	занасяло	Tense
надвнесяло	окрадваха	Tense
дай	плакал	Number
принеслата	озадачавахте	Tense
опасъл	подметените	Tense
пожари	италиански	Case
измрем	аблактации	Number
изчезнало	казваха	Tense
залезеше	надебелей	Person
дебели	запалващо	Number
подведяха	закуся	Mood
завлека	завлякла	lemma
интересуваме	вдиша	Mood
излезте	произлезехте	Person
бягащи	бягащите	lemma
наизлизащото	отсичали	Voice
заслужавах	препрочетете	Mood
отсичам	плащаха	Mood
автономии	сило	Case
опасеният	взимаха	Tense
отичахме	бесиш	Mood
по-искрената	най-искрена	lemma
опича	донасяли	Tense
насмитащо	насмита	lemma
ползвана	изгубихте	Tense
загребваните	поглеждах	Tense
правехме	принесен	Tense
университете	авантюристки	Case
чуваш	хайдуко	Number
напредвах	донасяли	Tense
наобличаше	охранявате	Mood
дебели	произнесях	Number
обсъдените	замитало	Tense
опаслото	заревавам	Number
анулиращия	анулирани	lemma
токсичните	решите	Number
купувай	вдишваш	Person
агенти	дворецо	Case
чувани	писателствалият	Tense
опридам	опридала	lemma
набоде	премираме	Mood
наричащо	нарича	lemma
прости	по-абсурдни	Number
болногледаческото	по-болногледаческо	lemma
казалият	казал	lemma
арки	авансови	Case
най-летни	дециметър	Number
отваря	най-турската	Number
подписа	подписания	lemma
загивал	обрекоха	Tense
забременялото	намекнехме	Tense
заречах	замрели	Tense
анулирала	изгубихте	Tense
заспиващо	втечнявалите	Voice
причинило	поопичащите	Voice
узаконявахте	затичайте	Person
агенти	организме	Case
доказвахме	подпрян	Tense
пометено	взимаха	Tense
маймуно	отци	Case
обещаващ	обещават	lemma
забравиш	буди	Person
пожари	енергични	Case
предупреждава	писалите	Tense
обречете	коронясваше	Mood
по-варварски	адове	Case
единадесетата	бастун	Number
босичка	насмети	Number
наемеш	преживявахме	Mood
упрекнеш	произнасяй	Person
заметохме	накълваван	Tense
разплакваният	разплаквайки	lemma
децилитри	бацилоносителко	Case
прехапва	казахме	Mood
розо	евнуси	Case
продавачки	надколенни	Case
наизлизащото	потресли	Voice
правя	гласуваха	Mood
танцувай	аплодира	Person
доказванията-нетата	доказва	lemma
хомосексуално	победата	Number
разпростирала	заспиваха	Tense
обличайте	удовлетворявате	Person
отричаме	отрича	lemma
вдишам	желаха	Mood
смазаното	принесяха	Tense
наводни	изчитай	Person
смазаното	попечахте	Tense
чуват	благодарящата	Tense
поопичахте	създалият	Tense
чобанката	узакони	Number
обезглавява	дециметър	Number
омитахме	тичаш	Mood
заричащи	заричащите	lemma
говорените	става	Tense
нагризваме	продължаваше	Mood
поспирало	завличахте	Tense
боевете	решите	Number
подвежда	напичане	Number
посетило	озадачи	Number
шантажиращият	измитат	Tense
свираше	заковавай	Person
поизмитахме	докаже	Mood
най-възможни	змиорки	Case
допичам	мъртви	Number
отваря	плакал	Number
преживявана	напредвахме	Tense
ползвана	казваха	Tense
небесносини	по-лилава	Number
най-интересни	документи	Case
прочетяло	обезсмъртя	Number
аналитичното	по-аналитично	lemma
слон	осиновявания	Number
потичащите	припаднал	Voice
упрекващо	упреквах	lemma
капането	капалото	lemma
изнуди	плащали	Tense
снасяли	ухапваният	Tense
плащащи	плащащите	lemma
шантажирам	продавахте	Mood
понапичащото	сприятелявате	Tense
клади	ходиш	Person
пуши	създадат	Mood
разхождащ	разхождащи	lemma
въвлечахте	писателствалият	Tense
плаши	обесвай	Person
учила	боядиса	Number
подробни	бедняци	Case
дъвка	шофьорка	Number
заповядвали	запридах	Tense
купувала	опридахме	Tense
препрочитаното	най-кратка	Number
изпий	уши	Person
здрави	евнуси	Case
виждаше	казвай	Person
препрочетох	пикаете	Mood
заповядан	плетяхте	Tense
заслужената	продавахте	Tense
отсичало	озаглавявахте	Tense
децилитри	по-гърдести	Case
обилни	овни	Case
можа	унищожавате	Mood
пращаният	донасяли	Tense
опаслото	североизточни	Number
предупреди	арестували	Tense
заподозрем	заподозря	lemma
омела	напредвахме	Tense
привнеси	пристигнеш	Person
чуха	заведяла	Tense
визи	по-оскъдни	Case
облечахте	обучава	Mood
превъзнесохте	изплетената	Tense
възлязоха	прозряло	Tense
прочитаните	интересува	Tense
препичащ	извличаше	Number
прегърнеше	изсичат	Mood
удовлетворявано	изковавалите	Tense
танцувай	сравни	Person
охраняващи	охраняващите	lemma
напичах	охранявате	Mood
гласувате	подписах	Mood
абсорбираше	комбинирали	Tense
по-анилиновите	по-анилиново	lemma
завлечало	произнасяхме	Tense
нанасяме	купува	Mood
мечоци	прочитания-нета	Number
хомосексуално	плаша	Number
подобрявана	пристига	Number
пастири	други	Case
най-абсолютни	отци	Case
разплачела	разплачех	lemma
боевете	озаглавихме	Number
пасете	пронасяйте	Person
комунистко	глави	Case
запаля	по-анархичното	Number
довлечеше	бастун	Number
препоръчваме	изпитваше	Mood
изтърваваха	подслушвалата	Tense
най-летни	наобличалото	Number
прости	саркастично	Number
отричай	провреше	Person
падахте	наболият	Tense
заслужавали	взимащият	Voice
загивах	обещавали	Tense
облечените	облечаха	lemma
произтичахте	обосновавала	Tense
инфантилни	алебарди	Case
доктора	двубоите	Number
помагала	въвираха	Tense
капеше	довличаме	Mood
морковът	обучавано	Number
въвряното	зърно	Number
гвоздею	бакшиши	Case
потушавала	бомбардиращите	Voice
изпитаният	изпитайки	lemma
астероиди	италиански	Case
влязоха	грабиш	Mood
закусващите	бомбардирала	Voice
обезглавиш	пречупвало	Number
най-надеждният	тръгвах	Number
провира	плашехме	Mood
хеликоптери	германски	Case
повтаряхте	понавлизал	Tense
авансираните	насмитало	Tense
изнудехме	изгубеното	Tense
посещавано	посещавала	lemma
доим	дои	lemma
изслушваният	изслушвалата	lemma
честваме	чества	lemma
допрочитащата	наводнели	Voice
полето	унищожено	Number
болногледачки	аскере	Case
по-бедни	змеици	Case
почвалият	въоръжаващи	Voice
изговаряш	заковавай	Person
възпиращите	дометяло	Voice
използвахме	използвайки	lemma
изневери	авансови	Case
бежанки	получеха	Number
понавлезеха	нанеса	Mood
юнака	зърно	Number
можехте	почете	Mood
астероиди	германски	Case
изпитащо	навестим	Tense
изкупуващ	изкупуващи	lemma
причинявалата	запалващи	Voice
бременното	по-бременно	lemma
започваното	започвано	lemma
господаруващата	навестят	Tense
обричането	обричаната	lemma
галицизми	решите	Number
кош	бебешката	Number
попитвалият	попитвал	lemma
получаваше	слушани	Tense
най-косматият	по-косматата	lemma
пекари	петльо	Case
провира	подписахме	Mood
спирания-нета	спирайте	lemma
написващите	протечала	Voice
навестяхте	наследява	Mood
зачетената	учихме	Tense
мечтано	плетяха	Tense
убивали	двубоите	Number
засичам	давалото	Number
почитам	обосновавахте	Mood
пекари	котко	Case
желайте	бушувахте	Person
заплашете	простирахте	Person
ограничават	прощава	Mood
заслужи	понавлез	Person
зими	бързички	Case
уплашвал	купувахме	Tense
по-земетръсни	екзарси	Case
зашивахме	зашивано	lemma
обичаме	аплодира	Mood
изнасяна	изнасяли	lemma
уби	плащали	Tense
спасявах	подметените	Tense
зашиващия	зашивани	lemma
важни	горелки	Case
най-верни	бъзли	Case
недостатъчни	алебарди	Case
най-унгарски	влъхви	Case
по-анасонови	шипки	Case
отсякохме	подкупва	Mood
купувала	опасвахте	Tense
написаният	плащали	Tense
прелъстеното	най-енергичен	Number
ометена	ометели	lemma
въвиращият	потресли	Voice
злоупотребяват	разплакваше	Mood
уплашвал	пристигнехме	Tense
правехме	наковавала	Tense
обеси	кралю	Number
изговарям	пейзажът	Number
изсечени	спрях	Tense
абсорбиралото	озаглавявахте	Tense
по-парадоксалният	звяр	Number
изпитвала	изпитваше	lemma
стана	обзаведохте	Mood
отключи	разболеете	Mood
най-непокътнатият	по-непокътнатата	lemma
здрави	отци	Case
надвнесе	обезсмърти	Person
озадачавайте	повярвахте	Person
заричате	залязвалите	Number
чувани	донесеше	Tense
доброто	най-мъдър	Number
ползвания-нета	ползвате	lemma
понеслата	отсичахме	Tense
изпихме	надонасяната	Tense
можахме	одобри	Mood
принеси	адресираш	Person
можехте	одобри	Mood
обвиняло	скуо	Number
инфантилни	евнуси	Case
по-ягодовият	мярко	Number
повтаряхте	затичайте	Person
окрадването	окрадваната	lemma
единадесетата	доктор	Number
отваряла	отваряше	lemma
избирани	разнесях	Tense
най-работливият	по-работливата	lemma
убитото	тръгваха	Tense
навестяхте	отвежда	Mood
благодарения-нета	благодарете	lemma
назовавал	отключващите	Voice
прочели	препрочитащия	Voice
почитаният	почитайки	lemma
унищожавахте	построяваният	Tense
започва	заковавай	Person
презира	благословят	Mood
пишещата	пишеш	lemma
безделничеха	помитаното	Tense
най-верни	автоматистрали	Case
по-деветите	анулирате	Number
снасящите	прочетяла	Voice
започва	почитай	Person
опасъл	кладяха	Tense
разболявания-нета	разболявайте	lemma
плаши	пуши	Person
построявахме	зре	Mood
довлечеше	най-гърдестата	Number
изтървавало	навличащите	Voice
говорените	завлече	Tense
дебелях	разсъдлив	Number
заплашващ	заплашват	lemma
изплитай	решиш	Person
падам	падала	lemma
одобрявахме	спирало	Tense
взема	зърно	Number
бегълци	обсъдят	Number
по-морскосините	по-морскосиньо	lemma
загивал	злоупотребяхме	Tense
победеше	подметем	Mood
обосновава	снасяй	Person
давали	интересува	Tense
ухапвали	чупеното	Tense
пътува	опичате	Mood
най-златният	по-златната	lemma
попечели	обричащото	Voice
снасяли	боядисваната	Tense
ближехме	насметяло	Tense
изпиваща	изпивалите	lemma
бежанки	двубоите	Number
по-неспособната	най-неспособна	lemma
розо	кълвачи	Case
поведи	оцветяваше	Person
започваме	започва	lemma
изгубвахме	изгубвайки	lemma
казващо	казва	lemma
пристигне	плашехме	Mood
допринасях	звяр	Number
врящата	изпивали	Voice
продавачки	млечнобели	Case
храсти	аскере	Case
допрочелия	изчитахте	Tense
донася	обучихте	Mood
навестявам	навестявала	lemma
изкупувахме	спирало	Tense
подведат	обезсмъртявах	Mood
вуйчовци	излизаха	Number
донася	припичахме	Mood
заредена	гласуването	Number
запечения	молиха	Tense
коря	корила	lemma
заоравания	запалваха	Tense
инфантилни	камъни	Case
драконе	биволи	Case
изреченият	изреклата	lemma
закупените	става	Tense
моля	молила	lemma
изплашеше	бушували	Tense
арестувало	създавахте	Tense
презират	опече	Mood
чорапогащнико	бели	Case
запечената	винящо	Number
изтечете	заченехте	Person
ставащият	изпечели	Voice
боевете	съобщаваме	Number
източни	зърно	Number
италианец	гения	Number
живеещите	спасявал	Voice
въвирана	слизам	Number
унищожава	благословят	Mood
пишещо	пишех	lemma
снасяли	изплетената	Tense
абаносовата	фемтолитре	Number
доктора	бегли	Number
отхапваш	игралият	Number
изчетете	предупредеше	Mood
понапичаните	анатемосвала	Tense
затичащи	спиралия	Voice
обещаха	режа	Mood
четящия	четени	lemma
вратовръзка	мъртви	Number
битпазари	овчарю	Case
понесеното	археоложка	Number
отсичащият	отсичалото	lemma
поотече	принесяхте	Mood
обучаваното	бушували	Tense
италианец	наеми	Number
пристигащи	пристигащите	lemma
по-умните	най-умен	lemma
засичам	мярко	Number
повярваха	нанеса	Mood
абдали	най-порнографични	Case
спряхме	говори	Mood
наказали	препрочитащия	Voice
повтаряха	започващите	Number
озадачавало	отключваха	Tense
захапано	захапела	lemma
препоръчвано	отнасящият	Number
инфантилни	екзарси	Case
изминато	обсъдихме	Tense
победи	победения	lemma
тресе	произнасяй	Person
плащаш	чухме	Mood
болногледачки	котко	Case
предсказващи	предсказващите	lemma
поотече	глобихме	Mood
най-низши	влъхви	Case
изслушам	обезсмъртяха	Mood
компетенции	лесе	Case
затеклото	заспиваха	Tense
по-авантюристични	адресирах	Number
живеният	напредвахме	Tense
ухапваше	продължите	Mood
благословя	довличащи	Tense
по-действителни	адове	Case
чуха	повело	Tense
пътува	оцелеем	Mood
най-летни	бие	Number
правехме	казаното	Tense
наемеш	принесяха	Mood
убеждавате	продължаваше	Mood
плащаш	подписахме	Mood
правещ	правещи	lemma
мачове	германски	Case
чобанки	германски	Case
раняващи	раняващите	lemma
тресях	произтекат	Mood
закусили	прозиращия	Voice
вечерят	занасях	Mood
изковаваните	убило	Tense
мечоци	пеещи	Number
загребвай	свира	Person
препоръчваме	отвежда	Mood
завлечало	прегръщахме	Tense
доведохте	изплетената	Tense
единадесетата	археоложка	Number
господарствуваща	господарствувалите	lemma
босичка	зачитащото	Number
коронясвало	наведяхте	Tense
дало	потушаващите	Voice
шунки	чавко	Case
съчетавам	виняхте	Mood
чакала	чаках	lemma
попичани	птиците	Number
мечтаният	мечтаейки	lemma
окрадвах	изречете	Mood
прочета	прочела	lemma
възляза	предяха	Mood
по-бавничката	най-бавничка	lemma
плашещ	плашат	lemma
по-земетръсни	бакшиши	Case
важни	радиоцентрове	Case
повярвате	подобрете	Person
оцелееш	заведяха	Mood
прости	зъбеца	Number
говорените	принуждава	Tense
пишех	писаното	lemma
целувахте	подкупва	Mood
автомобилът	аплодиран	Number
зверското	по-зверско	lemma
живеният	унасяли	Tense
по-глупавата	най-глупава	lemma
бомбардирахте	насмиталото	Tense
чобанки	аварко	Case
победиш	оцветяването	Number
помели	заповядва	Tense
плащахме	надебелее	Mood
съзирахме	съзирайки	lemma
храно	нанолитри	Case
охраняваха	спрения	Tense
озаглавявахме	обвиненото	Tense
по-жълти	печати	Case
мачове	лесе	Case
изпий	потушава	Person
обесете	интересувахте	Person
извеждана	извеждали	lemma
изнеса	забодяха	Mood
пристигнахме	нанасяш	Mood
италианци	гренландецо	Case
заметяхте	припаднете	Person
--	накълвавалото	Number
розо	глави	Case
произлизащи	произлизащите	lemma
изпий	решиш	Person
припеви	сило	Case
възпиране	авансиращият	Number
закусили	играещият	Voice
питам	доведохте	Mood
най-сатанистична	сатанистично	lemma
подклало	въвличащите	Voice
злоупотребяват	продължи	Mood
влязоха	убивам	Mood
заподозирали	полудяваше	Tense
възпирахме	ухапваният	Tense
надвнасяхте	наковавала	Tense
даващото	сядаме	Tense
помагали	нанесената	Tense
припече	припечения	lemma
изпичалите	авансираща	Voice
втечняващият	втечнявалото	lemma
ограничават	навлезех	Mood
събудиш	захапващи	Tense
плачещо	плака	lemma
хапещи	хапещите	lemma
неразсъдителни	камъни	Case
влязоха	зачета	Mood
амфитеатре	боя	Number
най-интелигентният	по-интелигентната	lemma
припадащи	припадащите	lemma
по-действителни	родини	Case
пращаният	обесехме	Tense
ползваща	ползвалите	lemma
поопекъл	преживяхме	Tense
съобщаваше	благословят	Mood
ограничавахте	насметяло	Tense
осиновяват	убих	Mood
начиталите	чупеща	Voice
обещаха	бесиш	Mood
наследяло	измитащите	Voice
абразии	по-хубави	Number
обясняха	отхапало	Tense
излезете	наранява	Mood
запаля	победата	Number
полудявахме	казаното	Tense
честват	забраняващ	Tense
най-невряла	невряло	lemma
най-авиационното	разлюбела	Number
биеш	по-различният	Number
повтаряха	мускулните	Number
запаля	врабчето	Number
наследявай	вдишваш	Person
книги	други	Case
загребвай	препрочиташе	Person
сило	почитащата	Number
отсичащи	виниш	Tense
произнесели	препрочитащия	Voice
спрете	обезсмъртеше	Mood
правителства	микроорганизъма	Number
въвираният	благодарихме	Tense
припекох	охранявате	Mood
запираше	азербайджанец	Number
пушите	коронясваше	Mood
повярваха	отричам	Mood
най-безпаричната	бие	Number
пуши	сравнят	Mood
чуваш	ограничаван	Number
пристигнахме	прочита	Mood
наводни	пуши	Person
недостатъчни	екзарси	Case
правите	смажете	Person
комбинирало	злоупотребяхме	Tense
опридана	келнера	Number
написаният	запридаха	Tense
отрекохме	отключвания	Tense
наследяваме	загребващия	Tense
погледнехте	надебелее	Mood
наобличаше	премираме	Mood
прозирано	ушиха	Tense
правехме	продаваната	Tense
ухапваше	понавлизаме	Mood
загребваните	загребваха	lemma
написващите	прелъстила	Voice
втечнявало	измитащите	Voice
предсказващи	вковаваш	Tense
ограничавахте	оцветила	Tense
надонасям	изговорехте	Mood
омита	доведохте	Mood
най-неразумна	неразумно	lemma
създавала	най-анонимни	Number
злоупотребяват	отхапвах	Mood
озаглавявахме	принесен	Tense
най-храбра	храбро	lemma
наизлизащото	полудеели	Voice
най-студентския	по-ненадеждна	Number
препрочитащо	припадалите	Voice
надебелявало	плетяха	Tense
оцветели	пронесеше	Tense
узаконяващо	узаконява	lemma
засича	нараняват	Mood
пулмоналното	по-пулмонално	lemma
бихте	пронасям	Mood
северното	боядиса	Number
разплаче	най-неузрелия	Number
припираща	написалите	Voice
кош	пристига	Number
ометях	ометеното	lemma
пушена	пушели	lemma
поглеждал	посещаващите	Voice
възпиращите	прочетяла	Voice
колачко	змеици	Case
изслушай	забраняваш	Person
счупвате	поотекох	Mood
заметохме	наболият	Tense
покриви	по-анархични	Case
завлеченият	изминеха	Tense
изговарям	гения	Number
южняци	енергични	Case
неразсъдителни	влъхви	Case
изплитахме	отвличаш	Mood
пожари	сило	Case
псувньо	алгоритми	Case
обвиняло	по-жестокият	Number
счупвате	отсъствах	Mood
ядат	прегръща	Mood
доказващо	доказва	lemma
можа	повтаряте	Mood
купуването	купуваната	lemma
охраняваните	обещавал	Tense
зверска	най-югоизточни	Number
американска	слизам	Number
най-безпаричната	чупеше	Number
отваряме	отваря	lemma
кладящо	кладях	lemma
надебелявало	навличаха	Tense
наследявай	вдишваше	Person
наклажда	най-неузрялата	Number
казвате	забраняващ	Tense
прехапа	прехапания	lemma
допринасях	озадачи	Number
забременялото	заметяха	Tense
агенти	германски	Case
мечтаещо	мечта	lemma
убедим	маза	Mood
насичащото	обесели	Voice
помели	отчетеното	Tense
мазаната	мъртви	Number
безбройни	змиорки	Case
най-агрегатната	най-агрегатните	lemma
препрочитаното	изчитаща	Number
интересуваме	аплодира	Mood
надебелявало	изчитахме	Tense
приятелки	арменски	Case
изчезнало	изгубихте	Tense
комбинираме	комбиниращо	lemma
поизмитания-нета	поизмитате	lemma
изпиваха	аблактации	Number
чу	купите	Mood
предупреждавахме	предупреждавано	lemma
припираща	глобилите	Voice
вечеряло	посещаващите	Voice
счупихме	отвличаш	Mood
изпредения	затекохте	Tense
повтарящите	живеела	Voice
прегръщала	заревавам	Number
посещаващи	посещаващите	lemma
прегърнах	най-гърдестата	Number
ограничават	допринася	Mood
нараняваше	гласуването	Number
полудявахме	боядисваната	Tense
коронясвалото	коронясвалия	lemma
възможни	снесените	Number
строяхте	напека	Mood
поглеждаме	поглеждащо	lemma
отхапаха	изгребвалата	Tense
обосновава	буди	Person
зидарки	глупави	Case
по-ядосаните	по-ядосано	lemma
пристигнахме	докаже	Mood
дете	оцветяването	Number
посещаването	посещаваната	lemma
решава	завеждат	Mood
поизмиташе	по-далечен	Number
забранеше	обезсмърти	Person
запаля	гения	Number
агробиоложки	лесе	Case
запирайте	изтичахте	Person
гърцизми	бързички	Case
по-тъмносините	най-тъмносин	lemma
дъвка	гласуването	Number
премяно	отци	Case
изневери	лесе	Case
озадачаваше	заспивате	Mood
разходи	чухме	Mood
ядосани	влъхви	Case
започва	надебелей	Person
битпазари	по-студени	Case
презираният	презирайки	lemma
живеещите	повярвала	Voice
обилни	шефове	Case
осиновяват	затриса	Mood
окрадват	произлезеше	Mood
апетити	арменски	Case
източни	оскъдно	Number
повтаряхте	нанесената	Tense
създавахме	мъже	Number
живеният	навеждахте	Tense
изпридалото	абсурдна	Number
възляза	гласуваха	Mood
апетити	осо	Case
замиращ	замиращи	lemma
заредяхте	пронасяйте	Person
поотичал	навличащите	Voice
изневери	други	Case
наплитало	вериго	Number
сияело	обсъдихме	Tense
разбира	разбирания	lemma
нанасялото	молиха	Tense
препрочитащо	втечнявалите	Voice
визи	бацилоносителко	Case
окрадвах	доплитате	Mood
обезглавява	плакал	Number
разлюбванията-нетата	разлюбва	lemma
по-компетентната	крадеш	Number
ядат	допрочетеше	Mood
чете	опичате	Mood
надебеляхте	предплатете	Person
намекваме	мъже	Number
тръгваща	предричат	Tense
засичалите	поглеждах	Tense
привнеси	присъстваш	Person
запалващ	запалващи	lemma
зашит	келнера	Number
съветващия	ушивали	Voice
залязох	плащали	Tense
пренасяното	бие	Number
изревавало	окрадваха	Tense
залезела	замряхме	Tense
въвличах	произтекат	Mood
измитахме	произнасяш	Mood
разболее	обречахме	Mood
спрете	погледнах	Mood
прегърнеше	попечем	Mood
красиви	надежди	Case
казвате	разпростиращия	Tense
бушуващата	желаят	Tense
по-безмилостно	по-безмилостни	lemma
изнеса	изговорехте	Mood
измрем	птиците	Number
заоравана	заоравали	lemma
пристигне	чухме	Mood
злоупотребяват	преведе	Mood
пчеларю	родини	Case
прехапят	дадеше	Mood
пренасяхме	начете	Mood
мъртвото	бастун	Number
слезеше	произтекат	Mood
отричащ	отричащи	lemma
розо	радиоцентрове	Case
вдишам	предплатихте	Mood
най-свръхестествени	алгоритми	Case
отнасяла	отнасяше	lemma
понапичалата	най-анонимни	Number
въвира	изпредем	Mood
изпичаща	изпичалите	lemma
восъко	нанолитри	Case
посети	опичате	Mood
загивал	изчитахте	Tense
взема	ограничаван	Number
най-ягодовата	най-ягодовите	lemma
ползвахме	разбирано	Tense
коронясалите	ушиеше	Tense
отсичало	тръгваха	Tense
предсказа	изсичат	Mood
най-интересни	бакшиши	Case
получавайте	радеете	Person
понавлизаща	понавлизалите	lemma
лягания-нета	лягате	lemma
наобличаше	презрете	Mood
лесна	потънех	Number
ядосани	устни	Case
вертикално	понапече	Number
вертикално	предскаже	Number
принеслата	окрадваха	Tense
оцветената	по-значителен	Number
визи	италиански	Case
пренесеш	опасвахме	Mood
по-мускулната	най-мускулна	lemma
озадачавайте	напечахте	Person
срядо	адове	Case
легализирания-нета	легализирате	lemma
зими	италиански	Case
интересуваме	загубва	Mood
прозирахте	спасявайте	Person
чуй	отключи	Person
посетиш	надебелей	Person
зачетат	прелъстеше	Mood
беряхте	допринасяйте	Person
коронясалите	заспа	Tense
затече	почитай	Person
обсъденото	запридаха	Tense
отнасял	прегръщахме	Tense
студове	сило	Case
погребвахте	заведяла	Tense
изплитахме	победиш	Mood
заплашете	плащате	Person
инфантилни	алгоритми	Case
уволняващият	анатемосваме	Tense
озаглавявахме	съобщеният	Tense
събуди	обковаваме	Mood
най-правителствени	писателстващото	Number
най-топлата	най-топлите	lemma
прелъстявах	довличаните	Tense
лизал	ушиха	Tense
ставането	ставалото	lemma
най-дяволският	по-дяволската	lemma
съветващия	полудеели	Voice
нараняваше	баща	Number
понапичащите	начитал	Voice
излезеше	препрочетем	Mood
най-земетръсната	най-земетръсните	lemma
отлично	попичания	Number
измитах	съзрете	Mood
опридали	съобщеният	Tense
въвряхме	тичаш	Mood
сиромахкини	подпиращи	Number
апетити	лесе	Case
давала	даваше	lemma
изчитайте	обковавахте	Person
изчетохме	изчетяхме	lemma
запирайте	насякохте	Person
астероиди	северняко	Case
понапичащите	бомбардирала	Voice
отричахте	обесвайте	Person
по-авторитарно	разлюбиш	Number
навлякох	продължите	Mood
горят	присъствах	Mood
врящата	надонесли	Voice
срещащи	срещащите	lemma
пречупили	наклаждания	Tense
изневери	германски	Case
живеещите	прехапал	Voice
подслушана	подслушали	lemma
навеждащите	разходи	Tense
давали	спрях	Tense
изпихме	подмиталия	Tense
плащала	плащаше	lemma
изслушай	пристигнеш	Person
възпиращите	завеждала	Voice
господарстващо	заредилите	Voice
подпишем	подписа	lemma
вдиша	възпрени	Tense
припекох	опичате	Mood
повярвате	пронасяйте	Person
подслушва	дъвчехме	Mood
тича	дециметър	Number
намекнах	произтекат	Mood
прозират	допичаше	Mood
разболяваше	четящо	Number
вечерят	казва	Mood
чобанката	батарейно	Number
отхапаха	отхапвала	Tense
наковавали	изслушващият	Voice
пристигнахме	говориш	Mood
превъзнесохте	презирайте	Person
отхапаха	счупилата	Tense
подписа	завеждат	Mood
простиращ	простират	lemma
уволнявахме	чества	Mood
наобличаш	припичахме	Mood
доплитащото	отхапвали	Voice
купила	боядиса	Number
протичаха	принеса	Mood
предупреждава	разбирани	Tense
заспим	прозря	Mood
избирани	наболият	Tense
безделничеха	въвирало	Tense
обезглавяла	най-непрекият	Number
млъква	окрадващите	Tense
черни	алебарди	Case
по-доверчивите	най-доверчив	lemma
вечеряния-нета	вечеряте	lemma
боевете	търтеи	Number
бойци	инфекцийо	Case
танцувай	припреш	Person
сънувахте	зачета	Mood
по-сладки	петаметри	Case
лекарят	бастун	Number
чувай	забраняваш	Person
вдиша	донасяли	Tense
слушахме	обучава	Mood
искреното	по-искрено	lemma
говорещ	написалите	Voice
замитаното	продажбена	Number
възлязлата	чупехте	Tense
чакам	чакалите	lemma
жабарю	наплитащата	Number
загиващият	опичали	Voice
подведени	принуждава	Tense
отмираха	напека	Mood
автономии	бързички	Case
гласуващият	оцелявали	Voice
превел	посещаващите	Voice
оцелееш	начитаха	Mood
ходихте	влязъл	Tense
будещият	фемтолитре	Number
господарстващо	правилите	Voice
правехме	наболият	Tense
най-ловка	ловко	lemma
надебелееха	господарувало	Tense
забрано	устни	Case
обвинявали	изговаря	Tense
говорените	поизмете	Tense
потичаща	по-полувисшият	Number
очаквахме	очаквайки	lemma
най-чудесно	бебешката	Number
отключи	биете	Mood
красиви	кълвачи	Case
спасяхте	пронасяйте	Person
дебелялото	дебелелия	lemma
отхапаха	замитало	Tense
пристигнат	прощава	Mood
посещаваните	подобряла	Tense
продават	казва	Mood
подпряната	обсъдихме	Tense
попечели	прозиращия	Voice
понапечем	понапече	lemma
дай	построеното	Number
допринасяния-нета	допринасяйте	lemma
по-парадоксалният	змею	Number
навестявах	най-гърдестата	Number
лекцията	изчитаща	Number
изтичанията-нетата	изтича	lemma
анатемосаха	мъже	Number
по-ароматичните	най-ароматичен	lemma
питахме	отвежда	Mood
купувай	заповяда	Person
начиталите	простиращ	Voice
въвряхме	господарстваш	Mood
превъзнесохте	втечнявалият	Tense
платеното	платено	lemma
чакания-нета	вършаха	Number
повлякло	заподозираха	Tense
охраняваха	ушиваната	Tense
произтеклите	най-кралски	Number
опридащите	прочетяла	Voice
предупреди	възпрени	Tense
зарекох	писателстващото	Number
студове	германски	Case
съчетавана	шибахме	Tense
заспа	полудеят	Mood
най-авангардната	най-авангардните	lemma
измитах	надебеляват	Mood
бъбреко	узакони	Number
нови	убедим	Number
по-летни	документи	Case
бушувалото	заревавам	Number
комбинирало	заметяха	Tense
отключващата	отключвала	lemma
изпредения	избодяха	Tense
предричащият	адресирах	Number
чу	биете	Mood
богът	припечи	Number
донесях	по-различният	Number
отрекохме	довлечеш	Mood
влязоха	произнасяш	Mood
въвлечахте	дотеклото	Tense
изчезвали	прозиращия	Voice
зачиташ	съчетаха	Mood
пасена	благодарихме	Tense
опичалият	опичал	lemma
метях	продължите	Mood
помагали	изчете	Tense
пречупили	поглеждах	Tense
обеси	спряло	Number
скучни	мъже	Number
възпирахме	довляклото	Tense
аргати	лесе	Case
победим	изпитваше	Mood
купувай	изслуша	Person
падахте	спасявалия	Tense
лекарят	пристига	Number
болногледачи	бегли	Number
анакондо	устни	Case
наводни	казвай	Person
заплелия	заспиваха	Tense
господарстващо	спестявалите	Voice
излезеше	унищожавате	Mood
съчетаващ	съчетаващи	lemma
изпий	отвори	Person
анатемосваме	подмиташе	Mood
благославяна	съчетахме	Tense
наследявана	заподозираха	Tense
изчезнало	злоупотребяхме	Tense
преживявана	взимаха	Tense
използвания	вярвали	Tense
построяхте	напечете	Person
изкупи	по-далечен	Number
ползва	прегърнат	Mood
очаквания	предскаже	Number
използвания	изпичаха	Tense
спасено	спасяла	lemma
можахме	заспива	Mood
давали	бесеното	Tense
най-батарейният	по-батарейната	lemma
дебели	спряло	Number
най-свръхестествени	змеици	Case
по-писателски	бъзли	Case
презира	закусваме	Mood
биеща	билите	lemma
дай	пращал	Number
обезсмъртите	презирания-нета	Number
тръгваща	подобряваме	Tense
заслужиха	ушиваната	Tense
одобрявахме	подобряла	Tense
дебелях	продажбена	Number
кошульо	родини	Case
счупите	млъквайте	Person
обезглавява	жена	Number
допряната	отвличащ	Number
най-неврели	арнаутки	Case
най-верни	алебарди	Case
нанасящия	потресли	Voice
срядо	влъхви	Case
изкупиш	по-детинското	Number
бралите	озаглавяващо	Voice
предсказвал	по-анархичното	Number
разбира	дометяхме	Mood
изнеса	отчитаха	Mood
по-ягодовият	насечах	Number
оцветявахте	припаднете	Person
счупите	смажете	Person
ядат	побеждава	Mood
недостатъчни	авантюристки	Case
прехапва	отечахте	Mood
желайте	пронасяхте	Person
рачиш	заковавай	Person
въвряното	пълен	Number
врабче	почитащата	Number
предплатеше	създадем	Mood
най-амбициозен	давалото	Number
посещаваните	спрях	Tense
бихте	чества	Mood
бягай	протича	Person
изкупувахме	обещавал	Tense
пуяци	беднички	Case
въвираният	взимаха	Tense
озадачи	озадачения	lemma
прелъстявах	вярвали	Tense
уволнявахме	заплаши	Mood
извлечи	нахапваш	Person
принуденото	прегръщахме	Tense
срещал	изчитахте	Tense
подведени	авансиралият	Tense
попичащия	попичани	lemma
възлязлата	съчетаха	Tense
подведях	подведеното	lemma
безделничеха	прочело	Tense
най-босички	чираци	Case
преживявано	агитационния	Number
дебели	най-турската	Number
адмирали	бацилоносителко	Case
по-кучите	по-куче	lemma
звере	бедняци	Case
затече	буди	Person
благославяли	боядисваната	Tense
живеещата	живяла	lemma
запечената	боядиса	Number
пометено	запалваха	Tense
ближехме	сприятеленото	Tense
приятелки	италиански	Case
създавахме	десети	Number
говорените	протича	Tense
танцувай	решиш	Person
мечоци	поглеждания-нета	Number
упрекналия	въоръжаващи	Voice
пуших	разболеете	Mood
подслушам	подслушалите	lemma
замитах	замитаното	lemma
правителства	икони	Number
навличам	гласуваха	Mood
превел	отключващите	Voice
нанасящ	нанасящи	lemma
падал	навличащите	Voice
затичахме	подкупва	Mood
храсти	най-порнографични	Case
помагали	спрях	Tense
охраняваха	довляклото	Tense
сприятеляваш	адресирай	Person
примирам	принесяха	Mood
абсорбираше	съобщавани	Tense
продавачки	арменко	Case
слушахме	вярваш	Mood
снасящите	окрадвал	Voice
съветвам	съветвала	lemma
одобрявахме	замитало	Tense
почвахте	затичайте	Person
ядосани	алгоритми	Case
спеченият	спеклата	lemma
опредеше	давалите	Tense
втечнявай	по-детинското	Number
прощаваща	прощавалите	lemma
пристигне	запридахте	Mood
шибането	шибалото	lemma
отбожданото	отбождано	lemma
отсякла	убиващите	Voice
пуяци	по-слънчеви	Case
купувала	прелъстените	Tense
оцветената	режа	Number
най-босички	змеици	Case
обилни	чираци	Case
разбирали	язовеца	Number
по-учтивите	по-учтиво	lemma
потичащите	залязвало	Voice
студове	други	Case
безбройни	пуйки	Case
примирам	произлизахте	Mood
плащането	плащалото	lemma
обсъди	набожната	Number
събуди	погледни	Person
изкупиш	азиатко	Number
пристигнат	вдиша	Mood
изнеса	заораваха	Mood
снасящите	препоръчала	Voice
охраняваха	надонасяната	Tense
храно	цици	Case
въвлечахте	построяваният	Tense
подвеждания-нета	подвеждате	lemma
очаквания	доктор	Number
бойци	други	Case
вратовръзка	испанският	Number
почитащ	почитащи	lemma
срядо	зъби	Case
мечоци	давахме	Number
лекарят	гърло	Number
срядо	шипки	Case
узаконило	бомбардиращите	Voice
говорените	обещавал	Tense
зидарки	печате	Case
построяла	по-мъртвия	Number
погледнехте	обрека	Mood
зачиташ	горяха	Mood
изковавате	спасеше	Mood
вечеряло	измитащите	Voice
розо	биволи	Case
прости	зърно	Number
купила	североизточни	Number
обречеш	заспаха	Mood
решихме	решахме	lemma
построя	начитаха	Mood
понапичащите	чуло	Voice
одобрихме	отхапвала	Tense
отключи	дадем	Mood
заши	създадем	Mood
скучни	въпросите	Number
пречупили	купуваното	Tense
изминаващият	изпечели	Voice
шибахме	шибайки	lemma
юнака	абсурдна	Number
залезела	отсичахме	Tense
умрелият	умрял	lemma
господарстващо	писателствалите	Voice
можа	купите	Mood
дъвка	пълен	Number
подробни	глави	Case
съзрели	работещата	Voice
горят	преведе	Mood
разплаче	припечи	Number
обвините	напечете	Person
овчето	по-овче	lemma
лизал	плетяхте	Tense
прозират	преведе	Mood
апетити	петльо	Case
горящи	горящите	lemma
заслужената	начитахте	Tense
ползвана	аплодирахте	Tense
наследява	анилиново	Number
лекцията	мъртви	Number
сило	ограничаван	Number
мрелите	ухапва	Tense
комбинирали	взема	Tense
спичаният	спичалата	lemma
препоръчваме	казваше	Mood
отваря	треторазредният	Number
начетяхме	обезсмърти	Mood
ядосани	глави	Case
врения-нета	наоблеклите	Number
допрочетох	благословят	Mood
вечерят	забрави	Mood
продаваше	препрочетете	Mood
наизлезете	затичайте	Person
интересуваме	поизметеше	Mood
по-белите	най-бял	lemma
изпия	изпила	lemma
спрях	спряното	lemma
автомобилът	разсъдлив	Number
поопичаха	наковавала	Tense
македонското	по-македонско	lemma
превъзнесохте	помитаното	Tense
вселена	безскрупулния	Number
заметохме	запичаната	Tense
зареждаща	повеждат	Tense
заковавания-нета	заковавайте	lemma
премяно	пуйки	Case
наемела	наемеше	lemma
надонесохме	надонасяната	Tense
изнудвах	вярвали	Tense
отнасящ	отнасящи	lemma
припряхте	въпросите	Number
обезглавява	носороже	Number
навлякох	обзавеждат	Mood
сънувания-нета	сънувате	lemma
отбождащото	избодем	Tense
предупреди	вярвали	Tense
изговарям	хапал	Number
граничат	допринася	Mood
изплитай	сравни	Person
повтаряха	агитаторите	Number
будещ	будят	lemma
снасящите	протекло	Voice
инвестирах	биете	Mood
благославяна	прегръщахме	Tense
по-аметистови	шефове	Case
посещаваните	могло	Tense
вечерят	преведе	Mood
изплашвани	изгребвалата	Tense
надонасяйте	закусите	Person
абдикиращ	абдикират	lemma
завлечало	плетяха	Tense
главо	влъхви	Case
студентстващи	наболата	Voice
подкупваният	анилиново	Number
сило	препичано	Number
опасеният	опаслата	lemma
шантажирам	продължавахте	Mood
по-аналитическо	по-аналитически	lemma
опаслото	звяр	Number
снасящите	простряла	Voice
наранилото	наранило	lemma
благословиш	принесяха	Mood
унесели	почитащото	Voice
убеждавате	зачитах	Mood
обучили	умиращият	Voice
погребвахте	наводнен	Tense
заслужавай	аплодира	Person
убедилото	съобщавани	Tense
беглото	по-бегло	lemma
доведохте	допирала	Tense
уплашвали	загубващото	Voice
загиваща	по-железния	Number
лекарят	по-абсурдни	Number
спасявахме	мечталият	Tense
подобри	стана	Person
тръгва	погледни	Person
прегърнем	отчитайте	Number
дай	врабчето	Number
размени	други	Case
изчезващ	изчезват	lemma
забраняваха	възпираният	Tense
подслушвалият	подслушванията-нетата	lemma
най-седмо	изневярата	Number
пътува	купите	Mood
комбинирали	разнесях	Tense
проври	довеждаш	Person
най-медицинската	най-медицинските	lemma
южняци	най-светли	Case
изминаха	възпираният	Tense
ближехме	потичалият	Tense
очното	по-очно	lemma
безбройни	отци	Case
отсичам	обучихте	Mood
разлюбилият	озадачавахте	Tense
господарувах	обзавеждат	Mood
отвеждали	работещата	Voice
отсичахте	повлечете	Person
черни	бедняци	Case
по-жълти	сантилитри	Case
инвестираш	буди	Person
убедим	забрави	Mood
обрекли	разлюбеният	Tense
посещаваните	изплете	Tense
почващият	подчертали	Voice
залезела	учихме	Tense
решава	понавлизаме	Mood
клади	сравни	Person
най-сеизмичният	по-сеизмичната	lemma
мажа	най-агресивният	Number
черни	кошмари	Case
напича	кралю	Number
оцелееш	казахме	Mood
замитащи	замитащите	lemma
лекцията	крадеш	Number
лекцията	спряло	Number
агрохимичко	кълвачи	Case
заплелия	съчетаха	Tense
примираш	одобрявахме	Mood
горят	допичаше	Mood
заслужавахте	казвайте	Person
недостатъчни	петаметри	Case
мряха	разпростра	Mood
гласуващият	повлекли	Voice
анатемосващ	спестявалите	Voice
препоръчвано	по-мъртвия	Number
танцувай	отвори	Person
допека	допекла	lemma
юнака	предскаже	Number
помагали	подчертаваният	Tense
съчетаващ	съчетават	lemma
премиралото	премирало	lemma
даваше	създадем	Mood
вземах	вземаното	lemma
компетенции	италиански	Case
изплашва	създадохме	Mood
поведи	сравни	Person
важни	отци	Case
платилото	платилия	lemma
злоупотребяват	прегръща	Mood
побеждаваше	казваме	Mood
отсичането	отсичалото	lemma
прегърналото	прегърналия	lemma
съчетаваният	съчетавалата	lemma
балкане	авантюристки	Case
най-седмо	насмети	Number
препоръчвано	по-решителната	Number
получаваше	комбинирали	Tense
благословяха	пронасям	Mood
продължилия	корящи	Voice
зачете	захапете	Mood
пращахте	по-уклончивите	Number
подпряната	начетохте	Tense
излезете	отвеждах	Mood
наклаждаха	грабиш	Mood
заслужавай	отнасяше	Person
подкупвалият	презряхме	Tense
обясняха	нагризвана	Tense
загиващата	узаконявали	Voice
астероиди	глупави	Case
разболяващия	наводнели	Voice
черни	екзарси	Case
протичащо	протича	lemma
врящата	допринасяли	Voice
запичалата	прощаващи	Voice
охранявам	окрадване	Number
обезсмъртявали	счупваното	Tense
по-дясно	радя	Number
зашива	оцелеем	Mood
по-жълти	алгоритми	Case
дебелях	по-продаваческото	Number
изчетете	прозря	Mood
надвнесем	нахапеше	Mood
биеш	прочелото	Number
шибащата	попитвали	Voice
монаси	германски	Case
изгризвала	изпичаха	Tense
припичайте	бушувахте	Person
доказвахме	подслушвалата	Tense
повярва	благословят	Mood
обучаваното	съчетавахте	Tense
падахте	съобщеният	Tense
изковавате	съчетаех	Mood
чу	честваме	Mood
най-македонска	по-благия	Number
изминаха	насметяло	Tense
закупете	унищожихте	Person
чувам	чувала	lemma
наказваше	студентстващата	Number
пренасяхме	загине	Mood
корели	изнесе	Tense
изпилият	въоръжаващи	Voice
изчиташе	писалите	Tense
наплитаща	наплиталите	lemma
обезсмъртяваха	нагризвана	Tense
заподозирали	спрения	Tense
по-кукувичият	озадачи	Number
разбиращи	разбиращите	lemma
учила	най-първоразрядното	Number
по-евтино	по-евтини	lemma
чете	честваме	Mood
отрекохме	разлюбеният	Tense
решавахте	казвайте	Person
оцветиш	прелъстявахме	Mood
арестувало	тръгваха	Tense
ползвахме	унищожавалата	Tense
пикаех	навлекат	Mood
пречупвахте	разпростра	Mood
наизлизала	наизлизаше	lemma
студове	плуже	Case
сприятеляваният	допичахте	Tense
бегълци	убедим	Number
слон	наеми	Number
най-верни	алгоритми	Case
живеният	вярвали	Tense
боядисаме	боядиса	lemma
битпазари	беднички	Case
високите	победи	Number
акордеоне	пуйки	Case
подобри	отнасяше	Person
поопекъл	плетяхте	Tense
изкусното	най-тънка	Number
закусилото	закусило	lemma
предплащащ	дебелеят	Tense
навеждащите	чуеш	Tense
наплетем	засече	Mood
шунки	крамоло	Case
препоръчваше	изпридате	Mood
живееше	по-аналитичен	Number
анулирах	разболеете	Mood
уплашваща	уплашвалите	lemma
победиш	най-агресивният	Number
абсорбиран	по-продаваческото	Number
започващ	започващи	lemma
плачещата	плакала	lemma
възпиращите	дъвчел	Voice
разлюби	аплодира	Person
навличам	изговорихте	Mood
пренася	анатемосате	Mood
влезем	влезе	lemma
горят	вярвах	Mood
разплаче	най-реалистичният	Number
насичащото	препоръчали	Voice
осинови	осиновения	lemma
богът	пращал	Number
влизала	влизах	lemma
въоръжавахме	преживееш	Mood
привнесял	навличащите	Voice
лекомисленото	по-лекомислено	lemma
по-августейшите	най-августейши	lemma
подчертали	интересува	Tense
пушите	съчетаех	Mood
посещаваните	лягало	Tense
зидарки	вратовръзко	Case
мазаната	гвоздею	Number
заслужената	произнасяхме	Tense
построявалата	разбирани	Tense
анатемосах	намекнат	Mood
обезсмъртиш	по-бавничкия	Number
по-неспособно	по-неспособни	lemma
изминели	озаглавяващия	Voice
запечения	купувахме	Tense
отсъстваше	мечтаем	Mood
засича	оцелеем	Mood
надонесъл	отключващите	Voice
подведяха	спася	Mood
унасяха	най-пъргави	Number
живеещите	изминело	Voice
съчетаваното	съчетавано	lemma
инвестиращите	пречупела	Voice
оцелява	казвай	Person
понесло	слизам	Number
прегърнем	доведените	Number
по-възголемия	допринасяло	Number
аргати	аксиомо	Case
събудехме	отвличаш	Mood
получаваш	довличащи	Tense
прочете	разнасяли	Tense
решавахте	затичайте	Person
бихте	заплаши	Mood
ползващо	ползвах	lemma
убедеше	заревават	Mood
написаният	замряхме	Tense
получаваните	получаваха	lemma
пренася	мечтаете	Mood
доплитането	бастун	Number
граничат	погледнах	Mood
простиращо	простира	lemma
подклаждащата	подклаждаш	lemma
благославяли	допичаше	Tense
опасващ	опасват	lemma
заврелият	корящи	Voice
тръгваща	навестят	Tense
разходи	съзирахте	Mood
влизаш	понавлез	Person
подчертали	взема	Tense
най-унгарски	зъби	Case
биещ	бият	lemma
заслужената	изгубихте	Tense
присъстващият	присъствалото	lemma
безделничеха	заплашвало	Tense
припирано	учихме	Tense
можещо	заредилите	Voice
зачете	понавлизаме	Mood
навлечете	насякохте	Person
зими	германски	Case
замитаният	замитайки	lemma
злоупотребихме	преживееш	Mood
побеждаваше	захапете	Mood
презират	изгубвах	Mood
използвания-нета	използвайте	lemma
лопати	енергични	Case
обезсмъртяваха	подкладяло	Tense
здрави	горелки	Case
пътува	казваме	Mood
нанасялото	опридахме	Tense
тръгва	казвай	Person
интересуваме	казваше	Mood
прегърнем	птици	Number
благословяха	тичаш	Mood
писателствалият	писателствал	lemma
бесиха	полудееш	Mood
разходи	дъвчехме	Mood
ограничаваха	изплаша	Mood
обличайте	примрете	Person
закупените	изплете	Tense
забравяният	доктор	Number
припряхте	надебелее	Mood
казвана	казвали	lemma
автомобилът	допринасяло	Number
причиняваното	най-енергичен	Number
по-ябълковото	слизам	Number
назовавах	пикаете	Mood
отчетения	азербайджанец	Number
разболее	чухме	Mood
най-възможни	лешове	Case
изнудехме	обещавал	Tense
създаваният	очаквали	Tense
смазващ	смазващи	lemma
предсказаният	подчертаели	Tense
насмитащ	насмитат	lemma
разплакваните	разплакваха	lemma
бръмбара	печати	Number
залезела	сврените	Tense
американска	североизточни	Number
наплитащия	наплитани	lemma
кладеш	надебелей	Person
надвнесоха	убивам	Mood
пикаещата	опасвали	Voice
почващия	почвани	lemma
изпечахме	изпечено	lemma
науко	петаметри	Case
пием	пи	lemma
зачетат	опече	Mood
отичахме	обучава	Mood
заредена	зъбеца	Number
допрочитащата	изслушали	Voice
мачове	бързички	Case
изчезвали	получаващия	Voice
извлечи	вдишваше	Person
оцветиш	предяха	Mood
поопичаното	разлюбиш	Number
розо	отци	Case
метеше	казвай	Person
изчезвали	почитащото	Voice
наказалите	десети	Number
авансиращо	авансира	lemma
събуди	продължавате	Mood
вертолете	евнуси	Case
по-аналитичните	по-аналитично	lemma
презира	обзавеждат	Mood
пренасяното	бастун	Number
снесли	прозиращия	Voice
бягай	припреш	Person
построявалото	попечахте	Tense
изсичаха	повеждал	Tense
обещаващи	джамиите	Number
правя	заспаха	Mood
попитвала	заспиваха	Tense
астероиди	по-храбри	Case
повтарящите	срещал	Voice
засича	залязваме	Mood
най-абаносовият	плащала	Number
бежанко	кошмари	Case
купуващи	искрените	Number
посещаващия	посещавани	lemma
обезглавява	изчезването	Number
подпреше	подмиталите	Tense
прозря	понавлизаме	Mood
изрекли	простиращото	Voice
очаквания	баща	Number
по-аметистови	бедняци	Case
коронясвало	грешихте	Tense
обезсмъртите	ягоди	Number
ограничавахте	бесилия	Tense
зареждаща	забравите	Tense
убедим	прозря	Mood
подобрели	попичащия	Voice
децилитри	гъркиньо	Case
забрано	пуйки	Case
обилни	родини	Case
обезглавиш	най-неузрелия	Number
живееше	трезвения	Number
съветващия	осиновили	Voice
най-абсурдната	най-абсурдните	lemma
подкладете	наплетеше	Mood
извлечи	сравни	Person
виелици	енергични	Case
изкупувахме	изгребвалата	Tense
съветващия	започвали	Voice
гърцизми	авансови	Case
биещ	биещи	lemma
хеликоптери	енергични	Case
гущере	воли	Case
по-земетръсни	пуйки	Case
надколянното	по-надколянно	lemma
провира	подвеждахте	Mood
разлюби	припадаш	Person
източни	ебане	Number
по-диво	по-диви	lemma
получехме	получено	lemma
обезсмъртяващия	обезсмъртявани	lemma
битпазари	гъркиньо	Case
влизаш	погледни	Person
изгризвал	азиатко	Number
озаглавявахме	изречената	Tense
убитото	молиха	Tense
изслушай	присъстваш	Person
моленето	молената	lemma
ядат	убих	Mood
отвеждали	простиращото	Voice
загиваща	зъбеца	Number
пращаше	дадем	Mood
опича	обещавали	Tense
заслужиш	изнеси	Person
мачове	енергични	Case
по-земетръсни	глави	Case
обещаващи	птиците	Number
подобри	отвори	Person
заречеше	сврените	Tense
изпявалият	по-сръбска	Number
подписвалия	допичахте	Tense
надвнасяхте	попитала	Tense
принеси	препрочиташе	Person
разлюбеното	изгубихте	Tense
продажбеното	по-продажбено	lemma
подкупваният	носороже	Number
набоде	засечените	Tense
изсичаха	построяваният	Tense
подписвалия	начетохте	Tense
измрем	запрени	Number
занасящата	предрекли	Voice
врящата	узаконявали	Voice
отсъстваше	пикаете	Mood
единадесетата	жена	Number
зарича	прегърнат	Mood
озаглавявахме	запичаната	Tense
надвнасяща	надвнасялите	lemma
маймуно	печати	Case
пикаех	опичате	Mood
плащаш	заораваха	Mood
одобрявахме	надвнесеният	Tense
попитвала	запалваха	Tense
децилитри	бронтозавре	Case
правехме	влязъл	Tense
анулирах	сравнят	Mood
розо	венци	Case
навлякох	изречете	Mood
покриви	бронтозавре	Case
срещаме	среща	lemma
по-анасоново	по-анасонови	lemma
небесносиньото	по-небесносиньо	lemma
абразии	бедничките	Number
изчезвали	простиращото	Voice
съчетавана	съчетаха	Tense
сиромахкини	най-първоразредните	Number
осиновяват	разнесе	Mood
удовлетворявано	чупехте	Tense
тича	изчезването	Number
науко	биокомпютри	Case
уволняващият	привнасяте	Tense
загубила	начитахте	Tense
загубвало	кладяха	Tense
събуди	изгребвай	Person
злоупотребят	заплетох	Mood
абсорбиран	най-гърдестата	Number
загребваните	донесеше	Tense
врящата	плашели	Voice
повлякло	обрекоха	Tense
чорапогащнико	кошмари	Case
унесели	прозиращия	Voice
говорил	произнасяхме	Tense
пишеха	птиците	Number
прозират	допринася	Mood
прехапваща	прехапвалите	lemma
опасъл	предсказваха	Tense
разболяваше	най-слабата	Number
уволните	въврете	Person
заспим	реши	Mood
припирано	тръгваха	Tense
най-арабската	най-арабските	lemma
пиенето	питата	lemma
наследявали	построяваният	Tense
завлечало	принесяха	Tense
почитането	почитаната	lemma
привнесохме	привнесяхме	lemma
решавам	решавала	lemma
влизали	бордеите	Number
най-неврелият	по-неврялата	lemma
храно	устни	Case
окрадях	продължавате	Mood
прехапващият	изоравате	Tense
по-сръбски	устни	Case
арестувало	аплодирахте	Tense
най-летни	изреваваща	Number
монаси	сандале	Case
можахме	зре	Mood
източни	най-агресивното	Number
произнесете	погледнах	Mood
по-низши	влъхви	Case
прелъстеното	дециметър	Number
потушахме	потушено	lemma
побеждаваме	побеждава	lemma
купено	купела	lemma
дотичащото	довлекли	Voice
навлечете	падахте	Person
чуваше	вярвали	Tense
наизлизащият	оцелеят	Tense
високите	убедим	Number
корящия	предрекли	Voice
обезглавява	надонесеният	Number
пчеларю	езици	Case
заревавала	зареваваше	lemma
запичащата	запичала	lemma
допрочитащата	изпивали	Voice
изминели	затичащият	Voice
разходи	принесяхте	Mood
адмирали	най-предпазливи	Case
очаквах	запалвани	Tense
предреченият	предреклата	lemma
пуши	плашехме	Mood
снасящата	снасяла	lemma
храно	печати	Case
апетити	аварко	Case
подкупите	презирайте	Person
доказали	бедничките	Number
пречупвайте	предплащали	Number
проницателни	оскъдно	Number
горят	разплакваше	Mood
алхимички	глупави	Case
обезглавява	зъбеца	Number
учила	бие	Number
безбройни	овни	Case
прости	разболял	Number
припеви	аскере	Case
пестим	пести	lemma
подведат	преведе	Mood
отрекохме	наследява	Mood
зрящата	зреш	lemma
простят	преведе	Mood
принесеното	принесено	lemma
изминаха	спряно	Tense
нанасял	обсъдихме	Tense
повтаряна	повтаряли	lemma
произтичащо	гласувалите	Voice
въвлечахте	чупело	Tense
храсти	по-югозападни	Case
питахме	заспива	Mood
пуши	отечахте	Mood
лопати	най-чудати	Case
бягаше	пикаете	Mood
повтарящите	припирал	Voice
подведат	присъствах	Mood
надебелявалото	въоръжаващи	Voice
понесло	изневярата	Number
изговарят	чучулиги	Number
изпилият	прощаващи	Voice
изпиеха	спася	Mood
недостатъчни	документи	Case
плашещ	плашещи	lemma
падахте	насмитало	Tense
обсъди	най-югоизточни	Number
спряха	могло	Tense
ядат	опече	Mood
обсъденото	ушиха	Tense
единадесетата	пълен	Number
алхимички	най-големи	Case
клади	изговаряше	Person
опридалият	оприданията-нетата	lemma
секлият	напредвахме	Tense
получавам	получавала	lemma
съзирам	зареждаха	Mood
заметените	заметяха	lemma
понесло	вериго	Number
най-босички	воли	Case
анатемосат	отсъствах	Mood
виелици	по-храбри	Case
изнуди	бушували	Tense
наранилият	обезглавяхме	Tense
обещаха	преживееш	Mood
чакала	чакаше	lemma
прегърнем	полудели	Number
създаваше	създадат	Mood
клади	дои	Person
окрадено	окрадяла	lemma
сиромахо	авантюристки	Case
слон	бие	Number
изпявана	писалите	Tense
наследява	по-мъртвия	Number
обезсмъртявали	наемания	Tense
обезсмъртява	отмирай	Person
изневери	жълъде	Case
дебели	бие	Number
восъко	документи	Case
отварящите	шиба	Tense
опрял	навличащите	Voice
спасявам	спасявала	lemma
близичките	заведохте	Number
живеещите	строял	Voice
врящата	предрекли	Voice
заплитания-нета	заплитайте	lemma
прочитаните	лягало	Tense
безделничеха	отключвания	Tense
играещия	играни	lemma
северното	ограничаван	Number
понапечахме	понапечено	lemma
кошульо	алебарди	Case
излезте	изпридахте	Person
чака	казваме	Mood
понапечало	убиващите	Voice
пасящ	пасат	lemma
предяла	навличащите	Voice
режеше	донасяли	Tense
охраняваха	ограничената	Tense
мажем	побеждаващото	Tense
арки	най-второразредни	Case
наизлизалите	заспа	Tense
навеждащите	граничиш	Tense
прехапят	продължи	Mood
събуди	заковавай	Person
подкупена	подкупели	lemma
говорено	говорела	lemma
препоръчвано	по-алкохолната	Number
морковът	абсурдна	Number
започнеш	казвай	Person
инвестиращите	правила	Voice
битпазари	млечнобели	Case
ядат	преведе	Mood
разболее	припичахме	Mood
давали	става	Tense
по-несъмнените	най-несъмнен	lemma
осиновяват	вярвах	Mood
вземалите	нанесат	Number
съчетавана	тръгваха	Tense
лизал	завличахте	Tense
допрочетох	забременеете	Mood
припичащ	припичащи	lemma
ометяха	нанеса	Mood
пътува	залязваме	Mood
заплетена	съчетаха	Tense
по-хепатално	по-хепатални	lemma
заспял	бомбардиращите	Voice
най-цялата	най-целите	lemma
източни	по-разсъдително	Number
бягай	изговаря	Person
опридали	става	Tense
свираме	аплодира	Mood
одобрихме	анатемосвала	Tense
преживееше	снасяй	Person
чуха	зачета	Mood
пронасянето	пронасяната	lemma
хомосексуално	пристига	Number
проницателни	зърно	Number
простят	убих	Mood
ограничават	занасях	Mood
отричалият	озаглавявахте	Tense
вярваш	чакал	Number
срещаното	срещано	lemma
правителства	танцувате	Number
надонасям	заченеха	Mood
въвряхме	преживееш	Mood
повярвалите	абдикираща	Voice
отчетения	най-тънка	Number
припичайте	унищожихте	Person
надебелява	заспивате	Mood
потушаваща	корилите	Voice
убедим	аплодира	Mood
пикаещата	надонесли	Voice
наследява	най-тънка	Number
най-авторитарната	замирало	Number
опрете	зачитах	Mood
въвирах	въвираното	lemma
изсичаха	бесеното	Tense
изпасваме	изпасва	lemma
хеликоптери	лесе	Case
чуването	пречупваше	Number
създадеш	казахме	Mood
университете	бели	Case
най-седмо	мъртви	Number
счупвате	зачитах	Mood
яла	мажехте	Tense
опридащите	прехапал	Voice
възпрели	поизмете	Tense
унищожавах	унищожаваното	lemma
почитам	забодяха	Mood
презира	създадат	Mood
плача	насякохте	Mood
снесли	допичащият	Voice
болногледачки	най-светли	Case
бягай	зачете	Person
чакания-нета	запалват	Number
зачиташ	господарствуваха	Mood
повярвате	изберете	Person
обясняващо	обяснява	lemma
вожд	обича	Number
най-летни	зидарката	Number
поднесете	надонесе	Mood
отхапаха	навираното	Tense
изрече	изречения	lemma
запечения	начитахте	Tense
уплашваше	завеждат	Mood
по-южната	най-южна	lemma
загива	биете	Mood
ползвахме	съобщеният	Tense
благославяли	обвиненото	Tense
пушите	вярвах	Mood
наранилият	грешихте	Tense
чуваше	обезглавилите	Tense
изговарят	потъвали	Number
кит	кралю	Number
ползваното	ползвано	lemma
навестили	работещата	Voice
вдиша	прелъстените	Tense
чуваше	запалвани	Tense
пекари	други	Case
презираш	извлечаха	Mood
бесещо	бесех	lemma
наобличащият	баща	Number
дебелеения-нета	дебелейте	lemma
обсъди	археоложка	Number
наплетем	анатемосваше	Mood
по-низши	змеици	Case
абразии	зачитайте	Number
пуши	доведохте	Mood
убедим	вдишва	Mood
изслушам	желаха	Mood
боядисва	прегърнат	Mood
най-авиационното	мъртви	Number
по-неголемите	чучулиги	Number
построяла	безскрупулния	Number
опеченият	предсказваха	Tense
прочитаните	принуждава	Tense
подчертавал	чувахте	Tense
обезсмъртяла	най-неузрелия	Number
изтърваваха	боядисваната	Tense
по-дясно	най-анонимни	Number
университети	най-второразредни	Case
кладе	хайдуко	Number
некомпетентното	по-некомпетентно	lemma
честват	съществуващия	Tense
повтори	повторения	lemma
алтовото	по-алтово	lemma
пуяци	по-гърдести	Case
убитото	убито	lemma
кладеш	поспри	Person
уплашвалото	уплашвалия	lemma
господарувах	изречете	Mood
виждащият	по-усърдна	Number
извлечи	доеше	Person
инфантилни	биволи	Case
създадеш	хапахме	Mood
подклажда	създадем	Mood
най-модерното	разлюбела	Number
затеклото	окрадваха	Tense
загубвало	изминеха	Tense
съчетаехте	припаднете	Person
най-съвременната	най-съвременните	lemma
пренесеш	наведяхме	Mood
привнеси	вдишваш	Person
навличащо	навличах	lemma
комбиниращият	комбиниралото	lemma
вълци	мускули	Number
обречала	заспиваха	Tense
удовлетворяващ	удовлетворяващи	lemma
зареждането	зарежданата	lemma
почитам	съзирахте	Mood
забожданият	забождайки	lemma
презиращия	презирани	lemma
обезглавява	испанският	Number
дотичащото	наводнели	Voice
презираш	отхапеха	Mood
най-чудесно	надонесеният	Number
корели	заповядва	Tense
винящо	победите	Tense
ограничаващо	ограничава	lemma
по-кадърно	по-кадърни	lemma
провира	насякохте	Mood
понапичащите	гласувал	Voice
изковаваха	изгубел	Tense
по-австралийските	по-австралийско	lemma
по-лукаво	по-лукави	lemma
бактериолози	по-ароматните	Number
закусиха	грешенията-нетата	Number
по-реалистичните	по-реалистично	lemma
наемащ	наемащи	lemma
бушуващата	чуем	Tense
примря	заковавай	Person
анатемосаха	желаещи	Number
корена	корели	lemma
заковаващото	предричат	Tense
зарича	създадат	Mood
възпиращите	прегръщала	Voice
разпростирала	окрадваха	Tense
вечерят	поизметеше	Mood
най-верни	горелки	Case
препрочиталото	препрочиталия	lemma
сънувайте	заченехте	Person
убедим	дадеше	Mood
обречала	мажехте	Tense
ходещия	отхапваме	Tense
срещани	решите	Number
шантажираща	шантажиралите	lemma
подчертали	купуваното	Tense
по-авторитарни	бакшиши	Case
по-любителската	най-любителска	lemma
понесеното	режа	Number
погребвахте	отключвания	Tense
доказващ	доказващи	lemma
обвинявали	изчете	Tense
давали	поглежда	Tense
полученото	получено	lemma
възлязоха	посъветвалия	Tense
отхапваш	изгубвалата	Number
понапичалите	запридах	Tense
забранявала	забранявах	lemma
отвеждали	играещият	Voice
заповядвали	казаното	Tense
прегърнем	по-хубави	Number
обяснявалото	корящи	Voice
посети	оцелеем	Mood
извлечахме	ухапваният	Tense
казвалите	завлече	Tense
най-отвесния	по-детинска	Number
нанасяме	загубва	Mood
помагали	разлюбената	Tense
най-авторитарната	потъващ	Number
врабче	североизточни	Number
пекари	италиански	Case
кървящият	чуем	Tense
опасъл	грешихте	Tense
подробни	документи	Case
предсказвал	заподозираха	Tense
източни	зъбеца	Number
излизащия	обезглавявате	Tense
бегълци	доведените	Number
изпяваща	изпявалите	lemma
излезлият	излязъл	lemma
наказали	озаглавяващия	Voice
сравнената	заспиваха	Tense
пастири	енергични	Case
слезеше	прегърнат	Mood
подписващата	подписваш	lemma
очаквания	звяр	Number
разболявам	разболявалите	lemma
мечоци	по-водоравните	Number
говорените	ухапва	Tense
пекари	глупави	Case
чулият	по-разсъдително	Number
пекари	арменко	Case
подкупите	срещайте	Person
възпрели	надонасяната	Tense
срещал	напредвахме	Tense
прегърнеше	завеждат	Mood
нахапеше	поизметем	Mood
прехапвахме	надебелее	Mood
обезсмъртяла	пейзажът	Number
привнасяла	привнасях	lemma
вуйчовци	доведените	Number
отсичащ	отсичащи	lemma
агенти	бързички	Case
най-разсъдливи	бакшиши	Case
крадена	крадели	lemma
зачетат	допичаше	Mood
бойци	глупави	Case
интересуваме	наранява	Mood
господаруващата	заслужат	Tense
бедуинки	агитаторите	Number
навреният	плетяха	Tense
сило	изгубвалата	Number
унищожава	изсичат	Mood
въвира	подметем	Mood
заметохме	оцветила	Tense
агенти	по-гърдести	Case
пести	оцветилите	Tense
наказаното	наказано	lemma
пуши	изпредохме	Mood
вратовръзка	пейзажът	Number
нанасяме	запече	Mood
поборника	пикометри	Number
злоупотребяват	подписах	Mood
събудехме	вярваш	Mood
биеше	дадем	Mood
наводнява	наводнявания	lemma
унищожава	създадат	Mood
създаваният	предсказваха	Tense
подробни	зъби	Case
бегълци	метените	Number
шантажирания-нета	шантажирайте	lemma
попичали	изслушващият	Voice
паланко	бакшиши	Case
загубващ	загубващи	lemma
понеслата	заметяха	Tense
брал	бойлерът	Number
пристигнат	изпитваше	Mood
по-сръбски	биокомпютри	Case
спичащият	въоръжих	Number
плащащо	плащах	lemma
по-авторитарни	бели	Case
раняващ	раняващи	lemma
охраняваните	протекла	Tense
възлязлата	обзавеждаха	Tense
ограничаващи	ограничаващите	lemma
възляза	заредяха	Mood
най-опитният	по-опитната	lemma
въвря	изчитаща	Number
помагали	става	Tense
избирани	заспа	Tense
комбиниращ	комбиниращи	lemma
подпирания-нета	подпирайте	lemma
заслужената	вярвали	Tense
чуването	най-отрицателна	Number
по-дясно	трезвения	Number
прости	отнасящият	Number
заричащата	авансирали	Voice
пристигнат	погледнах	Mood
възпира	оцветяхме	Mood
обезсмъртиш	археоложка	Number
корели	закусвах	Tense
домитай	уши	Person
вселена	обича	Number
допринасях	зърно	Number
изтърваваха	опридано	Tense
по-аметистови	алебарди	Case
подобри	замита	Person
залезеше	обесвай	Person
охраняваните	забраняваше	Tense
отваряхте	смажете	Person
арестуваща	арестувалите	lemma
най-практична	практично	lemma
бакалаври	вратовръзко	Case
опираща	опиралите	lemma
целувало	казваха	Tense
понавлезеха	нанасяш	Mood
допрочетох	нахапят	Mood
изплашващ	изплашващи	lemma
будало	камъни	Case
обясни	прочетени	Tense
губилото	губило	lemma
въвлечахте	боядисваната	Tense
простят	въвирах	Mood
загубиха	мускулните	Number
зашития	допичахте	Tense
питам	подкупиха	Mood
коронясващ	коронясващи	lemma
гвоздею	алебарди	Case
инвестирах	презрете	Mood
завличаният	завличайки	lemma
съзирам	играеха	Mood
припеви	глупави	Case
най-бавната	най-бавните	lemma
разболяващия	предрекли	Voice
разплакващи	разплакващите	lemma
бушуващата	избодем	Tense
отхапаха	мразилата	Tense
отлично	убива	Number
поопичахте	запичаната	Tense
млъкващ	млъкват	lemma
примираше	изречете	Mood
замираше	изчитай	Person
подчертаеше	препрочетете	Mood
отхапвахте	изберете	Person
мрелите	купувах	Tense
плачещата	плачеш	lemma
удовлетворявала	поопичащите	Voice
американска	трезвения	Number
вечерят	заплита	Mood
авансираните	убило	Tense
зрем	зрящо	lemma
строяхте	обрека	Mood
замитащият	отвеждали	Voice
вожд	обзаведе	Number
бягай	почва	Person
продават	погледнах	Mood
попитвам	скуо	Number
можа	довличаме	Mood
героиньо	шипки	Case
унасяха	сестриците	Number
ограничават	казва	Mood
отбожданият	отбождайки	lemma
изпитащо	доведете	Tense
чорапогащнико	овни	Case
единадесети	камъни	Case
питам	заредяха	Mood
надонасям	забодяхте	Mood
храно	пуйки	Case
разболяващия	надонесли	Voice
принудех	мечтаете	Mood
наковаващ	наковават	lemma
артикуле	венци	Case
по-широкият	четящо	Number
доплитащото	заревавали	Voice
припичайте	закусите	Person
изсечени	завлече	Tense
мряха	закуся	Mood
агенти	по-абсолютни	Case
предплащащата	предплащала	lemma
хората	изплашвани	Number
надебеляхте	кървете	Person
изплита	биете	Mood
подпряното	подпряно	lemma
интересуващ	интересуващи	lemma
по-бялата	най-бяла	lemma
подобрена	подмиталите	Tense
обвинявам	обвинявалите	lemma
зачете	биете	Mood
най-възможни	сантилитри	Case
нахапвам	нахапвалите	lemma
серяща	оцелеят	Tense
отмиралият	отмирал	lemma
слушахме	заплаши	Mood
автогаро	по-решителната	Number
вършеенията-нетата	върша	lemma
разплачехте	кървете	Person
повтарящите	получавала	Voice
разбиращ	разбират	lemma
пръчки	аварко	Case
пчеларю	кълвачи	Case
победим	разнесе	Mood
довлечеше	пейзажът	Number
озадачавайте	подпишехте	Person
розо	чираци	Case
провирала	провирах	lemma
шибащата	ушивали	Voice
разбра	дадем	Mood
получаваше	възпрени	Tense
най-свръхестествени	езици	Case
примирам	абсорбирахте	Mood
изгризваш	почитай	Person
търбуси	бацилоносителко	Case
обещаха	нанеса	Mood
засича	изсичат	Mood
вечерящата	подобряваме	Tense
мажа	начетен	Number
покриви	по-важни	Case
пастири	сило	Case
потушавала	потушаваше	lemma
нараняваше	винящо	Number
повторела	повтореше	lemma
загивал	благодарихме	Tense
снасялите	адресиращо	Voice
набоди	зъбеца	Number
можа	оцелеем	Mood
драконе	лешове	Case
потушавате	обезсмъртявах	Mood
безбройни	зъби	Case
ограничават	изпитваше	Mood
автономии	печате	Case
сънувайте	ранявахте	Person
наемам	наемала	lemma
адмирали	по-слънчеви	Case
изговарям	най-светлосиня	Number
опасващи	по-ароматните	Number
предсказа	оцелеем	Mood
заченат	побеждава	Mood
създадеш	преживявахме	Mood
мажем	изгребващия	Tense
спирала	потушаващите	Voice
запаля	изсеклият	Number
отваря	доктор	Number
плащаш	разболяха	Mood
паса	паслите	lemma
морковът	дълбока	Number
по-авантюристичните	най-авантюристичен	lemma
замитахте	надебелее	Mood
спряхме	одобри	Mood
най-босички	петаметри	Case
изслушам	плачехте	Mood
вярваха	изплаша	Mood
написването	написваната	lemma
очакваща	написалите	Voice
навестили	попичащия	Voice
граничат	поопечах	Mood
злоупотребяваме	злоупотребява	lemma
разпростирам	навлизахте	Mood
навестявали	обричащото	Voice
произтичахме	въвлече	Mood
наследява	зърно	Number
препеченият	препеклата	lemma
живеещите	благославяло	Voice
забременялото	ползвахте	Tense
покриви	по-гърдести	Case
обесвания-нета	обесвайте	lemma
озадачавала	озадачавах	lemma
обрекли	закусвах	Tense
изпий	заповяда	Person
написващите	припекло	Voice
пушите	изтърваващо	Tense
повтарящите	простряла	Voice
запряно	давалите	Tense
аксиоми	започващите	Number
унищожавахме	кориш	Mood
презиращо	презирах	lemma
повярвалите	одобряващо	Voice
благословяха	изплаша	Mood
заподозря	закусваме	Mood
закусим	препичаше	Mood
построиха	убивам	Mood
заспал	убиващите	Voice
прави	правения	lemma
най-мускулестата	най-мускулестите	lemma
причиняващо	причинява	lemma
предричащият	влезех	Number
възпирала	възпирах	lemma
изтечете	изтичахте	Person
кървящ	кървят	lemma
донасялият	донасял	lemma
причинях	причиненото	lemma
обезглавява	анилиново	Number
озаглавявалото	озаглавявалия	lemma
отсичах	отсичаното	lemma
проври	поизмиташ	Person
отлично	бие	Number
пасенията-нетата	пасе	lemma
мачове	петльо	Case
окрадеш	сравняваха	Mood
купувай	доведе	Person
заспим	привнасяше	Mood
дотечах	брани	Tense
чакащ	чакат	lemma
наследявали	забраняваше	Tense
пикаещата	изковавали	Voice
безбройни	адове	Case
разлюбете	птиците	Number
припекох	навлекат	Mood
произлизайте	доведяхте	Person
навличания-нета	навличайте	lemma
наказваше	най-неузрялата	Number
понапича	казвай	Person
опридащите	повеждало	Voice
спряха	наболият	Tense
акордеоне	змеици	Case
напичах	заревават	Mood
изтървавала	въвличащите	Voice
счупвахме	счупвайки	lemma
вселена	пиканата	Number
изпивани	завлече	Tense
биеше	продължавате	Mood
смазали	получаващия	Voice
разплакват	разнесе	Mood
загребваните	заповядва	Tense
доящ	доящи	lemma
ушилият	радееха	Tense
патриарси	креативните	Number
въвирането	въвираната	lemma
алжирки	аварко	Case
изминаха	наболият	Tense
допринеса	вдишахте	Mood
подслушваше	понавлез	Person
примрелите	спрях	Tense
повтарящите	ял	Voice
пикаещо	пикаех	lemma
дъвка	североизточни	Number
подслушвахме	подслушвано	lemma
принеслата	отключваха	Tense
бягам	бягала	lemma
обезсмъртилият	въоръжаващи	Voice
по-авторитарни	кошмари	Case
отричай	подпреше	Person
изплашехме	изплашено	lemma
препоръчваме	аплодира	Mood
храно	евнуси	Case
пристигнахме	наследява	Mood
уплашвал	продавахте	Tense
построиш	казвай	Person
спасели	става	Tense
тича	аплодиран	Number
най-неразсъдливият	по-неразсъдливата	lemma
разболяващия	обосновавали	Voice
книги	арменски	Case
най-азотни	кълвачи	Case
драконе	бъзли	Case
изговарям	по-значителен	Number
простираш	попитващите	Tense
обезсмъртяваха	нахапвалият	Tense
овцо	алгоритми	Case
извлечи	накажеше	Person
изпилият	запалващи	Voice
озадачаваше	изпредем	Mood
излизащ	излизащи	lemma
най-зли	кълвачи	Case
разболеехме	разболяно	lemma
апетити	сило	Case
дъвкания-нета	дъвчете	lemma
обосновава	заковавай	Person
изкупуваният	изкупувалата	lemma
спрете	разплаква	Mood
побеждаваше	отсъствате	Mood
пращаният	ползвахте	Tense
доброто	носороже	Number
изковаваните	изплете	Tense
чуй	плати	Person
запиращия	подчертали	Voice
обеси	доктор	Number
обясня	обяснила	lemma
можех	заплашат	Mood
закусим	надонесе	Mood
ползва	лижат	Mood
озадачилата	благодарихме	Tense
търсеният	търсилата	lemma
подобри	доеше	Person
повлеклият	създаващи	Voice
прегръщаща	прегръщалите	lemma
отсичаща	отсичалите	lemma
забременялото	обзавеждаха	Tense
красиви	бели	Case
създаваният	обсъдихме	Tense
уволняха	преживееш	Mood
назоваваните	назоваваха	lemma
благославяли	спрения	Tense
изковавате	навлезех	Mood
пречупили	наказа	Tense
спирахте	повлечете	Person
убедим	казва	Mood
изслушващ	изслушват	lemma
драконе	агрохимици	Case
даваше	отсъствате	Mood
съчетавам	разболяха	Mood
--	по-полувисшият	Number
коронясващото	наплетели	Voice
възпиращите	избождал	Voice
подписа	закусваме	Mood
обесили	построяваният	Tense
изминало	мярко	Number
победиш	археоложка	Number
бакалаври	аскере	Case
изчитаният	изчитайки	lemma
отнасял	кладяха	Tense
подвеждащ	подвеждащи	lemma
бием	биещо	lemma
понапичащото	избодем	Tense
най-мускулни	номера	Case
втечняваната	ушиха	Tense
изведяхте	зачета	Mood
извлечи	одобряваш	Person
припичаха	победиш	Mood
отваряхте	въврете	Person
книги	най-аборигенски	Case
заченат	разнесе	Mood
простят	присъствах	Mood
станеш	поспирай	Person
разлюби	потушава	Person
съчетавам	удовлетворявахте	Mood
донесеш	погледни	Person
най-дивата	най-дивите	lemma
помитащият	простим	Tense
нахапеше	попечем	Mood
простят	побеждава	Mood
изминаха	залязвалото	Tense
унищожавахте	ометената	Tense
спаси	спасения	lemma
по-южняшката	най-южняшка	lemma
повторил	абсурдната	Number
изгребващата	изгребвала	lemma
напредвахте	припаднете	Person
сило	дало	Number
алегорийо	лешове	Case
убитото	обещавали	Tense
завеждаха	довлечеш	Mood
произтича	казахме	Mood
мелото	въоръжаващи	Voice
псувньо	камъни	Case
навлякох	създадат	Mood
изкупи	наплитащата	Number
скучни	чупиха	Number
по-вертикалната	най-вертикална	lemma
наобличаше	оцелеем	Mood
танцувай	занася	Person
отечеш	почитай	Person
втечняваната	разнасяли	Tense
заченат	заплита	Mood
виждаха	спася	Mood
доведохте	нахапвалият	Tense
предупреждава	брани	Tense
вертикално	загиналият	Number
свирано	изревавалите	Tense
опрял	отключващите	Voice
загребвай	поведеш	Person
обсъжда	заплашат	Mood
вратовръзка	предсказва	Number
по-варварски	бели	Case
комунистко	алебарди	Case
възлязоха	помитаното	Tense
студентстващи	изкупувалото	Voice
посещаващ	посещаващи	lemma
обичах	съобщавани	Tense
корели	изговаря	Tense
южняци	абсцисо	Case
анакондо	горелки	Case
сврат	заслужех	Mood
въоръжаваният	заметяха	Tense
най-възможна	възможно	lemma
слушахме	тичаш	Mood
прехапят	подписах	Mood
чуха	наемания	Tense
отхапаните	изплете	Tense
подобри	доведе	Person
най-земетръсно	плаша	Number
превъзнесохте	ушиваната	Tense
замираше	изгребвай	Person
наизлизащото	отхапвали	Voice
сънувахте	нанеса	Mood
бакалаври	други	Case
мечтали	мускулните	Number
вковаващата	вковавала	lemma
изкупувахме	озаглавена	Tense
гласуващият	наводнели	Voice
зашива	прегърнат	Mood
вярваш	пълен	Number
ходихте	чупело	Tense
обвинят	презирания-нета	Number
даваше	препрочетете	Mood
излезте	пронасяхте	Person
убедим	закусваше	Mood
обвинявали	казаното	Tense
купувай	занася	Person
ближехме	причинявано	Tense
врящата	потекли	Voice
получавахте	одобри	Mood
разлюби	живя	Person
прощавала	измитащите	Voice
недостатъчни	горелки	Case
довлечеше	изчитаща	Number
осиновяваше	завеждат	Mood
изнудехме	наковавала	Tense
опекохте	власи	Number
обвинявали	протича	Tense
по-широкият	звяр	Number
по-непоколебимите	по-непоколебимо	lemma
разходи	грешихте	Mood
подчертали	нанесената	Tense
най-възможни	арнаутки	Case
изрекли	заричащият	Voice
отичахме	заплаши	Mood
преживееше	нагризвай	Person
обичах	обещавали	Tense
най-верни	агрохимици	Case
насичащото	потресли	Voice
допрочитащата	оцелявали	Voice
засича	надебелеят	Mood
безмилостна	обича	Number
авансе	алгоритми	Case
отваря	разсъдлив	Number
здрави	чираци	Case
казвалите	нахапех	Tense
по-варварски	глави	Case
примираше	залязваме	Mood
зверска	гения	Number
по-лилаво	по-лилави	lemma
поспиращия	поспирани	lemma
астролозите	ягоди	Number
изкупувахме	прочелата	Tense
плетем	плете	lemma
вечерят	допринася	Mood
серяща	засичат	Tense
мряща	простим	Tense
забравяло	бебешката	Number
учещи	учещите	lemma
упрекваме	упреква	lemma
по-ябълковото	най-югоизточни	Number
абаносовата	по-аналитичен	Number
ходихте	вдишвалата	Tense
пуши	навирахме	Mood
вълци	доведените	Number
дъвче	довличащи	Tense
спестяваме	плачещия	Tense
козли	решите	Number
закупените	интересува	Tense
бягащата	бягаш	lemma
бягай	изговаряше	Person
занасяше	запалвани	Tense
написахте	отвежда	Mood
снасялото	снасяло	lemma
купувала	обсъдихме	Tense
прощаваха	грабиш	Mood
виждаха	говориш	Mood
по-любознателните	допрочетяхте	Number
наранилият	взимаха	Tense
рачено	рачела	lemma
монаси	най-светли	Case
подробни	устни	Case
разлюбете	мъже	Number
причиняваното	хайдуко	Number
клади	доведе	Person
яла	ушиха	Tense
наводняла	убиващите	Voice
вратовръзка	режа	Number
вряхме	отключвания	Tense
унищожавахте	чупело	Tense
овце	плуже	Case
псувньо	номера	Case
покриви	други	Case
изкупувахме	обричано	Tense
бегълци	наоблеклите	Number
одобрявано	одобрявала	lemma
озаглавявахме	бесилия	Tense
продължаващият	измрат	Tense
изслушвалият	принесяха	Tense
тича	азербайджанец	Number
обличали	котараци	Number
организмът	опираща	Number
понеслата	обсъдихме	Tense
наказваше	понавлизаме	Mood
насмитате	смажете	Person
продължаващият	отвличат	Tense
напичах	унесат	Mood
небесносини	гения	Number
прощаваха	говориш	Mood
изреваващият	заревавали	Voice
вдишам	ранявахте	Mood
изпридалото	изпридало	lemma
чувай	адресираш	Person
слизалото	азиатко	Number
напредвахте	презирайте	Person
разлюбилият	ползвахте	Tense
подобрена	радееха	Tense
драконе	арнаутки	Case
инфантилни	родини	Case
втечнявай	най-югоизточни	Number
изчезнало	допичахте	Tense
нахапваха	посъветвам	Mood
превъзнесе	обзаведохте	Mood
понапичаните	допичаше	Tense
отнесеше	доплитате	Mood
говорил	прелъстените	Tense
изговаряният	изговаряйки	lemma
загребвал	съчетаха	Tense
най-лекарския	дълбока	Number
най-набожната	обича	Number
отмяно	чираци	Case
извлечи	прочетеше	Person
коронясвало	купувахме	Tense
игралият	игранията-нетата	lemma
напреднели	принасяше	Tense
агробиоложки	най-господарски	Case
по-кокошата	най-кокоша	lemma
насмитаме	насмита	lemma
легализираният	завличахте	Tense
предупреждаван	гласуването	Number
вратовръзка	най-агресивният	Number
изгризванията-нетата	давахте	Number
произтичахте	разбрания	Tense
доя	доила	lemma
тъпото	по-тъпо	lemma
произлизайте	уволнихте	Person
студентстващи	рачилия	Voice
дай	накълвавалото	Number
недостатъчни	воли	Case
изпитваха	отричам	Mood
легализиращият	легализиралото	lemma
помагащ	помагащи	lemma
оцелява	буди	Person
студове	котко	Case
произнесете	пренасях	Mood
одобрявала	одобрявах	lemma
изсичащи	изсичащите	lemma
чу	създадем	Mood
плача	отчитаха	Mood
чуй	отвежда	Person
изпивани	изминех	Tense
коронясващото	узаконявали	Voice
питам	питалите	lemma
северното	абсурдна	Number
покриви	котко	Case
биеше	заспивате	Mood
изнудехме	чупело	Tense
мелите	чупеща	Voice
говорените	говореха	lemma
най-чудесно	написваше	Number
уволните	презирайте	Person
принеси	сравни	Person
причинявали	заораващия	Voice
благославяли	казаното	Tense
бомбардиращата	бомбардираш	lemma
спестяваме	изтърваващо	Tense
заповядваше	премираме	Mood
прегърнало	обзаведе	Number
чакания-нета	въвряха	Number
напича	потъващ	Number
анулиращ	анулиращи	lemma
изпитащо	дебелеят	Tense
оцветявахте	спасявайте	Person
пушехме	пушихме	lemma
по-действителни	агрохимици	Case
ограничават	подписах	Mood
живеещите	давал	Voice
студентстващи	изгубилата	Voice
арки	германски	Case
излизащи	излизащите	lemma
жабарю	най-любопитният	Number
слоници	най-първоразредните	Number
забрано	цици	Case
плача	заораваха	Mood
благославяли	изречената	Tense
изсечени	заспа	Tense
изплита	заспивате	Mood
бягай	потушава	Person
изплашваният	изплашвайки	lemma
нанасяме	засече	Mood
попитаните	насмитало	Tense
горят	загубва	Mood
по-стомашните	най-стомашен	lemma
инфантилни	кошмари	Case
изминаха	предсказалият	Tense
подписвалия	благодарихме	Tense
бедуинки	най-сеизмичните	Number
наследявана	казваха	Tense
закусващите	опичало	Voice
будилата	запалващи	Voice
превеждам	превеждала	lemma
посети	унищожавате	Mood
компетенции	най-порнографични	Case
приятелки	облаце	Case
насичаха	произнасяш	Mood
потреслото	въоръжаващи	Voice
замитаното	дециметър	Number
заповядан	запридаха	Tense
чобанки	мравко	Case
юнака	припечи	Number
изпридали	наемания	Tense
пожари	по-неузрели	Case
заченат	вдиша	Mood
по-гребни	печати	Case
изминели	простиращото	Voice
окрал	учихме	Tense
небесносини	построеното	Number
гвоздею	воли	Case
заслужавахте	захапете	Person
обсъди	бастун	Number
убеждавате	надонесе	Mood
северното	слизам	Number
наранилият	наведяхте	Tense
изговарят	десети	Number
наказващ	наказващи	lemma
поопеклият	създаващи	Voice
безделничехме	безделничихме	lemma
окрадвах	охранявате	Mood
абаносовата	баща	Number
зачетената	плетяха	Tense
балкане	сантилитри	Case
измита	погледни	Person
зачете	оцелеем	Mood
решава	нараняват	Mood
обичах	арестували	Tense
врабче	победата	Number
най-амбициозен	прочелото	Number
допирали	доплитанията-нетата	Number
заковаваме	затресе	Mood
разбира	казахте	Mood
подведат	потъва	Mood
омелото	омелия	lemma
одобрявахме	изречената	Tense
абсорбиралото	обзавеждаха	Tense
привнесял	отключващите	Voice
заслужавахте	допринасяйте	Person
обещаха	убивам	Mood
превъзнесохте	мечталият	Tense
подкупваният	азербайджанец	Number
извлечахме	втечнявалият	Tense
прочели	играещият	Voice
победим	побеждава	Mood
допирам	допиралите	lemma
озадачавайте	уволнихте	Person
охраняващ	охраняват	lemma
рачиш	снасяй	Person
коронясано	най-турската	Number
подвежда	авгиевия	Number
затичаха	по-ароматните	Number
набоди	зърно	Number
винящо	предсказваме	Tense
храсти	други	Case
ограничах	ограниченото	lemma
ядосани	петаметри	Case
надвнесоха	тичаш	Mood
заповядвали	спрения	Tense
изтърваваха	понавлизал	Tense
гърцизми	енергични	Case
изневери	по-правителствени	Case
заподозираща	погледналите	Voice
припичана	припичали	lemma
обречете	наклаждах	Mood
навестяхте	разпростра	Mood
студове	най-предпазливи	Case
наклаждалото	наклаждало	lemma
поопичахте	бесилия	Tense
слуша	опират	Mood
потушавате	коронясваше	Mood
богът	шофьорка	Number
можахме	почете	Mood
грабена	грабели	lemma
по-северните	най-северен	lemma
допрочетох	завеждат	Mood
чу	осиновявате	Mood
ограничете	изпечахте	Person
зареваващият	заревавалото	lemma
инвестираме	инвестиращо	lemma
осиновяваше	разлюбваме	Mood
снасяли	преживения	Tense
колачко	шипки	Case
поопече	произтекат	Mood
влезлия	възпрени	Tense
произлизаха	надебеляващи	Number
изпридалото	боядиса	Number
по-аметистови	бакшиши	Case
заметохме	озаглавена	Tense
единадесети	биволи	Case
плащаш	играеха	Mood
одобрихме	отмряло	Tense
гласуваното	гласувано	lemma
пастири	глупави	Case
затечахме	затекохме	lemma
университете	шефове	Case
изминаха	затичала	Tense
опридана	победата	Number
кит	пейзажът	Number
одобрявахме	повеждал	Tense
домитанията-нетата	домита	lemma
пожари	гъркиньо	Case
изтървавала	потушаващите	Voice
анулиращият	отключите	Tense
вертикално	гласува	Number
прости	игралият	Number
аргати	котко	Case
надонасянето	надонасяната	lemma
обрекли	надонасяната	Tense
боядисването	боядисваната	lemma
най-лилава	авгиевия	Number
надебеляхте	серете	Person
правехме	изгубеното	Tense
книги	най-големи	Case
удовлетворявалият	удовлетворяванията-нетата	lemma
най-чудесно	изсеклият	Number
потичащите	вковавал	Voice
напреднели	поглеждах	Tense
по-анасонови	кълвачи	Case
центрове	чисти	Number
по-водоравно	по-водоравни	lemma
компетентностите	по-бременни	Number
ограничавахте	бесеното	Tense
абсорбиращо	спестявалите	Voice
замрях	доплитате	Mood
загубващата	загубваш	lemma
най-унгарски	глави	Case
назовавал	посещаващите	Voice
потресла	отсичахме	Tense
арестуваните	арестуваха	lemma
най-унгарски	алгоритми	Case
спрете	изпича	Mood
провирания-нета	провирайте	lemma
губещата	губила	lemma
заченат	подписах	Mood
целувало	окрадваха	Tense
правителства	навират	Number
обвиняваното	обвинявано	lemma
опираме	опиращо	lemma
закусващите	простряла	Voice
бралите	предплащаща	Voice
по-ябълковото	начетен	Number
произтичахте	изпасяла	Tense
по-беглите	по-бегло	lemma
уплашвали	прозиращия	Voice
наводнени	спрях	Tense
босичка	давалото	Number
най-близичка	по-кочият	Number
лесна	изчезването	Number
убеждаваха	спечеш	Mood
благославяли	заповядва	Tense
нанасяния-нета	нанасяйте	lemma
обясни	слушани	Tense
арестувах	арестуваното	lemma
адмиралите	власи	Number
гущере	овни	Case
снесохме	зре	Mood
абдикиралия	създаващи	Voice
донесеш	изнеси	Person
одобрихме	съобщеният	Tense
съчетавам	казахте	Mood
допичаният	учихме	Tense
полудявахме	отхапало	Tense
запалеше	господаруваме	Mood
звере	зъби	Case
обясняха	секлия	Tense
възпирахме	господарувало	Tense
бягай	ходиш	Person
важни	алебарди	Case
заричате	ягоди	Number
изминаха	ухапваният	Tense
танцуващо	корилите	Voice
припираща	спестявалите	Voice
най-пуйча	пуйче	lemma
дотичахте	зре	Mood
оцелеехте	предплатете	Person
написахте	заплаши	Mood
зарича	премираме	Mood
набождаща	прегръщате	Tense
снасяли	съобщеният	Tense
живеещите	подвеждал	Voice
давала	отключващите	Voice
допичам	бойлерът	Number
поднесен	кралю	Number
вечерящи	вечерящите	lemma
чуват	протичащия	Tense
по-кадърната	най-кадърна	lemma
обсъди	кралю	Number
излезете	обезсмъртеше	Mood
съобщаваше	полудеят	Mood
навеждалият	изговаряй	Number
обречала	сврените	Tense
пристигне	принесяхте	Mood
помелото	помело	lemma
единадесети	бедняци	Case
заслужената	прегръщахме	Tense
отвеждали	прозиращия	Voice
спрете	навлезех	Mood
отбождащото	отключите	Tense
най-ангелска	ангелско	lemma
изчитате	казвайте	Person
по-архаичната	най-архаична	lemma
омитахме	докаже	Mood
обрекат	казва	Mood
чуването	пристига	Number
отваря	пейзажът	Number
чуваш	бастун	Number
разпростирам	заковавахте	Mood
боевете	чупим	Number
круши	котко	Case
убиващият	убивалото	lemma
най-дълга	дълго	lemma
посещаващия	прегръщате	Tense
целувахте	убивам	Mood
доказвахме	принесен	Tense
превъзнесохте	пейте	Person
заплаши	заплашения	lemma
прегърнах	най-германски	Number
злоупотребяванията-нетата	злоупотребява	lemma
поспрели	обличащото	Voice
произлизащо	произлиза	lemma
южняци	аварко	Case
господарствуваше	произтекат	Mood
единадесети	екзарси	Case
лесна	зъбеца	Number
паланко	змеици	Case
организмът	разсъдлив	Number
ученият	учейки	lemma
клади	решиш	Person
чувай	честитиш	Person
обрекат	отключех	Mood
говорените	поотичаше	Tense
компетенции	глупави	Case
преживееше	унесат	Mood
заподозирали	възпираният	Tense
дете	мярко	Number
подведяла	подведеше	lemma
ползвахме	заплашвало	Tense
най-силната	най-силните	lemma
заковаваме	прощава	Mood
вдишва	вдишвания	lemma
подпряната	заметяха	Tense
вертолете	камъни	Case
главо	змиорки	Case
нахапалото	нахапало	lemma
напича	най-турската	Number
попичащо	отвлечения	Number
най-високият	по-високата	lemma
автоблокировки	гренландецо	Case
злоупотребихме	спечеш	Mood
изговарям	осиновявания	Number
домита	подметем	Mood
оцветяващо	оцветява	lemma
децилитри	северняко	Case
най-шестият	по-шестата	lemma
попичани	зачитайте	Number
разбра	завеждат	Mood
обясняха	убивалия	Tense
купувай	нагребва	Person
боядисвалият	боядисванията-нетата	lemma
зашива	създадат	Mood
учила	мярко	Number
завеждаха	преживееш	Mood
възпиращите	желала	Voice
най-учителска	учителско	lemma
по-благите	по-благо	lemma
обесете	простирахте	Person
заплиталият	заплитанията-нетата	lemma
убиела	въвличащите	Voice
чуха	казаното	Tense
изковаваните	понавлизал	Tense
насичаше	разнасяли	Tense
по-сребърно	по-сребърни	lemma
изпитваха	спася	Mood
здрави	шефове	Case
предсказаха	чукундури	Number
разбра	заплашат	Mood
наводняванията-нетата	наводнява	lemma
най-североизточни	бели	Case
губещ	губещи	lemma
сънувайте	уволнихте	Person
попитаните	преде	Tense
убитото	взимаха	Tense
загива	осиновявате	Mood
охраняваните	заспа	Tense
влезлия	запалвани	Tense
влезлия	казваха	Tense
заспива	опираща	Number
спряхме	заплаши	Mood
изпявана	обезглавилите	Tense
поспрели	уволняващата	Voice
влизахте	начете	Mood
изпий	почва	Person
допряната	по-аналитичен	Number
залезела	обезглавяхме	Tense
чуй	занася	Person
доброто	звяр	Number
можехме	можейки	lemma
въвлечените	въвлечаха	lemma
студентстващи	предупредилата	Voice
отнасял	изпичаха	Tense
вечерят	вдиша	Mood
врящата	полудеели	Voice
инфантилни	овни	Case
закупела	закупех	lemma
потушах	давалите	Tense
безбройни	документи	Case
корим	корящо	lemma
припекох	захапете	Mood
зими	по-югозападни	Case
завличащо	завличах	lemma
вертолете	арнаутки	Case
прости	аплодиран	Number
понеслата	ползвахте	Tense
припираща	изковавалите	Voice
зачете	изкупим	Mood
ходели	по-водоравните	Number
обучаваното	пристигнехме	Tense
продължаващият	желаят	Tense
упрекващата	упреквала	lemma
танцувай	стана	Person
студове	по-слънчеви	Case
попичали	берящата	Voice
патриарси	икони	Number
кладяла	кладях	lemma
понапичащите	завеждала	Voice
обсъденото	презряхме	Tense
бомбардирахте	разбрания	Tense
италианец	мъртви	Number
пращащият	пращалото	lemma
построяла	най-агресивният	Number
чобанката	пълен	Number
събуди	изпридате	Mood
строящата	строила	lemma
по-цялата	най-цяла	lemma
заслужиха	разбрания	Tense
полудявахме	прочелата	Tense
ядосани	печати	Case
закупете	принуждавахте	Person
виждаше	буди	Person
потичащите	умирало	Voice
заслужавах	навлекат	Mood
по-летни	камъни	Case
кош	по-продаваческото	Number
ухапвала	ухапвах	lemma
прелъстяваното	допичахте	Tense
здрави	цици	Case
посещавания-нета	посещавайте	lemma
унищожавахме	довлечеш	Mood
пеещите	тухли	Number
убитото	злоупотребяхме	Tense
по-анасонови	алгоритми	Case
по-сръбски	бели	Case
най-решителният	по-решителната	lemma
уволнилото	уволнилия	lemma
изковаваните	обещавал	Tense
зарича	лижат	Mood
продаваният	продавайки	lemma
опрете	въвирах	Mood
започнеш	понавлез	Person
маймуно	бедняци	Case
прочете	съобщавани	Tense
нанесеш	снасяй	Person
съзрели	обличащото	Voice
опрял	посещаващите	Voice
разбира	наемахте	Mood
затрисах	анатемосате	Mood
въвличал	келнера	Number
бихте	спася	Mood
подведат	назовавах	Mood
изтърваваха	запичаната	Tense
скучното	по-скучно	lemma
злоупотребят	отвлечах	Mood
по-ягодовият	баща	Number
американска	предскаже	Number
слон	обича	Number
допрочиталите	взема	Tense
сядащата	сядала	lemma
вожд	изчезването	Number
жълтото	по-жълто	lemma
падахте	изречената	Tense
принуждаваха	преживения	Tense
хората	запалват	Number
въвиращият	дотечели	Voice
написахте	заспива	Mood
въвирана	заревавам	Number
виждаха	тичаш	Mood
опридана	най-анонимни	Number
прелъстявах	очаквали	Tense
поднесели	ушиеше	Tense
изревавало	изминеха	Tense
плащахте	искрените	Number
разлюби	замита	Person
изпивахме	заспива	Mood
обесили	заповядва	Tense
най-алените	чупиха	Number
ползва	изсичат	Mood
забоди	обвиняваше	Person
сприятеления	абсурдна	Number
компетентни	бордеите	Number
обсъден	казваха	Tense
извлечахме	довляклото	Tense
изгризвал	кралю	Number
уби	затечели	Tense
героиньо	горелки	Case
маймуно	бели	Case
--	отвличащ	Number
спряха	казаното	Tense
уби	брани	Tense
най-босичкият	по-босичката	lemma
обвинят	оцветените	Number
изминаха	казаното	Tense
очаквания	наеми	Number
желах	презрете	Mood
черни	венци	Case
по-австралийски	бели	Case
питахме	говори	Mood
абитуриентското	по-абитуриентско	lemma
чуваното	начетохте	Tense
падахте	разлюбената	Tense
коронясвало	съчетавахте	Tense
убитото	вярвали	Tense
правителства	оцветените	Number
обвини	почитай	Person
по-авторитарни	отци	Case
допрочитало	благодарихме	Tense
обещаха	спася	Mood
ползвана	взимаха	Tense
авантюристичното	по-авантюристично	lemma
розо	кошмари	Case
децилитри	сандале	Case
прегърнах	по-ненадеждна	Number
храно	камъни	Case
злоупотребяват	удовлетворявах	Mood
интересуваме	побеждава	Mood
ходихте	подмиталия	Tense
обезсмъртяваха	опридано	Tense
лекцията	узакони	Number
наобличахте	смажете	Person
изминало	бие	Number
по-косместите	по-косместо	lemma
изплетохте	срещайте	Person
заповядан	тръгваха	Tense
запичането	запичалото	lemma
изкупи	безбожното	Number
поизмиташе	дълбока	Number
обезсмъртяваха	бесилия	Tense
убеждаваха	бесиш	Mood
по-еластичните	по-еластично	lemma
одобрихме	създалият	Tense
автономии	по-абсолютни	Case
пожари	най-саркастични	Case
навеждащ	глобилите	Voice
правехме	протекла	Tense
прелъстявах	комбинирали	Tense
полето	боядиса	Number
вършеенето	вършаната	lemma
поспрели	простиращото	Voice
заслужавай	доведе	Person
подписа	надебелеят	Mood
изнеса	очакваха	Mood
клади	протича	Person
насичаха	победиш	Mood
безбройни	цици	Case
обзавеждахме	обзавеждайки	lemma
корели	разлюбеният	Tense
обичаме	преведе	Mood
прехапвах	прехапваното	lemma
чуха	спася	Mood
затеклото	по-усърдна	Number
наводнени	преде	Tense
инвестираш	обезсмърти	Person
тресящото	наводнели	Voice
възлязоха	продаваната	Tense
вземаха	отричам	Mood
предплащания	грешихте	Tense
по-сврачите	по-свраче	lemma
повярва	прегърнат	Mood
обещаха	победиш	Mood
наводнени	изплете	Tense
черни	глави	Case
търбуси	най-светли	Case
победиш	по-аналитичен	Number
прочитаните	нахапех	Tense
закусили	обричащото	Voice
слънчевите	излизаха	Number
понапичащите	оцелявало	Voice
потичащите	живеела	Voice
разбирах	разбираното	lemma
изтърваваха	ушиваната	Tense
университети	крамоло	Case
арки	енергични	Case
ядосани	горелки	Case
по-дивия	унищожено	Number
анатемосваме	пътуваше	Mood
ходих	очаквали	Tense
чуха	кориш	Mood
можех	прегърнат	Mood
въвличах	нахапят	Mood
засича	обзавеждат	Mood
обковавах	рачили	Tense
университети	най-ароматни	Case
заспива	почитащата	Number
протичаме	протичащо	lemma
шибащата	довлекли	Voice
зверска	боя	Number
режещ	режат	lemma
подписа	погледни	Person
прощавахме	нанасяш	Mood
отмяно	арнаутки	Case
горят	потъва	Mood
най-надеждният	зърно	Number
по-възголемия	азербайджанец	Number
закусим	изпитваше	Mood
отбождах	отбожданото	lemma
съчетаехте	захапете	Person
абразии	наоблеклите	Number
дометат	зареваваше	Mood
арки	осо	Case
слуша	нахапят	Mood
втечнявай	заревавам	Number
коронясах	захапани	Tense
ставащият	изслушвали	Voice
получаваше	плащали	Tense
наводняваните	наводняваха	lemma
дотичахте	убивам	Mood
заслужавах	изпридате	Mood
аксиоми	победените	Number
дометат	назовавах	Mood
пуших	опичате	Mood
ограничаваме	ограничава	lemma
хеликоптери	северняко	Case
спичащият	хайдуко	Number
ползва	нахапят	Mood
изковаваха	надвнесеният	Tense
изреваващият	осиновили	Voice
срещалата	разлюбиш	Number
чувай	нагребва	Person
южняци	бродяго	Case
подклаждам	подклаждалите	lemma
разнасялите	целуваща	Voice
изгубиш	казвай	Person
победеният	победилата	lemma
навличам	сравняваха	Mood
препичащи	препичащите	lemma
възлязоха	събудено	Tense
повлечал	оцветяването	Number
продължаващата	продължавала	lemma
плащахме	чества	Mood
втечнявало	бомбардиращите	Voice
по-набожните	по-набожно	lemma
злоупотребяват	одобрявах	Mood
обичаме	ранеше	Mood
заковаванията-нетата	заковава	lemma
погребвала	погребвах	lemma
убеждавате	закусваше	Mood
създавала	трезвения	Number
пренесеш	зареваваха	Mood
изминато	запалваха	Tense
обвинят	креативните	Number
провираните	провираха	lemma
абразии	метоха	Number
можахме	победиш	Mood
набоди	най-абстрактният	Number
заповядваше	разболеете	Mood
избирани	забравях	Tense
пикаеща	повеждат	Tense
въвряно	въвряла	lemma
по-влажните	най-влажен	lemma
давали	спрения	Tense
продължаващият	предричат	Tense
по-внимателната	най-внимателна	lemma
попитващото	удовлетворявали	Voice
мелите	прелъстяващо	Voice
обезсмъртяла	крадеш	Number
пръчки	по-първоразредни	Case
центрове	метоха	Number
оцелея	оцеляла	lemma
съзрели	играещият	Voice
пеещ	пеещи	lemma
пасена	наведяхте	Tense
най-мускулни	шефове	Case
заплетоха	спечеш	Mood
препичащо	предсказваме	Tense
безмилостна	победата	Number
по-неблагоразумните	по-неблагоразумно	lemma
вковаващо	ранявате	Tense
закусиха	бабанки	Number
зашива	подметем	Mood
бакалаври	най-светли	Case
по-сръчно	по-сръчни	lemma
падахте	сприятеленото	Tense
по-добрата	най-добра	lemma
подписващ	подписват	lemma
можахме	можехме	lemma
понапичащите	отвеждало	Voice
изпридали	изплетената	Tense
наследявай	решиш	Person
чака	прегърнат	Mood
изпихме	секлия	Tense
опридащите	начитал	Voice
дометат	изпитваше	Mood
възпиращите	повеждало	Voice
обвинявано	казваха	Tense
най-втората	най-вторите	lemma
произнесете	простеше	Mood
безбройни	надежди	Case
най-абисинска	абисинско	lemma
клади	припреш	Person
лизал	обрекоха	Tense
анакондо	кълвачи	Case
загубвало	съчетавахте	Tense
припра	припрелите	lemma
обясняха	насмитало	Tense
сило	доктор	Number
окрадеш	отбодяхме	Mood
игрането	играната	lemma
причинило	отключващите	Voice
затичащи	насмелата	Voice
заковаващото	победите	Tense
олигархът	взимало	Number
прочетеното	прочетено	lemma
по-дивия	хайдуко	Number
можех	поднесат	Mood
смазвахме	обучава	Mood
опасвания-нета	опасвайте	lemma
овце	по-глухонеми	Case
восъко	езици	Case
загива	презрете	Mood
дъвчещо	дъвка	lemma
излезте	забременявахте	Person
хората	драки	Number
удовлетворявано	запалваха	Tense
понапичахте	срещайте	Person
врабче	предсказва	Number
погледнехте	одобри	Mood
допринеслият	заревавам	Number
загребваните	отхапало	Tense
вълци	запалват	Number
залязваща	залязвалите	lemma
зачиталият	зачитал	lemma
причинявали	затичащият	Voice
инвестиращите	опредяла	Voice
победим	продължи	Mood
кладенията-нетата	кладе	lemma
съобщаваше	понавлизаме	Mood
заповядваше	заплашат	Mood
обречала	шибахме	Tense
арестувало	ползвахте	Tense
прочитаните	обещавал	Tense
изпридал	опридахме	Tense
озадачавайте	взимате	Person
обезглавиш	близаното	Number
вярващи	вярващите	lemma
ядат	погледнах	Mood
узаконило	въвличащите	Voice
обрекат	отсъствах	Mood
помагала	изчитахте	Tense
поборника	птици	Number
презира	завеждат	Mood
обезглавиш	заподозирано	Number
будещ	будещи	lemma
обясняха	опридано	Tense
затеклото	купувахме	Tense
занасяше	захапани	Tense
осиновяват	дотечеше	Mood
изпеете	бегли	Number
отварящи	отварящите	lemma
изминало	по-железния	Number
подклалите	пътуващо	Voice
снасяли	надебелява	Tense
разпрострелия	създаващи	Voice
дометеше	изреваваща	Number
пристигал	принесяха	Tense
изпридали	нанесената	Tense
заметохме	довляклото	Tense
срещало	отключващите	Voice
визи	дъско	Case
обличайте	предяхте	Person
съчетавана	грешихте	Tense
припеви	германски	Case
вожд	търсеното	Number
припичаха	вярваш	Mood
по-продавачески	езици	Case
прехапвате	свирайте	Person
простят	одобрявах	Mood
плащаш	желаха	Mood
по-продавачески	биволи	Case
препрочетеше	казваме	Mood
прости	разсъдлив	Number
допринеса	сравняваха	Mood
преживея	преживяла	lemma
отхапаха	допиралото	Tense
университети	вратовръзко	Case
засичам	препичано	Number
повеждахте	закуся	Mood
помелите	обосноваващ	Voice
пуши	създадохме	Mood
ставащият	затичали	Voice
набоди	съзираното	Number
бомбардирах	полудеят	Mood
пометено	зареклите	Tense
предсказа	купите	Mood
слуша	оцелеем	Mood
храсти	по-неузрели	Case
покриви	германски	Case
допряната	винящо	Number
кладе	агитационния	Number
по-авторитарно	озаглавилият	Number
довелата	продавахте	Tense
надонасяйте	радеете	Person
пристигне	създадохме	Mood
танцувай	заповяда	Person
бежанко	алгоритми	Case
припаднели	въвличащото	Voice
скубалият	скубал	lemma
анатемосат	опече	Mood
въвряната	молиха	Tense
дотичащото	подчертали	Voice
единадесетата	запрело	Number
пиехме	обричано	Tense
допринеса	забодяха	Mood
понапичащото	обезглавявате	Tense
виелици	други	Case
окрадена	молиха	Tense
обсъденото	начитахте	Tense
разбираните	разбираха	lemma
сиромахо	бедняци	Case
измитах	писателстват	Mood
предупреждава	запалвани	Tense
закупете	господарувахте	Person
закупените	изчете	Tense
обещаващи	бозайници	Number
най-босички	кълвачи	Case
южняци	най-големи	Case
абитуриентът	най-мъдър	Number
привнесеният	привнеслата	lemma
счупихме	зачитайте	Number
почващият	изслушали	Voice
изминели	уволняващата	Voice
изгубващ	изгубват	lemma
повярвате	казвайте	Person
потичащите	начитал	Voice
съществувал	отключващите	Voice
набодяхме	бесиш	Mood
изгубващо	изгубва	lemma
южняци	най-ароматни	Case
обсъжда	създадем	Mood
обезглавявана	обезглавявали	lemma
обясняваха	кориш	Mood
абаносовата	студентстващ	Number
изневери	чавко	Case
започнеш	изчитай	Person
рачим	рачещо	lemma
посети	биете	Mood
бръмбара	оцветените	Number
принеслият	по-чернодробно	Number
чобанки	по-важни	Case
отвеждали	заричащият	Voice
сънувахме	сънувайки	lemma
захапването	захапвалото	lemma
прочитаните	надебелява	Tense
понавлизащата	изговаряли	Voice
напичах	завеждат	Mood
заспим	загиваше	Mood
подведат	допрочетеше	Mood
зарекох	по-аналитичен	Number
даваше	нараняват	Mood
поизмитахме	въвлече	Mood
опиралия	въвираха	Tense
вдишваното	учихме	Tense
астероиди	по-правителствени	Case
избирани	биех	Tense
хоризонталния	абсурдна	Number
разбра	създадем	Mood
получавайте	почетяхте	Person
небесносини	търсеното	Number
създаваният	шибахме	Tense
пращаше	опичате	Mood
благославяли	купувах	Tense
отварящата	отваряш	lemma
пътува	честваме	Mood
токсичните	ягоди	Number
розо	надежди	Case
принеси	заповяда	Person
дълго	най-аварийния	Number
лижещ	лижещи	lemma
счупихме	подпиращи	Number
най-близичка	търсеното	Number
организмът	белгийка	Number
най-безразсъдна	безразсъдно	lemma
счупвате	назовавах	Mood
опрете	понавлиза	Mood
по-безидейните	най-безидеен	lemma
написаният	вярвали	Tense
завлечало	продавахте	Tense
заплашвахте	обрека	Mood
убитото	кладяха	Tense
зашития	молиха	Tense
ближещата	ближеш	lemma
попитвам	най-агресивният	Number
закусили	уволняващата	Voice
втечнявай	по-мъртвия	Number
пастири	германски	Case
гласувате	понавлиза	Mood
наследявали	закусвах	Tense
мажа	озадачи	Number
хапехме	моленията-нетата	Number
вселена	нанеслата	Number
произтичащо	надонасялите	Voice
най-водоравни	шипки	Case
прехапвахме	преживееш	Mood
по-вертикалната	тръгвах	Number
плача	играеха	Mood
посещаваните	заплашвало	Tense
допичаният	разнасяли	Tense
очаквах	разнасяли	Tense
лопати	лесе	Case
навреният	унасяли	Tense
отваря	бомбардиралата	Number
използващи	използващите	lemma
най-безстрашната	най-безстрашните	lemma
сврат	удовлетворявах	Mood
отричалият	обзавеждаха	Tense
безделничеха	отхапвала	Tense
обичах	плащали	Tense
можахме	прочита	Mood
акордеоне	кълвачи	Case
арбитре	влъхви	Case
принудилата	принесяха	Tense
пуши	обезглавяхме	Mood
охраняваните	изговаря	Tense
помели	купуваното	Tense
овце	италиански	Case
живеещите	правила	Voice
можахме	наследява	Mood
правите	обесвайте	Person
неразсъдителни	пуйки	Case
подчертали	потресеният	Tense
ставащият	отвеждали	Voice
бягай	живя	Person
понапичащите	произтичал	Voice
козли	тичалите	Number
чудесното	по-чудесно	lemma
коронясвало	засечените	Tense
запалеше	купите	Mood
построиха	посъветвам	Mood
пиехме	припирала	Tense
важни	автоматистрали	Case
забравяното	забравяно	lemma
поопичаха	надвнесеният	Tense
абдали	шипко	Case
препичаха	победиш	Mood
наказваше	по-вещия	Number
здрави	езици	Case
унищожава	опират	Mood
автономии	бацилоносителко	Case
прехапят	допрочетеше	Mood
гущере	радиоцентрове	Case
сравнявана	сравнявали	lemma
дотечах	отхапалите	Tense
единадесети	документи	Case
ползвана	оцветилите	Tense
зашива	заплашат	Mood
надвнесяла	надонасящите	Voice
отчита	отчитания	lemma
напичах	произтекат	Mood
препоръчвано	испанският	Number
написахте	убивам	Mood
сприятеляваш	почитай	Person
замираше	навлекат	Mood
обучаваното	продавахте	Tense
примираше	подметем	Mood
изкупувахме	разлюбената	Tense
обезсмъртявали	раняваше	Tense
граничат	привнасяше	Mood
падахте	повеждал	Tense
поднесели	сприятеленото	Tense
подвежда	наеми	Number
най-летният	по-лятната	lemma
охранявано	охранявала	lemma
подписа	залязваме	Mood
препече	даващите	Tense
слуша	казваме	Mood
отхапваш	ебане	Number
най-верни	печати	Case
най-любопитната	най-любопитните	lemma
чудесният	дълбока	Number
изслушай	накажеше	Person
пиехме	отхапало	Tense
оцветеше	поспри	Person
запалеше	охранявате	Mood
лижете	гейовете	Number
предсказаният	намекнехме	Tense
разпростирала	продавахте	Tense
най-разсъдливи	радиоцентрове	Case
превеждаш	отключиха	Mood
заредяхте	пейте	Person
излезете	вдишва	Mood
запридащи	запридащите	lemma
заслужавай	залязваш	Person
обсъжда	унесат	Mood
ядат	отхапвах	Mood
окрадват	гореше	Mood
поборника	убедим	Number
дало	отключващите	Voice
загивах	обезглавилите	Tense
компетенции	осо	Case
по-арогантната	взимало	Number
победим	аплодира	Mood
надонасям	отключеха	Mood
мъртвото	пречупваше	Number
книги	лесе	Case
сило	гения	Number
озадачаваше	създадем	Mood
гласуващият	отхапвали	Voice
доброто	отвличащ	Number
анатемосаха	обвиненото	Tense
построявалото	кладяха	Tense
навличам	произтечахте	Mood
храно	глави	Case
ограничават	опече	Mood
занасящата	плашели	Voice
бягай	отвежда	Person
изчитайте	втечнявате	Person
подобри	изслуша	Person
повтаряха	бегли	Number
обичаме	маза	Mood
подведени	преде	Tense
нахапеше	поднесат	Mood
измитахме	победиш	Mood
построиха	нанеса	Mood
бакалаври	осо	Case
спасявахме	посъветвалия	Tense
зарича	поднесат	Mood
опасващи	въпросите	Number
по-кривите	най-крив	lemma
поотече	прочетяхме	Mood
лекцията	кралю	Number
написахте	посъветвам	Mood
опиралия	злоупотребяхме	Tense
излезете	аплодира	Mood
абдикиранията-нетата	абдикира	lemma
благодарящ	благодарящи	lemma
загиващият	осиновили	Voice
бера	брала	lemma
потушавате	затресе	Mood
опасеният	презряхме	Tense
небесносини	предскаже	Number
алегорийо	бъзли	Case
продължаващият	повеждат	Tense
нагризва	опират	Mood
дете	изчезването	Number
занасящата	чупили	Voice
продължи	продължения	lemma
пронесат	лягах	Mood
помагала	предсказваха	Tense
шибащата	изпечели	Voice
дебелях	зачитащото	Number
дядовците	драки	Number
единадесети	зъби	Case
амфитеатре	дълбока	Number
изчезвали	умиращият	Voice
астролозите	мускули	Number
поопичахте	разбирано	Tense
здрави	венци	Case
излезте	примрете	Person
ограничавахте	счупваното	Tense
заспа	понавлизаме	Mood
принудилата	изгубихте	Tense
спрете	вярвах	Mood
простят	получаваше	Mood
глобете	насечете	Person
понесло	узакони	Number
най-студентския	баща	Number
бръмбара	мускули	Number
назовава	назовавания	lemma
помитащият	избодем	Tense
ядат	комбинираше	Mood
унася	изковавалите	Tense
подчертавали	мъже	Number
убедилото	избодяха	Tense
апетити	по-анархични	Case
нанасяме	вдишва	Mood
най-сив	обича	Number
най-ароматната	най-ароматните	lemma
изплашеше	оцветилите	Tense
пести	разнасяли	Tense
драки	започващите	Number
поднесете	използваше	Mood
принеслият	озадачи	Number
ядосани	шипки	Case
доктора	пикометри	Number
агрохимичко	устни	Case
главо	бакшиши	Case
обичаме	прощава	Mood
осиновяват	отключех	Mood
уплашех	уплашеното	lemma
навличам	съзирахте	Mood
мажем	използващото	Tense
университети	бронтозавре	Case
занасящата	излезели	Voice
станеш	произнасяй	Person
подслушаната	начетохте	Tense
свирало	бомбардиращите	Voice
астролозите	почвате	Number
вечерялото	вечерялия	lemma
врабче	кралю	Number
чорапогащнико	лешове	Case
насметения	по-недостатъчна	Number
глобях	глобеното	lemma
повтаряхте	наводнен	Tense
изпиехме	изпихме	lemma
аргати	осо	Case
отхапеше	произнасяй	Person
вдишваното	заспиваха	Tense
тичала	тичаше	lemma
потресла	заподозираха	Tense
навестеше	комбинирали	Tense
въвлечахте	потресеният	Tense
авансе	бакшиши	Case
навестяваният	навестявалата	lemma
повярва	нараняват	Mood
изнесените	изнесяха	lemma
пренася	оцелеем	Mood
чуй	заповяда	Person
студентстващи	припадалото	Voice
автономии	италиански	Case
произтичащо	ограничилите	Voice
одобрихме	изсеклия	Tense
маймуно	авантюристки	Case
посещаващия	сядаме	Tense
изчезнало	въвираха	Tense
звере	арнаутки	Case
охраняваните	завлече	Tense
най-босички	влъхви	Case
танцувала	танцуваше	lemma
загиващата	изпечели	Voice
доказаното	доказано	lemma
припекох	прегърнат	Mood
хоризонталния	жена	Number
бесенията-нетата	беси	lemma
погребвахте	разлюбеният	Tense
изтечете	напечахте	Person
наоблича	подметем	Mood
препоръчваме	припечеше	Mood
единадесетата	кралю	Number
наказваше	най-слабата	Number
нагризваме	маза	Mood
живееше	наеми	Number
почетоха	посъветвам	Mood
побеждаваше	обковаваме	Mood
създам	създала	lemma
паланко	биокомпютри	Case
накажат	отмиращо	Tense
подобрели	затичащият	Voice
отхапвам	отхапвала	lemma
окрал	начитахте	Tense
загребвал	създавахте	Tense
американска	убива	Number
накажат	изтърваващо	Tense
спряха	спирало	Tense
зачеващата	зачеваш	lemma
легализирах	замрели	Tense
единадесети	устни	Case
надонасям	забодяха	Mood
авансираните	вреше	Tense
зашиващ	зашиващи	lemma
победим	пристига	Mood
подчертаеше	изречете	Mood
поборника	нанесат	Number
победим	засече	Mood
южняци	най-саркастични	Case
превел	въвличащите	Voice
най-азотни	нанолитри	Case
поотичаме	поотичащо	lemma
наказващо	наказвах	lemma
круши	аскере	Case
живеещите	ял	Voice
обесете	напечахте	Person
закусваха	вярваш	Mood
простиращ	простиращи	lemma
юнака	обича	Number
загребвай	одобряваш	Person
загребвал	произнасяхме	Tense
унищожава	поднесат	Mood
повторил	зъбеца	Number
подробни	бакшиши	Case
посещаваните	изгубел	Tense
понапичалата	азиатко	Number
по-предпазливо	по-предпазливи	lemma
съгласното	по-съгласно	lemma
господарствуваше	поднесат	Mood
очаквах	брани	Tense
отсъстваме	отсъства	lemma
зверска	гвоздею	Number
уволняващият	навестим	Tense
по-земетръсни	шипки	Case
преживявана	изчитахте	Tense
извлечахме	унищожавалата	Tense
изневери	сило	Case
извелия	въоръжаващи	Voice
обилни	радиоцентрове	Case
превъзнесе	глобихме	Mood
заплитате	отчитащо	Tense
очакващата	очаквала	lemma
визи	котко	Case
анулиращият	навестят	Tense
ухапвали	казаното	Tense
изпивала	изпиваше	lemma
купувала	обрекоха	Tense
победиш	доктор	Number
залезела	опридахме	Tense
нагризващата	нагризвала	lemma
падащ	падат	lemma
опридали	продаваната	Tense
въвлякоха	по-хубави	Number
доплитането	отключваше	Number
отхапаха	лягало	Tense
виненият	винилата	lemma
сядахме	прочита	Mood
пуяци	бацилоносителко	Case
правихте	смажете	Person
плащаш	предяха	Mood
автогаро	изгризва	Number
попичах	захапани	Tense
по-арогантната	препичано	Number
мъртвото	разлюбела	Number
надвнесоха	режа	Mood
поотече	заковавахте	Mood
получавайте	интересувахте	Person
създавала	фемтолитре	Number
овце	печате	Case
наплитанията-нетата	наплита	lemma
примрелите	наемах	Tense
клади	одобряваш	Person
поопичахте	озаглавена	Tense
изгуби	изгубения	lemma
обесили	нанесената	Tense
влязоха	вярваш	Mood
бралите	унищожаващо	Voice
надебелявало	навеждахте	Tense
казваме	казва	lemma
живеният	затекохте	Tense
хеликоптери	сило	Case
най-безбройни	устни	Case
нарича	наричания	lemma
най-интересни	горелки	Case
визи	враже	Case
аплодираме	пътуваше	Mood
побеждаващият	наводнели	Voice
клади	живя	Person
поотече	изговорехте	Mood
прелъстяваното	презряхме	Tense
завлече	запалвани	Tense
клади	отключи	Person
засечено	засечала	lemma
опасващия	опасвани	lemma
южняци	осо	Case
комбинирали	поизметеше	Tense
най-североизточни	евнуси	Case
капещ	капят	lemma
построяхте	млъквайте	Person
изсичаха	втечнявалият	Tense
продължаващият	отключите	Tense
отричащ	отричат	lemma
разнасялите	работещо	Voice
университете	цици	Case
засичам	най-агресивният	Number
заслужавах	сравнят	Mood
интересуващото	обосновавали	Voice
тръгващите	повличахме	Number
почелото	почело	lemma
прозирано	оцветилите	Tense
капеше	сравнят	Mood
напреднели	протича	Tense
вечерят	засече	Mood
прости	фемтолитре	Number
овце	по-важни	Case
прощаваха	спася	Mood
дебелеения-нета	дебелеете	lemma
шантажирам	отчитаха	Mood
изпридали	ушиваната	Tense
организмът	баща	Number
мускулното	по-мускулно	lemma
пекари	шипко	Case
заченат	присъствах	Mood
по-крив	зачитащото	Number
обичаме	вдишва	Mood
снесли	осиновяващия	Voice
правихте	подмета	Mood
подпряната	плетяха	Tense
кош	слизам	Number
виждалите	спрях	Tense
препрочитащия	препрочитани	lemma
алжирки	най-господарски	Case
понапичалата	мъртви	Number
зими	шофьоре	Case
прегърнела	бомбардиращите	Voice
влязоха	посъветвам	Mood
пречупвахте	говори	Mood
повтарящите	пътувала	Voice
ушиваше	изнеси	Person
вряхме	принесен	Tense
заредена	треторазредният	Number
допичам	насметял	Number
чества	захапващи	Tense
принуждаването	принуждаваната	lemma
изпридали	става	Tense
озадачилата	плетяхте	Tense
ползвана	начетохте	Tense
оцветиш	плащаха	Mood
най-неопитните	танцувате	Number
отрекохме	ометената	Tense
пристигнат	близах	Mood
ядосани	чираци	Case
отсичахте	пейте	Person
написахте	подведа	Mood
одобрявахме	изплашеното	Tense
причинявали	берящата	Voice
даде	дадения	lemma
обясняха	спирало	Tense
най-унгарски	бели	Case
прочитаните	вреше	Tense
използващ	използващи	lemma
подобри	сравни	Person
най-сърдита	сърдито	lemma
агробиоложки	плуже	Case
удовлетворяла	удовлетворях	lemma
обречете	припечеше	Mood
заченат	затриса	Mood
надебелееха	съобщеният	Tense
най-железният	по-желязната	lemma
будещият	окрадване	Number
отричай	нагребва	Person
наизлизащото	попитвали	Voice
най-турска	турско	lemma
пращаният	продавахте	Tense
отсъствай	сравни	Person
побеждавах	побеждаваното	lemma
отсичало	намекнехме	Tense
надонасям	господарствуваха	Mood
подобри	дои	Person
загивах	затечели	Tense
единадесетата	заподозирано	Number
срещал	обсъдихме	Tense
бъбреко	най-гърдестата	Number
казващ	казващи	lemma
спасявахме	създалият	Tense
най-безбройна	наплитания	Number
разлюбилият	запридаха	Tense
почетях	гласуването	Number
поопечеше	разболеете	Mood
опрете	затресе	Mood
припеви	други	Case
размени	германски	Case
отлично	узакони	Number
спиращата	спираш	lemma
ходихте	разбирано	Tense
клади	аплодира	Person
замитащият	опасвали	Voice
болното	по-болно	lemma
обезсмъртявали	наемах	Tense
допрочетох	пикаете	Mood
поглеждалото	поглеждалия	lemma
най-близичка	изсеклият	Number
врящата	започвали	Voice
замитащият	изпечели	Voice
по-зелен	най-първоразрядното	Number
озадачах	озадаченото	lemma
използвате	подобрете	Person
пречупващи	затреслия	Voice
разболяващия	повлекли	Voice
опридали	нахапех	Tense
забременяващо	забременявах	lemma
героиньо	кълвачи	Case
посещаваните	начита	Tense
обилни	бедняци	Case
биеш	най-германски	Number
зареждах	писателстват	Mood
анатемосващо	анатемосвах	lemma
навестяхте	докаже	Mood
изчезвали	берящата	Voice
заповядан	изревавалите	Tense
довелата	окрадваха	Tense
босичка	най-абстрактният	Number
зверска	гласува	Number
звере	чираци	Case
важни	номера	Case
спрете	вижда	Mood
оцветели	прозирах	Tense
обещаващи	обещаващите	lemma
започнато	започнела	lemma
пиявицата	предскаже	Number
заподозираща	глобилите	Voice
бойци	по-неузрели	Case
гущере	змеици	Case
обичана	обичали	lemma
срещалата	предскаже	Number
съзирам	очакваха	Mood
плашещата	плашила	lemma
поглеждаше	арестували	Tense
превъзнесохте	занасяло	Tense
презират	убих	Mood
възляза	допирахте	Mood
подчертаваше	препрочетем	Mood
навеждан	плетяха	Tense
пристигне	наведяхме	Mood
причиняваното	опираща	Number
изгризваш	изчитай	Person
изревавало	заметяха	Tense
режела	врабчето	Number
хеликоптери	южняко	Case
навлеклия	изгризва	Number
лекцията	тръгвах	Number
подчертаващ	подчертаващи	lemma
науко	овни	Case
построиха	полудееш	Mood
казаното	казано	lemma
използвате	захапете	Person
живеещи	живеещите	lemma
обезглавиш	по-мъртвия	Number
хеликоптери	италиански	Case
водоизпускателя	сохи	Number
разбирали	радеем	Number
запридалите	разболявах	Tense
полудях	биете	Mood
вярваш	забравяното	Number
пристигналият	създаващи	Voice
маймуно	змеици	Case
простят	казва	Mood
поопичахте	наводнен	Tense
построяващото	повеждат	Tense
изчитайте	падахте	Person
будещият	забождах	Number
потичащите	строял	Voice
съчетаехте	пронасяйте	Person
препоръчваме	разнесе	Mood
наобличаш	обезсмъртяха	Mood
съветващия	дотечели	Voice
плели	навестяващия	Voice
наранилият	предсказваха	Tense
изтечаха	спечеш	Mood
пуши	изсичат	Mood
обвините	затичайте	Person
болногледачки	глупави	Case
живеещите	протекло	Voice
забравяло	врабчето	Number
изговаряло	съчетаха	Tense
ограничават	простеше	Mood
принеслата	шибахме	Tense
навестявали	работещата	Voice
гърцизми	сило	Case
обсъди	бие	Number
зареждаща	отключите	Tense
опасвала	посещаващите	Voice
обясните	вярвах	Mood
подобрели	пречупващата	Voice
глобявания-нета	глобявайте	lemma
кладеш	заковавай	Person
затичащ	затичащи	lemma
простираните	простираха	lemma
отсичало	навличаха	Tense
допичалото	допичало	lemma
чуха	отключвания	Tense
погледнехте	убивам	Mood
чудесният	най-безалкохолна	Number
отключвалия	продажбена	Number
прозират	прозрях	Mood
компетенции	беднички	Case
розо	пуйки	Case
говорените	преде	Tense
по-алтовата	най-алтова	lemma
вуйчовци	мъже	Number
обесили	узаконеше	Tense
разплакват	отключех	Mood
заметяхте	смажете	Person
опеченият	затекохте	Tense
понавлизат	подкупващо	Tense
оцелеехме	оцеляхме	lemma
навлечете	насечете	Person
предричайте	уволнихте	Person
подслушат	шибаше	Mood
разболяваме	разболяващо	lemma
подслушвайте	изпридахте	Person
казвано	казвала	lemma
обеси	бастун	Number
най-автентичната	най-автентичните	lemma
ухапваше	презрете	Mood
преживявано	зидарката	Number
победим	изпича	Mood
ставащият	удовлетворявали	Voice
поспирало	заподозираха	Tense
благославящ	благославят	lemma
занасящата	наводнели	Voice
посетя	посетила	lemma
създавано	създавала	lemma
затеклото	съчетахме	Tense
по-азбестово	по-азбестови	lemma
завеждащи	завеждащите	lemma
даващото	измрат	Tense
адмирали	арменски	Case
решава	обковаваме	Mood
изкупи	гърло	Number
компетенции	по-храбри	Case
изпасващ	изпасващи	lemma
легализираният	въвираха	Tense
дотичащото	полудеели	Voice
охранявам	по-продаваческото	Number
проври	сереше	Person
повтарящите	благославяло	Voice
изревавало	свирахте	Tense
погледнехте	спася	Mood
забравяло	боя	Number
прозират	втечнеше	Mood
омитахме	говори	Mood
забравихте	бабанки	Number
ядосани	воли	Case
въвиращият	оцелявали	Voice
пренася	презрете	Mood
напичах	поднесат	Mood
унищожавана	унищожавали	lemma
пращаше	очаквали	Tense
граничат	прощава	Mood
оцелееш	одобрявахме	Mood
надебелееха	насмитало	Tense
най-порнографската	най-порнографските	lemma
пронасят	загубва	Mood
гвоздею	номера	Case
запичащия	доведете	Tense
най-неврели	лешове	Case
създаденият	създалата	lemma
начитащият	начиталото	lemma
подобрена	напредвахме	Tense
анатемосате	начитащата	Tense
спряхме	говориш	Mood
доплиталият	прощаващи	Voice
срещало	навличащите	Voice
боядисва	казваме	Mood
граничило	най-дяволския	Number
крадохте	предплатете	Person
виждаше	понавлез	Person
излезете	подписах	Mood
изкупиш	изгубвалата	Number
насичаше	съобщавани	Tense
надвнесем	дадеше	Mood
изнуди	отхапалите	Tense
опридали	раняваше	Tense
пеещия	пети	lemma
отнасял	обсъдихме	Tense
правихте	спася	Mood
обяснихте	подкупва	Mood
загубилото	загубилия	lemma
розо	бели	Case
можахме	забодеш	Mood
авансираните	авансираха	lemma
поведяхме	подкупва	Mood
затече	обзавеждат	Mood
хоризонталния	звяр	Number
въвлечахте	станел	Tense
взема	най-реалистичният	Number
подклалите	прелъстяващо	Voice
будилата	въоръжаващи	Voice
поопичахте	обосновавала	Tense
подслушва	създадохме	Mood
извлече	комбинирали	Tense
превежданията-нетата	превежда	lemma
чобанки	бронтозавре	Case
чувай	решиш	Person
избраното	избрано	lemma
поопичахте	наболият	Tense
презира	подметем	Mood
по-земетръсното	змею	Number
пренесеш	преживявахме	Mood
покриви	глупави	Case
изкупил	посещаващите	Voice
будало	зъби	Case
чакащ	чакащи	lemma
въвлече	буди	Person
черни	влъхви	Case
въвряната	заподозираха	Tense
овце	котко	Case
обучили	попичащия	Voice
вдиша	слушани	Tense
премряхме	микроорганизъма	Number
зареждаща	прегръщате	Tense
биенията-нетата	би	lemma
живеещите	получавала	Voice
отнасяме	отнасящо	lemma
зидарки	по-абразивни	Case
желайте	наводнихте	Person
спича	мечтаем	Mood
помагали	изпиташе	Tense
подведени	избоде	Tense
получавайте	изпридате	Person
охраняваните	взема	Tense
мразена	мразели	lemma
поизмитахме	заспива	Mood
изминало	пейзажът	Number
поопекъл	запридаха	Tense
надонасяйте	начитате	Person
най-възможни	бакшиши	Case
пиехме	лягало	Tense
боевете	припадали	Number
подклаждало	навличащите	Voice
изплашва	доведохте	Mood
обсъждащата	обсъждаш	lemma
излезеш	извлечаха	Mood
заслужаващите	отвличам	Tense
по-албанските	най-албански	lemma
най-низши	петаметри	Case
господарувах	подпрете	Mood
озадачавало	опасвахте	Tense
провира	казахме	Mood
измамо	влъхви	Case
обвинявали	заповядва	Tense
пикаех	поднесат	Mood
зидарки	най-порнографични	Case
сприятеляваха	чисти	Number
изминало	най-любопитният	Number
запряно	ползвахте	Tense
уплашвал	чувахте	Tense
събуди	казваме	Mood
говорещ	припадалите	Voice
слуша	надебелеят	Mood
най-словенска	словенско	lemma
кош	смазващия	Number
изневери	най-модерни	Case
посети	дадем	Mood
примирам	гласуваха	Mood
припираща	корилите	Voice
пестящата	пестила	lemma
американска	отвлечения	Number
излезете	премирах	Mood
поднесен	боядиса	Number
най-съгласната	най-съгласните	lemma
шунки	дъско	Case
помагали	запичаната	Tense
прегърнало	разлюбиш	Number
писателстващи	писателстващите	lemma
арбитре	езици	Case
пречупвах	завеждат	Mood
прости	унищожено	Number
говорила	обзавеждаха	Tense
навличам	заораваха	Mood
въоръжат	изковаващият	Tense
наранилият	заметяха	Tense
по-аметистови	печати	Case
по-аметистови	лешове	Case
изпичащият	изпичалото	lemma
доказвано	доказвала	lemma
заслужавали	работещата	Voice
чуваш	зърно	Number
съветващия	подкупвали	Voice
взема	най-неузрялата	Number
изнуди	прочетени	Tense
понапичалата	по-беден	Number
търбуси	по-гърдести	Case
чорапогащнико	петаметри	Case
обесете	сядахте	Person
арки	южняко	Case
вуйчовци	язовеца	Number
най-съвременна	съвременно	lemma
по-неловката	най-неловка	lemma
избирани	разболявах	Tense
решаващата	решаваш	lemma
спестяваме	възпиращата	Tense
въвряното	узакони	Number
изнеса	разболяха	Mood
подслушат	вдиша	Mood
недостатъчни	алгоритми	Case
разпростиращ	разпростиращи	lemma
заслужавали	затичащият	Voice
будеща	будилите	lemma
очакваща	втечнявалите	Voice
прелъстяващ	прелъстяващи	lemma
победиш	най-аварийния	Number
нови	нанесат	Number
астролозите	въвряха	Number
чуваш	най-германски	Number
пристигнат	прегръща	Mood
бакалаври	германски	Case
ограничете	граничехте	Person
построиха	говориш	Mood
замитаха	спася	Mood
ближехме	близано	lemma
попечаха	кориш	Mood
бягай	питаш	Person
най-бледничка	бледничко	lemma
недостатъчни	зъби	Case
понавлизала	понавлизаше	lemma
превъзнесохте	напечете	Person
нови	креативните	Number
оцветяхме	оцветено	lemma
изсичаха	господарстваш	Mood
заричащ	заричат	lemma
можещ	могат	lemma
изнеса	играеха	Mood
алхимички	аксиомо	Case
чуването	написваше	Number
най-бебешката	най-бебешките	lemma
вземащата	вземаш	lemma
предупреждавахме	предупреждавайки	lemma
навеждащ	корилите	Voice
плащахте	започващите	Number
пречупващи	запеклата	Voice
изсичаха	обещавал	Tense
заспива	по-детинското	Number
обосноваваше	вярвали	Tense
повтарящите	казвала	Voice
изнеса	господарствуваха	Mood
биеш	наобличалото	Number
наказваше	лижат	Mood
предричащо	погледналите	Voice
бихте	закуся	Mood
спасели	избоде	Tense
дядовците	търтеи	Number
отнасяна	отнасяли	lemma
пеещите	мъже	Number
зареждаща	измрат	Tense
южняци	фасуле	Case
най-надеждният	изреваваща	Number
горите	начитащата	Tense
построявахме	отвежда	Mood
злоупотребяват	загубва	Mood
посещаваните	зачетох	Tense
одобрявахме	потресеният	Tense
най-яйцевидно	радеех	Number
мечтано	изковавалите	Tense
арестувалата	купувахме	Tense
виждалите	поглеждах	Tense
допринеслият	адвокате	Number
окрадена	запридаха	Tense
заподозираше	закусваме	Mood
спасявал	ползвахте	Tense
ядосани	кошмари	Case
продължилия	създаващи	Voice
заведа	завелите	lemma
по-кореместите	най-коремест	lemma
по-авторитарно	произнесях	Number
стана	казахте	Mood
инфантилни	чираци	Case
спирахте	кървете	Person
най-отрицателна	отрицателно	lemma
взимащ	взимащи	lemma
по-мишите	по-мише	lemma
подкупят	подкупващо	Tense
втечнил	отключващите	Voice
омела	плетяхте	Tense
обвинят	силите	Number
прегърнеше	причиним	Mood
заметохме	надонасяната	Tense
пътува	повтаряте	Mood
безделничеха	спасявалия	Tense
по-ясните	по-ясно	lemma
ядат	предплащах	Mood
събуди	казвай	Person
по-безвярно	по-безверни	lemma
предплащащ	измитат	Tense
подобри	залязваш	Person
овце	крамоло	Case
чете	продължите	Mood
почвахте	пронасяйте	Person
посещаваните	протекла	Tense
автогаро	студентстващата	Number
желайте	изпридахте	Person
прочете	слушани	Tense
надонесохме	подкупва	Mood
обилни	сантилитри	Case
причинявали	играещият	Voice
понапече	понапечения	lemma
одобрявахме	вковаваният	Tense
пристигна	пристигнала	lemma
по-докторско	по-докторски	lemma
съчетаваме	съчетаващо	lemma
прегърнеше	заплашат	Mood
надонесохме	протекла	Tense
очаквания	оскъдно	Number
бедуинки	въпросите	Number
телефонирала	телефонираше	lemma
надвнесяло	обсъдихме	Tense
изпиеха	забодеш	Mood
пренася	поизметем	Mood
драки	бозайници	Number
възможни	драки	Number
излезеше	залязваме	Mood
апетити	котко	Case
опридали	навираното	Tense
алжирки	гренландецо	Case
събуди	изречете	Mood
превеждането	превеждалото	lemma
горилият	горенията-нетата	lemma
омита	оцветяхме	Mood
изтърваваха	построяваният	Tense
довеждащ	довеждат	lemma
ставащо	ставах	lemma
артикуле	надежди	Case
правехме	ушиваната	Tense
вдиша	комбинирали	Tense
навестили	пречупващата	Voice
берящ	омелите	Voice
изнесеният	изнеслата	lemma
ходихте	казаното	Tense
нанасялото	захапани	Tense
отсичам	отсичала	lemma
привнасяме	привнасящо	lemma
построявалото	заподозираха	Tense
подкупиш	изнеси	Person
забравиш	погледни	Person
заши	попечем	Mood
анулирахте	заплаши	Mood
спряхме	подкупва	Mood
унищожили	най-скъпите	Number
обвинявали	поглежда	Tense
търсеща	търсилите	lemma
изведа	извела	lemma
потекохте	кървете	Person
изпий	забраняваш	Person
произтичахте	опридано	Tense
обясняващ	обясняващи	lemma
опрете	вижда	Mood
търсехте	загине	Mood
прощавахме	подкупва	Mood
обречеш	заведяха	Mood
подведени	убивалия	Tense
изпивани	прозирах	Tense
обвини	отмирай	Person
пиявицата	платено	Number
уволнявало	азиатко	Number
по-опако	по-опаки	lemma
наказваше	почитащата	Number
изговарят	язовеца	Number
по-кукувичият	пристига	Number
надвнесяла	посещаващите	Voice
закупените	взема	Tense
подведени	изговаря	Tense
астролозите	икони	Number
заслужаваният	заслужавалата	lemma
наоблича	казваме	Mood
спирането	спираната	lemma
уплашвали	снасящото	Voice
най-осъществимата	най-осъществимите	lemma
губещ	губят	lemma
подколянната	отключваше	Number
опра	опрелите	lemma
обезсмърти	обезсмъртения	lemma
почиталото	почиталия	lemma
работещи	работещите	lemma
попечели	изпитащото	Voice
ползвахме	посъветвалия	Tense
глобявалият	глобявал	lemma
прегръщащата	прегръщаш	lemma
уволнявала	измитащите	Voice
морковът	по-сръбска	Number
запирайте	падахте	Person
приятелки	жълъде	Case
абитуриентът	зърно	Number
писаните	пишеха	lemma
нанасяме	побеждава	Mood
гвоздею	алгоритми	Case
най-възможни	биокомпютри	Case
по-безбройно	по-безбройни	lemma
забраняхме	заплаши	Mood
обезглавявам	изговорихте	Mood
посещаваните	изчете	Tense
препичахте	убивам	Mood
полудявахме	изпасяла	Tense
мелите	озаглавяващо	Voice
извлечи	изговаря	Person
възпиращите	ял	Voice
играното	граничехме	Tense
работещата	работила	lemma
правехме	въвирало	Tense
драки	въпросите	Number
винящо	отхапваме	Tense
пръчки	италиански	Case
примирам	заплетохте	Mood
наследявай	мечтаеше	Person
затресе	създадат	Mood
разбра	нараняват	Mood
бъбреко	по-детинското	Number
излизащия	отключите	Tense
питам	казахте	Mood
нанасящо	нанася	lemma
засичалите	накълваван	Tense
разнеслия	прочетени	Tense
плащахте	власи	Number
разпростирам	допирахте	Mood
подробни	цици	Case
виждалите	наказа	Tense
граничещ	граничат	lemma
по-адекватната	най-адекватна	lemma
спасяхте	смажете	Person
изговаряш	почитай	Person
одобрихме	нахапалото	Tense
надвнесем	пътуваше	Mood
най-алчна	алчно	lemma
заплелия	разбирани	Tense
виждаше	погледни	Person
бежанки	въпросите	Number
търбуси	по-студени	Case
здрави	змеици	Case
пеещите	търтеи	Number
говорехме	говорейки	lemma
изминаващият	заповядвали	Voice
по-кралско	по-кралски	lemma
втечняваната	тръгваха	Tense
нагризваща	нагризвалите	lemma
повярва	лижат	Mood
привнеси	заповяда	Person
наводнявате	подобрете	Person
подслушаната	шибахме	Tense
университети	италиански	Case
кървящият	посъветват	Tense
поведяхме	полудееш	Mood
корели	поглежда	Tense
бакалаври	по-абсолютни	Case
нагризва	създадем	Mood
затресе	прегърнат	Mood
запаля	платено	Number
помели	протича	Tense
най-прекрасната	най-прекрасните	lemma
наказваше	причиним	Mood
простираха	вярваш	Mood
храно	кошмари	Case
по-низши	отци	Case
разбра	опират	Mood
отричай	повлечеш	Person
потичащите	възлизала	Voice
ползва	поднесат	Mood
черни	шипки	Case
берящ	глобилите	Voice
окрадват	отключех	Mood
жабарю	по-недостатъчна	Number
охраняваните	разнесях	Tense
заченат	преведе	Mood
вдиша	подмиталите	Tense
охраняваните	разболявах	Tense
университети	сандале	Case
абсорбиран	гласуването	Number
припеви	шофьоре	Case
най-разсъдливи	воли	Case
одобряващата	одобряваш	lemma
комбинирало	радееха	Tense
обезсмъртиш	разсъдлив	Number
помитащо	помита	lemma
пиехме	спасявалия	Tense
най-седмо	загиналият	Number
зашития	обезглавяхме	Tense
получаваха	посъветвам	Mood
по-черните	по-черно	lemma
телефонираща	телефониралите	lemma
влизахте	говори	Mood
навличахте	зре	Mood
загива	оцелеем	Mood
зими	фасуле	Case
източни	въоръжих	Number
мъртвото	продажбена	Number
агенти	петльо	Case
пуши	повторихте	Mood
помитано	помитала	lemma
