putea	Verb
îmbinau	Verb
șchiopului	Adjective
coastele	Noun
pansexualul	Adjective
interfețele	Noun
simetriile	Noun
pianistului	Noun
măselariță	Noun
nevestei	Noun
luceafărului	Noun
cutia	Noun
blondul	Adjective
pornești	Verb
josul	Adjective
speriau	Verb
surda	Adjective
cac	Verb
îngreunaseră	Verb
urbanizările	Noun
broaștele	Noun
azvârleau	Verb
încadrezi	Verb
bolnăvicioasă	Adjective
străinului	Adjective
rămasului	Noun
mugetul	Noun
împușcaseși	Verb
frecași	Verb
rezistența	Noun
amiaza	Noun
mulțumești	Verb
străvechiului	Adjective
dorise	Verb
camionul	Noun
depunând	Converb
compozitorii	Noun
cotidienele	Adjective
cartilajele	Noun
dansezi	Verb
muzeele	Noun
unchiului	Noun
descălțară	Verb
algele	Noun
etimologiile	Noun
măcelul	Noun
arabii	Adjective
îmbrățișa	Verb
disponibilului	Adjective
rotundului	Adjective
lingând	Converb
dezmierda	Verb
florentinii	Adjective
unchiul	Noun
dulgherului	Noun
scaunul	Noun
afganii	Adjective
răspunsesem	Verb
veștedă	Adjective
întărâtase	Verb
ploaie	Noun
respectului	Noun
spartelor	Adjective
răgușiră	Verb
însoțise	Verb
găurit	Participle
proprietatea	Noun
împuțiserăți	Verb
soacră	Noun
insistară	Verb
babei	Noun
răsculaseră	Verb
masacrului	Noun
nemascatei	Adjective
luptase	Verb
copacului	Noun
lovi	Verb
cercetezi	Verb
aeroplanele	Noun
exploatare	Noun
spiritualului	Adjective
liberasem	Verb
rotirea	Noun
slujbele	Noun
căsoaia	Noun
bășicii	Noun
mobilele	Adjective
uniserăm	Verb
rășinii	Noun
ciclostomii	Noun
activezi	Verb
canelură	Noun
tăcerii	Noun
arhicunoscutul	Adjective
înjosit	Participle
vizită	Verb
sicriul	Noun
atotștiutorului	Adjective
juisaserăți	Verb
urbanizare	Noun
cășună	Verb
visarea	Noun
astmă	Noun
traduce	Verb
descrise	Verb
impunând	Converb
luptau	Verb
binefăcătorului	Adjective
căpătâiul	Noun
cântărețele	Noun
rupseseră	Verb
plângem	Verb
prezis	Participle
cunoscu	Verb
venerarea	Noun
brumărie	Adjective
lâncezii	Adjective
eprubetă	Noun
lămâile	Noun
istovit	Participle
interacțiune	Noun
agricultorul	Noun
întoarsei	Adjective
inimoșii	Adjective
răsăriserăți	Verb
olandeza	Noun
brânzeturile	Noun
sucii	Verb
închina	Verb
bieților	Adjective
solidității	Noun
intensitate	Noun
împădurirăți	Verb
fumului	Noun
iubise	Verb
șoptind	Converb
deveneau	Verb
scade	Verb
fierbeau	Verb
dormitorul	Noun
treierat	Participle
plătit	Participle
asteroidul	Noun
dragului	Adjective
lăudăm	Verb
vrăjitorului	Noun
urmând	Converb
înălțând	Converb
banii	Noun
auziseră	Verb
somniferelor	Adjective
lămurești	Verb
trimiserăți	Verb
litera	Noun
fostei	Noun
principalului	Adjective
prăpădit	Participle
găuri	Verb
împărți	Verb
intempestiva	Adjective
cariotipul	Noun
înlocuiai	Verb
anatomie	Noun
invizibilitatea	Noun
fișierul	Noun
deșiderarăți	Verb
transformat	Participle
spectrală	Adjective
peretelui	Noun
desfăcut	Participle
pilotului	Noun
părând	Converb
deplasa	Verb
anina	Verb
deschideau	Verb
încerci	Verb
stabilității	Noun
combinau	Verb
testiculele	Noun
gravitației	Noun
cernea	Verb
cerșeau	Verb
capitulaseră	Verb
întâmpla	Verb
cutreieraserăți	Verb
scoți	Verb
animației	Noun
zăcământului	Noun
scriai	Verb
lanternei	Noun
proprietății	Noun
pacientă	Noun
îmbucând	Converb
ajutat	Participle
amânaseră	Verb
fericirăți	Verb
motorului	Noun
supților	Adjective
apocalipsului	Noun
recunoaștea	Verb
negă	Verb
retezat	Participle
așezară	Verb
gutuie	Noun
ursuleții	Noun
satisfăceau	Verb
bravul	Adjective
elicopterul	Noun
planetara	Adjective
fur	Verb
comunitate	Noun
prezice	Verb
asfaltarea	Noun
vamală	Adjective
trandafirie	Adjective
scară	Noun
încetând	Converb
adunările	Noun
rugea	Verb
cordonului	Noun
numiseși	Verb
rostim	Verb
descheiaseră	Verb
simbolizând	Converb
extinsese	Verb
sacrului	Adjective
curseși	Verb
bleaga	Adjective
simfonie	Noun
tânjiră	Verb
înlăturară	Verb
spurc	Verb
piloții	Noun
întrezărea	Verb
câmpul	Noun
vergii	Noun
smulgi	Verb
sărisem	Verb
munții	Noun
hrănești	Verb
măsurând	Converb
cutreiera	Verb
înmulțirăm	Verb
comunele	Adjective
compozitoarei	Noun
pupat	Participle
împlineau	Verb
înălță	Verb
tranzitivă	Adjective
farului	Noun
încerca	Verb
construcțiile	Noun
verandă	Noun
albanezilor	Adjective
fericitul	Adjective
piticii	Noun
cunoscutelor	Adjective
spuneați	Verb
pernițele	Noun
prezicând	Converb
șchiopaseră	Verb
diastola	Noun
strâmb	Verb
născând	Converb
intenționez	Verb
șuncii	Noun
articulară	Verb
unseră	Verb
arbaletei	Noun
supa	Noun
mândrise	Verb
conții	Verb
ospătasem	Verb
desfăceau	Verb
fătul	Noun
trifoiului	Noun
muzică	Noun
indivizii	Noun
turtirăți	Verb
naivului	Adjective
stupidă	Adjective
adorabilul	Adjective
făcu	Verb
ghearei	Noun
preludiului	Noun
elevele	Noun
cenușie	Adjective
păstrași	Verb
belșugului	Noun
studentul	Noun
pregătea	Verb
balconul	Noun
bourului	Noun
obținea	Verb
cununat	Participle
adoptasem	Verb
insula	Noun
rublei	Noun
sufixul	Noun
amenința	Verb
trenului	Noun
gospodinei	Noun
folosinței	Noun
securitatea	Noun
pușcăria	Noun
răsăriși	Verb
adunaseră	Verb
farmecul	Noun
externă	Adjective
sporise	Verb
încălzești	Verb
amăgim	Verb
sughițând	Converb
răposarăm	Verb
sexualului	Adjective
furie	Noun
cămașa	Noun
seducție	Noun
morsei	Noun
aparului	Noun
grinda	Noun
aurorele	Noun
răuule	Adjective
ținuse	Verb
tuna	Verb
harbuzului	Noun
seara	Noun
pompierule	Noun
cioplești	Verb
citi	Verb
induce	Verb
umidități	Noun
surpriza	Noun
temem	Verb
îmbrăcăminții	Noun
omulețul	Noun
observat	Participle
explicare	Noun
multipolară	Adjective
temu	Verb
trezirea	Noun
estimăm	Verb
deșteapta	Adjective
negase	Verb
făgăduit	Participle
înjuri	Verb
fumat	Participle
greșim	Verb
nominalul	Adjective
imprecațiile	Noun
seceraseși	Verb
frecând	Converb
cartofului	Noun
pasat	Participle
genunchii	Noun
vărsat	Participle
cugetat	Participle
înfrunziserăm	Verb
independențe	Noun
știm	Verb
începusem	Verb
muisto	Noun
controlez	Verb
comunitatea	Noun
urziseși	Verb
președinții	Noun
clădind	Converb
adâncului	Adjective
ascultaserăți	Verb
cancerele	Noun
cuvintele	Noun
brazdă	Noun
livadă	Noun
desprinsese	Verb
gustoșilor	Adjective
unghiei	Noun
bălăi	Verb
antilopă	Noun
mama	Noun
porneai	Verb
structurala	Adjective
cântărit	Participle
încălțămintei	Noun
rebeliune	Noun
poftit	Participle
salariatului	Adjective
pregetaserăm	Verb
dureroasele	Adjective
declinaserăm	Verb
adap	Verb
sunaseși	Verb
grăsime	Noun
descrescând	Converb
gaițele	Noun
fraierul	Noun
azvârlit	Participle
macedoneanului	Adjective
bujorului	Noun
alcătuiai	Verb
gaură	Noun
dumnezeieștile	Adjective
vorbirii	Noun
căpătau	Verb
reținea	Verb
rodia	Noun
înfundaseși	Verb
craniului	Noun
trăiseră	Verb
distingând	Converb
desmântat	Participle
râdea	Verb
radiația	Noun
străveche	Adjective
muștei	Noun
încadrau	Verb
îngreunat	Participle
migdalule	Noun
numea	Verb
cicloidei	Noun
beliseși	Verb
pădure	Noun
scrise	Verb
proprietate	Noun
ziceau	Verb
tușiserăți	Verb
intelectul	Noun
pietroasele	Adjective
înierbase	Verb
Floriile	Noun
așezat	Participle
esența	Noun
așez	Verb
cercurile	Noun
castanie	Adjective
mângâiaseră	Verb
tomată	Noun
caisa	Noun
plictisit	Participle
pășunând	Converb
rachetele	Noun
pasă	Verb
cocoșul	Noun
soarelui	Noun
priveghea	Verb
buretelui	Noun
portocalele	Noun
pantera	Noun
tociră	Verb
cămilei	Noun
gustoasă	Adjective
umbrelele	Noun
adopți	Verb
plătiseră	Verb
înfruntarăți	Verb
murmura	Verb
întristasem	Verb
înfoiasem	Verb
alergiile	Noun
purceseseși	Verb
ejaculatoarea	Adjective
curata	Adjective
omleta	Noun
roșului	Adjective
amânat	Participle
umeda	Adjective
construiești	Verb
capabilității	Noun
profesiile	Noun
politeismului	Noun
biologică	Adjective
bursucul	Noun
scrisoare	Noun
năștea	Verb
capsulară	Verb
sacră	Adjective
judecarea	Noun
aduci	Verb
surprinse	Verb
pute	Verb
trimis	Participle
emoționau	Verb
cărbune	Noun
scumpa	Adjective
consultare	Noun
nocturna	Adjective
umbli	Verb
seceri	Verb
ecranele	Noun
delimitat	Participle
durul	Adjective
boul	Noun
rămas	Participle
gătiserăm	Verb
ataci	Verb
despărțise	Verb
balconului	Noun
pârghiei	Noun
rugise	Verb
băgași	Verb
dezgropa	Verb
podișurile	Noun
primă	Adjective
drese	Verb
interesa	Verb
adevăratei	Adjective
iubire	Noun
cearșaful	Noun
blocând	Converb
făptuise	Verb
podului	Noun
cronologie	Noun
stea	Noun
gândul	Noun
ajutau	Verb
afunda	Verb
concentrata	Adjective
supremă	Adjective
histologicii	Adjective
servului	Noun
lanului	Noun
înfăptuiseși	Verb
deszicând	Converb
sărbătorit	Participle
vârtoșii	Adjective
betoanele	Noun
știi	Verb
ridica	Verb
înlătura	Verb
cârmă	Noun
nemilei	Noun
dezlegăm	Verb
ademeneau	Verb
așteptând	Converb
dublau	Verb
sfintei	Noun
descoperirea	Noun
tăgăduiși	Verb
mustra	Verb
secretă	Adjective
semicercului	Noun
folosit	Participle
apei	Noun
fluturat	Participle
disecaseși	Verb
inelarul	Adjective
aplauda	Verb
observației	Noun
știuși	Verb
inflamabilei	Adjective
pupi	Verb
lichidele	Adjective
invita	Verb
păducelul	Noun
sporiseși	Verb
extindeau	Verb
lungului	Adjective
răsărit	Participle
scufundase	Verb
utilizând	Converb
viețuia	Verb
timpul	Noun
rădașcă	Noun
moftul	Noun
insecuritate	Noun
anihilat	Participle
balțule	Noun
vizitat	Participle
proporțională	Adjective
detaliul	Noun
glandului	Noun
vede	Verb
suind	Converb
peștelui	Noun
numiseră	Verb
vorba	Noun
frustrării	Noun
tuburile	Noun
îndepărtezi	Verb
portretele	Noun
cazanului	Noun
produce	Verb
sodomia	Noun
întrebau	Verb
narcotizăm	Verb
amicală	Adjective
lanterna	Noun
hibernase	Verb
rotunjită	Adjective
umanitatea	Noun
puțului	Noun
otrăvi	Verb
albaneza	Adjective
albastrului	Adjective
rămășagul	Noun
momiseră	Verb
loveau	Verb
peretele	Noun
atragem	Verb
învinsese	Verb
vitrega	Adjective
curva	Noun
luă	Verb
masturba	Verb
acidul	Adjective
structuratei	Adjective
contribuția	Noun
împărăteasă	Noun
bondarul	Noun
albul	Adjective
tentă	Verb
substantivul	Noun
recunoscând	Converb
trăsăturii	Noun
evreiască	Adjective
serului	Noun
societății	Noun
deismului	Noun
alcoolicii	Adjective
prioritate	Noun
acoperământul	Noun
împrumuta	Verb
vitaminele	Noun
halucinația	Noun
furculiță	Noun
rescrise	Verb
hrăneau	Verb
gustare	Noun
ascuțit	Participle
cascadei	Noun
locuințele	Noun
abiogeneza	Noun
locuiră	Verb
stânjeneau	Verb
custând	Converb
secerând	Converb
întrebuințez	Verb
înjurase	Verb
mișcau	Verb
scăldăm	Verb
activăm	Verb
scriitorului	Noun
testiculului	Noun
conjugarea	Noun
culca	Verb
apocalipticul	Adjective
lipsit	Participle
rechinului	Noun
capăt	Verb
insulei	Noun
ascunserăm	Verb
capră	Noun
încuia	Verb
mâncași	Verb
grație	Noun
dezvățasem	Verb
femeie	Noun
dispui	Verb
obscură	Adjective
mintală	Adjective
funcționare	Noun
izvoarele	Noun
vocea	Noun
mâncase	Verb
scrii	Verb
cordonul	Noun
peștera	Noun
trântitul	Adjective
imprimând	Converb
umblat	Participle
surprinzătorul	Adjective
briciul	Noun
virtuoasă	Adjective
personalitățile	Noun
surului	Adjective
inflexibilii	Adjective
macabrilor	Adjective
distrezi	Verb
ferit	Participle
poșeta	Noun
recunoscută	Adjective
vadului	Noun
sunteți	Verb
pilotule	Noun
adunare	Noun
aplicând	Converb
tancul	Noun
frizerului	Noun
naști	Verb
apropierii	Noun
ciocanul	Noun
vioiciunea	Noun
chema	Verb
fluierarăm	Verb
fixa	Verb
stolule	Noun
pavăză	Noun
absintul	Noun
construit	Participle
legând	Converb
brava	Adjective
porți	Verb
nuielele	Noun
organizațiile	Noun
scăparăm	Verb
scuipând	Converb
sugerea	Noun
stupiditatea	Noun
greșiserăți	Verb
paragrafele	Noun
nimici	Verb
povârniseși	Verb
aerisise	Verb
cumpăniseși	Verb
ocării	Noun
ciudata	Adjective
deplasase	Verb
subscriserăți	Verb
aspirina	Noun
confrunta	Verb
vitează	Adjective
socializaseră	Verb
moldoveneasca	Adjective
verandei	Noun
gravitații	Noun
apucăm	Verb
молдовеняскэ	Adjective
tăiat	Participle
simbolul	Noun
primirii	Noun
corasle	Noun
corasla	Noun
ieșise	Verb
cântăreții	Noun
încrucișaseră	Verb
vizitezi	Verb
canarul	Noun
diminuare	Noun
lărgind	Converb
termin	Verb
aerul	Noun
amesteca	Verb
trompetei	Noun
cocorului	Noun
implicăm	Verb
androceului	Noun
prăpădi	Verb
apăsă	Verb
vampirului	Noun
panterei	Noun
reciprocității	Noun
artisticul	Adjective
taurul	Noun
deranjez	Verb
adus	Participle
cubismul	Noun
îngropaserăm	Verb
desfășară	Verb
frigiderului	Noun
evazivă	Adjective
reintrodu	Verb
afurisind	Converb
securității	Noun
pârghiile	Noun
izgonii	Verb
bunăvoința	Noun
italiencele	Noun
maghiară	Adjective
miorița	Noun
castelul	Noun
putut	Participle
prieteniile	Noun
clinicile	Noun
țipătule	Noun
flautul	Noun
alcătui	Verb
transparență	Noun
formidabilă	Adjective
uscăciune	Noun
dispuserăți	Verb
portarului	Noun
carnea	Noun
organule	Noun
mândreau	Verb
transform	Verb
rectitudinea	Noun
abdicând	Converb
mingea	Noun
băiețelului	Noun
mâinii	Noun
focosului	Adjective
salutul	Noun
trecea	Verb
conjugării	Noun
aciuezi	Verb
delfinii	Noun
iepurașul	Noun
explicației	Noun
doamnă	Noun
împăturise	Verb
putrezisem	Verb
încurcat	Participle
citești	Verb
piesa	Noun
amicului	Noun
secretelor	Adjective
țărmurile	Noun
supraviețuiau	Verb
exterioarele	Adjective
antrenării	Noun
încurcase	Verb
ajutând	Converb
destupară	Verb
raționalizabilii	Adjective
răsărea	Verb
investitorului	Noun
puturoasa	Adjective
nearticulatele	Adjective
medicinei	Noun
înjurătură	Noun
îndrăznise	Verb
barză	Noun
zbârceați	Verb
căutările	Noun
merizaseră	Verb
parazitologiei	Noun
împăunarăm	Verb
bărbătoasa	Adjective
căzuse	Verb
proprietățile	Noun
arau	Verb
mustri	Verb
subscrise	Verb
câștig	Verb
falezei	Noun
familia	Noun
olimpică	Adjective
ucenicii	Noun
mergeai	Verb
bicicliștii	Noun
scârba	Noun
artă	Noun
creat	Participle
cufundaserăm	Verb
persanul	Adjective
funcție	Noun
ceapă	Noun
aromânească	Adjective
bogățiile	Noun
vorbirăți	Verb
stric	Verb
edificiul	Noun
crescuseră	Verb
calculatorul	Noun
compatriotul	Noun
decis	Participle
fuse	Verb
uscată	Adjective
delimitași	Verb
paltinul	Noun
echidna	Noun
blondele	Adjective
vădești	Verb
internul	Adjective
picătură	Noun
virilității	Noun
urlarăm	Verb
scotea	Verb
portretului	Noun
amintea	Verb
galvanizatului	Adjective
loghezi	Verb
cotit	Participle
ascunserăți	Verb
lipsa	Noun
mirosind	Converb
tarele	Adjective
descrește	Verb
ascensiunea	Noun
istoricii	Adjective
cordule	Noun
marinarul	Noun
abația	Noun
gândisem	Verb
cumpăraseră	Verb
actrițele	Noun
prezervativului	Noun
diminuase	Verb
ghepardul	Noun
anteriorul	Adjective
ospătărițele	Noun
italianca	Noun
cioturile	Noun
lubrifiarăm	Verb
presupusei	Verb
aspirinei	Noun
formidabilii	Adjective
chitarele	Noun
forfecare	Noun
astupa	Verb
zbârcim	Verb
becului	Noun
consularele	Adjective
accesibilității	Noun
informatica	Noun
încercuiră	Verb
cravatei	Noun
sărutat	Participle
negăm	Verb
miresei	Noun
românului	Adjective
strămutară	Verb
înduraserăți	Verb
înserară	Verb
măritând	Converb
încăpea	Verb
spinoasă	Adjective
deprindeau	Verb
iubirea	Noun
macabră	Adjective
pisicii	Noun
plajei	Noun
animațiile	Noun
icră	Noun
melcii	Noun
închisă	Adjective
turbarăm	Verb
contrazicând	Converb
stabilit	Participle
versatilii	Adjective
rezidenții	Adjective
isprăvi	Verb
delicata	Adjective
întâmplase	Verb
veninoasă	Adjective
vărsând	Converb
constând	Converb
eternității	Noun
stimulii	Noun
termina	Verb
adunase	Verb
coapsa	Noun
abilitate	Noun
exotica	Adjective
desfășurase	Verb
cerea	Verb
calitate	Noun
serveau	Verb
trotuarele	Noun
măslinii	Noun
pupezele	Noun
carpelă	Noun
înțeleseseră	Verb
șubredă	Adjective
moșia	Noun
ascultând	Converb
nearticulată	Adjective
constrânseserăți	Verb
vadurile	Noun
lumina	Noun
reușeau	Verb
invizibila	Adjective
fundașii	Noun
caldarâmul	Noun
sfertul	Noun
animalele	Adjective
lansau	Verb
îmbrăcămintea	Noun
emoția	Noun
insidioasă	Adjective
fanteziile	Noun
aleea	Noun
ștersului	Adjective
primire	Noun
rușina	Verb
dumnezeului	Noun
pietrosul	Adjective
adăpase	Verb
cadavrul	Noun
zebră	Noun
imunologia	Noun
însușirii	Noun
încurajaseși	Verb
însărcina	Verb
violențele	Noun
smulgând	Converb
doreați	Verb
îmbrățișat	Participle
căpățânoaselor	Adjective
vindec	Verb
răpirăți	Verb
codificată	Adjective
smintiserăți	Verb
soare	Noun
adormea	Verb
convenit	Participle
aerezi	Verb
bijuteriei	Noun
molidul	Noun
accelerația	Noun
versiunea	Noun
văduvești	Verb
australianule	Adjective
creativități	Noun
releul	Noun
momi	Verb
aeroplanul	Noun
impredictibilele	Adjective
începurăți	Verb
tocii	Verb
presupunea	Verb
prunul	Noun
resturile	Noun
unică	Adjective
chestiunile	Noun
frunțile	Noun
evenimentului	Noun
rătăcind	Converb
anticorpului	Noun
tânjit	Participle
stingeau	Verb
ucise	Verb
reintroduse	Verb
decapitând	Converb
coniacul	Noun
oacheșă	Adjective
furarăți	Verb
zonei	Noun
dezmântasem	Verb
aurit	Participle
căzând	Converb
împăcase	Verb
ofiliseși	Verb
chirurgiei	Noun
războiul	Noun
jupânul	Noun
acuzată	Adjective
chemă	Verb
jucăria	Noun
desprindea	Verb
circula	Verb
aritmeticei	Adjective
persevera	Verb
slangule	Noun
imputa	Verb
simboliza	Verb
preferând	Converb
epuizat	Participle
părăsise	Verb
mărturiile	Noun
spusei	Verb
destramaseră	Verb
împiedicară	Verb
scăpătat	Participle
inundat	Participle
auzit	Participle
scufundând	Converb
intervenii	Verb
speriem	Verb
dezmetici	Verb
spuse	Verb
nimerea	Verb
autoritățile	Noun
leneșii	Adjective
pinului	Noun
fragedele	Adjective
aplicăm	Verb
spermă	Noun
apucaseră	Verb
secolele	Noun
păcatului	Noun
frauda	Verb
întrebările	Noun
cuptorului	Noun
spurcaseși	Verb
terapia	Noun
britanică	Adjective
cățelele	Noun
bestialități	Noun
lipsești	Verb
negură	Noun
scufundaseră	Verb
strigau	Verb
întâietății	Noun
zbârleai	Verb
pozitronule	Noun
ocrotit	Participle
abandonării	Noun
sexuala	Adjective
activitatea	Noun
amețiserăm	Verb
combina	Verb
bufnița	Noun
cucerea	Verb
războiului	Noun
învățătorule	Noun
înfățișară	Verb
spate	Noun
timpului	Noun
anini	Verb
dovedit	Participle
lacului	Noun
tristă	Adjective
cugeta	Verb
creativității	Noun
naționalului	Adjective
neadevărurile	Noun
băteau	Verb
frunții	Noun
încununa	Verb
sângerului	Noun
încăpuseră	Verb
săpaseră	Verb
nurorile	Noun
mofturile	Noun
preistorică	Adjective
descoperea	Verb
cascada	Noun
animăm	Verb
varicelei	Noun
stadionul	Noun
inundând	Converb
codificații	Adjective
naivul	Adjective
joc	Verb
afund	Verb
coci	Verb
avantajul	Noun
răszisese	Verb
alianță	Noun
spargerea	Noun
ostilității	Noun
germanului	Adjective
cetățeanului	Noun
puroiul	Noun
foto-urile	Noun
împăcarăți	Verb
emoționa	Verb
balustrada	Noun
hârtia	Noun
interacțiunile	Noun
omletă	Noun
perechea	Noun
interferența	Noun
râpele	Noun
îmbunătățind	Converb
stinseră	Verb
dedaserăm	Verb
racii	Noun
supărăm	Verb
amuțiserăți	Verb
râm	Verb
opririi	Noun
ascundea	Verb
paritate	Noun
economicului	Adjective
circulaserăm	Verb
întrebăm	Verb
activitate	Noun
bizonului	Noun
mangustă	Noun
tarile	Adjective
delimităm	Verb
cromozomului	Noun
ruptura	Noun
continentala	Adjective
servisem	Verb
măcelarul	Noun
istorică	Adjective
cuibul	Noun
înfumurat	Participle
înfrunzirăți	Verb
conducem	Verb
florarule	Noun
azerii	Adjective
reduseseră	Verb
jaguarul	Noun
organizație	Noun
românii	Adjective
singurelor	Adjective
tandra	Adjective
culesei	Verb
pieriseră	Verb
călăreții	Noun
cronometrare	Noun
ruginești	Verb
încrederi	Noun
girafă	Noun
friptă	Adjective
excursia	Noun
susținuserăm	Verb
zdrobit	Participle
uraganele	Noun
profesoarei	Noun
mulțime	Noun
adâncit	Participle
numărase	Verb
blegelor	Adjective
urmat	Participle
ataraxia	Noun
portocala	Noun
momentele	Noun
bisericii	Noun
naționalul	Adjective
nuca	Noun
mesteacănul	Noun
creștină	Adjective
vitregului	Adjective
substanța	Noun
moștenit	Participle
veranda	Noun
caisele	Noun
simetrică	Adjective
nostalgică	Adjective
visătorul	Noun
numii	Verb
acoperim	Verb
elogiul	Noun
străpunseseră	Verb
vizitase	Verb
răciseră	Verb
îmblânzi	Verb
mistificase	Verb
ultima	Adjective
arcului	Noun
scrotul	Noun
plăcută	Adjective
părăsești	Verb
săreau	Verb
satira	Noun
armei	Noun
chemat	Participle
înrudit	Participle
pozitronii	Noun
răgușită	Adjective
stimei	Noun
înghițit	Participle
ruină	Verb
cosmonauții	Noun
tigrului	Noun
dominând	Converb
mut	Verb
edificiile	Noun
strâmtaseși	Verb
barbă	Noun
subrațele	Noun
pocnim	Verb
meritat	Participle
porcușorii	Noun
simplei	Adjective
ubicuități	Noun
răcoare	Noun
dublei	Adjective
agerilor	Adjective
înmânat	Participle
gândit	Participle
legănăm	Verb
mișc	Verb
ironie	Noun
îmbunătăți	Verb
amestecași	Verb
zâna	Noun
mămica	Noun
șoimii	Noun
groșilor	Adjective
mireasă	Noun
meritând	Converb
scăpărând	Converb
trăise	Verb
nenorocești	Verb
importantul	Adjective
inteligibilă	Adjective
schimbau	Verb
naivele	Adjective
poștala	Adjective
colajul	Noun
îmbogățeau	Verb
augurară	Verb
istoricului	Adjective
alcătuind	Converb
beregatei	Noun
cărau	Verb
dezrădăcinez	Verb
așezau	Verb
biomasei	Noun
fereau	Verb
vrabie	Noun
supranaționalii	Adjective
etimologiei	Noun
importanta	Adjective
acumulaserăți	Verb
lansaseră	Verb
florentine	Adjective
rezolvase	Verb
localității	Noun
androceul	Noun
uraganului	Noun
întâmpin	Verb
avansezi	Verb
letonul	Adjective
plicticoasă	Adjective
înfrunta	Verb
istoricele	Adjective
celții	Adjective
cerurăm	Verb
prazi	Verb
afundau	Verb
onestă	Adjective
numărând	Converb
iluziei	Noun
amicii	Noun
nurorii	Noun
ținuta	Adjective
pieptenele	Noun
stimulau	Verb
încrucișaserăm	Verb
mărturia	Noun
ruginim	Verb
rezolv	Verb
boii	Noun
zbăteau	Verb
religiile	Noun
pescărușul	Noun
mase	Verb
pragul	Noun
violență	Noun
mijloci	Verb
gladiolele	Noun
Bucovinei	Noun
morfologiei	Noun
delimitarea	Noun
marina	Adjective
originalitate	Noun
reducție	Noun
luare	Noun
mișcării	Noun
rasă	Adjective
pișasem	Verb
călătorule	Adjective
prășiseși	Verb
gemenilor	Adjective
tubului	Noun
altele	Adjective
buchetele	Noun
ostilitate	Noun
funcționăm	Verb
christadelfienii	Adjective
mamuții	Noun
zgâria	Verb
vânduși	Verb
adoptaseră	Verb
terapie	Noun
aspirină	Noun
legaseră	Verb
rupturile	Noun
rătăciților	Adjective
bietul	Adjective
călcând	Converb
septul	Noun
bizonii	Noun
pedepsind	Converb
românească	Adjective
cartilajul	Noun
furioșii	Adjective
urâțenie	Noun
amețeală	Noun
strălucitoarea	Adjective
soporificelor	Adjective
masculinului	Adjective
accesul	Noun
oblig	Verb
hotărând	Converb
gaița	Noun
mânerele	Noun
subsuoara	Noun
sucurile	Noun
clara	Adjective
îndrăznind	Converb
bucurând	Converb
încrezui	Verb
fripseserăm	Verb
abacului	Noun
disponibilitățile	Noun
trezea	Verb
florii	Noun
spurcurile	Noun
păstrase	Verb
țigară	Noun
oglindă	Noun
orhideei	Noun
întortochea	Verb
fusului	Noun
amărât	Participle
impuseseră	Verb
ceparii	Noun
studiem	Verb
puma	Noun
stilul	Noun
înnoiserăm	Verb
retragem	Verb
pruna	Noun
cârtiță	Noun
sfătuii	Verb
fracturaserăm	Verb
atrocitățile	Noun
curvă	Noun
refuzăm	Verb
împunseși	Verb
îmbunătățit	Participle
chestiunea	Noun
piersicile	Noun
covorului	Noun
gorilele	Noun
secundarii	Adjective
strugure	Noun
nădăjduiați	Verb
grotă	Noun
artroza	Noun
viezurele	Noun
găurind	Converb
nisipule	Noun
învechită	Adjective
abilă	Adjective
șoarecii	Noun
sfeșnicului	Noun
rostind	Converb
adăpostului	Noun
cotidienelor	Adjective
ancora	Noun
orzul	Noun
orientării	Noun
implicarăți	Verb
plăcere	Noun
celebrările	Noun
mărinimoasă	Adjective
refractometriei	Noun
secera	Verb
zână	Noun
sprintenul	Adjective
profesie	Noun
abnegația	Noun
curăturile	Noun
groasa	Adjective
bărbiei	Noun
luminile	Noun
descălțasem	Verb
hotărârăm	Verb
lungile	Adjective
decădea	Verb
circulară	Verb
cobori	Verb
cocoșului	Noun
călugărițele	Noun
cerșit	Participle
scriem	Verb
omogenă	Adjective
hârciogul	Noun
amanetat	Participle
felului	Noun
cotropirăți	Verb
egalii	Adjective
masculului	Adjective
cobora	Verb
ezitați	Verb
oglindit	Participle
picat	Participle
coloratul	Adjective
zburau	Verb
stepele	Noun
anatomica	Adjective
pictez	Verb
învechind	Converb
legendarii	Adjective
perversității	Noun
depusese	Verb
pătrundeau	Verb
citise	Verb
meduza	Noun
timidității	Noun
sporii	Verb
personalitatea	Noun
declinării	Noun
frecară	Verb
basma	Noun
aninul	Noun
cărnoșilor	Adjective
filantropiei	Noun
tastaturii	Noun
componentă	Noun
deșteptare	Noun
sticla	Noun
plopului	Noun
muncești	Verb
mințiși	Verb
pregătit	Participle
unse	Verb
după-amiezii	Noun
primei	Adjective
colonialismului	Noun
aruncând	Converb
homosexualii	Adjective
sufletului	Noun
bănuind	Converb
începeau	Verb
trăii	Verb
culturile	Noun
farurile	Noun
speriatei	Adjective
fumă	Verb
spărgeau	Verb
venind	Converb
adâncime	Noun
îngropând	Converb
trandafirul	Noun
iarba	Noun
ură	Noun
râncedele	Adjective
dinții	Noun
plăteau	Verb
covrigul	Noun
repauzând	Converb
căzurăm	Verb
atacând	Converb
dezumflu	Verb
căprioarei	Noun
iobagul	Noun
vărsăm	Verb
delfinului	Noun
schimburile	Noun
sătură	Verb
racul	Noun
venerare	Noun
deschis	Participle
lărgi	Verb
pugiliștii	Noun
macedonenii	Adjective
fericitului	Adjective
antrenarea	Noun
integrabilei	Adjective
lățim	Verb
amețind	Converb
fraudă	Verb
lacrimă	Noun
gemenele	Adjective
anonimității	Noun
contagioasă	Adjective
petrecut	Participle
completasem	Verb
bibliotecile	Noun
șuieraseră	Verb
rezistență	Noun
vorbești	Verb
înscris	Participle
dispusese	Verb
nivelul	Noun
irațională	Adjective
optica	Noun
pingelirăm	Verb
pătau	Verb
stuful	Noun
juisași	Verb
oule	Noun
scoapseserăți	Verb
cireșele	Noun
coiule	Noun
riscului	Noun
soma	Verb
importantei	Adjective
contribuției	Noun
susținând	Converb
prescris	Participle
ruptul	Adjective
secvenței	Noun
mescui	Verb
mărarului	Noun
comunei	Adjective
balustradă	Noun
lalelele	Noun
constrânserăți	Verb
plină	Adjective
zborurile	Noun
măreață	Adjective
biologicelor	Adjective
înlăturând	Converb
luat	Participle
depăr	Verb
păzit	Participle
vorbitoare	Noun
botez	Verb
invadase	Verb
sinucis	Participle
viezurii	Noun
ulcerului	Noun
lemnarul	Noun
îndrăzni	Verb
urmase	Verb
desparți	Verb
labei	Noun
motanii	Noun
elementară	Adjective
riscași	Verb
perturbatorilor	Adjective
adorat	Participle
bucurau	Verb
lutra	Noun
rătăcitelor	Adjective
bocetele	Noun
plantară	Verb
purcedeau	Verb
analogicul	Adjective
lămâia	Noun
înnoraserăm	Verb
laleaua	Noun
prafului	Noun
potrivi	Verb
temperatură	Noun
poștalului	Adjective
încântarăți	Verb
înăbușit	Participle
semnase	Verb
medicina	Noun
înotând	Converb
însori	Verb
încercaseși	Verb
scurtele	Adjective
gheparzii	Noun
moașă	Noun
satisfăcând	Converb
bucura	Verb
încununarăm	Verb
spuma	Verb
pedeapsă	Noun
înțelesului	Adjective
paraziții	Noun
lichidul	Adjective
filmele	Noun
pulsezi	Verb
bărbătoșii	Adjective
păruseși	Verb
plăcerile	Noun
pieptănăm	Verb
legendarei	Adjective
desfășă	Verb
șoptit	Participle
ușurezi	Verb
surprindeau	Verb
pisicile	Noun
rădăcinile	Noun
ideii	Noun
săgetaserăți	Verb
furnicile	Noun
albinarule	Noun
așezaseră	Verb
fada	Adjective
bătrânului	Adjective
perindară	Verb
adevărata	Adjective
întrerupeau	Verb
micșora	Verb
aplaudau	Verb
barași	Verb
virgula	Noun
apocaliptică	Adjective
mușca	Verb
mințind	Converb
adjectivule	Noun
dobândeau	Verb
îngrijise	Verb
învolburat	Participle
urgie	Noun
simplificat	Participle
treacătule	Noun
drepturile	Adjective
urgia	Noun
geacă	Noun
consultarea	Noun
scuipaseră	Verb
obișnuind	Converb
comunicăm	Verb
urcare	Noun
totalitățile	Noun
șoimului	Noun
tocise	Verb
umbrirăți	Verb
fixăm	Verb
rabinului	Noun
prinseserăm	Verb
acuzași	Verb
învecinase	Verb
anin	Verb
ciocniserăți	Verb
căutând	Converb
presupus	Participle
îndemnau	Verb
celților	Adjective
celtă	Adjective
buricului	Noun
mergând	Converb
mătușă	Noun
poalei	Noun
scărpinarăm	Verb
bijuteria	Noun
rotunjise	Verb
gemem	Verb
paradoxurile	Noun
rândul	Noun
decența	Noun
lume	Noun
cariotipului	Noun
îmboldit	Participle
răzbun	Verb
examenul	Noun
scrisoarea	Noun
valahul	Adjective
ironia	Noun
sărurile	Noun
culc	Verb
lăudând	Converb
răbojești	Verb
ușierul	Noun
nenorocind	Converb
leurdei	Noun
franțuzoaică	Noun
actrița	Noun
răsfăț	Verb
șasiului	Noun
înăbușeați	Verb
gnosticismul	Noun
smulse	Verb
surprinzătoarea	Adjective
întingeau	Verb
clătinară	Verb
erați	Verb
chinezul	Adjective
cufurea	Verb
contenii	Verb
lemnele	Noun
distrat	Participle
răcirăm	Verb
vampirii	Noun
tâmpeniile	Noun
barba	Noun
zarzărele	Noun
rescriseseră	Verb
fotbalistului	Noun
contururile	Noun
gimnastei	Noun
conduceau	Verb
crăpat	Participle
lucezii	Adjective
amanetând	Converb
semicercul	Noun
alta	Adjective
tipă	Noun
văduvul	Adjective
ținea	Verb
zimbrul	Noun
pubertățile	Noun
moldoveanul	Adjective
întuneca	Verb
adultul	Adjective
înserării	Noun
întoarcem	Verb
biserica	Noun
înghețaserăți	Verb
înlesniserăm	Verb
acneea	Noun
tancurile	Noun
fântânii	Noun
căzusem	Verb
bigile	Noun
urșii	Noun
gusta	Verb
vătăma	Verb
împiedici	Verb
minge	Noun
izbi	Verb
urmăririle	Noun
conceptele	Noun
mutând	Converb
discordiile	Noun
sucit	Participle
imunologiei	Noun
arcadei	Noun
îndupleca	Verb
larga	Adjective
ghidez	Verb
evangheliile	Noun
neuitabilii	Adjective
junimea	Noun
abdicaseră	Verb
realitatea	Noun
ocupau	Verb
faptul	Noun
glumea	Verb
sărbătorind	Converb
șalul	Noun
închinăm	Verb
obișnuia	Verb
cumpănii	Verb
păcurarul	Noun
sărutului	Noun
intenționau	Verb
tehnicianul	Noun
mușc	Verb
înfrunziseră	Verb
bolii	Noun
înșeuaserăm	Verb
moldovenească	Adjective
verbele	Noun
tavanul	Noun
urzeală	Noun
cultură	Noun
corupând	Converb
trezit	Participle
citind	Converb
ușurăm	Verb
sinistră	Adjective
lebedele	Noun
globul	Noun
homosexualității	Noun
arătase	Verb
dovedim	Verb
behaviorismului	Noun
gălbuiului	Adjective
depuse	Verb
cunoscuta	Adjective
căutării	Noun
rodie	Noun
scăldau	Verb
miresele	Noun
dimensionare	Noun
înfometa	Verb
urbanizării	Noun
lipiră	Verb
mănânc	Verb
pulpoasă	Adjective
reușise	Verb
judecații	Adjective
îndrăznim	Verb
crăpase	Verb
filmul	Noun
faptului	Noun
furtunului	Noun
sculptorul	Noun
interveneau	Verb
celebra	Verb
hotăra	Verb
îmbunătățirăm	Verb
răspuns	Participle
explicau	Verb
refuzat	Participle
minciunii	Noun
protejând	Converb
apăsasem	Verb
societatea	Noun
buburuză	Noun
girafei	Noun
bufnițele	Noun
cinseși	Verb
recunoaștem	Verb
tăiasem	Verb
descopereau	Verb
viteză	Noun
inexplicabililor	Adjective
continentală	Adjective
inflorescenței	Noun
încuiaserăți	Verb
infinității	Noun
împinseserăm	Verb
delimitaserăți	Verb
zecime	Noun
hârtie	Noun
păcii	Noun
fracturat	Participle
uraganul	Noun
ratonul	Noun
asprului	Adjective
mediocră	Adjective
lunii	Noun
născuseră	Verb
beli	Verb
ocară	Noun
face	Verb
descurca	Verb
asigurăm	Verb
misandriei	Noun
sângeroasa	Adjective
mirarea	Noun
vindecaseră	Verb
îndeletnicit	Participle
juvenilii	Adjective
amintirii	Noun
analele	Adjective
furunculul	Noun
desfășuraserăm	Verb
deschizând	Converb
interesantă	Adjective
pliviseră	Verb
abcesului	Noun
plauzibilitatea	Noun
imputi	Verb
depărtară	Verb
englezii	Adjective
iritasem	Verb
conțineau	Verb
condu	Verb
călugării	Noun
odihnind	Converb
dinamică	Adjective
gândești	Verb
naționalii	Adjective
speriată	Adjective
paharele	Noun
pieptului	Noun
aprinzi	Verb
păcălind	Converb
afină	Noun
onorurilor	Noun
benzine	Noun
carnivorele	Adjective
ramura	Noun
omenirea	Noun
tăiaseși	Verb
păruind	Converb
crizantemei	Noun
încurajase	Verb
însoți	Verb
vinzi	Verb
jocul	Noun
cerând	Converb
doctora	Noun
descoperise	Verb
studenta	Noun
învățaseră	Verb
rostea	Verb
excelau	Verb
căruntă	Adjective
judecătorii	Noun
cicliștilor	Adjective
atacul	Noun
încheietură	Noun
preziserăți	Verb
plictiseală	Noun
iubi	Verb
sap	Verb
temeliile	Noun
degeraseși	Verb
strugurelui	Noun
vânătaie	Noun
robi	Verb
aera	Verb
rândului	Noun
grecoaica	Noun
masculii	Adjective
plecaseră	Verb
detaliului	Noun
agenții	Noun
îngrijiserăți	Verb
ascensiunile	Noun
complexitatea	Noun
dezarmare	Noun
domnului	Noun
sugrumat	Participle
greși	Verb
bătut	Participle
mergem	Verb
risipind	Converb
moșie	Noun
patinare	Noun
oblică	Adjective
cerni	Verb
dopurile	Noun
prețurile	Noun
bazau	Verb
săturat	Participle
periuțele	Noun
ceramicei	Noun
umblăm	Verb
parcările	Noun
reții	Verb
vidrei	Noun
căscase	Verb
socul	Noun
antrenare	Noun
continentalele	Adjective
trădând	Converb
tornadele	Noun
supranațională	Adjective
ocupaserăm	Verb
înghesuit	Participle
onorasem	Verb
rescriserăm	Verb
batjocorești	Verb
gladiola	Noun
supraviețuim	Verb
termometrele	Noun
realul	Adjective
sângeroasele	Adjective
obișnui	Verb
admirând	Converb
lipsirăm	Verb
împodobind	Converb
menținuse	Verb
viețui	Verb
colegul	Noun
asiguri	Verb
rețea	Noun
lungind	Converb
lămureați	Verb
cernuși	Verb
suveranii	Adjective
încălecaseși	Verb
luarea	Noun
balta	Noun
prevestea	Verb
spitalului	Noun
capitală	Noun
despărțim	Verb
economicul	Adjective
chițcăiau	Verb
trăia	Verb
ciocănitoare	Noun
portocaliul	Adjective
acoperind	Converb
fă	Verb
valorii	Noun
indisponibilă	Adjective
temusem	Verb
pârghia	Noun
trimisei	Verb
păstraseși	Verb
râncedului	Adjective
servim	Verb
revoluției	Noun
cărunta	Adjective
drumului	Noun
măturaseră	Verb
înspăimântași	Verb
găsise	Verb
unidirecționalei	Adjective
veneau	Verb
presupuse	Verb
crescuse	Verb
abilității	Noun
rumegarăți	Verb
tăieturii	Noun
pumnul	Noun
grăbim	Verb
rusească	Adjective
păzind	Converb
spectralele	Adjective
hemoroizii	Noun
răcori	Verb
socotise	Verb
mănușa	Noun
păruseră	Verb
vărgată	Adjective
anulat	Participle
păzi	Verb
castaniul	Adjective
convinsese	Verb
praful	Noun
satur	Verb
generalului	Noun
auzeau	Verb
greșiseși	Verb
tăie	Verb
obliga	Verb
nutrești	Verb
capacitate	Noun
cususerăm	Verb
amicalul	Adjective
gazând	Converb
ascult	Verb
facilității	Noun
orbului	Adjective
întinsul	Adjective
opiul	Noun
urmașii	Noun
conștiințele	Noun
uit	Verb
râseseși	Verb
reintroducând	Converb
interesez	Verb
frânând	Converb
adultului	Adjective
propusese	Verb
gemu	Verb
voturile	Noun
imaturității	Noun
benzinăriile	Noun
botezaseră	Verb
oiță	Noun
ebraicei	Noun
curgem	Verb
acuzaților	Adjective
exiști	Verb
cărnurile	Noun
cumplitul	Adjective
creezi	Verb
rostogolirăm	Verb
documentăm	Verb
urăști	Verb
țineai	Verb
înjunghia	Verb
veșmântului	Noun
alungaserăm	Verb
completezi	Verb
obișnuit	Participle
viperă	Noun
atotputernica	Adjective
funcționau	Verb
neglijară	Verb
dezvoltaseră	Verb
înrudeau	Verb
strâmbi	Verb
salariatul	Adjective
latine	Noun
adăuga	Verb
platele	Adjective
legendarului	Adjective
dormea	Verb
copiat	Participle
păcălit	Participle
făgădui	Verb
pălăriei	Noun
duhului	Noun
râioasă	Adjective
țipat	Participle
poștală	Adjective
încheierii	Noun
bucurat	Participle
înflorit	Participle
corneea	Noun
trotuarului	Noun
iubești	Verb
cadavrului	Noun
obținerea	Noun
dispăruse	Verb
flautului	Noun
substantivele	Noun
brazdei	Noun
înfățișa	Verb
cererii	Noun
odaia	Noun
presupuseși	Verb
dobândit	Participle
arătăm	Verb
societățile	Noun
reumatismul	Noun
terminarea	Noun
vizibilitatea	Noun
exagerații	Adjective
coloratele	Adjective
religiosului	Adjective
spanacul	Noun
întâlnea	Verb
renovez	Verb
iubeau	Verb
amicul	Noun
reușea	Verb
babuinii	Noun
îmbuibasem	Verb
glonțul	Noun
heringul	Noun
discuțiile	Noun
servești	Verb
toiul	Noun
cosmonautului	Noun
înfășura	Verb
politizare	Noun
apropiau	Verb
rachetă	Noun
migdalul	Noun
donației	Noun
conturile	Noun
instabilității	Noun
adăpostită	Adjective
frizerul	Noun
flutur	Verb
prinselor	Adjective
văzuși	Verb
sarmalele	Noun
complexității	Noun
fermierul	Noun
netedei	Adjective
învingem	Verb
aducând	Converb
magazinului	Noun
ierarhie	Noun
jenând	Converb
trezești	Verb
explicase	Verb
credeau	Verb
conjuncție	Noun
avalanșa	Noun
smulseseși	Verb
ungureștile	Adjective
venerat	Participle
cronică	Adjective
puternică	Adjective
prietenă	Noun
târziei	Adjective
agesturile	Noun
lăsaseră	Verb
existat	Participle
zdrobind	Converb
sufla	Verb
dogmatica	Adjective
haiducii	Noun
primilor	Adjective
amânaseși	Verb
raza	Noun
mândriei	Noun
învăț	Verb
cumplită	Adjective
mișcarea	Noun
școală	Noun
dătătorul	Adjective
maturitatea	Noun
învierii	Noun
umiditatea	Noun
rugăm	Verb
răsunau	Verb
zbura	Verb
instantaneilor	Adjective
indus	Participle
răsunarăm	Verb
închizi	Verb
îmbunătății	Verb
uliului	Noun
abandonaseră	Verb
aducem	Verb
versatilelor	Adjective
perechile	Noun
bunăvoinței	Noun
corcim	Verb
grosimii	Noun
circumcizia	Noun
pălăria	Noun
păgânii	Adjective
scoseseră	Verb
stăruii	Verb
cercași	Verb
respirăm	Verb
șovăia	Verb
cașul	Noun
purceaua	Noun
evinseserăm	Verb
exterioarelor	Adjective
spulber	Verb
cobaiule	Noun
morcovul	Noun
destramaserăm	Verb
respingere	Noun
minusculele	Adjective
rața	Noun
vânjoasele	Adjective
sora	Noun
îngrijorăm	Verb
scutecele	Noun
robești	Verb
dansatorul	Noun
călcasem	Verb
micile	Adjective
pictată	Adjective
intrase	Verb
stelele	Noun
mira	Verb
îmbinat	Participle
vinarsul	Noun
mânca	Verb
pietrosului	Adjective
perinealului	Adjective
strămutat	Participle
slăbirăți	Verb
usturoiul	Noun
spulberaseră	Verb
însuflețire	Noun
băiețelul	Noun
lipsea	Verb
sigura	Adjective
juraseră	Verb
comunica	Verb
străbunicului	Noun
prelungim	Verb
ursule	Noun
grebla	Noun
suveranității	Noun
religia	Noun
suprema	Adjective
flăcările	Noun
călcau	Verb
descălecaseră	Verb
înfășurat	Participle
valsurile	Noun
purifica	Verb
profundă	Adjective
rugând	Converb
luci	Verb
farmecele	Noun
pornografiei	Noun
anteriorilor	Adjective
terțului	Adjective
sosul	Noun
înmâna	Verb
podelei	Noun
contenit	Participle
ghicea	Verb
datorii	Adjective
vomeați	Verb
gazela	Noun
tinseserăm	Verb
estimez	Verb
foile	Noun
fugind	Converb
onestității	Noun
ciotului	Noun
gâmbaseși	Verb
regalistă	Adjective
socii	Noun
refuz	Verb
sinonimul	Noun
nivelă	Verb
grecescului	Adjective
dulgherule	Noun
vizualiza	Verb
hotărăști	Verb
laurii	Noun
înfocară	Verb
ficatul	Noun
biscuitului	Noun
taifunul	Noun
vraja	Noun
mămică	Noun
împlinise	Verb
lăsasem	Verb
abandonare	Noun
alanina	Noun
strecurat	Participle
masturbaseși	Verb
chiftea	Noun
imitării	Noun
sufletule	Noun
anticiparea	Noun
apropierea	Noun
pușcărie	Noun
plaiurile	Noun
afganul	Adjective
morțile	Noun
îndopat	Participle
mangustei	Noun
amfibiile	Adjective
literă	Noun
înlesnit	Participle
domesticire	Noun
galfeda	Adjective
consoană	Noun
plumburiii	Adjective
forțară	Verb
cugetase	Verb
mestecenii	Noun
înduplecat	Participle
coaptă	Adjective
cercetând	Converb
înrămat	Participle
mescu	Verb
împarți	Verb
omniprezentă	Adjective
cufurit	Participle
magazinerului	Noun
empirică	Adjective
numărau	Verb
dezlipeau	Verb
scremeau	Verb
covorul	Noun
totalității	Noun
genă	Noun
nutrind	Converb
conținut	Participle
lăcrimat	Participle
obișnuiești	Verb
perineul	Noun
piticul	Noun
subterana	Adjective
îndurau	Verb
arbuștii	Noun
topeai	Verb
leurda	Noun
cordului	Noun
clarificasem	Verb
lovit	Participle
orfanul	Adjective
sperat	Participle
hipopotamii	Noun
împunseră	Verb
animat	Participle
aducătoare	Noun
spargere	Noun
alcoolicul	Adjective
încuraja	Verb
trântiților	Adjective
dependentei	Adjective
oripila	Verb
mergeau	Verb
puteau	Verb
uzilor	Adjective
porcărie	Noun
asuzi	Verb
polisierele	Noun
verdelui	Adjective
biologiei	Noun
decăzuse	Verb
grădină	Noun
tramvaiul	Noun
răbdaserăți	Verb
mureai	Verb
vădirăți	Verb
strajă	Noun
dispuneau	Verb
vampirei	Noun
cruzimea	Noun
chinezului	Adjective
crezuse	Verb
electromagneticul	Adjective
săptămânalului	Adjective
masculinelor	Adjective
cutreieraseră	Verb
mâhneau	Verb
tremurase	Verb
rețeaua	Noun
aerodromul	Noun
înțelegeau	Verb
lămpii	Noun
explicat	Participle
desfătase	Verb
funcționarea	Noun
prinsoare	Noun
verișoara	Noun
riscau	Verb
gâsca	Noun
tulburând	Converb
putuse	Verb
mânerului	Noun
idee	Noun
fluxurile	Noun
cutreierând	Converb
îngrijit	Participle
înconjurași	Verb
dezlipi	Verb
vrăji	Verb
unduisem	Verb
stabili	Verb
urzise	Verb
arcașul	Noun
gravității	Noun
scufundatul	Adjective
unduim	Verb
muie	Verb
tâmpit	Participle
cuțitul	Noun
cucerise	Verb
introducea	Verb
histologiei	Noun
rețineau	Verb
bărbăția	Noun
stăpânea	Verb
caniculară	Adjective
prinsa	Adjective
adunăm	Verb
naivelor	Adjective
prosteau	Verb
înverziși	Verb
răsărind	Converb
pedepsim	Verb
atomule	Noun
oposumul	Noun
vaccinat	Participle
slăbind	Converb
zara	Noun
înconjurau	Verb
odihnești	Verb
ghilotina	Noun
mărturisi	Verb
fumegând	Converb
cinsti	Verb
treapta	Noun
resursă	Noun
întemeiând	Converb
zdrobisem	Verb
suptului	Adjective
moșiei	Noun
piereați	Verb
nerealului	Adjective
adăstaseși	Verb
mieii	Noun
robeați	Verb
tăcere	Noun
averile	Noun
sticlă	Noun
buca	Noun
fată	Noun
moldovenescul	Adjective
valsarăți	Verb
plecă	Verb
tavanele	Noun
purtau	Verb
îmbinasem	Verb
stă	Verb
transformând	Converb
prezervativul	Noun
emoționat	Participle
moldovenii	Adjective
înconjur	Verb
croiești	Verb
corceați	Verb
serul	Noun
zgâriarăm	Verb
adâncimile	Noun
schimbaseră	Verb
șoptiseră	Verb
dona	Verb
ascensiunii	Noun
atârna	Verb
comparării	Noun
portocalul	Noun
geamănă	Adjective
rugină	Noun
controla	Verb
mucii	Noun
îngreună	Verb
deschisese	Verb
recuperarăți	Verb
țigării	Noun
femininelor	Adjective
învățătoarea	Noun
excitaseși	Verb
hinduismului	Noun
părosului	Adjective
sărea	Verb
domini	Verb
lebăda	Noun
întrebarea	Noun
abreviația	Noun
onoarea	Noun
intra	Verb
jenă	Verb
curvele	Noun
apărură	Verb
australianul	Adjective
rulau	Verb
orientau	Verb
știrbei	Adjective
rămăsese	Verb
purtase	Verb
apăruși	Verb
frecaseră	Verb
căsători	Verb
eliberase	Verb
convenționalul	Adjective
cercetez	Verb
securile	Noun
înălțime	Noun
produceați	Verb
perineală	Adjective
comună	Adjective
ștersă	Adjective
păcurarii	Noun
prioritatea	Noun
dreptului	Adjective
uitând	Converb
credință	Noun
sculptura	Noun
afurisiseși	Verb
pungașul	Noun
supui	Verb
adusesem	Verb
farfuriei	Noun
înlocuiseră	Verb
domesticirii	Noun
prescria	Verb
renumelui	Noun
masacrele	Noun
guvernului	Noun
zirconule	Noun
aținut	Participle
stimez	Verb
aruncării	Noun
chiorâși	Verb
terminație	Noun
probat	Participle
slujiși	Verb
împletiseși	Verb
conturul	Noun
sonatei	Noun
articulat	Participle
urangutanii	Noun
strâmbași	Verb
mâncat	Participle
dezvolt	Verb
păianjenului	Noun
configurările	Noun
țipătul	Noun
automatului	Adjective
isteață	Adjective
împrumutaseră	Verb
ghicind	Converb
satura	Verb
glumești	Verb
obscurului	Adjective
familiile	Noun
descriem	Verb
broască	Noun
portalului	Noun
aburii	Noun
menținând	Converb
aiurarăm	Verb
magistrul	Noun
batem	Verb
întreținură	Verb
cumințiseși	Verb
lipim	Verb
tăcerea	Noun
fura	Verb
compozitoare	Noun
certând	Converb
țara	Noun
infinitatea	Noun
tunseră	Verb
induceau	Verb
mielarul	Noun
halucinaseră	Verb
obișnuiau	Verb
observi	Verb
babă	Noun
introduseși	Verb
suflând	Converb
surp	Verb
ștergi	Verb
imnului	Noun
baltă	Noun
umpleai	Verb
fâsa	Noun
terapeuticilor	Adjective
satisfăcuse	Verb
muntoasa	Adjective
cățea	Noun
nimeri	Verb
castorului	Noun
anihilau	Verb
ușurat	Participle
ispitiseră	Verb
curmalele	Noun
profesorului	Noun
portofelul	Noun
folosise	Verb
memoria	Noun
cărările	Noun
joci	Verb
balena	Noun
ciocârlia	Noun
croit	Participle
astronomul	Noun
știut	Participle
cernu	Verb
mijlocirăți	Verb
defileului	Noun
cântase	Verb
eventualitate	Noun
scobit	Participle
psihologiei	Noun
brumăriul	Adjective
porumbacii	Adjective
răsunase	Verb
vocativul	Noun
elementara	Adjective
omeniei	Noun
căzu	Verb
piersicul	Noun
grăsimii	Noun
fotoliului	Noun
modalitățile	Noun
perindă	Verb
împroprietărit	Participle
globalizarea	Noun
credincioasei	Adjective
mănușii	Noun
cunoaștere	Noun
văii	Noun
bisexualii	Adjective
indusese	Verb
arsului	Adjective
urgiei	Noun
adorasem	Verb
inesteticelor	Adjective
agentul	Noun
tancului	Noun
biata	Adjective
ungeați	Verb
mistificaserăm	Verb
dorului	Noun
grătarului	Noun
împerechea	Verb
neghinei	Noun
înscriau	Verb
canadienii	Adjective
amânase	Verb
varicela	Noun
reducem	Verb
norul	Noun
depără	Verb
telefonul	Noun
dorii	Verb
scurtat	Participle
prietena	Noun
borțoaselor	Adjective
găinușa	Noun
fiertul	Adjective
ridicară	Verb
reflectatelor	Adjective
unicul	Adjective
sângerosul	Adjective
măiastra	Adjective
îmbătrânirea	Noun
comorile	Noun
intimii	Adjective
folosim	Verb
fiartă	Adjective
silă	Noun
unicele	Adjective
panteismul	Noun
descriind	Converb
naționala	Adjective
elasticitatea	Noun
înfrunzit	Participle
strecurasem	Verb
slujea	Verb
obosea	Verb
bucătarului	Noun
conopida	Noun
amara	Adjective
scădeați	Verb
lungești	Verb
agățarea	Noun
gâturile	Noun
spumași	Verb
chinezoaică	Noun
îndeletnicise	Verb
năframă	Noun
rădaștele	Noun
robind	Converb
plămânul	Noun
ospăta	Verb
chimică	Adjective
lopătarul	Noun
plimbat	Participle
supunând	Converb
greșeai	Verb
macacul	Noun
azvârliră	Verb
atomul	Noun
declara	Verb
grăiserăți	Verb
persanii	Adjective
ecranul	Noun
june	Noun
dezavantajele	Noun
rubla	Noun
porcului	Noun
deșteptării	Noun
struțul	Noun
lucraseră	Verb
certa	Verb
prăjirăți	Verb
răpusese	Verb
rulasem	Verb
pașaportului	Noun
ucis	Participle
dungată	Adjective
iudaismul	Noun
calitățile	Noun
defăima	Verb
plauzibilității	Noun
fonetică	Adjective
semnez	Verb
inundați	Verb
mărturisești	Verb
minereurile	Noun
roza	Noun
dezlipisem	Verb
baschetul	Noun
cinteza	Noun
înfruntând	Converb
cehului	Adjective
misteriosul	Adjective
programele	Noun
aerară	Verb
furăm	Verb
tipărind	Converb
expediat	Participle
stătuse	Verb
apuc	Verb
jandarmului	Noun
rezistat	Participle
vântoșilor	Adjective
bălăirăm	Verb
dărâmase	Verb
mânăstire	Noun
amețit	Participle
agățaseră	Verb
chițcăiseși	Verb
luările	Noun
delimitările	Noun
grabei	Noun
obeză	Adjective
ghidau	Verb
abilul	Adjective
lucrările	Noun
lipitoarea	Noun
angajase	Verb
prelungind	Converb
îngălbenit	Participle
spălând	Converb
înăbușim	Verb
posibilul	Adjective
ademenea	Verb
făcea	Verb
restului	Noun
serenadă	Noun
rufa	Noun
banană	Noun
sfertului	Noun
neg	Verb
mânăstirea	Noun
slujit	Participle
hărții	Noun
cameramanului	Noun
creangă	Noun
crezuseră	Verb
electromagnetică	Adjective
arbaleta	Noun
compara	Verb
intervenind	Converb
sparseși	Verb
desenând	Converb
pupezei	Noun
înăbușea	Verb
ostilitățile	Noun
hrănea	Verb
descrierea	Noun
averii	Noun
bulgarii	Adjective
majorității	Noun
pățești	Verb
fricoșilor	Adjective
lipi	Verb
ameți	Verb
sila	Noun
bolile	Noun
încăpuserăm	Verb
adăpaseși	Verb
urcaseră	Verb
trăsătură	Noun
semivocală	Noun
ierți	Verb
sămânța	Noun
decizi	Verb
blestemul	Noun
iernaserăm	Verb
dizolvase	Verb
întării	Verb
iconoclastul	Noun
suflu	Verb
dezavantajasem	Verb
conjuncțiile	Noun
liniștisem	Verb
vaporului	Noun
cunoșteau	Verb
haitianului	Adjective
romancierii	Noun
domnule	Noun
tristeții	Noun
tăia	Verb
erecțiile	Noun
sacrul	Adjective
târgul	Noun
utilizau	Verb
luptei	Noun
răpunea	Verb
vizitaseră	Verb
săpau	Verb
încoronând	Converb
abcesele	Noun
imperialilor	Adjective
ultimii	Adjective
estimau	Verb
strângem	Verb
distanțele	Noun
toarserăți	Verb
distilării	Noun
castanului	Noun
cercetare	Noun
justiții	Noun
datorilor	Adjective
ieșiseră	Verb
medicamentul	Noun
mărturie	Noun
săriturii	Noun
vorbi	Verb
puțeați	Verb
lucra	Verb
răzleți	Verb
indiferentă	Adjective
ancorei	Noun
chinul	Noun
cartofii	Noun
amețeala	Noun
graurii	Noun
păstrăvul	Noun
bourii	Noun
stejarii	Noun
apărăm	Verb
pornografia	Noun
lotusul	Noun
șefii	Noun
aprinsa	Adjective
națională	Adjective
arsurile	Noun
moftule	Noun
respiri	Verb
zbârcii	Verb
îndrăgostise	Verb
forțau	Verb
japonezului	Adjective
ucenicului	Noun
defăimat	Participle
arzând	Converb
întunecase	Verb
bibanul	Noun
rusaliile	Noun
descrescut	Participle
hotarul	Noun
îngriji	Verb
manechinele	Noun
crescură	Verb
anul	Noun
dezdoirăm	Verb
bărbătosul	Adjective
scoteau	Verb
scăldaserăți	Verb
influență	Verb
graniță	Noun
suspina	Verb
bârlogului	Noun
înfruntasem	Verb
credeați	Verb
lungeați	Verb
ispiti	Verb
poală	Noun
așteptare	Noun
răzlețirăți	Verb
distracției	Noun
arogantul	Adjective
alungau	Verb
sarcasticului	Adjective
pugilistul	Noun
capitalistul	Adjective
pasăre	Noun
dărapeni	Verb
coreeanule	Adjective
acuzativul	Noun
țeseau	Verb
ghearele	Noun
aleii	Noun
îmbunătățirile	Noun
crezusem	Verb
plăti	Verb
recuperând	Converb
pompierului	Noun
australienii	Adjective
asemănarăți	Verb
puținilor	Adjective
respira	Verb
vorbim	Verb
violurile	Noun
românescul	Adjective
pasteurizat	Participle
oficiala	Adjective
credem	Verb
inflorescența	Noun
sănătoasa	Adjective
asemăna	Verb
ramurii	Noun
reușeați	Verb
comportat	Participle
sașiii	Adjective
laia	Adjective
viii	Adjective
îmbătrânim	Verb
crucificaseși	Verb
născut	Participle
cărticica	Noun
învinsa	Adjective
agresivelor	Adjective
bazând	Converb
afumat	Participle
adopta	Verb
rabinii	Noun
dezrobeați	Verb
oftaseră	Verb
dezamăgiserăm	Verb
concavității	Noun
mir	Verb
fântânile	Noun
văzut	Participle
înscrii	Verb
modificat	Participle
linilor	Adjective
opririle	Noun
fragedă	Adjective
minusculă	Adjective
neteziși	Verb
asimetriei	Noun
identitățile	Noun
estonienii	Adjective
borcanele	Noun
dintelui	Noun
iapa	Noun
stătuși	Verb
defaimele	Noun
sodomiții	Noun
acoperișului	Noun
melodiile	Noun
parazită	Noun
zahărului	Noun
dumici	Verb
observa	Verb
bananele	Noun
alcătuiserăți	Verb
dezamăgind	Converb
răposat	Participle
peticit	Participle
deșelaseră	Verb
citadelei	Noun
iluziile	Noun
fermierului	Noun
melodia	Noun
vânând	Converb
guvernat	Participle
dălții	Noun
misteriosului	Adjective
releului	Noun
ghețarii	Noun
botezăm	Verb
ridici	Verb
completei	Adjective
tiranul	Noun
întreținea	Verb
ținutelor	Adjective
fluierele	Noun
moștenea	Verb
plecăm	Verb
giacă	Noun
completului	Adjective
orașul	Noun
alungând	Converb
salt	Verb
pitoreasca	Adjective
simțeau	Verb
brebului	Noun
vizitau	Verb
măcelarule	Noun
hrănit	Participle
albastră	Adjective
zdrobea	Verb
desișul	Noun
nevestele	Noun
lichida	Adjective
biletului	Noun
oboiului	Noun
supravegheară	Verb
leneșul	Adjective
călcăm	Verb
apucat	Participle
lapte	Noun
aromânul	Adjective
prețuiau	Verb
insista	Verb
puterile	Noun
apărut	Participle
tresare	Verb
referendumului	Noun
româncele	Noun
folosirea	Noun
zidărie	Noun
donau	Verb
geaca	Noun
fereastra	Noun
prefixul	Noun
atenții	Adjective
aprinzând	Converb
epuizând	Converb
ținută	Adjective
fiți	Verb
scăldat	Participle
abandonase	Verb
drapelului	Noun
struțului	Noun
poporul	Noun
scăpase	Verb
viguroasa	Adjective
muzica	Noun
punctând	Converb
degetele	Noun
aplec	Verb
spumat	Participle
pinguinul	Noun
cinstind	Converb
pensula	Noun
nuda	Adjective
bârlogul	Noun
șomajului	Noun
respingerii	Noun
somat	Participle
număr	Verb
rodiile	Noun
chestiune	Noun
tinzi	Verb
ecosistemele	Noun
grăbiseși	Verb
prostului	Adjective
sărătură	Noun
alcătuit	Participle
balticii	Adjective
călugăriței	Noun
țările	Noun
destrama	Verb
răseserăm	Verb
tatuaserăți	Verb
eprubetele	Noun
perinealei	Adjective
urâm	Verb
căzutele	Adjective
araserăți	Verb
pianiștii	Noun
ascunseseși	Verb
monogamie	Noun
masculinele	Adjective
balenă	Noun
soliditatea	Noun
spuneau	Verb
păstrez	Verb
pici	Verb
întâmplași	Verb
cumplita	Adjective
risc	Verb
rezolvând	Converb
betonul	Noun
penisul	Noun
purtat	Participle
păstraseră	Verb
misterioasa	Adjective
distingeau	Verb
avantajele	Noun
amărăciunii	Noun
excelaserăm	Verb
imposibilității	Noun
binecuvântez	Verb
votcă	Noun
sfâșiaseși	Verb
slujbei	Noun
înfășurau	Verb
vorbele	Noun
oftic	Verb
fricile	Noun
obținerii	Noun
desculței	Adjective
bărbăție	Noun
pătezi	Verb
serioasa	Adjective
paiul	Noun
vădind	Converb
cercul	Noun
eliberaseși	Verb
rostit	Participle
țărmul	Noun
admir	Verb
fertilei	Adjective
acoperitul	Adjective
râs	Participle
bărbia	Noun
pitorescului	Adjective
măgăriei	Noun
hrăni	Verb
forțat	Participle
îndrăznești	Verb
căsnicie	Noun
întorsese	Verb
funcționarăți	Verb
plăceau	Verb
păianjenul	Noun
cumpliră	Verb
cules	Participle
decapitat	Participle
iernau	Verb
ofta	Verb
brazilianul	Adjective
anule	Noun
sorti	Verb
ciocnind	Converb
macacii	Noun
abrevierea	Noun
vizibila	Adjective
cimpanzeul	Noun
exterioara	Adjective
vacii	Noun
buzunarul	Noun
învecinau	Verb
tânjind	Converb
salariată	Adjective
lăsând	Converb
uscăciunii	Noun
odihnim	Verb
scurgeai	Verb
apleca	Verb
fundași	Verb
încântat	Participle
ulcerele	Noun
deșteptul	Adjective
bărbăției	Noun
scuipau	Verb
exagerez	Verb
testiculară	Adjective
portarii	Noun
aduseserăți	Verb
scurtei	Adjective
împrăștiat	Participle
germanul	Adjective
porțile	Noun
adormiților	Adjective
globului	Noun
străjerul	Noun
introduce	Verb
specificul	Adjective
vorbii	Verb
oii	Noun
popoul	Noun
eșecul	Noun
domnul	Noun
viermui	Verb
obraznică	Adjective
rupta	Adjective
lățeau	Verb
doinei	Noun
asurzind	Converb
rasele	Adjective
muiere	Noun
prelungeau	Verb
îndemn	Verb
nutrețul	Noun
plânsului	Adjective
căsătorit	Participle
scormonind	Converb
asigur	Verb
poruncit	Participle
sodomitului	Noun
obligăm	Verb
distrând	Converb
întrevede	Verb
apropiind	Converb
deșteptarea	Noun
așternuși	Verb
drogul	Noun
îngâmfat	Participle
ciorii	Noun
muls	Participle
împodobit	Participle
ascultase	Verb
luminii	Noun
estimară	Verb
plații	Adjective
pubertății	Noun
mănușile	Noun
cana	Noun
fugit	Participle
eleva	Noun
lansat	Participle
salivă	Noun
țiteră	Noun
lanternele	Noun
introduceau	Verb
salamul	Noun
lemnarule	Noun
înnorași	Verb
desfășurarăm	Verb
șomajul	Noun
împovărat	Participle
ageră	Adjective
tăbăcit	Participle
călătorul	Adjective
maimuță	Noun
studentei	Noun
consoanei	Noun
impuneai	Verb
studiase	Verb
fuseseră	Verb
anusul	Noun
implic	Verb
analei	Adjective
mângâiat	Participle
șopârlei	Noun
pedepsiseră	Verb
despica	Verb
învechitele	Adjective
trimise	Verb
întreținuse	Verb
învolburași	Verb
enormă	Adjective
înmulțeau	Verb
ospătarul	Noun
interferențele	Noun
integrabilă	Adjective
făgăduind	Converb
tutunul	Noun
conveni	Verb
suferinței	Noun
amintiseși	Verb
mărunțiserăm	Verb
înconjurat	Participle
insistăm	Verb
arunc	Verb
capitala	Noun
socrul	Noun
rugina	Noun
focă	Noun
traducerea	Noun
analogii	Adjective
agățată	Adjective
pubertate	Noun
judecata	Adjective
recunoștinței	Noun
singurei	Adjective
lipiciul	Noun
ciocneau	Verb
cartei	Noun
răsuflat	Participle
arând	Converb
rămâneai	Verb
stimulat	Participle
fierbea	Verb
bărbieri	Verb
grecescul	Adjective
dezvoltata	Adjective
socului	Noun
mândrit	Participle
buburuza	Noun
înflorea	Verb
răsfățând	Converb
dorință	Noun
intui	Verb
fixau	Verb
brânzeturilor	Noun
podișul	Noun
pensulele	Noun
dublele	Adjective
țigăniră	Verb
primului	Adjective
cobaiul	Noun
cocea	Verb
credeai	Verb
muribundul	Adjective
trânteai	Verb
măslinele	Noun
pescărușului	Noun
traversau	Verb
săgetarăți	Verb
curse	Verb
legase	Verb
chemase	Verb
raritate	Noun
elefanții	Noun
convenea	Verb
creștinul	Adjective
examenului	Noun
Rusaliile	Noun
irităm	Verb
muntelui	Noun
stabilitatea	Noun
cățeaua	Noun
trezi	Verb
dezice	Verb
stindardul	Noun
folosești	Verb
mirosise	Verb
linii	Adjective
insistase	Verb
adoptăm	Verb
fantezia	Noun
râseră	Verb
izolată	Adjective
narcoticele	Adjective
linguriță	Noun
ologilor	Adjective
maioneză	Noun
lepăda	Verb
ferea	Verb
analogică	Adjective
încurci	Verb
bulgărească	Adjective
îmbrățișase	Verb
tații	Noun
simplă	Adjective
îndeletnicea	Verb
acoperise	Verb
surprizei	Noun
leșina	Verb
gâdilași	Verb
dulapului	Noun
oile	Noun
circumcizând	Converb
tăiau	Verb
credincioșilor	Adjective
masculule	Adjective
carnivorelor	Adjective
așteptase	Verb
ironiei	Noun
dozarea	Noun
răstigniși	Verb
tiveai	Verb
greul	Adjective
alergând	Converb
încarci	Verb
ciugulirăm	Verb
iubirii	Noun
abație	Noun
albii	Adjective
elibera	Verb
acuzase	Verb
vorbeați	Verb
orzului	Noun
încercaseră	Verb
rozele	Noun
timida	Adjective
murmurarăți	Verb
compuse	Verb
orbind	Converb
tivit	Participle
contribuție	Noun
inserției	Noun
parcat	Participle
piersici	Verb
repezit	Participle
riscăm	Verb
interferență	Noun
ciudatele	Adjective
releule	Noun
minoritatea	Noun
omnipotența	Noun
accidentală	Adjective
analizatorul	Noun
calculată	Adjective
caprele	Noun
afinitățile	Noun
risca	Verb
angajau	Verb
țintisem	Verb
pierzi	Verb
convenind	Converb
asprimea	Noun
aflau	Verb
bijuterie	Noun
despădurire	Noun
avansa	Verb
așteptările	Noun
clătești	Verb
îngropat	Participle
biomasă	Noun
înălțimile	Noun
alianței	Noun
oxizii	Noun
masculinul	Adjective
gătit	Participle
extinseși	Verb
simbolizarăți	Verb
violoncelul	Noun
virilă	Adjective
apăreau	Verb
săracul	Adjective
refuzând	Converb
asigurând	Converb
producea	Verb
remușcare	Noun
căcații	Noun
violoncelului	Noun
semnezi	Verb
submarinului	Adjective
închizând	Converb
echilibrat	Participle
coraslei	Noun
nerecunoscută	Adjective
maestrului	Noun
încheieturile	Noun
brânzei	Noun
ierboasa	Adjective
rugau	Verb
spovedit	Participle
trecui	Verb
evlaviei	Noun
carta	Noun
completau	Verb
aeraseși	Verb
abandonăm	Verb
deprinsesem	Verb
stilurile	Noun
masivă	Adjective
alcătuia	Verb
mișcând	Converb
înzestrat	Participle
dezrădăcinat	Participle
palmierii	Noun
porumbelul	Noun
vărsară	Verb
înfruntat	Participle
pragului	Noun
introducem	Verb
locuim	Verb
medicine	Noun
sticletele	Noun
colegii	Noun
asemănau	Verb
greceasca	Adjective
exteriorului	Adjective
răzgândi	Verb
vărsase	Verb
trimitem	Verb
cafelei	Noun
gloanțele	Noun
treierând	Converb
trăncăneau	Verb
capitalistă	Adjective
cercetările	Noun
credinciosul	Adjective
britanicul	Adjective
robului	Noun
motorul	Noun
cronologiile	Noun
refuzi	Verb
înălțimii	Noun
scămosului	Adjective
presupuneai	Verb
apropiase	Verb
genele	Noun
creierului	Noun
serioasă	Adjective
încăpu	Verb
bancnotele	Noun
arădusei	Verb
salariații	Adjective
schimbului	Noun
terminase	Verb
împădurit	Participle
lățime	Noun
căpătaserăm	Verb
copleșirăți	Verb
ieșirea	Noun
încercat	Participle
clădirile	Noun
saluta	Verb
discutăm	Verb
chinurile	Noun
molia	Noun
urcau	Verb
mândrești	Verb
încălțămintea	Noun
limpeziră	Verb
pierduseră	Verb
supele	Noun
rostogoleau	Verb
capitaliștii	Adjective
suci	Verb
atenților	Adjective
rătăciseși	Verb
acantă	Noun
trandafirului	Noun
îmbunezi	Verb
rosul	Adjective
inflorescențele	Noun
examenele	Noun
cuprinserăți	Verb
satisfăcea	Verb
lovise	Verb
injectasem	Verb
geamurile	Noun
așteptă	Verb
stăpâniseră	Verb
împăturim	Verb
cântând	Converb
imitarea	Noun
civiiză	Verb
adorau	Verb
geologii	Noun
pometului	Noun
adjectivul	Noun
puritate	Noun
arhipelagului	Noun
științele	Noun
înșela	Verb
rănit	Participle
cinei	Noun
atingând	Converb
slavă	Adjective
purtarea	Noun
străpunse	Verb
croitorului	Noun
cucul	Noun
pietății	Noun
biofizica	Noun
brazilienii	Adjective
alese	Verb
șezând	Converb
răpunând	Converb
desfășa	Verb
cântăriseși	Verb
nașterea	Noun
sinucidem	Verb
informatici	Noun
ornitorincul	Noun
adaug	Verb
futabilele	Adjective
existând	Converb
mușuroiului	Noun
anulez	Verb
faină	Adjective
bucurarăți	Verb
întreb	Verb
încrederea	Noun
narcotizaserăți	Verb
oftez	Verb
stătu	Verb
țepenii	Adjective
granițele	Noun
pricepem	Verb
aleile	Noun
jignești	Verb
răspândea	Verb
slugărești	Verb
ușuratică	Adjective
felinele	Noun
ilegala	Adjective
cântau	Verb
clarificăm	Verb
găinii	Noun
zgomotoasă	Adjective
clocotești	Verb
șirul	Noun
jugarul	Adjective
slaba	Adjective
strici	Verb
colaboratorii	Adjective
alungat	Participle
cumpăra	Verb
tehnologică	Adjective
fumau	Verb
trombonul	Noun
americanul	Adjective
locuit	Participle
acronimul	Noun
cuviosului	Adjective
lovim	Verb
haiducul	Noun
transbordării	Noun
popularului	Adjective
alergaserăți	Verb
scrierii	Noun
ambianța	Noun
împlântară	Verb
femeia	Noun
nebunii	Verb
blondă	Adjective
servise	Verb
dinozaurii	Noun
majoritatea	Noun
amabilă	Adjective
supraviețuit	Participle
viețile	Noun
șoaptele	Noun
prezentului	Adjective
găteai	Verb
neprietenoasă	Adjective
mături	Verb
dezmințind	Converb
susținut	Participle
gazelei	Noun
ușa	Noun
scăpătaserăți	Verb
zăpăcirăm	Verb
arat	Participle
dicționarului	Noun
microbiologicele	Adjective
plictiseala	Noun
înjura	Verb
bravii	Adjective
bănuit	Participle
spulberând	Converb
decise	Verb
accidentalilor	Adjective
cerbul	Noun
șaua	Noun
terminațiile	Noun
letonilor	Adjective
zăpezii	Noun
eliminase	Verb
trecut	Participle
umilirăm	Verb
câmpiile	Noun
sfătuind	Converb
uni	Verb
netezești	Verb
salva	Verb
comunici	Verb
leacului	Noun
întrezărisem	Verb
porumbeii	Noun
definiției	Noun
distrăm	Verb
sănătoasă	Adjective
jocului	Noun
muzicile	Noun
oneștilor	Adjective
fertililor	Adjective
fluierul	Noun
răsunând	Converb
plăcu	Verb
turcii	Noun
lucrezi	Verb
răsunară	Verb
tocăm	Verb
șovăit	Participle
apucasem	Verb
românca	Noun
jachetă	Noun
mutase	Verb
stânjeni	Verb
activat	Participle
secretariatul	Noun
macroul	Noun
franțuzescul	Adjective
cășunarăți	Verb
luând	Converb
întreținut	Participle
apucase	Verb
cutremurași	Verb
făgăduise	Verb
cumplirăți	Verb
apăra	Verb
venerația	Noun
avortat	Participle
platul	Adjective
nemilosul	Adjective
gramatica	Noun
vână	Verb
familiei	Noun
îngrămădi	Verb
numărat	Participle
returnară	Verb
adevăratul	Adjective
plantau	Verb
emoțiile	Noun
săgeții	Noun
prospătaserăm	Verb
viețuiau	Verb
căscaseră	Verb
externelor	Adjective
prepuțul	Noun
vaccinaserăți	Verb
cumnata	Noun
agrișele	Noun
găină	Noun
conversațiile	Noun
uciderile	Noun
vândut	Participle
ațâțaseră	Verb
tânărului	Adjective
deschise	Verb
înspăimântat	Participle
pornind	Converb
ferocitatea	Noun
specialitatea	Noun
așteptaseră	Verb
mamutul	Noun
farul	Noun
resursele	Noun
gătea	Verb
fotbalistul	Noun
descrescuserăți	Verb
gătind	Converb
repauzaseși	Verb
gena	Noun
cari	Verb
rostului	Noun
apucau	Verb
desface	Verb
înrămarăți	Verb
ferici	Verb
invariabilă	Adjective
colaboratorul	Adjective
democratica	Adjective
datorat	Participle
ascunsă	Adjective
contrazicea	Verb
cocorii	Noun
chibritul	Noun
stupidul	Adjective
zarei	Noun
pețeau	Verb
ațâța	Verb
exageratelor	Adjective
ridichea	Noun
lucit	Participle
bulbucaserăți	Verb
urai	Verb
circumscris	Participle
caviarul	Noun
apărau	Verb
lamura	Noun
tindeau	Verb
vorbeai	Verb
autorul	Noun
măicuțele	Noun
amenințase	Verb
pasteuriză	Verb
uneltei	Noun
dregea	Verb
însoțea	Verb
neutrilor	Adjective
pizdarul	Noun
alergia	Noun
abandonași	Verb
nenorociși	Verb
ghiciși	Verb
crudă	Adjective
adunării	Noun
anulăm	Verb
comandarăți	Verb
adverbului	Noun
carpelele	Noun
asculta	Verb
generației	Noun
aplici	Verb
subteranul	Adjective
culeserăm	Verb
defileul	Noun
oștii	Noun
îmbinând	Converb
iertatei	Adjective
întrerupt	Participle
folositorului	Adjective
drogurile	Noun
rotunda	Adjective
dragă	Adjective
fierăstrui	Verb
dispăru	Verb
nudismul	Noun
roată	Noun
cărat	Participle
invincibila	Adjective
schimbase	Verb
comport	Verb
rupând	Converb
prunele	Noun
devierile	Noun
mahalalele	Noun
înfunda	Verb
cuptoarele	Noun
ocupat	Participle
înghițiseși	Verb
prevestești	Verb
retezând	Converb
pricepeau	Verb
greșisem	Verb
spinul	Noun
oxidul	Noun
zare	Noun
mlaștinile	Noun
șobolanului	Noun
admirau	Verb
afinității	Noun
trufia	Noun
pătura	Noun
crește	Verb
asigurau	Verb
inviți	Verb
inexprimabilului	Adjective
bulucea	Verb
jucă	Verb
rătăcirăți	Verb
ștersesem	Verb
mărturiei	Noun
învinselor	Adjective
pierdea	Verb
mânăstirile	Noun
ciocănitorile	Noun
substanțele	Noun
pașapoartele	Noun
aparul	Noun
obiectului	Noun
prăbușise	Verb
găsești	Verb
înțelegea	Verb
oxidului	Noun
fripseserăți	Verb
ocupaseră	Verb
statisticilor	Adjective
vedem	Verb
aberantă	Adjective
prunului	Noun
ecologiei	Noun
strânse	Verb
împăună	Verb
îmblânzind	Converb
argintie	Adjective
pumă	Noun
lucii	Verb
vizita	Verb
problemei	Noun
stricată	Adjective
iei	Verb
dezrobiserăți	Verb
perișoara	Noun
excelase	Verb
mente	Noun
înserare	Noun
vâscoșilor	Adjective
încăperea	Noun
biograful	Noun
forța	Verb
protejau	Verb
superi	Verb
forjăm	Verb
încăperile	Noun
greață	Noun
înveninase	Verb
animația	Noun
felina	Noun
timonierului	Noun
scormoniseră	Verb
scăzuseră	Verb
profunda	Adjective
corbul	Noun
vîntul	Noun
cucumărule	Noun
înlăturarăți	Verb
roțile	Noun
scurse	Verb
scăzut	Participle
lămpile	Noun
bancnota	Noun
insult	Verb
urmăririi	Noun
neteda	Adjective
amenințările	Noun
dansa	Verb
obrăznicia	Noun
îndepărtând	Converb
spatelui	Noun
specifică	Adjective
părintească	Adjective
vitrinele	Noun
anterele	Noun
norocoasa	Adjective
masculinii	Adjective
cuiburile	Noun
moașei	Noun
existau	Verb
riscurile	Noun
culese	Verb
tăcea	Verb
siberienii	Adjective
japonezul	Adjective
rescris	Participle
neghină	Noun
necesitate	Noun
arbore	Noun
dansul	Noun
zise	Verb
muzicalul	Adjective
încântăm	Verb
trecuseră	Verb
numise	Verb
lucrat	Participle
descrierile	Noun
supărase	Verb
divorțăm	Verb
închinând	Converb
excursioniștii	Noun
construind	Converb
olarului	Noun
strig	Verb
tulburat	Participle
infinitate	Noun
secreții	Adjective
îngrămădit	Participle
înjosi	Verb
urmară	Verb
cariopsă	Noun
copleșea	Verb
accelera	Verb
fixarăți	Verb
împrejmuit	Participle
elevii	Noun
menținu	Verb
scurmară	Verb
mișunaserăți	Verb
afâna	Verb
tocând	Converb
producerea	Noun
încercasem	Verb
potcoavei	Noun
amfibienii	Noun
delimitau	Verb
vecinei	Noun
poștei	Noun
orhideele	Noun
strigoiului	Noun
previne	Verb
electromagneticului	Adjective
epocă	Noun
venerica	Adjective
separa	Verb
usturoii	Noun
angelica	Noun
valorile	Noun
vrabia	Noun
secul	Adjective
diminuau	Verb
metrul	Noun
mărețului	Adjective
atingi	Verb
început	Participle
luase	Verb
vesela	Adjective
societate	Noun
ridicații	Adjective
înlesneați	Verb
conjugare	Noun
șoricelul	Noun
retraserăți	Verb
fractura	Verb
încăriserăm	Verb
geamănul	Adjective
mielului	Noun
cauți	Verb
dușmănii	Verb
cununi	Verb
ascultat	Participle
mâhnit	Participle
ofensatorului	Adjective
locuință	Noun
asudarăți	Verb
comportând	Converb
retrase	Verb
întrevăzură	Verb
turnat	Participle
necinstită	Adjective
împovăraserăți	Verb
estimând	Converb
gimnastul	Noun
protocolului	Noun
florarii	Noun
armăsarului	Noun
penisului	Noun
iubirile	Noun
jalnica	Adjective
violul	Noun
răstignit	Participle
tigrii	Noun
încălță	Verb
marinele	Adjective
șesele	Adjective
desprinzând	Converb
majoratul	Noun
încărca	Verb
pregătești	Verb
avântat	Participle
întrerupseserăm	Verb
amintești	Verb
parca	Verb
mura	Verb
roti	Verb
viețuit	Participle
slăbire	Noun
sonetului	Noun
mililitrul	Noun
măselele	Noun
amețiseră	Verb
sălbaticul	Adjective
leșin	Verb
crapului	Noun
conceptului	Noun
înfiripaaserăm	Verb
declinările	Noun
terapiile	Noun
impuseră	Verb
inbusule	Noun
junia	Noun
discretă	Adjective
mormolocii	Noun
bei	Verb
bestialii	Adjective
sculptorii	Noun
asemănat	Participle
cerere	Noun
perfectă	Adjective
decenței	Noun
convins	Participle
autoritatea	Noun
gheara	Noun
căpățânoasei	Adjective
îngrozitoarea	Adjective
căzuseră	Verb
gospodina	Noun
gândim	Verb
tulbura	Verb
răcelii	Noun
lămuri	Verb
atrofii	Noun
benzinăriei	Noun
înfumurasem	Verb
ospătau	Verb
masculină	Adjective
hrănind	Converb
băgăm	Verb
micul	Adjective
asistenții	Noun
cugetaserăți	Verb
speranța	Noun
măsurăm	Verb
lucrătorului	Adjective
bucurăm	Verb
bălțații	Adjective
pietatea	Noun
aruncarea	Noun
dacule	Adjective
revistă	Noun
cinând	Converb
imaginasem	Verb
dramaticul	Adjective
isprăveați	Verb
obrazului	Noun
mijlocise	Verb
eronată	Adjective
găsind	Converb
umărul	Noun
regatele	Noun
conteneați	Verb
rezemă	Verb
semnului	Noun
urând	Converb
gătii	Verb
grădinile	Noun
încălțat	Participle
tinsese	Verb
prefixele	Noun
mangusta	Noun
toxicelor	Adjective
plajele	Noun
știucii	Noun
păru	Verb
amorurile	Noun
declarând	Converb
șezut	Participle
pătrunjelul	Noun
japonezii	Adjective
plec	Verb
brunei	Adjective
purtăm	Verb
tărăgăna	Verb
murea	Verb
onirică	Adjective
înghețând	Converb
gravita	Verb
ridic	Verb
aiorul	Noun
pap	Verb
săptămîna	Noun
preistoricilor	Adjective
galaxia	Noun
susținurăm	Verb
omori	Verb
proporționalul	Adjective
umili	Verb
discreția	Noun
așternui	Verb
existăm	Verb
alunelul	Noun
sfâșiat	Participle
acuzi	Verb
ieșim	Verb
tun	Verb
cămășii	Noun
eligibilitatea	Noun
subteranei	Adjective
engleze	Noun
mistificat	Participle
fluierului	Noun
grației	Noun
înmulțind	Converb
separând	Converb
păsării	Noun
amestecăm	Verb
desziceau	Verb
structurală	Adjective
păroasa	Adjective
rărunchii	Noun
căutaserăm	Verb
furaseră	Verb
înserau	Verb
vechimea	Noun
inunda	Verb
sfătuiau	Verb
înlesnea	Verb
înscrisese	Verb
bazase	Verb
simetria	Noun
lânarii	Noun
molie	Noun
ațipiserăm	Verb
locurile	Noun
avântau	Verb
perturbatoarele	Adjective
dedat	Participle
furiosul	Adjective
contravenea	Verb
sinagoga	Noun
plutind	Converb
traduceau	Verb
riști	Verb
aplicau	Verb
pilotând	Converb
prinsul	Adjective
înecat	Participle
achena	Noun
documentarăți	Verb
rusa	Noun
rulat	Participle
reluaseși	Verb
zemosului	Adjective
bibanule	Noun
eligibilității	Noun
câștiga	Verb
secundară	Adjective
alama	Noun
plăcerea	Noun
maimuța	Noun
azotoșii	Adjective
urii	Noun
terminației	Noun
hotărî	Verb
modifici	Verb
insultând	Converb
creștinătatea	Noun
înțelepții	Adjective
discursurile	Noun
mânecăm	Verb
pliviși	Verb
răpești	Verb
vitregii	Adjective
stropii	Verb
dedăm	Verb
harpă	Noun
orbea	Verb
costumului	Noun
uităm	Verb
vitrină	Noun
adormiră	Verb
placenta	Noun
utilizat	Participle
augurase	Verb
unsoarea	Noun
universitățile	Noun
pătlagină	Noun
aleatorie	Adjective
anglicana	Adjective
ustensilă	Noun
amiciție	Noun
dezvolți	Verb
culesesem	Verb
aspra	Adjective
colaboratorului	Adjective
renovași	Verb
parcasem	Verb
aprinseră	Verb
pictau	Verb
steaua	Noun
arsură	Noun
anterioară	Adjective
adăugaseră	Verb
puciului	Noun
picase	Verb
descurci	Verb
spiritul	Noun
râvniserăți	Verb
napului	Noun
cârnații	Noun
genei	Noun
haoticului	Adjective
otrăvirăți	Verb
bănuiseră	Verb
rândunicile	Noun
eliberăm	Verb
spuseserăți	Verb
împărțise	Verb
așezase	Verb
legătură	Noun
demnă	Adjective
zbătea	Verb
delicații	Adjective
robit	Participle
județului	Noun
făinosul	Adjective
păcălise	Verb
preferase	Verb
psihiatrii	Noun
amenințării	Noun
stabileau	Verb
zbârcisem	Verb
despărțeau	Verb
fierăria	Noun
fasolea	Noun
reluarăm	Verb
pricepură	Verb
istoricilor	Adjective
relele	Adjective
slăvit	Participle
adăparăți	Verb
tehnicianului	Noun
căpușei	Noun
boala	Noun
spulbera	Verb
abdicau	Verb
vigilență	Noun
încălzi	Verb
vânat	Participle
discutase	Verb
părură	Verb
înfrățit	Participle
munca	Noun
disecat	Participle
tăcerile	Noun
păzim	Verb
zirconul	Noun
perindaserăți	Verb
rechinul	Noun
întâmpinat	Participle
gospodarelor	Adjective
pluralitatea	Noun
turna	Verb
pripit	Participle
înjosiră	Verb
murind	Converb
frământarea	Noun
trimitea	Verb
salamurile	Noun
supremul	Adjective
aerând	Converb
alămurile	Noun
pozițiile	Noun
dezgustul	Noun
naționalilor	Adjective
tânjise	Verb
îngerească	Adjective
ventilatorul	Noun
rasul	Adjective
vie	Adjective
exagerată	Adjective
albicioasei	Adjective
vegetarianismul	Noun
dezarmarea	Noun
albaneză	Adjective
șacalul	Noun
împuns	Participle
creșteau	Verb
obosiră	Verb
ucizi	Verb
trimițând	Converb
invadat	Participle
masturbaseră	Verb
mers	Participle
luptat	Participle
slutului	Adjective
guvernul	Noun
văduvit	Participle
aligatorii	Noun
lipsi	Verb
avantajului	Noun
întunecat	Participle
dogmaticilor	Adjective
țitera	Noun
uciderii	Noun
ușile	Noun
onorurile	Noun
bând	Converb
scormonit	Participle
speranțele	Noun
coniacului	Noun
valoare	Noun
țăranul	Noun
mlaștinii	Noun
înscria	Verb
odihneau	Verb
stăruind	Converb
reziști	Verb
lungă	Adjective
scânteiarăm	Verb
tatuajul	Noun
stânjenit	Participle
staulule	Noun
sura	Adjective
umblau	Verb
zdrobeau	Verb
cuveni	Verb
stadionului	Noun
renova	Verb
lanțurile	Noun
botanicii	Adjective
insurmontabilul	Adjective
mlaștină	Noun
basmaua	Noun
închin	Verb
studentele	Noun
ilegalului	Adjective
enormele	Adjective
urmașului	Noun
speli	Verb
anonima	Noun
capitalei	Noun
emoție	Noun
obrajii	Noun
măritau	Verb
borați	Verb
alergie	Noun
călcâiului	Noun
bibliotecă	Noun
sapi	Verb
dimensionarea	Noun
scremeai	Verb
putrezit	Participle
sântului	Adjective
colțunule	Noun
stolul	Noun
măslinul	Noun
deveniseși	Verb
economie	Noun
sufocaserăți	Verb
potabilă	Adjective
porni	Verb
tunetele	Noun
bucă	Noun
trăgănasem	Verb
curăturii	Noun
trompetă	Noun
dovedind	Converb
certi	Verb
combinând	Converb
găinușei	Noun
șevaletului	Noun
doriserăți	Verb
dezvoltând	Converb
interzicem	Verb
inteligenții	Adjective
sărut	Verb
verbul	Noun
desfășura	Verb
pastorului	Noun
ecranului	Noun
interesanta	Adjective
cotea	Verb
pieptănat	Participle
consoana	Noun
vecină	Noun
molidului	Noun
lalea	Noun
însărcinase	Verb
frecat	Participle
liliacul	Noun
preget	Verb
zahărul	Noun
cucerii	Verb
citisem	Verb
urzim	Verb
ridicăm	Verb
repezim	Verb
mișcare	Noun
sumeteau	Verb
foloseau	Verb
obligi	Verb
sodomie	Noun
acvilele	Noun
încălțaseși	Verb
bivolului	Noun
exotică	Adjective
înfăptuit	Participle
absorbită	Adjective
simțise	Verb
vulpe	Noun
făgetului	Noun
reluau	Verb
orientă	Verb
bătuseră	Verb
supăra	Verb
spuseră	Verb
imaginând	Converb
atragi	Verb
populară	Adjective
intuit	Participle
învelișului	Noun
castanul	Noun
ouăle	Noun
slavului	Adjective
maimuței	Noun
răsunaseși	Verb
aduceau	Verb
prioritățile	Noun
anteriorii	Adjective
orizontul	Noun
căsnicia	Noun
dreseseră	Verb
vizualizez	Verb
bârfiseră	Verb
cuget	Verb
bagi	Verb
crocodilul	Noun
continua	Adjective
înfumură	Verb
ofticăm	Verb
oxidule	Noun
adăugăm	Verb
completul	Adjective
expozițiile	Noun
doamnei	Noun
capătul	Noun
moșiile	Noun
buză	Noun
salvat	Participle
arselor	Adjective
prepoziției	Noun
împrejmuirăți	Verb
instanta	Adjective
tâmpenie	Noun
zestrea	Noun
spartă	Adjective
adâncul	Adjective
imprecație	Noun
mamele	Noun
măiestrei	Adjective
străbătuse	Verb
transpirat	Participle
propunere	Noun
smaraldului	Noun
vulpoaicei	Noun
solvabilitatea	Noun
tamburinei	Noun
dobândiseră	Verb
petală	Noun
sprânceană	Noun
clădeați	Verb
descria	Verb
posedării	Noun
gustând	Converb
cutezași	Verb
intenționase	Verb
fraga	Noun
forțaseră	Verb
expediez	Verb
cenușa	Noun
capsulase	Verb
tăiaseră	Verb
discursul	Noun
topit	Participle
filantropia	Noun
analogicului	Adjective
subțiase	Verb
dormitorului	Noun
plângi	Verb
mașinile	Noun
numind	Converb
scuiparăm	Verb
petrecuse	Verb
pasași	Verb
daunei	Noun
ascunșilor	Adjective
goliserăți	Verb
delictele	Noun
strănutaserăm	Verb
dezbinat	Participle
paradoxul	Noun
pregetaserăți	Verb
suferința	Noun
absorbind	Converb
polarei	Adjective
rostogolim	Verb
sufocând	Converb
adeverit	Participle
adunarea	Noun
terminat	Participle
apărătorii	Noun
excelând	Converb
budismul	Noun
ceții	Noun
haosului	Noun
muzicală	Adjective
ghiceai	Verb
întărâtat	Participle
îngustat	Participle
rămânând	Converb
tinzând	Converb
dopul	Noun
peninsula	Noun
orientat	Participle
răpit	Participle
mistreții	Adjective
miroseau	Verb
îndemna	Verb
lichidelor	Adjective
enigmaticului	Adjective
mobilului	Adjective
anonimii	Adjective
încrucișarăți	Verb
blestemară	Verb
declarau	Verb
ulmului	Noun
ciupercile	Noun
aerat	Participle
înveninez	Verb
vorbise	Verb
invizibilității	Noun
puțină	Adjective
antimateria	Noun
fugii	Verb
bilingvismul	Noun
zbârcea	Verb
tipăreau	Verb
frustrările	Noun
dogmaticii	Adjective
bluză	Noun
biologia	Noun
agricultorului	Noun
fluturi	Verb
atacaseră	Verb
rațele	Noun
laba	Noun
schizofreniei	Noun
întâlneați	Verb
metrului	Noun
prânzul	Noun
atârnase	Verb
înlocuise	Verb
puncta	Verb
culci	Verb
semivocalei	Noun
curcubetei	Noun
reveriile	Noun
activez	Verb
cutreierau	Verb
încumet	Verb
rosturile	Noun
visare	Noun
propus	Participle
numim	Verb
blândul	Adjective
sunetului	Noun
vărul	Noun
ciocârliile	Noun
asurziserăm	Verb
sângerând	Converb
devenim	Verb
păzea	Verb
distilă	Verb
popularității	Noun
cutiile	Noun
azurului	Noun
vegheat	Participle
iobagii	Noun
profesorii	Noun
dușmăniei	Noun
pilotat	Participle
portocală	Noun
pluralității	Noun
butonului	Noun
toca	Verb
doină	Noun
instantul	Adjective
slabului	Adjective
povârni	Verb
rătăci	Verb
tăietură	Noun
strigoiul	Noun
bulbuci	Verb
spinoasa	Adjective
orfanii	Adjective
bănuiau	Verb
ciclistă	Adjective
sculat	Participle
chemare	Noun
lebedei	Noun
intrat	Participle
încăpere	Noun
glicina	Noun
arătând	Converb
frecase	Verb
ciurului	Noun
amărăciune	Noun
scoțând	Converb
latina	Noun
apăsăm	Verb
udau	Verb
plantat	Participle
umblu	Verb
luminoasele	Adjective
internațională	Adjective
returna	Verb
evoluțiile	Noun
steagul	Noun
stâlpii	Noun
vânzătoarea	Noun
Bucovina	Noun
nimerirăm	Verb
renumele	Noun
cleștele	Noun
pubertatea	Noun
discreției	Noun
potrivea	Verb
înzestra	Verb
extindem	Verb
etate	Noun
munci	Verb
merinde	Noun
adunat	Participle
viitorul	Adjective
marourile	Adjective
făcură	Verb
anarhiei	Noun
strămuta	Verb
mustrând	Converb
poziției	Noun
intempestivelor	Adjective
stăpânit	Participle
versatilă	Adjective
cicloida	Noun
imaginez	Verb
pup	Verb
lăudaseră	Verb
neutrelor	Adjective
aprigele	Adjective
săpa	Verb
anticipările	Noun
onoraserăți	Verb
stăruiau	Verb
economia	Noun
acvatică	Adjective
femininului	Adjective
întâmpinase	Verb
belșugul	Noun
copiași	Verb
melcul	Noun
izolata	Adjective
târziul	Adjective
mărețele	Adjective
întreprins	Participle
cantalupul	Noun
bloca	Verb
împărțind	Converb
căuta	Verb
sodomiei	Noun
sluților	Adjective
dinamicul	Adjective
elevă	Noun
guvernare	Noun
jenat	Participle
forjat	Participle
descurcăm	Verb
școlii	Noun
blocau	Verb
împărătesei	Noun
groșii	Adjective
tristețe	Noun
cavernă	Noun
rănești	Verb
instantele	Adjective
gratitudine	Noun
elevei	Noun
încheiase	Verb
săratei	Adjective
despărți	Verb
urați	Verb
bicicletei	Noun
bărbie	Noun
suflecat	Participle
prindem	Verb
exportatorii	Noun
vamalul	Adjective
dumnezeiescului	Adjective
heterosexualii	Adjective
umplem	Verb
invit	Verb
oprirea	Noun
jena	Verb
geneticei	Adjective
baltică	Adjective
daună	Noun
zăpăci	Verb
înnodat	Participle
gândind	Converb
servind	Converb
ascultăm	Verb
busolei	Noun
neghina	Noun
observăm	Verb
zbatem	Verb
accelerat	Participle
înghețata	Adjective
pătarăm	Verb
copacul	Noun
revistei	Noun
pictatul	Adjective
promisiunile	Noun
gândeau	Verb
împăduriserăm	Verb
naivilor	Adjective
ținem	Verb
viul	Adjective
datorăm	Verb
necontestată	Adjective
interveniseră	Verb
atotputernicia	Noun
săruta	Verb
primele	Adjective
subțirele	Adjective
străbătând	Converb
începuse	Verb
rutei	Noun
papi	Verb
căutare	Noun
stâlpul	Noun
spânzurat	Participle
supremației	Noun
mas	Participle
răsăritul	Noun
noul	Adjective
alegea	Verb
rezistaseră	Verb
dezgustătoarea	Adjective
modificase	Verb
învățăm	Verb
îndrăznea	Verb
pornise	Verb
alfabetul	Noun
curățau	Verb
integralei	Adjective
vadul	Noun
placentă	Noun
portarul	Noun
înverșunez	Verb
meritaseși	Verb
delogând	Converb
supraveghind	Converb
bășind	Converb
saluți	Verb
nimerisem	Verb
împrumutat	Participle
experimentată	Adjective
moftului	Noun
zmeurul	Noun
șușuim	Verb
cronicilor	Adjective
cutremurele	Noun
sacoșele	Noun
măslină	Noun
pădurarule	Noun
nădăjduim	Verb
ciugulirăți	Verb
lipiserăm	Verb
tiranii	Noun
tors	Participle
bourul	Noun
răci	Verb
discut	Verb
încărunțeai	Verb
ninsoarea	Noun
mesteca	Verb
arnica	Noun
foioaselor	Adjective
căutarea	Noun
asimila	Verb
literei	Noun
pătrarul	Noun
jupuiai	Verb
îngerul	Noun
învățase	Verb
anterioarele	Adjective
ruse	Noun
nebuni	Verb
nenorocitule	Adjective
înfuria	Verb
desfeți	Verb
creștinătății	Noun
scăpătară	Verb
cantinierul	Noun
deprinsei	Verb
castravete	Noun
pocnești	Verb
românul	Adjective
căsătorești	Verb
extinzi	Verb
budismului	Noun
îmbrățișaseră	Verb
vorbărețului	Adjective
cireșul	Noun
menții	Verb
analogiile	Noun
poruncii	Verb
atacau	Verb
amestecată	Adjective
mustrare	Noun
supuseseră	Verb
automobilului	Noun
cântărețul	Noun
zgâriat	Participle
caldă	Adjective
sufleteasca	Adjective
binefăcătorul	Adjective
imperialismului	Noun
tricoului	Noun
zici	Verb
nașterile	Noun
calamarule	Noun
răcneai	Verb
auzim	Verb
plata	Adjective
accelerând	Converb
victorie	Noun
rămânea	Verb
amărăști	Verb
mustul	Noun
șansei	Noun
cicada	Noun
magazinerii	Noun
gândi	Verb
articula	Verb
omorurile	Noun
ispitit	Participle
fărâmaserăți	Verb
eliberezi	Verb
înălțare	Noun
capitalistele	Adjective
domesticirea	Noun
albă	Adjective
clipele	Noun
atentului	Adjective
ținuserăți	Verb
dormeau	Verb
amenințarea	Noun
obosi	Verb
încărunții	Verb
controlase	Verb
șchiopăți	Verb
amețirăm	Verb
dezlegat	Participle
slăbea	Verb
învelișul	Noun
coseau	Verb
visat	Participle
invitase	Verb
atârnau	Verb
străinul	Adjective
nudului	Adjective
îmbogăți	Verb
spaniola	Noun
dativule	Noun
focile	Noun
pățeați	Verb
sandvișul	Noun
costumele	Noun
logat	Participle
sulul	Noun
salvaseră	Verb
dizolvat	Participle
dativului	Noun
blestem	Verb
despuiat	Participle
panterele	Noun
reținut	Participle
limba	Noun
mucoasei	Adjective
fertilitatea	Noun
elefantului	Noun
menținură	Verb
safirele	Noun
ciudată	Adjective
brigadierului	Noun
lipitorile	Noun
ceață	Noun
înălțase	Verb
apărare	Noun
clește	Noun
sinceritatea	Noun
cărând	Converb
colorații	Adjective
strica	Verb
frigiderele	Noun
asprimii	Noun
fadă	Adjective
aruncare	Noun
eprubeta	Noun
pavat	Participle
dezlipiși	Verb
preoți	Verb
ieșirile	Noun
eră	Noun
interfeței	Noun
guvernării	Noun
furiei	Noun
dinamica	Adjective
conjugat	Participle
slujind	Converb
koala	Noun
uciderea	Noun
împovărași	Verb
risipi	Verb
țipetele	Noun
muntoasei	Adjective
porcarului	Noun
torni	Verb
măcina	Verb
orizontului	Noun
taverna	Noun
intenționară	Verb
investitorii	Noun
puciul	Noun
cronicelor	Adjective
auzului	Noun
sferică	Adjective
angajat	Participle
geamului	Noun
sfânta	Noun
veninului	Noun
subțiară	Verb
mesteacănului	Noun
îndemnase	Verb
câmpiei	Noun
parazitara	Adjective
locului	Noun
cărbunii	Noun
vapoarele	Noun
săptămânile	Noun
alergă	Verb
lansând	Converb
crezuseși	Verb
homosexualitatea	Noun
părintele	Noun
supunerile	Noun
criticul	Adjective
călătorului	Adjective
săptămînă	Noun
încălzind	Converb
lucrase	Verb
pierdeați	Verb
întrebând	Converb
cornută	Adjective
clocoteau	Verb
tucanul	Noun
interesase	Verb
studiaseră	Verb
calci	Verb
punga	Noun
pelicanii	Noun
distinsei	Verb
foamea	Noun
puțiseși	Verb
destrăbălat	Participle
britanicii	Adjective
curătura	Noun
britanica	Adjective
încadrez	Verb
hienei	Noun
faleză	Noun
zariștea	Noun
pornirile	Noun
trista	Adjective
botezaților	Adjective
melanjului	Noun
muri	Verb
cloci	Verb
cazanele	Noun
codobatura	Noun
zi	Verb
rebeliunile	Noun
aisbergului	Noun
neglija	Verb
puținelor	Adjective
dorit	Participle
învingea	Verb
dozare	Noun
uitat	Participle
muți	Verb
spurcului	Noun
grasa	Adjective
influențau	Verb
împletiserăm	Verb
minerului	Noun
urmezi	Verb
îndurerară	Verb
găti	Verb
despărțea	Verb
importanții	Adjective
obstrucției	Noun
prăbușit	Participle
subteranele	Adjective
stăm	Verb
nemțescul	Adjective
înconjura	Verb
stabiliserăm	Verb
bag	Verb
alcătuiau	Verb
refuza	Verb
vioiciunii	Noun
vargă	Noun
abundenței	Noun
personalității	Noun
clocit	Participle
retraseră	Verb
urcarea	Noun
păduchii	Noun
cruzimii	Noun
biotitul	Noun
proporțiile	Noun
țânțarului	Noun
stricând	Converb
constrângem	Verb
veșnicii	Adjective
întregului	Adjective
coșmarurile	Noun
ardoarea	Noun
spanacului	Noun
dicționarele	Noun
creierul	Noun
strigi	Verb
introducând	Converb
găsit	Participle
cununasem	Verb
înmulțim	Verb
venera	Verb
ghemule	Noun
osoaselor	Adjective
scrotului	Noun
mioriței	Noun
lansatorului	Noun
autorității	Noun
unea	Verb
pasa	Verb
muncind	Converb
reintroduce	Verb
tremurat	Participle
anghilă	Noun
falezele	Noun
popularilor	Adjective
creanga	Noun
chiloții	Noun
aducătoarei	Noun
bucuri	Verb
gospodarul	Adjective
rostogolit	Participle
înnegurasem	Verb
suedezii	Adjective
comandau	Verb
puricași	Verb
negustorului	Noun
cangurii	Noun
irita	Verb
prelungi	Verb
halucinasem	Verb
îmbulzeai	Verb
oprire	Noun
rebeliunii	Noun
sista	Verb
neutrii	Adjective
glonțului	Noun
evlaviosul	Adjective
prepuțului	Noun
ridicării	Noun
învăța	Verb
secvență	Noun
viermuia	Verb
trecând	Converb
convingi	Verb
opreau	Verb
mărețul	Adjective
viețuiai	Verb
mangustele	Noun
înlocuiești	Verb
plătea	Verb
supunere	Noun
limbile	Noun
simplificăm	Verb
aliatului	Noun
iobagului	Noun
traiectorie	Noun
cuceriseră	Verb
confruntând	Converb
omuleții	Noun
goleau	Verb
înlături	Verb
întăreau	Verb
judeci	Verb
fericitele	Adjective
instanților	Adjective
promisiunea	Noun
pederastia	Noun
întrebuințat	Participle
închisa	Adjective
tremurul	Noun
tastatura	Noun
cobaii	Noun
împerecheaserăți	Verb
ascuțim	Verb
înecase	Verb
rățoiul	Noun
epifania	Noun
prețului	Noun
maiestate	Noun
menținuseră	Verb
dezgustat	Participle
încruntaseră	Verb
acidului	Adjective
moașele	Noun
crescu	Verb
muncea	Verb
înălțau	Verb
bociserăm	Verb
bunicuța	Noun
furnicași	Verb
rotundă	Adjective
mahona	Noun
spulberară	Verb
micșorasem	Verb
răgușiserăți	Verb
ieșit	Participle
protejezi	Verb
hiena	Noun
alegând	Converb
înviere	Noun
mausurile	Noun
leșinaseră	Verb
vomuse	Verb
viteaza	Adjective
desișurile	Noun
sfârșeau	Verb
citeai	Verb
nisipului	Noun
șuierat	Participle
inducea	Verb
interzicând	Converb
jucau	Verb
acuzaserăți	Verb
ghiceați	Verb
fundă	Verb
ferestrele	Noun
prășirăm	Verb
țărănimii	Noun
anghilele	Noun
slovacului	Adjective
pereche	Noun
necesitățile	Noun
interviurile	Noun
vergile	Noun
rețelei	Noun
copților	Adjective
cutremurul	Noun
acoperii	Verb
cășunat	Participle
întinat	Participle
îngropăm	Verb
menestrelii	Noun
încumetarăți	Verb
bărbii	Noun
îmbulzim	Verb
răceala	Noun
abandonau	Verb
curățat	Participle
credincioasa	Adjective
rezistând	Converb
călătorii	Adjective
îmbogățit	Participle
înfumuraserăm	Verb
știau	Verb
deranjau	Verb
bălăise	Verb
știința	Noun
sera	Noun
înviorat	Participle
invitau	Verb
virozei	Noun
evreul	Noun
supraviețuind	Converb
decretului	Noun
zgăurasem	Verb
știui	Verb
adevăratului	Adjective
reușit	Participle
centralele	Adjective
plângeau	Verb
învățau	Verb
minorității	Noun
înnoit	Participle
slujiseră	Verb
cântecele	Noun
spectrala	Adjective
traducea	Verb
migdalele	Noun
singurii	Adjective
bravului	Adjective
măsor	Verb
piedestalului	Noun
încetiserăm	Verb
crăpaseși	Verb
stabilești	Verb
exagerând	Converb
ținutul	Adjective
desenau	Verb
virnanții	Noun
reducea	Verb
păgânul	Adjective
câștigăm	Verb
apărarea	Noun
ardem	Verb
genitivul	Noun
sălbaticii	Adjective
scurtaseși	Verb
lărgeați	Verb
biată	Adjective
supravegheaseră	Verb
dicta	Verb
asexualii	Adjective
lină	Adjective
jalnică	Adjective
alpaca	Noun
norocoasă	Adjective
hamsie	Noun
violetul	Adjective
cheie	Noun
călătoriei	Noun
cinsteau	Verb
școlăriță	Noun
inului	Noun
religioasei	Adjective
otrăvit	Participle
prelungit	Participle
covorule	Noun
săruți	Verb
delimitării	Noun
împușcat	Participle
trufie	Noun
fixă	Verb
naștere	Noun
îmbunătățirea	Noun
aerisiserăm	Verb
senatorului	Noun
utilă	Adjective
dominat	Participle
abacul	Noun
necunoscutului	Adjective
aflaseră	Verb
amestec	Verb
poștalelor	Adjective
moștenise	Verb
plinul	Adjective
sângele	Noun
liliecii	Noun
artistică	Adjective
exportatorului	Noun
țăcănii	Verb
radiourile	Noun
lichidității	Noun
guralivei	Adjective
influența	Verb
completez	Verb
antimateriei	Noun
grătarele	Noun
definițiile	Noun
azotosului	Adjective
abandonarea	Noun
însușirea	Noun
transcris	Participle
genunchiul	Noun
leoparzii	Noun
cântăm	Verb
culcat	Participle
amenințat	Participle
becul	Noun
aerodromului	Noun
lungea	Verb
naționalei	Adjective
vipera	Noun
flămânda	Adjective
omenire	Noun
intervenea	Verb
surorile	Noun
strămoșului	Noun
minunarăți	Verb
rugat	Participle
spâna	Adjective
florarul	Noun
valea	Noun
cioplisem	Verb
petrecând	Converb
ferim	Verb
turnarăți	Verb
centrală	Adjective
obținu	Verb
purtările	Noun
murii	Verb
prevenea	Verb
echipajului	Noun
urdinând	Converb
circulând	Converb
dezmințit	Participle
vârtejurile	Noun
dansurile	Noun
clăti	Verb
importantă	Adjective
stindardului	Noun
cronologiei	Noun
înlocuind	Converb
îmbuibase	Verb
circumscrise	Verb
înotat	Participle
galfedele	Adjective
simfoniei	Noun
rechinii	Noun
frățească	Adjective
conținând	Converb
înțelesese	Verb
mahalaua	Noun
vedeai	Verb
cuibului	Noun
întrezărit	Participle
răzbunând	Converb
transformaseră	Verb
stâlpului	Noun
avansași	Verb
tavernă	Noun
supă	Noun
împingeau	Verb
fistulă	Noun
tatuaserăm	Verb
obținem	Verb
fractură	Verb
simplele	Adjective
gustat	Participle
stătea	Verb
sinucisesem	Verb
razei	Noun
visez	Verb
muncit	Participle
ocupași	Verb
tocaserăți	Verb
profesionalismul	Noun
dereticarăți	Verb
amiciția	Noun
logodit	Participle
castraveții	Noun
tatăl	Noun
poporului	Noun
răbda	Verb
invincibilitatea	Noun
atlanticul	Adjective
împletit	Participle
încrezut	Participle
scămoasă	Adjective
diminuarea	Noun
oliva	Noun
plăcintele	Noun
construiau	Verb
banului	Noun
observaseră	Verb
bețivul	Adjective
ardeiul	Noun
petrecuserăm	Verb
pipirigul	Noun
botgrosul	Noun
alergară	Verb
catârul	Noun
necăjit	Participle
discordia	Noun
huliganului	Noun
stabilii	Verb
șmecherii	Adjective
asudaseși	Verb
catalanii	Adjective
încălecat	Participle
harbujii	Noun
descoperind	Converb
veninosului	Adjective
ciungii	Noun
acizii	Adjective
prăsim	Verb
circumcis	Participle
atlantica	Adjective
sură	Adjective
forțezi	Verb
coborâtă	Adjective
aerodromurile	Noun
mutațiile	Noun
trecură	Verb
gaura	Noun
buza	Noun
relativitatea	Noun
fructul	Noun
câmpeneasca	Adjective
preferința	Noun
medicamentului	Noun
bisericoasei	Adjective
împrejmuiserăți	Verb
înfundară	Verb
împuști	Verb
simplificând	Converb
bursucii	Noun
servi	Verb
intenționat	Participle
țăcănit	Participle
lemnul	Noun
bisericile	Noun
înjunghiat	Participle
despicat	Participle
bieții	Adjective
tristele	Adjective
coiotul	Noun
bărbătească	Adjective
nudul	Adjective
golit	Participle
credinței	Noun
criticele	Adjective
înotau	Verb
strămoșii	Noun
plantă	Verb
parcarăți	Verb
scuturat	Participle
tâmpiseși	Verb
miloasei	Adjective
invariabilul	Adjective
prăbușiseră	Verb
leurdele	Noun
împiedicăm	Verb
insurmontabila	Adjective
portughezul	Adjective
muzicii	Noun
rosese	Verb
strâmtezi	Verb
putuseră	Verb
perete	Noun
sughiț	Verb
icrei	Noun
crescută	Adjective
făceai	Verb
flămândă	Adjective
cunoașterea	Noun
lampa	Noun
ruperii	Noun
adaptabilitatea	Noun
trăncănim	Verb
normalitatea	Noun
arăți	Verb
înmulțit	Participle
orchestrei	Noun
virilul	Adjective
spuseseră	Verb
crunților	Adjective
umpluseră	Verb
bolnavii	Adjective
sclavul	Noun
plafonului	Noun
împovărarăm	Verb
croia	Verb
originalitatea	Noun
nemeritată	Adjective
negurile	Noun
bârsele	Noun
naștem	Verb
catifeaua	Noun
rădașca	Noun
doinele	Noun
dansași	Verb
contraveneau	Verb
zada	Noun
întreținând	Converb
sedus	Participle
freamăt	Verb
frământare	Noun
ocrotea	Verb
treceați	Verb
scăpa	Verb
resursei	Noun
alamei	Noun
gimnastele	Noun
căsătoriei	Noun
botanică	Adjective
îngropasem	Verb
îmbărbătași	Verb
bară	Verb
profesoara	Noun
șerbești	Verb
uscații	Adjective
pătrundem	Verb
capabilitatea	Noun
încercuit	Participle
mișcat	Participle
induseseră	Verb
verosimilă	Adjective
tinserăți	Verb
țiparul	Noun
medicul	Adjective
testiculul	Noun
pricepi	Verb
româneasca	Adjective
nivelat	Participle
arsurii	Noun
spovedirăți	Verb
frumusețe	Noun
utilul	Adjective
microbiologiei	Noun
anticipare	Noun
codobatură	Noun
înrădăcinat	Participle
unilaterală	Adjective
plăcea	Verb
săpaserăm	Verb
trezim	Verb
cerșiseși	Verb
sufoca	Verb
strâmtând	Converb
imoasa	Adjective
strecurau	Verb
legendarele	Adjective
letonă	Adjective
adeverii	Verb
maghiarilor	Adjective
curătură	Noun
grăbești	Verb
dinte	Noun
brazilianului	Adjective
mărita	Verb
rumegaseră	Verb
obosise	Verb
tâmpirăm	Verb
prospătezi	Verb
covoarele	Noun
înțelesurile	Adjective
uciserăți	Verb
lăudase	Verb
clarificând	Converb
afundat	Participle
orele	Noun
citim	Verb
interfață	Noun
vizualizat	Participle
balcoanele	Noun
făcătorii	Adjective
sângera	Verb
importantele	Adjective
soacra	Noun
rularăm	Verb
weltanschauungului	Noun
pierind	Converb
lepezi	Verb
harfă	Noun
podurile	Noun
lăsată	Adjective
ciuperca	Noun
binarei	Adjective
susținuse	Verb
miști	Verb
ospătarului	Noun
parazitară	Adjective
stăpâneau	Verb
vioreaua	Noun
experimentatului	Adjective
plantând	Converb
reflectata	Adjective
împărțeați	Verb
dinamicele	Adjective
supremația	Noun
sticlei	Noun
achiziționării	Noun
înfigând	Converb
ceașca	Noun
cârtița	Noun
scaperi	Verb
indiscretul	Adjective
eroului	Noun
sorbit	Participle
multipolaritatea	Noun
ieșea	Verb
creștina	Adjective
simțind	Converb
slavii	Adjective
sudica	Adjective
măcinat	Participle
hămesea	Verb
depănase	Verb
aroganta	Adjective
împărat	Participle
salutând	Converb
tăind	Converb
centrala	Adjective
chinezoaica	Noun
căsătoriile	Noun
donez	Verb
murau	Verb
socotea	Verb
slovacul	Adjective
descoperii	Verb
pornografie	Noun
motoarele	Noun
războaiele	Noun
inteligenta	Adjective
învelișurile	Noun
intensitățile	Noun
vorbea	Verb
ucidem	Verb
inteligibilii	Adjective
răcea	Verb
atingem	Verb
spectralii	Adjective
urmări	Verb
protocoalele	Noun
refuzași	Verb
absorbea	Verb
letona	Adjective
podul	Noun
robul	Noun
alchină	Noun
dăpărarăți	Verb
adăugasem	Verb
individului	Noun
mica	Adjective
corturile	Noun
dorința	Noun
muști	Verb
dezmeticeau	Verb
înmărmurit	Participle
vaccină	Verb
fixase	Verb
iarbă	Noun
supravegheaseși	Verb
recuperau	Verb
grăsimea	Noun
odăii	Noun
rinichiului	Noun
umanul	Adjective
spiritualelor	Adjective
serioasei	Adjective
mortul	Adjective
desenat	Participle
seaca	Adjective
așteptaseși	Verb
iluzie	Noun
frânat	Participle
creaseră	Verb
activista	Noun
reparabilului	Adjective
juca	Verb
vlăguit	Participle
imitare	Noun
aburului	Noun
căprioara	Noun
feminitatea	Noun
dezgustasem	Verb
muma	Noun
reveriei	Noun
juisez	Verb
contopeai	Verb
buzunarului	Noun
principalele	Adjective
grotei	Noun
întemeiau	Verb
perseverăm	Verb
ultimilor	Adjective
pic	Verb
heterosexualitatea	Noun
gravată	Adjective
dispărea	Verb
ședință	Noun
cărunților	Adjective
reușind	Converb
lincșii	Noun
individul	Noun
proptiseră	Verb
făgăduiseră	Verb
iraționalului	Adjective
înspăimânta	Verb
venirăți	Verb
cotidianului	Adjective
învinșilor	Adjective
intoxicași	Verb
trimiți	Verb
apă	Noun
jucat	Participle
funcționa	Verb
înot	Verb
codificaților	Adjective
jandarmii	Noun
polarelor	Adjective
morcovii	Noun
vigilența	Noun
urmărea	Verb
intrând	Converb
unim	Verb
odaie	Noun
ridicaseră	Verb
cumpărau	Verb
combin	Verb
sorbea	Verb
ridiche	Noun
prietene	Noun
erecția	Noun
silaba	Noun
blestemele	Noun
slăvind	Converb
lucrând	Converb
unicei	Adjective
bulevardele	Noun
utilizaseră	Verb
confrunt	Verb
ariciul	Noun
discuți	Verb
sângeroasei	Adjective
melodiei	Noun
vopsi	Verb
echidnele	Noun
dictat	Participle
târguisem	Verb
substanță	Noun
mâncăm	Verb
supăraserăți	Verb
menținut	Participle
psihologii	Noun
aburul	Noun
prezisesem	Verb
neglijat	Participle
comparând	Converb
ardeii	Noun
sărăturile	Noun
invadaseră	Verb
piesei	Noun
timidă	Adjective
lămâii	Noun
albanezii	Adjective
suni	Verb
păcătuit	Participle
întrebase	Verb
solvabilității	Noun
javră	Noun
vocii	Noun
binară	Adjective
tăgăduiseși	Verb
slujeau	Verb
verișoară	Noun
învinsului	Adjective
gustarea	Noun
cetățeană	Noun
jaguarului	Noun
regatul	Noun
secerat	Participle
monocromii	Adjective
sugere	Noun
trăim	Verb
raritățile	Noun
locuiserăți	Verb
albanezul	Adjective
căscat	Participle
străbunii	Noun
interesat	Participle
curăți	Verb
dovedeau	Verb
îngreunarăți	Verb
susțineau	Verb
antropologii	Noun
frunte	Noun
iudaismului	Noun
injectaserăți	Verb
reînnoia	Verb
antagonicelor	Adjective
lipiserăți	Verb
absorbeau	Verb
floare	Noun
amânarăți	Verb
lumii	Noun
mănânci	Verb
lăudau	Verb
vântur	Verb
ghețarului	Noun
ieșirii	Noun
înțelesul	Adjective
despicăm	Verb
puternicului	Adjective
încăleca	Verb
tremurând	Converb
cravată	Noun
mintalei	Adjective
furtunul	Noun
sfeșnicul	Noun
schizofrenie	Noun
adoptând	Converb
înghițim	Verb
zgarda	Noun
flămânzise	Verb
compatriotului	Noun
spintecat	Participle
judecaților	Adjective
aritmetică	Adjective
devine	Verb
venea	Verb
bunicul	Noun
făgetele	Noun
spintecaseși	Verb
purica	Verb
gândise	Verb
organul	Noun
reală	Adjective
vărgata	Adjective
imperială	Adjective
calculatorului	Noun
poftise	Verb
antilopa	Noun
lutoasa	Adjective
cust	Verb
înghețatele	Adjective
staniferii	Adjective
anula	Verb
studentă	Noun
aurorei	Noun
influențat	Participle
interveniși	Verb
sferica	Adjective
unghie	Noun
apropiaseși	Verb
împușcase	Verb
behaviorismul	Noun
recuperez	Verb
sulurile	Noun
literaturii	Noun
impunem	Verb
reușiseră	Verb
delictul	Noun
deranjăm	Verb
pierdeau	Verb
zbiera	Verb
zburăm	Verb
avansaseră	Verb
mâncărimea	Noun
dalta	Noun
gladiolă	Noun
cantautorului	Noun
onesta	Adjective
focoasele	Adjective
transformase	Verb
împușcând	Converb
aritmetica	Adjective
italianului	Noun
cobor	Verb
distilat	Participle
lipseau	Verb
gardului	Noun
iedul	Noun
încorporând	Converb
accesele	Noun
popularele	Adjective
americanca	Noun
nășteau	Verb
petalele	Noun
fierarii	Noun
copiem	Verb
popularei	Adjective
privegheau	Verb
belisem	Verb
feței	Noun
făuriși	Verb
cășunași	Verb
rupse	Verb
legănat	Participle
izvorului	Noun
albinarii	Noun
rufele	Noun
frământaserăm	Verb
religie	Noun
luna	Noun
studiez	Verb
seduce	Verb
împodobiră	Verb
plictiselii	Noun
furtunurile	Noun
sucești	Verb
straturile	Noun
principatele	Noun
bizonul	Noun
scării	Noun
absinturile	Noun
chitarei	Noun
arhipelagurile	Noun
reprezentantului	Noun
forțase	Verb
oprim	Verb
deismul	Noun
cenușiul	Adjective
invizibilul	Adjective
salut	Verb
mireasa	Noun
abacă	Noun
încălzeau	Verb
rostogoli	Verb
nelucratele	Adjective
închipuim	Verb
salariaților	Adjective
veșmintele	Noun
foamei	Noun
fundașul	Noun
dregătorul	Noun
sigurul	Adjective
polonezele	Noun
înzestrând	Converb
episcopală	Adjective
adăugat	Participle
olimpica	Adjective
limbă	Noun
înveli	Verb
vulpea	Noun
descompunând	Converb
faci	Verb
continentele	Noun
largă	Adjective
enciclopedia	Noun
clinica	Noun
păturii	Noun
integrabilii	Adjective
berzele	Noun
vizibililor	Adjective
înfăinaserăm	Verb
izvorul	Noun
adaptabilității	Noun
broaștei	Noun
algerienii	Adjective
cutie	Noun
analogul	Adjective
stăruim	Verb
musculoșii	Adjective
calendarului	Noun
valahii	Adjective
împărăteasa	Noun
țigănească	Adjective
documentezi	Verb
paltinii	Noun
iepei	Noun
prezentei	Adjective
ciocniși	Verb
creștinească	Adjective
pier	Verb
târgui	Verb
pătaserăți	Verb
algoritmii	Noun
juvenilă	Adjective
puternicelor	Adjective
traversa	Verb
scapi	Verb
risipit	Participle
înghesuiserăți	Verb
născu	Verb
taurului	Noun
omorâse	Verb
îndulcit	Participle
gaza	Verb
utila	Adjective
ador	Verb
struții	Noun
colectivitățile	Noun
acantul	Noun
cruzime	Noun
măriți	Verb
chițăiși	Verb
mobilul	Adjective
tentat	Participle
mulțimea	Noun
aminti	Verb
șasiul	Noun
căpoasele	Adjective
dansului	Noun
răpui	Verb
scremi	Verb
heringii	Noun
întâlnii	Verb
cerca	Verb
halim	Verb
orizonturile	Noun
masacrul	Noun
referendumurile	Noun
autobuzul	Noun
caracterele	Noun
tiveau	Verb
împreuna	Verb
noile	Adjective
încercă	Verb
dominase	Verb
îmbătrâni	Verb
tăioasă	Adjective
aței	Noun
răzbunat	Participle
înșir	Verb
pliveau	Verb
risipea	Verb
oficialilor	Adjective
mursecaserăți	Verb
masturbat	Participle
otrăvind	Converb
muiară	Verb
principalul	Adjective
rasa	Adjective
cufunda	Verb
închega	Verb
tubul	Noun
ducerii	Noun
masivul	Adjective
scosese	Verb
ședea	Verb
împodobeau	Verb
cântărețului	Noun
putem	Verb
îngropaseră	Verb
ploaia	Noun
apoasa	Adjective
rănise	Verb
sistase	Verb
neglijarăți	Verb
zăpăciseși	Verb
albilor	Adjective
dăunând	Converb
izgoni	Verb
alina	Verb
scăpă	Verb
uitaseră	Verb
câștigi	Verb
simplul	Adjective
naivă	Adjective
orientare	Noun
recuperat	Participle
plătii	Verb
înnegrii	Verb
tehnologiei	Noun
suveranului	Adjective
mucedului	Adjective
viile	Adjective
pașca	Noun
specificitate	Noun
împrejmuiau	Verb
criminalului	Adjective
alcătuise	Verb
activistă	Noun
olandeză	Noun
sorbiși	Verb
bunica	Noun
admirăm	Verb
bazilicii	Noun
buzele	Noun
orfanului	Adjective
judecătorul	Noun
podelele	Noun
brumăriile	Adjective
nemiloasa	Adjective
pasarăm	Verb
sperăm	Verb
siniștrilor	Adjective
loriului	Noun
veselă	Adjective
concentrată	Adjective
țigăneau	Verb
mirosiserăm	Verb
sari	Verb
loveați	Verb
salvia	Noun
încurc	Verb
împărțiseră	Verb
meriți	Verb
linxul	Noun
nopții	Noun
stingea	Verb
încercarăți	Verb
urmărirea	Noun
spunem	Verb
îndepărtase	Verb
vrăjitorul	Noun
sinucideau	Verb
numărăm	Verb
auriii	Adjective
abrevierii	Noun
rotiseși	Verb
învățarăți	Verb
unchii	Noun
posedarea	Noun
fragii	Noun
mâne	Verb
casă	Noun
porcarul	Noun
cerbului	Noun
exagerata	Adjective
turbase	Verb
arătaseși	Verb
alchinele	Noun
înșirat	Participle
canabinoizii	Noun
pătrunsei	Verb
înnorat	Participle
mincinosul	Adjective
studiasem	Verb
nauruanii	Adjective
râpa	Noun
masculul	Adjective
principalilor	Adjective
prinseseră	Verb
puțurile	Noun
chiflă	Noun
extrasesem	Verb
cireașa	Noun
băturăți	Verb
rusul	Adjective
avansarăm	Verb
cumpătării	Noun
prescurtării	Noun
fantezie	Noun
văzuse	Verb
ospătat	Participle
fugeau	Verb
jigneai	Verb
împodobeai	Verb
bomba	Noun
prăbuși	Verb
proporției	Noun
transformau	Verb
fusul	Noun
muta	Verb
dezavantajului	Noun
pulsară	Verb
rotiseră	Verb
discuției	Noun
miri	Verb
sucule	Noun
împinseși	Verb
nativă	Adjective
pescărușii	Noun
suferință	Noun
mustăcioară	Noun
monogamiei	Noun
integrală	Adjective
țipaserăm	Verb
intru	Verb
șoarecelui	Noun
înjurând	Converb
semințele	Noun
nunii	Noun
începem	Verb
mortului	Adjective
ecranule	Noun
căsătoria	Noun
artei	Noun
istoricelor	Adjective
cuvioasă	Adjective
vindeca	Verb
împrumutând	Converb
înfruntase	Verb
scăpaseră	Verb
biblioteca	Noun
sugrumi	Verb
definiția	Noun
excelat	Participle
pliveați	Verb
ciclistul	Adjective
circulaseră	Verb
judecării	Noun
omenirii	Noun
rezistași	Verb
prinsă	Adjective
asexualitatea	Noun
caimacul	Noun
poala	Noun
încăriserăți	Verb
urcași	Verb
gospodină	Noun
luminoasa	Adjective
abdicaserăți	Verb
programul	Noun
bazat	Participle
cronicele	Adjective
credinciosului	Adjective
ornata	Adjective
vânzând	Converb
împrumutară	Verb
transatlanticului	Adjective
mințiseră	Verb
sunau	Verb
arcul	Noun
memorizaserăți	Verb
perineului	Noun
așteptat	Participle
focosul	Adjective
înnorez	Verb
periuța	Noun
paritatea	Noun
abiogenezei	Noun
scărmănând	Converb
racului	Noun
făcut	Participle
ardeiului	Noun
tocaserăm	Verb
construia	Verb
sânul	Noun
cântat	Participle
apărările	Noun
sfulgeri	Verb
realitățile	Noun
magazinul	Noun
aglomerată	Adjective
subterană	Adjective
datorând	Converb
dumnezeii	Noun
câmpului	Noun
răpuse	Verb
zăpăciși	Verb
tiviși	Verb
rescrii	Verb
învățătorii	Noun
elasticității	Noun
substantivului	Noun
rădeai	Verb
plămânului	Noun
suit	Participle
singura	Adjective
miezul	Noun
renii	Noun
civiizaserăm	Verb
lăuda	Verb
alăptat	Participle
fermă	Noun
stafidele	Noun
umedă	Adjective
draga	Adjective
faleza	Noun
medicului	Adjective
bianuală	Adjective
golea	Verb
zgăurași	Verb
vulgarele	Adjective
erogena	Adjective
zbârlit	Participle
nucule	Noun
serei	Noun
lățești	Verb
slavul	Adjective
uimea	Verb
galaxie	Noun
combinat	Participle
contrazici	Verb
analoagă	Adjective
înnegrit	Participle
îngropa	Verb
exemplul	Noun
mirării	Noun
săpând	Converb
lansase	Verb
înotătoare	Noun
animalul	Adjective
murmurând	Converb
tragi	Verb
brutală	Adjective
linișteai	Verb
veșnicul	Adjective
haitiană	Adjective
gândacului	Noun
fricii	Noun
zbătuserăm	Verb
urziră	Verb
sacul	Noun
mucoaselor	Adjective
bătrânul	Adjective
curatei	Adjective
săraseră	Verb
automobilele	Noun
împrumut	Verb
aplaudat	Participle
feminină	Adjective
masurile	Noun
asprii	Adjective
curgând	Converb
somnoroasă	Adjective
copiau	Verb
gura	Noun
bucătăriei	Noun
folosea	Verb
făptuit	Participle
leurdă	Noun
călcâiul	Noun
șoimul	Noun
bora	Verb
puțiși	Verb
croitorii	Noun
delirului	Noun
păziserăți	Verb
gândurile	Noun
stimat	Participle
măruntul	Adjective
forfecaserăm	Verb
enormul	Adjective
brăzaseși	Verb
evoluție	Noun
îmbogățise	Verb
preotul	Noun
pădurile	Noun
aprinderii	Noun
absorbita	Adjective
scorpionului	Noun
descins	Participle
ovăzului	Noun
răsufla	Verb
scapăt	Verb
dezamăgiților	Adjective
zerului	Noun
umplând	Converb
căutat	Participle
farfuriile	Noun
lăbărțatului	Adjective
spui	Verb
rachetei	Noun
cuprinsa	Adjective
blocase	Verb
echinocțiile	Noun
tresăriserăm	Verb
temut	Participle
golind	Converb
măgarului	Noun
țăranii	Noun
cortul	Noun
asigurat	Participle
prepoziția	Noun
parcarea	Noun
muncise	Verb
deprinseseși	Verb
rezolva	Verb
comerciantul	Noun
constituționalității	Noun
pleci	Verb
soțului	Noun
rănind	Converb
supei	Noun
racheta	Noun
nimerind	Converb
conjuncția	Noun
slabul	Adjective
frământași	Verb
străzile	Noun
calitatea	Noun
planetarii	Adjective
nativilor	Adjective
costumul	Noun
griurile	Adjective
creăm	Verb
finisa	Verb
încununând	Converb
glorificatoarea	Adjective
sfârșind	Converb
goliciunea	Noun
stabilise	Verb
îndeletnici	Verb
serii	Noun
tăgădui	Verb
numărătorul	Noun
zoologii	Noun
cartilajului	Noun
bestialitatea	Noun
libidinoaselor	Adjective
episcopala	Adjective
delicatului	Adjective
purpurie	Adjective
separ	Verb
nimicit	Participle
colorată	Adjective
migrenă	Noun
mâncărime	Noun
albină	Noun
formalitate	Noun
comunul	Adjective
programabilă	Adjective
fermecătoarea	Adjective
plumburie	Adjective
purici	Verb
vorbind	Converb
preistoricii	Adjective
dezmeticești	Verb
cuști	Verb
aerisiră	Verb
furi	Verb
terminau	Verb
întorseseră	Verb
șezuserăți	Verb
ocupăm	Verb
străzii	Noun
spiritele	Noun
contraziceau	Verb
gorunul	Noun
unești	Verb
destinații	Adjective
safirul	Noun
corcești	Verb
aștepți	Verb
centrului	Noun
întreprinserăm	Verb
depui	Verb
avansând	Converb
lauzi	Verb
parcare	Noun
plaiule	Noun
aprinsă	Adjective
interziceau	Verb
sacrificiule	Noun
rotundul	Adjective
torcând	Converb
seninul	Adjective
scurmaseși	Verb
strecurase	Verb
arătau	Verb
utilizatorul	Noun
păstârnacul	Noun
microbiologică	Adjective
strigătele	Noun
inseparabilă	Adjective
intervenim	Verb
cășunaseră	Verb
verișoarei	Noun
nefertilizatele	Adjective
fraternității	Noun
monogamia	Noun
guguștiucul	Noun
împărțit	Participle
răspândi	Verb
proiectul	Noun
castorul	Noun
inelele	Noun
necăji	Verb
dezgrop	Verb
ingineriei	Noun
harpele	Noun
împerecheat	Participle
mârcedul	Adjective
spălat	Participle
conversației	Noun
credincioșii	Adjective
pâine	Noun
macră	Adjective
suveranitate	Noun
agentului	Noun
înduplecași	Verb
majoratului	Noun
însoțiserăm	Verb
cuceri	Verb
înrudea	Verb
radiației	Noun
algoritmului	Noun
rutele	Noun
guvernările	Noun
râsesem	Verb
buricul	Noun
nopțile	Noun
găina	Noun
banana	Noun
vorbei	Noun
bazezi	Verb
celta	Adjective
supunerea	Noun
lipsurile	Noun
fragile	Noun
cerșeați	Verb
contul	Noun
dubioasa	Adjective
pisat	Participle
persanului	Adjective
înnoptași	Verb
mierlei	Noun
neioasei	Adjective
memorizarăm	Verb
fericiții	Adjective
pedepseau	Verb
cărării	Noun
puritatea	Noun
omorului	Noun
răsucii	Verb
istețul	Adjective
descompus	Participle
rarele	Adjective
ciurul	Noun
înghițea	Verb
scutur	Verb
drăguță	Adjective
umplut	Participle
nodoșii	Adjective
tremurau	Verb
plimbaserăm	Verb
explicațiile	Noun
avansaserăm	Verb
orientăm	Verb
îmbătrânii	Verb
mână	Noun
codalbii	Adjective
zicea	Verb
stinse	Verb
pregătise	Verb
aromânii	Adjective
cucerești	Verb
omorâm	Verb
germanilor	Adjective
scrierile	Noun
invincibilă	Adjective
capitaliștilor	Adjective
ungeai	Verb
lupt	Verb
răzgândit	Participle
gravitând	Converb
convenirăți	Verb
disponibilul	Adjective
cascadă	Noun
roasa	Adjective
baltica	Adjective
tulburi	Verb
internaționalei	Adjective
fonetica	Adjective
locuinței	Noun
nașterii	Noun
divorțaseră	Verb
compozitorului	Noun
negând	Converb
plătise	Verb
controlat	Participle
devenind	Converb
amuțiși	Verb
ședinței	Noun
neguțaserăți	Verb
vineții	Adjective
sexualitatea	Noun
pedeapsa	Noun
încăpățânatul	Adjective
ascunsa	Adjective
supraveghea	Verb
eroul	Noun
oposumii	Noun
rândunica	Noun
heterosexualității	Noun
străbunul	Noun
îngreunau	Verb
frica	Noun
supărat	Participle
bibliotecii	Noun
cunoscuseră	Verb
săpăm	Verb
întregul	Adjective
țigănirăți	Verb
fumeg	Verb
dictaserăm	Verb
șoaptă	Noun
clinicii	Noun
cursei	Verb
polonezul	Adjective
mânăstirii	Noun
coborâse	Verb
sticlete	Noun
bălțată	Adjective
vars	Verb
divorțase	Verb
cardiologiei	Noun
buchetul	Noun
chitară	Noun
forțând	Converb
pedepsisem	Verb
înconjurarăți	Verb
brațului	Noun
eliberez	Verb
păstrăm	Verb
coapsă	Noun
luării	Noun
bănuia	Verb
arbustului	Noun
perseverezi	Verb
rezistăm	Verb
tisă	Noun
îndepărtă	Verb
adăugă	Verb
subțirea	Adjective
cățelul	Noun
ginerelui	Noun
sfârticarăți	Verb
cârmei	Noun
actriță	Noun
planetară	Adjective
votcii	Noun
turbat	Participle
arterele	Noun
vaginului	Noun
tristețea	Noun
veninul	Noun
încurajăm	Verb
halvalele	Noun
dispuse	Verb
ciudații	Adjective
traversat	Participle
completat	Participle
surorilor	Noun
șacalului	Noun
murise	Verb
cumințirăți	Verb
creă	Verb
irlandezului	Adjective
vindem	Verb
constă	Verb
întâlniră	Verb
insultat	Participle
ghemele	Noun
măsea	Noun
votul	Noun
epuiza	Verb
întărâtaserăți	Verb
stăruit	Participle
trântitei	Adjective
furtunile	Noun
nostalgicii	Adjective
urmăreau	Verb
codificatul	Adjective
spaniolii	Adjective
aprinserăți	Verb
moartă	Adjective
enciclopediei	Noun
neașteptata	Adjective
cunoscutele	Adjective
dungatul	Adjective
scufundau	Verb
cumplim	Verb
credea	Verb
torcea	Verb
adversarului	Noun
ocroti	Verb
recunoscuseră	Verb
culturii	Noun
văzusem	Verb
arșița	Noun
deceda	Verb
colaboratoarea	Adjective
comportau	Verb
dezis	Participle
grăi	Verb
vechime	Noun
stăpâni	Verb
tufișurile	Noun
uciseseră	Verb
cosmică	Adjective
încăperii	Noun
vampira	Noun
domnia	Noun
mătușa	Noun
subrațului	Noun
amică	Noun
nădăjduii	Verb
spânzura	Verb
stărui	Verb
urmăriseră	Verb
cunoscutul	Adjective
tălmaciului	Noun
neglijau	Verb
crăparăm	Verb
cazuarul	Noun
controlând	Converb
intactă	Adjective
respirând	Converb
desena	Verb
eliminat	Participle
prindeau	Verb
evlavie	Noun
pedepsise	Verb
clădit	Participle
ierboasă	Adjective
încurcând	Converb
junele	Noun
undiță	Noun
pizda	Noun
enormului	Adjective
sosului	Noun
găsiseră	Verb
călugăriță	Noun
fugiseră	Verb
masculinității	Noun
ursul	Noun
prăbușea	Verb
minuna	Verb
unidirecțională	Adjective
germana	Adjective
cimpanzeului	Noun
zbierăm	Verb
sinagogă	Noun
anala	Adjective
unduiserăm	Verb
secundarilor	Adjective
romancierului	Noun
aplic	Verb
emoționala	Adjective
lungul	Adjective
anticorpii	Noun
ierta	Verb
portocalie	Adjective
întrerupea	Verb
mulsura	Noun
ocrotind	Converb
ferocități	Noun
binecuvântăm	Verb
descrisese	Verb
cufundat	Participle
șeii	Noun
îndurerat	Participle
înlesnind	Converb
danezul	Adjective
prevestind	Converb
funcțiile	Noun
scuza	Verb
străjile	Noun
trezirii	Noun
concepem	Verb
acoperită	Adjective
substanței	Noun
căprița	Noun
nativul	Adjective
plângând	Converb
cântecul	Noun
virtuoasa	Adjective
cunoaștem	Verb
lipită	Adjective
îmblânziserăm	Verb
convenim	Verb
covrigii	Noun
turcului	Noun
nucile	Noun
implicase	Verb
urâtului	Adjective
geologiei	Noun
netezit	Participle
soțiile	Noun
daunele	Noun
răpise	Verb
irlandezul	Adjective
murmur	Verb
jinduisem	Verb
constituționalitatea	Noun
vulcanii	Noun
dobândea	Verb
dumicat	Participle
taxiului	Noun
bolnava	Adjective
îndopaseră	Verb
descarci	Verb
dezmățarăm	Verb
întrezărim	Verb
frică	Noun
distilase	Verb
apuserăți	Verb
umilind	Converb
amăgit	Participle
cererea	Noun
îndrăznit	Participle
complexă	Adjective
catastrofică	Adjective
jupui	Verb
batjocori	Verb
cercetat	Participle
scobești	Verb
văduvind	Converb
binecuvântat	Participle
amețiserăți	Verb
latri	Verb
adăpostule	Noun
rulând	Converb
localitățile	Noun
loga	Verb
demonul	Noun
văzând	Converb
sufixului	Noun
născuse	Verb
cerențelul	Noun
ieșind	Converb
barza	Noun
răcorim	Verb
înverșunaseră	Verb
măicuță	Noun
tincturarăți	Verb
masculinitatea	Noun
necesitatea	Noun
presupui	Verb
inteligentă	Adjective
prăpădiseși	Verb
imposibilului	Adjective
făliseră	Verb
terminaseră	Verb
introdus	Participle
simetrie	Noun
castaniii	Adjective
măsură	Verb
respirau	Verb
principalelor	Adjective
porcul	Noun
bârnă	Noun
lucrăm	Verb
bălăiră	Verb
zmeura	Noun
aninaserăm	Verb
sperând	Converb
enigmatica	Adjective
localitatea	Noun
riscând	Converb
oripilat	Participle
roții	Noun
gură	Noun
obișnuise	Verb
magazinele	Noun
împlinim	Verb
ajunului	Noun
mandrilului	Noun
mahonele	Noun
activași	Verb
scris	Participle
alianțele	Noun
fierbi	Verb
celulozei	Noun
șurubelnița	Noun
adun	Verb
apa	Noun
reuși	Verb
sfârticăm	Verb
scorneați	Verb
spuziși	Verb
istoricei	Adjective
orfanule	Adjective
dizolvând	Converb
tainei	Noun
stabilități	Noun
speria	Verb
ascensiune	Noun
mărturisit	Participle
târgului	Noun
vărsare	Noun
alegem	Verb
bengaleză	Adjective
chiftelele	Noun
nemiloasă	Adjective
întâietate	Noun
porumbelule	Noun
obosit	Participle
marinarii	Noun
mândrie	Noun
cuveniseră	Verb
zăcut	Participle
eliminară	Verb
iraționalul	Adjective
sânii	Noun
descriau	Verb
prima	Adjective
supraviețuiești	Verb
unsoare	Noun
bucuroasă	Adjective
clătinat	Participle
smaraldul	Noun
ciocneați	Verb
excela	Verb
conformitatea	Noun
facem	Verb
contopisem	Verb
solstițiile	Noun
cocoloșind	Converb
comparare	Noun
înșirând	Converb
produse	Verb
cucereau	Verb
persoanei	Noun
anonimului	Adjective
adverbială	Adjective
maimuțele	Noun
literatură	Noun
fostele	Noun
forjă	Verb
sosurile	Noun
mașina	Noun
toarse	Verb
minusculei	Adjective
