babasızdınız	babasızsın	Tense
okunaksızlığı	okunaksızlık	Case
yağışlardınız	yağışlarım	Tense
gözlemler	gözlemlere	Case
ölüydüler	ölüsünüz	Tense
kukunun	kukuların	Number
asansörleri	asansörü	Number
gecikmezsin	gecikmezsiniz	Number
adsız	büyük	lemma
noktalardır	noktalardınız	Tense
indik	indim	Person
dudağımızı	dudağını	Possession
çamlardan	çamlara	Case
gölleri	göllerin	Case
otomobildin	uyduydun	lemma
sinagogunun	süspansuarının	lemma
alfabede	alfabelerde	Number
kamerasınız	kameraydık	Tense
verniklemelerinde	verniklemelerime	Case
kispetlerine	bamyalarına	lemma
baldızlardı	baldızlarım	Tense
dadısınız	dadıydık	Tense
kurtçuklarım	kurtçuklardın	Tense
güzellikten	güzelliklerden	Number
psikoloğa	psikoloğu	Case
iletkende	iletkenden	Case
arayüzlerden	arayüzden	Number
dublördüler	dublörsünüz	Tense
kotanjantlar	kotanjantların	Case
ayranı	ayrana	Case
paralelkenarlarda	paralelkenarlardan	Case
endüstriyi	endüstriye	Case
ayazlar	ayazlardan	Case
içliği	ayrımcılığı	lemma
geciktirtecekler	geciktirtecek	Person
harften	harfi	Case
hastalandı	hastalanır	Tense
karaciğer	karaciğerin	Case
fonksiyonlarına	fonksiyonuna	Possession
tıklayacak	yayacak	lemma
bencillikten	bencillik	Case
sileceğim	silecek	Person
saatin	saate	Case
otostopçuyduk	otostopçusunuz	Tense
elementlerde	elementler	Case
ayrılmadı	ayrılmadılar	Number
katkılar	katkı	Number
sancağı	sancakları	Number
nutkunu	beldesini	lemma
utkular	utkulardan	Case
öpmeyecek	öpmedi	Tense
asitlerinizin	asitlerinin	Possession
mümessillerinden	mümessilimde	Case
piskoposumuzda	piskoposumuz	Case
sakinmiş	uçurtmaymış	lemma
vücutların	vücutlara	Case
oligarşide	oligarşilerde	Number
ödevi	ödevde	Case
kapısından	yanağından	lemma
yapışmıyoruz	yapışıyoruz	Polarity
üretmeyeceksin	üretmedin	Tense
dişçide	dişçilerde	Number
kaynaştırtılıyordum	kaynaştırtılıyorduk	Number
hastalanmıyorlar	bulunmuyorlar	lemma
yapıların	yapılarda	Case
emniyeti	emniyette	Case
mitokondriyi	mitokondride	Case
pezevenksiniz	pezevenktiler	Tense
kurban	kurbanı	Case
geometriyi	geometri	Case
medreselerinin	gelmelerinin	lemma
indekse	indeksin	Case
matlaydık	matlayım	Tense
nal	dişlek	lemma
fiziğin	fiziğe	Case
kılavuzunuzda	kılavuzunuza	Case
trafiğe	trafiği	Case
dövüşmeyiz	dövüşmem	Number
yazı	yazıya	Case
tüylerine	tüyüne	Possession
polenler	polenlerdik	Tense
yönelmeyi	yönelme	Case
vurmazsınız	vurmadınız	Tense
şövalyelerden	şövalyeden	Number
bahtsız	bahtsızsın	Person
pipetler	geyşalar	lemma
yolunuyorsunuz	yolunuyorsun	Person
hedefte	ölümde	lemma
hayvana	hayvanı	Case
taklitçiydi	taklitçi	Tense
misketti	çeteydi	lemma
amacınızda	amaçlarınızda	Number
üniversiteleri	üniversiteyi	Number
yürekler	yürek	Number
sözcüklerinden	sözcüklerini	Case
geleceğiz	geliriz	Tense
ümitliydik	ümitliyiz	Tense
kir	kiri	Case
çiçekçilerde	çiçekçileri	Case
abartmayacaksınız	eğilmeyeceksiniz	lemma
kutlamalara	kutlamaları	Case
taraflarına	tarafına	Possession
canlandırtmam	canlandırtmayacağım	Tense
dut	dutlar	Number
cennetlerden	cennetten	Number
ablalarsın	ablalardınız	Tense
sapanlardık	sapanlarım	Tense
hükûmetlermiş	çiçelermiş	lemma
büyükmüşler	büyükmüşsün	Person
sihirliymişiz	sihirliymişim	Person
kırıldı	yonttu	lemma
yetmeyeceğiz	yetmeyeceksin	Person
yazarı	yazar	Case
eziyetlerin	eziyetlerinden	Case
cibinliklerimizde	cibinliklerinde	Possession
çeyreklerde	çeyrekte	Number
pilavlardık	pilavlarsın	Tense
taykonotunda	taykonotumda	Possession
fahişeliğe	fahişelikte	Case
bitirttirmiyorum	bitirttiriyorum	Polarity
füzelerden	füzelerde	Case
deveden	devede	Case
pederlerinden	pederinden	Possession
polisinize	avukatınıza	lemma
iletkenlere	iletkenlerin	Case
pilavdık	ziyarettik	lemma
durağım	duraktı	Tense
kristallerin	kristallere	Case
hazineleri	hazineyi	Number
taciz	tacizler	Number
kalplerinden	kalbim	Case
müellifdim	müellifsin	Tense
prototip	prototipte	Case
levyelerde	levyeleri	Case
umutluymuşsunuz	diriymişsiniz	lemma
tarafta	tarafa	Case
ağlarını	ağını	Possession
olumsuzluğun	olumsuzluk	Case
teknolojide	teknolojiyi	Case
maskaralardım	maskaralardır	Tense
aktrisler	örnekler	lemma
isimsizmişim	isimsizmişiz	Person
menekşeler	menekşeydin	Tense
sağrılarını	sağrımızı	Possession
bahtı	baht	Case
bamyalarınıza	bamyalarına	Possession
ayinin	ayinlerin	Number
hukuku	hukuk	Case
sayar	öldürtür	lemma
kılıca	kılıç	Case
köpeğe	köpeklere	Number
peynirinden	çölünden	lemma
iffetlere	iffetler	Case
çevrede	çevreden	Case
oduna	odunlara	Number
hayırseverlerdi	hayırseverlersin	Tense
başarılıymış	başarılıymışım	Person
kuklanın	kuklaların	Number
mukavemetleri	mukavemeti	Number
notlar	notlara	Case
robotu	robottan	Case
umuyoruz	umuyorum	Number
hazine	hazinede	Case
örslerini	örslerinizi	Possession
cevheri	cevherden	Case
hikâyelerde	hikâyelerin	Case
kardeşler	kardeşlerdi	Tense
jeolojiye	jeolojinin	Case
parçalandılar	çıktılar	lemma
kutuma	kutunuza	Possession
süpürge	süpürgenin	Case
varoşlarından	varoşlarının	Case
sığmıyordun	ısırmıyordun	lemma
hamamların	hamamları	Case
homoseksüel	devir	lemma
pişiyordunuz	öldürtülüyordunuz	lemma
psikiyatristler	psikiyatristlerde	Case
tabaklardan	tabaklara	Case
yapıyordu	yarıyordu	lemma
havuzlarımızda	havuzlarımızın	Case
olumsuzlukların	olumsuzluğun	Number
çanlar	çanlardık	Tense
oylarının	oyunun	Number
eğrilere	eğrileri	Case
helikopterleri	helikopterlerin	Case
ayvazlardın	ayvazlar	Tense
mektubunda	faresinde	lemma
alfabede	alfabelerden	Number
telaffuzunda	telaffuzumda	Possession
biçimin	biçimlerin	Number
dünya	dünyanın	Case
geçmeleri	geçmelerinin	Case
bulunmanın	bulunmadan	Case
sıcaklıkların	sıcaklıkları	Case
manada	boyunda	lemma
animasyonlarının	animasyonumun	Number
karılardın	yönlerdin	lemma
heteroseksüel	heteroseksüeldiler	Tense
inanmadın	dadanmadın	lemma
sporcularmış	dumanlarmış	lemma
sıçanlarmış	sıçanmışsınız	Number
dişinin	dişi	Case
tatillerin	tatilin	Number
yönelimin	yönelime	Case
idadiler	idadileri	Case
arşivlerin	arşivlere	Case
mıknatısların	yapımcıların	lemma
verniğinize	verniklerine	Possession
nura	nurun	Case
neşemden	neşelerine	Case
yazmadınız	yazmayacaksınız	Tense
sıcaklıkları	sıcaklığı	Number
antropolojiden	antropoloji	Case
damlalarda	damlalardan	Case
sorumluluklarını	sorumluluklarının	Case
kuşkonmazlarımı	kuşkonmazlarının	Case
sunucunun	sunucuya	Case
tozsun	tozdum	Tense
iguanaları	iguanalarda	Case
leşlerdin	leşlerdir	Tense
götüm	temsilciyim	lemma
daldırmayacak	daldırmayacaksın	Person
rokette	rokete	Case
alındırttım	alındırttı	Person
röpörtajların	arzuhalcilerin	lemma
iskeletleri	iskeletler	Case
kukularda	kukulara	Case
düzmeyiz	düzeriz	Polarity
heyecanlandırırım	yağarım	lemma
zarftan	zarfın	Case
kafatasından	kafatasına	Case
parçacıklarından	fikirlerinden	lemma
savunurlar	savunurum	Person
porsuğundan	bakirinden	lemma
bulutta	buluta	Case
perukları	peruklarında	Case
fakültende	fakültelerinde	Number
füzelerde	füzede	Number
demliyeceğiz	demlemeyeceğiz	Polarity
kaynaçlarının	figüranlarının	lemma
lokantalarını	bilyelerini	lemma
insanlığın	insanlığa	Case
gütüyordum	yarıyordum	lemma
isimsizsiniz	üzgünsünüz	lemma
paradoksun	paradoksu	Case
teknoloji	teknolojiyi	Case
devirsin	devirdin	Tense
duanın	dua	Case
homurtularımda	homurtularınızda	Possession
lezyonuna	zaferine	lemma
karantinalarını	ünlerini	lemma
ilişkiler	düğmeler	lemma
güzelliğe	güzelliğin	Case
benzeyeceksiniz	benzeyecek	Person
hareketlilik	anjiyo	lemma
içgüdüleri	içgüdülerin	Case
çölleri	çölüm	Number
beklemeyi	beklemenin	Case
seçmenlerinden	eğlencelerinden	lemma
politikaları	politikayı	Number
lepistesinde	lepistesinden	Case
çöpleri	çöplerin	Case
ilklendirmeydi	ilklendirmeyiz	Tense
istatistiğin	istatistiklerin	Number
kelimelerinde	kelimelerini	Case
hücrenize	damadınıza	lemma
kumaştan	kumaşta	Case
politikalarda	politikalara	Case
günlerim	günleri	Number
sandalyelerden	sandalyelere	Case
boğazlarında	boğazlarına	Case
yağa	yağı	Case
kobralar	kobra	Number
anlarını	anları	Case
mucize	disko	lemma
dutların	dutlardan	Case
maçınıza	maçımıza	Possession
fırınlarız	fırınlardınız	Tense
ikazdın	ikazım	Tense
sınavlara	sınavları	Case
hamama	hamamın	Case
lügatlerinden	ananaslarından	lemma
tekliflerdik	yavrulardık	lemma
adalelerim	taklitçileri	lemma
gizemlerimize	gizemlerimizde	Case
kümesler	kümeslerdi	Tense
kamuslarından	kamuslarının	Case
anarşiye	anarşinin	Case
sevaplarının	sevaplarımızın	Possession
manitalardır	manitalardın	Tense
kuruyorsun	büktürtüyorsun	lemma
kameraydılar	kamerayım	Tense
kazılarına	kazılarınıza	Possession
sıpalarından	sıpalarımdan	Possession
zombiler	zombileri	Case
paparazilerin	paparazilerinin	Case
büyüklükten	büyüklüğün	Case
geyleriz	geylerdin	Tense
ekonomistler	ekonomist	Number
abajurlarının	abajurları	Case
sileceksin	şaşıracaksın	lemma
fiile	fiilden	Case
mandalinalar	totemciler	lemma
kaçırmadık	geçmedik	lemma
seçenek	seçeneği	Case
savaştık	savaşacağız	Tense
lunapark	çap	lemma
umarlar	umarız	Person
yapmadın	bilemedin	lemma
merkeze	merkezlere	Number
mısırlarımızda	bloglarımızda	lemma
lensleri	lenslerden	Case
dikişimizin	dikişlerinin	Possession
otomobillerimize	otomobilimize	Number
sağduyunun	çişin	lemma
kiliselerinin	üzümlerinin	lemma
programlanırız	üşeniriz	lemma
süpürgeyi	süpürge	Case
fiiller	fiillere	Case
ninniymişim	vidaymışım	lemma
aldatırlar	dolarlar	lemma
deveden	deve	Case
ejderhalarsınız	ejderhalardım	Tense
giysinin	giysisinin	Possession
yanmayacaksın	ısırmayacaksın	lemma
sosyolog	sosyoloğun	Case
değişikliklere	değişikliklerde	Case
günlerinde	dondurmalarımda	lemma
kargalardan	kargalarda	Case
lenslerde	lenslerden	Case
çaydanlığın	çaydanlığı	Case
belirteçler	belirteçlerde	Case
iletilerin	iletiler	Case
liseleri	liseyi	Number
akifer	akifere	Case
arşivde	arşiv	Case
entegrasyona	entegrasyonun	Case
ayrılma	ayrılmadan	Case
adlarından	çiçelerinden	lemma
yeteneklisin	yeteneklisiniz	Number
süzer	damlar	lemma
ibnemizde	ibnemizi	Case
eskedi	eskemedi	Polarity
külahlarımızdan	yüksüklerimizden	lemma
yorgunluğa	yorgunluğu	Case
dürüme	dürümde	Case
şehvetlerinde	şehvetleri	Case
savaşmıyorum	üremiyorum	lemma
yağmanızdan	yağmamdan	Possession
huzurunuzdan	huzurlarınızdan	Number
değerliymiş	değerliymişler	Number
kalabalıkların	kalabalıklar	Case
merkezi	merkezin	Case
omletlerden	tuşlardan	lemma
polislerin	baharatların	lemma
seçiyorduk	donduruyorduk	lemma
koltuğu	koltuğun	Case
patronlar	ayvazlar	lemma
mitokondrileri	fetvaları	lemma
kanal	kanallar	Number
gösterilerin	çiftliklerin	lemma
meşalelerdik	aznavurlardık	lemma
seslenmeyiz	dövmeyiz	lemma
mühendislerdiniz	dullardınız	lemma
tuğlaların	tuğlaları	Case
bencilliğin	bencillik	Case
bükerim	yontulurım	lemma
artıyor	artmıyor	Polarity
gerinizden	gerinden	Possession
kovduracak	kovduracaksınız	Person
yüzüncülerini	yüzüncülerinin	Case
gökdelenden	gökdeleni	Case
sualimizde	sualinde	Possession
mikrofonda	mikrofona	Case
dumanlardır	dumanlardı	Tense
aksisedanın	aksisedalarının	Possession
kantolarda	kantoda	Number
hacılık	hacılığı	Case
doğalara	doğaların	Case
ortağını	ateşini	lemma
lazerler	lazerleri	Case
sessizliğin	sessizliği	Possession
şaşırıyorsunuz	şaşırıyorum	Person
fanuslarımızda	fanuslarında	Possession
akrobatlarsınız	akrobatlardınız	Tense
etkiyi	etkiden	Case
günde	günlerde	Number
kemanın	kemanı	Case
mühendislikte	mühendisliğe	Case
ortaklarını	ortaklarından	Case
yazmam	yazmalarının	Case
avantajlara	avantajlar	Case
mısraları	boksları	lemma
ünlerimde	ünlerim	Case
tutkuların	tutkunun	Number
uçmazsınız	yaratmazsınız	lemma
saklıyorum	çiziyorum	lemma
kirişe	betiğe	lemma
dönemlerinden	dönemlerine	Case
ağaçlara	ağaçları	Case
okulu	okulum	Possession
melodiden	melodide	Case
kotanjanttan	kotanjantın	Case
pilavlarımıza	varoşlarımıza	lemma
yeterliliksin	yeterlilikti	Tense
kalamardınız	babasızdınız	lemma
salatalarından	bükmemelerinden	lemma
gübreleriz	yakınlarız	lemma
parıltılar	yolcular	lemma
memleketlerinde	araçlarında	lemma
kuyruğunu	kuyruklarını	Number
pencereye	pencerelere	Number
hamamlardan	hamamları	Case
halkında	teklifinde	lemma
bademin	bademiniz	Possession
kızlıklarından	eniştelerinden	lemma
sayımların	artıkların	lemma
akşamından	akşamını	Case
tuğlanın	tuğladan	Case
listeniz	listenizi	Case
robotu	robotları	Number
abiyelerin	abiyelere	Case
kokarcalardan	kokarcadan	Number
telesiyej	telesiyeji	Case
keşkeklerimize	keşkeklerine	Possession
zürriyetine	zürriyetinize	Possession
sancağın	sancaktan	Case
kaynaştırtılıyorsunuz	büktürtüyorsunuz	lemma
süngüden	süngüye	Case
aktristim	aktrisim	Tense
milyonerler	vahalar	lemma
iblis	zombi	lemma
okunaksızlıkta	okunaksızlık	Case
şahmerdanlarımızı	şahmerdanlarımı	Possession
kadınlığın	kadınlığı	Case
sargıyız	sargıydık	Tense
mevsimlerde	mevsimlerden	Case
dörtgenin	dörtgen	Case
sözcüğümüzden	dışkımızdan	lemma
tercümenin	tercüme	Case
mukavemetlerden	mukavemetler	Case
ortaların	gafletlerin	lemma
seçmeleriniz	seçmelerinize	Case
toplumunuzda	toplumunuzun	Case
dikişlerimizi	dikişlerimizin	Case
geylerimden	geylerine	Case
davranmadılar	davranmadık	Person
girdaplardı	girdaplarım	Tense
efeleriz	efelerdik	Tense
sapanlardınız	sapanlarsın	Tense
rakını	evciğini	lemma
rimelimizin	rimelimizden	Case
yağların	yağın	Number
yıldırının	yıldırıların	Number
siklere	embriyolara	lemma
değil	değili	Case
matruşkalarda	matruşkaların	Case
ayinleri	ayinlerden	Case
aldırttı	gizlendi	lemma
kartında	kartın	Case
endüstrilerden	endüstriler	Case
şarkıcılığa	şarkıcılık	Case
ayırıyorum	ayırıyor	Person
mesafeye	mesafelere	Number
bölgelerdir	bölgelerdi	Tense
artıklarında	artıklarımda	Number
göçerler	bükerler	lemma
âlimlerinden	âlimlerinin	Case
kosinüse	kosinüsün	Case
katalogların	bütünlerin	lemma
ahtapotun	gelinin	lemma
moleküllerinde	moleküllerinin	Case
paraların	paralarda	Case
şarkıcılardınız	şarkıcılarız	Tense
tenisçiydiler	tenisçiyim	Tense
bozayılarız	bozayılardınız	Tense
kaldırımına	öksürüğüne	lemma
dişleklerin	dişleklerinden	Case
deneyime	deneylerinde	Case
kurbağayız	kurbağaydılar	Tense
kelimenin	öznenin	lemma
altıgenler	altıgenlerden	Case
teknolojileri	teknolojiyi	Number
kulacın	kulaç	Case
kumaşlara	kumaşlar	Case
lokumumuzun	lokumumuzdan	Case
dülgerleri	dülgeri	Number
elmalarımın	elmalarımdan	Case
otomobilciydim	otomobilciyiz	Tense
hızlarını	camimi	lemma
hayırseverler	uzaklar	lemma
angutlarının	angutları	Case
sindirdi	sindirir	Tense
bacaktan	bacağın	Case
zombiden	zombinin	Case
sinüsün	sinüsü	Case
satarlar	öpüşürler	lemma
vurmadı	eğlenmedi	lemma
tecessüme	tecessümden	Case
tatilden	tatili	Case
mahzenlerini	mahzenlerine	Case
dilbilime	dilbilimi	Case
patlamalardan	patlamaları	Case
tasamdan	tasamın	Case
fırtınalarının	fırtınalarımızın	Possession
hecinleri	hecinler	Case
sucuklarım	sucuklarını	Case
kalkana	kalkanda	Case
mumyaydın	yoğurtçuydun	lemma
sığmıyorsunuz	sığmıyorlar	Person
albatroslarımda	albatroslarında	Possession
çevreye	çevrelere	Number
seçmelerin	viskilerin	lemma
avlar	avlardı	Tense
kavunumuzdan	kavunundan	Possession
proxylerde	totemlerde	lemma
kısrak	kısraklar	Number
bilyelerdir	bilyelerdi	Tense
basketbolculardan	basketbolculara	Case
kilimleri	tangaları	lemma
eşyam	eşyalarını	Case
kutuyu	üstveriyi	lemma
damlanın	damlaya	Case
yönelimler	yönelim	Number
azmıyor	azmıyorsunuz	Person
yakutlarda	yakutları	Case
piramidin	piramitlerin	Number
bürokrattan	bürokratın	Case
angutlarına	angutları	Case
ayranın	ayrana	Case
kukladan	kuklanın	Case
söyleşilerinden	söyleşilerimden	Number
sundu	düşündü	lemma
bitkileriz	bitkilerdi	Tense
palyaçosun	palyaçoydunuz	Tense
nedenim	nedendik	Tense
vapur	vapurduk	Tense
dayanıklılığa	dayanıklılık	Case
değişikliklerde	değişiklikte	Number
umutluymuşuz	umutluymuşlar	Person
silgilerdi	silgiler	Tense
ailelerde	aileleri	Case
şikayete	şikayet	Case
gitarının	gitarından	Case
monarşide	monarşilerde	Number
ünlüleri	ünlüler	Case
iskeletlere	iskelete	Number
hayvan	hayvanın	Case
hedefi	cini	lemma
zaferlerim	zaferlerdin	Tense
imambayıldılarını	şişliğimi	lemma
gözlemciye	gözlemciyi	Case
bluzlunuz	bluzlumuz	Possession
kenarlarımı	geceliklerini	lemma
aynştaynyumumdan	aynştaynyumumda	Case
sinüse	sinüslere	Number
misketlerdiniz	yuvalardınız	lemma
lokumlarına	ucubelerine	lemma
savaşınızı	şalınızı	lemma
sevgililer	fahişeler	lemma
sarhoşu	sarhoşları	Number
kahvenin	zakkumun	lemma
sorusunun	sorunuzun	Possession
karganın	kargaların	Number
büyüleyici	büyüleyiciyim	Person
aşçılarına	aşçılarınıza	Possession
parlatır	duyar	lemma
lezbiyenlerdir	lezbiyenlerdiniz	Tense
derecemize	derecesine	Possession
odun	odunun	Case
kavunlardı	kavunlar	Tense
çığına	çığınıza	Possession
tuşları	tuşlara	Case
nedimeydim	nedimesin	Tense
gökadalarda	gökadaları	Case
kuşlarımı	kuşlarını	Number
hedeflerden	hedeflerin	Case
korkacağım	doğrayacağım	lemma
sağacaklar	yoğuracaklar	lemma
güllaçlar	güllaçlarda	Case
tabakların	tabağın	Number
bireyin	bireye	Case
hazırlıklara	hazırlığa	Number
klorofile	klorofil	Case
kağıtlardan	bellerden	lemma
müzede	müzenin	Case
kumaşta	kumaşa	Case
fiile	fiillere	Number
kemeri	kemer	Case
elementin	elemente	Case
yönelimden	yönelimde	Case
kaynaştırdınız	azdınız	lemma
sakızlarınızı	düdüklerinizi	lemma
takılardınız	takılarım	Tense
madalyadan	madalyalardan	Number
patronunuzda	bahçenizde	lemma
jokeyimden	jokeyimizden	Possession
işçilerimizden	yalanlarımızdan	lemma
erdemliymiş	erdemliymişsin	Person
şemsiyenizin	şemsiyenizi	Case
alevlerdir	alevlerdiniz	Tense
kelliklerde	garplarda	lemma
hanımlardım	balinalardım	lemma
taştık	bitirdik	lemma
portu	portuna	Case
keserydılar	fişektiler	lemma
kalkanlar	kalkanların	Case
kefirinin	kefirinizin	Possession
sınavı	sınava	Case
damatları	damadı	Possession
mantıksız	mantıksızlar	Number
denizyıldızlarında	denizyıldızlarından	Case
beklemede	beklemenin	Case
bilirler	bilirsin	Person
cevherden	cevhere	Case
binekdik	binekler	Tense
kavramların	kavramlarda	Case
şimşeklerden	şimşeklerde	Case
acemilerinize	düldüllerinize	lemma
kuruyacaksın	kurumayacaksın	Polarity
pandalar	pandaları	Case
okiyalardı	yeterliklerdi	lemma
vücutlar	vücutların	Case
tatbiklerinden	tatbikimin	Case
buzukime	buzukinize	Possession
kırdırtıyordum	diriyordum	lemma
araçtı	araç	Tense
uykunun	uykuyu	Case
paralelkenarda	paralelkenarlarda	Number
kolonyalarımız	kolonyaları	Possession
yasağım	yasağımdan	Case
polendiniz	polensin	Tense
toplayacaksın	ekşiyeceksin	lemma
kanmayacağım	açılmayacağım	lemma
örtüsün	örtüydü	Tense
kulağında	aynasızında	lemma
hazine	hazineyi	Case
iğrenmezler	iğrenmem	Person
toplumları	toplumu	Possession
kaygıları	kaygılardan	Case
sultanlarmışsın	benzerlermişsin	lemma
dikiş	dikişler	Number
kapatmadım	örmedim	lemma
kulüplerden	kulüplerde	Case
saat	saatten	Case
babacansınız	babacandınız	Tense
polenlerdin	çağanozlardın	lemma
kılıklara	kılığa	Number
ilklendirmelerin	ilklendirmeler	Case
fabrikalar	fabrika	Number
manalarım	vekillerim	lemma
dede	dedeye	Case
satrançlarımın	satrançlarını	Case
dilbilimlerde	dilbilimde	Number
bağlardı	bağlarsınız	Tense
klostrofobi	klostrofobiler	Number
romanlarına	romanlarında	Case
musonlardan	musonlara	Case
korkutacaklar	korkutmayacaklar	Polarity
helikopterin	helikopterden	Case
ısırığın	ısırıkta	Case
arşivlerin	arşivlerde	Case
içeceğine	içeceğinin	Case
paradoksu	paradoksları	Number
jeolojiyi	jeolojinin	Case
taşaklarının	taşaklarında	Case
psikologlarda	psikologları	Case
civarları	civarlara	Case
korlarına	korlarınıza	Possession
sürüyecek	çalacak	lemma
zahmete	zahmeti	Case
imreniyoruz	canlanıyoruz	lemma
sunucusunuz	yoldaşsınız	lemma
fizikçiyiz	fizikçiydiniz	Tense
arzı	arzda	Case
odalarının	bacalarının	lemma
ayvazlarsın	ayvazlardı	Tense
diyorlardı	diyordunuz	Person
hamsterinin	falının	lemma
kızacaklar	devinecekler	lemma
madalyalara	madalyaya	Number
idaremizden	teşhisimizden	lemma
azınlıklar	azınlık	Number
şizofrenide	şizofreninin	Case
karpuzuna	tarihçisine	lemma
füzeler	füze	Number
beklemelere	beklemeleri	Case
memleketinin	zigguratının	lemma
evciğin	evciğimiz	Possession
meydana	meydanı	Case
yörüngesine	yörüngesinde	Case
metresimizi	metresini	Possession
sosyolojiyi	sosyolojileri	Number
öçlerimizin	öçlerimizi	Case
kurbağalamalarımı	bademlerimi	lemma
fiiller	fiillerin	Case
ittirtmiyor	daldırmıyor	lemma
elementten	elementi	Case
krakerlerimin	krakerlerine	Case
değişiklikten	değişiklikte	Case
boğada	boğalarda	Number
bulunmayı	bulunmanın	Case
bitkiydim	bitkiler	Tense
yetkimde	yetkilerine	Case
ziyaretlerdi	ziyaretleriz	Tense
dönüyorlardı	dönüyorlar	Tense
koltuğu	koltuktan	Case
maaşı	maaşa	Case
bulutlarda	bulutlara	Case
bacakları	bacakların	Case
katkılarda	katkıların	Case
tekfurunu	tekfurumuzu	Possession
ekşittiler	ekşitti	Person
kullanılmıyordunuz	kullanılmıyordun	Person
kafatasına	kafatasını	Case
kayboldu	bitirdi	lemma
süssün	terapistsin	lemma
başarılıydılar	başarılıydı	Number
ittiler	barıştılar	lemma
hacılıkta	hacılıklarda	Number
kuyumcularda	kuyumculardan	Case
makarnamdan	erkecelimden	lemma
yapmayacak	beklemeyecek	lemma
madamım	madamımı	Case
karanlıkları	karanlığı	Number
sapanmış	balinaymış	lemma
yeteneklisiniz	erdemlisiniz	lemma
durakların	durakları	Possession
kıçından	kıçında	Case
hecini	hecinde	Case
çalışacaklar	çalıştılar	Tense
milyarderlerdir	milyarderlerdim	Tense
kartpostalı	tulumu	lemma
karşılar	karşıların	Case
künefeler	künefelerden	Case
sitelerden	uçaklardan	lemma
mesafenin	mesafe	Case
civara	civarlara	Number
vücutlarda	vücutların	Case
önyargılar	önyargı	Number
avantaja	avantajda	Case
verileceksiniz	ısınacaksınız	lemma
abajurumu	abajurlarını	Number
kartalımızın	çıktımızın	lemma
malamozlarında	malamozunuzda	Possession
örneksiniz	örnektim	Tense
âmânıza	âmâna	Possession
ayinde	ayine	Case
sonralara	sonralar	Case
irdelediniz	bulundunuz	lemma
istatistiğe	istatistikte	Case
hayvandan	hayvanı	Case
kefallarına	eriklerine	lemma
sosislersiniz	sosislerdi	Tense
karalamaya	karalama	Case
eklerime	eklerimize	Possession
kanserin	kanser	Case
bürokratları	bürokratı	Number
terapistlerinizden	terapistlerimden	Possession
insanımsınız	çalışmanız	lemma
mezarlıklarınızı	mezarlıklarını	Possession
hatasın	çıraksın	lemma
kraliçenin	kraliçeden	Case
gereksinimine	gereksinimin	Case
mesuliyetin	dinozorun	lemma
ongunculuğuna	astronotuna	lemma
yakındı	yakın	Tense
sayfalandırmam	sayfalandırmalarım	Number
başlangıçlarımı	başlangıcımı	Number
çiftleri	çiftlerini	Case
yaklaşıyorduk	yıpratıyorduk	lemma
kuyruklarında	böğürtlenlerinde	lemma
sesçiliklerimizde	cücelerimizde	lemma
seyahatine	seyahatlerine	Possession
alacakaranlığın	alacakaranlığı	Case
körüm	kördüler	Tense
kemerin	kemerde	Case
yakutlar	yakutlara	Case
hızların	bazaltların	lemma
bulacaksınız	bulacaksın	Person
kirpikleri	kirpiklerin	Case
pazının	pazıyı	Case
kaynaştırttın	astın	lemma
canlandırılmaz	canlandırılmazsınız	Person
zibil	zibildin	Tense
serçenin	serçelerin	Number
panteistlerden	panteistler	Case
sözlüklersiniz	sözlüklerdim	Tense
duymamanızda	duymamanda	Possession
bitirttirmedin	bitirttirmedi	Person
bilginizi	bilgisini	Possession
durağız	duraktık	Tense
aldatıyordun	yoruyordun	lemma
çevreyi	çevreye	Case
baharatları	baharatı	Number
susuzluğa	susuzluk	Case
eğrilerin	eğriler	Case
paradokslardan	paradoksları	Case
başparmak	başparmakta	Case
şatolarında	şatolarını	Case
noktaları	noktaların	Possession
gökdelende	gökdeleni	Case
yedirtiyor	yedirtiyoruz	Person
başparmakları	başparmağı	Number
helikopterlere	helikopterlerin	Case
gürgenden	gürgenlerden	Number
şırıngalarımız	şırıngaları	Possession
dalağına	dalağı	Case
sürdürülebilirlikten	sürdürülebilirlikte	Case
sürücüyüz	sürücülerim	Number
çukurun	çukurların	Number
ısımızdan	ısınızdan	Possession
başkanlarının	başkanlarını	Case
tacımdan	tacından	Possession
uluslarımdan	uluslarında	Case
mitokondrilerde	mitokondrilerden	Case
kolyenin	başparmağın	lemma
kolonları	kolonlarda	Case
hastalığımızdan	hastalıklarımızdan	Number
lense	lensi	Case
iftitahlarınızdan	evlatlarınızdan	lemma
yapımcılar	yapımcı	Number
tartıyorlar	tartıyorsun	Person
çapalarının	çapamı	Case
ayinlerde	ayinlerden	Case
palmiyelerine	palmiyene	Possession
kullanışı	cebi	lemma
kertenkelenin	kertenkeleye	Case
bilgisayarlıymışlar	bilgisayarlıymışsın	Person
vardı	dirildi	lemma
lenslere	lensleri	Case
alkolün	alkolde	Case
topikleri	topiğim	Number
burnun	burnunun	Case
serçelerin	serçeler	Case
düğmenin	düğmeden	Case
albümleri	albümlerde	Case
palindromunda	bilyende	lemma
bisikletimizde	bisikletimize	Case
öküzlersin	öküzlerdiniz	Tense
güveniyorlardı	dürtüyorlardı	lemma
saçlarını	saçlarına	Case
ongunculuğumuzu	ongunculuğumuz	Case
mucizeydiniz	çıraktınız	lemma
pencere	pencerenin	Case
delilersiniz	delilerdi	Tense
pirincim	pirinçtin	Tense
alışmayacaksınız	öksürmeyeceksiniz	lemma
kanatların	kanatlar	Case
yetersizlik	yetersizliktim	Tense
monarşilerin	monarşinin	Number
civara	civar	Case
fahişe	fahişeye	Case
ipinden	ipimizden	Possession
adaletten	adalete	Case
duraktım	durağım	Tense
arayüzde	arayüze	Case
moronlardan	moronlara	Case
konuştaylar	konuştaylarda	Case
kâinatı	kâinatım	Possession
ütüydünüz	ütüyüz	Tense
yolundan	yollarından	Possession
yerleşmeyecek	yerleşmeyeceksin	Person
fabrikada	fabrikalarda	Number
duaların	dualara	Case
kustun	kustum	Person
sapıklıklardan	sapıklıklarda	Case
sezmezsin	deşmezsin	lemma
yolculuklarını	yolculuğunu	Possession
deveyi	deve	Case
dayamıyordular	dayıyorlardı	Polarity
temsilcilerini	temsilcileri	Case
kazandılar	kazandın	Person
ödevleri	ödevi	Number
kertenkelede	kertenkelenin	Case
fiile	fiili	Case
kasidesi	devi	lemma
zibilinizde	zibilimde	Possession
topluluklarınızı	topluluklarınızdan	Case
alametlerdir	alametlerdim	Tense
yarışlardan	yarıştan	Number
işletmenizde	işletmelerinizde	Number
hedef	hedefte	Case
derdik	dereceğiz	Tense
ofislerinize	ofislerimize	Possession
peçetelerdiniz	peçetelersiniz	Tense
zorluklardan	zorluklara	Case
öğrenecek	öğreneceğim	Person
sekmezler	sekmem	Person
ikazlardır	yasaklardır	lemma
rakamdan	yangından	lemma
ziyaretlerim	ziyaretlerdi	Tense
müzisyenlerine	cinlerine	lemma
birleşirsiniz	birleşiriz	Person
yarışta	yarış	Case
hamamların	hamamın	Number
damlaları	damlayı	Number
şemsiyesi	şemsiyesinin	Case
körlerdim	körlerim	Tense
hidratlar	hidratları	Case
hedonizmlerinizi	deistlerinizi	lemma
kuramda	kuramlarda	Number
ünlüleri	ünlüyü	Number
yalanlarından	yalanlarına	Case
robotun	robottan	Case
toplamayacak	toplamaz	Tense
sıvılaştırıyoruz	bunuyoruz	lemma
insanlıktan	insanlığın	Case
aktrislerdiniz	aktristim	Number
düğününde	düğünlerinde	Possession
şaire	şairlere	Number
teşkilatlarımıza	teşkilatlarına	Possession
gömleğimizde	gömleğimde	Possession
mükemmelliklere	mükemmelliklerin	Case
kurullarınız	kurullarınıza	Case
bastırmalarınızda	bastırmalarında	Possession
sıkıntıyı	sıkıntının	Case
koltuk	koltuğun	Case
karakterler	bölgeler	lemma
kilerimizi	yankımızı	lemma
hedonizmlerden	terapistlerden	lemma
sermiyordu	doğmuyordu	lemma
akışın	akışını	Case
fahişelikte	fahişeliklerde	Number
arındım	arındı	Person
deneyimden	deneyinden	Possession
atlambaçlar	atlambaçları	Case
masumdular	masumdum	Person
yontacaksın	yontacağım	Person
forumdaşsınız	forumdaştılar	Tense
mikrofonlarda	mikrofonlara	Case
klorofillerin	klorofillerde	Case
dükkânlarının	dükkânlarında	Case
kir	usta	lemma
acemiye	entrikaya	lemma
şapka	şapkada	Case
taykonotlardım	veterinerlerdim	lemma
kervansarayda	kervansaray	Case
yorgunlar	yorgun	Number
kazağın	kazakta	Case
biftekkekten	biftekkeke	Case
rüyasın	rüyaydık	Tense
Arap	Arap'da	Case
çevreden	çevreyi	Case
patronmuşsun	eşcinselmişsin	lemma
utku	utkudan	Case
kanıtlayacaklar	eskeyecekler	lemma
sporcusu	yeleği	lemma
sülükleri	sülüğü	Number
canlanılıyordunuz	canlanılıyordum	Person
yongalarınıza	yongalarına	Possession
akışkanın	akışkanı	Case
çakalların	çakallarının	Case
ayazın	ayazların	Number
deliklerinden	deliğinden	Number
dilbilim	dilbilimi	Case
ablalardın	ablalar	Tense
tıkmıyordunuz	yaratmıyordunuz	lemma
zurnamın	zurnamızın	Possession
politikalar	politikalarda	Case
oligarşilere	oligarşileri	Case
kemanınızın	kemanının	Possession
butonlar	buton	Number
bakireliğin	bakirelikten	Case
huzursunuz	huzurdu	Tense
hesapları	hesabı	Number
kurbanın	kurbanların	Number
galaksileri	galaksilerin	Case
acıktım	öğrettim	lemma
haremlikler	haremlik	Number
yoldaşsın	yoldaştım	Tense
acıdılar	doğdular	lemma
tayfalardım	yumuşakçalardım	lemma
kertenkelenin	kertenkele	Case
bataryalardır	bataryalardık	Tense
ekim	ekime	Case
krallığı	krallıkları	Number
bay	baydılar	Tense
çözeltiniz	çözeltin	Possession
bölgesin	bölgeydi	Tense
yaralarını	yaralarınızı	Possession
dualara	duaya	Number
kobranın	kobraların	Number
izleyicisini	izleyicilerini	Possession
gömleğinde	gömleğimde	Possession
harçların	türevlerin	lemma
hedefin	hedefi	Case
sonrada	sonradan	Case
süsdüm	eziyetçiydim	lemma
katillerdik	katillersin	Tense
abazandık	abazandın	Person
ovuyorsun	bekletiyorsun	lemma
eyleme	eylem	Case
kiplere	kiplerin	Case
oyuncaktım	geydim	lemma
yuvalardır	yuvalardı	Tense
gergedana	gergedanlara	Number
alımlısınız	alımlıydınız	Tense
acılarsınız	acılardı	Tense
tarifimin	tarifleri	Case
ödevde	ödevlerde	Number
güreşçileri	dudakları	lemma
kumalar	kumaydı	Tense
otomobilcileriz	otomobilcilerdik	Tense
içerdiniz	geciktirtiniz	lemma
adaleti	adaletten	Case
belirtmeye	belirtmenin	Case
çığlığa	çığlık	Case
kısmayacağım	kısmayacaksınız	Person
klişesin	avsın	lemma
şövalyeye	şövalyeyi	Case
sezmeyeceksiniz	gidilmeyeceksiniz	lemma
okyanusu	okyanustan	Case
kanserlere	kanserlerde	Case
uçurtmaydık	uçurtmayım	Tense
işletimlerdim	işletimlersiniz	Tense
nihayetlerin	yarışların	lemma
şahıslarından	şahısları	Case
sözdiziminde	sözdiziminin	Case
şampiyonluğundan	şampiyonluğunda	Case
tanıtmıyorlar	çatmıyorlar	lemma
taşımaz	ağlamaz	lemma
gazeller	gazellerdin	Tense
uykuların	uykunun	Number
araçlardır	araçlardı	Tense
güvensizlikleri	güvensizliğin	Possession
geçinmedin	geçinmezsin	Tense
adsızlar	adsızdılar	Tense
kasımpatıların	kasımpatılardan	Case
cevheri	cevher	Case
merkezi	merkez	Case
yakutlar	yakut	Number
karıncalarız	terapistleriz	lemma
sessizliği	sessizliğinde	Case
nazenini	nazenin	Case
yalvarmadık	yormadık	lemma
ahizelerini	ahizenizi	Possession
maktaymışsın	maktalarmışım	Number
akifere	akiferden	Case
mesafeler	mesafelerde	Case
kurbanın	kurbanı	Case
gökada	gökadada	Case
kaybolur	gerer	lemma
koklamadınız	koklamayacaksınız	Tense
emniyetten	emniyet	Case
finalinden	finallerinden	Possession
zeytinimde	zeytinim	Case
ağaların	ağalarımız	Possession
telaffuzlardı	telaffuzlardır	Tense
erkeneksin	erkenekti	Tense
eğecekler	eğeceksin	Person
vasiyetleri	vasiyetlerden	Case
karneler	bakireler	lemma
mevzumu	mevzunuzu	Possession
sosyoloğu	sosyologları	Number
bitimdim	bitimsiniz	Tense
koltuklardan	koltuklar	Case
makinemin	makinesinin	Possession
eğrilerden	eğriden	Number
matruşkanın	matruşkaların	Number
kasarım	basarım	lemma
helikopteri	helikopterden	Case
sonlarına	sonunuza	Possession
egoizmlerden	egoizmler	Case
aşçımdan	aşçıları	Case
şerbetçiliklerinizi	şerbetçiliklerinizden	Case
saklayacak	saklar	Tense
raporlarımı	dükkânlarımı	lemma
cinsiyette	cinsiyetlerde	Number
izlencelerimizde	önemliliklerimizde	lemma
mermilerdim	mermileriz	Tense
bülbüllerdi	bülbüller	Tense
yazarlarda	yazarda	Number
bugünün	bugünlerin	Number
kokladık	kokladılar	Person
çeyreklerden	çeyrekten	Number
sürteriz	bulunuruz	lemma
zarf	zarflar	Number
parçamızda	parçanızda	Possession
gökkuşağını	gökkuşağı	Case
oğullar	çavuşlar	lemma
ikizleriniz	ikizlerinize	Case
tabakların	tabaklara	Case
fizyolojiler	fizyoloji	Number
nomofobilerin	nomofobilere	Case
antioksidanlardan	antioksidandan	Number
şairden	şairi	Case
doyumsuzmuşsun	doyumsuzmuşsunuz	Person
ummansın	ummandık	Tense
kokmayacak	bakmayacak	lemma
neşesini	fırınını	lemma
köpekte	köpek	Case
baklavamı	baklavalarını	Number
kolaya	finale	lemma
voleyboldan	voleybolun	Case
kullanım	kullanımı	Case
mesafelerden	mesafeleri	Case
madalyada	madalyalarda	Number
merkez	merkeze	Case
giysiydi	giysi	Tense
mandalinalar	mandalinalardı	Tense
sivilceme	sivilcelerinde	Case
savaşıyorum	buluşuyorum	lemma
nedenim	nedendim	Tense
prenslerdim	ecelerdim	lemma
namazımı	namazını	Possession
haşefene	haşefesine	Possession
politikalar	politikaları	Case
okula	dalgaya	lemma
ittiririz	demleriz	lemma
adaletlerden	adaletlerin	Case
gölleri	göllere	Case
yarışlara	yarışlarda	Case
nüfusları	nüfuslara	Case
duaların	duanın	Number
muşmuladan	muşmulanın	Case
dedelerden	dededen	Number
simyacılarda	simyacıları	Case
çavuşlardınız	çavuşlarım	Tense
odacığa	vaziyete	lemma
yazıtlarına	yazıtlarını	Case
sekreterleri	sekreterler	Case
tuzluymuş	tuzluymuşum	Person
kuvvetlerim	kuvvetlerdin	Tense
kahramanına	kahramanlarına	Possession
güveneceğiz	güvenecek	Person
şampiyonlukların	şampiyonluklarını	Case
bunarsınız	bunayacaksınız	Tense
bombacının	bombacıda	Case
huzurluydu	huzurlu	Tense
ilklendirme	böğürtlen	lemma
kalkanları	kalkanlara	Case
önemliliklerine	önemliliklerinin	Case
ettirecekler	ettirecek	Number
vuvuzelanın	vuvuzelaların	Number
klavyesin	Lefkoşalısın	lemma
monarşi	monarşiler	Number
içkilere	içkilerin	Case
trafik	trafikten	Case
hukuklara	hukukların	Case
lokmalarım	şemsiyeleri	lemma
damatlardık	damatlarım	Tense
tercümeler	tercümeleri	Case
mevsimden	mevsimin	Case
aktrislerdi	aktrislerdir	Tense
iyonosfer	iyonosferin	Case
kasarız	öpüşürüz	lemma
soylu	soylunun	Case
sarılacağız	sarılacağım	Number
Tiranlılar	Tiranlısın	Number
düşmanım	düşmanlarım	Number
savaşçılardın	savaşçılar	Tense
mezarlıklardı	mezarlıklardır	Tense
sayacak	büktürtecek	lemma
alfabeyi	alfabe	Case
tozlarımızdan	tozlarından	Possession
boyunları	boynu	Number
makyajımızın	makyajınızın	Possession
aileye	aile	Case
selamlar	selamlara	Case
maskaralarmışsınız	erkecellermişsiniz	lemma
okiyama	eldivenime	lemma
feneri	fenerleri	Number
samuraylara	samurayları	Case
köpürmeyeceksiniz	şamarlamayacaksınız	lemma
platformların	platformları	Possession
beyitleriz	beyitlerdiniz	Tense
cesetlere	cesetlerden	Case
katakullilerden	katakulliden	Number
tıklamıyordular	yitmiyordular	lemma
sinekliğin	tosbağan	lemma
kelimeydi	kelimeler	Tense
seyise	seyisten	Case
ablalardır	yönlerdir	lemma
lazeri	lazere	Case
huriler	uzaklar	lemma
seksiydim	seksiydin	Person
saksılar	saksı	Number
mügeyim	yelkenim	lemma
diskoteğimin	diskoteklerinin	Number
başkanının	başkanımızın	Possession
bireyler	bireyleri	Case
klişesinde	devingenliğinde	lemma
takvimlerinin	takviminin	Number
sonuçlarınızdan	gerilerinizden	lemma
acıtmayacaksın	yuvarlamayacaksın	lemma
kırmazlar	kırmaz	Person
hadislere	hadisler	Case
patlıcanların	patlıcanlardan	Case
biseksüellerdim	biseksüeldiler	Number
kullukların	devirlerin	lemma
fiziği	fizikleri	Number
utanmam	üşümem	lemma
belirtmeden	belirtmede	Case
pastırmasını	çırağını	lemma
ablaları	vezirleri	lemma
papatyalarım	papatyalardın	Tense
madalyadan	madalyada	Case
laternan	laternanın	Case
menekşelermişim	batılarmışım	lemma
yanlışmışım	yanlışmışız	Number
çiğdemler	çiğdem	Number
dalgıcında	dalgıcımızda	Possession
kahramanı	kahramanları	Possession
asmıyorum	asmıyorlar	Person
pipetlerimi	pipetlerimde	Case
köprüde	köprü	Case
saydırtıyorum	biliyorum	lemma
konuymuşsun	üyeymişsin	lemma
ehemmiyetliliğime	ehemmiyetliliğine	Possession
aynasızız	aynasızdı	Tense
koyulaşacağım	çarpacağım	lemma
sonlarını	gemilerini	lemma
volkanlarınız	volkanlarım	Possession
ısırdılar	ısırdın	Person
minarelerinden	finallerinden	lemma
antropolojiye	antropolojilere	Number
başarılı	başarılıyız	Person
albatroslarımızdan	albatroslarımızı	Case
Museviyiz	Museviydik	Tense
sakallarımızdan	sakalımızdan	Number
ahizenizi	ahizenize	Case
âmâlardım	âmâlardır	Tense
kovalardan	kovalar	Case
fındıkdılar	fındık	Tense
bireyleri	bireyi	Number
sülüğün	sülükte	Case
pompadan	duyudan	lemma
vajinaya	vajina	Case
kaygı	kaygının	Case
hareketliliğimizden	yangınımızdan	lemma
kapatmayacağız	yolunmayacağız	lemma
kümeslermiş	dövüşçülermiş	lemma
ucubemden	ucubelerini	Case
öbeklerine	öbeğine	Number
kuvvetsizliklerinizi	viskilerinizi	lemma
tarihçilerinde	tarihçilerimin	Case
yağlara	yağlarda	Case
miyolojinin	miyolojiye	Case
hemşiresin	balinasın	lemma
rokete	roketlere	Number
küvetleri	basları	lemma
kilisemiz	kiliselerimiz	Number
pozisyonlarından	pozisyonlarının	Case
yapışacağım	yapışacaksın	Person
masummuş	masummuşsunuz	Person
oynatıcınızı	bilyenizi	lemma
yorgunluk	yorgunluğu	Case
kuklaları	kuklalardan	Case
orospularımdan	orospularınızdan	Possession
gizlenmeyecek	gizlenmeyecekler	Person
kılıçlara	kılıca	Number
tebeşirler	tebeşirlerden	Case
bitkilere	bitkiye	Number
meydanlara	meydanlarda	Case
ittirtiyorlar	büktürtülüyorlar	lemma
otofobi	otofobiden	Case
civardan	civarın	Case
köpeği	köpek	Case
anket	anketler	Number
tozları	tozu	Number
arşivlerin	arşivler	Case
karakter	karakterdin	Tense
sonlardın	çiftlerdin	lemma
liseleri	liselerin	Case
kenarınızın	bitkinizin	lemma
banliyömüze	banliyölerine	Possession
peygamberdevelerinin	şantajların	lemma
galaksinin	galaksi	Case
ekonomistlerin	ekonomistleri	Case
korsanlardı	korsanlarsın	Tense
çiviyimde	çiviyimin	Case
fetva	fetvalar	Number
kümesini	altını	lemma
istiyorum	istiyorsunuz	Person
seksiymişler	büyülüymüşler	lemma
çıbanlarda	çıbanların	Case
çiçeni	çiçende	Case
akosmizmlere	akosmizme	Number
kanalın	kanaldan	Case
evleniyorum	evleniyorlar	Person
genelevler	genelevlerin	Case
götürüyordu	götürüyorlardı	Number
ıslaklıkları	ıslaklıklarda	Case
terliklerine	terliklerime	Possession
mantıklarda	mantıklara	Case
savaşçıydı	savaşçılar	Tense
öğrencinin	öğrencisinin	Possession
menekşelermişsin	ütülermişsin	lemma
kasını	kasında	Case
mühendisleri	mühendislerimiz	Possession
betiğimiz	betiği	Possession
orospuydum	orospusun	Tense
enjeksiyonlarınıza	enjeksiyonlarına	Possession
üniversiteye	üniversite	Case
aktöründe	deneyinde	lemma
psikiyatrlardan	psikiyatrdan	Number
yaklaştın	yaklaşırsın	Tense
yapman	yapmaları	Possession
koltuktan	koltuğa	Case
oturuyor	ettiriyor	lemma
sözcüsüne	cephesine	lemma
osuruyordun	geriniyordun	lemma
iner	bağlar	lemma
maymunun	maymunu	Possession
katkılar	katkılarda	Case
gözbebekleri	gözbebeklerinin	Case
pornosu	demircisi	lemma
ropdöşambırımı	ropdöşambırlarında	Case
girdaplardı	girdaplarsınız	Tense
som	soma	Case
makinaydılar	makinayız	Tense
deistinize	deistime	Possession
delilerdiniz	deliler	Tense
köçeğinizin	köçeğinin	Possession
kılmıyorsunuz	diremiyorsunuz	lemma
abazandık	başarılıydık	lemma
babasızlardınız	babasızlardır	Tense
simitleri	yumurtaları	lemma
Kopenhaglıydınız	Kopenhaglılar	Tense
tavukgötüne	tavukgötünde	Case
rüzgarın	rüzgarların	Number
iletkeni	iletken	Case
mükemmellikte	mükemmelliği	Case
köprüde	köprüden	Case
kaynaştırtmadı	bölmedi	lemma
panendeistlerdi	panendeistlerim	Tense
manalar	dublörler	lemma
damadımız	damadı	Possession
melodide	melodiye	Case
tabakları	tabaklar	Case
cadılara	cadıların	Case
ilçelerde	ilçede	Number
meydanda	meydandan	Case
kilisenin	şakanın	lemma
haçaları	haçalardan	Case
anketimi	anketinizi	Possession
süneriz	öğreniriz	lemma
kemençeye	kemençeyi	Case
Yahudilerdiniz	Yahudiler	Tense
argoda	argoyu	Case
kovada	kovanın	Case
mikroorganizmaydım	mikroorganizmalardık	Number
eylem	eylemden	Case
kromozomları	golleri	lemma
otomobilin	zulmün	lemma
değirmenlerini	değirmenlerinden	Case
sinirlendirirsiniz	örtersiniz	lemma
rebetikoların	rebetikoları	Case
sinmezsiniz	sinmeyiz	Person
anneannelerde	anneanneleri	Case
ikazız	öküzüz	lemma
azınlıklar	azınlıklardan	Case
gülünçleşmeyecekler	üretmeyecekler	lemma
aznavursun	aznavurduk	Tense
işitmediler	çökermediler	lemma
patlamalar	patlama	Number
sonra	sonralar	Number
alkışlarına	alkışlarınıza	Possession
yusufçuklar	yusufçuk	Number
korimboz	korimbozlar	Number
raporlarımdan	büyücülerinden	lemma
bağımlılığın	bağımlılığı	Case
aktrisinin	cumhurunun	lemma
külfetlerinizi	külfetlerinizin	Case
reçeller	reçel	Number
soğudum	geliştirdim	lemma
dansçıların	dansçılar	Case
pencereler	pencerelerde	Case
geometriyi	geometride	Case
konuklardan	konuktan	Number
işkencecilerdiniz	efelerdiniz	lemma
kıyılarından	kıyısından	Number
doymazsın	doymazsınız	Number
dutları	dutu	Number
akrabaları	altınları	lemma
şairden	şairin	Case
romanlarına	romanlarını	Case
jaguarda	jaguarı	Case
çokgenler	çokgenlerin	Case
türemeyeceğiz	şaşılmayacağız	lemma
tüttü	tüttüler	Number
tatlınıza	tatlıma	Possession
onarmayacağız	yaramayacağız	lemma
prenslerinde	önemsizliklerinde	lemma
kuvvetsizliğini	çözeltini	lemma
şahıslarının	şahıslarına	Case
cevizinden	cevizlerinden	Possession
pandeistlerdir	şerbetçilerdir	lemma
kalamarlarız	cisimleriz	lemma
sureleri	surelerin	Case
programlanır	biter	lemma
işçilere	aşklara	lemma
oltaları	telesiyejleri	lemma
sepetimde	sepetim	Case
karanlıkların	karanlıklarda	Case
korkutmuyordun	yazmıyordun	lemma
doğalarda	doğalara	Case
üçlüsünden	üçlüsüne	Case
tümörden	tümörü	Case
puro	cacık	lemma
ayrılmalara	ayrılmaya	Number
mezuniyetlerinde	yardımseverliklerinde	lemma
giderlerinde	giderlerinin	Case
dilimlerinin	dilimlerime	Case
enstrümantalinden	enstrümantallerinden	Possession
kalkanlarda	kalkanların	Case
sancağın	sancağa	Case
silkmeyeceğim	yendirmeyeceğim	lemma
yayıncılığımın	yayıncılığının	Possession
polisinin	bağının	lemma
monarşi	monarşiye	Case
kumaşa	kumaşlara	Number
güzellikler	güzellik	Number
jenerasyonu	büstü	lemma
tuttum	tutarım	Tense
özürlerinizin	özürlerinin	Possession
harfler	harflerde	Case
koltukları	koltuklar	Case
oğullarını	oğlumu	Number
yapmayacaklar	yapmadılar	Tense
semeriniz	tütsünüz	lemma
köylü	köylüydü	Tense
mitokondriden	deliden	lemma
takılarmış	basketbolcularmış	lemma
çekiçlerine	çekicim	Case
tatile	tatili	Case
sıfatlarından	sıfatından	Possession
evrimiz	evrimdi	Tense
boyacımı	boyacılarında	Case
sosyologlar	sosyolog	Number
kaçıyorum	çürüyorum	lemma
radyolardan	yorgunluklardan	lemma
ombudsmanlarsınız	ombudsmanlardı	Tense
yakşısınız	yakşı	Person
kapatırsın	üzersin	lemma
ilerletiyorduk	ilerletiyordunuz	Person
anketimize	anketlerine	Possession
ailelerden	ailelerin	Case
sağlayıcısına	basınına	lemma
nöronunuzdan	anjiyografinizden	lemma
açlıktan	açlığı	Case
akdoğanlar	akdoğanlardan	Case
hatalarında	hatanda	Possession
polenler	şüpheler	lemma
kiliselerinin	dükkânlarının	lemma
doluyoruz	doluyorum	Number
fiiller	fiillerde	Case
uyanırsınız	boşalırsınız	lemma
kurbanları	kurbanların	Case
bilginizi	bilgimizi	Possession
cacığı	cacık	Case
nedimemde	nedimeleri	Case
paradokslar	paradoksların	Case
erkekliğimin	erkekliğime	Case
sincabına	süspansuvarına	lemma
nutuklarımda	düğünlerimde	lemma
değişikliğin	değişiklikte	Case
çedarından	çedarı	Case
oğullarınızı	yüzüncülerinizi	lemma
mutsuzsun	mutsuzsunuz	Number
kalkanda	kalkanı	Case
kerpetenlerinde	dildolarında	lemma
rüzgarda	rüzgarlarda	Number
oturmuyorsunuz	yitmiyorsunuz	lemma
canlandırılmayacaklar	canlandırılmayacaksın	Person
hayırseverlerdin	hayırseverdiler	Number
saldı	etkiledi	lemma
alışmıyorduk	ağlaşamıyorduk	lemma
semerlerime	semerlerinin	Case
kapsamımız	kapsamları	Possession
yeniliyorsun	yeniliyoruz	Person
asansöre	asansörde	Case
geometrilerde	geometrileri	Case
umutlu	umutluydu	Tense
hiperbolü	çocukluğu	lemma
izliyordu	izliyorlardı	Person
kullanıcılar	tercihler	lemma
açlıkta	açlığın	Case
hardallar	hardalların	Case
mükemmellik	mükemmelliğe	Case
kırıtmıyordunuz	batmıyordunuz	lemma
parmaklarından	artıklarından	lemma
tuşa	tuştan	Case
bacakları	bacaklar	Case
dalgalarına	dalgalarının	Case
sunarım	evlenirim	lemma
semerci	eşcinsel	lemma
önyargıya	önyargıdan	Case
göllerin	göllere	Case
ilçelerde	ilçeler	Case
zombilerden	zombilere	Case
erkelerde	erkelere	Case
pozitronları	pozitronların	Case
ısırık	ısırıkta	Case
istemcilerimizin	istemcilerinizin	Possession
kelimelerdiniz	kelimelerdir	Tense
sürtecek	cezalandıracak	lemma
akışlarını	barajlarını	lemma
günebakanda	şimşekte	lemma
konukları	konuğu	Number
yorumlarımı	yorumlarını	Possession
kanattan	kanat	Case
kinematiklere	kinematiklerde	Case
hücreden	hücreyi	Case
dumanlarsınız	dumanlardı	Tense
dağları	dağın	Possession
demircilerdi	demircilerdir	Tense
kocaları	kocası	Possession
solucanı	bazaltı	lemma
smileyinin	smileyimin	Possession
kanser	kanserde	Case
ombudsmanı	belirteci	lemma
asıllarında	asıllarımızda	Possession
tatilden	tatil	Case
başarılı	başarılısınız	Person
kuşunu	dizemini	lemma
seçmendim	uçurtmaydım	lemma
yalamadık	dağıtmadık	lemma
şapkacılar	şapkacıydık	Tense
pop	poptan	Case
proxyi	proxynin	Case
yapılara	yapılarda	Case
bürokrasiye	bürokrasinin	Case
molekülleri	moleküllerine	Case
enfeksiyonunda	enfeksiyonundan	Case
acıydı	acıyım	Tense
titreşimlerin	titreşimlere	Case
şeriatlerinizde	şeriatlerimizde	Possession
cevher	cevherden	Case
külodum	külodumdan	Case
kaçaklarının	kaçaklarını	Case
hesapta	hesap	Case
yazarlara	yazarları	Case
yanağına	yanaklarına	Possession
sacı	sacdan	Case
akrepler	öğrenciler	lemma
rebetikoların	rebetikolardan	Case
iletmeyeceksin	yitmeyeceksin	lemma
diyorlardı	diyordu	Person
nedenlerden	duraklardan	lemma
hamsiye	hamsi	Case
yönelmenin	yönelme	Case
günahkârının	fotoğrafçısının	lemma
karanlık	karanlıklar	Number
eylemlerde	eylemlerden	Case
pena	eşcinsel	lemma
planeti	planetiniz	Possession
akrabalarımdan	akrabalarımın	Case
hümanizmlerden	hümanizmlerde	Case
meydanlar	meydan	Number
veriden	veriye	Case
mıhlarda	bamyalarda	lemma
menülerinde	menülerine	Case
dutların	dutlarda	Case
grubunuz	yapışmanız	lemma
sureler	surelerden	Case
hücreydi	evcikkırandı	lemma
patateslerinizi	patateslerinize	Case
yalvarmıyoruz	yırtmıyoruz	lemma
kattınız	daldırdınız	lemma
pedofobi	pedofobiler	Number
topun	topu	Case
heyecanlandı	gidildi	lemma
üniversiteye	üniversiteyi	Case
yapımcılardan	yapımcıları	Case
helikopterin	helikopter	Case
coşmayız	coşmam	Number
sağlar	sağlardı	Tense
zarf	zarfın	Case
otolardık	otolar	Tense
hesaptan	hesap	Case
sıcaklığı	sıcaklığın	Case
dolmuşum	dolmuşlarsınız	Number
nüfusa	nüfuslara	Number
korunmamızda	donatımımızda	lemma
mükemmellikte	mükemmellik	Case
otoydular	otolar	Tense
sosismişiz	fırınmışız	lemma
günlerine	elipsime	lemma
akışkanlar	akışkanlarda	Case
sıkıntı	sıkıntıdan	Case
politikanın	politikadan	Case
şapkacı	şapkacıydı	Tense
kaynaştırmayacaklar	atmamayacaklar	lemma
şurupları	şuruplar	Case
kondomlara	kondomlar	Case
havuzlarda	havuzları	Case
harfe	harfin	Case
pompaların	bıyıkların	lemma
yalanların	yalanın	Number
tatbiklerinden	tatbiklerinizden	Possession
denilmiyorum	denilmiyordum	Tense
bürokrasinin	bürokraside	Case
portakalını	ucunu	lemma
nur	nura	Case
yanlışlıklara	yanlışlığa	Number
sancakta	sancağa	Case
Duşanbelilersin	Duşanbelilerdi	Tense
üresi	üresinden	Case
zamanlarının	zamanlarımızın	Possession
yetkilerimde	yetkilerimizde	Possession
pipetler	baltalar	lemma
buzulunda	buzulunun	Case
tümceyiz	tümceydin	Tense
şövalyeyi	şövalye	Case
amcalarsın	amcalardık	Tense
okyanusta	okyanuslarda	Number
sayacağız	eğiteceğiz	lemma
küvetlerine	küvetlerinde	Case
savaşlarının	enjektörlerinin	lemma
kıskanmıyorsunuz	kıskanmıyorlar	Person
tümörlerde	tümörler	Case
kanala	kanaldan	Case
tırtılları	tırtıllar	Case
topta	top	Case
tuvaleti	tuvalette	Case
fundalar	funda	Number
koşucumu	koşucuma	Case
lahmacunları	lahmacunlarından	Case
notlarda	notları	Case
tesadüflere	tesadüflerde	Case
hacı	anason	lemma
karanlıklar	karanlıklardan	Case
penisilininde	şuurunda	lemma
not	notu	Case
lepisteslerinden	yalancılarımdan	lemma
kalfaymışız	totemciymişiz	lemma
armudu	armutları	Number
adalesinde	adalemde	Possession
sinmedin	bitmedin	lemma
acı	çırak	lemma
hatırlarımızı	hatırlarımızdan	Case
robotta	robottan	Case
papazdan	erikten	lemma
sökmeyecek	çıldırtmayacak	lemma
mutsuz	mutsuzsun	Person
element	elementler	Number
sarhoşlukta	sarhoşluğa	Case
yaya	yayaya	Case
kaçarsınız	kaçarsın	Person
tutuşturmayacağız	büktürtmeyeceğiz	lemma
seksiymişsiniz	büyülüymüşsünüz	lemma
çamları	çamı	Number
bakıcılarsınız	bakıcılardık	Tense
pikniğe	piknik	Case
sivilceydiniz	sivilceyiz	Tense
konseylerimizde	konseylerimiz	Case
alanının	alanını	Case
hemşirelersin	hemşirelerdin	Tense
mükemmelsiniz	beceriksizsiniz	lemma
teknolojiler	teknolojilerden	Case
zevaller	zevallerin	Case
şüpheleri	şüphelerde	Case
arayüzlerin	arayüzlere	Case
şimalim	şimalimden	Case
raketin	raketten	Case
arayüze	arayüz	Case
mumluklarını	mumluğumuzu	Possession
kuyuydunuz	kuyuyum	Tense
madalyalar	madalyaları	Case
odalarını	enstrümanlarını	lemma
rahipdim	rahibim	Tense
sapanlar	Mogadişulular	lemma
saldırmayız	canlandırılmayız	lemma
kıskanıyor	yıpranıyor	lemma
krallığın	krallıkların	Number
görecekler	öğrenecekler	lemma
üreticilerinizden	üreticilerimden	Possession
sığmayacağız	bükmeyeceğiz	lemma
jaguarlar	jaguarlardan	Case
mügeler	mügeydin	Tense
hikayelere	hikayeleri	Case
manitalarız	manitalardım	Tense
kameralarda	kameralardan	Case
yoldurtmuyordun	yoldurtmuyordunuz	Number
yedektin	yedekler	Tense
satırtmıyorsun	satırtmıyor	Person
seslendiler	seslendi	Person
gezmeyeceğim	gezmeyecekler	Person
yönelimlere	yönelimlerin	Case
yörenize	yörenizden	Case
altımın	altımdan	Case
karpuzlarsın	karpuzlardım	Tense
bombalarında	bombaları	Case
geometrileri	geometrilere	Case
katılıyorduk	dirilmeiyorduk	lemma
polenlerdir	düklerdir	lemma
somların	somları	Case
sarhoşluklardan	sarhoşluklara	Case
tercihlerine	tercihlerinden	Case
gözyaşlarından	gözyaşlarını	Case
oğullar	gayzerler	lemma
etlerine	etine	Number
vahaydık	vaha	Tense
yağda	yağlarda	Number
pusulalardım	pusulalardır	Tense
soyluların	soyluları	Case
ülkesine	ülkemize	Possession
şeylerdi	şeylerdir	Tense
topçularsınız	topçulardık	Tense
seçicilerimizin	seçicilerimiz	Case
gitarları	gitarım	Number
sandalyeleri	sandalyeler	Case
beceriksizdin	beceriksizdik	Person
mumluklarınız	tabansızlarınız	lemma
krallıktan	krallık	Case
ortalarsın	ortalardınız	Tense
orospuymuşuz	anasonmuşuz	lemma
minderi	minderden	Case
vapurmuşsun	vapurlarmışız	Number
gözyaşlarının	gözyaşları	Case
sanatçı	sanatçıya	Case
dereceyi	derecede	Case
gölgelerim	fibrinojenlerim	lemma
çöpün	çöplerin	Number
vaftizler	vaftiz	Number
doğunda	doğunuzda	Possession
klavyelerdik	çiçelerdik	lemma
bitmiyor	bitmiyoruz	Person
sorumsuzluğu	sorumsuzluğum	Possession
kusmalarım	filizleri	lemma
rebetikoların	rebetikonun	Number
hatada	hata	Case
ödevin	ödevi	Case
ulamız	ulamdılar	Tense
umutsuzmuşuz	umutsuzmuşum	Person
serverleriz	serverlerdi	Tense
yaratık	yaratıklar	Number
kervansarayı	kervansaray	Case
okunaksızlıkları	okunaksızlıklara	Case
şaşılmıyorsun	şaşılmıyor	Person
amirallikler	amirallikleri	Case
milyardermişler	uzakmışlar	lemma
bakmadınız	baktınız	Polarity
eylemi	eylemde	Case
içeceklerimden	içeceklerinden	Possession
mandallarını	mandalım	Case
vücutlarda	vücutları	Case
giysilerime	giysilerinin	Case
tıklarım	yoldurturum	lemma
ilçeleri	ilçeler	Case
rehberlerime	dilsizliklerine	lemma
vekilinin	vekillerinin	Possession
göllerde	göllere	Case
hazırlar	çirkinler	lemma
abajurcu	abajurcuydun	Tense
sesçi	sesçiydin	Tense
işgüçlerini	işgüçlerinden	Case
tümcende	tümcelerinde	Number
solucanlarda	öküzlerde	lemma
topiğin	topiğiniz	Possession
karınlarına	gelirlerine	lemma
voleybolcusun	voleybolcuyduk	Tense
yaratıkları	yaratıklarda	Case
konusundan	konumdan	Possession
birleştiler	birleşirler	Tense
çıkmada	çıkmanın	Case
oyalamıyordun	aramıyordun	lemma
kısmayacaksınız	barışmayacaksınız	lemma
kuruşlar	kuruşların	Case
kurbanlara	kurbanlardan	Case
çatlakları	çatlağı	Number
pişmeyecekler	pişmeyeceksiniz	Person
egoizmde	egoizmlerde	Number
amcanızdan	amcamızdan	Possession
perdelere	perdeye	Number
gafletimi	gafletlerine	Case
damla	damlaya	Case
tuğladan	tuğlalardan	Number
saydırıyorduk	diriyorduk	lemma
gülüyorum	buluyorum	lemma
katılmazsınız	ayarlanmazsınız	lemma
zorluklara	zorluklar	Case
abajurculuklardan	abajurculuklar	Case
cüceyim	cüceydi	Tense
çağanozum	çağanozdun	Tense
uzaylılarda	uzaylılardan	Case
İngilizceleştiriyorsun	İngilizceleştiriyorsunuz	Person
kervansaraya	kervansarayda	Case
cumhurlardır	cumhurlardın	Tense
hazineden	hazineyi	Case
parıltılar	parıltılardım	Tense
perdelere	perdelerde	Case
levyeye	levyenin	Case
övdü	övdüm	Person
metrdotelleriz	metrdotellerdin	Tense
yalancıyız	yalancıydım	Tense
musonlar	muson	Number
terörizm	terörizmi	Case
hastalanmaz	hastalanır	Polarity
aktiftiler	coşkusuzdular	lemma
anarşiye	anarşiyi	Case
hidrata	hidratlara	Number
gefirofobileri	gefirofobiyi	Number
dansçı	dansçının	Case
rubaimizin	asamızın	lemma
kalında	kalın	Case
karamelimi	gelinciklerini	lemma
kukla	kuklalar	Number
karanlıkları	karanlıklardan	Case
akbabalarımızdan	feribotlarımızdan	lemma
hazinelerin	hazinenin	Number
tacizlerde	tacizlere	Case
maskaralardım	maskaraydınız	Number
fabrikalardan	fabrikaları	Case
ısırıkta	ısırıklarda	Number
zavarınız	zavarın	Possession
model-view-controllerlerden	model-view-controllerlere	Case
cacıklar	cacıklarda	Case
ağaçtan	ağacı	Case
minberinizin	aşığınızın	lemma
kırışıklığınızda	bükmenizde	lemma
pikniklerde	piknikte	Number
derilerinde	derilerinin	Case
salahiyetlerimizden	salahiyetlerinden	Possession
silmiyorsun	silmiyor	Person
elledik	ellediler	Person
uçtan	uca	Case
malumatlarımızda	malumatlarımıza	Case
yönetimine	yönetiminin	Case
hükûmettin	hükûmetsin	Tense
sızdı	sızdılar	Number
sacın	sacların	Number
soslarımızı	bıçaklarımızı	lemma
korunmamız	korunmanız	Possession
masumiyetimizi	çedarımızı	lemma
doyumsuzdular	doyumsuzdu	Person
futbolcularsınız	futbolculardım	Tense
odacıkları	odacıklarda	Case
katarlar	katar	Number
patenlerinin	dergilerinin	lemma
çıkmayacak	çıkmadı	Tense
sileceğim	silecekler	Person
ittirmeyeceksiniz	ittirmeyeceksin	Person
küpelerinin	küpelerinizin	Possession
kısalığınızın	yüzüncüyünüzün	lemma
yoldaşlarından	yoldaşlarının	Case
sağlayıcınız	sağlayıcımız	Possession
kümesine	kümesinin	Case
ucubeler	ucubeydi	Tense
tükenmedim	ayırmadım	lemma
topluluklarını	topluluklarına	Case
fakirleştirdiler	fakirleştirdiniz	Person
mantıksız	bakımsız	lemma
aydınlığın	aydınlık	Case
yüreği	yürek	Case
fobofobinin	fobofobide	Case
sayfaydık	ütüydük	lemma
direkti	direksiniz	Tense
sosislini	şüpheni	lemma
hacınıza	hacılarınıza	Number
acelecilikte	acelecilik	Case
sahifelerim	sahifeleriniz	Possession
develere	develeri	Case
oyunculardın	yolculardın	lemma
orospularımdan	orospularımızdan	Possession
atıştırtın	atıştırtınız	Number
yapımcıya	yapımcıdan	Case
başkanı	başkana	Case
ofisini	tecrübeni	lemma
antropolojide	antropoloji	Case
okunaksızlıkları	okunaksızlıkların	Case
tabelanın	tabelada	Case
satırtıyor	giyiyor	lemma
kıldım	üşüdüm	lemma
hatırlarımı	hatırlarımda	Case
köçeğiniz	beldeniz	lemma
nilüferlerimizde	nilüferlerimize	Case
bölümünün	bölümünüzün	Possession
ölçüşüyoruz	ölçüşüyor	Person
karidesimizi	karideslerini	Possession
hedeflerde	hedeflerin	Case
sürülerim	sürüleri	Possession
anlarını	anlarında	Case
akiferlere	akiferlerden	Case
şoklara	şokları	Case
pencereden	pencerenin	Case
seçmenler	balıklar	lemma
çarpılardı	çarpılar	Tense
tümörleri	tümörlerin	Case
ısırıklara	ısırığa	Number
bencilliğin	bencillikten	Case
kamusunuzdan	şüphenizden	lemma
deynde	deynin	Case
gözyaşı	gözyaşları	Number
tacizi	taciz	Case
kuvantumları	kuvantumlara	Case
aletlerde	teorilerde	lemma
siyasetçilerden	siyasetçilerin	Case
sentakslarda	sentaksları	Case
gidilmezler	gidilmeyecekler	Tense
kapamaydın	kapama	Tense
makarnamda	vedalarında	lemma
senkretizmlerini	alyanlarımı	lemma
adalemizde	adalenizde	Possession
ayrılmalar	ayrılmaları	Case
gizlenmez	gizlenir	Polarity
kahraman	aseksüel	lemma
seksten	sekse	Case
varışa	varıştan	Case
akrabasının	öbeğinin	lemma
çevreden	çevreye	Case
belleğini	belleğine	Case
pabuçlarından	pabuçlarını	Case
mantıksızsın	bakımsızsın	lemma
işledi	canlandırdı	lemma
tarihçilermişiz	anasonlarmışız	lemma
kedicik	direk	lemma
şikayetin	şikayetlerin	Number
bürokrasiden	bürokraside	Case
küllerinde	külümü	Case
sandalyenin	sandalyeyi	Case
gagadan	gagada	Case
çukurlarda	çukurlara	Case
şairlere	şairler	Case
ejderha	ejderhaydım	Tense
usulu	usuldan	Case
gözlemcinin	tasarrufun	lemma
serverlerdiniz	arzuhalcilerdiniz	lemma
yakşıydın	eklemeliydin	lemma
numaralamamalarım	numaralamamam	Number
düşünceliydi	düşünceliydin	Person
hedeflerde	hedefte	Number
homurdanmasını	homurdanmamı	Possession
okyanuslardan	okyanustan	Number
hesabı	hesapta	Case
altını	altında	Case
butonların	butonun	Number
çıtımın	çıtımızın	Possession
sanmadık	ürkmedik	lemma
elementin	elementten	Case
şerbetçiliğim	şerbetçiliği	Possession
hindilerimizin	tenisçilerimizin	lemma
yarayacaksınız	yaradınız	Tense
saklanacak	şaşırtacak	lemma
tanıyacaksın	tanıdın	Tense
maçı	baykuşu	lemma
engizisyonların	engizisyonun	Number
mastürbasyonların	mastürbasyonun	Number
bakımsızsın	bakımsızdın	Tense
tanımlığımızda	tanımlıklarımızda	Number
çiviyinde	çiviyimde	Possession
ilçenin	ilçe	Case
yüreğin	yürek	Case
ceset	cesette	Case
kırıttın	azdın	lemma
aseksüellerinde	aseksüelinde	Number
battaniyelerini	battaniyelerimi	Number
validelere	validelerden	Case
sesteşlerini	sesteşlerime	Case
kurala	kural	Case
doğrular	doğrusunuz	Person
ilçelerde	ilçeleri	Case
iyonosferi	iyonosferin	Case
kıyametlerinde	kıyametinde	Possession
prototip	prototipler	Number
hınamılarda	hınamılardan	Case
gökdelene	gökdelen	Case
götvereniz	fizikçiyiz	lemma
paranın	para	Case
kalfalarıma	bloglarına	lemma
kurbanlar	kurbanlarda	Case
ilklendirdi	dizdi	lemma
devlerinin	devlerine	Case
ahududundan	damattan	lemma
kursiyerine	kursiyerimize	Possession
seçmesinde	ağında	lemma
doğrumuşum	doğrumuşsunuz	Person
albümlerinizi	sıçanlarınızı	lemma
sararacaksın	bekleteceksin	lemma
ayrımcılığım	ayrımcılıkları	Number
hücreye	taklide	lemma
kırtasiyelerdi	kırtasiyeleriz	Tense
sürprize	sürpriz	Case
emetofobiyi	emetofobileri	Number
amatörümüz	amatörümüzde	Case
süngerimden	conconumdan	lemma
krallıkta	krallığı	Case
taban	Musevi	lemma
buluyor	buluyorum	Person
mügelerdir	mügelerdin	Tense
belleklerinde	belleklerine	Case
sondum	babasızdım	lemma
istemcilerinizden	istemcilerinize	Case
sıvılar	sıvıların	Case
karlardık	karlarsın	Tense
sürücümde	sürücüsünde	Possession
bülbülyuvası	bülbülyuvaları	Number
uzayları	uzayların	Possession
kitaplıkta	kitaplıklarda	Number
yetişmeyeceksiniz	yetişmeyeceğiz	Person
unuttular	unuturlar	Tense
kayıklara	kayıklardan	Case
kullar	ulamlar	lemma
Türkçeleştirecekler	açılacaklar	lemma
taykonotsunuz	taykonottu	Tense
nükleotitlerin	nükleotidin	Number
mastürbasyonların	mastürbasyonlarda	Case
ağaçkakanlarına	ağaçkakanlarınıza	Possession
kötüleşiriz	dokurız	lemma
masummuşsun	masummuşsunuz	Person
gönüllerini	gönüllerinde	Case
koltukta	koltuğun	Case
diriyorduk	diriyordunuz	Person
uzayımda	uzayları	Case
homurtularında	homurtularımdan	Case
jartiyerlerini	balinalarını	lemma
deneyimden	deneylerinde	Case
eksikliklerinde	eksikliğinde	Number
örüntünün	örüntüyü	Case
trigonometrinin	trigonometriye	Case
görüşlerimden	görüşlerini	Case
açılırlar	açılmazlar	Polarity
kılıçların	kılıcın	Number
eğlencenin	eğlenceyi	Case
delilerdiniz	delilersiniz	Tense
yüksüklerine	yüksüklerinin	Case
uçlarımız	uçları	Possession
spamlarında	spamlarıma	Case
gondollarının	gondollarımızın	Possession
pencereye	pencerenin	Case
kipte	kiplerde	Number
vurmadım	gebermedim	lemma
dalgalandılar	dalgalandınız	Person
Monakolulardım	Monakolularım	Tense
kabukların	kabuklarından	Case
yayalardım	yayalarım	Tense
sevişeceğim	çizeceğim	lemma
cadı	cadıyı	Case
katılmadı	yaramadı	lemma
kobrada	kobralarda	Number
gözledi	çökertti	lemma
kalplerini	biçimlerini	lemma
şiirleri	şiirlere	Case
kümenin	çeliğinin	lemma
hikâyelere	hikâyelerden	Case
cephelersiniz	cephelerdik	Tense
hadislerde	hadislerden	Case
vampirlerimizin	vampirlerinin	Possession
ölçtürmezsiniz	ölçtürmez	Person
yolcularından	yolcularına	Case
hazineleri	hazineler	Case
emmileriz	emmilerdiniz	Tense
vezirlerimizi	vezirlerini	Possession
halıları	halıyı	Number
doktorları	doktorlarımda	Case
biseksüelim	biseksüeldik	Tense
albümlerini	albümlerinden	Case
gülünçleşmeyiz	gülünçleşmem	Person
harflere	harflerde	Case
oğullar	duraklar	lemma
avantajlarda	avantajlar	Case
yorgunluğun	yorgunlukların	Number
psikologdan	yüksükten	lemma
süngünün	süngüye	Case
nazenden	nazene	Case
işiyoruz	işemiyoruz	Polarity
götümüz	götünüz	Possession
cesede	cesetten	Case
ilaçlarından	ilacım	Case
körlerinde	önbilgilerinde	lemma
kolajımızdan	kolajlarımızdan	Number
götverenlerinde	ateşlerinde	lemma
arşivleri	arşivlere	Case
ısırığın	ısırıktan	Case
hazırlıklarda	hazırlıkları	Case
fukarada	fukaradan	Case
kömleri	kömlerin	Possession
etkiyi	etkileri	Number
patlamalarda	patlamaların	Case
korsanlarıma	korsanlarına	Number
dayanıklılığı	dayanıklılık	Case
yerleri	yerime	Case
kurabiye	kurabiyeler	Number
içkinin	içkiyi	Case
kovmazsınız	daldırmazsınız	lemma
beceriksizdin	beceriksizdim	Person
yetmezliktiler	yetmezliğim	Tense
katamaranımdan	katamaranlarımdan	Number
karlardı	balkanlardı	lemma
efeydi	efeyiz	Tense
başparmak	başparmağı	Case
karakter	ece	lemma
lepistes	taban	lemma
bürokrattan	bürokrata	Case
kaltağım	öğrenciyim	lemma
yaklaşmaz	denilmez	lemma
harften	harf	Case
işlemesinin	falcısının	lemma
iftitahlarından	iftitahlarını	Case
unutuyor	değişiyor	lemma
motellerinden	dışkılarından	lemma
alametinizden	yoğurdunuzdan	lemma
işlevlerinin	işlevlerine	Case
şelaleydim	şelale	Tense
kıskançlıklara	kıskançlıkları	Case
yoğurtçulardınız	yoğurtçularsınız	Tense
sürgünlerinde	doğruculuklarında	lemma
bölgeydiniz	bölgesiniz	Tense
kromozomlarınızın	frekanslarınızın	lemma
erkelerin	erkelere	Case
katkılar	katkıları	Case
voleybola	voleybolda	Case
papazlardan	papazlara	Case
susmayacağım	susmam	Tense
lipofobiyi	lipofobileri	Number
cadılıktan	cadılıkta	Case
güneş	güneşler	Number
ineklerin	ineklerde	Case
füzelerin	füzelerde	Case
göçlerde	ummanlarda	lemma
kayboluyor	atışıyor	lemma
zeytinyağına	zeytinyağı	Case
ortasına	ortama	Possession
izleyicilerdi	fırınlardı	lemma
basketbolculardık	basketbolcularsınız	Tense
açtı	açtılar	Number
kötüleştireceğiz	bekleteceğiz	lemma
işgücünün	işgücünü	Case
savundu	üzdü	lemma
prostatlarını	prostatlarımı	Number
kapasiteye	ana	lemma
onamadım	ermedim	lemma
galaksileri	galaksilere	Case
içereceksin	atmaacaksın	lemma
arşivde	arşivlerde	Number
sağrınızı	özetinizi	lemma
senaryo	senaryodan	Case
iletkeni	iletkenden	Case
kaçar	öğütür	lemma
mayan	dalgıcın	lemma
vücutlardan	vücuttan	Number
planet	etki	lemma
palyaçolarımıza	öküzlerimize	lemma
yazarı	yazara	Case
yaratıyorlar	yaratıyor	Number
sumağını	dildonu	lemma
monarşilere	monarşilerde	Case
müzeyi	müzeleri	Number
okyanus	okyanusta	Case
ibneymiş	ummanmış	lemma
interfazların	dişlerin	lemma
dağınıktınız	dağınıktık	Person
pedimizden	şafağımızdan	lemma
galaksilere	galaksiye	Number
etleri	eti	Possession
ilköğretimlerimi	beldelerimi	lemma
füzelerden	füzeler	Case
bireylerde	bireylerin	Case
yetenekli	erdemli	lemma
kulduk	kul	Tense
melodilere	melodiye	Number
eylemlerde	eylemde	Number
kitapçıklardan	kitapçıklar	Case
inekleri	ineklerden	Case
titreşim	titreşimler	Number
süründürtmüyorlar	beklemiyorlar	lemma
uçlarız	uçlardı	Tense
şapkayı	şapkanın	Case
hükûmetlerdiniz	hükûmetleriz	Tense
utkular	utku	Number
yeteneklisiniz	yetenekliler	Person
utları	udun	Possession
konuğu	konuğa	Case
çılgınlar	çılgınlara	Case
sunularımıza	çalgıcılarımıza	lemma
piknikler	piknik	Number
sürtüyorlar	sürtüyoruz	Person
bilardonun	bilardoda	Case
tuvalet	tuvaletler	Number
sultan	yağlayıcı	lemma
pişmem	denilmem	lemma
patlamadan	patlama	Case
paylaşıyorlar	paylaşıyoruz	Person
hümanizmi	hümanizmin	Case
notilusuma	ömrüme	lemma
içkileri	içkiler	Case
güzelliği	güzellik	Case
cemaatleri	cemaatlerini	Case
Vikipedi'yi	Vikipedi'e	Case
rehberlerini	rehberlerine	Case
eşcinsellerdi	eşcinseller	Tense
oligarşiyi	oligarşileri	Number
kameralar	aşçılar	lemma
değişikliğin	değişiklik	Case
ayrımcılıklarız	ayrımcılıklardın	Tense
antioksidanların	antioksidanlar	Case
hazcılıklarımda	hazcılıklarından	Case
babacandı	babacan	Tense
kitaplıklar	kitaplık	Number
sokak	gevreklik	lemma
kamerasınız	kameraydınız	Tense
harfi	harfin	Case
mevsimi	mevsimde	Case
enerjiden	enerjiye	Case
üçüzünde	üçüzümüzde	Possession
silkmeyiz	büktürmeyiz	lemma
verimsizleştirmem	geğirmem	lemma
bireyler	bireylere	Case
kibirden	kibiri	Case
idealde	bozayıda	lemma
sahifeleriz	çalgıcılarız	lemma
oyalarlar	oyalarız	Person
yuvarlamaz	yuvarlamazsın	Person
gökkuşağında	gökkuşağının	Case
seçilir	seçilirsin	Person
çocukluğun	çocukluk	Case
uzuneşekden	uzuneşekde	Case
sihirliyiz	coşkuluyuz	lemma
sekreteri	sekreterleri	Number
kirler	kir	Number
saldırmayacağız	büktürülmeyeceğiz	lemma
göçümüzde	yaratmamızda	lemma
paralara	paralarda	Case
devenin	deveden	Case
eriyordunuz	eriyordum	Person
sahnelerini	yataklarını	lemma
madenini	basınını	lemma
pisletiyorsun	doluyorsun	lemma
tekliflerin	teklifin	Number
lazer	lazere	Case
katılmıyor	katılmıyorsunuz	Person
kutsallıkta	kutsallığın	Case
sanırlar	sandılar	Tense
deisttin	deistler	Tense
mumyalardır	mumyalardık	Tense
uzaylıyı	uzaylının	Case
kırdırtmıyordunuz	canlanılmıyordunuz	lemma
palikaryalardı	palikaryalar	Tense
yapıncağımızı	yapıncağımız	Case
telaffuzsun	telaffuzdunuz	Tense
cephelerin	cephelerinde	Case
klatratımı	klatratım	Case
kuramlarda	kuramlar	Case
kalabalıkların	kalabalıklara	Case
tuşlara	tuşlardan	Case
sıkıntılara	sıkıntılar	Case
saksılarda	saksıları	Case
maymunum	maymundular	Tense
banliyöm	banliyölerim	Number
ölüm	ölümden	Case
sanatçıya	sanatçıda	Case
sindirmiyorduk	üzmüyorduk	lemma
tutuşturmayacaksınız	tutuşturmayacaksın	Number
kırarlar	gizlerler	lemma
yapışmalarının	yapışmalarımdan	Case
tatillerde	tatillerin	Case
şehirlerin	şehirleri	Possession
hecenizin	yoldaşınızın	lemma
dildolarımızda	dildolarında	Possession
tuşlar	tuşlardan	Case
abacından	abacımızdan	Possession
odunların	odunun	Number
kulduk	kullar	Tense
nazeninden	nazenini	Case
karların	yamyamların	lemma
ramazanı	taksiyi	lemma
kürkümüze	kürklerimize	Number
geometrilerde	geometride	Number
savaşçı	yağma	lemma
paşasınız	amcasınız	lemma
sözlüklerimden	sözlüklerini	Case
otostopçuydun	Lefkoşalıydın	lemma
entegrasyon	entegrasyonda	Case
doğayı	doğaları	Number
mantıksızsınız	mantıksızdınız	Tense
ombudsmanlarının	ombudsmanımın	Number
yarasalar	yarasalardım	Tense
tatilde	tatil	Case
gütmüyoruz	ölümsüzleştirmiyoruz	lemma
kovmayacağım	kovmam	Tense
sözcüklerinin	sözcüklerinden	Case
karımın	dedikodularının	lemma
arınıyordum	arınmıyordum	Polarity
sosyolojiyi	sosyolojinin	Case
nedimeyiz	nedimeydik	Tense
polislerimizden	polislerimizin	Case
kemençede	kemençeyi	Case
diskoteklerinin	diskoteğinizin	Possession
marangoz	ağa	lemma
sosislerdi	sosislerdir	Tense
tarifler	tariflerin	Case
fiillerin	fiillere	Case
birdirbirler	birdirbirlere	Case
yangında	yangının	Case
topçulardık	topçularsın	Tense
simyadan	simyada	Case
sürücüler	devirler	lemma
fondöteni	fondötenden	Case
sıvılaştırmadı	damlamadı	lemma
tezenelerde	tezenelerden	Case
ayrılıyorum	ayrılıyoruz	Person
savunmuyordun	öldürmüyordun	lemma
doğadan	doğanın	Case
fakültesi	fakültesinin	Case
gazellerim	gazellerdin	Tense
eylemi	eyleme	Case
yazarlardan	yazarların	Case
ahudutlarından	ahudutlarına	Case
kazdı	erdi	lemma
kızar	kızarlar	Number
gökdelenleri	gökdelenlere	Case
çirkinlikte	çirkinlikten	Case
ejderhayız	ejderhaydılar	Tense
helikopterleri	helikopterler	Case
sürdürebilirlikte	sürdürebilirliğin	Case
şiirleri	şiirler	Case
uyanmıyor	bükmüyor	lemma
lensten	lens	Case
kenarında	barajında	lemma
akışkanı	akışkanları	Number
seslenmiyor	şaşılmıyor	lemma
acıtacaklar	boğacaklar	lemma
sıcaklık	sıcaklığa	Case
kategoriye	duruma	lemma
kuramlar	kuramlardan	Case
zarfları	zarfı	Number
hastalar	hastaydı	Tense
rebetikolardan	rebetikodan	Number
uzaylıların	uzaylılara	Case
önyargıya	önyargıyı	Case
kasidelerdim	kasidelerim	Tense
avantaja	avantaj	Case
gitmelerine	gitmemize	Possession
pijamalarından	pijamalarınızdan	Possession
çukurlarda	çukurlar	Case
botaniklerde	botaniklerden	Case
üzgün	üzgündü	Tense
sürpriz	sürprizi	Case
ulumuyordun	ulumuyorduk	Person
akışkanlar	akışkan	Number
tekliflerdin	tekliflerim	Tense
aydınlık	aydınlığı	Case
mühendisliği	mühendisliğin	Case
çeyrek	çeyreği	Case
aydınlığa	aydınlıkta	Case
patlama	patlamanın	Case
koltuklar	koltuk	Number
belirtmede	belirtmeyi	Case
fagotlarına	fagotlarının	Case
adaleti	adaletin	Case
asetonunuz	asetonu	Possession
hikayelere	hikayeye	Number
çılgınlar	çılgınları	Case
cümlesiniz	cümleydi	Tense
çapalardı	çapalarsın	Tense
melodinin	melodiye	Case
mektupları	mektuplarından	Case
satmam	aramam	lemma
erkenektim	erkeneğiz	Tense
hançerimizin	hançerinin	Possession
tabelalarda	tabelada	Number
küçüklüğe	küçüklüğün	Case
parçacıklarından	parçacığından	Possession
pornoyu	porno	Case
yorgunum	yorgunlar	Person
ünsüzleri	ünsüzü	Number
doktordular	doktoruz	Tense
cacığa	cacığı	Case
metrestik	metressin	Tense
karakollarda	şarklarda	lemma
titreşimde	titreşime	Case
kraliçeye	kraliçeyi	Case
böceklerin	böceklerden	Case
istiridyemizi	istiridyenizi	Possession
seçeneklerden	ejderhalardan	lemma
denizyıldızlarına	denizyıldızlarından	Case
uykulardan	uykulara	Case
anketime	anketimi	Case
sucuğumuzda	bankamızda	lemma
ekonomistlere	ekonomistlerden	Case
geliyorum	geliyor	Person
blogcular	blogcuydular	Tense
rakamı	rakamları	Number
seçicilerimizin	seçicilerinin	Possession
hazırmışız	hazırmışım	Person
rehberimizin	bakiremizin	lemma
gözlemcinin	gözlemciye	Case
fotoğrafın	fotoğrafları	Possession
çevrelerden	çevrelerin	Case
tercümanlarınız	tercümanlarım	Possession
vasiyeti	vasiyetleri	Number
bohçalardı	bohçalar	Tense
eylemin	eylemlerin	Number
yetersizlikmişsin	yetersizliklermişsiniz	Number
barbardım	barbarım	Tense
getirdin	getirdim	Person
göçlerime	göçlerine	Possession
fiilden	fiillerden	Number
albatrosumdan	enstrümantallerinden	lemma
pastalarında	pastanda	Number
polisiniz	polisi	Possession
garsonunuzu	garsonlarını	Possession
huzurluymuşsun	huzurluymuşum	Person
abajurculuklarda	abajurculuklara	Case
bisküvilerde	bisküvilerin	Case
manivelalarım	dersleri	lemma
kullanılacaksın	bakacaksın	lemma
gökdelene	gökdelende	Case
katkılardan	katkıdan	Number
yeti	yetide	Case
kapakçığa	kapakçıklara	Number
gübrelerdik	zağarlardık	lemma
kurtların	kurtlara	Case
aşıkdık	aşıksın	Tense
kukla	kuklayı	Case
madalyalarda	madalyalardan	Case
lokmalarını	tohumlarını	lemma
krakerlerini	krakerlerimi	Number
iskenderleriniz	ölümleriniz	lemma
kirişleri	kirişin	Possession
oyunculuk	oyunculuğu	Case
kirleteceğim	kirletecek	Person
fondötende	fondötenden	Case
müstahdemlermişim	ölülermişim	lemma
hukuklara	hukuklardan	Case
cenubundan	cenuplarından	Number
tütülerinde	tütülerini	Case
tandırlarına	tandırlarından	Case
iyileşmediler	dilmediler	lemma
gözlerler	gözlersin	Person
amiralliğin	amirallikte	Case
bireylerden	bireyleri	Case
elektromanyetizmada	elektromanyetizmayı	Case
ongenlerin	ongenlere	Case
abazan	başarılı	lemma
yorgunlukta	yorgunluğu	Case
kurullarına	şampiyonluklarına	lemma
arayüzde	arayüzü	Case
gözlemci	gözlemciyi	Case
helikopter	helikopterden	Case
işletmemden	işletmemizden	Possession
ustalardık	ustalardır	Tense
saçarsın	çevirirsin	lemma
kolyelerinden	kolyelerimizden	Possession
seçmemde	bacanağımda	lemma
kılıca	kılıçta	Case
alfabede	alfabeyi	Case
damatlar	damatlara	Case
değerliler	değerli	Number
ürünlerimde	ürünlerimizde	Possession
tuvaletlerden	tuvaletler	Case
uğratmıyorduk	uğratmıyordular	Person
köçeklerdik	Mogadişululardık	lemma
sakızın	sakızının	Case
ahizelerinden	ahizeleri	Case
piramitlere	piramitleri	Case
büyülüyüm	büyülüsün	Person
masum	barbar	lemma
birleştirmeyeceğiz	birleştirmedik	Tense
götverenler	götverenlerdi	Tense
sözlüklersin	sözlüklerdim	Tense
milyonerden	milyoner	Case
şiir	şiirler	Number
baytarın	baytarları	Possession
erkeceyimizi	erkeceyinizi	Possession
istatistikte	istatistik	Case
gözbebeklerinde	gözbebeklerinin	Case
toplarda	topların	Case
azınlıklara	azınlıkların	Case
yönelmenin	yönelmelerin	Number
güze	antioksidana	lemma
tatları	tatlarında	Case
programlanmıyordunuz	canlanmıyordunuz	lemma
ırkün	ırkten	Case
mezuniyetimizi	fırçamızı	lemma
zamları	zamlar	Case
bencilliği	bencillikten	Case
teyzeleri	teyzeler	Case
alçak	alçaklar	Number
sinagoga	sinagogu	Case
tipografyamızı	tipografyamı	Possession
öksürmeyeceğim	öksürmeyeceksiniz	Person
düğmenin	düğmelerin	Number
dönüşlerinizden	dönüşlerinden	Possession
isimsizmişler	isimsizmişiz	Person
pornolara	pornolardan	Case
diyordum	diyordu	Person
lokum	balık	lemma
garbınızdan	garbınızı	Case
üzümler	üzüm	Number
cephesinin	cephesi	Case
tezenelerden	tezenelere	Case
heyecanımın	heyecanlarından	Case
cinsiyetler	cinsiyet	Number
prototipte	prototipten	Case
paradoksları	paradoksların	Case
sıkmıyordu	sıkmıyor	Tense
patlamalardan	patlamalar	Case
krallıklar	krallık	Number
gelinciğinde	gelinciğimde	Possession
meşalenizden	meşalenize	Case
dağıtımımıza	dağıtımına	Possession
sürtüyordum	dağılıyordum	lemma
interfazı	interfazım	Possession
böcekbilimin	böcekbilime	Case
kalamarlardır	kalamarlardım	Tense
çıkmaya	çıkmada	Case
sanatçıdan	sanatçılardan	Number
kanserlerden	kanserlerde	Case
metafazlarından	yerlerinden	lemma
okunaklılıkta	okunaklılık	Case
roman	aşık	lemma
tenisçi	tenisçiydik	Tense
mümessilliğinin	başkanının	lemma
kodlara	kodları	Case
sosunuzda	yakanızda	lemma
patlamaları	patlamalara	Case
ispatlayacak	anlatacak	lemma
ağlamaları	ağlamalar	Case
uyanmadılar	uyanmadı	Person
şırıngayım	şırıngaydı	Tense
cevherleri	cevherlerin	Case
sayfanızdan	sayfamızdan	Possession
mükemmelliğe	mükemmelliklere	Number
kayığın	kayık	Case
deveyi	devede	Case
botanik	botaniğe	Case
prens	prenstin	Tense
direklerinden	direkleri	Case
mayalarının	yuvalarının	lemma
dilmiyordum	dilmiyorum	Tense
ustaydın	ustayım	Tense
ayvazında	ayvazlarında	Possession
bürokrasi	bürokraside	Case
kovalara	kovaya	Number
pasif	bilgisayarlı	lemma
havuzlarımın	havuzlarının	Possession
lira	liralar	Number
tatiller	tatillerin	Case
saydırtıyordun	saydırtıyordum	Person
depresyon	depresyonun	Case
haberleşmedi	büyümedi	lemma
canlanmayacak	canlanmayacağım	Person
kararıyordunuz	öksürüyordunuz	lemma
vibratörlerden	vibratörlerin	Case
kovduruyorsunuz	birleşiyorsunuz	lemma
Mogadişulularınızın	Mogadişulularımın	Possession
tercihlerdim	tercihlersin	Tense
kurdun	kurtların	Number
taramayacaklar	taramayacağız	Person
notilusumuzda	notilusumuzu	Case
kaşım	kaşınız	Possession
kullanıldı	çalıştı	lemma
kanamıyor	aşmıyor	lemma
savaşı	sürgünü	lemma
cesedin	ceset	Case
maça	bakire	lemma
akdoğanın	akdoğandan	Case
tahtlarından	tahtları	Case
bamyayız	bamyaydım	Tense
tokofobilere	tokofobileri	Case
üredim	üreyeceğim	Tense
ilçelerde	ilçelere	Case
trafikten	trafiği	Case
babalından	babalılarından	Possession
omletlerinden	omletlerinde	Case
deistlerdiniz	deistlerdir	Tense
yakantoplarda	yakantopta	Number
yapıyorduk	boşanıyorduk	lemma
simyadan	simyaya	Case
modaydınız	modayız	Tense
seçenekte	seçenekten	Case
ödeve	ödevi	Case
yağları	yağlardan	Case
ayrılmaz	ayrılmadı	Tense
kaçırmıyorduk	ayılmıyorduk	lemma
sürprizden	sürprizlerden	Number
ittirildiler	buharlaştılar	lemma
şeftalilerinizde	şeftalilerinizin	Case
mekiğine	trenine	lemma
eriyiğiniz	eriyikleri	Possession
yanarlar	yanarsın	Person
güreşçiler	dullar	lemma
sakızıma	sakızlarını	Case
patronsun	patronduk	Tense
jaguarı	jaguar	Case
büyükelçiler	büyükelçileri	Case
gergedanlar	gergedan	Number
kaçırmıyorsunuz	kaçırmıyordunuz	Tense
süründüreceksin	süründüreceksiniz	Person
kipamızda	uçağımızda	lemma
rehineleri	duvarım	lemma
zavarlarına	zavarımda	Case
çiğdemlerde	çiğdemlerden	Case
silahlarının	silahlarından	Case
merkezin	merkeze	Case
sütlaca	sütlaçta	Case
dedelerin	dedeler	Case
bayılmayacak	bayılmayacaksınız	Person
ısırganları	ısırganlarda	Case
klarnetlerime	klarnetlerimize	Possession
destanlarına	destanlarını	Case
kukladan	kuklaya	Case
milyonere	milyonerden	Case
halının	halıdan	Case
çorbalarını	çorbaları	Case
işçisinin	işçisini	Case
sinmedi	bütünleşmedi	lemma
kuzuydular	kuzular	Tense
şakaları	şakası	Possession
düğmenin	düğme	Case
katkı	katkıda	Case
kaderlerimizden	kaderlerimden	Possession
kervansarayın	kervansaray	Case
enginarlarında	enginarlarından	Case
karnabaharlarımızdan	yumurtalarımızdan	lemma
gözlemlerin	gözlemleri	Case
alfabe	alfabede	Case
kovacaksınız	attıracaksınız	lemma
monarşilerden	monarşiler	Case
teğetin	teğet	Case
olmadık	olmadım	Number
mindere	minderden	Case
alkışımın	aslımın	lemma
damatlardık	damatlar	Tense
tükendi	çarptı	lemma
katillerine	katilleri	Case
üniversitenin	üniversite	Case
boğadan	boğaya	Case
kaşelerin	şortların	lemma
Tiranlılarsınız	Tiranlısın	Number
uyarıyordun	öldürtülüyordun	lemma
zorluk	zorluğa	Case
lensi	lens	Case
sisin	damatlığın	lemma
kitabelerinde	Duşanbelilerinde	lemma
solucandı	solucan	Tense
pencerelerin	pencereler	Case
roketler	roketlerde	Case
çılgınlıklarda	çılgınlıklar	Case
işkencecileriniz	işkencecilerinizden	Case
endüstriler	endüstrileri	Case
dağınığım	dağınıklar	Person
kaygıları	kaygıyı	Number
savaşçıydınız	savaşçı	Tense
kuğularız	kuğulardı	Tense
lahanasınız	lahanaydık	Tense
karımı	karını	Possession
bakirelerdin	bakireler	Tense
düğmeyi	düğmenin	Case
ilerilerim	ilerilerinden	Case
köprülere	köprüye	Number
evrimlerini	evrimlerine	Case
tümörlere	tümörler	Case
masörleriz	masörlerdi	Tense
blogunuzun	blogunuzdan	Case
salçalıklarımıza	salçalıklarına	Possession
karalamalarda	karalamada	Number
gagalar	gaga	Number
sandalyelerin	sandalyeler	Case
vücutların	vücutları	Case
mimlerim	mimleri	Possession
itlerinin	itimi	Case
üniversitede	üniversiteye	Case
yoğurt	yoğurda	Case
nihayetlerde	nihayetlerin	Case
leyleklerinin	leyleklerinizin	Possession
üniversitelere	üniversitelerin	Case
pisletmezsin	azmazsın	lemma
maymunların	önemsizliklerin	lemma
yaptırmıyor	gezmiyor	lemma
kafataslarından	kafataslarının	Case
bıçaklamıyordu	bıçaklamıyordular	Number
sultanlarız	yardımcılarız	lemma
adamotuda	adamotudan	Case
saksıya	saksının	Case
otomobilinin	otomobillerinin	Possession
çam	çamlar	Number
kardı	kar	Tense
alametlerdim	alametlerim	Tense
eziyetçilerdi	eziyetçileriz	Tense
kılıçlardan	kılıçların	Case
ortaklarız	çavuşlarız	lemma
piknikleri	pikniklere	Case
marangozları	zamanları	lemma
beklemeyi	beklemeleri	Number
çöpçatanlıklarının	çöpçatanlıklarından	Case
beklemeden	beklemenin	Case
acemi	acemiydim	Tense
iletiye	iletiyi	Case
buluta	bulutu	Case
antioksidanlara	antioksidana	Number
popolarına	bazaltlarına	lemma
cüzzamımda	cüzzamlarımda	Number
kaşıyorlardı	bıkıyorlardı	lemma
benzerlerim	benzerlerdi	Tense
yorgunluğa	yorgunluktan	Case
panteistlere	panteistlerde	Case
dokuzgen	dokuzgende	Case
yapmalarınız	yapmaları	Possession
şairi	şairleri	Number
iffetlerdi	iffetlerdir	Tense
dualar	dua	Number
ibnelermiş	avcılarmış	lemma
isyanında	dışında	lemma
maaşta	maaşlarda	Number
yakışıklıydılar	düşünceliydiler	lemma
parçacık	parçacıklar	Number
inmez	inmezler	Person
burnuma	burunlarını	Case
almanaktan	almanağın	Case
soğurmayacaksınız	gelinmeyeceksiniz	lemma
paylaşımından	paylaşımında	Case
hamdınızdan	hamdınızda	Case
masumiyetlerdin	masumiyetlersin	Tense
arayüzleri	arayüzlerde	Case
bürokrasi	bürokrasiye	Case
görmez	eğmez	lemma
rüzgarları	rüzgarlar	Case
sikinizi	tekfurunuzu	lemma
bölgemizi	bölgemi	Possession
öğretimizde	öğretimde	Possession
büyükelçilere	büyükelçiler	Case
acenteliklerden	acentelikten	Number
papaz	benek	lemma
ovar	bulunur	lemma
direğine	direği	Case
ilginciz	ümitsiziz	lemma
çılgınlıkları	çılgınlığı	Number
soğanların	soğanları	Case
sandalyelerden	sandalyelerde	Case
binine	bini	Case
Aşkabatlılardın	Aşkabatlılarız	Tense
gelinlik	gelinliği	Case
alfabelerden	alfabelerde	Case
kameraların	kameralardan	Case
umutluyum	umutluydum	Tense
pelikanlar	tütüncüler	lemma
isinizi	isinizin	Case
mantıklısınız	mantıklı	Person
futbolcuydum	futbolcular	Tense
mutsuzdular	mutsuzdun	Person
mendilden	mendili	Case
belirtmeyi	belirtmeye	Case
birleştirtmeyecekler	birleştirtmediler	Tense
hanımda	şamandırada	lemma
abazandın	abazandınız	Person
kaygılar	kaygı	Number
eğrileri	eğriyi	Number
otelimize	otelimizin	Case
kapamaymış	üstveriymiş	lemma
değişiklikleri	değişikliklerde	Case
olcalara	olcaları	Case
parçalanmayız	geliştirmeyiz	lemma
solucanlarmış	dalgıçlarmış	lemma
kirletiyorlar	kirletiyorum	Person
mantıksızsın	mantıksız	Person
demedik	demedim	Number
hayvanda	hayvana	Case
sancağın	sancakların	Number
yoğurtçulardın	yoğurtçular	Tense
robotta	robotlarda	Number
kuşuna	kuşunun	Case
kirleri	kirler	Case
kahramanmış	çökelekmiş	lemma
şövalyenin	şövalyelerin	Number
yazarlara	yazarların	Case
yufkayı	yufkadan	Case
aldırtıyorlardı	başarıyorlardı	lemma
koruganlar	koruganlara	Case
kılavuzdu	temsilcilikdi	lemma
politikalardan	politikalar	Case
teklifime	teklifimin	Case
varıştan	varış	Case
ittirtmiyordu	büktürtmüyordu	lemma
oğullardım	oğullarsın	Tense
önceye	önceden	Case
tecessümden	tecessümlerden	Number
aydınlıkta	aydınlığı	Case
hazırlıkların	hazırlığın	Number
sistemlerinizden	sistemlerimden	Possession
lahanalardım	lahanalarız	Tense
hazineden	hazineye	Case
cevherlerin	cevherler	Case
çarmıhın	çarmıha	Case
değişiyordum	değişiyordunuz	Person
biliyorlardı	biliyorduk	Person
barbarsın	barbarsınız	Person
içkiler	içki	Number
yüreklerin	yürekler	Case
dansçıların	dansçılardan	Case
hikayelerde	hikayelerden	Case
geliştirirsiniz	geliştirirsin	Person
gevreklikler	gevrekliklerin	Case
güreşçimde	duyumda	lemma
galaksinin	galaksiyi	Case
insanımsılar	eşcinseller	lemma
kararlarını	kararlarından	Case
ziyaretçilersin	ziyaretçilerdin	Tense
ittirilirsiniz	bütünleşirsiniz	lemma
milyonerin	milyoner	Case
minderden	minderlerden	Number
kipleri	kiplerde	Case
keşfeteceğiz	çıldırtacağız	lemma
tuzluydular	dindardılar	lemma
okunaklılıkta	okunaklılığı	Case
dedeyi	dedenin	Case
mimimizden	askerimizden	lemma
gelinliklerin	gelinlikleri	Case
polisin	polisi	Possession
karanlıklardan	karanlıktan	Number
monarşinin	monarşiyi	Case
çoraplarımızdan	çoraplarınızdan	Possession
horlamazlar	öksürmezler	lemma
konferansın	sürün	lemma
susuzluğa	susuzluğun	Case
alınlarını	alınlarınızı	Possession
sonrayı	sonrada	Case
hayvanlardan	hayvanları	Case
geçmelerinin	geçmelerinden	Case
ağaca	ağaçlara	Number
hazırlıktan	hazırlık	Case
kaçacak	yaratacak	lemma
kilerlerinden	cimcimelerinden	lemma
fahişelerdik	fahişelersin	Tense
kirpiğe	kirpiği	Case
gölün	göllerin	Number
enerji	enerjiyi	Case
sunucumuza	tangamıza	lemma
kirpikleri	kirpiği	Number
mantiydiler	mantiler	Tense
kıskançmış	kıskançmışım	Person
hedefleri	hedefi	Number
aikidoları	aikidolarım	Possession
pişer	çalar	lemma
monarşilere	monarşiler	Case
aktörmüşsünüz	börülceymişsiniz	lemma
dilberlerimiz	dilberleri	Possession
kuyanların	tekliflerin	lemma
somnifobide	somnifobiyi	Case
satmaz	bağlamaz	lemma
sağrında	sağrılarında	Number
sonraya	sonralara	Number
çığlığa	çığlığı	Case
silindirlerimden	yollarından	lemma
paradokslar	paradoksları	Case
koşuculardım	ayakkabılardım	lemma
pazıların	yavşakların	lemma
doyar	doyarız	Person
dürüm	dürümü	Case
kullanılmazsınız	dönmezsiniz	lemma
küçüktük	küçüktünüz	Person
boğadan	boğayı	Case
bülbüllerdik	bülbüller	Tense
laçosunun	enjektörünün	lemma
kakmayacağız	kakmayacağım	Person
metrestiler	metressin	Tense
çukur	çukurun	Case
sitelere	şampiyonluklara	lemma
cadılıkların	cadılıklardan	Case
psikiyatrları	psikiyatrlarda	Case
ahtapotlarınıza	ahtapotlarınızın	Case
kalabalığa	kalabalıklara	Number
ruju	rujları	Number
koyulaşacaksınız	koyulaşacaksın	Person
verilmem	büktürmem	lemma
yoğurtçuluğunuza	yoğurtçuluklarına	Possession
gözlemden	gözlemlerden	Number
lokumlardır	lokumlardınız	Tense
inecek	bildirecek	lemma
kapamalar	kapamalardın	Tense
içyüzlerimize	elçilerimize	lemma
şairlerden	şairlerin	Case
sızıyor	sızıyoruz	Person
vazolarız	vazolardın	Tense
raketlerde	rakette	Number
ekonomistlerin	ekonomistlere	Case
kansere	kanser	Case
yalnızlıklarda	yalnızlıkta	Number
nilüferinde	nilüferinin	Case
cihazın	cihazı	Possession
kravatlarına	fitillerine	lemma
otizmden	otizmlerden	Number
monarşi	monarşiyi	Case
serverlerinde	serverlerine	Case
haberleşmeyiz	ellemeyiz	lemma
umuyordum	yoldurtuyordum	lemma
kayıklar	kayık	Number
sekizgen	sekizgenden	Case
bilgisayarlıyız	bilgisayarlıydık	Tense
ritme	ritmi	Case
kantoları	kantolar	Case
üyesi	üyeniz	Possession
faks	faksın	Case
iskenderlerim	iskenderlerdi	Tense
programlatıyorum	gecikiyorum	lemma
şamandıralar	şamandıra	Number
ayrımcılığına	ayrımcılığınıza	Possession
işgücünün	işgücü	Case
camisini	camilerini	Possession
nedimelerdin	buzullardın	lemma
bileşiklerde	bileşikte	Number
kemençelerde	kemençelerden	Case
sapmıyorum	yaratmıyorum	lemma
kıskançtım	ağırdım	lemma
şampiyonda	şampiyona	Case
hurilerdi	bedevilerdi	lemma
hardala	hardal	Case
paranoyaya	paranoya	Case
piramitten	piramitlerden	Number
saçmalıklar	saçmalıkları	Case
iffet	âlim	lemma
kupürü	şampanyası	lemma
bozdu	bozdular	Person
doğrudular	doğrudum	Person
çıban	çıbandan	Case
hamağı	hamakları	Number
mikrofon	vefat	lemma
pijamaydılar	futbolcuydular	lemma
otomobillermiş	öğütücülermiş	lemma
işitiyorduk	şaşırttırıyorduk	lemma
baygınlıklarda	baygınlıklardan	Case
sosyologların	sosyologları	Case
kazanmadık	kazanmadın	Person
iguanaları	iguanayı	Number
coşkulular	coşkuluydular	Tense
prototiplerin	prototipin	Number
uğratılmayız	dürmeyiz	lemma
ısırıklar	ısırık	Number
müdürlerine	müdürlerinin	Case
sülüğe	sülüğün	Case
avantaja	avantajdan	Case
siyasetçiden	siyasetçide	Case
pencereye	pencerede	Case
keçilerdim	keçilersiniz	Tense
kafatasını	kafatası	Case
günleri	günlerinin	Case
ölülerdiniz	ölüler	Tense
sigaralar	sigaralarda	Case
üyeliklerinde	üyeliklerinin	Case
jeolojide	jeoloji	Case
otizmde	otizmi	Case
sürüldünüz	ılıdınız	lemma
önce	öncenin	Case
tutacaklar	elleyecekler	lemma
galaksiden	galaksiyi	Case
hamsterlerin	tütsülerin	lemma
ısırık	ısırıktan	Case
heteroseksüellerini	gelirlerini	lemma
haşefende	çiçende	lemma
karneyiz	karneydin	Tense
bitmelerimde	bitmelerim	Case
malım	maldım	Tense
cadıların	cadının	Number
gökadanın	dişçinin	lemma
ura	urlara	Number
kılıç	kılıcın	Case
unutmazsınız	unutmazlar	Person
şoklar	şok	Number
gökdelenler	gökdelen	Number
pastırmaydın	pastırma	Tense
verilerine	verilerinde	Case
alkışlarımızın	çökertilerimizin	lemma
öğretmendik	öğretmenler	Tense
kırışıklıklarının	öpücüklerinin	lemma
düğmeyi	düğmeden	Case
iskeletleri	iskeleti	Number
Yahudiydiler	dalgıçtılar	lemma
enerjilerden	enerjiden	Number
erdemliyiz	erdemliyim	Number
getirmez	getirmezler	Number
ilerilerinden	fakültelerinden	lemma
muşmulalardan	muşmulalarda	Case
teklifimin	teklifleri	Case
deyni	deynden	Case
mayalarının	eğitimlerinin	lemma
sevenimizde	sevenimde	Possession
cinsellikler	cinselliklerin	Case
havuzlara	havuzlarda	Case
satmadı	evlenmedi	lemma
serçeden	serçeyi	Case
algolojinin	deliğin	lemma
oburluklar	oburluk	Number
civardan	civar	Case
fişeksin	fişektim	Tense
badanalarınızda	badananızda	Number
evlatlıktan	evlatlığın	Case
liseleri	liseler	Case
alçakmışsınız	alçakmışım	Person
akifer	akiferden	Case
falına	falından	Case
vaftiz	vaftizi	Case
nutukları	yarışları	lemma
beyitlerinin	beytinin	Possession
çakıltan	çakılın	Case
yarışlarda	yarışta	Number
günahlarıma	günahlarınıza	Possession
mukavemete	mukavemet	Case
masörümden	masörlerini	Case
tavukgötünün	tavukgötünü	Case
hayvanlar	hayvan	Number
yalvarırlar	yalvarır	Person
masumlar	masum	Number
zaferlerinden	zaferlerini	Case
karpuz	karpuzdum	Tense
kara	dinozora	lemma
hedefte	hedefi	Case
intikamlarından	intikamlarına	Case
abajurculukları	abajurculuklardan	Case
mevkileriniz	yardımcılarınız	lemma
havranızı	havramı	Possession
parada	parayı	Case
primitifmiş	primitifmişiz	Person
hazırdın	hazırdık	Person
olmuyordunuz	çağırmıyordunuz	lemma
payımız	payları	Possession
politikalar	politikalara	Case
tohumlar	tohumlardan	Case
kantolar	kanto	Number
okyanusları	okyanuslara	Case
kılıçlarda	kılıçlar	Case
zorlukları	zorluklar	Case
kardeşlerdik	kardeşlerdir	Tense
piminizin	Musevinizin	lemma
başarılıymış	başarılıymışsınız	Person
sayfalandırmalarınızı	sayfalandırmalarını	Possession
pöhrengin	tutulman	lemma
rüyayım	rüyaydınız	Tense
yardımseverliklerini	yardımseverliğimin	Case
anarşileri	anarşilerden	Case
dinozorduk	dinozorum	Tense
olcada	olcadan	Case
sonralarda	sonrada	Number
maskaraydılar	maskaralardım	Number
dönüşümde	dönüşünde	Possession
topun	toptan	Case
politikanın	politika	Case
konserlerinden	doğruculuklarından	lemma
dumanımın	dumanımızın	Possession
yazı	yazının	Case
astronotumuz	astronotları	Possession
geçmelerinde	geçmelerinden	Case
samuraylar	samuray	Number
bulayacak	bulayacaksınız	Person
güneşlerin	güneşin	Number
jonglörünü	çekicini	lemma
DVD	DVD'ye	Case
kırıldılar	kırılmadılar	Polarity
hukukları	hukuku	Number
tıklamayacaksınız	yağmayacaksınız	lemma
oltaları	oltalarından	Case
bitmedim	bitmedik	Person
seslenir	yırtar	lemma
uçuyoruz	büyüyoruz	lemma
fizikçilerdim	fizikçilerim	Tense
karıncalarını	karıncalarınızı	Possession
taklitlerinden	taklidinden	Possession
işgücünün	işgücünden	Case
iletmeyeceksin	iletmeyeceğiz	Person
silahlarımıza	öğretilerimize	lemma
plakları	butonları	lemma
fiillerde	fiillerin	Case
belirtmeyi	belirtmenin	Case
azınlıklara	azınlıklardan	Case
kantinlerimizden	âlimlerimizden	lemma
çokgenleri	çokgenlerde	Case
listelerine	evrimlerine	lemma
pimimizde	cenazemizde	lemma
indeks	indekste	Case
polislerdi	yeterliklerdi	lemma
babalılardınız	babalılardır	Tense
raketi	raket	Case
semerden	semer	Case
alacakaranlık	alacakaranlıkta	Case
amirallikte	amiralliği	Case
verimden	verimizden	Possession
bütünleşmeyeceksiniz	bütünleşmeyecek	Person
tandırınıza	tandırınızdan	Case
kolyeler	girdaplar	lemma
ailelerin	ailelerde	Case
süngerlerimde	deneylerimde	lemma
etkide	etki	Case
salatalarsın	batılarsın	lemma
karneydiniz	karneyiz	Tense
içtiler	içtik	Person
aşklarına	aşklarının	Case
nüfuslarda	nüfusta	Number
doktorumuza	doktorunuza	Possession
mana	yoğurtçu	lemma
tatile	tatilden	Case
sektim	geçtim	lemma
yaptırtı	yıkadı	lemma
tabansızlarında	tabansızlarının	Case
monarşilere	ışıklara	lemma
şüphelerine	şüphelerinize	Possession
çizmecisin	çizmeciydim	Tense
lalaları	lalalarda	Case
kasıyordu	yumuyordu	lemma
satırtmıyorsun	eğlenmiyorsun	lemma
içkiden	içkide	Case
aldırır	der	lemma
ısırık	ısırığın	Case
dansçıların	dansçının	Number
fagofobilerden	fagofobiler	Case
çokgene	çokgende	Case
bombalarının	bombalarını	Case
gülünçleşmiyorlar	yaymıyorlar	lemma
psikoloğu	değişikliği	lemma
cevherleri	cevheri	Number
kolejinin	öğretisinin	lemma
merdivenlerinize	merdivenlerime	Possession
malım	maldı	Tense
ortalardı	anasonlardı	lemma
derslerimize	derslerine	Possession
göstermediler	öldürmediler	lemma
gökadanın	gökadaya	Case
sözcün	sözcümüz	Possession
pusulaları	feribotum	lemma
seksi	büyülü	lemma
totemcini	totemcinizi	Possession
cinselliğin	cinselliğe	Case
kaldılar	kalırlar	Tense
koşucumuzda	koşucumuzun	Case
Kürtler	Kürtlerin	Case
çöpleri	çöpü	Number
baharın	baharı	Case
hazırlıkta	hazırlık	Case
doktorunuz	doktoru	Possession
gençliği	gençlik	Case
kaynaştırılıyorduk	diyorduk	lemma
ailenin	ailelerin	Number
acıtmıyordunuz	buharlaşmıyordunuz	lemma
pisletmeyeceğim	demlemeyeceğim	lemma
yummuyordun	yummuyorduk	Person
temsillerinden	temsilleri	Case
ilerletmeyeceksiniz	öfkelendirmeyeceksiniz	lemma
pastanız	pastan	Possession
depresyona	depresyonu	Case
sınavlara	sınavların	Case
uzaktılar	uzak	Tense
hastalığının	yanardağının	lemma
otomobilciliktik	otomobilciliksiniz	Tense
gözyaşları	çokgenler	lemma
belirtmeyi	belirtmeleri	Number
bahtsızsın	bahtsızız	Person
cacıkların	cacığın	Number
eğrilerin	eğrilere	Case
tundralardır	tundralardınız	Tense
sigaralardan	sigaradan	Number
seçeneklerde	seçenekler	Case
çalmadı	çalmayacak	Tense
paralar	para	Number
dalgınlıkta	dalgınlığı	Case
hamollara	hamollardan	Case
karşılıklarımız	karşılıklarınız	Possession
öpüşmüyordum	öpüşmüyorum	Tense
notiluslarımızın	öpücüklerimizin	lemma
pipetlerimizin	çimkelerimizin	lemma
boğa	boğalar	Number
zibidiydiniz	zibidiyiz	Tense
çukurdan	çukurun	Case
uğratıyorsunuz	çalışıyorsunuz	lemma
iletkenden	iletken	Case
salatalarımıza	çapalarımıza	lemma
hazcılıklara	vampirlere	lemma
Duşanbeliyiz	Duşanbeliydiniz	Tense
akdoğanlara	akdoğanlar	Case
patlamadan	patlamanın	Case
sonuçlarmışsın	ecelermişsin	lemma
küçüklük	küçüklükte	Case
sınamayacaksın	gelinmeyeceksin	lemma
kelimesin	vikipedistsin	lemma
dansçı	dansçıyı	Case
hudutlarında	hudutlarımızda	Possession
onar	birleşir	lemma
kumaştan	kumaşı	Case
odacılardım	odacılardır	Tense
olumsuzlukları	olumsuzluklar	Case
rujlarıma	rujlarımıza	Possession
dalgam	dalgan	Possession
hiyeroglifleri	hiyeroglifler	Case
anasondunuz	anason	Tense
ettirdi	ettirdiler	Number
doyumsuzdum	doyumsuzdun	Person
aygıtlarında	aygıtında	Number
iletkeni	iletkende	Case
uzaksın	uzaktın	Tense
işçisinin	işçisine	Case
kürküme	kürkleri	Case
radarlarına	gerilerine	lemma
günahkârınız	günahkârı	Possession
pozisyonlarınıza	pozisyonlarına	Possession
ücretsizliğime	ücretsizliğimin	Case
büyüleyiciydin	büyüleyiciydim	Person
pırasalardı	terzilerdi	lemma
palikaryalarımızı	dolaplarımızı	lemma
gecemiz	gecemizde	Case
çeliklerdir	çeliklerdi	Tense
tozlarsın	tozlardık	Tense
şövalyeleri	şövalyelerden	Case
mızrapları	mızraplarda	Case
çıkmazlar	çıkmaz	Person
lügatlerimizde	lügatlerimiz	Case
hazırsın	çirkinsin	lemma
köprülere	köprülerde	Case
kullanmasında	Musevisinde	lemma
betiklerimden	betiklerimizden	Possession
sunağı	defteri	lemma
kapadım	kapadı	Person
cep	cepten	Case
sosluklarımızı	dalgalarımızı	lemma
nedenlerdi	nedendi	Number
gruplarından	gruplarına	Case
âlemlerinin	âlemlerini	Case
kovalar	kovalara	Case
muhalefetlerinizde	muhalefetlerimde	Possession
klorofilin	klorofile	Case
kursiyerlerimden	kursiyerlerimde	Case
politikacıların	politikacıları	Case
götverendiler	götvereniz	Tense
seçeneklerden	seçenekten	Number
perini	perinin	Case
düğmeye	düğmenin	Case
örneklerimiz	örnekleri	Possession
kavaklarında	kavağımdan	Case
korsanlarına	durumlarına	lemma
nalını	derneğini	lemma
mustatillerimizden	mustatillerimize	Case
babalığa	babalığın	Case
geometride	geometrinin	Case
götürüyordun	götürüyordunuz	Number
kurutmadınız	bilemediniz	lemma
politikada	politikalarda	Number
numaralamanızın	başvurunuzun	lemma
güreşçiler	aynasızlar	lemma
kerpicinizi	kerpicini	Possession
nüfuzları	nüfuzu	Number
madalyalarda	madalyaları	Case
daldırdılar	daldırırlar	Tense
yetenekliydi	yetenekli	Tense
sevmiyordum	üretmiyordum	lemma
hindisiniz	hindiydim	Tense
yıpranmayacaklar	yıpranmayacaksın	Person
kipleri	kipler	Case
verdirtiyordun	verdirtiyordunuz	Number
raketin	raketi	Case
kızgınız	babacanız	lemma
acıtmadım	yıpranmadım	lemma
bireyin	bireyde	Case
muhallebide	muhallebi	Case
yastıklarınızın	yastıklarının	Possession
hatırı	ıstakozu	lemma
sevişmiyorsun	sevişmiyorlar	Person
pimlerdi	vişnelerdi	lemma
zombiler	zombilerden	Case
hazırlıktan	hazırlığa	Case
parçalanmama	parçalanmaları	Case
laboratuvardan	sıkıntıdan	lemma
marmelatta	marmelat	Case
şapkayı	şapka	Case
delikleri	deliği	Number
hareketsizliklerimi	sürümlerimi	lemma
çalışmalarını	çalışmasını	Possession
öksürüğünüz	öksürüğümüz	Possession
kalabalığı	kalabalıkları	Number
şantajların	şantajları	Case
akbabaymışlar	tundraymışlar	lemma
aynalar	aynalardan	Case
enerji	enerjiden	Case
düğmeleri	düğmelerde	Case
oyuncularımızda	avlarımızda	lemma
görmüyorsun	öğütmüyorsun	lemma
orospulardınız	orospulardır	Tense
mezarlıklarınız	mezarlıkların	Possession
enerjileri	enerjilerin	Case
buluttan	buluta	Case
tutmuyor	yoğurmuyor	lemma
yaratmaz	yaratmadı	Tense
gürgenlere	gürgenlerin	Case
şapkanın	şapka	Case
zahmete	zahmet	Case
acıktırtırsınız	acıktırtırım	Person
sürtükmüşüm	dükkânmışım	lemma
bozunumlarımdan	bozunumlarından	Possession
yapmam	yapman	Possession
fenere	fener	Case
kıyafetler	ayrımcılıklar	lemma
noktalarsın	noktalardın	Tense
elementlerde	elementte	Number
nur	nurun	Case
kutsallıklarda	kutsallıklardan	Case
tabelaya	tabelada	Case
ümitsizdin	ümitsizdiler	Person
acemilerime	acemilerimize	Possession
hedeflere	hedefe	Number
kasaplar	örüntüler	lemma
mandalların	övgülerin	lemma
istemeyiz	istemem	Number
alacaksınız	alacağız	Person
doğrumuşum	doğrumuş	Person
başparmaklardan	başparmaklarda	Case
ayrılmalar	ayrılmalara	Case
kayığa	kayıklara	Number
hazırlıkların	hazırlıklarda	Case
kitapçıklardan	kitapçıktan	Number
aygıtının	aygıtınızın	Possession
bakiri	bakirin	Possession
düğmeye	düğme	Case
panteist	önemsizlik	lemma
keserydı	yüzüncüdü	lemma
amatörünüz	amatörleri	Possession
vermedik	vermediniz	Person
çetelerini	çetelerine	Case
sıcaklıklar	sıcaklık	Number
programlattırmazlar	eğmezler	lemma
kemerlerden	kemerleri	Case
kurabiyeden	kurabiyeyi	Case
damlaların	damlalardan	Case
sözleşmelerini	sözleşmelerinde	Case
sınav	sınavdan	Case
yağ	yağın	Case
lavaşına	doğusuna	lemma
yürekte	yürek	Case
şarkıcılığı	şarkıcılık	Case
kumandaları	kumandalarımız	Possession
kipler	kiplerde	Case
kardeştiniz	kardeşsin	Tense
amcıklar	amcık	Number
maçlarınızı	maçlarımı	Possession
ritüel	ritüeller	Number
büstlerinden	büstümü	Case
paradoks	paradokslar	Number
kullanıcıydın	yuvaydın	lemma
istisnaymışsın	yalancıymışsın	lemma
kıyısından	kıyısında	Case
barbardın	barbarsın	Tense
kanatların	kanatlarda	Case
dakikalarımızda	dakikalarınızda	Possession
pöhrengimde	pöhrenginde	Possession
üstverime	üstverine	Possession
içmediniz	içtiniz	Polarity
anneyi	anneye	Case
elementi	elementte	Case
tütüncüyüm	tütüncüydüm	Tense
purolarımızı	puromuzu	Number
tarakta	taraklarda	Number
sağrılarından	sağrıma	Case
valizinin	valizlerinin	Number
klişeydiniz	yoldaştınız	lemma
şimalim	şimallerine	Case
depresifmişim	depresifmişiz	Number
marangozlarının	cümlelerinin	lemma
odacığa	odacığı	Case
değişiklikleri	değişikliği	Number
sindirdin	dindin	lemma
ünlülerden	ünlüden	Number
alkoller	alkol	Number
bürokratları	bürokratlardan	Case
eylemi	eylemden	Case
kabuklarında	efsunlarında	lemma
aktifiz	coşkusuzuz	lemma
platformlarınızı	yedeklerinizi	lemma
avlarında	avlarından	Case
düşmandınız	düşmanlar	Tense
hazırdılar	hazırlar	Tense
kodları	kodu	Number
birada	birayı	Case
yapımcılara	yapımcılar	Case
kameraları	kameralarda	Case
âlimlerdir	âlimlerdim	Tense
kılmıyordu	basmıyordu	lemma
körlüklerde	körlükte	Number
harfler	harf	Number
tecessümlerin	tecessümün	Number
gökadadan	gökadanın	Case
huzurun	huzuru	Case
keşimizden	keşinden	Possession
ulusuna	ulusumuza	Possession
dilimlerinin	diliminin	Number
oya	oyu	Case
sanatçılarda	sanatçılar	Case
kıllıkları	üreleri	lemma
yorgunluklar	yorgunlukların	Case
hanımın	hanımına	Case
arşivin	arşivlerin	Number
mandalımdan	çerçilerinden	lemma
tamlayanlara	tamlayana	Number
vişnelerdiniz	vişneleriz	Tense
uğratılmayacağız	yapışmayacağız	lemma
pelikanlarız	pelikanlardın	Tense
karşıların	karşılarda	Case
rubai	üye	lemma
ahizelerine	örslerine	lemma
pastalarımdan	pastalarımda	Case
yönelim	yönelimden	Case
tüküreceğim	tüküreceğiz	Number
karpuzmuşum	ayrımcılıkmışım	lemma
sünmez	yummaz	lemma
tornavidalarıma	tornavidalarımın	Case
araçtım	araç	Tense
iskelette	iskeletten	Case
süspansuarımın	süspansuarınızın	Possession
azmadım	azmadık	Number
evcikkıranımıza	evcikkıranımızı	Case
sultanlardı	sultanlarsın	Tense
fotoğrafçıydık	fotoğrafçısın	Tense
süpürgelerde	süpürgede	Number
verdin	geliştin	lemma
melodileri	melodilerden	Case
tüyünün	tüylerinin	Possession
kibire	kibirde	Case
aydınlık	aydınlıkta	Case
lahmacunlarımın	lahmacunlarından	Case
yetenekliymişim	erdemliymişim	lemma
umutsuzdun	doyumsuzdun	lemma
süzgecimi	süzgecini	Possession
maymunumuzdan	yardımcılığımızdan	lemma
sağlar	sağlarım	Number
saçım	saçlarına	Case
solucanlara	eksikliklere	lemma
kardeşliğe	kardeşliği	Case
korse	taht	lemma
kulübin	kulüplerin	Number
mumyalarımızda	mumyalarında	Possession
geride	gerilerde	Number
süründürtüyordunuz	birleştiriyordunuz	lemma
küremiyoruz	küremiyorsun	Person
gökadayı	gökada	Case
kanser	kanseri	Case
körüz	kördüler	Tense
tamlananlarda	tamlananda	Number
ekim	eklerinde	Case
atılıyordun	atılıyordum	Person
ahudutlarında	ahudutlarına	Case
Aşkabatlın	düldülün	lemma
marangozdun	eşcinseldin	lemma
sözlüğüz	ciniz	lemma
saymıyorsunuz	saymıyorsun	Number
kafatasına	kafataslarına	Number
ağaçtan	ağaçta	Case
somda	somu	Case
yaptırırız	daldırtırız	lemma
sınavların	sınavlarda	Case
bitiriyorum	bitiriyorsunuz	Person
tabela	tabelayı	Case
uyanmayacaklar	çıldırtmayacaklar	lemma
âlimsin	âlimdin	Tense
argoları	argolar	Case
siyasetçinin	siyasetçi	Case
modelinde	modellerinde	Possession
fizyolojiye	fizyoloji	Case
babalıkta	babalığın	Case
bürokrata	bürokratlara	Number
dualardan	dualar	Case
güzellik	güzellikten	Case
fırtınalarının	fırtınalarından	Case
surelerden	sureleri	Case
paylaşırlar	paylaştılar	Tense
koşuldunuz	atıştırtınız	lemma
kantonun	kanto	Case
jaguarlar	jaguar	Number
bombacıların	bombacının	Number
kameraydı	kamerayım	Tense
sürülmeyecekler	ağlaşamayacaklar	lemma
dökmezler	dökmeyecekler	Tense
hazırmış	hazırmışlar	Person
kullanılıyordu	geliyordu	lemma
yavrudan	yavruyu	Case
voleyboldan	voleybol	Case
gülmedim	yıkmadım	lemma
seçeneği	seçeneğe	Case
albümün	vişnen	lemma
erdemlisin	erdemli	Person
cinlerinin	cinlerin	Case
şairlerden	şairlere	Case
yaptırıyoruz	yaptırıyor	Person
roketlere	roketlerde	Case
kimofobilerden	kimofobileri	Case
kapakçıkların	kapakçıkları	Case
şövalyenin	şövalyeyi	Case
uykuları	uykularda	Case
hamsiden	hamsilerden	Number
kumaşın	kumaşı	Case
kullanmazlar	girmezler	lemma
ısırganda	ısırgan	Case
topçuydular	topçuyum	Tense
mantıklıydılar	bahtsızdılar	lemma
pastırmalar	pastırmalardınız	Tense
ikazdım	ikazsınız	Tense
bireyin	birey	Case
minder	minderler	Number
çılgınlıkları	çılgınlıklar	Case
ortaklıklarını	ortaklığını	Possession
elementlerden	elementler	Case
engizisyon	engizisyonu	Case
sonranın	sonrada	Case
sürgünümüzden	sürgünlerimizden	Number
sayfaydı	vezirdi	lemma
dağınıkmışlar	dağınıkmışsın	Person
gemilerinin	gemilerinde	Case
titreşimlerin	titreşimin	Number
röntgenlerimize	domateslerimize	lemma
kıblesine	tahtına	lemma
belirtme	belirtmeler	Number
sakızını	sakızının	Case
tandırlarımızı	tandırlarını	Possession
ünlüleri	ünlülerde	Case
sözdizimlerinde	sözdizimlerine	Case
monarşilere	monarşilerin	Case
melodilerde	melodide	Number
yitmeyecek	yitmeyeceksin	Person
helikopterin	helikopterde	Case
sise	uzunluğa	lemma
yalnızlıklarda	yalnızlıklar	Case
ipeklerinizden	ipeklerinizde	Case
çıban	çıbanlar	Number
endüstriler	endüstrilerde	Case
çiftim	çifttin	Tense
gözyaşlarının	gözyaşlarını	Case
betiğim	betiği	Possession
kışkırtıyordunuz	açılıyordunuz	lemma
şarkımda	şarklarından	Case
kayıtlarınız	vekilleriniz	lemma
pezevenklerime	pezevenklerini	Case
belirtme	belirtmenin	Case
kırolarının	çeşnilerinin	lemma
oynatıcılarımdan	oynatıcılarıma	Case
sunu	çöpçatan	lemma
mistikler	ziyaretler	lemma
bileceğim	bileceğiz	Number
evliliğin	evliliğim	Possession
şarkıcılarıma	şarkıcılarımda	Case
küçüleceksin	küçülecek	Person
paylaştırmam	paylaştırmanız	Possession
acımaz	çevirmez	lemma
fundalarda	fundada	Number
bekliyorduk	bekliyordum	Person
soylularda	soyluda	Number
kahramanız	kahramandın	Tense
sunultaylar	sunultaylara	Case
önce	önceler	Number
ayvazsın	ayvazdım	Tense
tekilaydınız	tekilasın	Tense
arkadaşlıklarından	arkadaşlıklarını	Case
önceler	öncelerde	Case
kaynaştırtmayacağım	kaynaştırtmayacağız	Person
inekler	ineklerin	Case
beytim	beyittiniz	Tense
peskütanın	peskütanımız	Possession
otocuymuşuz	ceylanmışız	lemma
şikâyetleri	şikâyetime	Case
karanlığın	karanlık	Case
limonatan	limonatanız	Possession
tecritlerine	tecridine	Number
pandalara	pandaya	Number
bakire	bakireydi	Tense
utkularda	utkuları	Case
koltuğa	koltukta	Case
fiillerden	fiillere	Case
akışkanı	akışkanda	Case
civarda	civar	Case
mesafeyi	mesafeden	Case
flaşlardım	flaşlar	Tense
koydu	koyar	Tense
trigonometriye	trigonometrilere	Number
akrabasına	akrabana	Possession
kırıldım	kırıldık	Number
şafaklara	şafakları	Case
çılgınlığın	çılgınlıktan	Case
sürürsün	sürüdün	Tense
coşkulusunuz	coşkuluydunuz	Tense
çapalardı	çapalardır	Tense
kalıyoruz	çıkarıyoruz	lemma
dullarım	dullardın	Tense
baslardı	baslarız	Tense
otelinde	bazında	lemma
maymunlarız	fotoğrafçılarız	lemma
camilerimi	camilerinizi	Possession
minberlerinin	minberlerinde	Case
bağımda	bağında	Possession
cennetten	cennete	Case
kutlamaya	kutlamalara	Number
meşrubatlarımızı	meşrubatlarınızı	Possession
pencere	pencereler	Number
topları	topu	Number
Belgratlılardı	beyitlerdi	lemma
şüpheleriz	şüphelerdin	Tense
kuvvetlere	kuvvetleri	Case
kistimde	çadırımda	lemma
kullanmıyorum	kullanmıyoruz	Person
gelinliğe	gelinliklere	Number
rüya	amatör	lemma
fagofobileri	fagofobilere	Case
tarafının	tarafından	Case
yalvarışların	yalvarışlar	Case
cinselliğin	cinsellik	Case
geberirler	gebermezler	Polarity
yalvarmıyor	yalvarmıyorsunuz	Person
lazerler	lazerlerin	Case
karnelerini	başrahibimi	lemma
öncede	önceden	Case
sülüslerimden	sülüslerime	Case
uğratmıyordunuz	şamarlamıyordunuz	lemma
hipotalamuslarınıza	çedarlarınıza	lemma
odalar	odaydık	Tense
yapıyı	yapının	Case
çevrelere	çevrelerin	Case
denizyıldızları	denizyıldızı	Number
düşünür	düşünürsünüz	Person
ılımıyordular	ılımıyordun	Person
sekretere	sekreterin	Case
bardakları	bardaklarımdan	Case
iletkenleri	iletkenlerden	Case
modamızda	uyarımızda	lemma
prototiplerde	prototipler	Case
taraflarını	tarafımdan	Case
bakirdim	bakirim	Tense
aptallıkları	aptallıklardan	Case
adsızmışım	adsızmış	Person
zombide	zombiden	Case
amiralliğin	amiralliği	Case
akrobattık	akrobatsınız	Tense
sarhoşluğu	sarhoşluktan	Case
manitaymışsın	bağmışsın	lemma
seçeceksin	bürüyeceksin	lemma
gözlükçüsünüz	gözlükçüydük	Tense
polisi	dövüşü	lemma
başarılıydı	başarılı	Tense
örtüsün	örtüydüm	Tense
argolarda	argoların	Case
boğazlarında	boğazlarından	Case
delersiniz	delerim	Person
paylaşır	döver	lemma
yörüngemizden	yörüngelerinden	Possession
bilgisayarlıyım	bilgisayarlıydım	Tense
ısırığın	ısırığı	Case
dalgıcı	dalgıcına	Case
kıskanıyorlardı	kıskanmıyordular	Polarity
kemerlerin	kemerleri	Case
intikamınızın	intikamının	Possession
gökdelene	gökdeleni	Case
monarşilerden	monarşilere	Case
boşalıyorduk	boşalıyordunuz	Person
üyeliklerinize	üyeliklerime	Possession
paylaşmıyorum	paylaşıyorum	Polarity
kuvantumları	kuvantumlardan	Case
buharlaşıyorsun	buharlaşıyorsunuz	Number
hücrelerdim	hücrelerim	Tense
sülüklerde	sülüklerden	Case
sermediler	sermedin	Person
mandalsın	flaşsın	lemma
sığar	sığacak	Tense
armağanlardan	armağanları	Case
keş	diş	lemma
vasiyetlerin	vasiyetleri	Case
onguncular	onguncuydunuz	Tense
coşkuluyduk	coşkuluyuz	Tense
köftenize	yanağınıza	lemma
kalamardım	kalamarsın	Tense
kovdurduk	yırttık	lemma
bakirliklerde	bakirliklerden	Case
iletkenin	iletkenlerin	Number
ninnilerimizden	farelerimizden	lemma
kalamarlardınız	dilberlerdiniz	lemma
tuvalet	tuvalette	Case
bloglarda	bloglardan	Case
paşayız	öyküyüz	lemma
hükûmetlerdi	şarkıcılardı	lemma
çarmıha	çarmıhta	Case
sıyırmıyorlar	sıyırmıyordular	Tense
sıcaklığa	sıcaklığın	Case
meşrubatlarında	meşrubatlarından	Case
marangozdu	marangozlar	Tense
hücreden	hücre	Case
dudakları	dudaklarına	Case
müelliflerinizden	müelliflerimizden	Possession
fizikçilerdiniz	fizikçileriz	Tense
değirmenimizin	değirmeninin	Possession
pudinge	puding	Case
karıştırtdılar	demlediler	lemma
odacımdan	odacımızdan	Possession
erke	erkeler	Number
puanınız	puanları	Possession
inandı	boşaldı	lemma
voleybola	voleybolun	Case
abacısınız	bineksiniz	lemma
meydana	meydan	Case
kinematiğe	kinematikten	Case
pastırmaymışım	Lefkoşalıymışım	lemma
katkıya	katkıda	Case
değerliydin	değerlisin	Tense
kutsallıklar	kutsallıklarda	Case
annenin	anneden	Case
seçicinden	seçicin	Case
sevmez	sevmem	Person
programlanmayacaksınız	binmeyeceksiniz	lemma
seslenmezsin	diremezsin	lemma
enfeksiyonumuzu	enfeksiyonumuzdan	Case
çedarımızın	çedarımızda	Case
dudaklarından	dudakları	Case
yönelmelerden	yönelmeleri	Case
acentelikler	acentelik	Number
depresyonda	depresyonlarda	Number
kinematikler	kinematiklere	Case
endüstrilere	endüstrilerde	Case
hamamda	hamamın	Case
bürokratlara	bürokratlar	Case
bahçelere	bahçelerden	Case
kolalarımız	kolaları	Possession
depresyonları	depresyonu	Number
elifbelerin	elifbenin	Number
gökadalar	gökadalardan	Case
elipsinizi	elipsini	Possession
uyandı	uyandılar	Number
katmayacaklar	döndürmeyecekler	lemma
çarlarıma	çarlarından	Case
elifbelerden	elifbeden	Number
katılaşıyordunuz	üzüyordunuz	lemma
parçalanırız	ayılırız	lemma
kalını	kalın	Case
işkencecilerinize	işkencecilerine	Possession
güvenimize	brokolimize	lemma
almanak	almanağı	Case
profiterolden	profiterolün	Case
aydınlığa	aydınlığı	Case
maşasının	bağının	lemma
afiyetimiz	Cakartalımız	lemma
robot	robota	Case
harf	harfin	Case
sinüste	sinüsü	Case
kobralarda	kobralara	Case
pilavlardır	pilavlardı	Tense
sacın	sac	Case
onurunuz	anüsünüz	lemma
nüfus	nüfusu	Case
sandalyenin	sandalyeye	Case
tayfasın	fahişesin	lemma
nergisiniz	nergisim	Possession
önceye	öncenin	Case
katılaşacağım	katılaşmayacağım	Polarity
sinüsten	sinüslerden	Number
lahmacununuzun	çiftinizin	lemma
eksikliğini	eksikliklerini	Possession
röportajımızdan	başlangıcımızdan	lemma
iletinin	iletilerin	Number
akışının	akışını	Case
kasaplarının	kasaplarımın	Possession
kukulardan	kukulara	Case
sonlarsınız	vurgularsınız	lemma
sıcaklıktan	sıcaklığın	Case
yüreğe	yürekte	Case
bitirtmiyordum	bitirtmiyordunuz	Person
programlanmaz	programlanmazsın	Person
oyuncaklardınız	oyuncaklarsın	Tense
krallıkların	krallıkları	Case
bürokratlardan	bürokrattan	Number
ritminizi	önemliliğinizi	lemma
hadisi	hadise	Case
öğrencinin	öğrencinizin	Possession
azınlık	azınlıktan	Case
soğumayız	soğumazlar	Person
karamellerinin	türevlerinin	lemma
kaybolmuyordular	kaybolmuyorduk	Person
hahamından	hahamlarından	Possession
ilaçlara	devingenliklere	lemma
cephelerinde	cephemizde	Possession
katmıyordun	dolmuyordun	lemma
abecelere	abecelerden	Case
ilçeden	ilçelerden	Number
nohutumuza	nohutumuzda	Case
cenaze	cenazeydiler	Tense
bükecek	bükeceksin	Person
bürokratları	bürokratlara	Case
yavruydun	yavrular	Tense
cinselliğe	cinsellik	Case
şiirde	şiirin	Case
artıklarının	artıklarınızın	Possession
akışın	akışından	Case
hamızlarında	dişleklerinde	lemma
saate	saatte	Case
çiş	çişler	Number
cemaatimizin	cemaatinizin	Possession
kolonyanızda	kolonyamızda	Possession
maymunumuzda	maymununuzda	Possession
ereceğiz	erdik	Tense
güleceksiniz	bıkacaksınız	lemma
şahısların	şahıslarını	Case
övmedin	övmediniz	Number
Musevilerimizden	Musevilerinden	Possession
bitişine	bitişinden	Case
teklifimin	tekliflerinde	Case
yazıda	yazıya	Case
masummuş	barbarmış	lemma
masumiyete	çağanoza	lemma
sacı	sacda	Case
itmezler	düzelmezler	lemma
hesapları	sınırları	lemma
ucubelerdi	ucubelerim	Tense
içliği	içliğinin	Case
yönelim	yönelime	Case
hastalandın	çıktın	lemma
jenerasyonumda	jenerasyonlarını	Case
perdelerden	perdelerde	Case
uydulardı	uydulardır	Tense
asmaz	asmadı	Tense
dişleklerimi	dişleklerine	Case
pedofobilere	pedofobileri	Case
asansörün	asansörde	Case
politikacılardan	politikacılara	Case
şaşırıyorum	şaşırıyor	Person
dönmedik	döndük	Polarity
bahtsızmış	bahtsızmışlar	Number
meşrubatlar	dürümler	lemma
radardan	uzaktan	lemma
allıklara	allığa	Number
karıncaymışsınız	ziyaretmişsiniz	lemma
tayfalar	tayfalardın	Tense
dağlarına	dağlarının	Case
silmetaşa	silmetaş	Case
değişiklikte	değişiklik	Case
almanak	almanağa	Case
çıkmaları	çıkmalarda	Case
sistemi	sistemim	Possession
ayçiçeklerini	ayçiçeklerinden	Case
ziyarettiler	ziyaret	Tense
iskender	ayvaz	lemma
birlikteliklerini	birlikteliğini	Number
abartmazsın	ürümezsin	lemma
küçüleceksiniz	canlandıracaksınız	lemma
kondomlara	kondoma	Number
uğratıldım	uğratılırım	Tense
kristale	yumuşakçaya	lemma
ağaçları	ağaçların	Case
sızacağım	yaracağım	lemma
zaferleriz	zaferlerdin	Tense
kafatasına	kafatasında	Case
büyükelçiyi	büyükelçi	Case
çapsınız	çaptık	Tense
rahatsızlanmıyordum	demiyordum	lemma
aileyi	ehemmiyeti	lemma
yakınlarından	yakınlarında	Case
buzdolabında	buzdolabına	Case
okyanusun	okyanusların	Number
antropolojiler	antropolojilere	Case
alındırtıyorum	diliyorum	lemma
odacılarız	veterinerleriz	lemma
otomobillerini	otomobilleri	Case
torunlardı	torunlarsınız	Tense
sunaklarımızdan	dağlarımızdan	lemma
kırolardı	kırolardır	Tense
kaygılarda	kaygılardan	Case
boğadan	boğa	Case
söğütleri	söğüdümü	Case
kolaçta	kolacın	Case
yakınların	yakınlarından	Case
füzeler	füzelerin	Case
yanlışlığın	yanlışlığı	Case
titreşimlere	titreşimler	Case
sahifeymişim	üstveriymişim	lemma
iyonosferden	iyonosferin	Case
terapistlerdim	terapistlersiniz	Tense
konuştay	konuştayda	Case
elektromanyetizmada	elektromanyetizmanın	Case
türemiyor	türemiyordu	Tense
mümessilliklerdi	mümessilliklersin	Tense
yazarlar	yazar	Number
perdede	perdeyi	Case
Aşkabatlıydın	fizikçiydin	lemma
soygazlarımıza	soygazlarına	Possession
oteline	vitrinine	lemma
startını	ambulansını	lemma
otoculuktunuz	otoculuğum	Tense
vikipedisttiler	vikipedistlerdik	Number
minarelerinde	minarelerin	Case
hazırdınız	hazırdık	Person
küçüktük	küçüktüler	Person
parıltılarım	parıltılarımı	Case
sekmezsin	sekmem	Person
vücut	vücuda	Case
incirin	atomun	lemma
sıvılaştırmayız	sıvılaştırmazlar	Person
ileti	iletiyi	Case
kadayıfa	kadayıflara	Number
meşaleler	tenisçiler	lemma
karınlarımızda	karınlarımıza	Case
korkutmazsınız	korkutmazsın	Number
kosinüsleri	kosinüsü	Number
jeolojilerde	jeolojide	Number
kahramanınızdan	kahramanınızda	Case
nohutlarım	nohutlardım	Tense
deve	develer	Number
hedonizmimizde	çorabımızda	lemma
pazıda	pazıyı	Case
kervansarayları	kervansarayı	Number
raporda	önde	lemma
saymıyor	saymıyorum	Person
alkol	alkole	Case
kraliçeler	kraliçe	Number
vermezsin	geliştirmezsin	lemma
tutulması	tutulmam	Possession
dutta	duta	Case
bahardan	baharı	Case
başparmağın	başparmağı	Case
içyüzlerinin	geçmişlerinin	lemma
kolalarımızın	kolalarımız	Case
görüşlerine	görüşlerimize	Possession
tarağı	tarakları	Number
şırıngalarız	şırıngalardın	Tense
sagamızdan	uçurtmamızdan	lemma
yamukta	yamuğun	Case
saksının	saksıda	Case
ortaklarında	ortağında	Possession
pırasasından	bölümünden	lemma
uymadık	uymadınız	Person
hücrelerini	dağlarını	lemma
sağarsın	bakarsın	lemma
daldırtmıyor	daldırtmıyorum	Person
asayı	asadan	Case
kalmayız	kalmazlar	Person
gölgesinde	çekirdeğinde	lemma
güzü	güzün	Case
lenslere	lenslerden	Case
babaanneleri	babaannelerden	Case
idealine	idealinde	Case
eklemeliydiler	eklemeliler	Tense
alırlar	aldılar	Tense
güze	güzü	Case
bireylerde	bireyler	Case
edebiyat	edebiyatlar	Number
öcümün	öcünün	Possession
pandalarda	pandada	Number
bülbülyuvasına	bülbülyuvasından	Case
mallarının	beneklerinin	lemma
kumaş	kumaştan	Case
külotlarımdan	telefonlarımdan	lemma
urda	uru	Case
gagadan	gagayı	Case
kuralları	kuralın	Possession
toptan	toplardan	Number
kılı	şalvarı	lemma
büktürtürler	büktürtmezler	Polarity
yönelimde	yönelimlerde	Number
yazarlar	yazarları	Case
dindarım	dindar	Person
matlaydık	matlalar	Tense
kullanacağız	çıkacağız	lemma
gölden	göle	Case
nükleotitlerden	nükleotitten	Number
kapüşon	kapüşonun	Case
kristallere	kristale	Number
bombacılarda	bombacılara	Case
arayüz	arayüzler	Number
beklemeye	beklemenin	Case
sultanlardın	sultanlar	Tense
katım	önerim	lemma
katamaranlarımı	katamaranlarınızı	Possession
katılıyorum	katılıyor	Person
katilimizden	katilimize	Case
tekliflermiş	ucubelermiş	lemma
gökdelenden	gökdelenlerden	Number
kanserlerden	kanserler	Case
palyaçoydu	palyaçoyuz	Tense
hızlılar	hızlıdılar	Tense
mendilleri	teorileri	lemma
ödeve	ödevin	Case
kalemtıraşlarım	sürümleri	lemma
müzede	müzelerde	Number
füzelere	füzeye	Number
hazinelere	hazineler	Case
otizm	otizmi	Case
turşularız	turşulardınız	Tense
kayığa	kayığın	Case
ritmimde	ritmim	Case
iffetler	iffettim	Tense
kanallara	kanallar	Case
yaratıkların	yaratıkları	Case
önceleri	öncelere	Case
okunaklılıktan	okunaklılığın	Case
tuvaletlerden	tuvaletlerin	Case
fetişinizi	fetişlerini	Possession
tanrılar	tutkular	lemma
ekonomisti	ekonomistleri	Number
notun	notu	Case
bürokratları	bürokratlar	Case
gökkuşakları	gökkuşaklarını	Case
falımın	falımdan	Case
konuklar	konuk	Number
kursiyeriz	yalanız	lemma
kuyumcuydular	kuyumcular	Tense
merdivenlerinizi	çekmecelerinizi	lemma
irdelemiyordu	öldürtmüyordu	lemma
unlarımda	unlarından	Case
lepistesimizin	bipimizin	lemma
bluzsuzuna	bluzsuzunuza	Possession
karaciğerlerin	bataryaların	lemma
mikroplarının	yapbozumun	lemma
lense	lensten	Case
kazımayız	yenilmeyiz	lemma
kanatlarda	kanatta	Number
kondom	kondomu	Case
enerjiden	enerjinin	Case
şafakları	şafağı	Number
rotorumuza	rotoruma	Possession
garajların	garajları	Possession
ilimlerini	gemilerini	lemma
ütüyüz	ütüydün	Tense
nohutlarım	nohutlardı	Tense
avcılarsınız	avcılardı	Tense
tildede	tildenin	Case
dokuzgeni	dokuzgene	Case
ışınlar	ışın	Number
hikâyelerde	hikâyelere	Case
dindarmışlar	dindarmış	Number
kotanjantlarda	kotanjantta	Number
masan	masası	Possession
hissi	hisleri	Number
sacın	sacda	Case
vaftiz	vaftizin	Case
heyecanlandırttım	aştım	lemma
parlatıyorduk	büküyorduk	lemma
aktrislerdir	aktrislerdi	Tense
şokları	şoklar	Case
birdirbirlerin	birdirbirin	Number
aptallıkta	aptallıktan	Case
verimsizleştirmiyoruz	bulamıyoruz	lemma
akşamlarımın	bayılmalarımın	lemma
sigaralar	sigaraları	Case
cephelerdir	cephelerdi	Tense
âlimlerdi	âlimlersiniz	Tense
noktürnleri	noktürnü	Possession
aktörler	aktördü	Tense
etkilerden	etkiler	Case
teknolojiye	teknoloji	Case
sevgililerinizi	sevgililerimi	Possession
muşmulalara	muşmulalarda	Case
cinselliklere	cinsellikleri	Case
maskaralar	maskaraydılar	Tense
şapkalara	şapkaya	Number
çiçekçinin	çiçekçi	Case
oyalamaz	bıkmaz	lemma
sapanmışlar	şapkacıymışlar	lemma
gülmüyordular	yağlamıyordular	lemma
kokmuyorsun	kokmuyoruz	Person
arayüzlerin	arayüzün	Number
liselerden	liselerde	Case
müellifler	yalanlar	lemma
umutluydu	diriydi	lemma
yıldızımızı	yıldızlarımızı	Number
tekillerimi	tekillerime	Case
politikacılar	politikacı	Number
abarttınız	abartmadınız	Polarity
iletkenlerin	iletkenlerden	Case
bakandınız	bakanlar	Tense
tercümelere	tercümeler	Case
gösterdik	gösterdin	Person
egoizmlere	egoizmleri	Case
olcalara	olcalarda	Case
öznesine	özneme	Possession
dinamitimi	dinamitlerini	Number
heyecanlanırız	barışırız	lemma
mevsimler	mevsim	Number
belirteçlerin	belirteçlerden	Case
hafriyatı	hafriyatta	Case
maskeler	maskelerin	Case
kurabiyeden	kurabiyeye	Case
nomofobilere	nomofobiye	Number
hunisinden	huninizden	Possession
limonatanıza	yabancınıza	lemma
alçak	depresif	lemma
pisleteceğim	geçineceğim	lemma
pilavdı	pilavsınız	Tense
şırıngalardı	şırıngalarız	Tense
antioksidanlar	antioksidanlara	Case
Kopenhaglılarmış	Kopenhaglıymışım	Number
halıya	halılara	Number
sözleşmelerimin	sözleşmelerini	Case
azınlıklardan	azınlıktan	Number
köprülerin	köprülere	Case
cevabın	cevapların	Number
pipetlerinden	pipetimizden	Possession
marmelatların	marmeladın	Number
okyanuslar	okyanuslara	Case
üçüzlerini	üçüzlerimizi	Possession
hazine	hazineye	Case
civarların	civarın	Number
aşmadın	aşmadı	Person
şiirleri	şiirlerden	Case
cisimdiniz	cisimsiniz	Tense
paşalarından	bacalarından	lemma
cacığın	cacığa	Case
kartlarımdan	kartlarından	Possession
dövüşçü	dövüşçüydü	Tense
ikilemden	cenazeden	lemma
tacizin	tacizi	Case
gözlemde	gözlemlerde	Number
etkide	etkiden	Case
yorgunum	yorgunsunuz	Person
kuzulardım	kuzularsınız	Tense
evlatlıktan	evlatlıklardan	Number
kutudan	bağdan	lemma
tetrafobinin	tetrafobilerin	Number
bölgesin	bölgeydim	Tense
hamamların	hamamlara	Case
mektubunun	mektubumuzun	Possession
ailelerde	ailelere	Case
rüzgarı	rüzgarın	Case
verimsizleştiriyorum	yuvarlaıyorum	lemma
lügatçelerine	lügatçem	Case
kuvvetlermişsiniz	şüphelermişsiniz	lemma
silkmezsiniz	silkmezsin	Person
tabelalarda	tabelaların	Case
kütüğünü	üstverisini	lemma
köprülerin	köprülerde	Case
kanatlardan	kanatlarda	Case
dürüme	dürümlere	Number
nüfuzda	nüfuza	Case
türünün	türü	Case
çapalardınız	çapalarsın	Tense
ısırığın	ısırıkların	Number
kırdırmadınız	gizlemediniz	lemma
sosisimiz	sosisi	Possession
aygırlardım	aygırlarım	Tense
tokofobilerin	tokofobilerde	Case
götverenler	dedikoducular	lemma
birayı	biraya	Case
rüzgara	rüzgardan	Case
mutluluklarını	gecelerini	lemma
kırıntıları	kırıntıların	Case
gübresiniz	gübreydin	Tense
yönelme	yönelmeden	Case
basketbolcularım	basketbolculardım	Tense
şuruptan	şurubun	Case
kırıtıyordun	çeviriyordun	lemma
mezarlıklar	mezarlıktık	Tense
kanala	kanallara	Number
olcayı	olcaya	Case
hukukta	hukukun	Case
yapıda	yapılarda	Number
vajinanın	vajinada	Case
civcivlerden	civcivler	Case
ineklere	ineklerden	Case
indekste	indeksi	Case
sinematograflarımızda	sinematograflarında	Possession
kanat	kanatlar	Number
pazılar	pazı	Number
sivrisineğinizden	sivrisineklerinizden	Number
sıvılarda	sıvılara	Case
enflasyonu	enflasyonda	Case
peygamberdevelerinin	peygamberdevelerinden	Case
eşcinselsiniz	eşcinseldiler	Tense
yetiştirirler	yetiştirir	Person
cümlelerimizden	cümlemizden	Number
kuruşa	kuruş	Case
katıldım	deldim	lemma
peçete	gemi	lemma
yöresi	yöresinin	Case
bezdirilerden	bezdirilerin	Case
çarpıydım	çarpı	Tense
sepetiniz	bereketiniz	lemma
aile	aileden	Case
düşeslere	düşesler	Case
konukların	konuklardan	Case
karılarsın	karılardınız	Tense
avcıydık	avcısınız	Tense
vasatız	vasat	Person
kullanıcıyım	kullanıcıydı	Tense
karakterim	geyşayım	lemma
pöhrengiz	pöhrenktiniz	Tense
kaçmadınız	yummadınız	lemma
güvercinlerine	güvercinlerinin	Case
kodu	koda	Case
yüzüncülersin	yüzüncülerdi	Tense
usullar	usul	Number
şamandıralarda	şamandırada	Number
gücenmedik	doğmadık	lemma
kirpik	kirpikler	Number
devirinden	devirinin	Case
sıradanmışım	dağınıkmışım	lemma
istatistiklerin	istatistikler	Case
yalvarışlara	yalvarışlar	Case
malamozlarınıza	doğruculuklarınıza	lemma
mumyalardın	mumyalarsın	Tense
blogcularından	blogcularım	Case
kalamarlarımdan	düzinelerinden	lemma
ziyaretlerim	ziyaretlerdik	Tense
konsey	zeytin	lemma
saksıya	saksılara	Number
aletinde	cevizinde	lemma
uzuneşekde	uzuneşeğe	Case
nükleotidin	nükleotidi	Case
sıvıların	sıvılarda	Case
izlekleriniz	avokadolarınız	lemma
peygamberdevelerinin	peygamberdeveleri	Case
sattırtıracaklar	sattırtıracak	Person
kararmayacağım	yedirtmeyeceğim	lemma
mayalarımdan	mayalarım	Case
işitir	boğar	lemma
işitmez	binmez	lemma
kayboluruz	çıldırtırız	lemma
koordinatının	koordinatına	Case
karantinalarımızın	karantinalarımızda	Case
dülgerde	dülgeri	Case
sabanımızda	sabanında	Possession
yazının	yazıların	Number
bulutların	bulutlardan	Case
paradoksları	totemleri	lemma
kilerimiz	boksumuz	lemma
tuvaletleri	tuvaleti	Number
tabakları	tabaklara	Case
kalkanların	kalkanın	Number
sabanlarında	birlikteliklerinde	lemma
barbardın	barbardınız	Person
sislerine	şahıslarına	lemma
konserler	konserlerin	Case
kodları	kodlardan	Case
vahaydı	vahasın	Tense
şikayetlerden	şikayetlerde	Case
patlamadık	patlamadım	Person
yetenekliyim	erdemliyim	lemma
tatilden	tatilde	Case
karakterleri	karakterlerinde	Case
aygıtçıklarımın	aygıtçıklarından	Case
Nusayrîlere	Nusayrîye	Number
aşçıyım	aşçıydım	Tense
birliklerimde	birliklerini	Case
aracımıza	aracınıza	Possession
geçmişlerimden	geçmişlerimizden	Possession
develeri	deveyi	Number
mistiklerdin	uzaklardın	lemma
sihirliyim	sihirlisiniz	Person
kanserlere	kanserlerin	Case
annenin	anneye	Case
gerekmem	gerekmeyiz	Person
topolojilerinin	topolojilerimin	Possession
belimizin	bellerinin	Possession
ritüelleri	ritüellerin	Case
şarkıcılıkları	şarkıcılıklar	Case
değişkenlersin	değişkenlerdi	Tense
değişiklikten	değişikliklerden	Number
küredik	küremedik	Polarity
meleğimizde	meleğinde	Possession
kulaç	kulaçlar	Number
papalarının	eriyiklerinin	lemma
gözlemler	gözlemlerin	Case
kimliğimin	kimliklerini	Case
bulayacaksınız	bulayacağım	Person
karpuzlarına	karpuzlarınıza	Possession
sonralardan	sonradan	Number
şalım	şalınız	Possession
yabancılardır	yabancılardınız	Tense
karakollarımda	karakollarınızda	Possession
zeytinyağının	zeytinyağından	Case
ünsüzler	ünsüzlere	Case
sikişmeyeceksiniz	sikişmeyeceğim	Person
ablanıza	vişnenize	lemma
kanatın	kanattan	Case
izlemez	izler	Polarity
atışmayacaksın	atışmayacaksınız	Number
kalamarlarmış	çaplarmış	lemma
bıçaklıyorum	bıçaklıyor	Person
dünyaya	dünyada	Case
oyuncakları	asteroitleri	lemma
deliklerimizi	deliklerimizin	Case
alanı	takatı	lemma
önyargıyı	önyargının	Case
anasızlıklarımı	anasızlıklarınızı	Possession
gübreler	üstveriler	lemma
konukların	konuklarda	Case
maaşı	maaşları	Number
kürkeni	kürkenin	Case
kokmuyordum	ürkmüyordum	lemma
alevdin	şarkıcıydın	lemma
şampanyalarının	şampanyalarına	Case
titreşimden	titreşimde	Case
oğulsunuz	oğuldun	Tense
bacağın	bacakta	Case
yaratığa	yaratıklara	Number
tercümeden	tercümeye	Case
yağmalar	yağmalarda	Case
samurayın	samuray	Case
istatistik	istatistikler	Number
cinselliğin	cinselliği	Case
siyasetçileri	siyasetçilere	Case
çevre	çevreler	Number
bürokrasinin	bürokrasiden	Case
koparsın	koparız	Person
gökdelenlerin	gökdelenler	Case
mahzeni	yamyamı	lemma
bozayılarında	bozayılarınızda	Possession
kristalin	kristal	Case
tabelanın	tabelaların	Number
ortaklıklarını	ortaklıklarına	Case
alkol	alkolün	Case
tuvalete	tuvalette	Case
portakallarımızın	başkanlarımızın	lemma
ördeğimizde	ördeğinde	Possession
yerdim	yersiniz	Tense
istatistiğe	istatistik	Case
örüntülerde	örüntüde	Number
önyargıdan	önyargıyı	Case
gazelsiniz	gazeldik	Tense
ustalardık	ustalarım	Tense
kalından	kalın	Case
ekti	ekiz	Tense
anarşide	anarşilerde	Number
ilginçmişim	ilginçmişsin	Person
vekilleriz	vekillerdiniz	Tense
dürüm	dürümün	Case
piknikler	pikniklerden	Case
ayine	ayinlere	Number
akışkanların	akışkanlar	Case
vahalarsın	vahalardınız	Tense
kumanda	yalancılık	lemma
hacılarını	yönlerini	lemma
hazinelerin	hazinelere	Case
ayazları	ayazların	Case
nükleotitler	nükleotit	Number
olduk	oldun	Person
yüreği	yürekleri	Number
siyasetçilerin	siyasetçinin	Number
tarağı	tarağa	Case
kovmadım	dalgalanmadım	lemma
tuğlada	tuğlaya	Case
soruma	sorumun	Case
dansçıyı	dansçıya	Case
yumuşakçalardık	yumuşakçalarsın	Tense
keşfetmeyecekler	yetmeyecekler	lemma
kaşırlar	boyarlar	lemma
hamola	hamolda	Case
votkaydınız	votkasınız	Tense
beceriksizmişim	beceriksizmişsin	Person
şairler	şairlerin	Case
saklanmıyorum	ölçtürmüyorum	lemma
güçlüklerini	yarışmalarını	lemma
zombi	zombinin	Case
sandalyelere	sandalyelerin	Case
kesiyor	kesiyorlar	Person
öpeceksin	öpecek	Person
ağırdım	ağırdınız	Person
çekirgelere	çekirgeye	Number
ağlaşamıyor	ağlaşamıyorlar	Number
solucandı	solucansınız	Tense
acıkmıyorsun	bitirttirmiyorsun	lemma
varoşumuzdan	varoşunuzdan	Possession
deltoid	deltoidden	Case
nohutlarmış	âmâlarmış	lemma
alkolü	alkolleri	Number
galaksiden	galakside	Case
sürtmeyeceğim	sürtmedim	Tense
kediciklerine	kedicikleri	Case
genelevimde	genelevlerinden	Case
dayanıklılıkların	dayanıklılığın	Number
eklerini	eklerimi	Number
ustalar	ustaların	Case
avlarsınız	avlardım	Tense
akşamına	akşamından	Case
politikacılar	politikacılara	Case
kervansaraylar	kervansaray	Number
robotlardan	robotlara	Case
masum	masumdu	Tense
yoldurmam	yoldurmayız	Number
bakan	bakandılar	Tense
vaktin	vaktimiz	Possession
ispatladılar	geçtiler	lemma
acenteliğin	acenteliklerin	Number
vazoya	vazodan	Case
laçoydum	laçosun	Tense
kurtaracağız	anlatacağız	lemma
sevgililerden	sevgilileri	Case
politikacılardan	politikacılar	Case
saksocusun	saksocuydum	Tense
tercihlerini	tercihlerinde	Case
yenilir	yenilmez	Polarity
parlatıyorsun	parlatıyorsunuz	Number
sivrisineğine	sivrisineğime	Possession
beyitleriz	beyitler	Number
özeliz	özelim	Person
kaderlerimizden	kaderlerimize	Case
yarıştan	yarış	Case
abeceleri	abecelere	Case
indekse	indeks	Case
ongunculardım	çapalardım	lemma
açıyorsunuz	açıyorum	Person
sancakta	sancaklarda	Number
amca	amcayı	Case
tokofobiler	tokofobilerden	Case
yaralarına	yaralarında	Case
mantiymişiz	mantilermiş	Number
altıgenleri	altıgenlerde	Case
eğlencelerdiniz	eğlencelersin	Tense
verniklemelerinden	verniklemelerime	Case
pasif	pasifler	Number
çalışmalarından	çalışmalarının	Case
birdirbirlerin	birdirbirlerden	Case
küçükmüşler	küçükmüşsün	Person
işittiler	yağdılar	lemma
pastaları	pastan	Possession
annelikte	anneliğe	Case
girdaplar	girdaptılar	Tense
mügeydiniz	fildiniz	lemma
kümelerini	kümelerinin	Case
duaya	duayı	Case
kotanjantı	kotanjant	Case
olumsuzluklara	olumsuzluklar	Case
ağaçta	ağaca	Case
aksisedamda	aksisedalarımda	Number
papyonuma	papyonuna	Possession
roketlerden	roketlerde	Case
halıda	halıdan	Case
zahmette	zahmetlerde	Number
yarışa	yarışı	Case
sahiplerinin	sahibinin	Number
kıyılarını	veterinerlerini	lemma
haritaya	haritayı	Case
Aşkabatlılardı	Aşkabatlılarsınız	Tense
zombilere	zombilerde	Case
sandalyelerden	sandalyeler	Case
iğdeyi	iğdede	Case
fabrikalar	fabrikalara	Case
perdelerden	perdelerin	Case
zombilerden	zombiden	Number
enfeksiyonunda	enfeksiyonuna	Case
tatlılardır	vikipedistlerdir	lemma
konferans	balıkçı	lemma
fikolojilerin	fikolojilerden	Case
kullanmaların	ebelerin	lemma
kemerlerin	kemerin	Number
deisttik	deistim	Tense
aldırtırmaım	aldırtmamam	Polarity
sonuçlarına	sonuçlarından	Case
kenarını	kenarlarını	Possession
gelinmiyorduk	geliniyorduk	Polarity
başparmaklarda	başparmaklara	Case
süründürmeyeceğim	süründüreceğim	Polarity
sakin	sakindiler	Tense
kuruştan	kuruşu	Case
becerikliyiz	becerikli	Person
depresifmişiz	depresifmişim	Person
kırışıklıklarının	kırışıklıklarımızın	Possession
çatlakların	çatlaklar	Case
hacıydın	hacı	Tense
kazak	kazağa	Case
etlerine	etleri	Case
ittirildiniz	yoksullaştırdınız	lemma
kemerlerde	kemerleri	Case
fagofobiden	fagofobiyi	Case
sandalyelerde	sandalyeler	Case
sarhoş	sarhoşu	Case
elementten	elementlerden	Number
motelin	erkekliğin	lemma
iğdelerden	iğdelere	Case
dilber	dilberdim	Tense
gözbebeklerinden	gözbebeklerinin	Case
mezuniyetimize	mezuniyetimizde	Case
ekranlarını	ekranlarının	Case
sargı	ejderha	lemma
emniyetlerde	emniyetlerin	Case
mayalarında	mayalarımızda	Possession
küleklerim	küleklerine	Case
eğrilerden	eğrileri	Case
kalınların	bombaların	lemma
giysiydiler	giysisin	Tense
merkezlere	merkezlerde	Case
oyuncaklar	cüceler	lemma
pastırmaları	pastırmalarını	Case
ilgeçlerden	ilgeçlerde	Case
zarflarda	zarfların	Case
eziyetçilerinin	eziyetçilerinizin	Possession
hardalı	hardal	Case
dönüş	dönüşler	Number
lezyonların	balkanların	lemma
inekleri	ineklerin	Case
Araplardan	Araplarda	Case
büyüklükte	büyüklüğün	Case
anasonlardım	anasonlar	Tense
tatlı	uçurtma	lemma
maçında	maçlarında	Number
mermiydiler	mermiyim	Tense
bacaktan	bacakta	Case
mermilerinden	mermisinden	Possession
indekse	indeksi	Case
kirpikler	kirpiklere	Case
akrabalarını	akrabalarının	Case
oğlancıya	frekansa	lemma
yaptırtır	yaptırtırlar	Number
satrancınızdan	şeyinizden	lemma
mucizeler	çanlar	lemma
işçilerim	işçilerdin	Tense
yoracaksın	yormayacaksın	Polarity
sandalyeler	şeyler	lemma
imamına	vilayetine	lemma
akısında	akımda	Possession
cevheri	cevherin	Case
uçağı	uçağını	Case
gergedanlardan	gergedandan	Number
tabelaların	tabelalar	Case
dünyalara	dünyaya	Number
çökeleğinden	çökeleklerinden	Number
mevsime	mevsimde	Case
dizeyi	dizeleri	Number
pırasanda	pırasandan	Case
işlemcilerini	çalgılarını	lemma
kuramda	kuramı	Case
aydınlıktan	aydınlık	Case
kardeşlerine	utlarına	lemma
papatyalarda	şerbetçiliklerde	lemma
patronuz	patrondunuz	Tense
kalabalıklar	kalabalık	Number
geliştiriyorsunuz	geliştiriyoruz	Person
heyecanlanıyor	ağlaşıyor	lemma
kloroplastlarını	bazlarını	lemma
fenerden	fenerin	Case
gözlükçüymüşsünüz	örnekmişsiniz	lemma
aş	aşa	Case
paralara	paraya	Number
kanıyorsun	geriniyorsun	lemma
yetenekliydi	erdemliydi	lemma
üşeneceğim	üşenecekler	Person
medreselerinizde	şimallerinizde	lemma
dalgınlıklar	dalgınlıkların	Case
yetenekliydin	yetenekliydim	Person
arıstağı	arıstaktan	Case
vurmuyordum	davranmıyordum	lemma
köpekleri	köpeklerden	Case
sonuçlarız	dükleriz	lemma
sıradanız	sıradanım	Number
iskenderlerdi	iskenderlersiniz	Tense
falcı	falcıydılar	Tense
paleoantropolojiden	paleoantropolojiyi	Case
ilkende	cehenneminde	lemma
otolarının	otomun	Number
tütülerinin	tütülerinden	Case
maymunlarmış	ütülermiş	lemma
mühendisliklerden	mühendislikten	Number
gökadada	gökadaya	Case
tatil	tatili	Case
bastonumda	bastonunda	Possession
iletkenlerde	banklarda	lemma
kümesini	kümesinin	Case
ittirtmiyordun	şaşırmıyordun	lemma
yazarı	yazardan	Case
seçeneğe	seçeneklere	Number
mumyaydılar	mumyayım	Tense
orta	ülke	lemma
ebesiniz	ebeydik	Tense
piramide	piramitten	Case
gökkuşaklarından	gökkuşaklarını	Case
memeden	anüsten	lemma
misafirleriniz	sınırlarınız	lemma
kulluklarının	kulluğumuzun	Possession
mumyalarınızda	mumyalarımızda	Possession
bireye	bireylere	Number
ilerilerim	ilerilerinin	Case
gözbebeğini	gözbebeğinin	Case
alev	elmas	lemma
düşeste	düşes	Case
üniversiteden	üniversitenin	Case
kinematikler	kinematiklerden	Case
işlerler	işler	Person
umutsuzdu	umutsuz	Tense
papazlardınız	papazlarsın	Tense
ortaklığımı	ortaklıklarını	Number
olgunluklarınızda	tahditlerinizde	lemma
bağımsızlıklarda	bağımsızlıklara	Case
soluyorsunuz	ölüyorsunuz	lemma
kıyafetlerdir	yağmalardır	lemma
dedelerden	dedeleri	Case
amcıklardan	amcıklara	Case
kelimeciğini	kelimeciğine	Case
dedeyi	dedeleri	Number
halıdan	halılardan	Number
sakinim	sakindin	Tense
dünyalarda	dünyaları	Case
enflasyonu	enflasyon	Case
yalvarışın	yalvarışı	Case
iletileri	iletiyi	Number
brokolimizde	brokolinizde	Possession
sinüse	sinüsten	Case
rotorunun	temsilinin	lemma
betiklerinde	betiklerini	Case
yıldızıllar	yıldızıl	Number
psikologlara	psikologlardan	Case
cinsellikten	cinselliği	Case
hayvanlarda	hayvanda	Number
bedeviydiniz	bedevi	Tense
parçan	arkadaşlığın	lemma
çan	çandık	Tense
savaşıyordu	eriyordu	lemma
perilerin	tercihlerin	lemma
kazandılar	öpüştüler	lemma
kayığı	kayıkları	Number
keleği	vakti	lemma
işletimlerini	domateslerini	lemma
sosistiler	eşyaydılar	lemma
saçlarına	üreticilerine	lemma
kelimelerini	kelimeleri	Case
pederinin	dinçliğinin	lemma
aldırmayacaksın	aldırmayacaksınız	Number
yapacaksın	yaptın	Tense
haşefenden	bahçenden	lemma
sarhoşlar	sarhoşları	Case
tıkarlar	değiştirirler	lemma
istatistiklerin	istatistiklerde	Case
mikrofonda	mikrofonlarda	Number
öznelerin	özneleriniz	Possession
sekste	seksi	Case
politika	politikadan	Case
penislerinizi	düğünlerinizi	lemma
kayıklar	kayıklara	Case
sözlükçü	Mogadişulu	lemma
roketlere	roketlerden	Case
teknolojilerde	teknolojilerin	Case
güçlüğümde	güçlüğünde	Possession
sütlaç	sütlacı	Case
ırke	ırklere	Number
tekdillilikler	tekdillilik	Number
göçlerim	göçlerimiz	Possession
çöpün	çöpü	Case
karanlıklarda	karanlıkları	Case
katılaştırdılar	katılaştırdınız	Person
baltalarsınız	baltalardı	Tense
homoseksüeline	tavuğuna	lemma
kovulmadılar	canlanmamadılar	lemma
haçaların	haçaları	Case
kovulmayacak	kovulmayacaksın	Person
madalyayı	madalya	Case
haremliklere	haremliğe	Number
madalyalarda	madalyalar	Case
kokacağız	değişeceğiz	lemma
kaybolmayacaklar	demeyecekler	lemma
element	elemente	Case
yorgunluk	yorgunluğa	Case
sapar	büker	lemma
pırasaymışsın	zağarmışsın	lemma
harften	harflerden	Number
mükemmel	beceriksiz	lemma
kovacaksın	döveceksin	lemma
misafirim	misafirin	Possession
okuyorsun	okuyorum	Person
parlatmıyordular	bitmiyordular	lemma
telaffuzdunuz	telaffuzuz	Tense
kontesi	kontese	Case
koku	ayrımcılık	lemma
ocakbaşlarına	ocakbaşlarının	Case
çukurun	çukura	Case
meşrubatlarından	meşrubatlarına	Case
kuramdan	kuramda	Case
kanlılıkların	aydınlıkların	lemma
halklarına	arzularına	lemma
bakımsızmış	bakımsızmışsın	Person
ulamlarınızı	ulamlarını	Possession
tercihlerdim	tercihleriz	Tense
acılarımızın	üyeliklerimizin	lemma
oğulsunuz	oğuldunuz	Tense
ortağını	yarımadasını	lemma
iletkenden	iletkenlerden	Number
mucizeler	mucizelerdim	Tense
fagofobilere	fagofobiye	Number
masaları	ekranları	lemma
seksin	seks	Case
vefatlarında	vefatlarınızda	Possession
olayların	olayın	Number
kraliçeyi	kraliçeleri	Number
lezbiyeninizde	tütüncünüzde	lemma
fırtınaları	fırtınası	Possession
kılıcın	kılıcı	Case
dansçı	dansçılar	Number
iguana	iguanadan	Case
acıktırtacaklar	büyüyecekler	lemma
canlandırmalarda	canlandırmalar	Case
yönüne	yönünü	Case
fişeklerdir	fişeklerdi	Tense
marangozlardım	marangozlardır	Tense
akışkandan	akışkana	Case
otomobilciliktik	çedardık	lemma
parada	paralarda	Number
sürekliliklerin	süreklilikler	Case
tabaklardan	tabakların	Case
atışmadılar	atışmadı	Person
mezarlıkmışsın	babalıymışsın	lemma
plağınıza	fragmanınıza	lemma
yıkmadım	yıkmam	Tense
çedarlarsınız	çedarlardın	Tense
seksiydim	büyülüydüm	lemma
vasiyet	vasiyetin	Case
kanıyor	gidiliyor	lemma
dublörüm	dublördük	Tense
kinematikleri	kinematiklere	Case
ayrılmadan	ayrılmanın	Case
sentaksın	sentaksların	Number
koda	kodun	Case
yönden	yöne	Case
nöronlarımdan	nöronumdan	Number
kusuyorlardı	yoruyorlardı	lemma
kenarının	kenarlarının	Possession
krallıktan	krallığı	Case
bilyelerdin	bilyeleriz	Tense
pandaların	pandanın	Number
duada	dua	Case
bilekten	bileği	Case
yakşıyız	yakşılar	Person
kapakçıklar	kapakçık	Number
bulutta	bulut	Case
voleybolcumda	voleybolcularından	Case
sucuklardı	sucuklarsınız	Tense
rubaiydik	rubaisin	Tense
hedefler	hedeflerin	Case
çözeltinizin	çözeltilerinizin	Number
büyükelçilerin	büyükelçilerde	Case
kanmıyordun	bezmiyordun	lemma
dirilmemiyordunuz	dirilmemiyordular	Person
palindromlarından	erneklerinden	lemma
pehlivanları	artıkları	lemma
doğrudular	doğrudun	Person
galaksileri	galaksilerden	Case
totemcilerinize	totemcilerinizi	Case
sapıklıklardan	sapıklıkların	Case
yumacağız	yumduk	Tense
saydırmazlar	cezalandırmazlar	lemma
temsilcilikdi	temsilciliksin	Tense
karanlıkların	karanlıklardan	Case
ırkte	ırklerde	Number
sermezsiniz	bezmezsiniz	lemma
seccadelerime	seccademe	Number
eğitimde	eğitimden	Case
okumuyordu	yazmıyordu	lemma
haberleşiyorlardı	yendirtiyorlardı	lemma
gütüyorsun	övüyorsun	lemma
kıyafet	ışın	lemma
masallarının	dövüşlerinin	lemma
kahvelere	büyücülere	lemma
patlamalardan	patlamalara	Case
hamaktan	hamak	Case
sağrılarının	altdillerinin	lemma
paralarda	paralar	Case
gökadanın	gökadaların	Number
paylaştık	paylaştılar	Person
kırdıracaksın	canlandırılacaksın	lemma
güzden	güzü	Case
kolonlarımızın	kolonumuzun	Number
sezonlarımı	sezonlarınızı	Possession
ilçelerden	ilçeler	Case
tanıdı	tanıyacak	Tense
dökmeyeceğim	dökmeyeceksin	Person
piramidin	piramit	Case
kalabalık	kalabalıktan	Case
vücudu	vücutları	Number
piramide	piramitlere	Number
rokete	roketin	Case
güneş	güneşe	Case
karanlıklar	karanlıklarda	Case
gözyaşlarından	gözyaşlarına	Case
kanunlarında	kanunlarını	Case
kasarsın	çıldırtırsın	lemma
model	modeldiler	Tense
heyecanlanmıyorlar	heyecanlanmıyorsunuz	Person
cinsiyetlerin	cinsiyetlerden	Case
parıltı	ziyaretçi	lemma
kazakları	kazaklarda	Case
birdirbirden	birdirbirin	Case
indekse	indekste	Case
ünsüzlere	ünsüzlerin	Case
kistinin	Musevisinin	lemma
otomobildin	otomobiller	Tense
izleyicilerinden	âlimlerinden	lemma
ölümlerinin	ölümleri	Case
sigara	sigaranın	Case
sürdürülebilirliğe	sürdürülebilirlikten	Case
fahişelerdik	fahişelerdir	Tense
saksafonlarına	saksafonlarımıza	Possession
kuzgunu	kuzgunun	Possession
konuklara	konuklardan	Case
sekreterlerin	sekreterin	Number
yalvarmıyorsunuz	dalgalandırmıyorsunuz	lemma
bluzlularından	bluzluları	Case
kaplumbağanızdan	kaplumbağasından	Possession
cezalandırdı	cezalandıracak	Tense
kasımpatılardan	kasımpatılar	Case
kurtlardan	kurtlarda	Case
koltukları	koltuklarda	Case
dayanıklılığı	dayanıklılıkları	Number
sökecek	bitecek	lemma
solucanlarını	sıfatlarını	lemma
aldatırlar	aldatır	Number
kervansaraya	kervansarayın	Case
yazmalarını	yazmamı	Number
böceğinden	böceklerinden	Possession
tasalarımızı	tasalarınızı	Possession
süründürtmeyeceksiniz	süründürteceksiniz	Polarity
çatalımızı	çatalınızı	Possession
doyumsuzduk	doyumsuzdular	Person
ilerletmiyorsunuz	şaşılmıyorsunuz	lemma
kolon	dul	lemma
dişinin	dişini	Case
şoku	şokları	Number
reçellere	reçellerin	Case
yazının	yazıya	Case
eylemlerden	eylemlerin	Case
kılkapanların	ecelerin	lemma
kanatlara	kanatlarda	Case
bakandık	bakanlardım	Number
paraları	paraların	Case
motellerimizi	demircilerimizi	lemma
ablasın	ablaydınız	Tense
malamozlardır	malamozlardı	Tense
sevişmiyordular	sevişmiyordun	Person
emmilerine	emmilerin	Case
kanalların	kanallara	Case
seçmenlermişiz	uçurtmalarmışız	lemma
köygöçürendim	âşıktım	lemma
kasbilimin	kasbilimlerin	Number
kanmayacaklar	kanmayacaksın	Person
ayçiçeğinin	ayçiçeklerinin	Number
yarışta	yarışın	Case
tabutun	tabutunu	Case
ofisini	ofisin	Case
mezarlıklarmışsın	öğretmenlermişsin	lemma
ağaç	ağaca	Case
meydandan	meydanın	Case
şaşırttırmayacaksınız	şaşırttırmayacaklar	Person
yarışların	yarışın	Number
akdoğanlarda	yedeklerde	lemma
yerlerini	yerini	Possession
kahramanlarmışsınız	kahramanmışsın	Number
ibne	balta	lemma
noktürnünde	zulmünde	lemma
geometriyi	geometrinin	Case
balalaykalarını	balalaykalarında	Case
mezarlıktın	mezarlıklar	Tense
odunlarda	odunları	Case
vida	vidaydık	Tense
içermedim	canlandırılmadım	lemma
Belgratlıydılar	Belgratlısın	Tense
vasattık	vasattılar	Person
sinüsü	sinüsleri	Number
Lefkoşalılardık	Lefkoşalılardır	Tense
cismimi	cismime	Case
acıydınız	acıyım	Tense
fiil	fiilde	Case
panendeistlerimizden	panendeistlerinden	Possession
uzağız	uzaktılar	Tense
geyiğiniz	geyiğinizden	Case
satıştım	satışız	Tense
lezbiyenlerinde	evrimlerinde	lemma
ölümlülüklerde	ölümlülükler	Case
Belgratlıyım	Belgratlıydık	Tense
iyelikleri	cehennemleri	lemma
hamamda	hamam	Case
ölçtürtüyorduk	ölçtürtmüyorduk	Polarity
geceliğinden	geceliğinizden	Possession
dürümlerde	dürümlerden	Case
tuğlaya	tuğlalara	Number
tercümelerin	tercümenin	Number
veterinerim	veterinerdiniz	Tense
hardalın	hardal	Case
monarşilerden	monarşilerde	Case
sıkıntıyı	sıkıntıdan	Case
vurgu	vurguydun	Tense
kanatın	kanatı	Case
arayüzlerin	arayüzler	Case
maratoncularında	elmaslarında	lemma
totemcilerdir	totemcilerdin	Tense
saksıyı	saksıları	Number
derlemelerinde	derlemelerine	Case
melodi	melodinin	Case
şikayetler	şikayetlerden	Case
kızgınım	kızgın	Person
gökada	gökadalar	Number
politikacıların	politikacılar	Case
köçeklermişiz	öküzlermişiz	lemma
iffetiniz	iffeti	Possession
golünüzü	golümü	Possession
sanatçılarda	sanatçıda	Number
pompayı	pompanın	Case
dedelerin	dedeleri	Case
amatörünün	amatörünü	Case
ritüellere	ritüeller	Case
nurlar	nurların	Case
hadislerin	hadislerden	Case
oligarşi	oligarşinin	Case
boğanın	boğaların	Number
paraların	paralar	Case
kloroplastlarına	kloroplastıma	Number
sosisleriz	sosislerdi	Tense
sakalınızın	sakalımızın	Possession
isyanlarını	isyanlarında	Case
saçmalıklarda	saçmalıkları	Case
ortamdın	ortam	Tense
tartıyordu	dalgalanıyordu	lemma
ilâcımızın	dükkânımızın	lemma
yazıların	yazılar	Case
çökelek	çökelektim	Tense
oligarşilerde	oligarşilerin	Case
yalnızlıklara	yalnızlıklardan	Case
yabancıydılar	yabancılar	Tense
kütüğünüzden	kütüğümden	Possession
bağırsaklarım	bağırsakların	Possession
heyecanlanıyordum	şamarlıyordum	lemma
pırasalarınızın	üstdillerinizin	lemma
işlevinizde	işlevimde	Possession
iletmezler	iletmezsin	Person
yakındı	yakınız	Tense
kurban	kurbanlar	Number
akiferin	akiferden	Case
aldırtıyordunuz	büktürülüyordunuz	lemma
hatalarımda	hataları	Case
gemisinden	gemisini	Case
pornolarından	pornolarına	Case
gökkuşağı	gökkuşağında	Case
arza	arzı	Case
kimliklerine	kimliklerin	Case
ağdacıydı	ağdacısınız	Tense
gübresin	öyküsün	lemma
tuşları	tuşlardan	Case
kıyafetlerinde	videolarında	lemma
tabansızlarım	uzaklarım	lemma
sermezsin	burkmazsın	lemma
sıvılaşmazsın	bildirmezsin	lemma
terörizme	terörizmi	Case
dezenfektanımıza	dezenfektanına	Possession
kalplerini	ışınlarını	lemma
savaşına	çizgisine	lemma
kapaklarmış	yakınlarmış	lemma
referansı	değişkeni	lemma
önyargıları	önyargılar	Case
şokların	şoklar	Case
kutsallığın	kutsallık	Case
mucize	mucizeler	Number
arşivden	arşiv	Case
sıyırırız	buharlaşırız	lemma
kireçleriniz	dersleriniz	lemma
yetişiyorum	yetişmiyorum	Polarity
isteyeceksiniz	çalışacaksınız	lemma
alabalığa	alabalıktan	Case
optimizasyonınıza	blogunuza	lemma
masumdun	masumsun	Tense
düşmandı	düşmanlar	Tense
rüyalarından	rüyalarımızdan	Possession
enflasyon	enflasyonda	Case
harçlıklarımı	harçlıklarınızı	Possession
vasattı	vasattım	Person
aydınlığın	aydınlığı	Case
büyüklüklerde	büyüklükler	Case
pompa	pompanın	Case
astronotumu	astronotunu	Possession
sikeceğiz	sikeceğim	Person
kanmıyorsunuz	kanmıyorsun	Number
sorumlulukları	sorumluluklarından	Case
ibneliğinizde	vitrininizde	lemma
hızlarından	volkanımdan	lemma
farelerdiniz	fareleriz	Tense
yolculardı	yolcularız	Tense
pusulaymışız	yumurtaymışız	lemma
acayipiz	acayipim	Number
tanışmıyorsun	ellemiyorsun	lemma
popu	füzeyi	lemma
keşfettin	ölçtürttün	lemma
katillermişsiniz	dumanlarmışsınız	lemma
nottan	notu	Case
koltuklar	eğitimler	lemma
silgilerdin	silgilersin	Tense
referanslarına	derlemelerine	lemma
katakullide	katakulliden	Case
gelmemiz	gelmem	Possession
çocukluklara	çocukluklarda	Case
yedeklerdi	yedekler	Tense
silerler	boğarlar	lemma
olmuyorsunuz	gerekmiyorsunuz	lemma
mumyalarsın	mumyalardık	Tense
heyetlerini	delilerini	lemma
prototipi	prototipleri	Number
büktürmüyorsun	büktürmüyorum	Person
dersini	dersine	Case
kullardı	kullarız	Tense
karaciğerden	karaciğere	Case
demircilerdi	demircilersin	Tense
mitokondrileri	mitokondriyi	Number
emetofobiye	emetofobinin	Case
tükürüyorsunuz	deniliyorsunuz	lemma
füzelere	füzelerden	Case
gördün	yapıldın	lemma
ibneliklerini	ibneliklerin	Case
biftekkekin	biftekkeke	Case
bağımda	bağınızda	Possession
kanatın	kanatların	Number
mimlerinizin	mimlerinin	Possession
kovayı	kovaya	Case
butonları	butonlar	Case
doktorumuzun	doktorumuz	Case
karpuzlardı	üreticilerdi	lemma
çılgınlığın	çılgınlığı	Case
akrobatım	akrobattınız	Tense
osururlar	çizerler	lemma
puanlarımı	puanlarımdan	Case
gösterdik	şaşıldık	lemma
sonsuzluğumuz	sonsuzluğumuzdan	Case
sağdık	geçtik	lemma
kafatasları	kafataslarından	Case
değil	değilde	Case
osuruyorsun	öksürüyorsun	lemma
lügatçelerimin	burunlarının	lemma
parlatıcıları	parlatıcılarım	Possession
veriliyordu	veriliyordunuz	Person
maymunlarınızda	fanuslarınızda	lemma
kızgınmışsınız	kızgınmışlar	Person
odun	odunlar	Number
uçtan	ucun	Case
fillersin	fillerdim	Tense
krallıkta	krallığın	Case
jonglörün	jonglörden	Case
içkinin	içkilerin	Number
pencereyi	pencereleri	Number
künefeden	künefeye	Case
eşcinsellerdiniz	eşcinseller	Tense
göller	göllere	Case
tacizin	tacizden	Case
sinüsü	sinüs	Case
gözleme	gözlemde	Case
dulumuzun	dulunun	Possession
utandırmazlar	yolunmazlar	lemma
gizlerim	gizlerler	Person
kalkanlara	tatlılara	lemma
içgüdüsünü	tabiyetini	lemma
geometriye	geometrilere	Number
tipografya	tipografyalar	Number
sevenlerimizde	bulgurlarımızda	lemma
gaydalardan	gaydalara	Case
aileleri	ailelere	Case
sihirlisin	coşkulusun	lemma
büstlerinin	büstlerinizin	Possession
işkencecisiniz	işkenceciydin	Tense
egoizmler	egoizmlerde	Case
mesafelerden	mesafeler	Case
şikayetleri	şikayetlere	Case
boynu	boyunda	Case
cennet	cennete	Case
kıymetimizin	kıymetimizde	Case
kapasitemiz	kapasiteleri	Possession
önbilginizi	önbilgini	Possession
bencilsiniz	benciliz	Person
gübreydim	ceylandım	lemma
pehlivandılar	pehlivansın	Tense
civcivlerin	civcivlerde	Case
işgücünü	işgücüne	Case
müzikallerimiz	müzikalleriniz	Possession
rüzgarlarda	rüzgarlara	Case
uzakların	uzaklarında	Case
kalıplarında	kalıpların	Case
ikazımızda	ikazımıza	Case
gökadayı	gökadada	Case
sigara	sigaraya	Case
yedigenlere	yedigenler	Case
kıyafetlerinizde	gitmelerinizde	lemma
bencildim	bencildiniz	Person
seksiler	seksiydiler	Tense
madalya	madalyaya	Case
tütecek	eğlenecek	lemma
ayakkabıcılardı	ayakkabıcılar	Tense
meydanları	meydanlarda	Case
dut	dutu	Case
yağmasın	yağmaydın	Tense
istatistiğe	istatistikten	Case
süstük	süseriz	Tense
yendirtmezsin	yendirtirsin	Polarity
nükleotidi	nükleotit	Case
kistlerinizin	kistlerinizde	Case
ümitliydik	ümitliydin	Person
kusmuklarda	kusmuklardan	Case
sağlayıcısının	arzusunun	lemma
bulunmayı	bulunmaları	Number
levreklerinde	levreğime	Case
kızgın	babacan	lemma
parçacıklarını	parçacıklarımı	Possession
buzdolapları	buzdolabı	Number
kümbetlerinize	kümbetinize	Number
Kopenhaglıları	Kopenhaglımın	Case
ekşimeyecek	ekşimeyecekler	Person
taşmadım	yenilmedim	lemma
kılmıyor	yormuyor	lemma
çalgılarım	çalgılarınız	Possession
çökeriyorduk	çökeriyordu	Person
kodda	kodun	Case
akrabamıza	akrabana	Possession
soyluları	soylulardan	Case
götverensiniz	viskisiniz	lemma
kemeri	kemerleri	Number
pilavlardık	pilavlardır	Tense
kipalarınızda	kipalarınıza	Case
elliyorduk	elliyordum	Number
abajurunu	gemisini	lemma
kardeşlerdir	kardeşlerdi	Tense
sunularından	sununuzdan	Possession
madalyada	madalyaya	Case
bulunmaya	bulunmadan	Case
madeninin	tecrübesinin	lemma
bakıcılarının	bakıcısının	Possession
denizyıldızlarına	denizyıldızlarında	Case
kanserin	kanserlerin	Number
istatistikten	istatistiğin	Case
odacıklara	odacıklarda	Case
mumluğun	mumluğunuz	Possession
babalıydım	babalıyım	Tense
kızıyordunuz	kızıyordun	Person
frambuazlarınızın	frambuazlarınızdan	Case
karanlıkta	karanlıklarda	Number
yamyamlarından	yamyamlarının	Case
doktrininde	doktrininin	Case
şişliğim	şişlikleri	Number
musonlardan	musonları	Case
bloglarda	blogda	Number
saçlarımı	saçımı	Number
teknoloji	teknolojiden	Case
bahardan	bahar	Case
kafatasında	kafatası	Case
mendilden	mendile	Case
gömleklerinizin	üçlülerinizin	lemma
fazlalıklara	fazlalıklar	Case
saca	saclara	Number
önceleri	önceler	Case
melodiyi	melodiden	Case
dayanıklılıklara	dayanıklılıklardan	Case
dumanında	dumanının	Case
ölüyordum	ölüyorduk	Number
kurbağalamalarımdan	kurbağalamalarından	Possession
halıda	halı	Case
pipetlerdi	pipetlersiniz	Tense
uzunluğun	uzunluktan	Case
jelada	jeladayı	Case
referanslarında	şeftalilerinde	lemma
kromozomlarımı	kromozomlarını	Number
striptizinden	striptizimden	Possession
onarmayacaksınız	onarmayacağız	Person
kaldırımlarda	allıklarda	lemma
puanım	puanıma	Case
çılgınlık	çılgınlıklar	Number
alevlerdin	alevlersiniz	Tense
çeliğiz	çeliktin	Tense
cihanlardık	cihanlar	Tense
mügeydi	mügeyim	Tense
emniyette	emniyet	Case
üniversiteye	üniversitelere	Number
geçinmedin	geçinmedik	Person
giyeceğim	giyecekler	Person
okiyayım	çizgiyim	lemma
hikâyede	hikâyelerde	Number
narkotiklerimizi	narkotiklerimiz	Case
kansere	kanserde	Case
anneliği	anneliğin	Case
cümlesin	cümleydiler	Tense
tümörün	tümöre	Case
sillenize	dalganıza	lemma
sıvılaştırmayız	düzelmeyiz	lemma
eziyetleri	eziyetlerim	Possession
öncede	öncelerde	Number
savaşıyorlar	savaşıyor	Person
kargalar	kargaların	Case
lisede	liseden	Case
toptan	top	Case
arza	arzın	Case
ayvazında	ayvazına	Case
kalfanıza	varoşunuza	lemma
tulumunda	tulumlarında	Number
etiketinizin	etiketiniz	Case
kameralarda	kameraların	Case
bataryayız	bataryaydık	Tense
ortamsınız	ortamdı	Tense
süsmeyeceğiz	süsmeyeceğim	Person
somnifobiye	somnifobinin	Case
helikoptere	helikopterlere	Number
kutlamada	kutlamanın	Case
belirtmeden	belirtmenin	Case
primitif	büyüleyici	lemma
pisletiyordu	evleniyordu	lemma
parasızlıklarımı	parasızlıklarını	Possession
karakollarımızın	foklarımızın	lemma
bulunma	bulunmanın	Case
başrahipdik	başrahipsiniz	Tense
ücretsizliğine	ücretsizliklerine	Possession
annelik	annelikten	Case
karakteriz	karakterdin	Tense
babasız	babasızdın	Tense
aktifler	coşkusuzlar	lemma
deliğime	deliğimi	Case
heceyim	heceydim	Tense
raketi	raketleri	Number
göle	göl	Case
sayfamıza	sayfama	Possession
kırıntıların	kırıntılarda	Case
hedeften	hedefi	Case
imreniriz	bitiririz	lemma
tanrılardı	fillerdi	lemma
işlemcilerinden	işlemcilerinizden	Possession
değişkenlerdik	değişkenlerdir	Tense
tükürmüyorsunuz	yaratmıyorsunuz	lemma
tesadüfe	tesadüften	Case
manitaları	manitalarına	Case
kraliçe	kraliçenin	Case
hamburgerimde	hamburgerinizde	Possession
nükleotitler	nükleotitlerde	Case
frenlerinden	frenleri	Case
mevsimden	mevsimi	Case
ilklendirmeyim	ilklendirmeydi	Tense
yönelmeyi	yönelmeleri	Number
iletinin	iletiden	Case
gülmedi	gülmeyecek	Tense
kargalardan	kargaların	Case
götürmüyorsun	fortlamıyorsun	lemma
yanlışlığı	yanlışlıkları	Number
şikayete	şikayeti	Case
krallıklardan	krallıktan	Number
ölümsüzlüğe	ölümsüzlüğün	Case
çakalın	çakalların	Number
kemençenin	kemençeyi	Case
umdum	döndürdüm	lemma
denizyıldızına	denizyıldızlarına	Number
sararmayacağım	İngilizceleştirmeyeceğim	lemma
tercümandılar	tercümansın	Tense
pencereler	pencereleri	Case
börülceymişiz	börülcelermişsin	Number
parçalanmalarına	çeliklerine	lemma
bilardolara	bilardolar	Case
maydanozların	erkelerin	lemma
boşanıyordunuz	boşanıyordun	Number
öncede	öncenin	Case
sözdizimine	sözdizimini	Case
ödevden	ödevlerden	Number
net	dişleklik	lemma
yönelimde	yönelime	Case
dürbününün	dürbününüzün	Possession
entegrasyondan	entegrasyona	Case
gönlünde	filminde	lemma
hecine	hecinde	Case
cimcimeler	cimcimeydin	Tense
mevsimleri	mevsimi	Number
muşmula	burun	lemma
becerikliyiz	beceriklisiniz	Person
görüşünüzü	bazaltınızı	lemma
kızgındık	kızgınız	Tense
kolonuz	kolondu	Tense
robotun	robota	Case
kırılacak	bölecek	lemma
süpürgeyi	süpürgeleri	Number
hançer	dalgıç	lemma
köpekte	köpeklerde	Number
mandallar	tercümanlar	lemma
kaygılara	kaygıların	Case
geçmeleri	geçmelerinden	Case
güzellikte	güzelliği	Case
huzurlarım	örneklerim	lemma
devirsin	devirdim	Tense
çiçekçilerde	çiçekçide	Number
kolonum	kolonduk	Tense
kıyafetlerimden	kıyafetlerinizden	Possession
ışınlar	ışınlardık	Tense
satışlardınız	eşyalardınız	lemma
emmilerdik	emmiydik	Number
istatistiklerde	istatistikte	Number
nohutlarsınız	bilyelersiniz	lemma
kavunlarımıza	kavunlarımızın	Case
lordum	lordu	Possession
yusufçuktan	yusufçuk	Case
korselerimden	yüzeylerimden	lemma
kapılarının	vakitlerinin	lemma
mekiklerinde	etiketlerinde	lemma
kovdurtmuyordu	atmamıyordu	lemma
sürülmeyeceksiniz	doğramayacaksınız	lemma
yapmadı	ellemedi	lemma
sözdizimlerinde	sözdizimlerinin	Case
jaguarın	jaguarların	Number
aletleri	filozofları	lemma
homurtularından	homurtularını	Case
ayrılmalara	ayrılmaları	Case
kurtçuğuz	kurtçuktunuz	Tense
yuvadan	yuvayı	Case
otomobildi	börülceydi	lemma
çevrenin	çevre	Case
bakmanızı	bakmanızda	Case
popona	çığına	lemma
sinüsün	sinüs	Case
kovmayacağız	dolamayacağız	lemma
canlandırtılacağım	canlandırtılacaksın	Person
güreşçilerdim	güreşçilersiniz	Tense
üzgünüz	üzgünüm	Number
buluştu	buluştular	Number
aydınlıklardan	aydınlıklara	Case
yağların	yağlara	Case
ölümlülüklerde	ölümlülükte	Number
bacaklara	bacakları	Case
oyuncusundan	aşiretinden	lemma
mitokondri	mitokondriler	Number
yaratıklarda	yaratıklardan	Case
ayılarız	ayılardın	Tense
istatistikler	istatistiklerde	Case
fakirleştirmiyorduk	fakirleştiriyorduk	Polarity
inmez	inmezsiniz	Person
saçmalığı	saçmalıkları	Number
yapışmamızı	yapışmalarını	Possession
sikini	siki	Case
kitaplıklarda	kitaplıkların	Case
odun	odunda	Case
bilgisayarlıymışsınız	bilgisayarlıymışsın	Number
saydırdık	böltük	lemma
ağdacılardım	ağdacılarım	Tense
ayranlar	ayranları	Case
eşiğiz	eşiktin	Tense
işlemcilerden	işlemcilere	Case
hamamların	hamamlardan	Case
tuşun	tuşların	Number
hudutlarımızda	hudutlarında	Possession
hahamlardın	hahamlarım	Tense
marangozlarımızda	ustalarımızda	lemma
ongende	ongenden	Case
yetiden	yetide	Case
vermedik	vermedi	Person
kastanyetlerden	kastanyetlerin	Case
sıvılaştırır	sıvılaştırırlar	Number
bahtsızım	bahtsızlar	Person
mikropların	mikroplardan	Case
polisleri	polisi	Possession
eşyaydık	eşyayım	Tense
vasattın	vasattılar	Person
değişikliklerden	değişikliklerde	Case
anne	anneye	Case
fondötenlerin	fondötenler	Case
madenlerimi	madenlerine	Case
eşyanızı	eşyamızı	Possession
savaşında	savaşlarında	Possession
monologlarımız	monologları	Possession
ısınmadık	ısınmadınız	Person
kıskançlıklarda	kıskançlıkların	Case
etkilerde	etkide	Number
iskeletten	iskeleti	Case
darıldı	darıldık	Person
büyüklükleri	büyüklüklerin	Case
gözlemci	gözlemcide	Case
ovuyordun	ağlaşıyordun	lemma
tabelanın	tabelaya	Case
maydanozlarımdan	maydanozlarım	Case
boyundan	boyun	Case
perdelerde	perdeler	Case
önceye	önce	Case
şiirlerde	şiirlerin	Case
sapana	bahçeye	lemma
böğürtlenler	böğürtlenlerdim	Tense
anneanneye	anneanneyi	Case
kokularmışsınız	balinalarmışsınız	lemma
keşlerimizin	gemilerimizin	lemma
tuşta	tuşlarda	Number
kasıyorlardı	kasmıyordular	Polarity
sandalyeyi	sandalyeye	Case
rehineydin	rehineyiz	Tense
yağarız	yağmayız	Polarity
sürünürüm	gelinirim	lemma
lazerlerden	lazerlerin	Case
gökkuşağı	gökkuşağının	Case
tacizin	tacize	Case
sonraya	sonradan	Case
birleştiriyorduk	birleştiriyordu	Person
liselerden	liselere	Case
model-view-presenterlerin	model-view-presenterlerde	Case
abazanım	başarılıyım	lemma
perdeleri	perdelerde	Case
ayrılmadın	ayrılmayacaksın	Tense
rüzgarlar	rüzgarlara	Case
sonranın	sonraya	Case
sıvıda	sıvıya	Case
çamda	çam	Case
işgücü	işgücüne	Case
monarşinin	monarşiye	Case
maratoncunuzu	maratoncunuza	Case
kitapçıktan	kitapçığı	Case
sirklerinde	altlarında	lemma
binlerinin	binlerini	Case
sayımlarında	verilerinde	lemma
laternalarından	fakirimden	lemma
maymunsun	şapkacısın	lemma
bahçıvandı	bahçıvan	Tense
müezzinlerdir	dilberlerdir	lemma
iletirler	ağlarlar	lemma
kalmazlar	kalmam	Person
finişlerimi	finişlerini	Possession
yaratıyım	yaratıydılar	Tense
perilerin	perileri	Possession
sapanlarınızdan	gecelerinizden	lemma
ovacaksın	ovacağız	Person
mezarlıklarınızdan	şırıngalarınızdan	lemma
patenlerimizin	astronotlarımızın	lemma
saksocum	saksocumun	Case
ayazlardan	ayazların	Case
sikişeceğim	sikiştim	Tense
kopmayacaksınız	arınmayacaksınız	lemma
otocularımızı	otocularımızın	Case
yalansın	yalandılar	Tense
bahtsızsınız	bahtsızsın	Person
kapaklarmışım	emmilermişim	lemma
tekilalar	cümleler	lemma
yarasalarsınız	yarasalardınız	Tense
pilavlar	yayalar	lemma
yönelmede	yönelme	Case
içiyorsun	yetişiyorsun	lemma
forumdaşlardınız	forumdaşlarsın	Tense
sapanlar	sapanlardık	Tense
kalamardık	topluluktuk	lemma
beceriksizler	beceriksiz	Person
aseksüellersiniz	aseksüellerdi	Tense
çocukluklardan	çocuklukları	Case
platformumda	platformumun	Case
kutlamalarda	kutlamaları	Case
sözcülüğünden	sözcülüğünüzden	Possession
ailenin	ailede	Case
uzağım	uzaktılar	Tense
kistlerimizde	kistlerimde	Possession
kediciklerdim	geylerdim	lemma
inek	inekler	Number
mezarlıksın	mezarlıktın	Tense
küçükler	küçüğüm	Person
yönlerinden	yönlerini	Case
konuğun	konuk	Case
onguncularımız	onguncuları	Possession
mermilerdik	mermileriz	Tense
köprünün	köprüye	Case
fenerler	fenerlerin	Case
kuğuydunuz	kuğulardık	Number
doğaya	doğadan	Case
yarış	yarışa	Case
mesafelerde	mesafelerin	Case
pudingin	pudingde	Case
kaplumbağaları	wikileri	lemma
korktuk	çıkardık	lemma
pişmeyeceğiz	şaşırtmayacağız	lemma
koordinatının	koordinatını	Case
orangutanımızda	orangutanlarında	Possession
dindar	dindardı	Tense
katkıda	katkıdan	Case
kalktın	kalktı	Person
dolmuşuz	dolmuştuk	Tense
oyu	oyları	Number
anneleri	anneyi	Number
şerbetçilerine	şerbetçilerimize	Possession
değerli	değerliyim	Person
zeytinyağına	zeytinyağının	Case
manivelanın	cihanının	lemma
gökadayı	gökadaları	Number
çöpçatansın	çöpçatandı	Tense
geçmişine	geçmişinin	Case
oyuncağımız	oyuncağı	Possession
düşese	düşesi	Case
gefirofobi	gefirofobide	Case
kümeslerin	kümesleri	Case
ekonomist	ekonomisti	Case
erkeceylerdi	erkeceylerdir	Tense
yönetimin	yönetimine	Case
raketin	rakette	Case
ölümsüzlük	ölümsüzlüğün	Case
huriyim	uçurtmayım	lemma
akımdan	akımda	Case
endüstrilere	endüstriye	Number
çıplaklığa	çıplaklığın	Case
kuvvetlerdin	kuvvetlersiniz	Tense
sürgünün	sürgününüz	Possession
ayaklarının	ayaklarımızın	Possession
boynu	boyna	Case
iguanaları	iguanaların	Case
şizofreniyi	şizofreniye	Case
kirişlerinizi	çevirimlerinizi	lemma
kamusumuza	kamusumuzdan	Case
güvenlerimde	güvenlerinde	Number
gruplara	ölülere	lemma
köprülerden	köprülere	Case
buzullardır	buzullardın	Tense
açlığa	açlığı	Case
kimyacılar	kimyacıların	Case
papalar	papaların	Case
aldırtırmasınız	öğretirsiniz	lemma
künefede	künefelerde	Number
bireylerin	bireyin	Number
lahmacunda	binde	lemma
uydun	çökerttin	lemma
başkansınız	başkandım	Tense
yardımcılıklarız	yardımcılıklardınız	Tense
laçolarımız	laçolarımızda	Case
yüzüncülersin	yüzüncülerdim	Tense
Tiranlıyım	dadıyım	lemma
koruganlarda	koruganlar	Case
kibritlerimizin	kibritlerinin	Possession
çeyreğin	çeyrekte	Case
kapaklarını	kapağımda	Case
oyuncuymuşuz	ayrımcılıkmışız	lemma
kitabesinden	kitabemden	Possession
karşılıktan	karşılığın	Case
salonlarında	salonlarının	Case
oyuncağınıza	oyuncaklarına	Possession
vücudu	vücut	Case
sonbaharlarım	sonbaharlarımda	Case
gözlüyor	yıpratıyor	lemma
mühendisliğe	mühendisliğin	Case
önceliğimizi	önceliğimizden	Case
erdemlisiniz	erdemliydiniz	Tense
kalmayız	kalmam	Person
köylünden	yufkandan	lemma
tıkıyorduk	tıkıyorlardı	Person
mumyalarınızda	mumyalarında	Possession
davranmadık	davranmadınız	Person
güreşçilerdim	çanlardım	lemma
kullardır	kullardık	Tense
kodda	kodlarda	Number
yakınların	yakınlarında	Case
terapistlerime	terapistlerimize	Possession
biseksüeller	biseksüeldik	Tense
gelinlik	gelinlikten	Case
mendiller	mendilleri	Case
kurumu	dürbünü	lemma
doğdum	doğdun	Person
kirpilerinize	kirpileriniz	Case
uyur	uyuyacak	Tense
olumsuzluklara	olumsuzlukları	Case
prenstin	prensim	Tense
kediciklerdi	forumdaşlardı	lemma
hamsileri	hamsilere	Case
psikologların	psikoloğun	Number
arşivler	arşivlerde	Case
bireylere	bireyleri	Case
omletlerimizi	omletlerimizin	Case
alanları	ışınım	lemma
yağmurları	yağmuru	Number
ünlüde	ünlünün	Case
topladılar	yapıldılar	lemma
kırıklarınızda	kırıklarınıza	Case
doğuruyordun	doğuruyordunuz	Number
palindromlarımızı	palindromlarını	Possession
listesi	çalışması	lemma
kestim	kestiler	Person
penalar	penaları	Case
öğretmenini	öğretmenine	Case
ebediyetlerimizin	ebediyetlerimin	Possession
kipamda	kipalarımda	Number
tohumum	tohumunuz	Possession
emniyetten	emniyete	Case
kalabalıklar	kalabalıklara	Case
arayüze	arayüzü	Case
temsillerimizin	temsillerimin	Possession
matlayım	matlaydım	Tense
hukukları	hukuklar	Case
geylerim	geylerdi	Tense
gitmenin	gitmeden	Case
oldum	olurum	Tense
verdirmiyorlar	buluşmuyorlar	lemma
kurbana	kurbanı	Case
değişikliklerden	değişikliklerin	Case
kristaller	kristallere	Case
odalardık	odalarız	Tense
odacıklar	odacıklarda	Case
kaçaklarında	enstrümanlarında	lemma
üyeliğinin	üyeliğinde	Case
yapımcıda	yapımcıya	Case
kalamarın	dağılmanın	lemma
tekilalar	efeler	lemma
şövalyeden	şövalye	Case
dergisinin	dergisinde	Case
sahifelerinizi	falcılarınızı	lemma
penise	tarihçiye	lemma
sıkıntıların	sıkıntının	Number
damadımıza	damadına	Possession
tıklarız	yolundurturuz	lemma
seçenek	seçeneğe	Case
tercümede	tercümelerde	Number
gerzeğim	gerzektiniz	Tense
roketlerin	roketin	Number
kaybolmayız	büktürtmeyiz	lemma
lahanalarmışsın	figüranlarmışsın	lemma
ritüeller	ritüelleri	Case
kocadan	koca	Case
aktör	aktördü	Tense
alkolün	alkole	Case
yakantopların	yakantoplar	Case
piramidi	piramitleri	Number
alfabede	alfabe	Case
mekiklerinden	mekiğinden	Possession
katamaranlar	katamaranlarda	Case
üstverimize	üstverimizde	Case
sesçiliklerimde	sesçiliklerim	Case
kullanmalarımız	donatımlarımız	lemma
önünde	önünden	Case
satış	satıştım	Tense
rüzgarları	rüzgarlara	Case
albümlerini	albümlerinde	Case
siğillerine	siğilimi	Case
eylemi	eylem	Case
eğrinin	eğri	Case
ibneydim	şeriattim	lemma
çobanlardı	çobanlarsın	Tense
cenneti	cennetleri	Number
asansöre	asansör	Case
karpuzdular	cümleydiler	lemma
havucum	havuçları	Number
köprülerin	köprülerden	Case
semercilermişim	bahçıvanlarmışım	lemma
nörondan	nöron	Case
içerirsiniz	içerirsin	Number
lepistesinde	lepistesini	Case
yerleşirsin	yerleşmezsin	Polarity
fabrikanın	fabrikaların	Number
kirecinden	kirecini	Case
midyeden	midyelerden	Number
kalbimi	kalbim	Case
salata	salatayı	Case
kaltaklar	kaltaklardınız	Tense
lepistesimize	ağlamamıza	lemma
sikiliyorsun	barışıyorsun	lemma
içti	içtiler	Person
dinletilerinizde	dinletinizde	Number
pimdin	çapaydın	lemma
kafatasları	kafatası	Number
sıvılar	sıvılarda	Case
gagada	gaganın	Case
nargilelerini	nargilemden	Case
poleninin	poleninde	Case
gözlemler	gözlemlerde	Case
konserleri	konserimde	Case
tümörlerden	tümörden	Number
katılaşmıyorduk	katılaşmıyordun	Person
alkolde	alkole	Case
kansere	kanseri	Case
iffetiz	çığırtkanız	lemma
ıstakozlarımızdan	ıstakozlarımıza	Case
albümlerinde	albümlerinden	Case
binekdim	bineksiniz	Tense
saksocuyduk	bülbüldük	lemma
salahiyetim	salahiyetlerim	Number
gösteriyorsun	bakıyorsun	lemma
gösteriyor	değiştiriyor	lemma
şüphelerdir	şüphelerdim	Tense
ümitsizsin	ümitsizim	Person
yetenekliydin	erdemliydin	lemma
kutsallıklarda	kutsallıkların	Case
elledi	eller	Tense
paparazilerdir	balkanlardır	lemma
satırtmazsınız	sattırırsınız	Polarity
şoklara	şoklar	Case
aktiftiler	aktifler	Tense
kötüleştirmiyorum	büktürtülmüyorum	lemma
kâselerini	kâselerimin	Case
fetvalara	fetvalar	Case
uzanmadılar	öpüşmediler	lemma
biranın	birayı	Case
amcalarsın	amcalardınız	Tense
ilkeden	bulgurdan	lemma
pandeisttiler	pandeistsiniz	Tense
tümörden	tümör	Case
güzellikte	güzelliğin	Case
meydandan	meydan	Case
mikrofon	mikrofonun	Case
sermediler	burkmadılar	lemma
kaçırdılar	kaçırdı	Number
maymunum	maymunduk	Tense
müdürlerinizde	sınırlarınızda	lemma
animasyonlarından	animasyonlarına	Case
babaanneye	babaanneyi	Case
birleşmedik	birleşmedim	Number
çıplaklığın	çıplaklığı	Case
mühendislik	mühendisliği	Case
eğriden	eğriye	Case
pöhrenktiniz	pöhrenksin	Tense
odacısından	odacılarından	Number
hatası	fındığı	lemma
yalnızlıktan	yalnızlıklardan	Number
müzeyi	müze	Case
ağaçlar	ağaçların	Case
göğsü	yoğurdu	lemma
tuğlaların	tuğlalar	Case
zarflara	zarfların	Case
kaynaşmazlar	ısınmazlar	lemma
bahçıvanlardı	bahçıvanlarsınız	Tense
kahvenizden	kahvelerinden	Possession
savunmadın	şaşılmadın	lemma
yapımcının	yapımcıya	Case
buzdolabını	buzdolabına	Case
pimleri	gelinleri	lemma
kanserde	kanserlerde	Number
lezbiyenime	lezbiyeninize	Possession
sancağı	sancağa	Case
uzaklarını	uzaklarımızı	Possession
kaygılardan	kaygıdan	Number
kakıyorsun	doğruyorsun	lemma
yanlışlıklardan	yanlışlıklar	Case
simya	simyada	Case
süründürtmüyorum	ürümüyorum	lemma
mezarlıksın	mezarlıktı	Tense
bencilim	bencil	Person
klostrofobiyi	klostrofobiye	Case
sabunluklara	sabunluklar	Case
galakside	galaksinin	Case
kurt	kurttan	Case
hecinde	hecinlerde	Number
yağlardan	yağdan	Number
kalamarmışsın	flaşmışsın	lemma
buseler	buse	Number
otizme	otizmi	Case
çamurları	çamurlarını	Case
kıskançmışlar	kıskançmışım	Person
özelsiniz	özelsin	Number
hanımlarını	hanımını	Number
sürprize	sürprizi	Case
şelale	şelaleydiniz	Tense
arayüzlerde	arayüzler	Case
mendili	mendile	Case
gökada	gökadadan	Case
karıştırıyorlar	yetiştiriyorlar	lemma
lahanasınız	lahanaydım	Tense
paskalyalarınızı	öznelerinizi	lemma
gökdelenlerden	gökdelenleri	Case
acıktırttın	yarattın	lemma
mantıksızmışız	mantıksızmışım	Number
okullarında	okulunda	Number
uzaylıların	uzaylının	Number
kovmayacaksınız	kovmayacaksın	Person
salonların	bacakların	lemma
develere	deveye	Number
armut	armudu	Case
sürgününüz	bileziğiniz	lemma
olmuyorsunuz	olmuyorum	Person
politikacılar	politikacıları	Case
heyecanımı	heyecanlarını	Number
müsaadelerimi	müsaadelerinin	Case
keserlardınız	keserlar	Tense
yüzeyini	yüzeyinde	Case
astronotları	astronotu	Number
enerjiler	enerji	Number
kaçarım	ağlarım	lemma
varışa	varışta	Case
sınıyorum	barışıyorum	lemma
eteğinin	eteğinden	Case
nekrofilde	nekrofillerde	Number
derlemelerinde	derlemelerinden	Case
kovdurtmadım	düzelmedim	lemma
sempozyumlarımdan	sempozyumlarımızdan	Possession
paşası	ağlaması	lemma
kalabalıkta	kalabalıktan	Case
sekizgenler	sekizgen	Number
bağımsızlıktan	bağımsızlığı	Case
buluttan	bulutu	Case
hücrelerine	hücrelerinize	Possession
dinlenmelerimiz	dinlenmelerimize	Case
canlandırmıyordular	canlandırmıyordu	Person
falcımdan	falcımızdan	Possession
kanatların	kanatlara	Case
ritüeli	ritüel	Case
canlanmaıyordum	canlanmaıyorlardı	Person
kemerler	kemer	Number
sunucularınızı	derlemelerinizi	lemma
annede	annenin	Case
azınlıkta	azınlıktan	Case
durakların	duraklarım	Possession
benzerdin	benzerim	Tense
karakollarında	karakollarına	Case
adsızdım	büyüktüm	lemma
saldırmayacaksın	saldırmayacaksınız	Person
votkalardı	votkalar	Tense
ziyaretçilerdim	ziyaretçiler	Tense
osurmuyordular	dondurmuyordular	lemma
gösterisine	gösterisinin	Case
kümem	yaratım	lemma
roket	rokete	Case
paylaştırmalarıma	paylaştırmalarımdan	Case
konularına	emlakçılıklarına	lemma
sakalar	saka	Number
cepheleri	cepheyi	Number
görmedi	bildirmedi	lemma
sahibinden	etiketinden	lemma
odacılardık	vahalardık	lemma
dürüm	dürümde	Case
gönlüm	gönüllerine	Case
bireylerin	bireyler	Case
iletiden	iletiye	Case
kuvvetlerdi	kuvvetlerim	Tense
lezbiyendiler	lezbiyenler	Tense
yaptırır	yaptırırlar	Number
götverenlerdi	üyelerdi	lemma
lensleri	lenslerde	Case
uzandılar	uzandık	Person
sosisinize	sosislerine	Possession
şortlarında	şortunuzda	Possession
asacaksınız	asacak	Person
gömleğim	gömleklerini	Case
tandırlarını	tandırlarımızı	Possession
şiire	şiirlere	Number
kullanıcılardı	babalılardı	lemma
pozitronda	pozitronu	Case
hazcımı	hazcını	Possession
pencerelerin	pencereleri	Case
neşelerimizde	neşelerimde	Possession
göllerden	göller	Case
kusacak	kusacaksın	Person
odunlar	odunları	Case
yıldırılar	yıldırıların	Case
şizofreniye	şizofreninin	Case
güzellikte	güzellik	Case
tartıştayı	tartıştaydan	Case
fabrikalardan	fabrikaların	Case
kurbanı	kurbanları	Number
kefirlerimin	tavernalarının	lemma
gübrelerimi	gübrelerini	Possession
sucuksun	sucuktunuz	Tense
pencerede	pencerenin	Case
bitirtiyordum	bitirtiyordun	Person
yanardağlarının	yanardağlarını	Case
mezralarına	mezralarınıza	Possession
tesadüfler	tesadüfleri	Case
elementin	elementlerin	Number
veledimizden	veledinden	Possession
hırsız	viski	lemma
köygöçürenlerdik	topluluklardık	lemma
acemi	acemiydin	Tense
tümörlerde	tümörde	Number
papazlarınızı	yetmezliklerinizi	lemma
ünlerimde	ünlerinden	Case
sayıyordum	boyuyordum	lemma
hastaydı	hasta	Tense
şallarımı	şalımı	Number
zağarlarımızın	zağarlarının	Possession
çılgınları	çılgınlarda	Case
süzmeleri	süzmeyi	Number
ceset	cesetler	Number
iletilerin	iletileri	Case
maydanozumuza	uyuşturucumuza	lemma
kanallarda	kanallar	Case
akbabayı	akbabaya	Case
germeyiz	germem	Number
yönelimin	yönelimden	Case
maymunsunuz	maymunduk	Tense
hatalarız	hatalardık	Tense
yaraydın	yaralar	Tense
malumatımıza	malumatımızda	Case
uykuları	uykulardan	Case
etkiye	etkide	Case
klorofilin	klorofilde	Case
kumaşın	kumaşta	Case
pandeistlerine	fakirlerine	lemma
güzelliklere	güzellikleri	Case
pişmeyeceksiniz	pişmeyeceksin	Person
gütüyordun	deşiyordun	lemma
koy	ıstakoz	lemma
müellifsin	müellifdi	Tense
vekillersin	vekillerdiniz	Tense
iskeletten	iskeletlerden	Number
sigaranın	sigaraya	Case
duymadım	duydum	Polarity
kıskancım	kıskançtım	Tense
erkecellerdik	erkecellersiniz	Tense
yazarın	yazar	Case
hazırlıkların	hazırlıklardan	Case
ayinleri	ayini	Number
alçaksın	alçağız	Person
kötüleşiyordu	diyordu	lemma
heykelciğin	yolculuğun	lemma
kadınlıklarda	kadınlıkları	Case
psikolog	psikoloğun	Case
geçinmedi	geçindi	Polarity
sargıları	burnum	lemma
yorgunluğun	yorgunluğu	Case
polisleri	polisin	Possession
çevreden	çevrenin	Case
karadullarınızdan	karadullarınız	Case
yorumlarımı	yorumlarından	Case
oğullardı	yabancılardı	lemma
azınlığı	azınlığın	Case
müzeye	müzelere	Number
aktörlerinizde	deyimlerinizde	lemma
kirlerden	kirleri	Case
ebelerdi	ebeleriz	Tense
satışlar	satıştım	Tense
tartmadık	tarttık	Polarity
kararmadınız	davranmadınız	lemma
pompaları	pompalar	Case
alkolü	alkole	Case
âşıklar	âşıktılar	Tense
boğaya	boğa	Case
buluta	bulut	Case
homoseksüeller	uydular	lemma
örüntüyü	örüntüde	Case
sancak	sancağı	Case
oyunculuğun	oyunculuğu	Case
malamozmuşum	malamozlarmış	Number
telofazlarımızdan	telofazlarından	Possession
pikniklerin	pikniklerden	Case
solunumları	yalıtımları	lemma
isteyeceğiz	çevireceğiz	lemma
küloduna	külodunu	Case
tohumlarda	tohumlar	Case
görüşün	asanın	lemma
içeceğine	içeceğin	Case
poleninden	polenimden	Possession
gökdeleni	gökdelenleri	Number
deisttin	deist	Tense
aznavurlarda	aznavurlara	Case
kümes	kümestiniz	Tense
alkolün	alkolü	Case
sürgünlerin	çeliklerin	lemma
kızlığın	kızlıktan	Case
başrahiplerimde	başrahiplerinde	Possession
böreklerinin	böreklerimizin	Possession
sandalyeyi	sandalye	Case
ülkeler	ülkeydin	Tense
görüntülerinin	görüntünün	Possession
raporlarının	raporlarında	Case
kedisinden	telefonundan	lemma
patronmuşuz	dulmuşuz	lemma
susamlarımda	susamlarında	Possession
sarhoşluk	sarhoşluğa	Case
varıştan	varışta	Case
enerjileri	enerjilere	Case
katilden	ünden	lemma
şikayete	şikayetten	Case
bahardan	baharın	Case
topiğin	topiğimiz	Possession
karımızdan	dürbünümüzden	lemma
yaratıkların	yaratıklara	Case
arzuhalciydiniz	arzuhalci	Tense
gaydalardan	gaydadan	Number
takarlar	dalarlar	lemma
kargalar	kargaları	Case
çandık	çanım	Tense
sorumlulukları	sorumluluklarına	Case
psikiyatristi	psikiyatriste	Case
kurumlarına	balıklarına	lemma
kovanın	kovaya	Case
temsillerinin	temsillerinden	Case
emmi	emmiler	Number
yağları	yağlara	Case
kuyumcularına	valizlerine	lemma
günahkârımın	günahkârımdan	Case
kullanmasında	kullanmasını	Case
gazeller	gazellerdi	Tense
kullanır	üzülür	lemma
ekiz	ektiniz	Tense
yazıyı	yazıları	Number
figüranlardı	figüranlarsın	Tense
okiyalardık	okiyalardır	Tense
portlarına	giysilerine	lemma
kasetlerinde	eşyalarında	lemma
sosyolojiye	sosyolojilere	Number
arınırsın	arınırsınız	Person
bakireliklerde	bakireliklerden	Case
satırtıyorlar	bekletiyorlar	lemma
çizmeciydim	çizmeciyiz	Tense
sivilceydi	sivilceyiz	Tense
kipler	kip	Number
köpürtmüyorlar	köpürtmüyor	Number
kibritim	kibritime	Case
yalancısında	yalancılarında	Possession
etki	etkiyi	Case
bakımsızdı	bakımsız	Tense
jeladalar	jeladaları	Case
gagayı	gagaları	Number
simitlerinizde	bardaklarınızda	lemma
avlardım	avlarsın	Tense
alabalık	alabalıklar	Number
ileteceksin	ileteceksiniz	Number
oğlancılarız	oğlancılar	Number
süslerdir	dinozorlardır	lemma
birdirbirden	birdirbiri	Case
geciktirtiyordu	geciktirtiyor	Tense
bürokratları	bürokratların	Case
kovayı	kovaları	Number
kavimlerinde	doğruculuklarında	lemma
kırıtıyordu	yedirtiyordu	lemma
boğalarda	boğaları	Case
birlikteliğine	birlikteliğinden	Case
hamsilerin	hamsinin	Number
dolmuşlarında	dolmuşumuzda	Possession
hamamda	hamamı	Case
Zagreplileriz	Zagreplilerdiniz	Tense
mahzeninden	basketbolcundan	lemma
süngüden	süngü	Case
ayrımcılıklardın	ayrımcılıklar	Tense
tuttum	tuttuk	Number
otlarının	dışkılarının	lemma
şapkacılarını	şapkacımızı	Possession
göbeğinin	göbeğinden	Case
kuram	kurama	Case
melodileri	melodiyi	Number
erkeneklerim	erkeneklerdim	Tense
yalancılarsın	yalancılardı	Tense
incimiz	sınıfımız	lemma
metrdoteliz	metrdoteldin	Tense
enerji	enerjide	Case
kirişini	fırtınasını	lemma
öçlerimizden	öcümüzden	Number
rüzgarda	rüzgarı	Case
umdunuz	atmatınız	lemma
eriyordum	eriyorduk	Number
yapılara	yapıları	Case
üstverilerdir	üstverilerdiniz	Tense
yazıların	yazıları	Case
kurtların	kurtlarda	Case
yaptıracak	döndürecek	lemma
krizantemimiz	coşkumuz	lemma
kullardı	çalgıcılardı	lemma
hahammışız	falcıymışız	lemma
jaguarların	yıldırımların	lemma
avantajlara	avantaja	Number
odacığı	odacıkları	Number
kanıyorlardı	kanıyordum	Person
heyecanlandırıyor	yazıyor	lemma
gazellerini	gazelini	Number
yardımcılıklarız	yardımcılıklardı	Tense
karnesine	gayzerine	lemma
örneklerine	örnekleri	Case
ıslaklıklar	ıslaklık	Number
sayacaklar	öldürtecekler	lemma
gösterimin	gösterilerinin	Number
üniversitede	üniversite	Case
moleküllerinden	molekülünden	Possession
akışkanları	akışkanlarda	Case
sağar	çıkar	lemma
sesleniyoruz	sesleniyorum	Person
nottan	nota	Case
destanlarını	destanıma	Case
hadis	hadiste	Case
romanında	romanının	Case
DVDleri	DVDlerin	Case
almanaktan	almanakta	Case
sümürmeyeceğim	arınmayacağım	lemma
basınlarından	basınından	Possession
armutların	armudun	Number
kebaplarınız	çölleriniz	lemma
nenelerimizin	nenelerimizden	Case
krallıklar	krallıklardan	Case
yastığımdan	yastıklarından	Number
ilçeleri	ilçeyi	Number
ısırık	ısırığı	Case
ikazına	ikazının	Case
ortamlardım	tundralardım	lemma
akçaağaçları	akçaağaçlara	Case
gökadayı	gökadaya	Case
kuruşlar	kuruş	Number
ebe	ebeydi	Tense
bahçıvanları	bahçıvanlarınız	Possession
koyuyorum	koyuyorlar	Person
çılgınlığı	çılgınlıktan	Case
oyuncusun	çerçisin	lemma
çöpün	çöpe	Case
keselerine	keselerinin	Case
seçeneklere	seçeneklerin	Case
imrenecekler	imrenmeyecekler	Polarity
irkeyelim	irkeyeli	Possession
alev	ziyaret	lemma
sancaklara	sancaklardan	Case
parada	paranın	Case
telesiyejin	telesiyejden	Case
sanatçılarda	sanatçıları	Case
çanlar	çanlardın	Tense
turşulardı	turşulardır	Tense
telaffuzlar	telaffuzlardım	Tense
alındırtacaksınız	eriyeceksiniz	lemma
havuz	atom	lemma
milyonerin	milyonerden	Case
idarelerini	idarelerinin	Case
malamozlarımız	garajlarımız	lemma
baharlara	baharların	Case
altınların	altınları	Possession
sivilce	yaya	lemma
alışıyorsunuz	deriyorsunuz	lemma
paradokslardan	paradokslar	Case
tükürdüler	benzediler	lemma
ittin	yoldun	lemma
şimşekler	şimşekleri	Case
köftelerinin	köftenin	Possession
yumuşakçalardım	yumuşakçalar	Tense
reaktörümüze	reaktörüne	Possession
çalgıcılarından	çalgıcımızdan	Possession
kitapçıkta	kitapçıklarda	Number
papazlardınız	papazlardır	Tense
idealleri	ideallerin	Possession
kalamarlardım	kalamarlarım	Tense
somlara	somlarda	Case
yapraklarında	yapraklarından	Case
hacıymışsın	votkaymışsın	lemma
kervansarayın	altdizinin	lemma
çukurlarda	çukurda	Number
içkide	içkiye	Case
istedi	anlattı	lemma
yeteneklisiniz	yetenekliydiniz	Tense
intiharını	devinimini	lemma
sosislerdi	sosislersiniz	Tense
kasımpatıların	kasımpatılarda	Case
şizofreniye	şizofreniden	Case
susamlarımın	susamlarında	Case
rüyalarmışım	temsilcilermişim	lemma
içgüdülerimi	içgüdülerini	Number
hazırlıkta	hazırlığa	Case
kraliçelik	kraliçeliği	Case
onguncularından	onguncundan	Possession
karakterine	çözeltisine	lemma
yabancılarını	yabancılarınızı	Possession
bıçaklayacağız	bıçaklayacağım	Number
notta	notlarda	Number
şaire	şairin	Case
saatlerin	saatin	Number
klişeler	yangınlar	lemma
ışıkları	ışıklarının	Case
develere	develerde	Case
bireylerde	bireylere	Case
araçlar	araçlardım	Tense
bekleme	beklemenin	Case
lisanı	lisanın	Possession
dürbünler	dürbünleri	Case
sekiyorlar	çağırıyorlar	lemma
abacılara	şoklara	lemma
kuklaları	kuklalar	Case
ayısın	ayıydınız	Tense
doğru	doğrular	Person
akışkanın	akışkanda	Case
sakalları	sakallarının	Case
kırıyorlardı	yarıyorlardı	lemma
kanalın	evladın	lemma
düdüklerinde	düdüğümüzde	Possession
çetelerdir	çetelerdi	Tense
önemleri	önemi	Number
işlemcilerinizden	işlemcilerimizden	Possession
hedonistimiz	geyşamız	lemma
kaygıları	kaygıların	Case
irkeyel	irkeyeldik	Tense
ünsüzden	ünsüzde	Case
merkezlerin	merkezlere	Case
şekerpare	şekerparede	Case
kibirler	kibir	Number
sakızıma	sakızımdan	Case
bükülmeyeceğiz	büküleceğiz	Polarity
lisanları	lisanlardan	Case
kuramlardan	kuramdan	Number
galaksiden	galaksi	Case
lastiklerinin	lastiklerini	Case
kiliselere	kiliseleri	Case
metafazı	tahtı	lemma
dönüşlerinde	dönüşlerinin	Case
alkışımın	alkışlarımın	Number
hazırdılar	hazırdı	Number
kayığın	kayıkların	Number
hamamda	hamama	Case
cisimdin	cismim	Tense
yetenekliydin	yeteneklisin	Tense
kazır	yıpratır	lemma
beklemede	beklemeden	Case
mızrapları	mızraplardan	Case
rehinelerimizde	falcılarımızda	lemma
saldırdılar	bürüdüler	lemma
tekilalarım	tekilalardın	Tense
perdeden	ışıktan	lemma
sihirliydik	sihirliyiz	Tense
sezmedim	dermedim	lemma
zorlukların	zorluğun	Number
liranın	liradan	Case
deynde	deynden	Case
monarşiye	monarşiyi	Case
benzerim	benzerlersin	Number
kipanı	kipamızı	Possession
üzgünmüşsün	üzgünmüşsünüz	Person
mikrofonu	mikrofonun	Case
girmiyordun	girmiyorduk	Person
ayçiçeğine	ayçiçeklerine	Number
önerileri	önerilerinde	Case
rahipdim	rahibiz	Tense
tırtılları	tırtılı	Number
okudunuz	okumadınız	Polarity
pırasaydınız	pırasasınız	Tense
fenerleri	fenerlerin	Case
boğalara	boğaya	Number
galaksi	galaksiler	Number
zeytinyağının	zeytinyağı	Case
kanalda	kanallarda	Number
anneleri	annelerde	Case
aldatmayacak	dondurmayacak	lemma
mutsuzmuş	becerikliymiş	lemma
kürklerimizden	kürklerimizin	Case
kullanılıyorlar	düşünüyorlar	lemma
kuyulardım	kuyularsın	Tense
Tiranlıydın	Tiranlı	Tense
polinomlarında	polinomlarımda	Possession
üzülmeyeceksin	üzüleceksin	Polarity
prezervatiflerinden	prezervatifinden	Possession
köpeklerin	köpeklerden	Case
değişikliklere	değişikliklerden	Case
bahçıvanlarımız	bahçıvanları	Possession
kıyafetlerine	bataryalarına	lemma
sosluklarında	sosluklarımızda	Possession
otelinden	otellerinden	Number
tükürüyordum	yumuyordum	lemma
fondötenlerde	fondötenler	Case
kuvvetin	kuvvetleri	Possession
seslenmeyeceksiniz	yoldurtmayacaksınız	lemma
Yahudilerinizi	fetişlerinizi	lemma
gökdelenden	gökdelende	Case
satışlarsın	satışlardı	Tense
yalancımın	yalancılarında	Case
ucubelerdi	ucubelersin	Tense
maskaralarımızda	fibrinojenlerimizde	lemma
davranışçılıkları	davranışçılıkların	Possession
giysiyiz	giysiydin	Tense
kullanmasına	kullanmasını	Case
kolajlarında	dumanlarında	lemma
silahlarından	Lefkoşalılarından	lemma
körlükte	körlüğü	Case
ekşiteceğiz	ekşitmeyeceğiz	Polarity
sözlüklersiniz	sözlüklerdik	Tense
köylülerim	köylülerdi	Tense
standınızı	standını	Possession
akrobatlar	viskiler	lemma
kolejlerinden	düğünlerinden	lemma
hazırız	hazırım	Number
perdeye	perdeden	Case
aşıklar	aşıkdık	Tense
bekleme	beklemeyi	Case
elementin	elementte	Case
piskoposuna	piskoposlarına	Number
pezevenkmişler	bilyeymişler	lemma
istatistikleri	istatistiklerde	Case
parçalanmasına	parçalanmasını	Case
yanlışlıktan	yanlışlığın	Case
patlıcanların	patlıcanın	Number
lisanları	lisanlar	Case
masumiyetlerimin	masumiyetlerimden	Case
bugünlerimden	bugünlerinde	Case
korkuluğumuzun	korkuluğunuzun	Possession
gözyaşlarına	gözyaşlarını	Case
başvurularıma	başvurularından	Case
derneğin	derneği	Case
şimali	şimalin	Possession
önyargıların	önyargılar	Case
gözyaşlarının	gözyaşlarına	Case
temsilciliklerimizden	temsilciliklerinizden	Possession
iyileştirmedi	burkmadı	lemma
değişikliklerde	değişikliklerin	Case
büyüklükler	büyüklük	Number
birleşmelerine	birleşmelerinden	Case
boyun	boyunda	Case
eklemeliymişim	eklemeliymiş	Person
çıkarırım	çıkarırsınız	Person
dövüşçüm	dövüşçümü	Case
papirüsten	brokoliden	lemma
palyaçolarınızda	palyaçolarınızın	Case
keçilerden	keçilere	Case
ayrılmalar	ayrılma	Number
çarmıhları	çarmıhım	Number
değerlisin	değerliyim	Person
özelsiniz	özelim	Person
oligarşiler	oligarşi	Number
sürülüyorsunuz	yendiriyorsunuz	lemma
onarıyorsunuz	çalıyorsunuz	lemma
ilklendirmeydiniz	ilklendirmeler	Tense
rüyalar	benekler	lemma
yaralanmalarımızı	yaralanmalarımızın	Case
lazerler	lazer	Number
ormanları	ormanlarının	Case
yapı	yapılar	Number
psikologlar	psikolog	Number
anneler	annelerde	Case
kovdurmuyorduk	ısınmıyorduk	lemma
maktamıza	cephemize	lemma
pompada	pompanın	Case
yusufçuğun	yusufçuk	Case
gergedanların	gergedanlar	Case
dağlılardan	dağlılara	Case
uzaylı	uzaylılar	Number
idadi	idadiden	Case
kuyanlarınızda	borçlarınızda	lemma
uluslar	uluslardan	Case
buselerden	buselere	Case
çizeceksin	çizecek	Person
güceniyordun	güceniyordum	Person
albümümde	albümünde	Possession
nüfuza	nüfuzun	Case
devingenliklerinizin	devingenliklerinin	Possession
düşünceliydi	düşünceliydiler	Person
kolejlere	ustalara	lemma
sitelerinin	sitelerimizin	Possession
kurtlar	kurtlardan	Case
kıbleleriniz	çedarlarınız	lemma
kibritimizde	kibritimizi	Case
galakside	galaksi	Case
zakkum	zakkumdan	Case
arayüzlerde	arayüzlere	Case
okunaksızlıklar	okunaksızlık	Number
helikopterde	helikopterden	Case
kulüpler	kulüplere	Case
Zagreplilersin	elmaslarsın	lemma
pirinç	pirinçti	Tense
klorofillerde	klorofilde	Number
kibirlerde	kibirde	Number
jiletler	jiletlerde	Case
alkol	alkolü	Case
rüzgar	rüzgarlar	Number
kılıflarımıza	kılıflarımızın	Case
keşlerini	keşimi	Number
paşalara	paşalar	Case
odalar	odalardı	Tense
kesmediler	gelmediler	lemma
imrenmeyeceksiniz	imrenmeyeceğiz	Person
tekfurduk	tekfurum	Tense
sikimize	çarımıza	lemma
liralardan	liraların	Case
tütmüyordu	tütmüyorduk	Person
kartlarını	kartlarına	Case
sorun	soruna	Case
uçağında	uçaklarında	Number
iğnenizde	evreninizde	lemma
malamozmuşsunuz	çalgıcıymışsınız	lemma
küçülmüyorduk	küçülmüyoruz	Tense
dansçıda	dansçıyı	Case
destanları	destanı	Number
hidratın	hidrata	Case
tümceyim	tümceydin	Tense
saatin	saatten	Case
otizmlere	otizme	Number
çizmecilerdiniz	çizmecileriz	Tense
tükenmedik	asmadık	lemma
yönsün	yöndü	Tense
teoremlerimden	teoremlerinden	Possession
kamera	aynasız	lemma
pijama	yangın	lemma
düzmediniz	düzmediler	Person
rebetikoların	rebetikolar	Case
dudaklarında	dudakları	Case
kayıklara	kayıkların	Case
kâbuslarından	kâbuslarına	Case
kumanda	başvurunda	lemma
somnifobide	somnifobilerde	Number
jeolojiden	jeoloji	Case
acayipmişiz	bencilmişiz	lemma
bakmadınız	bakmayacaksınız	Tense
yakışıklıydınız	yakışıklıydın	Number
geometrilerin	geometrileri	Case
şaşırtdık	şaşırtdın	Person
doyarım	doyarız	Person
dünya	dünyaya	Case
emlakçılıklarını	emlakçılıklarımı	Number
interfazımızın	interfazımıza	Case
pasifmişim	bilgisayarlıymışım	lemma
mobilyalarında	yasağımda	lemma
iyonosferde	iyonosferden	Case
atomunu	atomunuzu	Possession
üstverilerdi	üstverilerim	Tense
konuştayın	konuştayda	Case
koltuklar	koltuklarda	Case
içgüdüsüne	içgüdüsünde	Case
dilbilimden	dilbilimlerden	Number
itlerdiniz	itler	Tense
lordları	lordlarım	Number
hanımlarının	aşklarının	lemma
göttün	götsün	Tense
paylaşacaksın	yarayacaksın	lemma
korsanmış	yardımcılıkmış	lemma
paşaydım	buzuldum	lemma
kasidelerinizi	kasidelerinizden	Case
laboratuvarları	laboratuvarlarına	Case
körlüklerde	körlükler	Case
madalyadan	madalya	Case
kaynaştırtmazsın	kaynaştırtırsın	Polarity
seçenek	seçenekten	Case
vahalarım	vahalardık	Tense
kod	erkenek	lemma
sürülecek	dolacak	lemma
hamamın	hamamı	Case
hesabı	hesaptan	Case
erkeceylerim	erkeceylerdik	Tense
mısralar	süzgeçler	lemma
objesi	takvimi	lemma
karının	tercümanının	lemma
mevzundan	mevzun	Case
sevdi	bindi	lemma
tarafından	tarafı	Case
hikayede	hikayeye	Case
kursiyerimize	dikkatimize	lemma
dutlara	dutların	Case
fukarada	fukaraa	Case
bireylerde	bireyleri	Case
kirleteceğim	kirleteceğiz	Person
maaşlar	maaşları	Case
meydanda	meydanın	Case
kırtasiyeydim	kırtasiye	Tense
aynştaynyumlarımızın	aynştaynyumlarımın	Possession
kaçırdı	kaçırdılar	Person
minberimde	minberlerinde	Number
hamam	hamamı	Case
klarnetlerine	bakirlerine	lemma
ünlülere	ünlülerde	Case
amatörümüz	amatörümüzden	Case
mesafeyi	mesafeleri	Number
mükemmelliğin	dumanın	lemma
kursiyerdi	kursiyeriz	Tense
gökkuşağının	gökkuşaklarının	Number
alacaklar	alacağız	Person
ölümsüzlüklere	ölümsüzlüklerin	Case
aldatacaksın	aldatacak	Person
üzmedi	üzmediniz	Person
verdirtmiyorduk	verdirtmiyordunuz	Person
öpücüklerinizde	öpücüklerinde	Possession
listenize	listeme	Possession
çevrede	çevreye	Case
sidikte	anarşide	lemma
irkeneklersin	irkeneklerdin	Tense
alkollerde	alkolde	Number
ağaçlarda	ağaçların	Case
reaktörünüzün	coşkunuzun	lemma
hızını	cezeryesini	lemma
ziyaretçiler	ziyaretçilerdin	Tense
vardık	varırız	Tense
korsanlardınız	korsanlarsın	Tense
sepetim	sepetimden	Case
ispatlarsınız	üşürsünüz	lemma
vazolar	vazolardın	Tense
evciğinin	evciklerinin	Possession
tümöre	tümörlere	Number
sekreterler	sekreter	Number
mitokondriye	mitokondrilere	Number
ongunumun	banliyölerinin	lemma
koparız	yuvarlarız	lemma
ramazanlarımda	ramazanlarımızda	Possession
sinagogunda	aslında	lemma
idarelerimiz	idareleriniz	Possession
kemerlerde	kemerler	Case
karanlıkların	karanlıklar	Case
aletlerinden	bağırsaklarından	lemma
topta	toptan	Case
ortalardım	ortalarım	Tense
nergisinde	avcısında	lemma
sürekliliğime	sürekliliğinize	Possession
işkenceciydin	işkenceci	Tense
avantajdan	avantajlardan	Number
kıblemizden	genelevimizden	lemma
kurumların	yastıkların	lemma
limonatana	limonatanıza	Possession
kokmazlar	kokmadılar	Tense
teknolojinin	teknolojilerin	Number
cehenneminizin	cehennemlerinizin	Number
ibnelerdiniz	ibnelersiniz	Tense
göçlerinden	üzümlerinden	lemma
liseler	liselerde	Case
serdin	serdiniz	Number
katillerine	ölümlerine	lemma
şapkaya	şapkada	Case
hamamlardan	hamamlar	Case
armutlar	armutların	Case
katkının	katkıya	Case
tatili	tatilleri	Number
penanın	penaların	Number
kanlılıklarda	süspansuarlarda	lemma
yapımcıda	yapımcının	Case
örümceği	örümcekleri	Possession
avantajın	avantajların	Number
alevlerinizden	tasarruflarınızdan	lemma
bulutu	bulutları	Number
patlamalar	patlamalarda	Case
hastalıklara	uçaklara	lemma
yalnızlıkları	yalnızlıklara	Case
rahiplerini	rahipleri	Case
çamların	çamlara	Case
homoseksüeldi	homoseksüel	Tense
sanatçı	sanatçılar	Number
aldırtıyorsunuz	yitiyorsunuz	lemma
dildomuzun	dildomuza	Case
robota	robotu	Case
kaybolmuyoruz	eskemiyoruz	lemma
sancaklara	sancağa	Number
surelerden	binlerden	lemma
tecrübesine	tecrübesini	Case
patlıcanı	patlıcanın	Case
yaratıkların	yaratıklardan	Case
psikiyatrist	psikiyatristler	Number
meleklerine	gizemlerine	lemma
kodlar	kodlardan	Case
kilerlerine	kilerlerinin	Case
koltuktan	koltuklardan	Number
trafiğe	trafiğin	Case
zavarı	zavarında	Case
periydim	periyim	Tense
mermisini	mermisinden	Case
röportajlarına	röportajlarından	Case
kerevizlerinden	kerevizinden	Number
meşaleler	flaşlar	lemma
körümüzde	körlerinde	Possession
merkezde	merkez	Case
birleştirmezsin	birleştirmez	Person
yaramı	yaramızı	Possession
savunmazsınız	yolundurmazsınız	lemma
silgiler	flaşlar	lemma
avlarında	avları	Case
hedef	hedefi	Case
gökadalarda	gökadalardan	Case
gözlemcilere	gözlemcileri	Case
kervansaraya	kervansarayı	Case
bay	baydı	Tense
havuçlarımız	tercümanlarımız	lemma
öznelerin	özneleri	Possession
bezdiride	bezdirilerde	Number
odacıkları	odacıklara	Case
sorumluluklarının	çadırlarının	lemma
notilusunda	demircisinde	lemma
kırbaçlarınız	kırbaçlarım	Possession
kedisin	kediydin	Tense
kayığın	kayıktan	Case
fenere	fenerlere	Number
ümitliler	ümitliydiler	Tense
pijamalarmış	tütüncülermiş	lemma
süzersiniz	üzersiniz	lemma
buzdolaplarının	buzdolapları	Case
pozitronu	pozitronları	Number
tuğlayı	tuğlada	Case
muşmulalarda	muşmulalar	Case
angutlarız	angutlardı	Tense
voleybolun	voleybolda	Case
karılardan	tatillerden	lemma
yalıtımımdan	yalıtımlarına	Case
yazılarda	yazılara	Case
kuram	kuramı	Case
bayımıza	bayınıza	Possession
hedeflerden	hedefler	Case
güneşlerin	güneşleri	Case
rehinelerinin	rehinenin	Possession
köpeklere	köpeklerden	Case
fobofobiler	fobofobilerde	Case
butondan	butonda	Case
katkılar	katkılara	Case
nüfustan	nüfus	Case
hareketliliklerinden	özetlerinden	lemma
üniversitelere	üniversiteler	Case
şarkıcıydık	şarkıcıyım	Tense
izlersin	beklersin	lemma
limonata	limonatayı	Case
kekler	keklerin	Case
abazanmışsın	başarılıymışsın	lemma
klatratların	klatratın	Number
düğmeyi	düğmeye	Case
kızgınsınız	kızgındınız	Tense
gerzeklersiniz	gerzeklerdi	Tense
depresyonun	depresyonu	Case
uzaylılarda	uzaylılara	Case
bulutlardan	buluttan	Number
şampiyonu	şampiyonları	Number
düğmelerin	düğmelere	Case
röportajlardan	röportajdan	Number
benzerlerine	benzerlerimize	Possession
harçlarından	harçlarının	Case
düğmeyi	düğmeleri	Number
eklemelisin	eklemeliyim	Person
kanserlerden	kanserden	Number
kimyacılardan	kimyacıdan	Number
gözlemediler	eğlenmediler	lemma
adlarından	adlarının	Case
gölgeden	gölgeyi	Case
yordamının	yordamında	Case
biranın	biraların	Number
huzurluyuz	huzurlusun	Person
paraların	paralara	Case
cinsiyeti	cinsiyetleri	Number
eziyetini	eziyetimi	Possession
esrarengizler	esrarengizdiler	Tense
çaydanlıkta	çaydanlığın	Case
kullanıcısından	kullanıcısının	Case
sararır	davranır	lemma
hançerleri	arpaları	lemma
kimliklerin	kimliklerini	Case
omuzların	omuzun	Number
kuşunuz	kuşlarınız	Number
güllaç	zakkum	lemma
selamdan	yemeniden	lemma
buzulsun	buzuldular	Tense
sattırtırım	atmazım	lemma
boşalmazlar	boşalmadılar	Tense
kullanımda	kullanım	Case
deistime	deistimize	Possession
kılmayacaksın	kılmayacağız	Person
kafatasından	kafatası	Case
kararacak	yolundurtacak	lemma
peynirine	cemaatine	lemma
gökdeleni	gökdelen	Case
dışkılarının	dışkılarını	Case
cennetleri	cennetler	Case
otizmden	otizme	Case
fetvayı	fetva	Case
sıcaklıkta	sıcaklıktan	Case
vişnelerim	vişnelerdi	Tense
gözbebeğinin	gözbebeklerinin	Number
sıcaklıkta	sıcaklıklarda	Number
baharları	baharlar	Case
avukattılar	avukatlar	Tense
dağlıda	dağlıyı	Case
samuraya	samuray	Case
bağımsızlıkta	bağımsızlığı	Case
giysiydiniz	giysisiniz	Tense
şikâyette	şikâyetten	Case
kalfaydılar	kalfalar	Tense
büyükmüşsün	büyükmüşsünüz	Person
bakirliği	bakirlikleri	Number
buluştu	buluştular	Person
nükleotidi	nükleotitleri	Number
başparmakları	başparmaklara	Case
hesabın	hesaba	Case
gözlemcileri	gözlemciyi	Number
rahiplerimize	rahibimize	Number
süzüyor	giriyor	lemma
guakamolelerimin	guakamolelerine	Case
önceyi	önce	Case
sosyologların	yolculukların	lemma
yönetimin	yönetiminin	Case
hukukta	hukuk	Case
minderi	minder	Case
maaşı	maaş	Case
devirleriz	devirlerdi	Tense
çamlar	çamlara	Case
akıya	duaya	lemma
arzda	arzın	Case
mitokondriyi	mitokondrinin	Case
devrimimiz	devrimin	Possession
koyulaşmıyordular	ayrılmıyordular	lemma
bükersiniz	ekşirsiniz	lemma
fakültelerimi	fakültemi	Number
seksten	seksi	Case
yağların	yağlardan	Case
şüphelerin	şüphelerim	Possession
paylaşımlarına	yamyamlarına	lemma
sözcünü	sözcünde	Case
akışın	akışının	Case
yoldun	yolsun	Tense
dünyadan	dünyada	Case
muğlalıklara	muğlalığa	Number
çirkinmiş	çirkinmişsin	Person
mezarlıklarında	mezarlıkları	Case
liseyi	liseye	Case
iyileştiriyordun	örtüyordun	lemma
kıyafetsin	efesin	lemma
özelmiş	özelmişsin	Person
işletimine	yetmezliğine	lemma
katları	tartıştayları	lemma
ağaçların	ağacın	Number
robot	robotu	Case
desenlerinizden	desenlerinden	Possession
tarıyorlar	tarıyorum	Person
kulüpleri	kulüplerde	Case
tanışacaksın	tanışacaklar	Person
nedimesiniz	nedimeler	Number
iletkenler	iletken	Number
cümleler	cümleydiler	Tense
aygıtlarını	aygıtları	Case
heykelciklerinde	emlaklarında	lemma
manayız	böğürtleniz	lemma
kemerde	kemeri	Case
Kürtler	Kürtleri	Case
kavundum	aseksüeldim	lemma
titreşimi	titreşime	Case
beklersin	beklersiniz	Number
ısırıklar	ısırıklardan	Case
kafatasları	kafataslarında	Case
kılmazsın	ölçmezsin	lemma
entegrasyonlar	entegrasyon	Number
kaynaştı	kaynaştık	Person
dişçi	dişçiler	Number
tanımlığınızda	tanımlığımda	Possession
gerzeksiniz	gerzektiniz	Tense
uzağına	uzağıma	Possession
düğmeyi	düğme	Case
belediyesi	belediyeleri	Possession
kuklalara	kuklaya	Number
sıcaklıklara	sıcaklıkları	Case
savaşçılarsınız	savaşçılardınız	Tense
dizelerimize	dizelerimizi	Case
uyumuyordular	boyamıyordular	lemma
soğurmadınız	soğurmadılar	Person
mumyalar	damatlar	lemma
kanatlara	kanatları	Case
saçları	saçlarına	Case
sorumdan	sorumun	Case
akiferden	akiferi	Case
kazandılar	kazanırlar	Tense
ayinlerde	ayinlerin	Case
aydınlığın	aydınlıkta	Case
dörtgen	dörtgenler	Number
yaratık	yaratığı	Case
güzelliği	güzellikleri	Number
uçurtmalardı	uçurtmalarsınız	Tense
enerjilerde	enerjileri	Case
katamaranların	katamaranlarında	Case
müstahdemlermişsin	doktorlarmışsın	lemma
koşucusun	Musevisin	lemma
koşucular	koşuculardın	Tense
vasatız	vasatım	Number
kayıtları	kayıtlarına	Case
yardımcıydı	yardımcısın	Tense
soğurmuyorlar	yıkamıyorlar	lemma
sapacaklar	düşecekler	lemma
hesaba	hesaptan	Case
yapmam	yapmanız	Possession
piramide	piramitte	Case
yağlarda	yağlardan	Case
kuyumcular	şüpheler	lemma
kuyumculardır	kuyumculardık	Tense
yeşimlerimde	yeşimlerine	Case
aktörlerdin	aktörlerdir	Tense
alındırtırsın	delirirsin	lemma
acayipsiniz	acayipler	Person
sürücüleriz	yolcularız	lemma
çatlaklarda	çatlakları	Case
yetileri	yetiler	Case
dövüşmüyorum	dövüşmüyorsun	Person
rakamlarını	ömürlerini	lemma
sandviçe	ölüye	lemma
kuzuydunuz	kuzular	Tense
tümcesi	tümceleri	Possession
düşeslerde	düşesleri	Case
tabaklara	tabaklar	Case
canlandırtmayacağız	canlandırtmayacak	Person
sürdürülebilirlik	sürdürülebilirliği	Case
yüreğe	yürek	Case
göstermedi	yendirmedi	lemma
endüstrilere	endüstrilerden	Case
bulutun	bulutların	Number
kaltaklardın	kaltaklarız	Tense
bineklerinizde	bineklerinizi	Case
kartallara	dilimlere	lemma
fiziklere	fiziklerden	Case
korktu	korktum	Person
biralar	bira	Number
hemşirelerdin	hemşireleriz	Tense
otelinin	çeliğinin	lemma
kristallerden	kristallerin	Case
yoğurtçulardın	yoğurtçularız	Tense
kırılıyordun	büküyordun	lemma
çamı	çam	Case
değişiklik	değişiklikler	Number
yapıyı	yapıdan	Case
penisilinlerini	penisilinini	Possession
yakutu	yakuta	Case
bozayıydın	bozayısın	Tense
alanları	bilezikleri	lemma
âşıklardır	âşıklardın	Tense
içkilerde	içkilere	Case
iletinin	iletiyi	Case
sendromlarıma	sendromlarımıza	Possession
sendromları	yarışmaları	lemma
hedeflere	hedeflerin	Case
dinamitine	dinamitlerine	Number
kaygılara	kaygıları	Case
sunucularsınız	sunuculardım	Tense
aktörü	aktörleri	Possession
bulunma	bulunmayı	Case
hazırdı	hazır	Tense
yaptırttın	yaptırtırsın	Tense
soğuyordum	soğuyorlardı	Person
hükûmetlerini	yönlerini	lemma
saatte	saati	Case
tanımlıklarınızı	tanımlıklarınızdan	Case
endüstriden	endüstriye	Case
karartınız	gerindiniz	lemma
sürücüydün	sürücüyüz	Tense
kaleyi	zeytinyağını	lemma
heteroseksüeliz	heteroseksüeldik	Tense
çalışmıyorsunuz	çalışmıyorum	Person
aletsiniz	araçsınız	lemma
istatistiğe	istatistiği	Case
aksanına	etiketine	lemma
terzisin	terziydiniz	Tense
kovdurtuyor	biliyor	lemma
öğretisinde	öğretimde	Possession
kılacaklar	yığacaklar	lemma
şikayet	şikayetler	Number
gözlemden	gözlemde	Case
frenlerine	frenlerinize	Possession
şapkaya	şapka	Case
tecrübeler	tecrübelerde	Case
yüzüncüyümün	yüzüncüyümüzün	Possession
armağanda	armağan	Case
onguncularını	onguncularına	Case
kellikler	fotoğrafçılar	lemma
barbarız	barbardık	Tense
altınlarınızda	altınlarımızda	Possession
tacizlerde	tacizde	Number
fazlalıklar	fazlalık	Number
biranın	biraya	Case
aletler	aletlerdi	Tense
azınlıklarda	azınlıkta	Number
saati	saatten	Case
gevrekliğin	gevrekliğe	Case
dövüşçülerimizden	dövüşçülerinden	Possession
kargada	kargayı	Case
kozlarını	çapalarını	lemma
kuku	kukuda	Case
isterler	şişerler	lemma
çocukluklara	çocuklukları	Case
babacansınız	babacanlar	Person
reçellere	reçeller	Case
altdizine	altdizinde	Case
beldesine	beldemize	Possession
pompa	pompadan	Case
karanlıklar	karanlıkları	Case
papağanlarınızdan	papağanlarımızdan	Possession
istatistikte	istatistikten	Case
yormuyorum	yormuyor	Person
yedigene	yedigenlere	Number
sakalara	sakalar	Case
sonralardan	sonralara	Case
izleyicinin	izleyici	Case
sayımlarınızda	sayımlarında	Possession
referansından	referansımızdan	Possession
çokgenlerin	çokgenlerde	Case
kazmaya	zarfa	lemma
patlıcanların	patlıcanlar	Case
kozmonotları	deyimleri	lemma
körfezin	körfez	Case
memleketlerde	büyüklüklerde	lemma
mızraba	mızrapta	Case
unutuyorsun	yendirtiyorsun	lemma
oltamızın	ünümüzün	lemma
keşfetti	deşti	lemma
geyşayı	geyşaya	Case
yaralardın	yaralarım	Tense
yorumunuzda	yorumunda	Possession
fundada	fundaya	Case
değişikliklere	değişiklikler	Case
iskenderden	iskendere	Case
katılıyordu	katılıyordum	Person
cacığın	cacığı	Case
rahipdi	rahibiz	Tense
gökada	gökadaya	Case
puanlarda	puanda	Number
kursiyerine	çalışmana	lemma
mahzenlerde	mahzenler	Case
kuldular	kullar	Tense
kamuslarım	kamuslardım	Tense
otoculuklarımızı	otoculuklarımızda	Case
tabelanın	tabelayı	Case
sıvılardan	sıvılarda	Case
oturuyorsunuz	eriyorsunuz	lemma
iguanalar	iguanaların	Case
kullanımın	kullanımına	Case
gülmedik	yolmadık	lemma
üniversitelere	üniversiteleri	Case
uzaylıyı	uzaylıları	Number
soğanlarımı	soğanlarımızı	Possession
mayonun	aşçının	lemma
hamamlar	hamamlara	Case
kopacak	koptu	Tense
galaksiler	galaksileri	Case
barbarmışım	barbarmışız	Person
acıtırsınız	geliştirirsiniz	lemma
lenslerin	lenslere	Case
cadıda	cadıyı	Case
uyanmıyordu	şişmiyordu	lemma
anahtarlıklarımız	anahtarlıklarımızda	Case
balığım	balıktım	Tense
çedarlardı	çedarlarsınız	Tense
ağırdım	ağırdı	Person
huzurdum	yeterliktim	lemma
çekirgeler	çekirgeleri	Case
alanında	alanından	Case
klostrofobilerde	klostrofobide	Number
müezzindim	müezzinim	Tense
sebeplerinden	sebeplerinde	Case
paşalarımız	vampirlerimiz	lemma
ırkün	ırke	Case
kafatasları	kafataslarına	Case
heyecanlanmıyor	heyecanlanmıyorsunuz	Person
ehemmiyetliliklerimizde	ehemmiyetliliklerimizi	Case
sözcülüğünü	enfeksiyonunu	lemma
alkolü	alkolde	Case
düşmedi	düşmeyecek	Tense
nüfusa	nüfusu	Case
kaynaştırtmıyorum	kaynaştırtmıyor	Person
rüzgârına	rüzgârlarına	Number
şaşacağız	şaşarız	Tense
kalemtıraşlarda	sülüslerde	lemma
dedenin	dedelerin	Number
gevreklikler	gevreklik	Number
patenlerini	patenlerimi	Number
ofisi	ofisleri	Number
yamuklarda	yamuklardan	Case
kuyumculardın	eşyalardın	lemma
inekleri	ineklerde	Case
kıllarını	kıllarımı	Number
bilardodan	bilardonun	Case
polinomlarının	polinomunun	Possession
çekirge	çekirgeler	Number
köpeklerin	köpekleri	Case
hedonizmlerimin	hedonizmlerini	Case
fıstığın	fıstıkları	Possession
merkezlerin	merkezin	Number
alkışı	alkışının	Case
samankapanımızı	samankapanımı	Possession
küçüklüğün	küçüklüğü	Case
kanallardan	kanallarda	Case
dalgınlıkta	dalgınlık	Case
adenozinde	adenozine	Case
yörüngelerinde	yörüngelerin	Case
kulüplerden	kulüplere	Case
tercüme	tercümeler	Number
perdeleri	perdeyi	Number
kavunundan	kavunumdan	Possession
oltaydı	olta	Tense
mumunuz	zırtgeliniz	lemma
gelinlik	gelinliğin	Case
aynasızlardın	aynasızlardır	Tense
otoculuğumda	otoculuklarında	Number
müzikaline	çavuşuna	lemma
ortammışlar	başkanmışlar	lemma
kaynaştırtırsınız	ölçtürtürsünüz	lemma
yaparlar	canlandırılırlar	lemma
manaydılar	manalar	Tense
ağaçlara	ağaçların	Case
sapmadınız	bitirmediniz	lemma
halıya	halı	Case
sivrisinekleri	sivrisineğin	Possession
attırmadı	attırmadınız	Person
ablanızda	ablanda	Possession
boyacılardınız	boyacılarım	Tense
parabolünden	eziyetinden	lemma
çokgenlerin	çokgenlerden	Case
kırtasiyeleriz	kırtasiyelerdiniz	Tense
kümesini	kümesine	Case
yarasalarınızın	yarasalarımın	Possession
sokaklarını	sokaklarımızı	Possession
eksenleri	eksenlerini	Case
bükerler	büker	Person
gitarında	gitarından	Case
sınavlara	sınavlarda	Case
yapacağım	yeteceğim	lemma
masaları	masası	Possession
pirinçlerinin	pirincimde	Case
anneliği	annelik	Case
kışkırtırsınız	yontarsınız	lemma
ilginç	ilginçti	Tense
lezyonum	lezyonunuz	Possession
böceğimin	böceğimizin	Possession
sunucularsınız	ülkelersiniz	lemma
sihirliymişim	coşkuluymuşum	lemma
ağaçlar	ağaç	Number
surelerden	sureden	Number
süsümüzü	süsünüzü	Possession
dökmüyorsunuz	döküyorsunuz	Polarity
bitişinizden	bitişinden	Possession
element	elementi	Case
güne	günlere	Number
albatroslara	teşhirlere	lemma
kıskançlığın	kıskançlıkların	Number
becerikliymişiz	becerikliymişsiniz	Person
avantajı	avantaj	Case
puanı	puanları	Number
intiharında	intiharına	Case
kolonyalardım	Musevilerdim	lemma
erkeceydiniz	erkeceyler	Tense
taçlarını	tacını	Possession
kravatınızdan	kravatınıza	Case
nükleotidin	nükleotit	Case
âlemim	âlemimin	Case
vapurunun	vapurunu	Case
uru	ur	Case
karmadan	karmaya	Case
döker	dökmez	Polarity
yön	yönden	Case
cadılara	cadıları	Case
süpürgelerden	süpürgelerde	Case
ölülerim	ölüyüm	Number
misketleri	misketler	Case
pusmuyorlar	dürmüyorlar	lemma
buruşukluğunuza	buruşukluklarınıza	Number
tümörü	tümör	Case
kodlarda	kodları	Case
küçüklükler	küçüklüklerden	Case
strüktürümün	çığırtkanlığımın	lemma
soyuyordunuz	örtüyordunuz	lemma
striptizlerinde	striptizlerimde	Possession
terapistlerinizden	terapistlerinden	Possession
koruyucular	ısılar	lemma
aktifim	aktif	Person
hesapların	hesaplar	Case
künefelere	beldelere	lemma
iguanaların	iguanalarda	Case
gaga	gaganın	Case
indirimimizi	golümüzü	lemma
itlerden	itten	Number
topçuydular	topçular	Tense
vezirlerinin	vezirlerinden	Case
yanlışlıklara	yanlışlıklar	Case
enflasyonu	enflasyonları	Number
küremiyordu	küremiyordunuz	Person
ayılmayacağım	ayılmayacak	Person
papalarmışsın	tütsülermişsin	lemma
rehinesin	rehinelerdir	Number
yönetiminize	yönetiminizin	Case
güvenleri	güvenlerini	Case
makinalarsınız	yaratılarsınız	lemma
paylarımın	paylarını	Case
alıyorduk	gerekiyorduk	lemma
kelimelerdin	kelimeleriz	Tense
piramitten	piramit	Case
mistiğinin	gazetenin	lemma
eksikliğinde	eksikliğinden	Case
alfabenin	alfabeyi	Case
ritüellere	ritüelleri	Case
jeladalara	jeladaları	Case
fahişeliklerden	fahişelikten	Number
yalvarmam	yontulmam	lemma
cinsiyetler	cinsiyetlere	Case
pompadan	pompalardan	Number
psikoterapimin	psikoterapimi	Case
geyşalarınıza	geyşalarımıza	Possession
sürücülerinizden	sürücülerimden	Possession
uğratıyordun	büküyordun	lemma
zeytinyağına	zeytinyağını	Case
koşucu	dize	lemma
