rapetissé	Participle
délimiteraient	Verb
réconcilia	Verb
crevai	Verb
bloqueraient	Verb
dui	Verb
fredonné	Participle
quasses	Verb
quitterai	Verb
babilleroies	Verb
finançait	Verb
boirait	Verb
décontaminer	Verb
joindraient	Verb
instituaient	Verb
classifia	Verb
defubler	Verb
ficelé	Participle
starter	Verb
douteraient	Verb
cara	Verb
rosi	Participle
putréfias	Verb
travaillaient	Verb
contraster	Verb
attendrir	Verb
démarquait	Verb
déconcertant	Participle
enjamberaient	Verb
blâmaient	Verb
hasarda	Verb
déboité	Participle
nécessitant	Participle
biloqueriez	Verb
indiquerai	Verb
arrangera	Verb
glacer	Verb
tondras	Verb
followerait	Verb
verserai	Verb
mena	Verb
reconnaîtraient	Verb
américanisassiez	Verb
répondrait	Verb
noveras	Verb
débat	Verb
récupérant	Participle
sentimentaliser	Verb
distribuera	Verb
republia	Verb
objecta	Verb
récompensa	Verb
appliqueront	Verb
persévéré	Participle
agiront	Verb
accuserait	Verb
débarrasserait	Verb
amplifier	Verb
fixerait	Verb
livrerai	Verb
attriquerai	Verb
occupât	Verb
épuisera	Verb
odora	Verb
coltiner	Verb
confessa	Verb
périssant	Participle
lyé	Participle
inquiété	Participle
goutter	Verb
équivalussiez	Verb
meut	Verb
rebâti	Participle
réagir	Verb
édicter	Verb
éloignerait	Verb
abusera	Verb
populariser	Verb
entremêlé	Participle
fusionnèrent	Verb
jaillir	Verb
becquetant	Participle
dusse	Verb
divertissant	Participle
cadrer	Verb
advenir	Verb
blâmé	Participle
styliser	Verb
coloraient	Verb
souquât	Verb
émanciperaient	Verb
authentifiasse	Verb
créditant	Participle
continueras	Verb
noircir	Verb
désarticulerai	Verb
sévissait	Verb
décoincer	Verb
dessaisi	Participle
fola	Verb
commissionner	Verb
batisse	Verb
surpassèrent	Verb
cachierent	Verb
cantes	Verb
tapoté	Participle
escoltassent	Verb
évoluaient	Verb
vielleraient	Verb
caréné	Participle
siégèrent	Verb
rasseürassent	Verb
réinitialiser	Verb
accumulerait	Verb
rechuter	Verb
transformerait	Verb
éprouvant	Participle
plastifiâtes	Verb
fournissaient	Verb
rectifiait	Verb
différentiant	Participle
rançonna	Verb
revivait	Verb
proroger	Verb
abordé	Participle
coulissait	Verb
agençât	Verb
accuser	Verb
roya	Verb
effaça	Verb
préciserai	Verb
ist	Verb
baya	Verb
absorbant	Participle
dérapa	Verb
crypteras	Verb
dissuadèrent	Verb
envenimant	Participle
resserrait	Verb
auditionnait	Verb
champignonnerai	Verb
partageraient	Verb
membrai	Verb
leira	Verb
descendant	Participle
contrarié	Participle
assiégèrent	Verb
commémorerait	Verb
idéaliser	Verb
fiançâtes	Verb
dotera	Verb
énuméré	Participle
appréciait	Verb
carapatant	Participle
rétablirai	Verb
anesthésié	Participle
paissaient	Verb
achaptassions	Verb
transcoder	Verb
méfièrent	Verb
brodât	Verb
percolant	Participle
agrandira	Verb
rédiger	Verb
survolera	Verb
embranchait	Verb
entrainait	Verb
dominerait	Verb
concourant	Participle
fidéliser	Verb
peiné	Participle
révélèrent	Verb
refit	Verb
résidât	Verb
réessayer	Verb
déstructuré	Participle
crièrent	Verb
conjuguer	Verb
agitant	Participle
évaluer	Verb
subirent	Verb
guérissant	Participle
explosant	Participle
vieillirons	Verb
articulèrent	Verb
sculpter	Verb
élevèrent	Verb
confisquait	Verb
interpola	Verb
calmeront	Verb
ruminasse	Verb
inventé	Participle
ensimer	Verb
endossait	Verb
obligea	Verb
coteraient	Verb
truffa	Verb
remariant	Participle
voudraient	Verb
moucheté	Participle
réprouva	Verb
plombant	Participle
excentra	Verb
symboliserait	Verb
enchaîner	Verb
périr	Verb
concourront	Verb
bagué	Participle
densifiant	Participle
échancré	Participle
conseillerait	Verb
conclura	Verb
opacifierait	Verb
obtînt	Verb
nagera	Verb
assimilé	Participle
restait	Verb
accumulé	Participle
enivraient	Verb
nover	Verb
notas	Verb
mellé	Participle
caricaturé	Participle
demeura	Verb
avalisait	Verb
excellant	Participle
stagné	Participle
slicé	Participle
surplomber	Verb
renverrait	Verb
vendes	Verb
conformerait	Verb
bossait	Verb
déblatérer	Verb
étriqué	Participle
enfreignait	Verb
renversaient	Verb
renié	Participle
colpa	Verb
rusé	Participle
gommé	Participle
engrangé	Participle
bruité	Participle
démobiliser	Verb
contrecarrant	Participle
ligoter	Verb
gaimentera	Verb
attesterait	Verb
orthographier	Verb
rependu	Participle
tardera	Verb
freinerait	Verb
reconstruira	Verb
resservi	Participle
tramaient	Verb
élaboré	Participle
flambèrent	Verb
taxaient	Verb
soupçonnaient	Verb
percerait	Verb
exorciseraient	Verb
détaxerai	Verb
désola	Verb
enfouissait	Verb
sanctionnât	Verb
sombrerait	Verb
balla	Verb
concerté	Participle
allégorisant	Participle
bougea	Verb
resservir	Verb
jalousant	Participle
waz	Verb
germeront	Verb
sifflait	Verb
créneleront	Verb
mythifié	Participle
alanguîmes	Verb
réimmergerez	Verb
kiferont	Verb
mitrailla	Verb
aidé	Participle
lanceraient	Verb
épargnait	Verb
chuchotaient	Verb
rédigea	Verb
hanter	Verb
inspecta	Verb
trafiquer	Verb
stimulèrent	Verb
jetaient	Verb
animant	Participle
pontifiant	Participle
regretter	Verb
émettra	Verb
disparaitra	Verb
envahiront	Verb
sombra	Verb
gacheras	Verb
formaliserai	Verb
ravaler	Verb
enterré	Participle
choma	Verb
scorâtes	Verb
rempliraient	Verb
invitant	Participle
sous-dosant	Participle
érigèrent	Verb
afroieroies	Verb
réceptionné	Participle
obéissant	Participle
livrasses	Verb
reprend	Verb
céda	Verb
déraillé	Participle
votaient	Verb
manqué	Participle
appauvrissait	Verb
épuisé	Participle
pleurerai	Verb
approchera	Verb
argumenté	Participle
bifurquait	Verb
échancraient	Verb
bêlant	Participle
trépigner	Verb
écologisait	Verb
attaqué	Participle
évaluerez	Verb
fustigerions	Verb
diligenté	Participle
redescendaient	Verb
déduire	Verb
réinjectant	Participle
nova	Verb
ironisant	Participle
évita	Verb
intensifier	Verb
pullulant	Participle
méconnaitre	Verb
comanderas	Verb
stresser	Verb
décéléré	Participle
fayoterons	Verb
radiotélévisera	Verb
progresseront	Verb
parier	Verb
frappèrent	Verb
manifestèrent	Verb
répondirent	Verb
restreindraient	Verb
assigné	Participle
mouliner	Verb
desjeuniiens	Verb
jettera	Verb
revérifier	Verb
anserroit	Verb
maigrirons	Verb
traversera	Verb
enceinter	Verb
inverserait	Verb
ceinturaient	Verb
retarda	Verb
apoiera	Verb
horripilassent	Verb
témoigneraient	Verb
gênerai	Verb
cloné	Participle
detranchieroit	Verb
stellifiera	Verb
emporté	Participle
soulignerait	Verb
maltraitaient	Verb
escomptant	Participle
pasmeroies	Verb
surévaluèrent	Verb
charma	Verb
incomber	Verb
convoquer	Verb
esragierent	Verb
héla	Verb
pivotait	Verb
buer	Verb
effeuillant	Participle
terminerait	Verb
déduisit	Verb
statuèrent	Verb
adusta	Verb
saviez	Verb
rattrapèrent	Verb
blinder	Verb
glucosé	Participle
maltraitai	Verb
attaquerai	Verb
prédire	Verb
émerveillé	Participle
rallongé	Participle
occurrerai	Verb
embraser	Verb
désintoxiquer	Verb
remettrez	Verb
givet	Verb
séjournait	Verb
tinter	Verb
concordant	Participle
boulotter	Verb
hez	Verb
apiquait	Verb
émanassions	Verb
résonnaient	Verb
débarquant	Participle
modifiait	Verb
refiler	Verb
seoir	Verb
concentra	Verb
convertissant	Participle
imputera	Verb
repassèrent	Verb
accessoiriserions	Verb
convolé	Participle
esquisser	Verb
chagriner	Verb
communier	Verb
cameras	Verb
barda	Verb
aficheroie	Verb
arborèrent	Verb
amnistia	Verb
abstrayant	Participle
abandonnerai	Verb
pulverizer	Verb
réduira	Verb
apparentant	Participle
déshonorer	Verb
axait	Verb
dûmes	Verb
malfisse	Verb
pâtissât	Verb
errer	Verb
détérioreront	Verb
réessayé	Participle
taguant	Participle
chantera	Verb
décuplant	Participle
précipitaient	Verb
anticipé	Participle
triomphé	Participle
ruinas	Verb
roder	Verb
concourra	Verb
légendé	Participle
pèlerinèrent	Verb
apprécierai	Verb
aicher	Verb
permettront	Verb
sanctuarisas	Verb
vinifiant	Participle
gonflerait	Verb
reconcentrai	Verb
qualifiait	Verb
fist	Verb
enchargeras	Verb
encadrait	Verb
foudroyassiez	Verb
barbouiller	Verb
surexploité	Participle
ratas	Verb
rattachait	Verb
affecterait	Verb
satisfastes	Verb
siégeant	Participle
emmener	Verb
grandissaient	Verb
stockaient	Verb
dérogea	Verb
trouvé	Participle
attribuât	Verb
éduqué	Participle
élevaient	Verb
suggérer	Verb
justifiant	Participle
veḍreies	Verb
gêna	Verb
ridé	Participle
enserraient	Verb
enchainé	Participle
éclairé	Participle
débarqué	Participle
essaierai	Verb
dissiperas	Verb
différencié	Participle
pélerineraient	Verb
énouai	Verb
proliférer	Verb
emberlificotèrent	Verb
étoffera	Verb
émet	Verb
amassâmes	Verb
titraient	Verb
celant	Participle
édifieront	Verb
centrera	Verb
faudras	Verb
cannas	Verb
récompensant	Participle
séquencerait	Verb
louper	Verb
quêter	Verb
consolider	Verb
réformèrent	Verb
cotai	Verb
concevaient	Verb
embûchasses	Verb
priveront	Verb
immiscera	Verb
engluer	Verb
effaroucher	Verb
disséquât	Verb
rectifiai	Verb
essayerait	Verb
préparera	Verb
concédaient	Verb
félicitera	Verb
fourras	Verb
trépassé	Participle
bruire	Verb
empoizonnassiez	Verb
assaillir	Verb
augurer	Verb
enterrera	Verb
métra	Verb
polissant	Participle
propageant	Participle
frustrai	Verb
voguant	Participle
bifferons	Verb
corrigerons	Verb
redorer	Verb
morfondissent	Verb
accolé	Participle
adapteront	Verb
surviendront	Verb
incubant	Participle
cristallisera	Verb
chasserait	Verb
eût	Verb
usant	Participle
procurait	Verb
enrhumé	Participle
déchaînera	Verb
matérialisaient	Verb
sarclassent	Verb
frémi	Participle
avisera	Verb
surestimait	Verb
désaltéré	Participle
siglasses	Verb
démarquèrent	Verb
démordra	Verb
déchaîneraient	Verb
mesurèrent	Verb
achèvera	Verb
remplira	Verb
suivi	Participle
détruirai	Verb
reparaître	Verb
séquestré	Participle
soit	Verb
couvrirait	Verb
opprimant	Participle
réactivera	Verb
cunter	Verb
renoioient	Verb
doué	Participle
périmer	Verb
pincer	Verb
consentiraient	Verb
blindé	Participle
frangé	Participle
remédia	Verb
lama	Verb
cumandissoiz	Verb
criminalisait	Verb
excusa	Verb
séché	Participle
retentira	Verb
embrasserai	Verb
salopé	Participle
quadrillaient	Verb
insensibiliser	Verb
absenté	Participle
émargeait	Verb
pressentaient	Verb
carrer	Verb
rima	Verb
décentralisé	Participle
apprendre	Verb
immisçant	Participle
retailleroit	Verb
lambinerons	Verb
ensuivrait	Verb
réabsorber	Verb
succéda	Verb
assombri	Participle
détonnant	Participle
radoter	Verb
enfiellassiez	Verb
bénissait	Verb
vulcaniserions	Verb
flâner	Verb
deifiions	Verb
accompagnaient	Verb
réutilisant	Participle
croira	Verb
connaîtras	Verb
escroquer	Verb
achata	Verb
vacillant	Participle
huai	Verb
soper	Verb
osera	Verb
retaillé	Participle
apporteraient	Verb
complexer	Verb
réindexasses	Verb
rédigeaient	Verb
atténua	Verb
choquer	Verb
manœuvraient	Verb
gigoter	Verb
habiterait	Verb
poursuivit	Verb
tâchera	Verb
entreposerions	Verb
amuï	Participle
refonder	Verb
suderas	Verb
associaient	Verb
glaçant	Participle
enfreindrait	Verb
confiait	Verb
essayant	Participle
aggravant	Participle
aimé	Participle
couterait	Verb
approximé	Participle
confrontas	Verb
présenterait	Verb
fermentant	Participle
estampas	Verb
décrirai	Verb
insurgeant	Participle
prémunir	Verb
jeûner	Verb
basanaient	Verb
payé	Participle
ruisselant	Participle
refoulé	Participle
embourgeoisé	Participle
recélait	Verb
interprétèrent	Verb
quitter	Verb
enfoncerons	Verb
dénomma	Verb
nanti	Participle
aoureras	Verb
ixassent	Verb
préconisé	Participle
voulurent	Verb
alarmant	Participle
mariné	Participle
influenceraient	Verb
endotrinoie	Verb
embrigadâtes	Verb
achèveront	Verb
cicatrisé	Participle
distinguera	Verb
confronter	Verb
rajouterai	Verb
découlera	Verb
questionné	Participle
appartinrent	Verb
maintenait	Verb
reluisimes	Verb
confondra	Verb
détériorera	Verb
planas	Verb
chercher	Verb
rebattit	Verb
récréé	Participle
stabilisèrent	Verb
recyclait	Verb
consister	Verb
plorent	Verb
arpentait	Verb
freinsisses	Verb
calait	Verb
profana	Verb
officialiser	Verb
chroniquant	Participle
enorgueillir	Verb
déréglementâtes	Verb
supposait	Verb
conscientiser	Verb
baraqué	Participle
bossa	Verb
colmatant	Participle
oubliaient	Verb
ardre	Verb
bastions	Verb
déformé	Participle
attisait	Verb
perdrait	Verb
saluant	Participle
deifierons	Verb
prolongeait	Verb
dévider	Verb
concurrencé	Participle
libérait	Verb
videra	Verb
sué	Participle
cotait	Verb
spoliâtes	Verb
éternisa	Verb
décommander	Verb
accidenterez	Verb
faschissons	Verb
chiner	Verb
désapprouvèrent	Verb
amochai	Verb
marquera	Verb
renforceraient	Verb
purjasse	Verb
paumé	Participle
microfilmer	Verb
ressentit	Verb
assignèrent	Verb
accréditant	Participle
plané	Participle
dissoudrait	Verb
oublieras	Verb
écœuré	Participle
aguist	Verb
engourdi	Participle
trafiquant	Participle
grisonné	Participle
imputerions	Verb
repêchèrent	Verb
naja	Verb
visaient	Verb
alimentera	Verb
remuaient	Verb
écrirai	Verb
retourneras	Verb
ovula	Verb
refond	Verb
préluder	Verb
démaquillant	Participle
suivît	Verb
dicterait	Verb
obliquâmes	Verb
fiança	Verb
codirigera	Verb
caoutchoutât	Verb
codera	Verb
handicaperions	Verb
décortiqué	Participle
acheminèrent	Verb
perfectionner	Verb
parlai	Verb
vidanger	Verb
contesterai	Verb
végétant	Participle
prisiiez	Verb
attachait	Verb
lever	Verb
avertissaient	Verb
perdrez	Verb
perdront	Verb
exporta	Verb
péché	Participle
influerait	Verb
satisfoie	Verb
trotté	Participle
estérifiant	Participle
assisses	Verb
réserverait	Verb
adjugé	Participle
protégea	Verb
psychanalyser	Verb
fréquenté	Participle
cumulerai	Verb
déchoir	Verb
raconterait	Verb
servirait	Verb
spécifié	Participle
abissasse	Verb
expliquèrent	Verb
séduisait	Verb
interpeller	Verb
danseront	Verb
réajusterai	Verb
arst	Verb
disconvinrent	Verb
jachéraient	Verb
consentirent	Verb
démunîmes	Verb
cisailler	Verb
exaucera	Verb
trampas	Verb
produisit	Verb
écœurant	Participle
douer	Verb
supprimerez	Verb
captivait	Verb
confinâmes	Verb
titularisant	Participle
fraudé	Participle
signifié	Participle
canteras	Verb
matérialisa	Verb
entreprendrait	Verb
dépêtrer	Verb
remarquerait	Verb
dissimulera	Verb
obérer	Verb
sous-dosai	Verb
communiait	Verb
valoir	Verb
vocheroit	Verb
pourchassaient	Verb
gorgé	Participle
fleurir	Verb
renger	Verb
rechignait	Verb
ambitionnaient	Verb
remarqua	Verb
fourmillait	Verb
désamianté	Participle
rédigeassiez	Verb
échangerait	Verb
ancra	Verb
confiera	Verb
députèrent	Verb
coursera	Verb
réprouvait	Verb
éclusâmes	Verb
élancera	Verb
ramena	Verb
faignes	Verb
pua	Verb
parviendront	Verb
paraffinerai	Verb
reformera	Verb
joindre	Verb
débusquer	Verb
progressa	Verb
diamanter	Verb
aimer	Verb
dégoûta	Verb
flairs	Verb
agrandirent	Verb
attaqua	Verb
réabsorbé	Participle
penchaient	Verb
converger	Verb
grever	Verb
déséquilibré	Participle
atalanta	Verb
soldâtes	Verb
commentera	Verb
lotir	Verb
arangiiens	Verb
aresteroiz	Verb
traumatiser	Verb
adopter	Verb
carbonylé	Participle
reconditionné	Participle
ôterait	Verb
inclura	Verb
branché	Participle
déconcentré	Participle
cirer	Verb
jua	Verb
reflua	Verb
déréglé	Participle
publiait	Verb
blablater	Verb
vaster	Verb
terrorisant	Participle
gouverner	Verb
pèsera	Verb
materna	Verb
singer	Verb
différenciant	Participle
séduirait	Verb
sevrassiez	Verb
dureraient	Verb
émasculer	Verb
garant	Participle
hisser	Verb
cloisonner	Verb
remorqué	Participle
acompliroie	Verb
recueillant	Participle
idéaliserez	Verb
sonas	Verb
entraînerait	Verb
bourdonné	Participle
arriveras	Verb
siglé	Participle
décompressé	Participle
éboulé	Participle
fournir	Verb
accommoderait	Verb
planifiait	Verb
éclaireront	Verb
adaptera	Verb
acompliroiz	Verb
enverrez	Verb
nitrifiassions	Verb
contredirent	Verb
incommodait	Verb
calcula	Verb
crooner	Verb
torné	Participle
invalider	Verb
harmonisé	Participle
gagnerai	Verb
toaster	Verb
devinassions	Verb
défroquerons	Verb
conditionnerait	Verb
tormentas	Verb
granulé	Participle
contraignit	Verb
chouchouter	Verb
enfermas	Verb
savoras	Verb
rouiller	Verb
lissant	Participle
rassurer	Verb
procèderai	Verb
naviguer	Verb
boiser	Verb
traité	Participle
alléguaient	Verb
caractériseront	Verb
peigné	Participle
collaborera	Verb
rallié	Participle
ôté	Participle
déménageait	Verb
clapas	Verb
clouait	Verb
privèrent	Verb
basa	Verb
rapatrié	Participle
excluait	Verb
réparer	Verb
concernait	Verb
épaula	Verb
soustraire	Verb
détectant	Participle
traîné	Participle
duras	Verb
analyseraient	Verb
réfrigéré	Participle
péchant	Participle
truqué	Participle
comparé	Participle
prenz	Verb
ponctuait	Verb
grimant	Participle
sensibiliseriez	Verb
denuncissons	Verb
notifiera	Verb
persistèrent	Verb
complexât	Verb
encirassiez	Verb
culpabiliserai	Verb
dérangerai	Verb
ingérer	Verb
falsifiait	Verb
vend	Verb
servît	Verb
choisirons	Verb
suçant	Participle
désirèrent	Verb
mésestimer	Verb
accorderait	Verb
scandant	Participle
estimait	Verb
hésitait	Verb
métisseront	Verb
peigner	Verb
rapprochant	Participle
distanceras	Verb
rappelai	Verb
muèrent	Verb
redéploya	Verb
recouvrira	Verb
signifierai	Verb
maximiserait	Verb
signifièrent	Verb
diminua	Verb
parcourait	Verb
inversa	Verb
trouveraient	Verb
alit	Verb
déchirant	Participle
astreindre	Verb
cabrant	Participle
haletant	Participle
alïeroies	Verb
faciliter	Verb
raidissant	Participle
coupler	Verb
commercialiser	Verb
remettant	Participle
favoriseraient	Verb
arousa	Verb
appuierait	Verb
accepteras	Verb
affriandassions	Verb
éjectera	Verb
réécoutassent	Verb
lanciner	Verb
déposeraient	Verb
refassent	Verb
énonçant	Participle
criblé	Participle
décrivirent	Verb
convoquerait	Verb
relèvera	Verb
désorientant	Participle
désherberez	Verb
dévaloriserons	Verb
turna	Verb
déconseillait	Verb
surpassa	Verb
subiuguieriez	Verb
essuyer	Verb
mangier	Verb
tordait	Verb
disparaitront	Verb
induisait	Verb
décentraliser	Verb
délaissaient	Verb
proteger	Verb
convoyaient	Verb
entremêlèrent	Verb
contrariera	Verb
parrainé	Participle
bégayer	Verb
scintilla	Verb
sponsorisa	Verb
admiraient	Verb
restassent	Verb
affermer	Verb
ligna	Verb
secréter	Verb
filas	Verb
kiet	Verb
turnera	Verb
soulèvera	Verb
formulèrent	Verb
mariai	Verb
annonçaient	Verb
évertuer	Verb
réalésé	Participle
amenuîtes	Verb
désarrimasse	Verb
rechigna	Verb
moustrant	Participle
useront	Verb
basé	Participle
permit	Verb
milita	Verb
imprégnèrent	Verb
circuité	Participle
établissant	Participle
gainé	Participle
cernaient	Verb
resituant	Participle
hérisseras	Verb
orienterait	Verb
résisté	Participle
ôter	Verb
retouchant	Participle
déboîter	Verb
saccagèrent	Verb
renommerai	Verb
esloignoies	Verb
revisitant	Participle
statuasses	Verb
empêchant	Participle
joindrait	Verb
pilota	Verb
défausser	Verb
allumeront	Verb
écurerait	Verb
pacifia	Verb
parasitant	Participle
gouter	Verb
randomisé	Participle
engenroient	Verb
provoqué	Participle
étalé	Participle
effrayaient	Verb
aprovendiiens	Verb
présageâmes	Verb
rodant	Participle
servi	Participle
silhouettât	Verb
pratiquaient	Verb
bouté	Participle
inciteront	Verb
refoulant	Participle
orientait	Verb
remariera	Verb
chiant	Participle
stopperait	Verb
deçut	Verb
temporiser	Verb
apporterez	Verb
armèrent	Verb
objectèrent	Verb
empresserai	Verb
clivant	Participle
exprimerait	Verb
obtinrent	Verb
dénoué	Participle
desmembriiens	Verb
détrônèrent	Verb
razzier	Verb
broutait	Verb
crucifier	Verb
méprendre	Verb
returt	Verb
siéger	Verb
acheté	Participle
cliver	Verb
dogmatisassent	Verb
ternir	Verb
offusquant	Participle
bordant	Participle
respectaient	Verb
jugeait	Verb
celtisant	Participle
trianguler	Verb
manutentionnerions	Verb
décorèrent	Verb
continuerai	Verb
réimplanter	Verb
tout	Verb
environnaient	Verb
dénonça	Verb
presupposeroient	Verb
exonèrera	Verb
aparola	Verb
violera	Verb
danser	Verb
tria	Verb
fleuré	Participle
déraisonnât	Verb
coexisteraient	Verb
réforma	Verb
accroit	Verb
barrèrent	Verb
féminisé	Participle
succèderont	Verb
connaitrai	Verb
émancipera	Verb
persécutait	Verb
limogea	Verb
expulseront	Verb
évoluer	Verb
décupler	Verb
aboyant	Participle
constitua	Verb
dompta	Verb
reconsidéra	Verb
briser	Verb
baptoiasses	Verb
déglutirai	Verb
retracer	Verb
réadapter	Verb
rejettera	Verb
reflétant	Participle
obscurci	Participle
recoud	Verb
joignaient	Verb
secorus	Verb
staffer	Verb
saboter	Verb
désinfectasse	Verb
desjoindra	Verb
dealèrent	Verb
dévalait	Verb
canotant	Participle
renchérit	Verb
insinuait	Verb
arimast	Verb
acheminant	Participle
compromettait	Verb
desservait	Verb
cacheté	Participle
méfiant	Participle
suscitant	Participle
apposait	Verb
supprimasse	Verb
décocher	Verb
bloquera	Verb
munté	Participle
débattait	Verb
lettraient	Verb
fleurant	Participle
cognasse	Verb
éliraient	Verb
dissimulé	Participle
procedes	Verb
ambras	Verb
fêtera	Verb
déconnecter	Verb
déjugeassiez	Verb
travailleraient	Verb
rasèrent	Verb
trespasses	Verb
protégeaient	Verb
m’extasiasse	Verb
discernait	Verb
biglerions	Verb
examina	Verb
galvanisant	Participle
dissent	Verb
terreautait	Verb
croisèrent	Verb
revivifier	Verb
piétinant	Participle
procrastiner	Verb
patrouillaient	Verb
transmuté	Participle
contingenté	Participle
disloquer	Verb
dénoterait	Verb
tempérait	Verb
bardera	Verb
chassèrent	Verb
interpretant	Participle
accablerons	Verb
compiler	Verb
mûrir	Verb
descuvrist	Verb
développeront	Verb
introduirait	Verb
excéder	Verb
démettant	Participle
fécondant	Participle
optimisant	Participle
souffrait	Verb
sentit	Verb
souillé	Participle
prépositionnâtes	Verb
requinqué	Participle
codifia	Verb
puisait	Verb
réfugiant	Participle
réapparaitront	Verb
adossé	Participle
désavouèrent	Verb
latinisant	Participle
abandonneraient	Verb
redressait	Verb
lèveront	Verb
réinterpréter	Verb
nuit	Verb
ganchiriiez	Verb
gênait	Verb
ébranler	Verb
stimulai	Verb
dévoiler	Verb
encercler	Verb
copierai	Verb
amochassiez	Verb
coudasses	Verb
incarneront	Verb
délayant	Participle
opposèrent	Verb
commettant	Participle
accrédita	Verb
relayer	Verb
inculper	Verb
répercutera	Verb
accolant	Participle
faillit	Verb
encensera	Verb
gagnèrent	Verb
jalonnant	Participle
platiné	Participle
carra	Verb
récupèrera	Verb
affaiblirent	Verb
contreviendraient	Verb
codiriger	Verb
érigé	Participle
habitué	Participle
heurter	Verb
attaquer	Verb
descoloré	Participle
abrita	Verb
terrasser	Verb
électrifia	Verb
beurrerai	Verb
paralysa	Verb
rapetassât	Verb
énumèrerez	Verb
flingué	Participle
drainant	Participle
transformèrent	Verb
rationalisa	Verb
menai	Verb
doctriner	Verb
procèdera	Verb
répandra	Verb
hivernaient	Verb
interdisaient	Verb
retraitant	Participle
agonisé	Participle
incluraient	Verb
fourvoieront	Verb
damasquina	Verb
saccada	Verb
mité	Participle
consentaient	Verb
référèrent	Verb
flasheront	Verb
amarsi	Participle
trituré	Participle
pâliront	Verb
clavardai	Verb
guerroyant	Participle
allouai	Verb
sexera	Verb
cailla	Verb
encerclèrent	Verb
gager	Verb
traquaient	Verb
mehaingneroies	Verb
estincelleroit	Verb
dépêcha	Verb
manda	Verb
carencé	Participle
perpétré	Participle
raccorderait	Verb
donnas	Verb
flamboyant	Participle
rouvrira	Verb
réceptionnerai	Verb
battront	Verb
arretai	Verb
baptizant	Participle
caillé	Participle
divinisé	Participle
révoqua	Verb
fondront	Verb
reléguèrent	Verb
anéanti	Participle
dégluâtes	Verb
casserai	Verb
illusionnerons	Verb
puiserait	Verb
conspirer	Verb
casser	Verb
ensuivant	Participle
ressentissiez	Verb
vira	Verb
reconceptualiser	Verb
octroyaient	Verb
representer	Verb
exorcisé	Participle
mixa	Verb
suturé	Participle
stationné	Participle
lustré	Participle
réconfortant	Participle
doublant	Participle
communiqué	Participle
itérant	Participle
retrouveront	Verb
ébauché	Participle
répugnaient	Verb
vendu	Participle
advenait	Verb
décongestionnant	Participle
définir	Verb
obligeant	Participle
aimera	Verb
préfèrera	Verb
prévint	Verb
écourté	Participle
blêmirait	Verb
déclenchait	Verb
quitteraient	Verb
gardas	Verb
délasser	Verb
façonerent	Verb
retirerai	Verb
lampas	Verb
sortiras	Verb
vagi	Participle
raboter	Verb
tronçonné	Participle
niellé	Participle
recounteroiz	Verb
manquerait	Verb
équivalaient	Verb
enlaidi	Participle
correspondront	Verb
réparerait	Verb
visant	Participle
compara	Verb
leurrer	Verb
desclos	Verb
agonisant	Participle
tombât	Verb
immigra	Verb
apothéoseriez	Verb
découla	Verb
prélevassiez	Verb
arrondir	Verb
militarisé	Participle
approcha	Verb
promettait	Verb
transigea	Verb
distribuèrent	Verb
figurait	Verb
fusses	Verb
embranchasse	Verb
menacé	Participle
congédier	Verb
germa	Verb
préfigurera	Verb
dédaignait	Verb
cueillant	Participle
susciter	Verb
contrôlant	Participle
sentaient	Verb
aprismera	Verb
hæsitâmes	Verb
radiostérilisas	Verb
brassaient	Verb
reiectasmes	Verb
rediffusant	Participle
consacrerai	Verb
distinguerons	Verb
conviendra	Verb
mentionnant	Participle
cartonné	Participle
professera	Verb
honoreront	Verb
demandé	Participle
égorgeassent	Verb
éterniser	Verb
frustré	Participle
symbolisait	Verb
gisait	Verb
bleuirait	Verb
agressant	Participle
oubliai	Verb
abrogeait	Verb
député	Participle
ron	Verb
brader	Verb
abrogeant	Participle
débobineraient	Verb
humera	Verb
écraseront	Verb
rouas	Verb
gripperaient	Verb
inspecter	Verb
amputait	Verb
manquâtes	Verb
enbuscheroies	Verb
déchargeait	Verb
illustreront	Verb
trez	Verb
aperçoives	Verb
affilier	Verb
corrodé	Participle
noncissoiz	Verb
sentiront	Verb
répercutât	Verb
procureront	Verb
resister	Verb
rafistolé	Participle
déglacer	Verb
pressurisai	Verb
buter	Verb
rattrapât	Verb
embarquait	Verb
disparaitrait	Verb
modelèrent	Verb
affairant	Participle
empresser	Verb
formerait	Verb
enquit	Verb
proscrire	Verb
nettoya	Verb
apercevra	Verb
criminalisant	Participle
étranglant	Participle
destitué	Participle
concentrasse	Verb
orneront	Verb
annonceront	Verb
expliquaient	Verb
geter	Verb
offrit	Verb
revendit	Verb
décarboxylé	Participle
fila	Verb
ordonnancé	Participle
professant	Participle
dégradé	Participle
alïes	Verb
resserrer	Verb
resolvai	Verb
débarassâmes	Verb
mordaient	Verb
initierait	Verb
enquêta	Verb
raréfié	Participle
arpenté	Participle
illusionner	Verb
régulant	Participle
charmaient	Verb
ravalerions	Verb
dépendu	Participle
entremettre	Verb
inféré	Participle
mandant	Participle
délirant	Participle
flambé	Participle
dépensa	Verb
acoucheroit	Verb
duta	Verb
éborgnant	Participle
ligaturé	Participle
minoré	Participle
concourait	Verb
blaserions	Verb
rutilai	Verb
garderaient	Verb
sténographia	Verb
plébiscitant	Participle
dépossédé	Participle
combattrons	Verb
évoluant	Participle
débordait	Verb
invertir	Verb
affectionnait	Verb
marieraient	Verb
ramonassiez	Verb
découpé	Participle
scanderait	Verb
accompagnait	Verb
aillant	Participle
saigné	Participle
aquarellassent	Verb
contacterons	Verb
prestasmes	Verb
schématiser	Verb
cautionné	Participle
déconnecté	Participle
desirt	Verb
chargé	Participle
naviguera	Verb
obsédant	Participle
googlé	Participle
depeçasses	Verb
réglementaient	Verb
cumanciiez	Verb
accueilleront	Verb
vouait	Verb
décrirons	Verb
façonnait	Verb
carrelai	Verb
retireront	Verb
excaver	Verb
homogénéisé	Participle
angoisser	Verb
débuté	Participle
interagiront	Verb
bâtiront	Verb
inspira	Verb
ferraillât	Verb
dissertant	Participle
feindre	Verb
imiter	Verb
croûtassiez	Verb
gonfler	Verb
torent	Verb
castilla	Verb
émarger	Verb
ballotta	Verb
décimant	Participle
végèteront	Verb
désirerai	Verb
veintriiez	Verb
boycottant	Participle
estraisisse	Verb
déclarer	Verb
abreuver	Verb
empescheroit	Verb
alcoolisé	Participle
héler	Verb
réélut	Verb
dépaysé	Participle
monitorer	Verb
gagnerons	Verb
abriter	Verb
ramassa	Verb
modulâmes	Verb
sexâmes	Verb
renâcleront	Verb
alpaguer	Verb
taquiné	Participle
dotait	Verb
affronteraient	Verb
évolué	Participle
médire	Verb
dégourdi	Participle
carrera	Verb
raturai	Verb
excoriâmes	Verb
diplôma	Verb
semblât	Verb
témoignera	Verb
chuter	Verb
forgèrent	Verb
mitera	Verb
affina	Verb
enveloppaient	Verb
tranchames	Verb
garder	Verb
cohabité	Participle
subdivisé	Participle
offusqueras	Verb
bâclé	Participle
discusses	Verb
carâtes	Verb
échancrât	Verb
emprisonnera	Verb
interdirait	Verb
disparaitraient	Verb
vanquissons	Verb
illusionné	Participle
surgissait	Verb
succédèrent	Verb
dédicaçant	Participle
relèverait	Verb
coincé	Participle
plaira	Verb
rapporteront	Verb
provisionné	Participle
pendaient	Verb
hibernerons	Verb
boucheriez	Verb
commenter	Verb
reconnecter	Verb
interdira	Verb
annihilé	Participle
musse	Verb
perquisitionner	Verb
tintas	Verb
dresseront	Verb
garderez	Verb
fonderait	Verb
bougé	Participle
reconduisirent	Verb
prouveraient	Verb
desséché	Participle
hellénisant	Participle
pencheront	Verb
absentait	Verb
éteignant	Participle
éprouvé	Participle
descendra	Verb
obscurcir	Verb
réémet	Verb
rouant	Participle
défigurant	Participle
waster	Verb
coailleront	Verb
ahurira	Verb
humiliera	Verb
omirent	Verb
épaissi	Participle
affectionnaient	Verb
propulsé	Participle
dévissassiez	Verb
fouler	Verb
soufflaient	Verb
envahira	Verb
revivifierait	Verb
rengeasmes	Verb
communieront	Verb
répudierai	Verb
vulcaniser	Verb
redescendant	Participle
surgiront	Verb
doutant	Participle
superviserait	Verb
détenaient	Verb
analysant	Participle
abondait	Verb
apposer	Verb
espirant	Participle
tranché	Participle
accentueront	Verb
qualifiera	Verb
tâtant	Participle
numérotant	Participle
vocalisera	Verb
fistas	Verb
tinté	Participle
gouaché	Participle
boycottèrent	Verb
vérifiant	Participle
alaitames	Verb
chemineront	Verb
terroriseriez	Verb
horripilant	Participle
roelassent	Verb
retombant	Participle
récoltera	Verb
lamer	Verb
soupirant	Participle
agissait	Verb
condamnât	Verb
digéré	Participle
hocherait	Verb
challengerez	Verb
ressasser	Verb
ordonner	Verb
croz	Verb
offusquait	Verb
fabriquer	Verb
tramait	Verb
véhiculait	Verb
persuader	Verb
assassina	Verb
hosta	Verb
attribuant	Participle
placardassiez	Verb
chauvisses	Verb
excéda	Verb
consommant	Participle
tapoter	Verb
décorant	Participle
associeront	Verb
acquérir	Verb
relirai	Verb
serché	Participle
rogner	Verb
calculeront	Verb
pluchâtes	Verb
redevenaient	Verb
retouchait	Verb
ulcéra	Verb
chagrinait	Verb
affectionné	Participle
estranglassiez	Verb
zébras	Verb
lâché	Participle
pardonnerai	Verb
disputant	Participle
bétonné	Participle
violas	Verb
clairsemerions	Verb
deserves	Verb
guettant	Participle
roidirez	Verb
délibérant	Participle
dépayser	Verb
déploieront	Verb
pressentait	Verb
remblayé	Participle
réserva	Verb
respirait	Verb
récrire	Verb
ouata	Verb
vaincras	Verb
recouru	Participle
souriant	Participle
subvint	Verb
impatienter	Verb
immortaliseront	Verb
neiiiens	Verb
possedant	Participle
matter	Verb
embrassa	Verb
abolera	Verb
démilitarisé	Participle
pretas	Verb
lavé	Participle
grailler	Verb
resteront	Verb
joustant	Participle
approcher	Verb
exemptant	Participle
braveront	Verb
solutionnera	Verb
implorait	Verb
rougir	Verb
tireras	Verb
baratoit	Verb
rendrai	Verb
disclaimer	Verb
rainé	Participle
synchronisé	Participle
encensé	Participle
barguigneriiez	Verb
préfixerai	Verb
bouchonné	Participle
vérifieront	Verb
prolongeaient	Verb
distinguaient	Verb
désintégrant	Participle
radiorepèreras	Verb
recroiser	Verb
détraquer	Verb
attestèrent	Verb
avalasse	Verb
desirant	Participle
regrettant	Participle
ramifié	Participle
applaudirent	Verb
déflorer	Verb
féria	Verb
perdit	Verb
simplifierai	Verb
agrafé	Participle
dialoguant	Participle
guis	Verb
structurant	Participle
excepta	Verb
submerger	Verb
mambrant	Participle
élèveras	Verb
scalpâmes	Verb
mua	Verb
dérapait	Verb
cantonnait	Verb
agret	Verb
disperseront	Verb
pénétré	Participle
apostillerez	Verb
autopilotasse	Verb
ganglions	Verb
équipé	Participle
bâillonner	Verb
inclûmes	Verb
distancia	Verb
conqueṣis	Verb
dilapida	Verb
modéliserait	Verb
récusait	Verb
européaniseront	Verb
protesta	Verb
virevoltera	Verb
stoppera	Verb
vivoter	Verb
zéolitisas	Verb
dégradera	Verb
matérialiser	Verb
réécouté	Participle
ignifugé	Participle
recueillirent	Verb
supplémenté	Participle
refermaient	Verb
enflammera	Verb
abuser	Verb
jetèrent	Verb
ponctuèrent	Verb
déconseillèrent	Verb
redoublait	Verb
glander	Verb
catégorisait	Verb
balisaient	Verb
avantager	Verb
conjecturé	Participle
scora	Verb
mué	Participle
déchargera	Verb
formeraient	Verb
empêchait	Verb
commèreraient	Verb
constatera	Verb
posât	Verb
maitriserions	Verb
convaincra	Verb
accablé	Participle
moissonné	Participle
destitueras	Verb
revigorer	Verb
vénéra	Verb
suffisaient	Verb
rétorquer	Verb
transcrirait	Verb
scelleront	Verb
cherchera	Verb
reconnaitront	Verb
soulevé	Participle
clignotait	Verb
réunifiassiez	Verb
étrennassiez	Verb
terroriserai	Verb
affleurer	Verb
autodissout	Verb
arraché	Participle
dismutassions	Verb
soulagé	Participle
gravitaient	Verb
citas	Verb
obligeraient	Verb
parquassions	Verb
finaliser	Verb
appuyant	Participle
muloteriez	Verb
rêva	Verb
démembrant	Participle
robotiserions	Verb
razzias	Verb
contas	Verb
miaulant	Participle
réenterré	Participle
rêvasseront	Verb
décolla	Verb
biper	Verb
déprendrions	Verb
affronta	Verb
trucidera	Verb
rigolé	Participle
raffina	Verb
margé	Participle
baliseras	Verb
cautionner	Verb
exprimeront	Verb
enconnerez	Verb
procréant	Participle
grippé	Participle
bastonné	Participle
surclassa	Verb
assoit	Verb
representerons	Verb
contorsionnant	Participle
paner	Verb
animalisa	Verb
doublait	Verb
assemblé	Participle
masculiniser	Verb
refondre	Verb
homicideraient	Verb
illuminé	Participle
téléporter	Verb
publia	Verb
apprécièrent	Verb
expurgeasse	Verb
soutiendraient	Verb
planter	Verb
trépidant	Participle
empiété	Participle
lambineront	Verb
régiront	Verb
sensibilisé	Participle
clavarderez	Verb
reclameroies	Verb
appartiendra	Verb
enfoncerait	Verb
compromit	Verb
teignant	Participle
conseillast	Verb
éradiqua	Verb
dissuader	Verb
querellait	Verb
désabuseras	Verb
chourinas	Verb
désavantagerait	Verb
rigidifiassions	Verb
confesser	Verb
ordonnaient	Verb
carburé	Participle
prépara	Verb
héritait	Verb
acordissons	Verb
aguichant	Participle
répandre	Verb
saccager	Verb
épouvanté	Participle
ruis	Verb
mattai	Verb
déroutant	Participle
islamiser	Verb
effondreront	Verb
enculé	Participle
tigra	Verb
déconnectassent	Verb
fixeraient	Verb
cesseraient	Verb
appâtât	Verb
trouverait	Verb
réaffecterions	Verb
possèderont	Verb
fricotait	Verb
trinquant	Participle
réagissaient	Verb
fêtèrent	Verb
dépréciant	Participle
torché	Participle
faussaient	Verb
décanter	Verb
emboutèrent	Verb
singularisa	Verb
parasitait	Verb
descuvrant	Participle
courriellasse	Verb
sût	Verb
apporterai	Verb
téléporteront	Verb
laborer	Verb
blessé	Participle
rejoindrai	Verb
ignoreraient	Verb
rendra	Verb
tracèrent	Verb
sculptaient	Verb
réarrangea	Verb
publierez	Verb
approvisionnait	Verb
refuserait	Verb
excellera	Verb
pataugé	Participle
présupposer	Verb
puisera	Verb
vuiderent	Verb
entonner	Verb
éduqua	Verb
surgirent	Verb
discuté	Participle
souhaiteriez	Verb
clôturé	Participle
émeut	Verb
employa	Verb
prévoira	Verb
clouant	Participle
languir	Verb
gazéifié	Participle
monnayer	Verb
arresterent	Verb
recouper	Verb
embuignoie	Verb
amusèrent	Verb
baissera	Verb
débroussaillé	Participle
résisteront	Verb
débloqua	Verb
propageaient	Verb
réinsérant	Participle
civiliserons	Verb
nasaliser	Verb
supposé	Participle
raréfiasse	Verb
photographierait	Verb
sentirez	Verb
accostant	Participle
animaliserai	Verb
entériné	Participle
provoquèrent	Verb
établir	Verb
injectait	Verb
bazarder	Verb
rallumé	Participle
dépensant	Participle
distordant	Participle
ostelissons	Verb
dunas	Verb
lâchassions	Verb
faz	Verb
tremper	Verb
ennoyé	Participle
tâcha	Verb
existé	Participle
relâcha	Verb
ripolinerons	Verb
construiront	Verb
brouettaient	Verb
pondérer	Verb
devinait	Verb
allonger	Verb
durant	Participle
assistât	Verb
ficha	Verb
adaptai	Verb
malmené	Participle
fériant	Participle
obtenant	Participle
intoxiquant	Participle
fourniraient	Verb
parvenir	Verb
épousseter	Verb
quist	Verb
raisonnait	Verb
attacheront	Verb
enhardirent	Verb
précipitera	Verb
commanditer	Verb
saluèrent	Verb
rabattaient	Verb
ressuscité	Participle
plaiderait	Verb
transmettre	Verb
grincer	Verb
carburant	Participle
subît	Verb
contaminassiez	Verb
renvoya	Verb
scella	Verb
amarsiras	Verb
motivait	Verb
poignant	Participle
tâtonnant	Participle
arrosant	Participle
formaté	Participle
recontactera	Verb
éventer	Verb
armera	Verb
enclenchait	Verb
reconfortoie	Verb
homologué	Participle
compterait	Verb
exécutaient	Verb
larguait	Verb
laisié	Participle
rediffusassent	Verb
dépasseront	Verb
titulariser	Verb
prélever	Verb
accédant	Participle
jurait	Verb
récitera	Verb
envier	Verb
rentrerai	Verb
louchant	Participle
évoluerait	Verb
remembré	Participle
détaillant	Participle
dessiner	Verb
fustigeaient	Verb
contournait	Verb
apparentâtes	Verb
soulignant	Participle
regagnas	Verb
désorganisé	Participle
rediffuser	Verb
alongeas	Verb
murer	Verb
garantiront	Verb
délivreront	Verb
motiva	Verb
dansèrent	Verb
acheminé	Participle
rouspétassiez	Verb
jailli	Participle
surpasser	Verb
tracé	Participle
naissait	Verb
déboulonner	Verb
égalant	Participle
improvisé	Participle
butter	Verb
motorisait	Verb
arraisonner	Verb
anserreriiez	Verb
gerberas	Verb
décrétèrent	Verb
inonderait	Verb
décapitassiez	Verb
entoura	Verb
affronté	Participle
residast	Verb
urbanisa	Verb
appréciaient	Verb
découleront	Verb
empreignaient	Verb
tripler	Verb
supplantant	Participle
dépensaient	Verb
fuyait	Verb
méthaniser	Verb
sélectionner	Verb
rentrer	Verb
renseigna	Verb
occuperait	Verb
conseillé	Participle
certifia	Verb
hausseriez	Verb
honni	Participle
scellèrent	Verb
fiancèrent	Verb
généra	Verb
collectera	Verb
décédèrent	Verb
reconduisit	Verb
attaquant	Participle
subordonné	Participle
trottant	Participle
conjurant	Participle
secourant	Participle
ensanglantaient	Verb
dénommant	Participle
prépositionné	Participle
supprimerait	Verb
écarterait	Verb
recracher	Verb
farfouillant	Participle
abstenaient	Verb
opposer	Verb
exhibait	Verb
dépêcher	Verb
nié	Participle
interagissant	Participle
fessant	Participle
dialysé	Participle
frayai	Verb
engoulant	Participle
sophistiqué	Participle
reclassé	Participle
rayé	Participle
informaient	Verb
défragmentâmes	Verb
dormi	Participle
objectiver	Verb
narguerons	Verb
circonvenir	Verb
cuirasserai	Verb
acceptera	Verb
syncopé	Participle
engendrerait	Verb
comater	Verb
desnoes	Verb
érigeront	Verb
apportait	Verb
pencha	Verb
atendiiens	Verb
transplanter	Verb
réabsorbai	Verb
baisait	Verb
esloigniiens	Verb
encourt	Verb
pondèreraient	Verb
comata	Verb
exhalât	Verb
redémarrerez	Verb
usé	Participle
émergeaient	Verb
excuseras	Verb
recollant	Participle
azurât	Verb
professé	Participle
arqua	Verb
remettront	Verb
éprouver	Verb
irait	Verb
retrousser	Verb
souna	Verb
persuadait	Verb
garas	Verb
désactivera	Verb
proposa	Verb
accaparaient	Verb
evaporerez	Verb
dispenser	Verb
marquant	Participle
coassant	Participle
modelait	Verb
prématuré	Participle
démarrèrent	Verb
pianoterez	Verb
violé	Participle
contempler	Verb
laminant	Participle
truffé	Participle
éteindrait	Verb
jugulé	Participle
explosa	Verb
parabola	Verb
phagocyter	Verb
criassent	Verb
seyait	Verb
affineront	Verb
implanteront	Verb
sacrifier	Verb
œuvrait	Verb
urbaniser	Verb
tracasseront	Verb
croustillant	Participle
sulfaté	Participle
figeant	Participle
reconquit	Verb
rétréci	Participle
débiner	Verb
dupant	Participle
naquîtes	Verb
ensanglanté	Participle
cagoulerons	Verb
rockèrent	Verb
réchauffé	Participle
effectuera	Verb
tyranniser	Verb
intériorisé	Participle
tentera	Verb
dramatiser	Verb
copas	Verb
tractaient	Verb
prénommeraient	Verb
fournirons	Verb
ramènerai	Verb
convergeassent	Verb
légalisé	Participle
beurrasses	Verb
reboisé	Participle
couinant	Participle
griffé	Participle
oscillerait	Verb
minéralisé	Participle
rechargé	Participle
narguassiez	Verb
concèdera	Verb
reconstituait	Verb
décollera	Verb
appartient	Verb
dardât	Verb
affacturerai	Verb
embrasseront	Verb
remaria	Verb
esrichastes	Verb
trimbalâmes	Verb
recroira	Verb
dressant	Participle
sillonnèrent	Verb
escortera	Verb
sevriiez	Verb
fonctionnant	Participle
cueillait	Verb
tomber	Verb
influencé	Participle
tarabustèrent	Verb
diminuèrent	Verb
éprouvaient	Verb
automutiler	Verb
effrayait	Verb
figuras	Verb
transmettraient	Verb
réintégrant	Participle
hâtaient	Verb
dédier	Verb
magner	Verb
engouffreras	Verb
copilotas	Verb
flairer	Verb
sombrer	Verb
photographiassiez	Verb
fixeront	Verb
cliquerait	Verb
fusionnerait	Verb
intéressa	Verb
impatientant	Participle
enrôlaient	Verb
imitera	Verb
oublieraient	Verb
voltigeâtes	Verb
ajointaient	Verb
iniuriasses	Verb
reiglastes	Verb
trémula	Verb
autonomisé	Participle
encombrait	Verb
sirotant	Participle
tiraillâmes	Verb
enfilaient	Verb
escrimé	Participle
régnèrent	Verb
exaucer	Verb
ronproies	Verb
lover	Verb
soustrayait	Verb
appréhendaient	Verb
punaisa	Verb
débutait	Verb
défaisant	Participle
condamnera	Verb
vassalisas	Verb
raturerez	Verb
écossas	Verb
racheter	Verb
vanté	Participle
repêchant	Participle
chiffrait	Verb
explosèrent	Verb
stagnaient	Verb
bataillé	Participle
pressant	Participle
paroleront	Verb
conduisirent	Verb
prévaut	Verb
rajoutait	Verb
béniras	Verb
tourmenteraient	Verb
suggèrera	Verb
réemployer	Verb
centras	Verb
bombardant	Participle
réassorti	Participle
éperonné	Participle
busses	Verb
imitèrent	Verb
enjoignaient	Verb
engloberait	Verb
pontifier	Verb
forjas	Verb
manigancer	Verb
sentimentaliserons	Verb
tochissons	Verb
chialer	Verb
muloté	Participle
liquida	Verb
traduisaient	Verb
redécouvert	Participle
chambra	Verb
agrémentant	Participle
déclencheriez	Verb
wardant	Participle
affilié	Participle
gagnaient	Verb
émoussé	Participle
perfectionnait	Verb
écrasassions	Verb
pleurait	Verb
prospérèrent	Verb
jouxtant	Participle
brandi	Participle
visser	Verb
enfilait	Verb
barra	Verb
compeller	Verb
interpréter	Verb
emmaillottai	Verb
démythifiassent	Verb
étatisé	Participle
insista	Verb
braire	Verb
prædiront	Verb
bordait	Verb
fêta	Verb
épurant	Participle
poussez-vous	Verb
proferas	Verb
réinstaurant	Participle
calas	Verb
transplantant	Participle
déchargé	Participle
environnait	Verb
popas	Verb
troqueriez	Verb
amusas	Verb
chasser	Verb
décidât	Verb
embrocher	Verb
examinera	Verb
aviner	Verb
surproduisisses	Verb
enviandâtes	Verb
instituait	Verb
comanda	Verb
figuraient	Verb
cuisinaient	Verb
accèdera	Verb
déchristianisé	Participle
autoproclamer	Verb
allotiriez	Verb
dépendirent	Verb
suralimenté	Participle
programmé	Participle
manier	Verb
béatifier	Verb
tressaient	Verb
espionnera	Verb
surinerions	Verb
rallongeant	Participle
pissier	Verb
croniquiasses	Verb
différait	Verb
universaliser	Verb
détrempas	Verb
orent	Verb
perdrions	Verb
gachas	Verb
sacrant	Participle
infligerait	Verb
alangui	Participle
prohiba	Verb
compensé	Participle
deviendrai	Verb
reprochait	Verb
abaz	Verb
impliquer	Verb
expédiera	Verb
hésitèrent	Verb
fermeront	Verb
rougeoyer	Verb
affectionner	Verb
sanblerons	Verb
exauçant	Participle
rimait	Verb
procez	Verb
répudiera	Verb
montrer	Verb
définirent	Verb
interviendrait	Verb
agrafer	Verb
tornai	Verb
variait	Verb
alertaient	Verb
démilitarisant	Participle
inviterait	Verb
arrangeaient	Verb
enfourcheront	Verb
écrasera	Verb
racheté	Participle
redoutant	Participle
décarboné	Participle
assonancerai	Verb
copulant	Participle
engendrait	Verb
offrirai	Verb
minimisé	Participle
bouturer	Verb
ciblait	Verb
enterrant	Participle
préfaçant	Participle
empêcha	Verb
convinrent	Verb
intercepter	Verb
finant	Participle
proclamant	Participle
dallé	Participle
rencontreront	Verb
résinasse	Verb
hutter	Verb
arrivant	Participle
tanna	Verb
catastrophé	Participle
hésiteras	Verb
façonnâmes	Verb
utilisèrent	Verb
vivoterions	Verb
interrompit	Verb
étronçonnerait	Verb
sillonnant	Participle
circulèrent	Verb
kératinisé	Participle
concevant	Participle
réputé	Participle
huché	Participle
imposeraient	Verb
incarcérer	Verb
dysfonctionné	Participle
rattacha	Verb
perlant	Participle
chargeant	Participle
proposaient	Verb
broutaient	Verb
serras	Verb
travaillé	Participle
nécessiteraient	Verb
zombifié	Participle
gâchera	Verb
cisaillant	Participle
accostaient	Verb
vouèrent	Verb
sonné	Participle
vérifia	Verb
réclameront	Verb
fomentera	Verb
estimera	Verb
enterrait	Verb
mouvoir	Verb
bridger	Verb
montra	Verb
mystifiant	Participle
déplaira	Verb
lynchaient	Verb
déshabillé	Participle
élargira	Verb
arbitrant	Participle
reloueras	Verb
excusait	Verb
utiliseriez	Verb
embauchaient	Verb
signer	Verb
écachera	Verb
auger	Verb
divulguant	Participle
flori	Participle
déniaiser	Verb
cadrait	Verb
torneras	Verb
avantai	Verb
nitrifiait	Verb
reconcentraient	Verb
convaincront	Verb
affubler	Verb
consulté	Participle
drossé	Participle
soumettait	Verb
marketa	Verb
conditionneront	Verb
transparaît	Verb
ensuivirent	Verb
dopait	Verb
vulcanisé	Participle
consistait	Verb
approuvèrent	Verb
supprimaient	Verb
nettoyant	Participle
recouvrir	Verb
œuvraient	Verb
crawlât	Verb
affritassent	Verb
cordas	Verb
minorâmes	Verb
ménageâmes	Verb
scorer	Verb
manœuvrasses	Verb
redéposasse	Verb
défendu	Participle
démembra	Verb
tapissé	Participle
crit	Verb
entretiendra	Verb
transcendât	Verb
commissionna	Verb
gâcher	Verb
junoies	Verb
impatientait	Verb
diapré	Participle
accomplissait	Verb
supposa	Verb
alerter	Verb
gambader	Verb
recumençasse	Verb
pommassions	Verb
recueilleront	Verb
affluait	Verb
dupliqué	Participle
cultiva	Verb
restructurer	Verb
comprendriez	Verb
romancé	Participle
migrèrent	Verb
échangèrent	Verb
fêtaient	Verb
enfermèrent	Verb
grimasse	Verb
indiquaient	Verb
disjoncté	Participle
caparaçonné	Participle
fabriquera	Verb
rigolait	Verb
narrer	Verb
endommaigeroit	Verb
éponger	Verb
arrivèrent	Verb
diffusant	Participle
encombré	Participle
affairer	Verb
haranguer	Verb
déformerai	Verb
expirant	Participle
indemnisé	Participle
forerions	Verb
déprêtrisassiez	Verb
croirez	Verb
constitueraient	Verb
réinstallerons	Verb
endurait	Verb
norma	Verb
tormenta	Verb
convoqua	Verb
attirerait	Verb
prohibaient	Verb
tergiversa	Verb
émigrer	Verb
dirions	Verb
tonnassiez	Verb
entremarchanderiiens	Verb
récuras	Verb
escumeroit	Verb
aporter	Verb
kidnapper	Verb
infestâtes	Verb
plastiquassiez	Verb
monstré	Participle
draguait	Verb
décerna	Verb
fuité	Participle
battirent	Verb
choieras	Verb
marquerait	Verb
crostant	Participle
bonifia	Verb
pressait	Verb
vendit	Verb
esveiglerions	Verb
tentât	Verb
mouchetai	Verb
indigner	Verb
balbutiait	Verb
disposait	Verb
ratifia	Verb
piégèrent	Verb
gargariser	Verb
réislamisant	Participle
concéda	Verb
attachera	Verb
égayer	Verb
colorisé	Participle
huèrent	Verb
noteront	Verb
commercialiserait	Verb
cediiez	Verb
asservir	Verb
bougeront	Verb
bénéficier	Verb
doblasses	Verb
découplerons	Verb
eschauferons	Verb
recensé	Participle
éborgné	Participle
jutas	Verb
complémenterions	Verb
démissionnèrent	Verb
revînt	Verb
macèreriez	Verb
ociz	Verb
défendrait	Verb
mariait	Verb
contrecarré	Participle
gravira	Verb
titra	Verb
numérisé	Participle
réfugièrent	Verb
kiffât	Verb
compté	Participle
biffé	Participle
tesmoigniiez	Verb
excepter	Verb
inhibant	Participle
perpétuera	Verb
convainquirent	Verb
entant	Participle
succédât	Verb
travestir	Verb
invaginasse	Verb
décharné	Participle
incubât	Verb
possèdera	Verb
allaiter	Verb
contesta	Verb
raccompagna	Verb
restituer	Verb
accuseront	Verb
artificialiseriez	Verb
voûter	Verb
exécrèrent	Verb
batist	Verb
mostra	Verb
excisa	Verb
filaient	Verb
connaîtrez	Verb
présageaient	Verb
utiliseront	Verb
pistant	Participle
semant	Participle
inutilisé	Participle
rester	Verb
euthanasia	Verb
partiras	Verb
prouverai	Verb
naitrons	Verb
dévorèrent	Verb
travaillant	Participle
surprotégé	Participle
cousu	Participle
copiloté	Participle
déshumaniser	Verb
dispersaient	Verb
louangé	Participle
urt	Verb
assouplissant	Participle
impactait	Verb
encomençassent	Verb
instillé	Participle
survit	Verb
soumettront	Verb
instaurait	Verb
dédommagé	Participle
recouvré	Participle
compliquant	Participle
déclamaient	Verb
égalisé	Participle
participerai	Verb
agglutinant	Participle
lancinant	Participle
innocentera	Verb
grattait	Verb
roquer	Verb
sema	Verb
ébranleraient	Verb
conquérant	Participle
sommèrent	Verb
replaçant	Participle
ébranlant	Participle
dominait	Verb
dénigra	Verb
posèrent	Verb
intitulaient	Verb
rainuré	Participle
soutira	Verb
réengagé	Participle
inculqueras	Verb
exténué	Participle
rallièrent	Verb
ajourât	Verb
senblai	Verb
repositionner	Verb
entraina	Verb
amincissant	Participle
descendu	Participle
hackerons	Verb
rénova	Verb
repousseront	Verb
promeut	Verb
sécher	Verb
blastenjoie	Verb
préserverons	Verb
focalisa	Verb
paroleriiens	Verb
grondasse	Verb
regetoit	Verb
repousserait	Verb
renoncer	Verb
ponctionnâmes	Verb
tuerons	Verb
contraindre	Verb
pratiquèrent	Verb
flirtant	Participle
monologuassent	Verb
avorta	Verb
rut	Participle
défavorisé	Participle
abolissait	Verb
compromettaient	Verb
bouilli	Participle
designer	Verb
militaient	Verb
turniiez	Verb
contactèrent	Verb
refondé	Participle
ébouillanter	Verb
singularisé	Participle
arguèrent	Verb
usiner	Verb
ensoleillé	Participle
essuyé	Participle
inscrivait	Verb
bornait	Verb
approfondissant	Participle
échappant	Participle
arrangea	Verb
douta	Verb
éprouvai	Verb
lacé	Participle
correcerons	Verb
éblouissant	Participle
regarderez	Verb
couvrira	Verb
imposerai	Verb
clarifierons	Verb
picqué	Participle
fâchèrent	Verb
bâillerait	Verb
palabrer	Verb
remuer	Verb
contamineront	Verb
proféraient	Verb
évertué	Participle
repoussé	Participle
renfermas	Verb
filialisé	Participle
reproduira	Verb
sons	Verb
inaugurant	Participle
gravissaient	Verb
fatigua	Verb
déconcerter	Verb
cofinancer	Verb
appauvrir	Verb
surfer	Verb
couronnant	Participle
explicitas	Verb
recuperer	Verb
escortèrent	Verb
négligeaient	Verb
enfourner	Verb
asséna	Verb
daguerréotypera	Verb
grinçai	Verb
lyncher	Verb
détruisait	Verb
mordit	Verb
molli	Participle
ailleront	Verb
reconquisses	Verb
rajoutaient	Verb
accueillait	Verb
cosignera	Verb
vocaliser	Verb
serpenté	Participle
dévêt	Verb
espéraient	Verb
reschauffes	Verb
froissant	Participle
airas	Verb
practicquast	Verb
tiraient	Verb
réfléchirait	Verb
plantera	Verb
guidera	Verb
aguisoit	Verb
coassa	Verb
vola	Verb
fondrai	Verb
terminerai	Verb
évaporera	Verb
canné	Participle
fouillera	Verb
terrorisait	Verb
relira	Verb
laisseriez	Verb
embrachas	Verb
dispensât	Verb
assisterait	Verb
réconcilié	Participle
baliverait	Verb
découvrît	Verb
abandonerons	Verb
lyophilisé	Participle
réchaufferait	Verb
dirigeront	Verb
excursionnait	Verb
rivalisera	Verb
broder	Verb
amplifia	Verb
voyagera	Verb
couvrir	Verb
boursoufflassent	Verb
lasseraient	Verb
manipulait	Verb
rejeta	Verb
executer	Verb
militant	Participle
ulcèrerions	Verb
cristallisant	Participle
starisant	Participle
acosteroie	Verb
tripla	Verb
smashaient	Verb
pesta	Verb
expliciter	Verb
perturbaient	Verb
dîtes	Verb
accordant	Participle
élever	Verb
réinterpréta	Verb
brulant	Participle
clairsemeraient	Verb
projetterait	Verb
réhabilitera	Verb
garrocha	Verb
compromettre	Verb
fortifiait	Verb
salé	Participle
polarisé	Participle
faner	Verb
dévergondé	Participle
désorganisant	Participle
lésinâtes	Verb
bioconcentrer	Verb
embarquaient	Verb
translittéré	Participle
discutaient	Verb
débrider	Verb
pullulaient	Verb
emberlificoter	Verb
épargnaient	Verb
réussissait	Verb
décléricalisassions	Verb
déchaîné	Participle
baladas	Verb
ravageaient	Verb
entitulasse	Verb
reversé	Participle
avantageait	Verb
plier	Verb
déserter	Verb
pagaya	Verb
embrasera	Verb
rapatrier	Verb
tintant	Participle
emprunta	Verb
coupleriez	Verb
coutant	Participle
arrentâmes	Verb
garai	Verb
récurer	Verb
vendait	Verb
garasse	Verb
ajouterai	Verb
dimensionnant	Participle
bloqueront	Verb
dégradassent	Verb
virevolter	Verb
devisassiez	Verb
revancha	Verb
déplaçaient	Verb
débobinant	Participle
recourbant	Participle
géométriserez	Verb
évangélisaient	Verb
refermait	Verb
éraflé	Participle
invoquant	Participle
boycottera	Verb
produisirent	Verb
dégréerons	Verb
habiteront	Verb
trouveriez	Verb
repêcha	Verb
estomaquerai	Verb
étripé	Participle
implanter	Verb
encadrer	Verb
montrerait	Verb
alimenter	Verb
fuguer	Verb
ébranlait	Verb
décelant	Participle
perfectionnèrent	Verb
recopia	Verb
plissé	Participle
reparlerons	Verb
vitupèrerons	Verb
praesenterez	Verb
descellé	Participle
blâmant	Participle
énumérait	Verb
dénoncèrent	Verb
cofinancé	Participle
terra	Verb
détonasses	Verb
muera	Verb
réassortiront	Verb
viabilisé	Participle
autoproclamait	Verb
poignardâmes	Verb
ardu	Participle
dissocier	Verb
mentionnait	Verb
bavèrent	Verb
annotant	Participle
générer	Verb
resistasses	Verb
modèrerons	Verb
risquait	Verb
attristé	Participle
savourant	Participle
dépenseront	Verb
imploraient	Verb
checker	Verb
dépêtra	Verb
véhiculer	Verb
grattant	Participle
démythifierai	Verb
dérangeant	Participle
bavardant	Participle
réfléchir	Verb
cumulé	Participle
redécouperai	Verb
aisames	Verb
diffuseraient	Verb
lester	Verb
atrairoies	Verb
dépoussièreriez	Verb
contestaient	Verb
exhiberaient	Verb
assurerai	Verb
conservera	Verb
praeparasses	Verb
traquera	Verb
campé	Participle
psalmodiant	Participle
préjuger	Verb
confirmera	Verb
élagué	Participle
veillant	Participle
commerçant	Participle
trimbalèrent	Verb
canonner	Verb
abriterait	Verb
fluidifiâtes	Verb
séparé	Participle
vendrait	Verb
reversant	Participle
enfoiré	Participle
waivasses	Verb
absorbaient	Verb
atarjastes	Verb
réalimenter	Verb
acheminerait	Verb
féconder	Verb
permettraient	Verb
mutilé	Participle
espérèrent	Verb
arrondiraient	Verb
téléguider	Verb
hystérisa	Verb
spécifiera	Verb
mûrit	Verb
disputer	Verb
brisait	Verb
chambrer	Verb
dopé	Participle
acquittaient	Verb
adapterait	Verb
symbolisant	Participle
traversèrent	Verb
desploier	Verb
découlèrent	Verb
snackera	Verb
assombrissant	Participle
aliéné	Participle
assainissant	Participle
étiola	Verb
pourfendu	Participle
déplumerez	Verb
abusant	Participle
survoler	Verb
procréé	Participle
multipliera	Verb
interpelé	Participle
acquiescèrent	Verb
vanta	Verb
estout	Verb
controverserons	Verb
maximiser	Verb
présenterai	Verb
décourager	Verb
écouter	Verb
coïncidera	Verb
américanisera	Verb
attisé	Participle
employé	Participle
exploré	Participle
soupçonnait	Verb
narguas	Verb
affleurai	Verb
remettes	Verb
conféraient	Verb
scinder	Verb
manipulant	Participle
royas	Verb
pronostiquer	Verb
recueillera	Verb
subventionnant	Participle
sélectionnerait	Verb
griffer	Verb
fesant	Participle
pillait	Verb
épuisait	Verb
usera	Verb
altèreriez	Verb
conservant	Participle
pérennisé	Participle
européanisé	Participle
émoulu	Participle
assortir	Verb
proposerez	Verb
réemploierons	Verb
délivrait	Verb
fustigea	Verb
gabai	Verb
confiaient	Verb
entraîna	Verb
conseiller	Verb
batta	Verb
rembarré	Participle
pollueraient	Verb
déborda	Verb
surjoué	Participle
élargirait	Verb
rebutait	Verb
intéresseraient	Verb
aiguisé	Participle
ennuierait	Verb
chérissant	Participle
défèquerez	Verb
imitant	Participle
promulguer	Verb
entrebâillèrent	Verb
dorloter	Verb
reconstruiraient	Verb
enrouleront	Verb
écumèrent	Verb
accentuant	Participle
damasquiné	Participle
hésita	Verb
présentait	Verb
codas	Verb
damasquineront	Verb
fractionnaient	Verb
renforcer	Verb
lamas	Verb
desmantela	Verb
chantai	Verb
arrimer	Verb
ocré	Participle
tarderont	Verb
boivre	Verb
courrielleront	Verb
zoné	Participle
démêlé	Participle
numeroiz	Verb
identifier	Verb
grésillas	Verb
affamant	Participle
détruira	Verb
réconforter	Verb
façonnant	Participle
trillas	Verb
noué	Participle
facilitant	Participle
affinait	Verb
materner	Verb
démérité	Participle
ombrageant	Participle
agrippant	Participle
agitait	Verb
amollir	Verb
connectait	Verb
contrevenait	Verb
désendetter	Verb
fluctuait	Verb
lava	Verb
intronisant	Participle
dépendre	Verb
entassa	Verb
consulter	Verb
redundast	Verb
revêtira	Verb
idolâtrer	Verb
overbookait	Verb
écumassiez	Verb
abordant	Participle
dédia	Verb
niaient	Verb
damnifier	Verb
déclinèrent	Verb
concurrençait	Verb
approchant	Participle
douter	Verb
maternant	Participle
germanisant	Participle
glorifier	Verb
précisé	Participle
simplifierait	Verb
prêcheraient	Verb
assignera	Verb
afublissoiz	Verb
redescendait	Verb
succombèrent	Verb
lovassiez	Verb
métissé	Participle
menotté	Participle
engendrera	Verb
paressasses	Verb
exploitaient	Verb
toila	Verb
boiter	Verb
embrancher	Verb
partîmes	Verb
dispersera	Verb
prospérait	Verb
fondera	Verb
étiqueté	Participle
dissimulait	Verb
costumé	Participle
désagrafas	Verb
dégradait	Verb
lugeasse	Verb
disposant	Participle
acompliront	Verb
contenir	Verb
pétri	Participle
culbutant	Participle
empiffrer	Verb
hué	Participle
regagneraient	Verb
élu	Participle
mondialiser	Verb
hivernant	Participle
mutilant	Participle
dissiperont	Verb
fidélisas	Verb
obéir	Verb
hocheriez	Verb
pérennisera	Verb
décapotassions	Verb
retarder	Verb
dépoussiérant	Participle
differs	Verb
subissait	Verb
réinstallé	Participle
voûtera	Verb
charmé	Participle
partait	Verb
consomma	Verb
désengager	Verb
termineront	Verb
délocalisa	Verb
aliast	Verb
savent	Verb
interrompre	Verb
centralisait	Verb
éraillassiez	Verb
hélé	Participle
inventaient	Verb
semaient	Verb
préconisèrent	Verb
stationnait	Verb
assénait	Verb
infantilisant	Participle
renforçassiez	Verb
soulant	Participle
autopsia	Verb
supervisera	Verb
oublié	Participle
baver	Verb
joui	Participle
pilonneras	Verb
discipliné	Participle
prenant	Participle
rembarqua	Verb
obéiraient	Verb
aimerez	Verb
composant	Participle
couva	Verb
résigné	Participle
vivifiant	Participle
excentrer	Verb
dialyserez	Verb
patoiserai	Verb
nappé	Participle
référa	Verb
signeraient	Verb
interférer	Verb
billeté	Participle
raccordant	Participle
dormira	Verb
complotera	Verb
excédant	Participle
exercèrent	Verb
éviscérer	Verb
comprimer	Verb
cessaient	Verb
soulignera	Verb
perdes	Verb
accentuait	Verb
critiquèrent	Verb
séquestrer	Verb
équilibrer	Verb
tromperaient	Verb
enorgueilli	Participle
countrefais	Verb
sélectionneront	Verb
impressionner	Verb
chroniquerez	Verb
intervertir	Verb
butai	Verb
quittait	Verb
reparlaient	Verb
emmenait	Verb
chevasse	Verb
séduire	Verb
refilé	Participle
mouchardassent	Verb
rentabilisassiez	Verb
thésauriser	Verb
pèseraient	Verb
voguaient	Verb
autopsier	Verb
descellerons	Verb
orientèrent	Verb
éprouveraient	Verb
cochonnassions	Verb
analysa	Verb
sacrer	Verb
dévorant	Participle
engueulé	Participle
torbloit	Verb
cylindré	Participle
recouvrirent	Verb
ballastassions	Verb
adjoindre	Verb
ethnographias	Verb
électrisé	Participle
rappelleraient	Verb
primeras	Verb
effaçait	Verb
retisser	Verb
déclassifié	Participle
resunoies	Verb
arpenter	Verb
déprima	Verb
imputer	Verb
félicitant	Participle
enfouissant	Participle
infectait	Verb
ombrager	Verb
réquisitionnassiez	Verb
advînt	Verb
mélodramatiserez	Verb
enregistra	Verb
peuplèrent	Verb
sala	Verb
maniera	Verb
apparût	Verb
débaptisa	Verb
ciblé	Participle
contribueraient	Verb
désavouasses	Verb
jetait	Verb
égratignant	Participle
renfrogné	Participle
romançant	Participle
multiprogrammâtes	Verb
épousé	Participle
traumatisé	Participle
abusèrent	Verb
afïeroit	Verb
levèrent	Verb
entuberont	Verb
habilitant	Participle
cesseras	Verb
machiné	Participle
enchainer	Verb
consumasse	Verb
fendu	Participle
fermât	Verb
baratté	Participle
haz	Verb
remorquaient	Verb
stockera	Verb
anticiper	Verb
descourageassions	Verb
conserverait	Verb
supprimé	Participle
assassineras	Verb
chûtes	Verb
massacrait	Verb
driver	Verb
applis	Verb
convoité	Participle
inscrirait	Verb
arborer	Verb
rétrocédait	Verb
soignerez	Verb
ourlâmes	Verb
limiterai	Verb
semon	Verb
trônerions	Verb
réinstallèrent	Verb
lorgnasse	Verb
transféra	Verb
croiserait	Verb
chevaucherai	Verb
déglutir	Verb
vouer	Verb
réduire	Verb
surexploiter	Verb
démissent	Verb
peuplant	Participle
phosphorylé	Participle
surpassaient	Verb
spécialisèrent	Verb
parvenu	Participle
sursaturât	Verb
dessevreroiz	Verb
rejoué	Participle
enorgueillissait	Verb
sospiroit	Verb
embêté	Participle
transmettrai	Verb
plébisciter	Verb
triplera	Verb
mouvant	Participle
esproveroies	Verb
redescendra	Verb
renommerait	Verb
décerneront	Verb
priait	Verb
tiquer	Verb
assolant	Participle
oppresserai	Verb
sondant	Participle
scénarisa	Verb
utilisât	Verb
constata	Verb
ajuster	Verb
nantiriez	Verb
consista	Verb
modernisait	Verb
eschargaitant	Participle
souffrirent	Verb
assoileroit	Verb
soldera	Verb
immolant	Participle
embrigaderez	Verb
concourt	Verb
comparaîtra	Verb
vacilla	Verb
désilasses	Verb
consacrerait	Verb
aventuraient	Verb
déléguaient	Verb
éternuerai	Verb
égosillons-nous	Verb
gaujoit	Verb
ponctuant	Participle
raccrochant	Participle
veḍissent	Verb
conserveront	Verb
indiquera	Verb
désertèrent	Verb
potasser	Verb
affronterai	Verb
ingérant	Participle
impatienta	Verb
enverraient	Verb
transfiguré	Participle
candidaté	Participle
avalé	Participle
fusionné	Participle
maudissant	Participle
cordonnas	Verb
mentaient	Verb
runs	Verb
rapa	Verb
toréant	Participle
enlevait	Verb
conteneurisé	Participle
aseüroient	Verb
remania	Verb
conspiraient	Verb
nitrerez	Verb
reposé	Participle
requeṣimes	Verb
fomentèrent	Verb
bourgeonnant	Participle
mécanisant	Participle
acheminaient	Verb
négligé	Participle
r'asseurerent	Verb
exploitait	Verb
taquinant	Participle
lixivieras	Verb
infirmant	Participle
centraliser	Verb
regrouperont	Verb
bichonnerions	Verb
bidonné	Participle
casseront	Verb
détériorer	Verb
contaminé	Participle
dessilla	Verb
verrouilleras	Verb
adeseroie	Verb
fracasserons	Verb
prévoyant	Participle
suffirent	Verb
blechoient	Verb
innova	Verb
pavé	Participle
fureté	Participle
dones	Verb
sonjé	Participle
culbutèrent	Verb
restructuré	Participle
quadrupla	Verb
comprenaient	Verb
vêlant	Participle
torturait	Verb
ozoniser	Verb
caillassé	Participle
stipulant	Participle
protègeront	Verb
achèterai	Verb
recullasses	Verb
émanaient	Verb
cibla	Verb
contacterai	Verb
incommodant	Participle
ratifieras	Verb
labélisé	Participle
personnalisait	Verb
patienter	Verb
étonnerai	Verb
concorderait	Verb
créditait	Verb
infantilisassions	Verb
internèrent	Verb
boudinerions	Verb
voler	Verb
réconciliant	Participle
recentré	Participle
réveillaient	Verb
résultera	Verb
classerait	Verb
décroit	Verb
desafubleroient	Verb
lâchant	Participle
tondu	Participle
limoger	Verb
dirigeait	Verb
centrait	Verb
mimé	Participle
révoquer	Verb
encapsulant	Participle
soumettra	Verb
rajouter	Verb
décrédibiliseront	Verb
informatiser	Verb
breeroit	Verb
correçoient	Verb
diagnostiquèrent	Verb
listé	Participle
déformasses	Verb
counter	Verb
brassai	Verb
écarter	Verb
prenent	Verb
s’enfuyant	Participle
découragerait	Verb
tuai	Verb
nettoyait	Verb
adjoindront	Verb
marchaient	Verb
enroula	Verb
republié	Participle
atteindrons	Verb
interviewait	Verb
harper	Verb
stipulaient	Verb
adhérait	Verb
émigrait	Verb
énervé	Participle
clouèrent	Verb
privait	Verb
pécher	Verb
éteignit	Verb
ravissant	Participle
aimant	Participle
emmena	Verb
despencerez	Verb
relataient	Verb
cuisiné	Participle
cembleront	Verb
militera	Verb
paupérisassiez	Verb
hua	Verb
photographié	Participle
respiraient	Verb
embausmas	Verb
luittas	Verb
penchera	Verb
inaugura	Verb
béatifièrent	Verb
rencontreraient	Verb
estropiasse	Verb
trapper	Verb
miré	Participle
affadir	Verb
pelletant	Participle
démolissait	Verb
désintéressaient	Verb
connecté	Participle
encaserné	Participle
suffira	Verb
jazzassions	Verb
reconditionneraient	Verb
dropper	Verb
reculaient	Verb
éventra	Verb
bâtira	Verb
moqua	Verb
esluigneriiens	Verb
touz	Verb
guasta	Verb
guérissait	Verb
distordu	Participle
protègerai	Verb
exporté	Participle
celebroient	Verb
braqueras	Verb
autoproclamant	Participle
monopolisé	Participle
entrelacerions	Verb
désacralisant	Participle
achevé	Participle
supplantera	Verb
asphyxié	Participle
disputèrent	Verb
envisageâtes	Verb
torcher	Verb
gêné	Participle
mondant	Participle
décloisonnant	Participle
décollèrent	Verb
graviter	Verb
moutonné	Participle
radiorepèreriez	Verb
tumas	Verb
boitillaient	Verb
taraudé	Participle
freiné	Participle
arguaient	Verb
plierait	Verb
polarisasse	Verb
babillassions	Verb
abîmer	Verb
designant	Participle
survenir	Verb
masquant	Participle
chastrasse	Verb
reteindriez	Verb
mugissant	Participle
bidouillé	Participle
clavarderai	Verb
golfer	Verb
asembleroiz	Verb
extraira	Verb
informant	Participle
mâché	Participle
bénéficierait	Verb
chaussant	Participle
transcrivaient	Verb
pliera	Verb
griller	Verb
enflamissons	Verb
important	Participle
hachuré	Participle
remonter	Verb
descovroie	Verb
partaient	Verb
réarmerait	Verb
mailla	Verb
évitera	Verb
mémoriser	Verb
convoler	Verb
ornèrent	Verb
surdosassions	Verb
rediscutassent	Verb
redirigeaient	Verb
désapprouver	Verb
déshydratassiez	Verb
revivifieraient	Verb
rebadigeonné	Participle
plongeait	Verb
adamagissoiz	Verb
retiré	Participle
décroitre	Verb
attériras	Verb
exonérer	Verb
pétiller	Verb
droguer	Verb
rayas	Verb
bradé	Participle
reprendraient	Verb
départagerions	Verb
alertèrent	Verb
délocalisant	Participle
cohabitant	Participle
reverserait	Verb
dézippassent	Verb
remercier	Verb
déguisèrent	Verb
préexistant	Participle
émana	Verb
désintégré	Participle
retournerai	Verb
infirmer	Verb
entrabrasseroie	Verb
parada	Verb
foudroyant	Participle
construisit	Verb
ajusteront	Verb
amassait	Verb
écroulèrent	Verb
obvieront	Verb
déploré	Participle
semblèrent	Verb
aventurerait	Verb
réjouissait	Verb
disjoindre	Verb
applïeras	Verb
densifier	Verb
surmené	Participle
franchît	Verb
affinaient	Verb
craignaient	Verb
amoindrissent	Verb
apprendrait	Verb
omettant	Participle
comptabilisé	Participle
imputèrent	Verb
cilla	Verb
évolueront	Verb
défier	Verb
méritèrent	Verb
bruissèrent	Verb
fédèreront	Verb
évoquerai	Verb
tâcher	Verb
prophétisant	Participle
sevré	Participle
évangélisait	Verb
conneüssons	Verb
entrouvririez	Verb
déliant	Participle
téléphoné	Participle
transporté	Participle
esmer	Verb
incisant	Participle
dériver	Verb
calligraphié	Participle
afficher	Verb
conformerai	Verb
allaité	Participle
conspiré	Participle
préludé	Participle
incisa	Verb
conclurai	Verb
pasé	Participle
facilitait	Verb
rationalisant	Participle
pisser	Verb
engendreront	Verb
limita	Verb
irisa	Verb
externaliser	Verb
intervenait	Verb
sécularisa	Verb
combinaient	Verb
tamponnerions	Verb
lubrifié	Participle
foirer	Verb
échanger	Verb
démentirent	Verb
saisirent	Verb
succombé	Participle
écrivissiez	Verb
emplir	Verb
prierait	Verb
especuleroies	Verb
saouler	Verb
domicilié	Participle
fuser	Verb
nuancer	Verb
puisa	Verb
transita	Verb
vénérait	Verb
enduré	Participle
salas	Verb
bagarrer	Verb
ristournerions	Verb
amené	Participle
claustrèrent	Verb
recréerai	Verb
aliéner	Verb
amodié	Participle
résilia	Verb
étudier	Verb
prédisaient	Verb
mijoté	Participle
pionnait	Verb
salasses	Verb
manipulaient	Verb
entrelaçassent	Verb
sentes	Verb
encombrant	Participle
articulaient	Verb
abondaient	Verb
combattait	Verb
arraisonna	Verb
prodiguer	Verb
rectifierions	Verb
aboutissant	Participle
desheriteriez	Verb
éparpilleraient	Verb
rallumer	Verb
aprendre	Verb
perdait	Verb
arabiser	Verb
démêlassions	Verb
transférèrent	Verb
ralentira	Verb
engloutissait	Verb
dégager	Verb
allongerait	Verb
amerrît	Verb
smashé	Participle
affûtassent	Verb
crever	Verb
visèrent	Verb
visait	Verb
rotter	Verb
vissé	Participle
ruperas	Verb
plongea	Verb
enveiastes	Verb
cartonnassent	Verb
dominé	Participle
horrifiant	Participle
planaient	Verb
récusèrent	Verb
coïtassiez	Verb
tremblaient	Verb
débarrassaient	Verb
oies	Verb
incendié	Participle
écraserait	Verb
hérissant	Participle
astreignant	Participle
recoifferait	Verb
hiérarchiser	Verb
affaibli	Participle
incurva	Verb
submergèrent	Verb
profitant	Participle
automatisé	Participle
agirait	Verb
déléguait	Verb
fréquenteront	Verb
croniquieroit	Verb
empochâtes	Verb
regardai	Verb
zinguerions	Verb
adopteraient	Verb
vérifié	Participle
supplanter	Verb
admirassent	Verb
surélèveriez	Verb
succédait	Verb
déraillât	Verb
scotcher	Verb
incinérer	Verb
gouasses	Verb
écourta	Verb
patronnait	Verb
quittant	Participle
bernas	Verb
rentreraient	Verb
abrutir	Verb
humidifiassent	Verb
reposèrent	Verb
minimisera	Verb
computer	Verb
valsas	Verb
tarifa	Verb
plâtras	Verb
emboîtèrent	Verb
songeait	Verb
découcher	Verb
préférèrent	Verb
comandera	Verb
dinât	Verb
déconsidèreras	Verb
décommandé	Participle
tabla	Verb
s’époumonaient	Verb
administra	Verb
appelai	Verb
étonnera	Verb
exclura	Verb
conspira	Verb
nierait	Verb
ressaisi	Participle
clamé	Participle
haucié	Participle
perpétra	Verb
parbolir	Verb
nacra	Verb
vaqueras	Verb
givré	Participle
scrabblas	Verb
musé	Participle
régurgité	Participle
déterrait	Verb
appetissoie	Verb
divulguera	Verb
souhaitèrent	Verb
discuter	Verb
préqualifié	Participle
prélevait	Verb
prétendre	Verb
débranchant	Participle
affamât	Verb
hypothéquer	Verb
poétiser	Verb
recréerait	Verb
désaltérant	Participle
jugerait	Verb
guerroya	Verb
bénéficia	Verb
résidait	Verb
wastissoiz	Verb
nacrant	Participle
relaxer	Verb
confondrai	Verb
échappera	Verb
dégoupiller	Verb
culasse	Verb
empaumâmes	Verb
arriérassions	Verb
signalerait	Verb
fascinera	Verb
demonstreriez	Verb
décamper	Verb
préféré	Participle
félicitaient	Verb
promut	Verb
maigrir	Verb
scolarisé	Participle
dénuder	Verb
morir	Verb
transporterait	Verb
aller	Verb
briqua	Verb
manipula	Verb
installer	Verb
blondir	Verb
louchait	Verb
tourmentera	Verb
recommander	Verb
conforta	Verb
semblait	Verb
glorifiaient	Verb
abondé	Participle
enrouler	Verb
interposeras	Verb
affrété	Participle
ravissait	Verb
inventoria	Verb
troublaient	Verb
gaufrer	Verb
perçaient	Verb
encontras	Verb
apercevrait	Verb
écrasant	Participle
développeraient	Verb
apprenaient	Verb
passionnèrent	Verb
cessant	Participle
aimèrent	Verb
jalousaient	Verb
nuncier	Verb
mitant	Participle
étouffé	Participle
déciderai	Verb
marchandant	Participle
porpenserent	Verb
censurât	Verb
songeaient	Verb
décrivant	Participle
calmera	Verb
brimèrent	Verb
innovant	Participle
détonnait	Verb
blatérai	Verb
boucaneraient	Verb
barboter	Verb
consolida	Verb
pardonnait	Verb
irritèrent	Verb
dissuadera	Verb
désemboueriez	Verb
éternuai	Verb
recevrait	Verb
professionnalisera	Verb
hydrater	Verb
aymer	Verb
revencheroit	Verb
éprouveront	Verb
menant	Participle
noumeroient	Verb
refermera	Verb
télécommandé	Participle
téléphona	Verb
sanctionnera	Verb
manquant	Participle
remporta	Verb
hésiterai	Verb
effriter	Verb
débilité	Participle
nasalisasse	Verb
rattrapé	Participle
désemparâmes	Verb
éclipsèrent	Verb
récupérèrent	Verb
déambulant	Participle
badinerai	Verb
captèrent	Verb
surchaufferaient	Verb
participeront	Verb
imbibâtes	Verb
impliqué	Participle
proposerai	Verb
desséchant	Participle
ruinèrent	Verb
instituèrent	Verb
slavisant	Participle
choquaient	Verb
exténuerai	Verb
expurgerai	Verb
sépareront	Verb
fournirait	Verb
pratiquait	Verb
esquaché	Participle
rapas	Verb
changera	Verb
accultura	Verb
balloté	Participle
monophtonguasses	Verb
présenta	Verb
sarcler	Verb
suspectassiez	Verb
participèrent	Verb
dérouleront	Verb
ballonné	Participle
nécessité	Participle
tonsuré	Participle
promené	Participle
décoré	Participle
transparaitront	Verb
édifier	Verb
risquera	Verb
administrerait	Verb
débarquèrent	Verb
réinvestissant	Participle
bénéficiât	Verb
divaguant	Participle
impressionnait	Verb
énervant	Participle
priveraient	Verb
cumulera	Verb
débinera	Verb
houerez	Verb
pist	Verb
assembla	Verb
fusaient	Verb
songerait	Verb
appartenant	Participle
baraz	Verb
respecterait	Verb
blasâtes	Verb
fabriqueront	Verb
déprogrammer	Verb
daubé	Participle
contresigné	Participle
inspireront	Verb
émigreront	Verb
rayonné	Participle
coniurerai	Verb
confire	Verb
épongeaient	Verb
enrayé	Participle
surtitré	Participle
assemblant	Participle
rognant	Participle
glaisassiez	Verb
solvaté	Participle
méprisant	Participle
câblasses	Verb
étalonnâtes	Verb
minait	Verb
regarnir	Verb
considerant	Participle
rallieraient	Verb
maximisant	Participle
suivrons	Verb
grillaient	Verb
ridiculiser	Verb
accédèrent	Verb
parler	Verb
communes	Verb
individualisant	Participle
redéposerai	Verb
élançait	Verb
fleurdelisant	Participle
chiffrerait	Verb
vibrait	Verb
envouté	Participle
gominera	Verb
sautillant	Participle
zappas	Verb
délirer	Verb
focalisait	Verb
obtiendras	Verb
inclure	Verb
cherchant	Participle
rectifiant	Participle
réveilleront	Verb
éternisait	Verb
espleiz	Verb
hypnotisant	Participle
compleindriiez	Verb
obéré	Participle
raccourcissait	Verb
réfugia	Verb
gracias	Verb
obéi	Participle
boursicotassent	Verb
raenchonneriez	Verb
médiatisant	Participle
refaire	Verb
contestera	Verb
brandir	Verb
accentua	Verb
occulter	Verb
relièrent	Verb
tranprera	Verb
ébattant	Participle
remontait	Verb
provoquant	Participle
apostrophant	Participle
amena	Verb
subordonnant	Participle
devisant	Participle
convergera	Verb
échouaient	Verb
calculé	Participle
gravita	Verb
cumuler	Verb
affrontant	Participle
scindait	Verb
amuserait	Verb
terrassa	Verb
perd	Verb
minimisant	Participle
adopteront	Verb
revisiter	Verb
effaroucheraient	Verb
metra	Verb
indexa	Verb
caça	Verb
existera	Verb
represantoies	Verb
embrochai	Verb
sédentarisant	Participle
délaissait	Verb
tisât	Verb
faiblissait	Verb
cueillissions	Verb
académisâmes	Verb
impartir	Verb
mineras	Verb
roter	Verb
satiné	Participle
déménager	Verb
retirer	Verb
réuniraient	Verb
supai	Verb
fusillait	Verb
combinait	Verb
enterrasse	Verb
fondas	Verb
postsynchronisât	Verb
évoqua	Verb
gauchi	Participle
suspendirent	Verb
bordé	Participle
italianisant	Participle
rétractera	Verb
engobai	Verb
remetre	Verb
expulser	Verb
théorisant	Participle
compassionnerons	Verb
ambitionné	Participle
assassinait	Verb
endommagèrent	Verb
ressuscitait	Verb
structura	Verb
duteroit	Verb
outré	Participle
souciaient	Verb
siphonné	Participle
emboiter	Verb
empalé	Participle
apprivoisant	Participle
conjecturer	Verb
dînaient	Verb
affirmeront	Verb
rêvasser	Verb
aminci	Participle
apparaitre	Verb
codifiant	Participle
accueillirent	Verb
estropier	Verb
navalisai	Verb
desfier	Verb
recoiffassent	Verb
inquièterons	Verb
grisonner	Verb
ingénié	Participle
topographier	Verb
acclamer	Verb
jacta	Verb
chuteront	Verb
vocifèreriez	Verb
élabora	Verb
gronder	Verb
sanctionnerait	Verb
cèderont	Verb
donneraient	Verb
conspua	Verb
suffiraient	Verb
exclu	Participle
adressant	Participle
évoqueront	Verb
accouchant	Participle
attribué	Participle
transfèrera	Verb
séduirez	Verb
bénéficiera	Verb
baptisissoiz	Verb
dansait	Verb
bloquerai	Verb
façonnera	Verb
vaciller	Verb
réjoui	Participle
dénombré	Participle
terminait	Verb
nuançant	Participle
déchiqueter	Verb
fulminé	Participle
tabula	Verb
rapprocheraient	Verb
défenestrassions	Verb
ronronnant	Participle
honorerait	Verb
returnai	Verb
réexamina	Verb
bénéficiant	Participle
conquestassions	Verb
contribuerai	Verb
exercera	Verb
inciteraient	Verb
désobéir	Verb
déconseiller	Verb
surplomberiez	Verb
savonner	Verb
cristallisa	Verb
authentiquaient	Verb
restaurer	Verb
afublissons	Verb
asphalté	Participle
desevroit	Verb
laisseraient	Verb
appelleraient	Verb
entonné	Participle
réouvriront	Verb
boursouflé	Participle
rassortirait	Verb
rôdant	Participle
défonçant	Participle
ornaient	Verb
riboterons	Verb
dirigea	Verb
tagueriez	Verb
radotassiez	Verb
listant	Participle
mâter	Verb
emménagèrent	Verb
christianisa	Verb
affutera	Verb
composerait	Verb
sius	Verb
acquittant	Participle
assura	Verb
désencombrèrent	Verb
ralliera	Verb
tacha	Verb
savonneras	Verb
égaré	Participle
replantèrent	Verb
brassé	Participle
imprégnant	Participle
parla	Verb
encasernèrent	Verb
gout	Verb
délimitant	Participle
accommodaient	Verb
accoururent	Verb
rechigner	Verb
ridât	Verb
endetta	Verb
revivront	Verb
érotiserons	Verb
acclamera	Verb
encercheroiz	Verb
creusa	Verb
désherbé	Participle
driller	Verb
menait	Verb
répondant	Participle
empilé	Participle
satinant	Participle
herborisa	Verb
quadrillant	Participle
expérimentèrent	Verb
évadé	Participle
guerroyait	Verb
transgressa	Verb
frayant	Participle
sublimer	Verb
transcrire	Verb
assiéger	Verb
divulgua	Verb
jalonner	Verb
amènerons	Verb
fend	Verb
végétaliser	Verb
désespéra	Verb
libérèrent	Verb
becquerons	Verb
cert	Verb
commenceront	Verb
préférer	Verb
fendit	Verb
portraiturer	Verb
présupposé	Participle
neutralisera	Verb
embarrasser	Verb
convertir	Verb
épicé	Participle
piler	Verb
filtrera	Verb
opprimait	Verb
resisteroit	Verb
déclassai	Verb
accommodera	Verb
abreuvé	Participle
engendré	Participle
ameublir	Verb
ralenti	Participle
capitulant	Participle
complétait	Verb
chamboulâtes	Verb
traînassèrent	Verb
viabiliser	Verb
refondirent	Verb
estachast	Verb
analysé	Participle
lèverai	Verb
soumissionner	Verb
sonneront	Verb
vicia	Verb
examiné	Participle
composterait	Verb
crédibiliserons	Verb
disséminèrent	Verb
cela	Verb
écorniflerons	Verb
anuierai	Verb
levait	Verb
sollicitèrent	Verb
zézayé	Participle
incorporant	Participle
émusse	Verb
subodoré	Participle
croupissant	Participle
reprendra	Verb
étalera	Verb
mimaient	Verb
nacreras	Verb
affranchissant	Participle
possédaient	Verb
ordonnèrent	Verb
aspiraient	Verb
canjant	Participle
manœuvré	Participle
découragerai	Verb
décoder	Verb
visitaient	Verb
coopéraient	Verb
validé	Participle
différencieront	Verb
épousait	Verb
acta	Verb
symboliserions	Verb
récitant	Participle
réenregistra	Verb
reculerait	Verb
cosignait	Verb
opina	Verb
descendrait	Verb
élucidé	Participle
courut	Verb
étayèrent	Verb
alphabétisé	Participle
enchanter	Verb
sabordèrent	Verb
dira	Verb
doing	Verb
défenestré	Participle
affréter	Verb
andureriiens	Verb
trouvâmes	Verb
persisterons	Verb
méritait	Verb
tâta	Verb
fissurant	Participle
loucher	Verb
demeurait	Verb
diviniser	Verb
contrediront	Verb
annoncerait	Verb
copierez	Verb
moucherons	Verb
discréditant	Participle
ratant	Participle
empêcherai	Verb
extériorisât	Verb
enorgueillissaient	Verb
prodiguaient	Verb
retoucheriez	Verb
bouchait	Verb
compacta	Verb
publièrent	Verb
hypnotisâtes	Verb
échangera	Verb
réfracter	Verb
réinstalla	Verb
descuvrerai	Verb
maraboutas	Verb
comblé	Participle
contacta	Verb
creuser	Verb
sangloter	Verb
frotasses	Verb
mérita	Verb
manquerai	Verb
arqueriez	Verb
poissé	Participle
vales	Verb
allégeait	Verb
acceptant	Participle
transformera	Verb
balkanisé	Participle
œuvrer	Verb
infectant	Participle
lâchèrent	Verb
recevaient	Verb
franciser	Verb
décrédibiliser	Verb
dissoudra	Verb
construirons	Verb
unifierez	Verb
apaisèrent	Verb
persuadera	Verb
mandata	Verb
succomber	Verb
timbrer	Verb
risquèrent	Verb
laissa	Verb
lustra	Verb
implosé	Participle
engazonné	Participle
gaudant	Participle
capté	Participle
raina	Verb
comparerait	Verb
bouleversant	Participle
inhaler	Verb
accourut	Verb
adorerait	Verb
déposerai	Verb
redécouvraient	Verb
annonçait	Verb
nationalisait	Verb
reclamer	Verb
priser	Verb
émailler	Verb
brees	Verb
bluffant	Participle
avançait	Verb
renia	Verb
embêterait	Verb
envoyant	Participle
éternisé	Participle
attelaient	Verb
factura	Verb
alunasse	Verb
gonflèrent	Verb
caressant	Participle
remez	Verb
récidiver	Verb
rassurant	Participle
assit	Verb
évoquera	Verb
réhydrater	Verb
diverti	Participle
hissant	Participle
composait	Verb
plaisanta	Verb
soulever	Verb
paraîtrez	Verb
caricaturant	Participle
rebourrait	Verb
recensaient	Verb
relaterait	Verb
flexibilisa	Verb
pleuvoir	Verb
rebutaient	Verb
annoter	Verb
régnait	Verb
coïncider	Verb
tercera	Verb
acoupla	Verb
accosta	Verb
concurrencer	Verb
forssenerai	Verb
attendre	Verb
recadrer	Verb
intriguait	Verb
commanderont	Verb
sanglas	Verb
remblayassions	Verb
scolariseras	Verb
abîmait	Verb
solubiliser	Verb
écroué	Participle
bruma	Verb
sédimenter	Verb
atterrissant	Participle
remobilisé	Participle
fixa	Verb
planait	Verb
retenter	Verb
conservât	Verb
braconné	Participle
stalinisas	Verb
fructifié	Participle
combiner	Verb
inséraient	Verb
faiblissaient	Verb
séparaient	Verb
patoisasse	Verb
retranchèrent	Verb
planifiant	Participle
mentant	Participle
anus	Verb
avantagé	Participle
ovationné	Participle
débloquant	Participle
discerner	Verb
baugeâtes	Verb
déferla	Verb
harra	Verb
insulter	Verb
gratta	Verb
toquer	Verb
musclé	Participle
arrérageaient	Verb
substitueront	Verb
détectèrent	Verb
désireraient	Verb
éveillaient	Verb
palpant	Participle
clignait	Verb
résumé	Participle
aventurera	Verb
héroïseront	Verb
poileriez	Verb
pikas	Verb
figea	Verb
rendissent	Verb
faussé	Participle
caser	Verb
surnommerai	Verb
volatiliser	Verb
prêtèrent	Verb
avèrerait	Verb
surédifiera	Verb
offriront	Verb
tressé	Participle
commençât	Verb
assommant	Participle
dérouleraient	Verb
freinèrent	Verb
vivotant	Participle
désennuyassent	Verb
sombrera	Verb
hachurant	Participle
nargué	Participle
déblatérâtes	Verb
titularisait	Verb
edifias	Verb
overbookâmes	Verb
boiterions	Verb
vandaliser	Verb
démissionner	Verb
copieras	Verb
confinerai	Verb
secourut	Verb
échappé	Participle
preias	Verb
renforçant	Participle
dépend	Verb
délivrant	Participle
retrouvé	Participle
orthogonaliseraient	Verb
hucher	Verb
désinstalleriez	Verb
resterait	Verb
rencontrai	Verb
infesté	Participle
mécontenterez	Verb
souhaitait	Verb
vez	Verb
empourpreras	Verb
atomiser	Verb
patientassiez	Verb
proliférèrent	Verb
consentissent	Verb
misait	Verb
présentassent	Verb
conçut	Verb
jaspé	Participle
exprimant	Participle
réhabilita	Verb
espuserons	Verb
effacera	Verb
psalmodier	Verb
posséder	Verb
prévirent	Verb
catché	Participle
considéraient	Verb
assisté	Participle
nécessitera	Verb
illusionnerai	Verb
ondoyant	Participle
tond	Verb
pressera	Verb
disconvinsse	Verb
chorégraphierez	Verb
figer	Verb
proportionneront	Verb
stimulé	Participle
eurt	Verb
recalé	Participle
massa	Verb
guaita	Verb
louchèrent	Verb
baleiné	Participle
augmentèrent	Verb
aciérai	Verb
affirmé	Participle
sédimenté	Participle
purifiait	Verb
tourmenté	Participle
cassera	Verb
redirigea	Verb
operas	Verb
renta	Verb
structurera	Verb
déposséder	Verb
garbelassent	Verb
estrainsimes	Verb
limogeassiez	Verb
démolissant	Participle
commuant	Participle
mentionnasse	Verb
affectèrent	Verb
désolèrent	Verb
urina	Verb
initier	Verb
essaya	Verb
bouler	Verb
placardisé	Participle
entamé	Participle
voudrait	Verb
suborner	Verb
entrainèrent	Verb
alertant	Participle
résignai	Verb
regretterai	Verb
pratiqué	Participle
transfusé	Participle
éclaircirait	Verb
démoli	Participle
profita	Verb
nécessiterait	Verb
crédibiliser	Verb
bricolé	Participle
enduire	Verb
renouait	Verb
désosser	Verb
stérilisant	Participle
bigler	Verb
coopéré	Participle
scotchant	Participle
zappant	Participle
pétitionnant	Participle
oras	Verb
redonnant	Participle
cuyderoit	Verb
comprendrez	Verb
rouvrir	Verb
légiféra	Verb
interpénétrant	Participle
intuber	Verb
prescrivirent	Verb
scolarisant	Participle
enfermaient	Verb
espost	Verb
recroisant	Participle
collera	Verb
accomplir	Verb
incombant	Participle
baisseront	Verb
englobaient	Verb
cheminé	Participle
temporisasses	Verb
résignant	Participle
reconstruisant	Participle
substituant	Participle
soufrerions	Verb
immobilisèrent	Verb
personnalisé	Participle
balancer	Verb
approvisionné	Participle
retombera	Verb
décompilerait	Verb
preieient	Verb
récusé	Participle
méfiaient	Verb
remporterait	Verb
obligerait	Verb
cuntenir	Verb
décapitalisâtes	Verb
consommeraient	Verb
gracier	Verb
giflant	Participle
dégénérer	Verb
hardira	Verb
refermant	Participle
étagé	Participle
plafonna	Verb
vochoient	Verb
empocha	Verb
ancrait	Verb
enclavant	Participle
retravailler	Verb
épilerions	Verb
compliquèrent	Verb
bistras	Verb
brillèrent	Verb
sillonné	Participle
gala	Verb
ressert	Verb
disparaitre	Verb
élèverait	Verb
bêchevetant	Participle
retomber	Verb
chevauchierez	Verb
connaitrait	Verb
construisaient	Verb
retombaient	Verb
esté	Participle
égarer	Verb
parviendrons	Verb
interjeta	Verb
impressionnèrent	Verb
retrouveras	Verb
intitulant	Participle
diffracter	Verb
refermé	Participle
subodorerai	Verb
affronteront	Verb
ornementer	Verb
écroulera	Verb
herboriser	Verb
allouer	Verb
pratiquât	Verb
pastiché	Participle
pourrissait	Verb
soupirera	Verb
cliquera	Verb
réévaluant	Participle
attardant	Participle
articulé	Participle
empilant	Participle
tutoyé	Participle
remerciant	Participle
connaitra	Verb
risquerait	Verb
voulaient	Verb
formaliser	Verb
omit	Verb
goûtant	Participle
récidivé	Participle
bouter	Verb
rendormîmes	Verb
hachurasse	Verb
policer	Verb
entrouvrant	Participle
disperser	Verb
brandissant	Participle
positionnera	Verb
exilé	Participle
commutant	Participle
déprenant	Participle
illuminer	Verb
paressant	Participle
espoigniens	Verb
régenter	Verb
entrainant	Participle
marchait	Verb
misses	Verb
toisant	Participle
ballota	Verb
consolait	Verb
charpenterait	Verb
défolié	Participle
temporisant	Participle
coutera	Verb
inculpant	Participle
effondrait	Verb
dépaysant	Participle
avachi	Participle
industrialisant	Participle
grappillé	Participle
raccordé	Participle
trainé	Participle
segmenté	Participle
renflant	Participle
vêt	Verb
groupa	Verb
alarmer	Verb
oeuvré	Participle
désensibilisant	Participle
recrutaient	Verb
nitratâmes	Verb
employait	Verb
résilier	Verb
rebiffer	Verb
accepterez	Verb
conditionnait	Verb
désoxydant	Participle
matraqué	Participle
classait	Verb
défendant	Participle
étiqueter	Verb
évoquer	Verb
fauté	Participle
apprêta	Verb
facetterons	Verb
recumença	Verb
bigarrât	Verb
estiva	Verb
pénalisant	Participle
firent	Verb
régresser	Verb
enneigé	Participle
savourait	Verb
potentialiserait	Verb
aventuras	Verb
pesté	Participle
zappa	Verb
tâchaient	Verb
rupa	Verb
riper	Verb
coffrer	Verb
impatienté	Participle
réalimentera	Verb
boirai	Verb
aunerai	Verb
interpreter	Verb
différencier	Verb
révèlera	Verb
inséré	Participle
consacrèrent	Verb
spiralât	Verb
cura	Verb
engameras	Verb
expatriant	Participle
dégivrai	Verb
entachant	Participle
handicapera	Verb
arrentèrent	Verb
annihiler	Verb
fermenter	Verb
enregistré	Participle
embrasa	Verb
décrasser	Verb
plumé	Participle
rinçant	Participle
entretinrent	Verb
massant	Participle
francisait	Verb
adoptant	Participle
influencerait	Verb
redessinait	Verb
defublera	Verb
acculant	Participle
loupâmes	Verb
lévitèrent	Verb
étançonnerons	Verb
basait	Verb
autodétruira	Verb
concernera	Verb
prévalu	Participle
alloué	Participle
aboutir	Verb
hybridait	Verb
dressé	Participle
attristant	Participle
réexaminé	Participle
colt	Verb
rentra	Verb
santis	Verb
baignaient	Verb
survêtissions	Verb
governassent	Verb
figureront	Verb
censuré	Participle
craindra	Verb
élèvera	Verb
confirma	Verb
chaungeriiens	Verb
déconseilla	Verb
musarder	Verb
égorger	Verb
gesticuler	Verb
réduisant	Participle
participaient	Verb
canadianisassions	Verb
aboucher	Verb
réclamait	Verb
osé	Participle
charabia	Verb
facturé	Participle
débarrassant	Participle
apostasia	Verb
avaleraient	Verb
harponnas	Verb
tueraient	Verb
heurtait	Verb
resurgît	Verb
activaient	Verb
dénudèrent	Verb
supprimerai	Verb
blâmer	Verb
doublerait	Verb
pimentait	Verb
dissimulant	Participle
soudait	Verb
réitéré	Participle
quadruplé	Participle
amnistier	Verb
suppliera	Verb
rapprochât	Verb
aprenoient	Verb
fonça	Verb
enferma	Verb
divulgué	Participle
doutasse	Verb
prendront	Verb
surnageant	Participle
inaugureront	Verb
survivre	Verb
incluant	Participle
festineras	Verb
persister	Verb
fournira	Verb
demandèrent	Verb
flambait	Verb
foisonnaient	Verb
immergeant	Participle
amuïr	Verb
rectifia	Verb
escompter	Verb
farci	Participle
entourlouper	Verb
reprochèrent	Verb
distrayait	Verb
dépisté	Participle
putrifïé	Participle
aplani	Participle
enjoignant	Participle
émancipant	Participle
assassinera	Verb
reverrez	Verb
informerait	Verb
nourrir	Verb
illustraient	Verb
abhorré	Participle
redurent	Verb
mordillant	Participle
enclosasse	Verb
remit	Verb
admira	Verb
répétait	Verb
tourbillonner	Verb
embûchai	Verb
fabriquerait	Verb
introduisit	Verb
décarcasser	Verb
agaça	Verb
brandissaient	Verb
vomi	Participle
apportai	Verb
confisqua	Verb
suralimentaient	Verb
formata	Verb
figurant	Participle
aquerra	Verb
retiendrai	Verb
ridiculisa	Verb
positionnait	Verb
septuplé	Participle
terças	Verb
escaufoies	Verb
cerner	Verb
animalisant	Participle
couvoiteroiz	Verb
désorbé	Participle
bleuir	Verb
blanchirai	Verb
égarant	Participle
braquant	Participle
prisé	Participle
débloquerai	Verb
troublé	Participle
mijoter	Verb
phrasé	Participle
patina	Verb
disséquant	Participle
rainurer	Verb
déversa	Verb
dressera	Verb
scruter	Verb
influaient	Verb
vangeriiens	Verb
colonisera	Verb
relevait	Verb
lika	Verb
répudia	Verb
dépendrait	Verb
retournassent	Verb
fomentait	Verb
itéré	Participle
tucheroit	Verb
abuserait	Verb
concrétisant	Participle
commettra	Verb
former	Verb
raisonné	Participle
circonstancié	Participle
réfléchiraient	Verb
génèrerait	Verb
dérobèrent	Verb
déprimant	Participle
devait	Verb
concourir	Verb
consommeras	Verb
admonesté	Participle
ayderoit	Verb
résultant	Participle
insurgé	Participle
figé	Participle
réaménagea	Verb
interpelait	Verb
apprécieront	Verb
soupeser	Verb
horrifiait	Verb
véhiculant	Participle
culbuté	Participle
recharger	Verb
cers	Verb
exténuant	Participle
débordé	Participle
débouta	Verb
clairsemaient	Verb
contint	Verb
lobasse	Verb
restât	Verb
accroître	Verb
écoutèrent	Verb
remplacerai	Verb
tochasses	Verb
ovra	Verb
terroriser	Verb
dimériser	Verb
encenser	Verb
contrôlerai	Verb
grasseyé	Participle
éperonnâtes	Verb
tuilé	Participle
avoglerons	Verb
émietter	Verb
authentifièrent	Verb
bottant	Participle
doives	Verb
arasèrent	Verb
dépenser	Verb
atterrir	Verb
ronproie	Verb
classaient	Verb
fabriquèrent	Verb
attestera	Verb
coti	Participle
suffoquer	Verb
fragmentant	Participle
désapprend	Verb
dépurassions	Verb
vacciné	Participle
lièrent	Verb
arboras	Verb
recercerai	Verb
offrirent	Verb
compliquer	Verb
économiser	Verb
intervinssent	Verb
essaimer	Verb
expertiser	Verb
préparèrent	Verb
bina	Verb
réconcilieront	Verb
allègera	Verb
choqua	Verb
subsisterez	Verb
mâteront	Verb
descrïeroit	Verb
requérait	Verb
repend	Verb
consistaient	Verb
emboutir	Verb
transpirant	Participle
délier	Verb
escamotait	Verb
gaver	Verb
garderait	Verb
sillonnaient	Verb
agirai	Verb
massacra	Verb
commercialiseront	Verb
bâti	Participle
sera	Verb
culant	Participle
enconvenençasses	Verb
scroller	Verb
préexister	Verb
barbarouffas	Verb
cheminait	Verb
auscultant	Participle
réactiva	Verb
chauffé	Participle
circonscrire	Verb
assoupît	Verb
tuna	Verb
introduira	Verb
exposant	Participle
triché	Participle
polissonnassions	Verb
coûtait	Verb
produisant	Participle
agressèrent	Verb
octaviera	Verb
ramona	Verb
tirèrent	Verb
redémarrer	Verb
défaisaient	Verb
réverbéras	Verb
négociait	Verb
shoota	Verb
commissionnèrent	Verb
électrisant	Participle
hosterons	Verb
ligaturer	Verb
ennoyâtes	Verb
crayonné	Participle
dépénalisant	Participle
robé	Participle
éveilleront	Verb
infliger	Verb
ouvrer	Verb
ghettoïserions	Verb
contenaient	Verb
échaudé	Participle
inclinerai	Verb
claustré	Participle
rêvé	Participle
foundas	Verb
apparier	Verb
dégelé	Participle
clappât	Verb
lessiver	Verb
continuèrent	Verb
cordé	Participle
approfondi	Participle
repérant	Participle
culminait	Verb
sourcerai	Verb
intimider	Verb
étudia	Verb
répandrons	Verb
omet	Verb
pourri	Participle
arnaquer	Verb
éloigné	Participle
retomberont	Verb
torréfier	Verb
militait	Verb
capitulait	Verb
toiser	Verb
survécut	Verb
optant	Participle
taquiner	Verb
huma	Verb
écharpé	Participle
cria	Verb
suspendit	Verb
éditèrent	Verb
geller	Verb
désappointerons	Verb
admonesterions	Verb
décrépirez	Verb
africanisant	Participle
réparaient	Verb
esmaiassent	Verb
alloua	Verb
banaliseras	Verb
numeroient	Verb
cunfortissoiz	Verb
enclouer	Verb
défiaient	Verb
capturant	Participle
rationnera	Verb
dénudé	Participle
occlurait	Verb
provisionneriez	Verb
empierrer	Verb
servirent	Verb
commandé	Participle
redescendre	Verb
conseillier	Verb
déboutonné	Participle
extirper	Verb
feignit	Verb
légiférer	Verb
structurer	Verb
pestant	Participle
débâclassent	Verb
trotta	Verb
ébruitèrent	Verb
intimidant	Participle
entraînait	Verb
doctrines	Verb
requit	Verb
réanimé	Participle
forcé	Participle
leicher	Verb
patrouilla	Verb
solarisât	Verb
diversifia	Verb
connecterait	Verb
décrédibilisant	Participle
délibérer	Verb
ravitaillaient	Verb
attribueront	Verb
dérailla	Verb
excavé	Participle
échelonné	Participle
enduisait	Verb
dégoudronnerait	Verb
moussa	Verb
baguer	Verb
communicquerions	Verb
empailleront	Verb
confieront	Verb
dégotter	Verb
étamait	Verb
coustera	Verb
distancié	Participle
ventiler	Verb
prévenu	Participle
scrolleras	Verb
dériveraient	Verb
improvisaient	Verb
aidèrent	Verb
réorganiser	Verb
molant	Participle
décroît	Verb
adorer	Verb
murmurer	Verb
désenchanterez	Verb
bruni	Participle
flambant	Participle
pagayera	Verb
aduba	Verb
espacé	Participle
redeviendra	Verb
anoblissait	Verb
retailleriiens	Verb
collerai	Verb
échapperas	Verb
rissolé	Participle
investissait	Verb
construirait	Verb
surabondant	Participle
subvient	Verb
policé	Participle
permirent	Verb
tané	Participle
appareillait	Verb
positiverai	Verb
déchoyant	Participle
pendirent	Verb
enveiereit	Verb
réengazonneriez	Verb
labialisé	Participle
amortiriez	Verb
pardonna	Verb
excita	Verb
concoctant	Participle
azimuteriez	Verb
rétablissait	Verb
effaçaient	Verb
parvînt	Verb
relocalisé	Participle
triomphant	Participle
fissurer	Verb
dérivé	Participle
mandater	Verb
démarré	Participle
affrontera	Verb
formater	Verb
frictionnâtes	Verb
abala	Verb
fournirai	Verb
surpeuplé	Participle
exilant	Participle
transhumant	Participle
accidentai	Verb
trahir	Verb
découvrir	Verb
jouseriez	Verb
cota	Verb
empescherons	Verb
écopé	Participle
impulsa	Verb
écrivant	Participle
voisinaient	Verb
remontrait	Verb
siérait	Verb
réclamer	Verb
tuba	Verb
éclôt	Verb
raconterai	Verb
inondait	Verb
retremper	Verb
languiras	Verb
dédoubla	Verb
chanterons	Verb
prédominaient	Verb
obligeait	Verb
composta	Verb
émettre	Verb
pâli	Participle
recrutait	Verb
grésillerons	Verb
décryptât	Verb
exhibaient	Verb
corroboré	Participle
léguèrent	Verb
palliait	Verb
revêtirent	Verb
warda	Verb
abolira	Verb
intéressera	Verb
discutait	Verb
tumbas	Verb
évoquaient	Verb
quassant	Participle
separer	Verb
patientera	Verb
cumulerait	Verb
feulassiez	Verb
cessera	Verb
invitait	Verb
glorifiant	Participle
dégénérèrent	Verb
considèrerai	Verb
résolut	Verb
traînaient	Verb
dédouanerait	Verb
compacterons	Verb
incisaient	Verb
conserveraient	Verb
dissocia	Verb
effilé	Participle
traversé	Participle
estivant	Participle
agrémentaient	Verb
bousculaient	Verb
détendant	Participle
accepter	Verb
réinterprétant	Participle
galvaudé	Participle
confectionner	Verb
varias	Verb
hérité	Participle
grouillant	Participle
fertiliserons	Verb
gambadant	Participle
sous-alimentèrent	Verb
restituèrent	Verb
toileraient	Verb
avachît	Verb
peuplé	Participle
prétendirent	Verb
dépanné	Participle
fédéra	Verb
substituaient	Verb
ioniser	Verb
indiquerez	Verb
assassiner	Verb
fallût	Verb
dévidait	Verb
plaisantant	Participle
moralisé	Participle
maintiendraient	Verb
apposèrent	Verb
requérant	Participle
confirmer	Verb
encorder	Verb
connaîtra	Verb
réaffirmait	Verb
assurât	Verb
quadrupler	Verb
quereller	Verb
présidait	Verb
diffamé	Participle
rentrerait	Verb
déniait	Verb
tempter	Verb
structuraient	Verb
apeurer	Verb
alkyleriez	Verb
baugera	Verb
déploya	Verb
estimeraient	Verb
alourdir	Verb
améliorèrent	Verb
kifa	Verb
confectionna	Verb
externalisé	Participle
revendiquera	Verb
conviendrai	Verb
culpabilisé	Participle
coécrivit	Verb
dévorera	Verb
décloueront	Verb
tiserez	Verb
irriguant	Participle
réjouirent	Verb
perdre	Verb
biner	Verb
démordre	Verb
banalisé	Participle
éluant	Participle
sourire	Verb
mentir	Verb
appréhendera	Verb
cheminant	Participle
estimerez	Verb
warranteront	Verb
centralisera	Verb
préjugeant	Participle
existerait	Verb
renoncera	Verb
raréfiant	Participle
reprît	Verb
réemployant	Participle
supplantèrent	Verb
borda	Verb
uniformiser	Verb
binant	Participle
percevrait	Verb
égalait	Verb
runja	Verb
dénotait	Verb
gérait	Verb
criendront	Verb
croisant	Participle
collationné	Participle
déboucha	Verb
remplissant	Participle
cumandas	Verb
estimerai	Verb
assiégeaient	Verb
tablaient	Verb
affaira	Verb
magouillerez	Verb
gonflera	Verb
répondu	Participle
solliciterait	Verb
brailler	Verb
tassé	Participle
accompli	Participle
défrayaient	Verb
convoyer	Verb
admirerai	Verb
jeûnera	Verb
récriraient	Verb
empailler	Verb
piégé	Participle
consoleront	Verb
réagiraient	Verb
répertoria	Verb
déposer	Verb
préféra	Verb
erigeassiez	Verb
sapures	Verb
incombé	Participle
justifieront	Verb
anglicisant	Participle
chassa	Verb
camerons	Verb
enfiévré	Participle
dupa	Verb
alimenteriez	Verb
recalai	Verb
carboniser	Verb
masquas	Verb
opéraient	Verb
empoissonné	Participle
autoanalysassiez	Verb
ramait	Verb
soupçonner	Verb
prêchait	Verb
souler	Verb
constateras	Verb
retourneront	Verb
titrant	Participle
correçast	Verb
effroiissoiz	Verb
apurer	Verb
infusé	Participle
circula	Verb
espérant	Participle
déplacerai	Verb
resplendissant	Participle
haces	Verb
allumèrent	Verb
réinsérâtes	Verb
déchausser	Verb
accumula	Verb
posé	Participle
ternirent	Verb
compacter	Verb
administraient	Verb
cafté	Participle
jasper	Verb
surchauffé	Participle
surenchérir	Verb
échangeait	Verb
décrochera	Verb
redessina	Verb
succomberas	Verb
démonétisé	Participle
dominera	Verb
protégèrent	Verb
contrariait	Verb
resemblai	Verb
polytyperiez	Verb
encouragèrent	Verb
persiflera	Verb
mentionnerai	Verb
attirera	Verb
régaler	Verb
affermé	Participle
trompera	Verb
sonorisé	Participle
écorner	Verb
recroisé	Participle
remotiverait	Verb
renierait	Verb
veillerai	Verb
transférait	Verb
signalisassent	Verb
refonctionner	Verb
engouffré	Participle
prédestinait	Verb
communerent	Verb
qualifierait	Verb
poquâtes	Verb
demanderait	Verb
renchérissent	Verb
incubé	Participle
morfondre	Verb
monopolisant	Participle
formulaient	Verb
statua	Verb
épicer	Verb
feront	Verb
bavai	Verb
serrai	Verb
corsant	Participle
syndiquant	Participle
décalcifié	Participle
bivouaqué	Participle
traiterons	Verb
acquéraient	Verb
décollètera	Verb
baisé	Participle
soupait	Verb
atterrirent	Verb
luxer	Verb
jumelé	Participle
entaché	Participle
rapeaus	Verb
empâté	Participle
réunir	Verb
traîner	Verb
évitaient	Verb
identifièrent	Verb
projeter	Verb
emménageront	Verb
démantelant	Participle
confirmaient	Verb
mordant	Participle
suffoqué	Participle
enroué	Participle
téléporté	Participle
jonchaient	Verb
récréer	Verb
formuler	Verb
réapprend	Verb
attrapait	Verb
violeraient	Verb
désenclavé	Participle
rebattissiez	Verb
abdiquant	Participle
promulguera	Verb
hydrogéner	Verb
gronda	Verb
galera	Verb
haiteroies	Verb
juxtaposant	Participle
auditionner	Verb
aromatisait	Verb
coud	Verb
cantonner	Verb
étayerions	Verb
centralisa	Verb
souffriraient	Verb
épousèrent	Verb
ébranlerez	Verb
descendras	Verb
naissant	Participle
chargeaient	Verb
disciplina	Verb
confrontant	Participle
rebout	Verb
mervellasse	Verb
masqué	Participle
subodorant	Participle
rogna	Verb
motoriseraient	Verb
zieutâmes	Verb
suz	Verb
fabriquant	Participle
affiner	Verb
interpreté	Participle
présumait	Verb
conduirait	Verb
conservaient	Verb
tormentames	Verb
dépérir	Verb
démentiront	Verb
centralisant	Participle
rejouer	Verb
empalant	Participle
délaisser	Verb
persécutant	Participle
clarifia	Verb
personnifiait	Verb
gomma	Verb
ambiançassent	Verb
photocopier	Verb
ramper	Verb
promettre	Verb
détaillerai	Verb
octroyé	Participle
luttèrent	Verb
rapportera	Verb
scintillaient	Verb
conseillait	Verb
mènera	Verb
soupesé	Participle
envouter	Verb
affabuler	Verb
querelerons	Verb
razziaient	Verb
métré	Participle
repassé	Participle
acompaigneroit	Verb
postulera	Verb
ferla	Verb
châtraient	Verb
gênai	Verb
distribuerait	Verb
relayé	Participle
ennuyait	Verb
entretoisaient	Verb
cernerez	Verb
bulla	Verb
voudroit	Verb
éclusé	Participle
guerroyaient	Verb
qualifiaient	Verb
contraignaient	Verb
opis	Verb
castra	Verb
apponter	Verb
bangnai	Verb
postulerions	Verb
dévêtu	Participle
actassions	Verb
réitèrera	Verb
environnant	Participle
prouvera	Verb
parachutant	Participle
surconduisissiez	Verb
enracina	Verb
bordas	Verb
rejoindront	Verb
déserteront	Verb
remixant	Participle
déjoué	Participle
fermerai	Verb
déporta	Verb
obtempèreront	Verb
distillé	Participle
appartiendraient	Verb
constellé	Participle
alléguait	Verb
concoures	Verb
exprimerai	Verb
tuchissons	Verb
renommèrent	Verb
concurrencerait	Verb
infestaient	Verb
affligeriez	Verb
souhaitai	Verb
sextuplé	Participle
intituler	Verb
adsorberions	Verb
habilitâtes	Verb
miraculasses	Verb
givrant	Participle
parquetassent	Verb
émaneraient	Verb
notai	Verb
flattaient	Verb
reposeraient	Verb
réussîtes	Verb
atendis	Verb
entêter	Verb
prépayé	Participle
considérât	Verb
franchi	Participle
retransférer	Verb
pénétrant	Participle
migreraient	Verb
neutralisaient	Verb
déficelai	Verb
carbonylerait	Verb
pardonnât	Verb
couvraient	Verb
radiorepérer	Verb
volleyeraient	Verb
posa	Verb
retransmettra	Verb
chantaient	Verb
léché	Participle
courrouçasse	Verb
gitai	Verb
accoté	Participle
boycotteraient	Verb
quintuplé	Participle
animas	Verb
consultaient	Verb
tramer	Verb
polychroma	Verb
picorer	Verb
habitait	Verb
attabler	Verb
recroisai	Verb
débilitant	Participle
estiquassent	Verb
lista	Verb
retaper	Verb
dédouaneras	Verb
sentant	Participle
persuada	Verb
descellât	Verb
donnerai	Verb
limant	Participle
coexister	Verb
confectionnait	Verb
circulé	Participle
équipaient	Verb
mesurer	Verb
tait	Verb
diminuera	Verb
consistera	Verb
subtilisé	Participle
apelé	Participle
ébrancha	Verb
empruntait	Verb
interviewa	Verb
revêtait	Verb
enjôlas	Verb
moquer	Verb
soumettrai	Verb
estomper	Verb
étuver	Verb
teignaient	Verb
lovera	Verb
tamponner	Verb
tirait	Verb
remuant	Participle
commentait	Verb
botta	Verb
retroussant	Participle
désarçonner	Verb
douté	Participle
feignaient	Verb
décollait	Verb
magnétoscopé	Participle
appâtant	Participle
paverions	Verb
audita	Verb
empêtrer	Verb
tablait	Verb
racoleraient	Verb
proviendrait	Verb
sanctifiant	Participle
poons	Verb
amenuisait	Verb
questionner	Verb
décourageant	Participle
enrayeriez	Verb
éclaboussé	Participle
grignotait	Verb
amorcer	Verb
convoitaient	Verb
traduisant	Participle
attisa	Verb
destituer	Verb
épicera	Verb
décevoir	Verb
révolutionnera	Verb
réélit	Verb
entraîner	Verb
florissant	Participle
argenter	Verb
débaucher	Verb
défavorisant	Participle
auseroient	Verb
départageant	Participle
culbuta	Verb
pilonner	Verb
marginalisa	Verb
enflammèrent	Verb
baissa	Verb
gueulé	Participle
subsisté	Participle
calquant	Participle
formaient	Verb
assurera	Verb
surclassaient	Verb
cunteroient	Verb
transféré	Participle
caressait	Verb
coordonnant	Participle
répugnant	Participle
enraciné	Participle
effrita	Verb
résoudra	Verb
agrémenter	Verb
assaillirent	Verb
happer	Verb
rompirent	Verb
sévissaient	Verb
explorait	Verb
embobinassions	Verb
japper	Verb
hisseraient	Verb
appétant	Participle
fructifier	Verb
engouffrassions	Verb
fléchas	Verb
serves	Verb
pronostiqué	Participle
habitant	Participle
tousser	Verb
étrécîmes	Verb
dépénaliser	Verb
suscitait	Verb
carbonisé	Participle
cachissons	Verb
trainaient	Verb
délassait	Verb
expulsera	Verb
recommençait	Verb
courbant	Participle
repolitisasses	Verb
fortifias	Verb
amenant	Participle
starifier	Verb
entourerait	Verb
organiserai	Verb
cogérer	Verb
révolutionnant	Participle
booker	Verb
fusilleront	Verb
dédramatiser	Verb
warrantassiez	Verb
additionné	Participle
décontracté	Participle
foles	Verb
mugir	Verb
conclurons	Verb
praesentasse	Verb
restituerait	Verb
candidater	Verb
décarburer	Verb
accompagneraient	Verb
désavoué	Participle
débaucha	Verb
exprimaient	Verb
ramollir	Verb
dampnastes	Verb
requérir	Verb
pond	Verb
récolteront	Verb
porras	Verb
clavarder	Verb
prétextait	Verb
ravirent	Verb
sacrifieront	Verb
désagrégé	Participle
constitutionnaliser	Verb
transformer	Verb
délesterai	Verb
proposer	Verb
dégringolé	Participle
photocopié	Participle
prêterai	Verb
consumant	Participle
essayer	Verb
errajoie	Verb
partit	Verb
décochant	Participle
arraisonnâtes	Verb
popularisé	Participle
hisseront	Verb
croulait	Verb
acidifier	Verb
dissipé	Participle
soigner	Verb
viciâtes	Verb
démené	Participle
programmaient	Verb
boycottait	Verb
entrainera	Verb
confinaient	Verb
incité	Participle
citerons	Verb
obérant	Participle
montrèrent	Verb
duraient	Verb
assombriras	Verb
pollué	Participle
harz	Verb
russifierions	Verb
intriguer	Verb
financeront	Verb
talonnait	Verb
chloroformeront	Verb
coloniseront	Verb
bosseler	Verb
saigner	Verb
recrutant	Participle
déformant	Participle
tara	Verb
concédèrent	Verb
échelonnaient	Verb
rent	Verb
bancquetoient	Verb
variaient	Verb
implorer	Verb
remplissaient	Verb
ingérait	Verb
entredéchirât	Verb
vaguer	Verb
confrontèrent	Verb
indigna	Verb
emmagasiné	Participle
reprenant	Participle
dût	Verb
désuni	Participle
obtiendront	Verb
levant	Participle
rendraient	Verb
continué	Participle
résistant	Participle
sentiraient	Verb
partagerait	Verb
avalisant	Participle
sécurisant	Participle
moulerez	Verb
instruira	Verb
abstiendrait	Verb
mystifier	Verb
ingérassiez	Verb
marquait	Verb
repoussaient	Verb
singeant	Participle
bivouaquèrent	Verb
comméraient	Verb
nomas	Verb
téléportant	Participle
caler	Verb
caroles	Verb
militèrent	Verb
légumiserons	Verb
trafiqué	Participle
foutrait	Verb
daté	Participle
revendront	Verb
forceraient	Verb
dépasseras	Verb
critiquer	Verb
appartînt	Verb
approvisionnèrent	Verb
tarifiassent	Verb
disclaimastes	Verb
entrèrent	Verb
aiguiser	Verb
coopérait	Verb
festoyé	Participle
échauderez	Verb
appartint	Verb
cryptaient	Verb
effeuillé	Participle
scandalisèrent	Verb
revenaient	Verb
manquait	Verb
fripâtes	Verb
rafraichissant	Participle
élaborait	Verb
allumera	Verb
sympathisaient	Verb
raturer	Verb
compulsé	Participle
délégua	Verb
revinrent	Verb
laminer	Verb
sachez	Verb
conçoit	Verb
dénichera	Verb
empiétait	Verb
renommait	Verb
ravageant	Participle
approximeriez	Verb
soupirassiez	Verb
començoie	Verb
beuglas	Verb
psychanalyseriez	Verb
écorné	Participle
retentir	Verb
montrera	Verb
livraient	Verb
caças	Verb
pilotant	Participle
dévirginiserait	Verb
influença	Verb
mirant	Participle
plâtrèrent	Verb
jetteraient	Verb
challengeassent	Verb
maté	Participle
documenté	Participle
américanisant	Participle
canadianiserons	Verb
inauguraient	Verb
décelait	Verb
impacterait	Verb
baptisèrent	Verb
caqueta	Verb
revécu	Participle
obstruerait	Verb
astreignait	Verb
humilia	Verb
élevant	Participle
privilégieront	Verb
réembaucher	Verb
caractériseraient	Verb
désirant	Participle
conférèrent	Verb
bredouiller	Verb
installeraient	Verb
tardassiez	Verb
confina	Verb
puisèrent	Verb
conreerent	Verb
crawler	Verb
calma	Verb
fluidifiant	Participle
arpentaient	Verb
vieillissait	Verb
corneta	Verb
polythéisèrent	Verb
fluidifier	Verb
condicionastes	Verb
fortifié	Participle
ceignit	Verb
désescaladé	Participle
phantastiquera	Verb
saumura	Verb
recourt	Verb
jalonnèrent	Verb
lâchait	Verb
appartiendront	Verb
sollicitait	Verb
hydratait	Verb
agressa	Verb
pardonneras	Verb
ballotté	Participle
engagerait	Verb
valideront	Verb
gouvernera	Verb
escher	Verb
développa	Verb
frottaient	Verb
permettrez	Verb
saisissant	Participle
magnas	Verb
conviait	Verb
précipiteraient	Verb
devenir	Verb
adot	Verb
répudier	Verb
bornerai	Verb
déplut	Verb
réunirait	Verb
sondèrent	Verb
surexposé	Participle
sauvegardas	Verb
crossèrent	Verb
avéraient	Verb
désinfecter	Verb
délivré	Participle
remariaient	Verb
perçait	Verb
asséné	Participle
aspergea	Verb
barras	Verb
sécréta	Verb
traqua	Verb
faibli	Participle
hackaient	Verb
tira	Verb
effrois	Verb
dépeindre	Verb
inscrire	Verb
parrainer	Verb
prophetizai	Verb
débandèrent	Verb
réutilisèrent	Verb
résoudront	Verb
treioies	Verb
cornetas	Verb
démultiplié	Participle
durcira	Verb
déjouai	Verb
contraria	Verb
fermé	Participle
harmoniser	Verb
mutinèrent	Verb
nouait	Verb
débouché	Participle
boycottaient	Verb
jouxtaient	Verb
habitua	Verb
retarderont	Verb
s'entredonneroient	Verb
sondé	Participle
abusa	Verb
refaçonné	Participle
géolocaliserait	Verb
éluai	Verb
découvriront	Verb
déjugé	Participle
sectionnant	Participle
handicapé	Participle
entamant	Participle
countoient	Verb
titubèrent	Verb
stoppé	Participle
prêchèrent	Verb
handicaper	Verb
éjectait	Verb
copieront	Verb
succombait	Verb
tressaillir	Verb
remarcheront	Verb
freinsistes	Verb
coiffé	Participle
enrobèrent	Verb
reposant	Participle
envisagea	Verb
poncer	Verb
transmissions	Verb
institutionnaliser	Verb
brïes	Verb
lacer	Verb
freinaient	Verb
contraindrait	Verb
consulteraient	Verb
inscrivant	Participle
monopoliser	Verb
paniquèrent	Verb
constataient	Verb
émancipa	Verb
interfacerai	Verb
boucha	Verb
bassinassiez	Verb
régulé	Participle
étudié	Participle
vénérer	Verb
échoué	Participle
brossé	Participle
randonnasse	Verb
denuncera	Verb
promirent	Verb
loupa	Verb
dirigeât	Verb
écorcer	Verb
revenchions	Verb
empêcheraient	Verb
pourvoirait	Verb
répondre	Verb
rebondissait	Verb
stipulait	Verb
incarnait	Verb
pilonné	Participle
calculèrent	Verb
rembarrasse	Verb
adviser	Verb
intervenu	Participle
provoquerions	Verb
stocker	Verb
tarderait	Verb
représenterait	Verb
soupçonné	Participle
cloitré	Participle
ridiculisé	Participle
arrangerai	Verb
punissaient	Verb
refusant	Participle
rattrapera	Verb
murmuraient	Verb
dépuré	Participle
déliterai	Verb
asséché	Participle
bousculé	Participle
balaya	Verb
dévastaient	Verb
peuplaient	Verb
ensuit	Verb
ajustera	Verb
caramélisé	Participle
bittâmes	Verb
restitua	Verb
épinerions	Verb
repasserait	Verb
écroulant	Participle
épiler	Verb
transcender	Verb
avalaient	Verb
immatricula	Verb
enrager	Verb
proclamé	Participle
skié	Participle
jugeraient	Verb
trebuchasse	Verb
revalorisa	Verb
collerait	Verb
retardant	Participle
franchissant	Participle
cunseilasse	Verb
tanner	Verb
décerner	Verb
intronisaient	Verb
combla	Verb
responsabilisé	Participle
fluctué	Participle
appréciera	Verb
bluffé	Participle
alliaient	Verb
narraient	Verb
câblé	Participle
laidengerez	Verb
soufflait	Verb
piétinait	Verb
chiquer	Verb
ricochant	Participle
chantait	Verb
déformerait	Verb
miraculasse	Verb
réfugier	Verb
fusionneront	Verb
considèrera	Verb
redirigé	Participle
surveillassiez	Verb
cumula	Verb
irrité	Participle
coïncideront	Verb
flottaient	Verb
activa	Verb
supprimeront	Verb
grommeler	Verb
zaperions	Verb
essaierons	Verb
emporterait	Verb
requirent	Verb
drapait	Verb
retirant	Participle
abstint	Verb
hospitaliserai	Verb
renommera	Verb
côtoyé	Participle
représenter	Verb
passerillèrent	Verb
inclinerait	Verb
indiqueraient	Verb
reconnaitra	Verb
descendit	Verb
guias	Verb
aseptiserions	Verb
structuré	Participle
rentabiliser	Verb
césarisé	Participle
fléchirons	Verb
paquera	Verb
exhuma	Verb
warder	Verb
éparpiller	Verb
téléverseraient	Verb
révoquant	Participle
dounerent	Verb
hériteront	Verb
communiquant	Participle
dérangeaient	Verb
pirouetteront	Verb
déambuler	Verb
dépendaient	Verb
lancer	Verb
décourageasses	Verb
parvinrent	Verb
survécurent	Verb
clamait	Verb
fuirent	Verb
éberlué	Participle
degastassent	Verb
concelant	Participle
exclamera	Verb
slalomant	Participle
esperer	Verb
camouflait	Verb
orbita	Verb
émanant	Participle
entraineront	Verb
réévalué	Participle
approuvaient	Verb
affirmerait	Verb
appliquaient	Verb
déjantant	Participle
voterait	Verb
adultérant	Participle
rot	Participle
orra	Verb
élanceront	Verb
réactivé	Participle
costa	Verb
doctrinerai	Verb
enquérant	Participle
converti	Participle
nivelait	Verb
disséminé	Participle
crawlassiez	Verb
basera	Verb
déroulerait	Verb
triant	Participle
répand	Verb
percuter	Verb
instaura	Verb
habituant	Participle
introduiraient	Verb
goudronnerait	Verb
arriveront	Verb
topographié	Participle
livreraient	Verb
conférer	Verb
surestimas	Verb
borné	Participle
désarticuler	Verb
relança	Verb
obligèrent	Verb
réapprenait	Verb
rapetisser	Verb
labellisèrent	Verb
concluaient	Verb
rétracté	Participle
rapai	Verb
bibelotasse	Verb
facilitèrent	Verb
créditera	Verb
morphologisaient	Verb
déclassé	Participle
brodassent	Verb
mélangera	Verb
reconquirent	Verb
poché	Participle
balançaient	Verb
assommer	Verb
ébouillanté	Participle
ublioient	Verb
grimaçant	Participle
marchanderaient	Verb
gazouiller	Verb
bénéficiassiez	Verb
cantonnaient	Verb
déblayeront	Verb
minimiserait	Verb
démaquilleriez	Verb
déliter	Verb
téléportassions	Verb
adreceroiz	Verb
réapparait	Verb
publierait	Verb
toléra	Verb
tricotant	Participle
écoutait	Verb
achetèrent	Verb
autonomiseront	Verb
dénommaient	Verb
perchâmes	Verb
dévia	Verb
refoulera	Verb
ralentiraient	Verb
châtier	Verb
girait	Verb
blasonnaient	Verb
encroûtant	Participle
ouvré	Participle
survenu	Participle
agglomérant	Participle
ridiculisèrent	Verb
séquestreront	Verb
cadençant	Participle
acculait	Verb
éreinté	Participle
béatifia	Verb
camouflé	Participle
esgara	Verb
parcourra	Verb
réprimèrent	Verb
gravèrent	Verb
certifieriez	Verb
déconfessionnalisassiez	Verb
situé	Participle
cambrioler	Verb
ferma	Verb
rechercher	Verb
égrené	Participle
intubé	Participle
pressuriser	Verb
déchaîneront	Verb
navigua	Verb
houspiller	Verb
coiffant	Participle
fraternisé	Participle
jouissant	Participle
épargnerait	Verb
incarnerait	Verb
fertilisant	Participle
dérivant	Participle
leva	Verb
ordonnant	Participle
chantonnant	Participle
répondront	Verb
continuant	Participle
inscrivisse	Verb
localisèrent	Verb
forcerait	Verb
loguer	Verb
étudiaient	Verb
roué	Participle
exila	Verb
ajourna	Verb
dénombra	Verb
soldèrent	Verb
démissionnera	Verb
dureriez	Verb
éduquèrent	Verb
goûtait	Verb
battissent	Verb
copiassent	Verb
peaufinerions	Verb
mousserons	Verb
dégoulinât	Verb
tarda	Verb
occulta	Verb
acclama	Verb
omettre	Verb
réfractant	Participle
marinas	Verb
desceller	Verb
verifié	Participle
fourvoyer	Verb
recommandaient	Verb
immigraient	Verb
élaborera	Verb
apitoyer	Verb
stationna	Verb
copiant	Participle
rembourser	Verb
cavit	Verb
implémentera	Verb
dérogeant	Participle
assaillant	Participle
resumé	Participle
scrabblasses	Verb
représenta	Verb
représentera	Verb
préparerait	Verb
reculleroit	Verb
géolocaliseriez	Verb
crevèrent	Verb
expliquerai	Verb
dénombraient	Verb
courriellassions	Verb
renvoyasses	Verb
vrillant	Participle
contesteront	Verb
livra	Verb
paser	Verb
chanterai	Verb
interloquaient	Verb
utiliseras	Verb
impliquerai	Verb
bidouiller	Verb
décernera	Verb
omettrez	Verb
quaillissons	Verb
englueras	Verb
aboya	Verb
triompheront	Verb
pulverizeroie	Verb
récoltaient	Verb
reconsolidâmes	Verb
trinquèrent	Verb
révéraient	Verb
basculèrent	Verb
mambré	Participle
occuperaient	Verb
concentraient	Verb
écrapoutirait	Verb
mariât	Verb
périclitant	Participle
ceignes	Verb
instruire	Verb
immergea	Verb
apprécierait	Verb
désavouait	Verb
engageaient	Verb
préfacé	Participle
enverrai	Verb
gèlerait	Verb
reconnaîtrait	Verb
équeuteras	Verb
éraillas	Verb
méritas	Verb
interviewer	Verb
dénommèrent	Verb
débarquait	Verb
costé	Participle
prémunissant	Participle
réservait	Verb
entêtait	Verb
débarrassé	Participle
sohaideroit	Verb
scandalisant	Participle
hanterait	Verb
relevèrent	Verb
émasculé	Participle
acclamaient	Verb
cèdera	Verb
poivrer	Verb
sponsorisassent	Verb
insurgea	Verb
reconstruisit	Verb
vouera	Verb
conciliant	Participle
obscurcissait	Verb
mandaté	Participle
récolta	Verb
équipassiez	Verb
ornait	Verb
toréa	Verb
pacifié	Participle
courroucer	Verb
assaisonner	Verb
élit	Verb
pulvérisé	Participle
appréhendait	Verb
cravachas	Verb
gangréné	Participle
immortaliser	Verb
gambergeassiez	Verb
craquelé	Participle
ralliaient	Verb
outrepassât	Verb
asset	Verb
provoqua	Verb
obturé	Participle
heitiiez	Verb
momifieriez	Verb
skia	Verb
assaisonnait	Verb
verrouiller	Verb
affrétaient	Verb
minant	Participle
crépir	Verb
concerner	Verb
rafraîchir	Verb
décrivit	Verb
endormes	Verb
fournît	Verb
écrasèrent	Verb
narra	Verb
nouaient	Verb
amasser	Verb
sojorniiez	Verb
entrapercevraient	Verb
économisé	Participle
distendre	Verb
vernir	Verb
apeuré	Participle
atténuer	Verb
supputant	Participle
présélectionnerons	Verb
amorça	Verb
teinterait	Verb
relatèrent	Verb
fonctionneraient	Verb
formalisant	Participle
solidifiant	Participle
délabra	Verb
déganteraient	Verb
accélérèrent	Verb
exacerbant	Participle
culminèrent	Verb
occultant	Participle
feuilletait	Verb
ameuter	Verb
prédisposer	Verb
pardonnant	Participle
orchestré	Participle
gratiner	Verb
passerillé	Participle
brandissait	Verb
remontrasse	Verb
aboutissaient	Verb
agrémenta	Verb
classeraient	Verb
desieunasse	Verb
redéployant	Participle
multiprogrammerez	Verb
tomba	Verb
dorlotèrent	Verb
mailer	Verb
grimpai	Verb
surchauffer	Verb
agir	Verb
bougerai	Verb
multiplieront	Verb
saucissonner	Verb
drainé	Participle
lamera	Verb
expectoreras	Verb
galant	Participle
dirigèrent	Verb
chambarderions	Verb
rivalisant	Participle
pinceraient	Verb
déplu	Participle
boita	Verb
posséda	Verb
accorda	Verb
réimposer	Verb
neiassent	Verb
déjuger	Verb
codétenait	Verb
enchéri	Participle
déjeusnasse	Verb
conviant	Participle
répugnait	Verb
inversaient	Verb
montrerons	Verb
orné	Participle
mont	Verb
oseraient	Verb
amélioreront	Verb
baster	Verb
confinant	Participle
améliora	Verb
aspirassiez	Verb
clôtureront	Verb
aidât	Verb
humanisant	Participle
redressa	Verb
établirait	Verb
terré	Participle
embrassait	Verb
enseveli	Participle
renvoyant	Participle
exceptant	Participle
calibrer	Verb
agiteront	Verb
deslogerez	Verb
recuirerez	Verb
naissaient	Verb
révélant	Participle
appuyer	Verb
secourir	Verb
embrouiller	Verb
récupérait	Verb
interviendrai	Verb
bifurquera	Verb
incombait	Verb
courtisé	Participle
péricliter	Verb
préfèrerai	Verb
semblera	Verb
sonder	Verb
mesurant	Participle
mira	Verb
gelant	Participle
effarant	Participle
fusionneraient	Verb
usineraient	Verb
arrogeait	Verb
cala	Verb
regrettera	Verb
pivoter	Verb
estimerait	Verb
arrimé	Participle
pleurnichant	Participle
queutai	Verb
abritait	Verb
défiera	Verb
rédigerai	Verb
annulant	Participle
personnaliseriez	Verb
assignant	Participle
tractait	Verb
réutiliseront	Verb
peinta	Verb
permettes	Verb
satiriser	Verb
apprennes	Verb
essaimé	Participle
renassent	Verb
capitulé	Participle
diversifiant	Participle
signifiait	Verb
amplifiassiez	Verb
glosé	Participle
occupant	Participle
décimasse	Verb
humé	Participle
chutèrent	Verb
conplaindrai	Verb
restreignant	Participle
commérer	Verb
capé	Participle
colonisait	Verb
internationalisé	Participle
sonnera	Verb
circulant	Participle
déprimer	Verb
chauffera	Verb
trépassa	Verb
prêtera	Verb
déverminerez	Verb
seriez	Verb
consacreront	Verb
intercalé	Participle
intenta	Verb
détruisit	Verb
démena	Verb
rabattirent	Verb
convenaient	Verb
vouté	Participle
décrypter	Verb
figeassiez	Verb
importuner	Verb
embêtaient	Verb
parqueté	Participle
goué	Participle
consuire	Verb
dépensé	Participle
commettre	Verb
stimulant	Participle
ressusciter	Verb
conféra	Verb
siroterions	Verb
toiserez	Verb
séjournera	Verb
utilisaient	Verb
retombé	Participle
listas	Verb
énoncer	Verb
lofa	Verb
furniriiez	Verb
rageant	Participle
notifié	Participle
agoniser	Verb
déraisonné	Participle
aspergeait	Verb
alia	Verb
attendrai	Verb
céder	Verb
représentaient	Verb
apprécié	Participle
entrer	Verb
enfourché	Participle
zigzaguant	Participle
