մարզիկներից	Plural
քննադատներից	Plural
պսակները	Plural
չվախել	None
աքեմենյաններ	Plural
կխոպոպեր	Singular
ուսուցչուհիներ	Plural
մտածելակերպ	Singular
մրջյունները	Plural
հրապուրում	None
թեշիկներդ	Plural
կենդանանալ	None
արտասահմանին	Singular
ամերիցիում	Singular
փորձես	Singular
գոյանալ	None
քար	Singular
ներբողները	Plural
հանրագիտարանում	Singular
ոլորակել	None
օգտագործումից	Singular
կտառապեիք	Plural
քարդ	Singular
անմնացորդներումս	Plural
հեռագիրը	Singular
առյուծներ	Plural
արթնացել	None
տեսուչը	Singular
կանխող	None
չմխիթարեն	Plural
պարերում	Plural
արկղ	Singular
ջրարջերի	Plural
մամուռ	Singular
զորավոր	Singular
արսենիդ	Singular
էներգիայից	Singular
հեղինակություն	Singular
հիմնախնդիրներով	Plural
սենատից	Singular
խոստումները	Plural
մոլորակներով	Plural
կոպեկներս	Plural
մայրաքաղաքներին	Plural
չորացնել	None
ֆաշիզմը	Singular
մոլիբդենի	Singular
բակլան	Singular
ակնաղբյուրի	Singular
ցլամարտը	Singular
կտակել	None
տեսնալ	None
անշարժով	Singular
ինֆեկցիա	Singular
հեթանոս	Singular
հրապուրելու	None
փարպեցին	Singular
գնելու	None
փուլից	Singular
հոնքերը	Plural
տանտիրուհուն	Singular
բացառելու	None
ֆեոդալական	Singular
տեսուչներ	Plural
հմուտ	Singular
թքած	None
մարկերի	Plural
շահագործելու	None
ոչնչացմամբ	Singular
չհարկադրել	None
ժպիտով	Singular
մանգաղ	Singular
հնդկերեն	Singular
մոնղոլներս	Plural
տոների	Plural
խաղաղությունից	Singular
ճրագի	Singular
հաճախվել	None
կանչես	Singular
միացրած	None
հանգեց	Singular
լողափին	Singular
չակերտներով	Plural
հալել	None
աշխատեր	Singular
թեորեմները	Plural
կանոններ	Plural
ռազմիկը	Singular
կզաքիսը	Singular
արտս	Singular
քննարկելիս	None
բժշկության	Singular
ամերիկահայերովդ	Plural
թվանքներդ	Plural
նվազներդ	Plural
բոշադ	Singular
քրդովդ	Singular
անվճռական	Singular
փաստաբաններից	Plural
տուժում	None
երթալ	None
ծովահենիցս	Singular
թողություն	Singular
աղքատների	Plural
բարձրաբերձ	Singular
կրճատում	Singular
մտոցը	Singular
ծաղրով	Singular
ձմեռային	Singular
կրթությանը	Singular
տարբերում	None
կտրականների	Plural
հիասթափության	Singular
հատկանշով	Singular
խառատները	Plural
մեղրամոմ	Singular
տրամադրել	None
պահքը	Singular
կաշկանդող	None
գրանցումները	Plural
ուրագներովդ	Plural
հենել	None
բացատրութիւնս	Singular
շիկացած	None
շինվածքի	Singular
բառնալ	None
գլխիս	Singular
շնորհավորանքներին	Plural
ճապոնականներումս	Plural
էլեմենտ	Singular
կմաքրեիք	Plural
շերեփներ	Plural
հավասարումներին	Plural
անզգայացվ	None
պղպեղները	Plural
ծծում	Singular
քանդ	None
ցանկացել	None
սերուցքով	Singular
հատած	None
տարվեց	Singular
կառավարող	None
ներկայացր	None
գտանք	Singular
մանրադիտակները	Plural
արագություններում	Plural
չտրամադրել	None
փրփրալ	None
քնկոտ	Singular
ուտելիքի	Singular
գործարկվել	None
սանրվում	None
սնդիկը	Singular
կոկոյումդ	Singular
կատակերգությունների	Plural
արգելող	None
ոտնակ	Singular
նկարիչներին	Plural
ահագնացող	None
անկում	Singular
ամայանալու	None
ուղեկցած	None
իտալացի	Singular
աներոջ	Singular
հարգող	None
զուգահեռագիծ	Singular
կալիֆորնիում	Singular
մեծամասնությունից	Singular
լուծելիք	None
կարողանան	Plural
հեծնում	None
նկուղ	Singular
բոժոժում	Singular
ապրանքներ	Plural
մոլեգնող	None
չբուսնած	None
արարածներից	Plural
հոդից	Singular
պրոթեզի	Singular
ջրամբարը	Singular
գոհացնելու	None
արշավանքից	Singular
անատոմիային	Singular
ջրհորները	Plural
ստեղծագործությունում	Singular
անոդի	Singular
ուռթանալու	None
ողբերգությանը	Singular
չկասկածող	None
վեպերի	Plural
աշտարակներից	Plural
մակեդոնացիներին	Plural
ծնծղայում	Singular
ակադեմիաները	Plural
սպասարկել	None
բացակային	Singular
արդուկելիս	None
չփողոտող	None
չքոչող	None
մռայլ	Singular
ընտրվում	None
չշտապել	None
մոտեցնող	None
կալած	None
սուսերամարտիկներդ	Plural
առեղծվածը	Singular
կշարժվենք	Plural
անուշովդ	Singular
հասկացել	None
բարձրաձայն	Singular
հաստատություններ	Plural
աստղաբույլերը	Plural
պագած	None
թագից	Singular
վաճառքում	Singular
մարգագետին	Singular
արշիպելագում	Singular
ավանից	Singular
հալածելու	None
արծվաբույններիցդ	Plural
կբացատրեք	Plural
բողբոջե՛ք	Plural
անվճռականության	Singular
վառարանում	Singular
ոստրեների	Plural
կհարբենա	Singular
սավանի	Singular
բույրը	Singular
ձեռնոցի	Singular
խաղատներից	Plural
չափելու	None
ճնշումների	Plural
արգելքս	Singular
խրախուսելու	None
դի	None
մոլորվեր	Singular
հայցելու	None
վարդապետները	Plural
չցանկացող	None
գրգռելիս	None
վռնդում	None
փախնել	None
չվում	None
հեռուստաընկերությունների	Plural
ավանդում	None
գլխուղեղից	Singular
պարտեզներ	Plural
սպառնալիքը	Singular
ջերմաչափով	Singular
պրոթեզիդ	Singular
քարշ	None
տեղատվությունը	Singular
խոթող	None
տուբերկուլյոզը	Singular
հագել	None
բրդով	Singular
գյուղերից	Plural
հիմարներ	Plural
ներկայացնեմ	Singular
խաչմերուկ	Singular
ունակությունը	Singular
զգուշացնել	None
տառապեցնելիք	None
կերտում	None
աճուրդ	Singular
ղազախներից	Plural
ալիբի	Singular
ծանր	Singular
սանդերի	Plural
սարսափած	None
արատներից	Plural
հարաբերությանը	Singular
իոններին	Plural
խնկող	None
մուրաբաներումս	Plural
քաոսի	Singular
կորտին	Singular
կախարդում	Singular
մեքենաներում	Plural
ենթարկած	None
կատարները	Plural
կերակուրը	Singular
հուսալքում	None
խրատների	Plural
մութը	Singular
բացառվում	None
հղփանալու	None
սփռող	None
կկարողանան	Plural
աշնանը	Singular
զանգահարեի	Singular
կարծելու	None
կարծրախտի	Singular
փչանալ	None
խոհարարի	Singular
քերծ	None
լիզել	None
նեղացող	None
ռենիում	Singular
թաղ	Singular
ամերիկացիների	Plural
չփքվենք	Plural
ապստամբությունում	Singular
լքած	None
աճել	None
ընդգծել	None
ելուստները	Plural
շուշաններ	Plural
կամեցել	None
տեղեկանա	Singular
կր	None
ցավում	Singular
ռոբոտին	Singular
միությունները	Plural
պետությունները	Plural
մկրատ	Singular
խառնած	None
կարմրող	None
նվագած	None
սադրել	None
տանուտերերը	Plural
մեքենայի	Singular
մոնիտոր	Singular
ժամկետ	Singular
ջղայնացել	None
չհայտարարել	None
մետրանոցներում	Plural
չփորձած	None
սփռել	None
համբուր	None
տեսողությունից	Singular
իշխանությունում	Singular
հպարտացել	None
տառադարձելիս	None
գանգրված	None
լաստանավերի	Plural
կանգնեցնել	None
քանդեն	Plural
ուժեղացան	Plural
մեծանալու	None
փղերը	Plural
կարտ	Singular
ենթարկել	None
էնցեֆալիտի	Singular
անզգայացվելիք	None
խոյացած	None
զրույցում	Singular
մտցրել	None
հածող	None
ձգտվել	None
երիցուկի	Singular
կաղամախիներումս	Plural
հորանջող	None
հրճվանքի	Singular
կառերեսենք	Plural
հուլիսի	Singular
արքունիքից	Singular
սառնամանիքներից	Plural
սպիրտներ	Plural
թակույկներում	Plural
մայա	Singular
արծաթե	Singular
գոլֆում	Singular
հրեշներից	Plural
ստուգելու	None
անսասաններս	Plural
շալվարներ	Plural
բողոք	None
ծառայած	None
պիոն	Singular
միանալիս	None
մեծություններ	Plural
զատելու	None
վանկարկել	None
էջեր	Plural
արբեն	Plural
չարորած	None
ահազանգերով	Plural
կմեծարենք	Plural
թրմում	None
օժանդակվել	None
չտրցակած	None
երկարությունից	Singular
կողոպտեիք	Plural
սկզբունքայնություններիցս	Plural
աքսիոմիս	Singular
հարկադրեց	Singular
միասեռականների	Plural
փորձել	None
հալածել	None
խճումս	Singular
ամերիկացիներից	Plural
մորթիդ	Singular
բողոքարկվել	None
պարտություններ	Plural
պադյեզդները	Plural
կուրերին	Plural
չամուսնացնել	None
ակրոբատների	Plural
քննությունների	Plural
գործազրկություն	Singular
զանգելու	None
էղնելիք	None
թեւին	Singular
ծանրորդներ	Plural
ալեկոծեցիր	Singular
օբյեկտներից	Plural
զավթած	None
թուլացող	None
մեթոդներով	Plural
փարթամակեցություններիս	Plural
արձագանքում	None
ձեռնարկ	Singular
աղոթելու	None
սյունակներում	Plural
սոսնձում	Singular
վարդապետ	Singular
արմս	Singular
ոսկիները	Plural
երեկվա	Singular
աբորտի	Singular
ապացուցվում	None
վախճան	Singular
աստղագուշակության	Singular
տափակում	Singular
բավարարելու	None
մեկնաբանությունիցս	Singular
ճնշումը	Singular
անդաստակումս	Singular
արտաքսվել	None
քերականագետիդ	Singular
կոտորակ	Singular
հեղինակությունների	Plural
ուստրը	Singular
կնիքների	Plural
դատարկել	None
ճիճվի	Singular
տերություններում	Plural
բացառականներ	Plural
բուտը	Singular
առաջադրանքով	Singular
նախդիր	Singular
արագությանը	Singular
խիզախի	Singular
հորիզոններ	Plural
սավանների	Plural
չփախցնեք	Plural
հայտնվել	None
աստվածուհիների	Plural
մեծացող	None
կցանկանայինք	Plural
չայ	Singular
վրանը	Singular
աշխատել	None
փչում	None
ձուլվել	None
բաղարջ	Singular
կհայտնեմ	Singular
արդուկող	None
քաոսականներումս	Plural
բարքիս	Singular
եռում	None
վճռելու	None
ակները	Plural
օրհներգ	Singular
վառվելու	None
կծելու	None
շամպայնը	Singular
բազմոցը	Singular
խոչընդոտներին	Plural
ռինգերի	Plural
պալատականներ	Plural
կրակում	None
սելերս	Plural
սովորականովս	Singular
խոյեր	Plural
շաղախների	Plural
մղելիք	None
վալս	Singular
կրթությամբ	Singular
համերգում	Singular
կայսրուհիներ	Plural
հակահերոսիցս	Singular
կեղտոտում	Singular
ապիրատ	Singular
ուղեկցող	None
մսագործներով	Plural
տաբուի	Singular
մեռյալները	Plural
օվկիանոսներից	Plural
հոլաթեւեր	Singular
շինարարներս	Plural
սպանախ	Singular
վերադառնալիս	None
մթության	Singular
ավետարանից	Singular
երաժշտություններից	Plural
անբովանդակներիցդ	Plural
բազալտների	Plural
ծածկվել	None
հայհոյում	None
բարձրաձայնեիր	Singular
հենվել	None
հաստատող	None
նշանավորիցդ	Singular
հալածում	None
ուսանելիս	None
կհարթուկեի	Singular
վճռվել	None
կանխվել	None
պարտավորությունների	Plural
փնթիովդ	Singular
որսալ	None
կակազում	None
չնվացած	None
ցասկոտ	Singular
հանդուգններ	Plural
գայթակղի	Singular
մեկնում	None
աղքատի	Singular
կրակել	None
ազազելիք	None
փիլիսոփայությունում	Singular
կտուրով	Singular
կրծքանշանները	Plural
կաղկանձած	None
խալերի	Plural
աղացած	None
ռետինովս	Singular
առագաստներիցդ	Plural
լոգանքից	Singular
կարեկց	None
չտառադարձել	None
տառապում	None
թերիի	Singular
նետած	None
շրջվում	None
արագությունում	Singular
հերթի	Singular
ամայացնել	None
պարզ	Singular
պաշտամունքների	Plural
բազմամարդ	Singular
չխրոխտացած	None
մարտիրոսների	Plural
դարձվածքը	Singular
բեղերը	Plural
ջինիս	Singular
ձվարաններում	Plural
կողքերին	Plural
խանդը	Singular
ընկերուհիներից	Plural
տեսնել	None
զգուշանում	None
տեղեկացրեց	Singular
ձգտելու	None
արարողություններով	Plural
պատրանքը	Singular
կառքին	Singular
առակներից	Plural
զավտրըկներիցդ	Plural
տրամադրեր	Singular
ադամանդագործականներով	Plural
մեղեդու	Singular
առզելիցդ	Singular
վերծանելու	None
չանկանեն	Plural
ամբողջությունը	Singular
համակարգելիք	None
հաշվի	Singular
ուն	Singular
ինքնասպանություն	Singular
քննությունները	Plural
չորացնելիս	None
շնագայլերի	Plural
երաժշտություններ	Plural
փարթամներ	Plural
բնութագրեց	Singular
կրակելու	None
ծնկոսկրի	Singular
կռատուկը	Singular
աղանդերներ	Plural
չթվարկած	None
հեղ	None
նետաձիգներով	Plural
մագլցած	None
ճանապարհորդություններում	Plural
սպուտնիկի	Singular
կոճակները	Plural
վանկին	Singular
սկզբունքները	Plural
խոլերայի	Singular
ավետիսի	Singular
գովեստ	Singular
լանջապաններիցս	Plural
երազի	Singular
անձնագրի	Singular
թարգմանությունը	Singular
ստրկացնում	None
թուլանում	None
ուսուցանող	None
հոկեյով	Singular
զվարճացնել	None
փուլումս	Singular
կողմանոցումդ	Singular
ցեղերը	Plural
վտակը	Singular
կերտել	None
չկակազած	None
ուռ	None
խմող	None
թարգմանությունների	Plural
գերմանացիներ	Plural
գլուխներում	Plural
կատարելու	None
վախենում	None
իշխանություններ	Plural
խնձոր	Singular
նվագելիք	None
հայրենակիցների	Plural
խմորի	Singular
պաշարներով	Plural
խրախուսանք	Singular
զղջալ	None
արագությամբ	Singular
հերոսներով	Plural
պայմանագրից	Singular
կանչել	None
գավաթներում	Plural
հարսնացուի	Singular
հոդ	Singular
նավահանգիստ	Singular
բլթակներ	Plural
կոպեր	Plural
հատկացրած	None
արձագանքել	None
կրկես	Singular
ճառագայթների	Plural
համար	None
հասունները	Plural
ոստիկանությունից	Singular
վզիկով	Singular
չաշխատել	None
տունդրայում	Singular
վատի	Singular
ավանդած	None
բռնություններ	Plural
խալիֆայությանը	Singular
ստուգել	None
կուսակցության	Singular
մարկով	Singular
կայսրություններից	Plural
արգանակ	Singular
հրահրելիս	None
չգնչող	None
քարոզարշավներ	Plural
ապստամբող	None
վաստակով	Singular
տղամարդկանց	Plural
կրոնից	Singular
օգտագործեք	Plural
խորհրդից	Singular
մարտնչող	None
հետեւի	Singular
խռթայինք	Plural
շնորհակալ	Singular
կցորդ	Singular
չկորնչող	None
կկեն	Plural
գագաթնաժողովում	Singular
վերնագրերից	Plural
մերկանում	None
արագությունից	Singular
սարավանդների	Plural
աճյունը	Singular
դոլարներումդ	Plural
գյուղով	Singular
թափված	None
հիմնավորելու	None
հրահրել	None
ագռավանալու	None
գերում	Singular
աճեցնել	None
անգամով	Singular
բանաստեղծներից	Plural
հումուսից	Singular
պիտանիներով	Plural
ախոյաններս	Plural
հուշարձաններում	Plural
հետեւելու	None
բիզնեսների	Plural
բարբառների	Plural
խակի	Singular
նախարարներին	Plural
հավելվածի	Singular
ներարկիչի	Singular
ձետերի	Plural
խորենացուն	Singular
փնջերում	Plural
շփոթել	None
գուրգուրացել	None
հրաժեշտը	Singular
հիմնավոր	None
հատորներով	Plural
տելուր	Singular
կառչած	None
չաջակցեց	Singular
պանծացած	None
առեղ	Singular
ընտրվող	None
խանձատեցի	Singular
տեսողությանը	Singular
փլվես	Singular
զեռում	None
ոչնչացումները	Plural
նվագելիս	None
մեծություններից	Plural
հավատքից	Singular
նեղացել	None
չփլվեիք	Plural
չառաքող	None
ջրանցքից	Singular
սպանում	None
բալենին	Singular
մտցվել	None
պաղատեին	Plural
մոռացած	None
մաղադանոսը	Singular
անկումներ	Plural
կոմբայնովդ	Singular
լքել	None
ուրացող	None
ընձառյուծները	Plural
ներդրմանը	Singular
բողոքարկեմ	Singular
խույր	Singular
ցեղում	Singular
նպաստելու	None
սիլիցիում	Singular
չպառկած	None
ձեւեր	Plural
փոխարինել	None
ծայրերից	Plural
սլովակերեններին	Plural
կիրառեցին	Plural
գոռալու	None
քերականագետներ	Plural
հիպնոսը	Singular
կիրճում	Singular
պողոտա	Singular
կվարցում	Singular
կամարները	Plural
կարտոֆիլը	Singular
աշխատեցին	Plural
արտասվում	None
նեղուցները	Plural
ճանկերի	Plural
հաճախած	None
մեքենաների	Plural
ալքիմիան	Singular
կավերով	Plural
կարի	Singular
սնոտիներս	Plural
կոչվել	None
խառնաշփոթության	Singular
տեղեկատուներ	Plural
երկրաշարժ	Singular
լրացումիցդ	Singular
քանակների	Plural
թոռոմներումս	Plural
հասկացնել	None
հաճախեցին	Plural
բաժանվի	Singular
կիլոմետրերով	Plural
հասկանանք	Plural
հորդորել	None
պարապելու	None
սովորելու	None
տեղի	Singular
ժողովրդավարության	Singular
արվեստով	Singular
կաթսայում	Singular
պատրաստություններ	Plural
հայող	None
հագեցնում	None
կեղծիքը	Singular
պողոտաներում	Plural
մատնելու	None
թարխունի	Singular
կամարների	Plural
կտոկային	Plural
չընթանանք	Plural
գործոններով	Plural
կառավարեն	Plural
ձվատարում	Singular
պսակ	Singular
շարժվեց	Singular
լիզի	Singular
հոգացող	None
նշենու	Singular
գյուղատնտեսություն	Singular
չտռզի	Singular
չվանեինք	Plural
բետոններ	Plural
բարձրաձայնելու	None
բջիջներ	Plural
ավանդությամբ	Singular
կաթիլները	Plural
ավանդույթին	Singular
կայացել	None
չխոչընդոտող	None
մենինգիտով	Singular
լորին	Singular
բարելավում	None
չաշխատող	None
ռեփը	Singular
մեռոն	Singular
ակնածոտումդ	Singular
բատիսկաֆիս	Singular
հանդիսասրահի	Singular
փերի	Singular
երկայնանալիս	None
այլեւայլություններովս	Plural
հիվանդագինից	Singular
չսիրված	None
վարկածով	Singular
ենթակառուցվածքի	Singular
մոնղոլներին	Plural
էականումդ	Singular
մրցավարները	Plural
աղտեղիներով	Plural
ճամպրուկ	Singular
չվերընթերցեք	Plural
հափշտակում	Singular
շարունակել	None
հոնքեր	Plural
երկաթյա	Singular
այգեստան	Singular
կապիկին	Singular
երկրաչափությունից	Singular
լուսամուտներ	Plural
աճեն	Plural
տաբատի	Singular
տրամվայները	Plural
սուզվել	None
լիմոնադի	Singular
խոտորումներովդ	Plural
աքսորելիս	None
հնչույթ	Singular
արմավենիներ	Plural
թրծած	None
տղամարդկանցից	Plural
համառոտ	Singular
մղելու	None
հետեւելիս	None
մետրից	Singular
քերականների	Plural
ընդեղենիցս	Singular
շաուրմա	Singular
որբանում	None
քեր	None
հայտնել	None
այցելել	None
կոշկաքուղերին	Plural
բեղերով	Plural
կրծոսկրի	Singular
արդարացրել	None
ակկոյունլու	Singular
փեսայի	Singular
վիժանուտներդ	Plural
կկ	None
էլիպսի	Singular
զտած	None
իռացիոնալին	Singular
կղզիախումբը	Singular
զառերով	Plural
նացիստիս	Singular
երազ	None
հրկիզվել	None
քավել	None
հեղինակությունը	Singular
թանգարանի	Singular
ծպտվող	None
առագաստները	Plural
գետակները	Plural
հրահրվել	None
սանրը	Singular
բացատրությամբ	Singular
էակ	Singular
կոմունիզմ	Singular
գրախանութը	Singular
ամպում	Singular
արարողությունները	Plural
հերոսների	Plural
կորեերեններ	Plural
առանցքներ	Plural
պահպանելու	None
սելավը	Singular
խոչընդոտելու	None
գյուղացիներ	Plural
թղթադրամը	Singular
մանվածքային	Singular
նուկլոնումդ	Singular
սանրերը	Plural
չլկստված	None
խմբագրելու	None
չարդարացրեց	Singular
զարմացի՛ր	Singular
հնչույթը	Singular
բազմոցի	Singular
շատացնել	None
արածելու	None
փորձեն	Plural
բանեցնող	None
իլերից	Plural
արգանդափողերի	Plural
ճաշելու	None
սպերմատոզոիդ	Singular
ֆրանսուհու	Singular
խխունջներ	Plural
դեղաբոյսեր	Plural
ապրանքիցդ	Singular
խաչմերուկներ	Plural
փլվում	None
ուզել	None
փչանալիս	None
բարձր	Singular
փակյալից	Singular
սանդերս	Plural
կեչուցիդ	Singular
կանադականումս	Singular
ոռնում	None
զատող	None
կենսաբանականդ	Singular
կար	None
ուսանողը	Singular
գուշակների	Plural
ոզնի	Singular
մտցնել	None
առակներում	Plural
ներքնազգեստից	Singular
մաքառումը	Singular
արձագանքեն	Plural
չզտող	None
կնճիթը	Singular
տեսախցիկների	Plural
ստուգվել	None
հեգնանք	Singular
երկրպագուներով	Plural
ճանկում	Singular
կայանա	Singular
զավթելու	None
գլխուղեղում	Singular
խոտ	Singular
ցողունների	Plural
կայանալիք	None
հալածվել	None
վանող	None
ամերիցիումը	Singular
կոպ	Singular
օժանդակել	None
հեղինակը	Singular
առավել	Singular
սումոյում	Singular
կեղտ	Singular
համբար	Singular
սանձահարող	None
քանակի	Singular
հավելել	None
չհոխորտայիք	Plural
կատեգորիաներով	Plural
պանակի	Singular
նավակներով	Plural
մրջյունի	Singular
ներգաղթելու	None
երկկտտացնելիք	None
տուժելու	None
ճոպաններ	Plural
պայմանավորում	Singular
մարտկոցը	Singular
կլարնետի	Singular
բուժքույրեր	Plural
կերակրելիս	None
կիրառվող	None
ձկնաբան	Singular
բացականչությունները	Plural
չսառչի	Singular
երեսնամյայովդ	Singular
սաղանայինք	Plural
չահազանգել	None
ներկայացմանը	Singular
բռնությունից	Singular
ուղեկցես	Singular
մատուցած	None
քվարցը	Singular
թարգմանեք	Plural
գարշերից	Plural
սափրիչ	Singular
նպաստող	None
զարմացրել	None
հնարքով	Singular
խորաններին	Plural
հեռավորություններից	Plural
չվերադարձան	Plural
բանավեճից	Singular
ասվիներով	Plural
արիությամբ	Singular
մրսում	None
կաշառում	None
մեքենաներով	Plural
աբստրահվ	None
համաձայնել	None
հաչաղ	Singular
ուսմամբ	Singular
արխիվից	Singular
էակների	Plural
ստրկացնելու	None
ցողունում	Singular
հյուծելու	None
տեսարանով	Singular
չհելած	None
դատապարտող	None
նպաստում	Singular
թուլացել	None
տրամադրեցին	Plural
ողնուղեղում	Singular
գրպաններ	Plural
լողակների	Plural
սլանում	None
կպապանձեցնեք	Plural
վարորդը	Singular
սպիում	Singular
սպերմատոզոիդի	Singular
վերելակները	Plural
քերականին	Singular
հաշվով	Singular
ժանգ	Singular
կհարսնանար	Singular
հրեշտակներով	Plural
ունակությամբ	Singular
մարդագայլերդ	Plural
կազմ	Singular
օմար	Singular
մտածելակերպի	Singular
գերեզմանոցներում	Plural
առաջնություններին	Plural
ճոռոմախոսելիս	None
վանքը	Singular
մրցավարին	Singular
բախով	Singular
վիճում	None
ունկնդրելիս	None
թափվելու	None
միմոս	Singular
չփորձեց	Singular
ատոմների	Plural
հնձանի	Singular
հետույք	Singular
վկայություններին	Plural
մրցավար	Singular
անապատներում	Plural
ջանացած	None
թարխանության	Singular
հումանիզմ	Singular
ամուսնացրել	None
աճուրդով	Singular
ֆլեյտան	Singular
արյունահոսությունների	Plural
նպաստեց	Singular
բազմոցներով	Plural
տերմինների	Plural
օրորի	Singular
ավելացնեն	Plural
անջատիցդ	Singular
ասորիներին	Plural
ներգաղթող	None
ավագանովդ	Singular
ներկայացուցչության	Singular
մղեն	Plural
կանգնում	None
քվարկներ	Plural
կենդանաբաններին	Plural
պապանձվեիր	Singular
վիճակ	Singular
վռնդելու	None
տերեւը	Singular
խափանելու	None
լավաներ	Plural
հրահրած	None
չկորնչեց	Singular
թլփատող	None
ալբոմում	Singular
քաղաքականությունները	Plural
ստոծանին	Singular
կրպակներիցս	Plural
չծածանած	None
պաշտոնին	Singular
կրելու	None
ականջներով	Plural
տասնամյակներ	Plural
գիին	Singular
խթանած	None
չվառները	Plural
հումուսի	Singular
բառապաշար	Singular
չանզգայացվեի	Singular
շորեր	Plural
օծելու	None
դաշնությունը	Singular
գիտակցելիք	None
մալայերենի	Singular
մրսած	None
սխալվելու	None
ներարկիչների	Plural
ներխուժող	None
ուժեղացող	None
կերակուր	Singular
հալ	None
հադրոններ	Plural
հրաբուխների	Plural
մետրոպոլիտենիդ	Singular
կողր	Singular
ոսկոր	Singular
սահմանել	None
գուսանների	Plural
ռետինից	Singular
էակներով	Plural
կարծում	None
անեկդոտներովս	Plural
տրոմբոնի	Singular
գրառում	None
արտագաղթեցնել	None
պարգեւող	None
թանգարանին	Singular
չբտած	None
էշայծյամներիս	Plural
դեզօքսիռիբոնուկլեինաթթու	Singular
վերմակով	Singular
կտակում	Singular
չալեկոծել	None
բառակապակցությամբ	Singular
տեղյակներովս	Plural
միաց	None
տարածքներ	Plural
դարպասների	Plural
սանձելու	None
տերեփուկի	Singular
սավաններիս	Plural
թքել	None
մեղրամոմը	Singular
արգելոցներ	Plural
կանացիների	Plural
նախանձոտ	Singular
բռնաբարել	None
կռվախնձոր	Singular
ֆիզիկականը	Singular
բխող	None
նշխարիդ	Singular
ֆինլանդական	Singular
սկզբնատառերը	Plural
բողոքում	None
միացվել	None
տանտալը	Singular
չհողդողդած	None
նպաստել	None
հաճախությունների	Plural
թեփուկներից	Plural
ազդանշանի	Singular
քառյակում	Singular
չմտցրած	None
խրատներովս	Plural
տաղանդ	Singular
վագոններից	Plural
բաժին	Singular
պարտվող	None
բանտարկում	None
ռեստորանի	Singular
բետոնը	Singular
մտմտալիք	None
ապաթարց	Singular
չանիծած	None
չընթեռնած	None
բալետումդ	Singular
սովորում	None
վերուվարեցին	Plural
աստծուց	Singular
ազդեցությանը	Singular
ալտեր	Plural
խափումս	Singular
թեկնածուները	Plural
թեկնածուներին	Plural
փռում	Singular
առաքվել	None
քարոզող	None
համեստություն	Singular
երկայնքը	Singular
ածխածնի	Singular
բանանով	Singular
կառավարում	None
խազի	Singular
շիջած	None
սկզբունքներից	Plural
չկատակեց	Singular
բակտերիաների	Plural
չինքնահավանեիր	Singular
զվարճանալ	None
վերարտադրության	Singular
գողտրիկ	Singular
մոտոցիկլով	Singular
զղջալու	None
կլանում	None
խոսացել	None
կիսում	None
հեռախոսը	Singular
չորանում	None
կթոտած	None
գիտակցելու	None
լայնության	Singular
արթնացած	None
արտադրությունները	Plural
տենդերը	Plural
հինդուիզմի	Singular
խմելիս	None
հալելու	None
մրցելիս	None
չներխուժել	None
խոհարարական	Singular
հայտնագործություններով	Plural
ազդվում	None
ընդունակություններով	Plural
ֆեոդալիզմ	Singular
հյուպատոսության	Singular
երգեցողությանը	Singular
հրաշքից	Singular
կնքած	None
ֆուտբոլիստից	Singular
ճրագների	Plural
բացվածքներից	Plural
իբո	Singular
որսում	None
սովորություններ	Plural
չնվացիք	Plural
ակներովդ	Plural
պայմանավորել	None
հերքած	None
կենսաբաններ	Plural
ցինկի	Singular
սրով	Singular
մահացած	None
վարժություն	Singular
ոտնակի	Singular
տաճարները	Plural
տանտեր	Singular
ժամանակաշրջանը	Singular
օղողելիս	None
կայքից	Singular
լողանում	None
քերում	None
սիրեկանի	Singular
աննպաստ	Singular
բնութագրելու	None
լուսանկարում	Singular
կաթոդը	Singular
հավանները	Plural
ներգաղթյալները	Plural
հաչաղկոտից	Singular
արդարների	Plural
ցանկացած	None
պտույտով	Singular
փորում	None
վեզիրով	Singular
զորահավաք	Singular
ջայնիզմ	Singular
կբռնաբարեն	Plural
ոջիլների	Plural
կիրճերից	Plural
մնջախաղով	Singular
թուլանալ	None
արտասահմանում	Singular
պետություններ	Plural
զգենալու	None
բորբոքել	None
օծած	None
սովորույթներ	Plural
բխել	None
արեգի	Singular
ավազակ	Singular
ակունքից	Singular
ալգորիթմներին	Plural
շրջակայքով	Singular
ավագներ	Plural
աճեցրել	None
վաճառած	None
աղանդերի	Singular
խորենացի	Singular
տերություններին	Plural
չխրտնող	None
պղծել	None
լիսեռը	Singular
սահմանականներդ	Plural
կմրմնջաս	Singular
փայփայում	None
համաստեղությունը	Singular
կոճակ	Singular
պողոտայում	Singular
բան	None
շինարար	Singular
ջերմաչափ	Singular
աթեիստ	Singular
կերպի	Singular
նեյտրոնում	Singular
ծղրտացել	None
գաղտնաբառերի	Plural
դողում	None
անհանգստանալ	None
սայթաքող	None
կապանքումդ	Singular
սրճարանների	Plural
ամուսնությունները	Plural
արարողություններ	Plural
բռնություններից	Plural
ծառայում	None
կարիք	Singular
չազդվել	None
հաստություն	Singular
վերերումս	Plural
հեղեղատ	Singular
ձախլիկներով	Plural
չարիք	Singular
քվարցի	Singular
ոստիկանին	Singular
կաթնուկովս	Singular
խնջույքներով	Plural
տրամվայը	Singular
լքեցինք	Plural
մղեցիր	Singular
մտադրություններ	Plural
փչացնել	None
արեւելքին	Singular
կոտրվել	None
կգնահատի	Singular
քարայրի	Singular
հազալիս	None
չվճարած	None
ուղեկցել	None
մեջտեղով	Singular
կլքեմ	Singular
հաղորդմանը	Singular
խրամատ	Singular
վերադարձին	Singular
տեսություններից	Plural
շաղախներ	Plural
հանրագիտարաններիդ	Plural
խառնվածքների	Plural
ղարաբաղցի	Singular
աղյուսակին	Singular
ժողովուրդներին	Plural
չկանխագրել	None
հառաչալիին	Singular
փչելու	None
ավելուկը	Singular
գթության	Singular
ֆրանկականիցս	Singular
մարտնչելիս	None
բացումից	Singular
մակարոն	Singular
հադրոն	Singular
շառավիղներով	Plural
լճից	Singular
հայեցվածներիդ	Plural
ռոմին	Singular
խեթկելու	None
մտմտալ	None
խուլիգանների	Plural
խեղդող	None
հուշանվերներ	Plural
կոչումներով	Plural
հոտոտում	None
հայրենիներումդ	Plural
մեդալը	Singular
ընտրվել	None
կիլոգրամի	Singular
առաքելություն	Singular
էնցեֆալիտներ	Plural
կփախցներ	Singular
հոսած	None
թարթած	None
լուսանկարները	Plural
պորտապարի	Singular
արարածները	Plural
հառաչականը	Singular
գուշակությամբ	Singular
պառկող	None
տերեւներ	Plural
վիզայումդ	Singular
աքսորվեց	Singular
գրաբար	Singular
անիծել	None
շփելիս	None
աճուրդների	Plural
կազմերում	Plural
փակ	Singular
չվռնդող	None
թվարկած	None
թալմուդ	Singular
կանչեր	Singular
կվանկեք	Plural
հաճախող	None
վկայությամբ	Singular
ծածկ	None
որոճեցնել	None
հարուստներ	Plural
օրորումդ	Singular
շեշտում	None
քամեցինք	Plural
սոխակ	Singular
ծիլեր	Plural
կարծել	None
ավազակներ	Plural
բոյկոտը	Singular
կոստյումները	Plural
բուսնի՛ր	Singular
խորովեն	Plural
մանկապարտեզից	Singular
փոխարինող	None
որձաքարից	Singular
չվանկարկել	None
օգտագործմամբ	Singular
հայրենիքը	Singular
չգլդորել	None
հերքիչներովս	Plural
պորտով	Singular
տեղատվություն	Singular
ոստիկանությանը	Singular
հիվանդանոցներից	Plural
օսական	Singular
մալեիք	Plural
նավատորմիղ	Singular
վարդակակաչ	Singular
չշառաչեցիք	Plural
պանրով	Singular
վարդենիներիդ	Plural
օֆիսում	Singular
թվարկել	None
բնավորությանը	Singular
սոխը	Singular
չգլտորող	None
վերելակիդ	Singular
դադարս	Singular
չխոչընդոտել	None
զգացմունքներ	Plural
խորանում	Singular
աշակերտուհիներից	Plural
սուզում	None
ռումիներեններիցդ	Plural
չբխենք	Plural
քիլ	Singular
զարթօնքովս	Singular
մագմային	Singular
մսից	Singular
բնակվում	None
անիոն	Singular
չտուժեինք	Plural
կատիոններդ	Plural
մետրեր	Plural
հառնում	None
ըմբիշներ	Plural
զոհասեղանում	Singular
կտակարաններ	Plural
չհորդորեն	Plural
վերադառնալ	None
հենելիս	None
մատուցել	None
հիմարների	Plural
ծծել	None
պոռնոգրաֆիայի	Singular
կորոճար	Singular
չարմացած	None
ձվարան	Singular
հեռացնելիս	None
իրական	Singular
խոչընդոտել	None
գաղափար	Singular
կրաքարեր	Plural
պարողների	Plural
մատնեին	Plural
ամորձիներից	Plural
ներկայացնում	None
կիվիի	Singular
պատվերի	Singular
գեղեցկությանը	Singular
մեղքերի	Plural
կուզեր	Singular
աստղաֆիզիկայիցդ	Singular
հրեշներիդ	Plural
բենգալի	Singular
հապավումը	Singular
ատյաններից	Plural
մաքրում	None
աշակերտներով	Plural
խրատը	Singular
բանավեճը	Singular
ճանկեր	Plural
մերձ	Singular
սնգուրած	None
անգլիացիները	Plural
աղավաղել	None
ճարտարապետություններս	Plural
լրթանալու	None
հագնվել	None
չորերում	Plural
կսահմանեն	Plural
ցեղին	Singular
բուլղարացին	Singular
գեղգեղած	None
քաղած	None
ստրուկին	Singular
նավահանգստով	Singular
չարաշահել	None
տնտեսագետներ	Plural
գրադարձությունիցդ	Singular
հերքելու	None
այցելություններ	Plural
ազդող	None
կենտրոնով	Singular
պրազեոդիմ	Singular
մաղադանոսից	Singular
անարատ	Singular
կենդանանում	None
հավաքածուները	Plural
ճարպով	Singular
խօսելու	None
բեգեմոտներովդ	Plural
պառկելու	None
թեքումները	Plural
ակադեմիաներ	Plural
հալվայումդ	Singular
հանգում	None
հասցրած	None
էջերում	Plural
անոդը	Singular
խորքերում	Plural
գործարանը	Singular
վճարում	None
ֆլորենցիացիներովդ	Plural
շփոթմունքս	Singular
ելակի	Singular
այբուբենը	Singular
քարոզի	Singular
փիլիսոփոսիցս	Singular
արկերում	Plural
համբերել	None
բրոմի	Singular
ճանապարհորդել	None
շաքարից	Singular
լուծելու	None
բղավում	None
ահազանգող	None
խազեր	Singular
խորովել	None
նվերը	Singular
արոտավայրերիս	Plural
տեսիլք	Singular
հոգեբան	Singular
պայթում	None
ստվարներիս	Plural
իբոյում	Singular
ձգտող	None
ողբերի	Plural
վեպով	Singular
կախեցին	Plural
օրհնեիր	Singular
խմեց	Singular
տանձի	Singular
ճմռթում	None
ցնծում	None
անձնագրերը	Plural
լուրը	Singular
խարխլելու	None
շրջակայք	Singular
հորեղբայրը	Singular
տուրիզմով	Singular
վարվել	None
տեսուչի	Singular
ստուգումներից	Plural
լարին	Singular
գոհ	Singular
գիտնականները	Plural
չղջիկները	Plural
ալ	Singular
քրտնեցնել	None
սփռում	None
բամբասանքի	Singular
սոցիալիզմ	Singular
ռուսաստանցի	Singular
կողքիդ	Singular
կհավատաս	Singular
սպրիչներ	Plural
թռ	None
շինվածքները	Plural
մրի	Singular
շպրտել	None
ընդգծում	None
շուրթերին	Plural
ոլորունումս	Singular
ուսմանը	Singular
պատկեր	None
գործադուլների	Plural
ճուճուլիկի	Singular
բառացանկերում	Plural
մարզերի	Plural
կկանչի	Singular
վարան	None
ստել	None
տաջիկներ	Plural
գրանիտներիցդ	Plural
հեծանոցներ	Plural
բարձած	None
ամբ	Singular
մոլորակներում	Plural
ահաբեկել	None
կստորագրես	Singular
թորշոմող	None
ուրարտացիների	Plural
մղում	None
կարողանաք	Plural
արեւելքի	Singular
անցքերին	Plural
վարագույրներով	Plural
բոլորը	Singular
ճախրող	None
գուջարաթի	Singular
կոտորածներին	Plural
սպասարկելու	None
տնտեսով	Singular
պատառելիս	None
բացառությամբ	Singular
երկյուղի	Singular
լրտեսելու	None
փայտիկի	Singular
քերծելիք	None
սուսերամարտ	Singular
ոգեշնչում	Singular
լոլիկ	Singular
ընդավորներին	Plural
չտենչային	Plural
հրթիռում	Singular
ուղարկեցին	Plural
խաղաթուղթ	Singular
սինհալերենս	Singular
մասունքը	Singular
ստիպվել	None
գրասենյակից	Singular
կանաչապատում	Singular
ձեւի	Singular
կաթիլներից	Plural
էմիգրանտումս	Singular
կարողանում	None
կալերում	Plural
կատարելիս	None
շքերթների	Plural
ախտորոշել	None
դատողությունների	Plural
հառաչեին	Plural
կայսրուհիների	Plural
ճանապարհորդելու	None
ակնախնձորով	Singular
թուլացած	None
փոխարինեցին	Plural
խույրի	Singular
ֆիզիկոս	Singular
հուսահատված	None
վերնագրից	Singular
ճաշակում	Singular
օսմանների	Plural
որջը	Singular
քամիներից	Plural
նորության	Singular
գրգռող	None
մոլեգնած	None
ռեկորդային	Singular
խոլերան	Singular
պարապում	None
ազոխներիդ	Plural
խորշերի	Plural
ճանապարհորդող	None
սուզանավի	Singular
տեղեկացնող	None
խրամի	Singular
քերականագետներին	Plural
ատոմներից	Plural
ֆեոդալիզմից	Singular
տարբերելու	None
հապավումներից	Plural
գնահատող	None
չտենչացած	None
պարտվելիս	None
չշիկանալ	None
նատրիումով	Singular
արածելիս	None
երբեմնի	Singular
կոչող	None
մանուշակներ	Plural
յոդը	Singular
տույժի	Singular
կրծքիս	Singular
ֆիզիկականներիցդ	Plural
սրբիչներովս	Plural
կատակների	Plural
մրգերին	Plural
բավարարում	None
չպայմանավորված	None
չփքվել	None
մեղրամսի	Singular
մյուսլիներիս	Plural
թամբերովդ	Plural
սկզբնաղբյուրներ	Plural
քարմանիս	Singular
հայելու	None
հեռուստաընկերությունում	Singular
ցուցասրահը	Singular
փչացող	None
օրակարգը	Singular
բաժանվեց	Singular
գիշատելիս	None
բարիք	Singular
հաստոցի	Singular
կերերով	Plural
ճաշելիք	None
ուրուր	Singular
ավագանուն	Singular
ծիծաղաշարժներումս	Plural
մատուռներից	Plural
սրտաշարժելու	None
զորավարը	Singular
արդյունքներից	Plural
կարծրախտ	Singular
մեքենաներին	Plural
ընկղմվել	None
հատակ	None
վայրերումդ	Plural
ուկրաինացիները	Plural
խնչելիք	None
հատկացնել	None
պատշգամբ	Singular
նեղանալու	None
ձիաստաններիդ	Plural
ստորագրեր	Singular
քիմիային	Singular
վիկինգներ	Plural
շալվարի	Singular
ջերմերի	Plural
թուլացան	Plural
արթուն	Singular
ոսպնյակից	Singular
բոլորիդ	Singular
գիշերվան	Singular
գետնառյուծներիցս	Plural
հավաքածուների	Plural
շաղախով	Singular
հացահատիկի	Singular
պաշտոնական	Singular
ոգում	None
էրիկ	Singular
վհատիչներից	Plural
ծղրիդ	Singular
առաքելությունների	Plural
խառնելու	None
աղանդավորներ	Plural
չեմպիոնները	Plural
շենքում	Singular
հուզող	None
տոնում	Singular
վերագրվել	None
ատաման	Singular
դատապարտել	None
վանքերը	Plural
տասերորդները	Plural
կարելու	None
եպիսկոպոսների	Plural
հնչյունը	Singular
ած	Singular
պսակից	Singular
ծովագնացը	Singular
կողքերից	Plural
մզկիթը	Singular
իշխանափոխություններով	Plural
ծծող	None
սմարթֆոնների	Plural
վերնագրեր	Plural
գլխարկներով	Plural
շիջուցանելու	None
քանդվել	None
գելող	None
կացիններ	Plural
ողողվող	None
ավանը	Singular
ազդրոսկրին	Singular
հակամասնիկի	Singular
լեհերին	Plural
արեւային	Singular
բրդին	Singular
ծորանը	Singular
ալտի	Singular
հակահերոսներիցդ	Plural
ոսկեներովդ	Plural
դյուցազուն	Singular
մեքենայից	Singular
առաքելությունից	Singular
առյուծներին	Plural
աղերս	None
մօտենան	Plural
ալաններին	Plural
մեծարում	None
ցցունքների	Plural
գանգրացնում	None
ընձուղտով	Singular
ուդմուրտներ	Plural
առաջնությանը	Singular
պատիժ	Singular
տնօրինել	None
շփոթելիս	None
լուտեցիումի	Singular
աջաբսանդալ	Singular
կամարներ	Plural
սահմանում	None
երթանք	Plural
ֆլեշմոբի	Singular
օազիսներ	Plural
ջեռդ	Singular
լոուրենսիում	Singular
կարստերում	Plural
պարգեւները	Plural
արբած	None
երամակներով	Plural
էպոսը	Singular
հակազդելու	None
ավագ	Singular
աջակցել	None
ջանար	Singular
կահույքը	Singular
պարտավորություններով	Plural
կաղապար	Singular
էլեմենտները	Plural
կտուց	Singular
հանգստանաք	Plural
օգոստոսից	Singular
հեգել	None
արտասվելու	None
տեսլականներովս	Plural
զխկտելիք	None
հերքումը	Singular
զարկերակը	Singular
ականատեսի	Singular
մեծարվել	None
չխայթել	None
ավտոբուսներ	Plural
վախեցնել	None
կանգն	None
մրգերից	Plural
թերակղզիներից	Plural
սարդենիներդ	Plural
բացառվող	None
վաշտում	Singular
վայել	None
ձեռնոցներին	Plural
հայհոյի՛ր	Singular
վճռող	None
կտղե՛ք	Plural
մետաղալարից	Singular
մայրենին	Singular
չսփոփվող	None
գովելու	None
սայթաքում	None
մահափորձին	Singular
աղորիքներ	Plural
ջունգլիներով	Plural
վարսավիրը	Singular
կեղտոտող	None
շահագործականի	Singular
պղպեղիս	Singular
հայրանունները	Plural
ածել	None
ռոդիումը	Singular
չհյուսեր	Singular
հրեադ	Singular
սառնարաններում	Plural
աղատել	None
աշտարակը	Singular
քննում	None
դրսեւորվել	None
դրդում	None
ֆոտոններդ	Plural
ավելուկի	Singular
հաս	Singular
հետազոտ	None
վերադառնալու	None
վերքի	Singular
բարիումի	Singular
գորով	None
հարող	None
պատմությունում	Singular
չագարականացող	None
թզուկ	Singular
սիրեկաններ	Plural
սիրուած	None
կանանցով	Plural
հուշարձանով	Singular
կայսերապաշտականդ	Singular
ռեակցիայով	Singular
տեսարանները	Plural
բարբառներով	Plural
ալկոհոլայինում	Singular
համբուրվում	None
թագով	Singular
սավառնելիք	None
դրսեւորել	None
մերձենալիք	None
կոնդ	Singular
բռնաբարելու	None
թաքցնել	None
հնչյունաբաններին	Plural
շաղախները	Plural
հովհարով	Singular
աշտարակների	Plural
չխրոխտացող	None
կապվածության	Singular
դարանակալել	None
շտապի	Singular
ձետիս	Singular
տուփից	Singular
ծովածոցեր	Plural
գիտակցող	None
երակները	Plural
կամենալիք	None
տառադարձությունը	Singular
քերեն	Plural
թակարդներ	Plural
տարողությունը	Singular
սխրանքը	Singular
աճուրդում	Singular
վաստակում	Singular
մանրագորներին	Plural
այծքաղ	Singular
փոխանակելու	None
էլեկտրոնների	Plural
բացառեց	Singular
հանքերի	Plural
մոլորվել	None
կուլակների	Plural
արդարացվել	None
գանգրենա	Singular
վիճել	None
հառաչող	None
երիկամներով	Plural
ադամանդի	Singular
կայծառներ	Plural
հրաժեշտներից	Plural
դիսկոտեկի	Singular
ծխում	Singular
նստարան	Singular
կառչող	None
հանելուկում	Singular
ճարպի	Singular
սեղանատամումս	Singular
թերակղզում	Singular
ապացուցում	None
պատկանող	None
լոգարիթմում	Singular
հեգնում	None
վերջնախաղի	Singular
ազգանուններով	Plural
քորել	None
լրտեսության	Singular
արհեստանոցի	Singular
այլանդակությունումդ	Singular
ելուստներից	Plural
ոսկյա	Singular
կրած	None
զգեստներով	Plural
աքս	Singular
կիպարիս	Singular
աղյուսակ	Singular
պարտված	None
կենդանիներին	Plural
սանդուղքով	Singular
սիրվում	None
կապահովացներ	Singular
կենդանիի	Singular
կոչելու	None
շփել	None
քնն	None
կասպերը	Plural
սպասարկեց	Singular
տուժել	None
սերմի	Singular
ռեստորաններից	Plural
վճարել	None
կախելու	None
աղավաղում	None
ճառերից	Plural
կոմպոզիտորների	Plural
քուն	None
ճառում	Singular
հայլի	Singular
ֆիլմը	Singular
մերկացնել	None
վերքից	Singular
չորոճեց	Singular
առաքելու	None
հոկեյի	Singular
փրփրում	None
կանչելու	None
չշողացի	Singular
ավազաքարերով	Plural
ներբեռնվել	None
նեղուցով	Singular
չվախենալ	None
հաճախելիության	Singular
օրգանիզմները	Plural
դժարումս	Singular
ընդգծած	None
վարած	None
ամպրոպը	Singular
քարայրներում	Plural
սովորենք	Plural
ազգանուն	Singular
չտարվել	None
չհոգացող	None
օղի	Singular
զորախմբի	Singular
շիթերը	Plural
փորձվել	None
կրիաներին	Plural
կաքավ	Singular
ուց	Singular
կազակների	Plural
բացառվել	None
խռմփացինք	Plural
հայտարարվել	None
աքեմենյան	Singular
մաքառելու	None
քցել	None
մայիսյանի	Singular
հյուծվել	None
դարպասապահներից	Plural
աղքատներիս	Plural
շնչելիս	None
խմում	None
հայացքից	Singular
քանդում	None
սարդոստայն	Singular
սահմանած	None
խաղատանը	Singular
թարգմանելիս	None
հոբելյանին	Singular
թակերիցդ	Plural
խանձերիցս	Plural
վայելել	None
ածանցներով	Plural
մեքսիկացի	Singular
ջանքեր	Plural
առաջադիմելու	None
չփտել	None
հորթերի	Plural
չարացած	None
անեկդոտով	Singular
պայմաններով	Plural
մասնակցով	Singular
գետնառյուծներիցդ	Plural
ընթացան	Plural
հեղեղել	None
քննող	None
վառոդի	Singular
գիլասում	Singular
տոհմից	Singular
ազգությանը	Singular
քաղաքը	Singular
չալեկոծած	None
ընկերուհիները	Plural
դարանակալ	None
պանդոկին	Singular
աճեց	Singular
ահաբեկիչները	Plural
իղձերովս	Plural
երգիծել	None
մեկնաբանությունները	Plural
զառ	Singular
չարիքը	Singular
աքիլլեսյանի	Singular
խորովածներով	Plural
կեչուտ	Singular
փորելու	None
ամրոցը	Singular
ստուգես	Singular
խորանների	Plural
հումքի	Singular
կայանը	Singular
ժամացույցներ	Plural
արդարացնելու	None
առաջադիմությանը	Singular
կենսուրախ	Singular
լուրերը	Plural
տանկերից	Plural
մեծացնել	None
գներ	Singular
պանթեոնում	Singular
մեծաց	None
շքանշանումս	Singular
հաստոցով	Singular
քորին	Singular
կարտերի	Plural
չբարբանջեմ	Singular
ցեղերում	Plural
լորտու	Singular
հատեմ	Singular
բացառությունը	Singular
սպանեցին	Plural
բոզոն	Singular
շարահյուսությամբ	Singular
բանտարկած	None
ագահելիք	None
համակարգում	None
մխիթարել	None
ներկայացնեին	Plural
կերակուրներից	Plural
ճշգրտվել	None
պատրանքի	Singular
կառուցվածքով	Singular
ավելուկով	Singular
գրաբարի	Singular
վնասվածքները	Plural
անզգայանայինք	Plural
վճար	None
օգոստոս	Singular
հրթիռ	Singular
հնարքներ	Plural
խոչընդոտների	Plural
տեղեկացրել	None
զրույցները	Plural
մեղանչում	None
ամրոցները	Plural
տարածեք	Plural
սպասավորները	Plural
լծում	None
հուսահատեցնում	None
փոխհատուցելիք	None
գրաբարովդ	Singular
ռադիում	Singular
ըմբիշ	Singular
գանգրաձեւից	Singular
հետույքի	Singular
վերնագրերը	Plural
մարգարեություն	Singular
թարգմանություններին	Plural
հեռավորություններով	Plural
գաղտնիքներին	Plural
փոխարինած	None
պարտիայից	Singular
պարիկիս	Singular
արջամուկը	Singular
գայթակղել	None
պատրաստել	None
իշխանների	Plural
եբրայերենի	Singular
փղերի	Plural
կայծքար	Singular
աներկյուղություններում	Plural
ցածրից	Singular
թով	None
կողքերի	Plural
վերծանել	None
սառ	Singular
մատյանները	Plural
չբզզացող	None
սրճարաններ	Plural
ակոսներով	Plural
հումք	Singular
մաթեմատիկոսի	Singular
տարիքից	Singular
չդիեին	Plural
ըմպելիք	None
սավառնելու	None
մատուցում	None
ընդելուզող	None
ահաբեկես	Singular
լքում	None
փեսա	Singular
շփոթվել	None
տժվժիկներ	Plural
ծայրերին	Plural
նվագվել	None
վտարումներով	Plural
ջունգլիի	Singular
արածելիք	None
տմարդի	Singular
նեխեին	Plural
հարգելիս	None
չառաջադիմած	None
արգելվել	None
հայը	Singular
վկայությունից	Singular
ավանդությունների	Plural
թռել	None
պեղվել	None
այբուբենում	Singular
փահլեւանությունիցս	Singular
շարունակելու	None
կոկիկ	Singular
պարտություններից	Plural
նկարներով	Plural
չեխական	Singular
տնակների	Plural
չքերծած	None
հրեց	Singular
ժամադրություն	Singular
նախադասության	Singular
ռազմիկները	Plural
նեոդիմի	Singular
կայծքարից	Singular
ձուլում	None
ուսանելու	None
փշերով	Plural
քառյակները	Plural
պտղատու	Singular
ստեղնի	Singular
չթարգմանել	None
էթում	None
հայագետ	Singular
թավումդ	Singular
ակներեւ	Singular
հետեւանքները	Plural
արշավանքիս	Singular
բացատրութիւնդ	Singular
երկայնաբանություններիցս	Plural
արտագաղթած	None
մեծությունները	Plural
կծելիս	None
վանեցի	Singular
խեժից	Singular
ըմբիշներից	Plural
գնահատում	None
խնդրանքներիս	Plural
վտակի	Singular
հածելու	None
չավանդած	None
բուսանել	None
դատարկելու	None
կառքերի	Plural
հրաբուխ	Singular
արմաց	None
ցուրտ	Singular
նացիստդ	Singular
քարտ	Singular
ամիրա	Singular
լրիվներ	Plural
էլեկտրականությունը	Singular
օգտագործելու	None
հիմունքով	Singular
չահագնանալ	None
կամենում	None
տապիցս	Singular
չչաղացած	None
անապատում	Singular
հայցող	None
շինականներին	Plural
կողպեքի	Singular
արմունկով	Singular
զատել	None
կտակարանը	Singular
կխնչեին	Plural
որոճող	None
շնաձուկս	Singular
ուժեղացած	None
մարխ	Singular
արմավ	Singular
պարտվում	None
կլանել	None
մեծամասնության	Singular
ծիծաղացող	None
իլին	Singular
վերադարձող	None
ահաբեկելու	None
բացատրություններ	Plural
վտանգավոր	Singular
տանձ	Singular
լրացումները	Plural
դարպասին	Singular
հոլովակների	Plural
կարած	None
թենիսիստի	Singular
մարզադաշտերից	Plural
սումոյի	Singular
գեղմը	Singular
արագությունների	Plural
կծե՛ք	Plural
ագահ	Singular
հասցներ	Singular
էրեկցիան	Singular
բարելավեց	Singular
այծերը	Plural
շքախմբի	Singular
հարգ	None
համենայինք	Plural
ողջույններ	Plural
խրախուսվել	None
կթոտելու	None
մեկն	None
օդանավակայանից	Singular
պարին	Singular
արտոսրս	Singular
տպիչիս	Singular
մրգով	Singular
կործում	None
ապստամբել	None
չծփած	None
բուշտներով	Plural
հրամայեցին	Plural
ամառանոցը	Singular
կենսաֆիզիկայով	Singular
սաղմերից	Plural
չաներկյուղացած	None
քանդելու	None
տեղեկությունում	Singular
կուղեկցի	Singular
գեղմումս	Singular
նմանները	Plural
չվերթ	Singular
մաքրած	None
աճեցնում	None
սելավներ	Plural
ապաշխարում	None
քաղաքներ	Plural
խորշերդ	Plural
թացերով	Plural
վիրուսներին	Plural
մատղաշների	Plural
կապացուցեն	Plural
մեզոն	Singular
բանալ	None
ակունքներին	Plural
հայտարարություններով	Plural
կարօտող	None
հեղափոխությամբ	Singular
թզենի	Singular
ոսկրի	Singular
պաշտամունք	Singular
օֆիսը	Singular
գյուղերով	Plural
արյունաքամ	Singular
թրթնջուկի	Singular
խառնող	None
տաքության	Singular
համբարձումը	Singular
քվարցից	Singular
հուսալքված	Singular
ելույթներից	Plural
արշալույսներիցս	Plural
զվարճության	Singular
դրվատելու	None
քաղաքներից	Plural
արյունահոսող	None
ծնել	None
կենսաբանություններիս	Plural
պարոններ	Plural
ճարպեր	Plural
մանթերից	Plural
հեռացրի	Singular
թենիսիստների	Plural
շվեդականների	Plural
քուրայի	Singular
չհատկացնող	None
զգուշացումներին	Plural
տեղանունների	Plural
գնդերումս	Plural
արծրունյացումդ	Singular
կծածանեիք	Plural
բուսնելու	None
բուսնող	None
սոսինձ	Singular
տպելու	None
գլխարկներ	Plural
ստեղնաշարով	Singular
շփոթված	None
ջայլամ	Singular
բողկը	Singular
ռեպին	Singular
չկերակրած	None
արածի	Singular
պարսկական	Singular
բացատներում	Plural
երդվում	None
սիեստաներիցդ	Plural
թախտին	Singular
կոմունիստական	Singular
սենյակի	Singular
ձվաձեղները	Plural
խնամած	None
զվարճանում	None
փաստաբան	Singular
հեծեծեց	Singular
չհելնել	None
կենդանաբանիցս	Singular
քվարկները	Plural
բաժանված	None
գործադուլում	Singular
մատուցող	Singular
այտուցներ	Plural
ուսուցիչների	Plural
անկման	Singular
չհայտնել	None
ընդգծեց	Singular
անտուն	Singular
շալվարներիդ	Plural
կայացած	None
բարքը	Singular
քանդակներին	Plural
ցածրահասակ	Singular
ժողովածուներ	Plural
բացառված	None
գրախոսության	Singular
նվեր	Singular
ապահովիցդ	Singular
գոյեր	Plural
բորբոքվել	None
արքունիք	Singular
օրակարգ	Singular
հասունին	Singular
ստամոքսից	Singular
զարկերակ	Singular
խորհուրդներից	Plural
էլեկտրոնները	Plural
սխալները	Plural
չխեղդեցին	Plural
կաթնասունները	Plural
անրակներիցդ	Plural
ճիրաններից	Plural
ակնարկները	Plural
խոշորացույցի	Singular
ավանդել	None
հեռացնելու	None
ուսուցիչներ	Plural
ծառայել	None
բաղաձայնները	Plural
հրթիռների	Plural
հավատացել	None
ծծելու	None
հանցագործներից	Plural
պատարագից	Singular
գուրալու	None
մարտկոցում	Singular
ավագին	Singular
պատկերասրահիս	Singular
գել	None
սավառնող	None
տնտեսությունում	Singular
զետեղելու	None
հայուհու	Singular
հավաքածուի	Singular
ամանորյա	Singular
վառվել	None
հատիկը	Singular
կորեկով	Singular
կարճի	Singular
հավատքներ	Plural
խոնջիցդ	Singular
բանականությանը	Singular
դիսկոտեկների	Plural
ադամանդներով	Plural
կալանքից	Singular
կարենան	Plural
մեկնեց	Singular
հեռագիր	Singular
վրացերենին	Singular
ժամացույցին	Singular
ջունգլիներում	Plural
սրիչ	Singular
տատմերը	Singular
կաշկանդելու	None
վանդակի	Singular
առջեւին	Singular
շնչել	None
ավելացվել	None
հնդկահավ	Singular
հայտնեց	Singular
երկսայրիների	Plural
հագնել	None
կերդվեք	Plural
չկախարդվեր	Singular
մոնիտորի	Singular
աշխատավարձի	Singular
փայլունացումովդ	Singular
ենթակառուցվածքներ	Plural
գործարաններին	Plural
փիլիսոփայությունը	Singular
փորոքներումս	Plural
գոհացնող	None
պատառը	Singular
ընկճում	None
լենի	Singular
պատվիրակության	Singular
չհուռթացած	None
ջանա	Singular
ընկճելու	None
արսենը	Singular
մարկեր	Plural
վերնագրերին	Plural
շփոթվում	None
հրավերով	Singular
միջատի	Singular
համարելու	None
կամարին	Singular
ապացուցող	None
հաղարջ	Singular
կրից	Singular
զվարճությունների	Plural
շաքարավազից	Singular
մանր	Singular
տառապել	None
չքոչեցինք	Plural
բավարար	None
չփրթող	None
մերձեցել	None
բացակայի	Singular
անմահները	Plural
կենցաղից	Singular
կրոնի	Singular
ամերիցիումդ	Singular
գերաններով	Plural
սոմալին	Singular
շվեդի	Singular
գամփռ	Singular
շուրթերով	Plural
բացառություն	Singular
պիցցայիս	Singular
տարբեր	Singular
արփին	Singular
վանքերով	Plural
հորդորելիս	None
վրդովվում	None
լվացված	None
չհարող	None
խոսում	None
հայ	Singular
մետաղալարերի	Plural
աստատը	Singular
հղիանալու	None
մատուցեց	Singular
ընդոստում	None
հուսահատվում	None
ցածրահասակով	Singular
պարբերությունը	Singular
բզեզի	Singular
ժամացույցներից	Plural
զարդարանքի	Singular
ակնհայտնիներդ	Plural
պարանոցի	Singular
խոչընդոտ	Singular
իոններով	Plural
պատուհանի	Singular
պղպեղը	Singular
արեւադարձերովդ	Plural
կերակրող	None
հերոսներից	Plural
անագը	Singular
գծիկը	Singular
ներկայացրած	None
պատուհասովս	Singular
զանգապանների	Plural
կոչումներումդ	Plural
արտասահմանցուցդ	Singular
ձուլող	None
արեւմուտք	Singular
հայկազունին	Singular
չչափող	None
տպվել	None
ամառանոցի	Singular
անմահովս	Singular
լայնքով	Singular
քերի	Singular
ծնվել	None
մեծանուն	Singular
փայլատակում	None
փայլունացել	None
գոհացնել	None
իսպանացիներին	Plural
աջակցելիք	None
գրասենյակներից	Plural
մսանումս	Singular
միանալու	None
քերել	None
աներ	Singular
արդարացնող	None
ադրբեջանցիներ	Plural
ձեւույթիցս	Singular
հայցում	Singular
մագման	Singular
զգացմունքները	Plural
փոխանակում	None
հանվեց	Singular
հերոսությունների	Plural
ինադների	Plural
ավետիսում	Singular
օգտագործվել	None
ուղղությամբ	Singular
փաթեթում	Singular
արյունահոսություն	Singular
քիմիականի	Singular
կովի	Singular
հոգում	None
հասարակածից	Singular
կողոպտում	None
գիշերվա	Singular
հանցագործները	Plural
հիասթափեցնում	None
գրգռելու	None
վարձ	Singular
վախենալիս	None
արեւելյանիցդ	Singular
թիկունքի	Singular
չսարսափող	None
քիմիայով	Singular
գանգրաձեւովս	Singular
հիմնավորում	None
շրջվող	None
չտեսած	None
պատկերեց	Singular
մակդիրները	Plural
հանճարումդ	Singular
ձվարանում	Singular
փոթերում	Plural
պորտուգալացու	Singular
գործընկերների	Plural
հաշվման	Singular
տեսախցիկներից	Plural
փռշտալիս	None
մշակույթների	Plural
հրեն	Plural
արտաքսեին	Plural
քնարով	Singular
հարվածներին	Plural
հարաբերությունը	Singular
քաղաքներով	Plural
կազմակերպչի	Singular
մենինգիտի	Singular
խայթող	None
թափվեին	Plural
չներկայացնեիր	Singular
հիացած	None
այցելող	None
շտապում	None
վանդակների	Plural
վարել	None
սիլիցիումի	Singular
համարում	None
նավակայանները	Plural
ջրանցքը	Singular
չմղած	None
մատիտ	Singular
հնչույթներ	Plural
բնագրերում	Plural
նախարարների	Plural
վիճակը	Singular
ապրանքներից	Plural
մզկիթները	Plural
գրողների	Plural
հաճախել	None
չգիտակցվող	None
հասունը	Singular
չլծած	None
պոմպերից	Plural
օղակ	Singular
համակարգող	None
չկծի	Singular
ջանան	Plural
բացատրենք	Plural
չվերթումդ	Singular
մթնոլորտը	Singular
լրջամիտներիցդ	Plural
ակտինիումներումդ	Plural
փաստով	Singular
կնձնիներիս	Plural
շագանակենի	Singular
ավանդվել	None
ձգտում	None
ամուսնալուծությունից	Singular
խրթեիք	Plural
խրախուսում	None
աղիքը	Singular
կոմսուհու	Singular
խոյանում	None
խաղալիքներով	Plural
այրված	None
խոչընդոտող	None
ցինկից	Singular
դարակները	Plural
պիրոլների	Plural
ուրախ	Singular
ծեփամածիկին	Singular
բեյսբոլը	Singular
չհամբուրել	None
մաքրեն	Plural
թիկունքում	Singular
ազնիվի	Singular
չմտադրել	None
մարգագետնում	Singular
ղազախներ	Plural
պիտույքների	Plural
բզեզը	Singular
վահանագեղձովս	Singular
գիրուկ	Singular
կոտորածներ	Plural
արտագաղթել	None
ստուգող	None
ցեց	Singular
հինդիում	Singular
ուսանողներից	Plural
առաջնություններ	Plural
փոթերը	Plural
գողացան	Plural
չորացնող	None
արծրունյաց	Singular
սրճարանը	Singular
կասկածելիությունիցս	Singular
հալոգենները	Plural
մեխանիզմ	Singular
ալմասները	Plural
չածանցած	None
դանիերեն	Singular
պատմվածքներից	Plural
շփոթում	None
սահմանեն	Plural
երթուղիներ	Plural
սրճագույն	Singular
կերպարանքով	Singular
ստուգելիս	None
կողմնացույցներդ	Plural
ծոծրակից	Singular
արքադիս	Singular
հերքված	None
օծանելիք	Singular
ցանկացող	None
մարտակառքի	Singular
մոլեկուլից	Singular
խորքի	Singular
կենսաբանությանը	Singular
ավարի	Singular
տաշդ	Singular
կայծ	Singular
մայրուղում	Singular
լավ	Singular
խնդրանքը	Singular
բազումի	Singular
ճշգրտել	None
ֆրիզ	Singular
դատարանների	Plural
հավելվածների	Plural
ահագիններիս	Plural
չկատարած	None
հեռուստաընկերությանը	Singular
ֆրիզը	Singular
ինքնագիր	Singular
հել	None
կարողանալ	None
մարմարը	Singular
չզվարճացնող	None
չհորանջող	None
արհամարհել	None
քաղող	None
բակ	Singular
թիակներիդ	Plural
խռմփալիք	None
զխկտել	None
նախասրահով	Singular
կազմակերպել	None
հրդեհումս	Singular
գրամներով	Plural
գործարքից	Singular
ալիս	Singular
չքարոզեիր	Singular
հյուս	None
գանգրվելիս	None
ալտ	Singular
բնորոշվել	None
խայթոցս	Singular
օժանդակելու	None
խաղալիքներին	Plural
խոհեմիցս	Singular
մօտենալ	None
փուշ	Singular
մահացող	None
աղվան	Singular
հայրենիքում	Singular
անճոռնի	Singular
ծավալներ	Plural
ադրբեջաներենից	Singular
գրպանը	Singular
հանգույցներ	Plural
անասնաբույժով	Singular
լեյտենանտ	Singular
հայցել	None
վերջինում	Singular
հելնել	None
բամբասովս	Singular
հետազոտելիս	None
թարթիչները	Plural
վարդապետից	Singular
քշելու	None
սառույցից	Singular
գործարան	Singular
ավելացնի	Singular
լեյտենանտները	Plural
լողացող	None
անհանգստանում	None
անձրեւելու	None
գիշերայինը	Singular
բգովդ	Singular
մղձկեցիք	Plural
հագ	None
մթություն	Singular
լեզվաընտանիքներով	Plural
կելտերին	Plural
բացականչող	None
թավջութակներով	Plural
չճաշեիք	Plural
կանոնները	Plural
խմ	None
կանչում	None
օրականը	Singular
բարբառում	Singular
խտրականության	Singular
սուզեն	Plural
չվրդովող	None
ալյումինովս	Singular
կարեկցում	Singular
կառուցվածքի	Singular
քսենոնը	Singular
ֆերմիոնները	Plural
ասացվածքները	Plural
երկարությանը	Singular
ծլելու	None
երկխոսություններում	Plural
կործանեցին	Plural
չարածեցնող	None
էլեկտրոններով	Plural
գերեզմանոցին	Singular
գնել	None
երկերի	Plural
շեշտելիս	None
կղբենիները	Plural
պատկերասրահները	Plural
բերիլիում	Singular
ձարխոտովս	Singular
միտ	Singular
կղզիախմբում	Singular
խարզան	Singular
ապերը	Singular
չբաղձալ	None
ղանձլամեր	Singular
ալեբաստրեի	Singular
ուսուցչից	Singular
կծած	None
կերտելիս	None
ոխացել	None
կեղծամով	Singular
որջ	Singular
հրկիզող	None
ազոխի	Singular
ընծաները	Plural
ատոլ	Singular
արոտավայրերը	Plural
կարողացած	None
աննպաստներով	Plural
կառչելու	None
բոբիկներին	Plural
յուղաբլիթներիցս	Plural
կարօտելու	None
չսառչող	None
տեսած	None
տառադարձ	None
ճտի	Singular
բաոբաբ	Singular
երկրաբանության	Singular
վաճառքին	Singular
չծփեցիք	Plural
դեղինից	Singular
վարակը	Singular
տեւողություններով	Plural
ճահիճներ	Plural
հնարքները	Plural
համակարգեր	Singular
գործիքին	Singular
նիստուկացերովս	Plural
չճողոպրել	None
ձեռնոցների	Plural
տեսիլքները	Plural
ժողովածուի	Singular
հնագույնը	Singular
վարդենուց	Singular
սպիրտը	Singular
նախդիրը	Singular
չանորոշանային	Plural
մտցնելիս	None
անվեհեր	Singular
թքելու	None
հղիացած	None
չստրկացրած	None
կուլտուրադ	Singular
էլեկտրոդը	Singular
վանելու	None
ֆոտոններին	Plural
առերեսվել	None
չդատապարտած	None
չգայթակղեցիք	Plural
մեծեր	Plural
բարելավեմ	Singular
արտադրությունից	Singular
հայեցակարգ	Singular
հիմարացնող	None
բարբառներին	Plural
տերմինին	Singular
ապաշխարելիք	None
խորհրդի	Singular
միանում	None
ալյանսի	Singular
կայսրություն	Singular
համարել	None
կղբենովդ	Singular
ընկճախտի	Singular
անվրդով	Singular
թովվել	None
գագաթնաժողովին	Singular
զանգել	None
պայմանավորված	None
ակնածանքով	Singular
հոլանդացիս	Singular
կառուցվածքին	Singular
ողբացող	None
կատարների	Plural
առերեսվեցիք	Plural
շաշկի	Singular
անվտանգությունը	Singular
գողացած	None
լուց	None
գրգռեն	Plural
արսենով	Singular
մորուիդ	Singular
ներբողի	Singular
եբրայեցիներիցս	Plural
ոսկր	Singular
չհղեցող	None
հարթուկել	None
գնացող	None
որոշումներով	Plural
պարմեզաններումս	Plural
նավում	None
փքումներիս	Plural
ըմբշամարտից	Singular
ողողվել	None
փնջեր	Plural
հեծած	None
ճառերում	Plural
ներխուժած	None
ձախող	Singular
պարապած	None
չխմբագրել	None
պղծող	None
շատացել	None
մեզոնների	Plural
շարժապատկերներ	Plural
մահանա	Singular
սպասքի	Singular
այգիներով	Plural
արգանակով	Singular
կտեւեի	Singular
լավը	Singular
խցիկով	Singular
վերարտադրություններումս	Plural
պարաշյուտներ	Plural
տանուտիրոջ	Singular
տեւած	None
տաքությունը	Singular
մղող	None
գրառ	None
օրհնվել	None
համատեքստից	Singular
ցել	Singular
թղթադրամի	Singular
առկայծող	None
կանոնը	Singular
բառակազմությունը	Singular
զգեստդ	Singular
ատելությունը	Singular
ճեմեիր	Singular
թարգմանվել	None
հազայիր	Singular
տրոլեյբուսի	Singular
կարողանալու	None
թոքեր	Plural
հանումներում	Plural
կանխեց	Singular
չհանձնեմ	Singular
կանխագրելու	None
պրազեոդիմներից	Plural
տոհմով	Singular
առաջարկությունը	Singular
աշակերտներից	Plural
խցի	Singular
թարգմանելու	None
վաճառող	None
վտիտ	Singular
հոտած	None
ժպիտ	Singular
դատապարտվել	None
արվեստի	Singular
փշեր	Plural
ֆիննուհիների	Plural
կառավարվել	None
ըմպեն	Plural
եպիսկոպոսներին	Plural
մակդիրներ	Plural
կալվածքներում	Plural
չաղարտող	None
առաջադիմումումդ	Singular
մեյդանումդ	Singular
հատելու	None
պուճուրիկիս	Singular
ամնիստիայումս	Singular
սկուտեղ	Singular
թեզաններիս	Plural
մրցող	None
որովայն	Singular
նորերի	Plural
անհրաժեշտությանը	Singular
ստուգեք	Plural
հոսող	None
ստորագր	None
բնութագրող	None
բարեւելիս	None
բաղարջիցդ	Singular
մեծարելու	None
խալիֆայությունից	Singular
սիրահար	Singular
հայրերին	Plural
ծորան	Singular
շպռտելիս	None
էտում	None
ճառագայթները	Plural
փակի	Singular
ազդանշան	Singular
երկխոսությունները	Plural
հայրերի	Plural
համակարգել	None
համբեր	None
գայթակղում	None
կրոններիցս	Plural
մեջտեղից	Singular
պնչերը	Plural
չկարօտած	None
երգչուհին	Singular
սպիները	Plural
գողացող	None
կզակը	Singular
խաչբառից	Singular
առագաստ	Singular
ամպրոպից	Singular
քարտում	Singular
ապահովեց	Singular
ճկույթը	Singular
նեխած	Singular
կերպերիս	Plural
թաղանթը	Singular
պղծելիք	None
չհասկացա	Singular
միապետությանը	Singular
օգտագործեին	Plural
կասկածները	Plural
չափազանցում	Singular
վար	None
լվանալու	None
աղունիկ	Singular
հաճախությունները	Plural
ամիրաների	Plural
պետությանը	Singular
անհանգստացնել	None
ալպականերովդ	Plural
խարխալենք	Plural
բակը	Singular
մարտկոցները	Plural
աշխարհագրությունը	Singular
կամարի	Singular
ակների	Plural
չհիանալ	None
պաշարները	Plural
քրոմը	Singular
դեղատանս	Singular
մերու	Singular
լուսանը	Singular
շքանշաններին	Plural
ազդել	None
արոտ	Singular
դաշտաններդ	Plural
ապշած	None
հոլով	Singular
չափեց	Singular
բողբոջ	Singular
թաքցրած	None
տաջիկներով	Plural
փակում	Singular
կքչքչաս	Singular
ստորագրում	None
չառերեսի	Singular
ծնված	None
ողջագուրած	None
հերքել	None
իրանահայեր	Plural
երկկենցաղների	Plural
չկտակեցի	Singular
վառարանների	Plural
հարաբերությունները	Plural
վերագրելու	None
ռուբիդիում	Singular
սարդոստայնի	Singular
տուրք	Singular
չքամած	None
բերբերի	Singular
ցանկանար	Singular
չբացառվեի	Singular
մուրճ	Singular
անհամեստությունս	Singular
տնակներով	Plural
ճանապարհորդությունները	Plural
խանություն	Singular
ցանկանալիս	None
հալող	None
մառանում	Singular
գլխում	Singular
ձվաձեւներս	Plural
նեյտրինոյի	Singular
խոյացող	None
սահմանվել	None
մասնակիցներ	Plural
չթրջող	None
գոհացնելիք	None
նախածանցների	Plural
ծովեզերքը	Singular
գանգրամազովս	Singular
խառնում	None
վարանելու	None
պողովատին	Singular
կոնականիս	Singular
հոտոտելիս	None
մեջտեղ	Singular
շուկաներին	Plural
արփիին	Singular
բուժումը	Singular
մօտենում	None
կներկայացնենք	Plural
հագեցնող	None
աղբը	Singular
երգիծած	None
թելադրիչիս	Singular
ստուգումներ	Plural
շեֆեր	Plural
քաղաքագետը	Singular
հենում	None
սամբան	Singular
աղբերովդ	Plural
չշարունակել	None
անապատին	Singular
ցեղերիցս	Plural
ջեռերովս	Plural
ճահուկի	Singular
գնչեցի	Singular
սովոր	None
հրեշտակին	Singular
փայփայի՛ր	Singular
ամուսնացնել	None
մայրենիներում	Plural
տեսուչների	Plural
ապահով	Singular
բանաստեղծը	Singular
վարանումներս	Plural
բախումներից	Plural
խորխելու	None
ընթացող	None
մարքսիզմ	Singular
վեպում	Singular
չատել	None
ջանացել	None
կառուցվածքում	Singular
մերկացող	None
արույրի	Singular
թխվածքը	Singular
բրդից	Singular
լայնշիովդ	Singular
առերեսվ	None
կործանող	None
ընդունակություններիս	Plural
աստվածը	Singular
անջրդիներով	Plural
չխածեցինք	Plural
զարմացել	None
սուսեր	Singular
քիմիկոս	Singular
նորերով	Plural
տուբերկուլոզ	Singular
հաստատունների	Plural
ատում	None
կազմակերպում	None
հերքվելիք	None
ձկնորսականդ	Singular
նահանգներ	Plural
անցում	Singular
վիճաբանած	None
չնվաղած	None
երկանաքարից	Singular
բողոքել	None
հագնվում	None
կրկեսը	Singular
բարբաջած	None
եվրո	Singular
տեսքը	Singular
փիլիսոփայությունից	Singular
արթնանալիս	None
թեփուկներ	Plural
բուսան	None
աշորայի	Singular
ապիրատի	Singular
մեծաբանե՛ք	Plural
բառապաշարից	Singular
խմեն	Plural
տակնուվրա	Singular
քիմքերիդ	Plural
փչանում	None
կոչերով	Plural
անցքեր	Plural
ցանկանային	Plural
չորանալ	None
զվարճացնելու	None
կռունկը	Singular
չարկանած	None
չդրսեւորի	Singular
կառավարել	None
շատանում	None
ջանով	Singular
փնտրում	None
ուղում	Singular
ստվարագլուխներից	Plural
հարսնանալու	None
առոգանությունը	Singular
ախտորոշվել	None
հառնած	None
բանաստեղծս	Singular
մոտոցիկլումս	Singular
փրփուր	Singular
տեւեք	Plural
ջրամբարի	Singular
չկալաք	Plural
երկյուղ	Singular
չթոռոմող	None
հեղեղած	None
ապաշխարող	None
վարդապետներից	Plural
դարանակալում	None
լկստվեցի	Singular
դարանակալած	None
կտցարների	Plural
կուլտուրա	Singular
վտարումից	Singular
ազդանշանում	Singular
մատույցներին	Plural
հազ	Singular
լավաների	Plural
գրանցումներ	Plural
ասպարեզների	Plural
թաղապետ	Singular
մասունքները	Plural
շենքերի	Plural
սելենի	Singular
պատրաստած	None
շնիկի	Singular
հազաս	Singular
վարելու	None
բդկել	None
արբանյակներում	Plural
հիասթափեցնել	None
երկերում	Plural
կինոյից	Singular
հանված	None
ուղղություններից	Plural
դրդեց	Singular
ճաշում	Singular
մոծակներին	Plural
հեղեղների	Plural
քառյակին	Singular
մտրակներ	Plural
կոմունիզմին	Singular
տոհմածառ	Singular
պայմանավորվածությունների	Plural
համբույրով	Singular
կապիկի	Singular
ժանգոտներս	Plural
հարվածից	Singular
կառչում	None
խցանը	Singular
օգտագործող	None
քերծում	None
մետրոպոլիտենը	Singular
տանկերի	Plural
հոտ	None
կնքել	None
ժամանակաշրջաններում	Plural
գորտնուկի	Singular
հետեւում	None
երբեմնիներով	Plural
փնտր	None
օծվել	None
կանանց	Plural
շիջելիք	None
կառավարություն	Singular
չհղիացած	None
կիրառվել	None
կոմունիզմի	Singular
լուսամուտներովդ	Plural
կառավարած	None
վիրուս	Singular
բառակապակցություններից	Plural
պատրաստեն	Plural
երկրպագուի	Singular
անցին	Singular
շարունակեցին	Plural
անզգայացնող	None
առողջացնեն	Plural
կխթեիք	Plural
խաղողը	Singular
հոտում	None
տեսող	None
ժանիք	Singular
վախենալու	None
աղբի	Singular
բողոքարկում	None
մանիշակներիս	Plural
ավազաքարերի	Plural
գարին	Singular
համակարգչից	Singular
չխարխլած	None
վնասը	Singular
նախածանցի	Singular
բնակվել	None
մեխակի	Singular
ճառը	Singular
սուրդ	Singular
զոհասեղանները	Plural
պարտիզանի	Singular
ավտոբուսի	Singular
կործանելու	None
զարդարանքներ	Plural
ներգաղթյալների	Plural
այցելած	None
հայտն	None
հավելում	None
արքայով	Singular
ստամոքսին	Singular
մատաղիս	Singular
անսասան	Singular
քվեներ	Plural
դատարաններին	Plural
առկայծում	None
կիրառել	None
կողոպտել	None
խեժով	Singular
լուծի	Singular
հորթը	Singular
մուրայինք	Plural
արտադրություններ	Plural
բորենիներ	Plural
քմծիծաղներ	Plural
վաճառքներից	Plural
հայրենակիցներ	Plural
շահեկան	Singular
առվում	Singular
փոխարինման	Singular
մեծաքանակ	Singular
տեղեկացնեն	Plural
նքողում	None
համակարգիչը	Singular
ողբալ	None
զնջիլներիցս	Plural
միացնելու	None
կատակերգություններին	Plural
թղթախաղի	Singular
ծխախոտ	Singular
մասնակիցներով	Plural
համեմունքների	Plural
բամիայումս	Singular
ժողովներում	Plural
ձիթենիներիս	Plural
մետր	Singular
մոլեկուլին	Singular
նեղանալ	None
իրիդիումի	Singular
միզեք	Plural
խեժը	Singular
ինքնասպանության	Singular
չխրոխտանալ	None
թրթուրները	Plural
հիմնախնդրի	Singular
պարանոցներովս	Plural
բանտարկել	None
հարվել	None
կուզենան	Plural
այցելելիս	None
բարքեր	Plural
շարժապատկերի	Singular
թավով	Singular
քարտուղարին	Singular
կոստղաշատներումդ	Plural
ազերիս	Singular
չափսեր	Plural
նշխարը	Singular
պղպեղով	Singular
տաղտկացի՛ր	Singular
թրծում	None
տնօրինող	None
այգուն	Singular
ագուցանելիք	None
լվանալ	None
որձերի	Plural
ոսկիների	Plural
բորբոքած	None
հիդրատներովս	Plural
սփոփվելիս	None
անհանգիստ	Singular
ուղարկեք	Plural
պայմանավորվում	None
հաշիվներից	Plural
քարշի	Singular
հոգատար	Singular
շրջակայքը	Singular
կոթողները	Plural
մատուցի	Singular
գործիքներում	Plural
բորբոքելու	None
վերջինիցս	Singular
լուտալ	None
տանջելու	None
հավելող	None
բումերանգի	Singular
զարմանալ	None
սպառնալիքից	Singular
ցեղասպանություն	Singular
ընկերք	Singular
հորանջած	None
զանկապաններիցդ	Plural
ծանուցումների	Plural
գարնանայիններովդ	Plural
լողափի	Singular
առաջադեմը	Singular
երկխոսության	Singular
թունելայինը	Singular
մկնաքիսներս	Plural
ազդանշանը	Singular
կարգիչդ	Singular
սոցիալիզմին	Singular
էակներ	Plural
զոմբիի	Singular
զարթնեցնել	None
քննարկմամբ	Singular
հածանավից	Singular
հերոսուհիներից	Plural
արդարացնել	None
հպատակվել	None
ճնճղուկ	Singular
սուպերմարկետ	Singular
քրդերից	Plural
չփողոտած	None
վերս	Singular
ձկնկուլը	Singular
սովորություններով	Plural
քարոզելիս	None
մոռացել	None
կազինոն	Singular
չխածեցիք	Plural
արտադրանքները	Plural
ձայնավորներից	Plural
տարվել	None
ուղիներին	Plural
ղեկերը	Plural
շնաձկներից	Plural
անեկդոտ	Singular
սմոգի	Singular
հերյունիս	Singular
ախտորոշմամբ	Singular
ամբողջությամբ	Singular
հարավից	Singular
առագաստներով	Plural
պարերից	Plural
հասարակածով	Singular
ռազմիկներ	Plural
հրկիզել	None
ուղեկցի	Singular
կրիաների	Plural
թեղին	Singular
ճառով	Singular
լկստելու	None
լաբիրինթոսը	Singular
մեծաշիթներս	Plural
շպրտում	None
վարչապետների	Plural
ընթանալիս	None
կատալիզատորիդ	Singular
թին	Singular
դեզ	Singular
սաղմի	Singular
ճուտ	Singular
համաձայնելու	None
ուսուցանելու	None
դատապարտում	None
շեշտել	None
ընթրիքը	Singular
գայռով	Singular
քարոզ	None
ավետարանների	Plural
փախցրին	Plural
հյուսում	None
նկարներում	Plural
արշավանքով	Singular
հեռախոս	Singular
չկախած	None
սեռ	Singular
գործոններից	Plural
հրեային	Singular
չշփոթել	None
գորտերի	Plural
ակունքին	Singular
հոբելյաններին	Plural
ծառայությունը	Singular
ավիաընկերություններ	Plural
նամը	Singular
հարգանքը	Singular
ախտորոշելիք	None
կուլտուրայով	Singular
շնիկները	Plural
գնչու	Singular
նիստը	Singular
ջիլ	Singular
լողավազաններ	Plural
փոխառություն	Singular
անցքից	Singular
խորանը	Singular
կթրծեի	Singular
ծնելու	None
տարաժամանակյա	Singular
ձեռնածու	Singular
ջհուդին	Singular
ծփելիք	None
չնվաղել	None
խմբագրես	Singular
սպասավորի	Singular
փքված	None
ճմլելիս	None
հորա	Singular
կարմր	None
հափշտակումներից	Plural
գլեմ	Singular
սխալվելիք	None
ծածկելու	None
Գարիկ	Singular
քարանձավներում	Plural
կազակներից	Plural
սիկտիրված	None
կաթողիկոսից	Singular
ֆիլմեր	Plural
բաժանվել	None
կեռի	Singular
պայմանավորվածությունը	Singular
ճանապարհներով	Plural
թաղերիդ	Plural
փռշտոցի	Singular
կանգնել	None
փերու	Singular
կազմակերպիչներ	Plural
խրձերը	Plural
զարմացնում	None
զոհասեղան	Singular
քարավաններ	Plural
պահպանել	None
դատարկվել	None
ակնամոմերին	Plural
վանեցին	Plural
օժանդակող	None
կշռում	None
լայնի	Singular
պրոտոնիդ	Singular
վան	None
ծափահարել	None
մարգարտածաղիկ	Singular
մտածելակերպով	Singular
մնացյալները	Plural
ճանճին	Singular
օբյեկտների	Plural
փախցնել	None
մաքրել	None
ժանրերին	Plural
ծնոտ	Singular
շողացող	None
կանաչին	Singular
պաշտել	None
ճեմասրահում	Singular
պատուհաններով	Plural
ցողկս	Singular
գլուխներից	Plural
թանաքամաններին	Plural
հատելիս	None
կորած	None
ջանասեր	Singular
պոզիտրոնը	Singular
դանիերենի	Singular
տեքստ	Singular
բլոգի	Singular
սկյուռի	Singular
կիլոգրամ	Singular
ներքնաձիգին	Singular
կոֆեին	Singular
հիր	None
կաշխատեն	Plural
փարթին	Singular
էլեկտրոններ	Plural
քարշած	None
եղջյուրի	Singular
արգելած	None
չվերուվարեցի	Singular
ուլունքներից	Plural
մերուս	Singular
տեղեկացնելու	None
խմբագրվել	None
ներբեռնումը	Singular
լոլիկով	Singular
քերած	None
նոյեմբերյաններին	Plural
աղբյուսիս	Singular
մղվել	None
գիսաստղեր	Plural
բանեցնելու	None
պատկերած	None
նահանգապետիս	Singular
ասսամի	Singular
հարսները	Plural
կիսել	None
բեկտած	None
չընգնող	None
կցորդիչներով	Plural
վեպերով	Plural
պատրաստություն	Singular
բառախաղով	Singular
հպարտանալ	None
հաջորդներին	Plural
դարպասապահների	Plural
խոպոպացած	None
ծխախոտների	Plural
հյուսի	Singular
շարունակում	None
ջանում	Singular
փոքրի	Singular
նիրհած	None
չահաբեկվող	None
ճառագայթներից	Plural
հավաքարարներիս	Plural
տուրքերը	Plural
փայլունացնելիք	None
թարթում	None
խմեցնել	None
խոչընդոտներով	Plural
սալորի	Singular
փողրակի	Singular
ծորանի	Singular
թթխմորով	Singular
ֆինների	Plural
հավաքածուն	Singular
թիթեռներին	Plural
թութակների	Plural
գանգրվում	None
լեռնագրականներովդ	Plural
կապտուկովս	Singular
աճեցրած	None
երջանկության	Singular
մարտնչում	None
այսօր	Singular
ինքնաթիռներ	Plural
չեմպիոնը	Singular
փորձեց	Singular
գիսաստղ	Singular
մերձեցավ	Singular
թրծելու	None
շեֆերի	Plural
հյուսելու	None
նպաստեր	Singular
բլիթ	Singular
վավերացումից	Singular
ձողիկովդ	Singular
հանցագործներ	Plural
կառավարություններում	Plural
ուսումնասիրեր	Singular
չարբել	None
տեգդ	Singular
խմբագրում	None
հպարտանում	None
ենթարկեցին	Plural
զարթօնքներում	Plural
խոցելիս	None
վառվում	None
երկրաշարժից	Singular
համարիչ	Singular
արձագանքելիք	None
կհմայեին	Plural
չհամակարգեցիք	Plural
պայթող	None
իշխանները	Plural
ծառայի	Singular
վարկած	Singular
քարանձավներով	Plural
փորձելու	None
մեծաբանելիք	None
արթնանալու	None
կերակրել	None
կույտի	Singular
փրփրել	None
ճագարներից	Plural
հարձակումը	Singular
հրկիզած	None
կոնֆետների	Plural
քիլում	Singular
մրջյունների	Plural
միանալ	None
բարդություններից	Plural
ակադեմիաներիդ	Plural
խմբագրեք	Plural
անհրաժեշտություններումս	Plural
բառարանների	Plural
խոնարհի	Singular
շաքարների	Plural
հուսալքությունիցս	Singular
աճեցնես	Singular
հիանում	None
զազրոտիս	Singular
զննող	None
կտակարանների	Plural
պայմանավորվող	None
գրգռելիք	None
թոռնիկը	Singular
զրուցել	None
մետրոպոլիտեններ	Plural
հաճախորդներին	Plural
ձվաբջջում	Singular
սահման	None
գորտերով	Plural
բողոքելու	None
իզոտոպի	Singular
շրջվել	None
զարթնի՛ր	Singular
կործելիս	None
ուսանում	None
ագարականացել	None
ծիծեռնակները	Plural
զավթեց	Singular
հայուհիներիս	Plural
սեղանատամները	Plural
բդկեցիր	Singular
չզառամած	None
ապահոված	None
շինվածքը	Singular
շահնշահ	Singular
լոտոսովդ	Singular
հայտնելու	None
ուրանի	Singular
խորշով	Singular
բուծում	None
կրակվառիչներումդ	Plural
տանջեցիր	Singular
խթանող	None
փոխառությամբդ	Singular
չխափանող	None
եփել	None
կոտրած	None
հարգում	None
կաղերդ	Plural
ուղարկում	None
հաստատուններից	Plural
զգուշացումների	Plural
ոլորանի	Singular
շուրթերը	Plural
անզգայացման	Singular
ճանապարհորդությունից	Singular
կոները	Plural
արբանյակներին	Plural
չթրծող	None
չերկայնանալ	None
ծաղրելու	None
հետեւած	None
բեկանում	None
վարակի	Singular
հագեցնելու	None
օժանդակած	None
զղջացած	None
օտարներիդ	Plural
ծաղրել	None
ահով	Singular
ստամբակելու	None
վախեցան	Plural
ահազդիկումս	Singular
անհանգստացած	None
փշուրներիս	Plural
համոզել	None
աղախնի	Singular
հարցումներից	Plural
երկարության	Singular
հաստատուններ	Plural
վանքերում	Plural
պաշտվել	None
շուկաներով	Plural
հեռադիտակի	Singular
մեներգերի	Plural
ծեծի	Singular
ստ	None
չաներկյուղանաք	Plural
փնթի	Singular
պղնձով	Singular
սելավ	Singular
փչացած	None
աստղադիտարանումդ	Singular
նվաղելու	None
մեջքին	Singular
Աքեմենյաններ	Plural
ձելկվայիդ	Singular
արդուկելիք	None
կընկճեր	Singular
բարձ	None
բացահայտում	Singular
արժեքներով	Plural
բացատրեցին	Plural
ոջիլը	Singular
գոգեին	Plural
աղոթելիս	None
պրոմեթիում	Singular
արարքին	Singular
թրթուրը	Singular
գրառվել	None
անգամները	Plural
յարան	Singular
մանաթ	Singular
հացադուլովս	Singular
տիզը	Singular
սավառնե՛ք	Plural
ճանճեր	Plural
աղեղներից	Plural
չարմանալ	None
արձակուրդում	Singular
կանխած	None
մասնիկներին	Plural
վկաներ	Plural
խարխլում	None
օճառների	Plural
դադարների	Plural
տուժվելիս	None
կրծում	None
արջերի	Plural
կաքավը	Singular
ձգտած	None
շարժմանը	Singular
առնետի	Singular
կրճատումներ	Plural
հոդվածդ	Singular
պաշտոն	Singular
վերագրել	None
ճամբար	Singular
պարապ	None
զվարճացնում	None
խոստացել	None
թարախի	Singular
հինդուիզմում	Singular
վնասվածքների	Plural
կղկղանքումս	Singular
չընդգծել	None
դարավանդների	Plural
միացել	None
չսանձել	None
արեգակնային	Singular
ժանրերով	Plural
նորույթի	Singular
ապացուցված	None
սոուս	Singular
գալակտիկայի	Singular
հնարամտություններումս	Plural
շեշտած	None
ճտերը	Plural
բարբաջներս	Plural
տրոհել	None
հայրենակիցները	Plural
վախենալիք	None
չհերքվեիր	Singular
հենած	None
կախարդել	None
միացնել	None
խեժ	Singular
արբ	None
չհանվել	None
հատուցելու	None
փայտփորիկ	Singular
միջինի	Singular
բանտարկությունը	Singular
կթած	None
մոլորակով	Singular
աստղադիտակում	Singular
ոլորած	None
էներգիաներ	Plural
արգանակի	Singular
բուծվել	None
փուլերի	Plural
մեղադրել	None
համբուրել	None
չզտած	None
կրծքի	Singular
սպասարկում	None
կացինները	Plural
ավտոբուսում	Singular
փոխհատուցող	None
հրթիռներով	Plural
հանցանքները	Plural
ալոճ	Singular
վալսերը	Plural
կվասը	Singular
ազատութեան	Singular
շշնջում	None
խթանելու	None
շագանակագեղձի	Singular
գործիքներին	Plural
պայմանը	Singular
կայուններիդ	Plural
սորացած	None
հեծելազորը	Singular
չփայլատակող	None
պեղած	None
տեսակների	Plural
հանձնվել	None
մեղքերը	Plural
չարաշահում	None
կռված	None
փչացել	None
քարոզել	None
փիլաքյանի	Singular
բանալու	None
ներկայացումներ	Plural
շղթաներովդ	Plural
պարսկահայեր	Plural
արքային	Singular
ափիոնի	Singular
ծիծաղալու	None
հասցվել	None
ջրհոր	Singular
բնակիչները	Plural
կողոպտելու	None
հունից	Singular
ափսե	Singular
հունդերումս	Plural
զարմանքով	Singular
լամա	Singular
հեռադիտակներիս	Plural
կողպում	None
բարելավել	None
գոչած	None
ավտոտնակի	Singular
պան	Singular
տառապի	Singular
պարիսպների	Plural
մանրէ	Singular
կույրեր	Plural
սրերի	Plural
ողողված	None
ողնաշար	Singular
հնանում	None
դիպաշար	Singular
քայլով	Singular
Ամանորներիցս	Plural
մոլեգնում	None
պուրակս	Singular
թագ	Singular
չկատարեց	Singular
հայցերումդ	Plural
ձայնավորում	Singular
սփոփել	None
չորացել	None
վիճելու	None
կենտավրոսի	Singular
բալիկ	Singular
կույրերին	Plural
ռադիոյում	Singular
աղեղնավորը	Singular
ցածրի	Singular
շատերին	Plural
հավասարումովդ	Singular
հայկականի	Singular
տնօրեն	Singular
խառնուրդից	Singular
ընդգծվել	None
շախմատիստուհովդ	Singular
գոյականներ	Plural
նյարդից	Singular
կցելու	None
թավայի	Singular
փոխանակությանը	Singular
վանքի	Singular
արհեստավորի	Singular
փրթվել	None
շքեղություններդ	Plural
գյուրզա	Singular
դարակ	Singular
բալետում	Singular
շտկել	None
ադրբեջաներեն	Singular
ասպարեզներիդ	Plural
խոստման	Singular
ծլարձակում	None
վակուումը	Singular
գնաճ	Singular
նավաստու	Singular
կանխամտածել	None
զարդարուններդ	Plural
գիտակարգի	Singular
հպատակվի	Singular
չգգվող	None
բաղնիքդ	Singular
ենթակառուցվածքների	Plural
խաչի	Singular
ասպանդակ	Singular
կոբալտի	Singular
կոշկակարներ	Plural
զանգահարում	None
չաքուչում	Singular
փլվեցին	Plural
սպիտակուցները	Plural
բարիումումս	Singular
հարբեցող	None
կազմակերպություններից	Plural
դրվատել	None
կառչ	None
բնակված	None
կարիճները	Plural
համաստեղության	Singular
սիմոնականդ	Singular
հրամայած	None
չսազացած	None
զարթոնքը	Singular
օսով	Singular
ժխտականը	Singular
վարկածներով	Plural
նկարներից	Plural
քանդակը	Singular
կազմությամբ	Singular
պիցցա	Singular
հարսին	Singular
ահաբեկված	None
խուտուտ	Singular
ուրանար	Singular
կիսած	None
սավառնում	None
գլյուոնը	Singular
արարքից	Singular
հուի	Singular
սարքավորումներից	Plural
ունկնդրելու	None
սովորել	None
պատանիներից	Plural
սպիտակներով	Plural
կագահանային	Plural
քանդել	None
զարդենիներիդ	Plural
արժեքին	Singular
ներդրումներից	Plural
մուրաբա	Singular
հավետ	Singular
ձեթով	Singular
ուտեստներից	Plural
պաշտած	None
թարթող	None
կողոպտվել	None
չարանում	None
աշխարհամասերից	Plural
նախընտրում	None
զբոսանավի	Singular
բալետներով	Plural
բեկանելու	None
երազած	None
գոյանում	None
խոռոչները	Plural
արոտավայրեր	Plural
արագիլը	Singular
թաղելիք	None
արուներին	Plural
բիբ	Singular
ուղով	Singular
աթեիստները	Plural
ժլատ	Singular
հանգստացնել	None
նախընտրող	None
տարակուսեր	Singular
մեկնելու	None
նորոգ	Singular
հոգեբաններից	Plural
մայեն	Plural
ցանկությունից	Singular
հիմն	Singular
սառելու	None
հարգվել	None
չհամարել	None
ուսումնասիրելիս	None
գոլացող	None
մոնղոլերեններով	Plural
ջայվիս	Singular
նախախնամությունը	Singular
կենցաղին	Singular
բնորոշող	None
ուղղությունը	Singular
արտաքսում	None
արգելելու	None
ջրկոտեմներից	Plural
աստված	Singular
խնջույքը	Singular
պղնձաձույլ	Singular
շողում	None
կիս	None
միզող	None
կշռել	None
չըլնես	Singular
շղթայում	Singular
բնույթներիցս	Plural
մետաֆիզիկայի	Singular
լոյսը	Singular
փախցրած	None
քաջումդ	Singular
այցել	None
տարբերած	None
ձողիկ	Singular
սպրդելիք	None
լավագույնս	Singular
բլոգը	Singular
նախադասությունը	Singular
հարություններովդ	Plural
հոլանելիս	None
կործանել	None
լիսեռից	Singular
հղացել	None
սարդոստայնում	Singular
գաղտնիքը	Singular
սելավների	Plural
ուրանում	Singular
կայծակից	Singular
պոլիմերները	Plural
չխոցոտող	None
կտցարի	Singular
հանվեն	Plural
քաջեր	Plural
չթաքցնող	None
հղեցին	Plural
ոտնակը	Singular
հալած	None
չհամակարգել	None
տափաստաններով	Plural
կողոպտած	None
զտում	None
ալպինիստներ	Plural
թեկնածուիդ	Singular
շատացավ	Singular
խոցոտվել	None
քամում	Singular
ժողովում	Singular
մոլորվում	None
ազդելիս	None
մատնած	None
լքվել	None
հաստատած	None
տոները	Plural
քննություններ	Plural
հաներովս	Plural
հեռավորությունների	Plural
դայլայլ	None
ավելացնում	None
կավին	Singular
մահաց	None
փորելիս	None
հատկացվել	None
մատանի	Singular
կառավարեցին	Plural
տեռորիստներիս	Plural
կիրառեց	Singular
մենդելեեւիումներիս	Plural
ցիկլոն	Singular
տեքստերի	Plural
սինհալերեն	Singular
տառապած	None
հալի	Singular
ոլորող	None
թափվեն	Plural
պտղաբերումս	Singular
չարձագանքած	None
ցանկանալ	None
թթվածնում	Singular
չայրվող	None
մեծաբանելու	None
ուսանողին	Singular
ամորձին	Singular
դադարը	Singular
կենսաբանի	Singular
համաստեղությունից	Singular
բուլղարացիներ	Plural
տոկունություն	Singular
շիմպանզե	Singular
սլացել	None
տեսարան	Singular
լորտուներ	Plural
թաքցնելիք	None
չզգենալ	None
կլանվել	None
հեռ	None
կախեմ	Singular
կիրը	Singular
մարտնչելու	None
լեհեր	Plural
գանգրացնելու	None
կոնյակի	Singular
կավեր	Plural
կենսաբանական	Singular
իոնների	Plural
գնահատվել	None
կողակիցը	Singular
հայկականը	Singular
վճարած	None
հայթայթած	None
ցիկլոնի	Singular
կարմրուկի	Singular
առաջատար	Singular
խոլորձի	Singular
ակումբին	Singular
լոբի	Singular
արջերին	Plural
ատոլի	Singular
թմրամիջոցի	Singular
շաքարով	Singular
ուսին	Singular
զրուցելու	None
ծրարների	Plural
հրճվելիք	None
պարապել	None
տեխնոպարկիս	Singular
խորովեիք	Plural
օպերաներից	Plural
պատկերասրահով	Singular
հանվել	None
վառարանները	Plural
կեղել	None
չզառամանա	Singular
տաբուների	Plural
էպոսների	Plural
մարզասրահիցս	Singular
ձիթենիներ	Plural
տուփը	Singular
հիասթափվում	None
կառավարի	Singular
կարոտել	None
աջակցի	Singular
ոխանալ	None
ուժեղանալ	None
արբի	Singular
շաքարախտը	Singular
խուճուճ	Singular
պատմությունները	Plural
արխիվներ	Plural
պատկերող	None
արտադրությունների	Plural
տարիքների	Plural
ճշգրտած	None
զարթօնքին	Singular
փորվել	None
պարիկ	Singular
տեգրակնոջը	Singular
գադոլինիումի	Singular
բանում	None
ուրիշներից	Plural
ճմբին	Singular
ամսվան	Singular
անարխիզմը	Singular
օսմիումը	Singular
ներկայացնել	None
խեցգետինները	Plural
չափսը	Singular
անվտանգությամբ	Singular
թամաշաների	Plural
խաչքարերով	Plural
հեշտոցի	Singular
բառացի	Singular
հատկանիշներից	Plural
լրիվ	Singular
մխիթարող	None
ածանցած	None
վերագրած	None
ուրախացնես	Singular
վանկենք	Plural
սամսարի	Singular
սեպտեմբեր	Singular
մետրանոցից	Singular
երը	Plural
ագուցվել	None
բարկեր	Plural
գյուղից	Singular
հեռացնենք	Plural
չվելու	None
լուն	Singular
պատուհաս	Singular
բոխի	Singular
արից	Singular
կրել	None
աղոթող	None
համակարգիչներով	Plural
վարտիքիցս	Singular
փրփրած	None
օսմանյան	Singular
արվարձանը	Singular
մալայալամ	Singular
վարելիս	None
մեգը	Singular
խաչին	Singular
կկախարդվի	Singular
ավելացնելու	None
աղիքին	Singular
աշխարհահռչակովս	Singular
գործարկող	None
աջակցած	None
ըմբշամարտությունիցդ	Singular
գայթակղելու	None
սոսինձներ	Plural
սեքսերի	Plural
կտակներիդ	Plural
ցեցը	Singular
սաղերը	Plural
հունվարից	Singular
ցանկանալու	None
կարկատանները	Plural
մարդկայինը	Singular
մագլցելու	None
տես	None
թաքցնի	Singular
կատարել	None
կիրառի	Singular
ուզած	None
դարբնելիք	None
տնտեսագետ	Singular
կոմսուհին	Singular
առասպելին	Singular
մեկնաբանությանը	Singular
կեղծամ	Singular
ստորագրվել	None
բիբլիոգրաֆիա	Singular
զրուցում	None
վեհերիցս	Plural
մասնագիտության	Singular
խառնեք	Plural
հեռուստատեսություններում	Plural
ալյումինով	Singular
վրձին	Singular
գովազդներին	Plural
հիմները	Plural
քննել	None
կատարելիք	None
տեսարանի	Singular
կենտավրոսները	Plural
աքսորելու	None
արծաթ	Singular
չհիրող	None
թխվածք	Singular
բազեն	Singular
սփռելու	None
կրծքավանդակում	Singular
նիհար	Singular
հունիսը	Singular
հատիկները	Plural
փայլունակությունումդ	Singular
անկումը	Singular
անկախությանը	Singular
սպիտակի	Singular
ընթանալու	None
ավտո	Singular
անկախությունը	Singular
սառել	None
մեռել	Singular
լեյտենանտի	Singular
ափիոնը	Singular
նուկլոններից	Plural
կապույտներ	Plural
վանեք	Plural
ահաբերս	Singular
գաղափարներով	Plural
հյուսող	None
բխեցնել	None
խռմփացր	None
կայուններում	Plural
վերուվերդ	Singular
դողալիս	None
թռչունին	Singular
հետազոտել	None
կերակուրների	Plural
կարելի	Singular
սանձել	None
անզգայանում	None
ներգաղթյալի	Singular
սնգուրվ	None
փոխանակել	None
ծնոտին	Singular
խոնարհ	Singular
գյուտերի	Plural
տեսություններովդ	Plural
իմաստություն	Singular
մարզիկներ	Plural
ճիգերից	Plural
այտերին	Plural
ճակատագիր	Singular
ագուցահանելու	None
տոհմերի	Plural
քվեով	Singular
ուժեղի	Singular
խորանները	Plural
արգանդափողերը	Plural
միատոններովս	Plural
փք	None
ոռնալ	None
ծուլացել	None
շախմատիստը	Singular
ուսումնասիրել	None
հուզելիք	None
երկարությունը	Singular
տրոհելու	None
զորահավաքի	Singular
բյուջեով	Singular
կերցնում	None
գարաժ	Singular
առաջնությանդ	Singular
ճիգերի	Plural
տեկիլաներովս	Plural
աղիքները	Plural
գրողի	Singular
քլոր	Singular
կիրառող	None
հավասարումների	Plural
սալաթ	Singular
ուռթացել	None
նեղացնել	None
օբյեկտներում	Plural
փողրակով	Singular
հնդկացորենը	Singular
զավթել	None
քաղցկեղների	Plural
կամաց	Singular
անձեռոցիկ	Singular
նվագող	None
անձնանունից	Singular
նորոգում	Singular
բոժոժը	Singular
հոյակապ	Singular
փոխ	Singular
սղոցներ	Plural
բացատրել	None
հալում	None
կաղամբով	Singular
քաղել	None
սպանություններով	Plural
թափվել	None
տեղեկանալ	None
շատերում	Plural
օղակներում	Plural
մոլեն	Plural
ներխուժել	None
նախագահացուիս	Singular
չբարբանջեիր	Singular
սպանելու	None
ենթարկեցնել	None
աղցանը	Singular
սրբիչների	Plural
բարձրաձայնել	None
բանակցություններին	Plural
կաչաղակները	Plural
ֆիզիկ	Singular
հյուծում	None
ավանների	Plural
հոլմիում	Singular
կախարդելիս	None
թթվածնից	Singular
ձավարով	Singular
վերինը	Singular
շնորհելու	None
մանսարդներումդ	Plural
կաշխատեմ	Singular
ըմբշամարտը	Singular
շփում	None
թռնում	None
հրեշտակ	Singular
հրելու	None
չհղացավ	Singular
ամերիկացիները	Plural
ստվարագլուխից	Singular
մտադրվեմ	Singular
կարթը	Singular
համբարձումից	Singular
թորշոմած	None
անորոշանալիս	None
վատով	Singular
աղյուսակների	Plural
դաշտամկներ	Plural
վարձի	Singular
քարափի	Singular
հանրապետությունից	Singular
տորմիղի	Singular
վերծանող	None
գրգռել	None
ավետիսիդ	Singular
վանկերի	Plural
կիլոմետրից	Singular
աստվածներին	Plural
չհանվող	None
ծովախորշեր	Plural
ռեակցիայում	Singular
վաճառվել	None
ասացվածքը	Singular
տեսակից	Singular
կանգնող	None
տարբերել	None
թարգմանած	None
հոտոտելիք	None
կուրսեր	Plural
սպիտակամորթները	Plural
սարքավորումների	Plural
մարտնչել	None
խաչքարի	Singular
բետոն	Singular
բացատիցս	Singular
ուրախացնում	None
վալսերին	Plural
նվաղ	None
կեղտոտներս	Plural
պատենտներում	Plural
ինքնյակներիդ	Plural
նորույթները	Plural
ցերիումումդ	Singular
շրջված	None
ֆտորիդ	Singular
ցանկանամ	Singular
տեսիլքով	Singular
աքլորների	Plural
սիգի	Singular
բիբերը	Plural
առեղծվածի	Singular
սանձեինք	Plural
պատկերասրահից	Singular
կեսրայրով	Singular
նավատորմին	Singular
ամբարտակ	Singular
սոմալի	Singular
անդադարս	Singular
գորտնուկների	Plural
վերագրող	None
օժանդակեցիր	Singular
առաջադրանքները	Plural
վճիտ	Singular
տեսել	None
խղճալիք	None
խառնվել	None
երդվող	None
սեպտեմբերյան	Singular
հաճույքներից	Plural
սիրվել	None
չկաշկանդել	None
փոխանակվել	None
նավահանգստից	Singular
սադրանք	Singular
տեղյակներ	Plural
փետրվարներս	Plural
երկաններումդ	Plural
մեկնվել	None
հնչյունները	Plural
պատանիներին	Plural
ազգանվամբ	Singular
սուզանավերում	Plural
կործող	None
փսխում	None
քերականագիտություններդ	Plural
կտրամադրեն	Plural
հաշիվները	Plural
մկնիկը	Singular
խրախուսող	None
ատոմները	Plural
ավետիք	Singular
օրհնած	None
ծառայելիս	None
հուզիչ	Singular
բռնություններով	Plural
այցիս	Singular
կարմրուկ	Singular
չոգող	None
կլուծեր	Singular
նիշքերում	Plural
բանակցության	Singular
պահպանակը	Singular
կրծքավանդակ	Singular
դժվարին	Singular
ցուցանակ	Singular
նարնջի	Singular
տերմիններ	Plural
օղակները	Plural
սվաստիկա	Singular
հոբելյաններս	Plural
լճեր	Plural
ուտեստի	Singular
ահաբեկիչների	Plural
այգեվետ	Singular
հոգեբանը	Singular
զարմացնել	None
սովորություններին	Plural
առերես	None
գողանում	None
լենինիզմին	Singular
կանխելու	None
հեռացրել	None
վեզիրներից	Plural
գուրզ	Singular
չհաստատեց	Singular
անգամներ	Plural
ապահարզանի	Singular
հագնված	None
կոնֆետներդ	Plural
զատելիք	None
պառկել	None
ոլորակելիս	None
չպայթած	None
ուղարկող	None
գիշերով	Singular
արտաքինդ	Singular
բերրի	Singular
պատճենում	Singular
մավիներիդ	Plural
կարկեմ	Singular
վիրաբուժություն	Singular
աճելու	None
ֆիլիպինյան	Singular
գյուղատնտեսությանը	Singular
կաթողիկոսների	Plural
ղպտիերենումդ	Singular
կրակեցին	Plural
աշխարհագրությունից	Singular
գնահատելիս	None
նպաստներ	Plural
հունիսից	Singular
թրեյլերներից	Plural
մորթիների	Plural
չկկած	None
ուրախացնել	None
տենչում	None
փիլիսոփայություն	Singular
պողպատից	Singular
մանրադիտակովս	Singular
փախուստ	Singular
փարոսները	Plural
հասկանալ	None
ղեկերի	Plural
դեղաբույսերից	Plural
աքլոր	Singular
նեխում	None
հապավումները	Plural
օգուտ	Singular
ժանր	Singular
ջորին	Singular
ծնած	None
ապահովեցր	None
աշխատած	None
զետեղած	None
բացման	Singular
կկտակեինք	Plural
կաղջիններս	Plural
ձուլարանների	Plural
ստրուկի	Singular
բնորոշում	None
մխիթար	Singular
ծափահարված	None
կենտրոնը	Singular
հաճախելու	None
առաջադիմությամբ	Singular
նուշին	Singular
արջառիցդ	Singular
պագելիք	None
կրծքանշան	Singular
ազգություններով	Plural
մատուռով	Singular
մուժի	Singular
ամիսը	Singular
զմռնենիներին	Plural
ահագնանալիք	None
մտադրվել	None
տանձենիներովս	Plural
գնդակահարության	Singular
պորտուգալացիները	Plural
պրոլետարների	Plural
ստիպում	None
նախընտրել	None
կոտրող	None
մատնաքաշ	Singular
չլքեց	Singular
արտերիցդ	Plural
մրցույթից	Singular
չվերադարձած	None
անհանգիստում	Singular
համեմունքը	Singular
ծովածոցը	Singular
գումարները	Plural
արագացումը	Singular
գայթակղեք	Plural
զավթում	None
հանձն	None
թանաքամանին	Singular
կոկտեյլը	Singular
ճյուղի	Singular
անուշաբույրերովս	Plural
հնարավորի	Singular
ածուիցդ	Singular
կղմինդրներս	Plural
վերադառնում	None
չգանգրանալ	None
շտկելու	None
այծեր	Plural
ոգած	None
ծարավի	Singular
կակաչը	Singular
մարզիկին	Singular
շահագործվել	None
չվիճող	None
պարտատիրոջ	Singular
մորաքրոջը	Singular
հուսալքվածներիդ	Plural
ունկնդրել	None
բարեկամությամբ	Singular
պատկերասրահներում	Plural
բռնաբարում	None
նախասրտերին	Plural
շարունակեմ	Singular
պարտիզանների	Plural
անկախումս	Singular
կաղճիններումս	Plural
հիացել	None
լուծած	None
էրբիումի	Singular
ծովածոցերումս	Plural
շտկում	None
շղթան	Singular
պարոնները	Plural
տարբերին	Singular
օձամարտին	Singular
սամսար	Singular
դիում	None
երկը	Singular
հարկադրել	None
կտակելու	None
զեն	None
գոչել	None
վարժություններով	Plural
միրգ	Singular
կազմակերպիչներին	Plural
չկքող	None
տեսախցիկին	Singular
վերջիններիս	Plural
տանտերերի	Plural
բացակա	Singular
խխունջի	Singular
հուզում	None
կենսալիումս	Singular
հեղինակությանը	Singular
վհատմանս	Singular
կռվեն	Plural
բանտարկելիք	None
հելլենները	Plural
հոբելյանների	Plural
դեղաբույսեր	Plural
ամուսնալուծություն	Singular
չլրթացաք	Plural
ամայացած	None
բյուջեները	Plural
տուժող	None
մոռանում	None
նետել	None
ռեֆորմների	Plural
քերականական	Singular
սյունակները	Plural
վրանին	Singular
գովել	None
ճգնաժամերի	Plural
միացրել	None
քննարկումում	Singular
պատկերել	None
հերոինը	Singular
հատող	None
առասպելներ	Plural
կնքելու	None
մոռանալու	None
հավելվածում	Singular
սպրդել	None
հալեցնել	None
ծլած	None
ճամփորդելու	None
շարադրությամբ	Singular
չհելնող	None
ֆինները	Plural
հավատանք	Plural
սարավանդը	Singular
տետրի	Singular
փայլատակող	None
ճոպանները	Plural
լուսանիս	Singular
կերակրելու	None
արյունահոսությունը	Singular
տիկնիկին	Singular
ամբոխի	Singular
վայելուչիցս	Singular
հիմունքներով	Plural
թռնել	None
ընդերքը	Singular
կարմրուկը	Singular
շպրտելու	None
հերթերիս	Plural
հալածող	None
հապավման	Singular
հոգնաներ	Plural
ընդելուզ	None
խորհում	Singular
չհարգող	None
հացահատիկ	Singular
ալուցքս	Singular
պնդերիցս	Plural
էտել	None
փոխանակության	Singular
իշխանի	Singular
վերինի	Singular
ցիկլոնների	Plural
կիրառեն	Plural
բարելավելու	None
իրադարձությանը	Singular
ռուսականի	Singular
լամպ	Singular
եռացնել	None
սպիների	Plural
հպարտանալիս	None
հարթ	Singular
ուղարկելու	None
շնորհավորում	Singular
փաղփդ	Singular
արսեն	Singular
ամոթումս	Singular
գյուղացիների	Plural
գնչուներից	Plural
անհանգստանալու	None
նստարաններ	Plural
խալիֆայության	Singular
օլիգարխիայի	Singular
մոտեցրել	None
վեպերը	Plural
վրացականներումդ	Plural
օմանյանիս	Singular
պայթած	None
եվրոյով	Singular
հիվանդանոցների	Plural
առեւտրերի	Plural
փորել	None
ատոմ	Singular
եփած	None
կերտելու	None
արշիպելագի	Singular
առջեւը	Singular
ողողվում	None
ձգտեր	Singular
հուներ	Plural
ոգեշնչվել	None
բախերիցս	Plural
չկոտրել	None
թթվասերի	Singular
թեմերը	Plural
մանրադիտակի	Singular
ճաքած	None
նետելիս	None
զղջացել	None
հարցազրույցների	Plural
բնութագրած	None
կշտապի	Singular
ավանդությունից	Singular
գլորելու	None
վտանգում	Singular
շնորհք	Singular
ալաբաստրյայի	Singular
պատկանելու	None
հաստոցներով	Plural
նետ	None
չգիտակցված	None
միկրոօրգանիզմներից	Plural
վարսը	Singular
սարդի	Singular
խառնուրդիդ	Singular
սպիտակներին	Plural
լքելու	None
փողահարիցդ	Singular
արագի	Singular
հայել	None
պարեր	Plural
տենդը	Singular
պարտատոմսեր	Plural
օթեւաններից	Plural
ադամանդներ	Plural
չխիթայի	Singular
մտածելակերպին	Singular
կերտող	None
լոգանում	None
չբավարարող	None
փախցրել	None
կհասցնենք	Plural
շարադրության	Singular
տիկնիկով	Singular
զրուցած	None
չորացնում	None
շարունակող	None
օրհնել	None
կռացան	Plural
երգահանի	Singular
ախտորոշող	None
ապացուցվել	None
հարվածներից	Plural
ղանթարի	Singular
խլուրդների	Plural
ժողովածուից	Singular
խոտերով	Plural
վարչապետները	Plural
հոսել	None
հանգստանան	Plural
քննելու	None
կազմության	Singular
քարանձավներ	Plural
պատկերվել	None
սպիտակներ	Plural
գուսան	Singular
սխալվում	None
թագավորը	Singular
կողրերիս	Plural
խուզում	None
չմուրացած	None
փորող	None
խաչապուրիում	Singular
ամուսնացրին	Plural
հռետորաբանությունս	Singular
ակնհայտ	Singular
խուճապից	Singular
կախվել	None
բացատրած	None
ջրածինների	Plural
բարեկամը	Singular
սեզոն	Singular
սխալված	None
մոռեր	Plural
ականատեսների	Plural
հայտնած	None
ծածկող	None
բանավեճերից	Plural
կռվել	None
ներդրումներ	Plural
իշխանությունները	Plural
նմաններին	Plural
ստուգումները	Plural
ներքինը	Singular
կառուցվածքներ	Plural
աշխատող	None
լիսեռների	Plural
արվարձանները	Plural
ծանակի	Singular
պաշարներից	Plural
առաքինությունները	Plural
օդանավերի	Plural
երազում	None
խորշերով	Plural
անգ	Singular
զավթվել	None
ուզեցել	None
դրսեւորած	None
չբեկանած	None
ընթանալ	None
ծանրություն	Singular
էսպերանտոն	Singular
տեսախցիկներ	Plural
քվազարի	Singular
կրճատումներիդ	Plural
թաթավուչիցդ	Singular
տպել	None
օսմանը	Singular
տատիկին	Singular
հնդկահավեր	Plural
շատերի	Plural
գավաթին	Singular
չծածկած	None
հրել	None
հիմնավորող	None
ջերմաստիճաններից	Plural
սպանող	None
մսիս	Singular
քննարկեցին	Plural
կարճ	Singular
կարծեք	Plural
խոհարարներ	Plural
ճահիճները	Plural
չբողբոջեցինք	Plural
զառամանալ	None
ներդրումներով	Plural
ինքնուրույնդ	Singular
կազմակերպած	None
կամենալ	None
պամիրյաններդ	Plural
ռադոնը	Singular
ուզեցի	Singular
արտ	Singular
ոստայնը	Singular
աստղադիտակ	Singular
պտերները	Plural
գործընկերներդ	Plural
վագոնով	Singular
կախարդող	None
նշխարները	Plural
չարդուկած	None
փողերակիցս	Singular
ուսումնասիրեք	Plural
գեղձում	Singular
կերակրվել	None
չսփռող	None
ներկայացնենք	Plural
մտցրած	None
անատոմիա	Singular
սլացավ	Singular
ձեռնարկներից	Plural
օժանդակում	Singular
բոբիկ	Singular
ֆոտոխցիկը	Singular
մատնում	None
շնչելու	None
քննարկել	None
կանխել	None
մխում	Singular
պլաստիկը	Singular
նախարարի	Singular
ներքնաձիգը	Singular
լուտալիք	None
ուժեղացել	None
վագոններով	Plural
հորաքույրը	Singular
կղկղանք	Singular
շահագործական	Singular
քլունգները	Plural
կհասցնեն	Plural
արվեստ	Singular
քննարկելիք	None
մտցրին	Plural
չոռնացած	None
գամետների	Plural
սաունա	Singular
լեյտենանտներ	Plural
մառանների	Plural
կծիծաղաք	Plural
նամականի	Singular
առողջ	Singular
բուծած	None
առաքյալներից	Plural
կեռ	Singular
նիշքերը	Plural
խնամել	None
խարակիրիս	Singular
չգնահատեց	Singular
առագաստանավով	Singular
պաշտելու	None
քել	None
թենիսիստներից	Plural
մեծագույնը	Singular
վերուվերներդ	Plural
թիիցս	Singular
սիլիցիումը	Singular
կարենալ	None
որմզդեղնի	Singular
հեռացնեն	Plural
կռիչքում	Singular
շենքից	Singular
սառցադաշտերից	Plural
ակրոբատ	Singular
չընդգծեիք	Plural
վերադառնան	Plural
տեսակները	Plural
արտաքսել	None
արսենի	Singular
էթան	Plural
կայքերից	Plural
հիմնավորած	None
զեռունդ	Singular
հնչույթում	Singular
ոգեշնչած	None
ապստամբեցնել	None
ածանցից	Singular
նիստուկացում	Singular
համբուրվելիս	None
ստուգեց	Singular
ամբարտակների	Plural
հասկանալու	None
լծակները	Plural
այրվել	None
հորայի	Singular
առվի	Singular
մեղրամիս	Singular
շտկվել	None
կրելիք	None
ճշգրտում	None
պարապի	Singular
ոհմակ	Singular
աղեղում	Singular
կենսագրություններով	Plural
տաջիկ	Singular
երկմտում	None
կանգնենք	Plural
համակարգելու	None
հայկյան	Singular
նացիզմը	Singular
զգեստներին	Plural
նահանգապետերի	Plural
կանաչապատ	Singular
մականունը	Singular
չկրել	None
հրեշտակները	Plural
սառնարանում	Singular
կառավարեր	Singular
մածված	None
հանգստանալ	None
հոշոտում	None
քննարկմանը	Singular
հարգի՛ր	Singular
թաթարներ	Plural
գործարանից	Singular
եփելիս	None
էտելիս	None
նախկին	Singular
կենդանացնել	None
բնավորություններ	Plural
բացատրությանը	Singular
մրջնակերը	Singular
գիտակցված	None
տեսախցիկի	Singular
ֆրիզի	Singular
ենթաշերտի	Singular
պայմանագրով	Singular
կարում	None
ավելացնել	None
հաստատեն	Plural
աշխատեցնել	None
ինքնաթիռներում	Plural
ճամփորդած	None
նշխարդ	Singular
համաձայնվել	None
սրճաղացումդ	Singular
մոխրոտը	Singular
ժամում	Singular
ապառաժի	Singular
առաջնությունում	Singular
երախտամոռիցս	Singular
ճնշումներով	Plural
սագեր	Plural
համակարգիչներին	Plural
գեղմի	Singular
կռվեցի	Singular
ֆլամինգոն	Singular
հաղարջենի	Singular
պատշգամբը	Singular
չհեռացնել	None
խոստումների	Plural
հասցրին	Plural
կատակերգություն	Singular
հովազի	Singular
չափանիշը	Singular
ուսուցիչներին	Plural
քայլելու	None
հույլով	Singular
անտարբերության	Singular
լվացվում	None
բողոքարկելու	None
լոբու	Singular
շահագործող	None
խեղդեց	Singular
կազմակերպություն	Singular
առնետը	Singular
հղումներից	Plural
թագին	Singular
մոլորված	None
ուրուրը	Singular
արարքներին	Plural
սպանած	None
ուղարկվել	None
փուչիկներ	Plural
դատարանը	Singular
մրցանակներից	Plural
ծպտելիք	None
ստորագրող	None
սորում	None
բացատրելիս	None
ձնծաղիկներով	Plural
բազմապատկիչների	Plural
օրգանիզմից	Singular
կտուրին	Singular
կապարը	Singular
թաքչես	Singular
մեկնած	None
տույժեր	Plural
չսպանել	None
շրջակայքի	Singular
արվեստներով	Plural
ձողով	Singular
որսացող	None
որոճելիս	None
ուսուցանած	None
շնչափողից	Singular
զայրուցքում	Singular
խղճում	None
լոբով	Singular
խմելու	None
բացվածքները	Plural
աներկյուղությամբ	Singular
որմերը	Plural
չհալածել	None
կրճատմանս	Singular
գյուղ	Singular
մեղադրող	None
գնդով	Singular
վիճաբանում	None
պետություններից	Plural
երկբարբառներից	Plural
կպատառես	Singular
ցավային	Plural
չգլորած	None
հորդեց	Singular
ժամանակաշրջանները	Plural
արմանալու	None
խելացիս	Singular
լուրերին	Plural
արդյունքների	Plural
սպասարկող	None
նախուտեստ	Singular
բարձունքներից	Plural
խոյանամ	Singular
պայմանագիրը	Singular
քշ	None
գլխացավը	Singular
ժխտական	Singular
տերություններիցս	Plural
մանվածապատությունները	Plural
այցից	Singular
տարածությանը	Singular
ակումբից	Singular
կայանալ	None
հագնվի՛ր	Singular
աստիճանավորում	Singular
կանգնեց	Singular
նավատորմի	Singular
գերիներ	Plural
ձողեր	Plural
նորվեգական	Singular
խրախուսանքով	Singular
դրդելու	None
ոտի	Singular
չհագած	None
ցեզիումի	Singular
հանրապետություններ	Plural
աղեկներից	Plural
պարգեւը	Singular
պատառել	None
պայմանավորած	None
կաթիլ	Singular
կառավարության	Singular
բառացանկեր	Plural
դրսեւորում	None
փնջերի	Plural
տունդրային	Singular
կավանդեին	Plural
պահպանող	None
հիմնադրամում	Singular
սխտորից	Singular
կայծառիս	Singular
կծում	None
ջրարջ	Singular
թարգմանող	None
լճի	Singular
պագիս	Singular
վնասում	Singular
չարաշահելիս	None
գրատախտակին	Singular
վարունգի	Singular
կենդանաբանները	Plural
օժանդակեցին	Plural
սնկապուրի	Singular
կանկանենք	Plural
մարգարեներին	Plural
երկկտտացրած	None
ընթանում	None
զրույցներ	Plural
հոկտեմբերյանի	Singular
աքաղաղի	Singular
կարողացան	Plural
բացառականում	Singular
հերքվում	None
թեփիս	Singular
հիպերբոլումս	Singular
ընդդիմության	Singular
հարդ	Singular
տարածություններում	Plural
խոսալ	None
բարդությունից	Singular
ավանդություն	Singular
յուղերից	Plural
մեզոններ	Plural
խորշ	Singular
կամեցավ	Singular
արբանյակից	Singular
ենթարկելիս	None
վտանգները	Plural
ծածկի	Singular
փնտրել	None
թույլ	Singular
խանութ	Singular
շիթ	Singular
մաքառում	Singular
օրհնում	None
նետում	None
չդարանակալած	None
երերացել	None
բողոքարկել	None
արեւածաղիկ	Singular
խնկ	None
ազդվել	None
քլորը	Singular
քոչվորական	Singular
չխոթել	None
դաղալումդ	Singular
չծառայեցի	Singular
վաճառքդ	Singular
կիրառված	None
պատրաստվել	None
տպ	None
էլեմենտներով	Plural
սաղավարտներիցս	Plural
ստադիոն	Singular
ամիրաներ	Plural
ընկերուհիներիս	Plural
հուսահատի	Singular
նաժիշտս	Singular
գիտակցում	None
կիրառած	None
կրակած	None
պուրակները	Plural
չափելիս	None
տափաստաններ	Plural
մերձենում	None
քծնում	None
հաճախելիություն	Singular
ոլոռի	Singular
գեղեցկությամբ	Singular
ծիծաղում	None
արարքները	Plural
մեկնեցին	Plural
պուպուլ	Singular
խառն	None
ակումբներով	Plural
սպիտակուցներին	Plural
պլաստիկի	Singular
աղերսանք	Singular
հումուսով	Singular
սաղանալիս	None
վիճող	None
տարաներ	Plural
ձգտել	None
ծափահարումներիս	Plural
գոլֆը	Singular
գերանդու	Singular
նահանգապետեր	Plural
օսեր	Plural
կարտոֆիլին	Singular
նախագահության	Singular
ելիս	Singular
մուրում	None
համարեցին	Plural
ամուլ	Singular
արջերը	Plural
թարգմանել	None
թուլացե՛ք	Plural
դարձվածքի	Singular
լավայով	Singular
բանտից	Singular
հարել	None
զղջային	Plural
չեխերենները	Plural
քցում	None
սգալու	None
բնորոշել	None
գործարանին	Singular
հեռացնի	Singular
օրհներգի	Singular
հավատացած	None
լողանալիս	None
հասկացած	None
խոպոպացվում	None
փուչիկը	Singular
խցում	Singular
լուծելիս	None
պողոտան	Singular
թվարկող	None
մերկասառույց	Singular
լենը	Singular
կազմակերպ	None
կոտորակները	Plural
կտրոնը	Singular
հանգստանում	None
մոտեցնելու	None
գողանալ	None
վայելած	None
բացատրի	Singular
ոստանի	Singular
եռալ	None
ծնծղաների	Plural
գործառնությունների	Plural
փտեցնել	None
կոներից	Plural
հոգեբանությունից	Singular
արմավենիները	Plural
կողբացիներից	Plural
ստուգումների	Plural
ակրոպոլիս	Singular
երազել	None
հանրապետության	Singular
սառչող	None
պահեստներից	Plural
հայթայթել	None
հանդերին	Plural
պանթեոնի	Singular
խոսացող	None
զգացմունքիցդ	Singular
տանկով	Singular
բավարարվել	None
ներբեռնման	Singular
ծովածոցում	Singular
հառում	None
քվարկի	Singular
փլատակների	Plural
տրոհում	None
կկռթնեն	Plural
մեծարոյիդ	Singular
կաղամարներ	Plural
օրիորդի	Singular
կքարոզեր	Singular
մայաները	Plural
պայմանավորվեցինք	Plural
սմբակներ	Plural
վարդակակաչի	Singular
սիգը	Singular
գլխից	Singular
մատնվել	None
արատ	Singular
ընտրված	None
խոզանակիդ	Singular
իրադարձության	Singular
էսպերանտոյով	Singular
հիասթափված	None
նինջաների	Plural
ծածկույթ	Singular
վճարվել	None
փնջի	Singular
սաքսոֆոնի	Singular
ֆիննական	Singular
իմաստուններ	Plural
հացահատիկները	Plural
սաղացրած	None
զանգում	None
ճանապարհի	Singular
ծառայություններից	Plural
գրգռում	None
փաթեթ	Singular
քառյակների	Plural
քամած	None
մատղաշներ	Plural
հիմնադրամներ	Plural
զատվել	None
տհասներս	Plural
կիպարիսը	Singular
թզերումդ	Plural
քշում	None
հիասթափեցրեց	Singular
հիվանդները	Plural
շքանշանին	Singular
գործարկում	None
չթվարկել	None
կլանած	None
ունակություններ	Plural
բաժանումը	Singular
սիգարի	Singular
հինը	Singular
ալքիմիայում	Singular
կլանող	None
բանտարկվել	None
առնիս	Singular
միջինից	Singular
լավագույն	Singular
չդրվատած	None
նիստերը	Plural
հալվել	None
օթեւանիցդ	Singular
ճշգրտելու	None
չկանգնեն	Plural
ցողունի	Singular
չճամփորդեցի	Singular
տրամադրվել	None
ռեակցիայի	Singular
հղել	None
շահնշահս	Singular
լիբրետոներ	Plural
հատկանիշներ	Plural
զրույցների	Plural
առաջադիմությունը	Singular
ավանդույթներ	Plural
շփոթի	Singular
կարոտեն	Plural
ժանրով	Singular
մշուշների	Plural
արթնացող	None
ախտորոշելու	None
լորի	Singular
էստոներեններով	Plural
սլավոններիս	Plural
հնչույթների	Plural
սենատին	Singular
օսլայումս	Singular
կրոններ	Plural
տուրիզմ	Singular
փողրակների	Plural
կարողացել	None
անձրեւանոցովդ	Singular
խոպոպեր	Singular
չուղեկցեցինք	Plural
նեղանում	None
ճարտարապետությունների	Plural
տարածող	None
լողակում	Singular
սերմնաբջիջը	Singular
նկուղի	Singular
բերբերներից	Plural
գանգաթիթեռիցդ	Singular
Աքեմենյանի	Singular
խոխոջող	None
ղազ	Singular
տառապեցր	None
ծեծը	Singular
հեղինակից	Singular
կլան	None
հիդրոլիզի	Singular
լուսամուտից	Singular
ապարանջանի	Singular
պարգեւելու	None
ձեռնարկներ	Plural
խոտից	Singular
նրբերշիկի	Singular
խոստանալ	None
գոռալ	None
վինը	Singular
հանելուկ	Singular
տաղտկանալիք	None
սիրեկաններից	Plural
աշտեներով	Plural
գիտելիքով	Singular
շքանշանով	Singular
վճարող	None
համարեն	Plural
գուսանը	Singular
կայսրությունում	Singular
գործարկել	None
պարտատոմսումս	Singular
ձերբակալներիցս	Plural
շփոթվածությանդ	Singular
չգիտակցել	None
արվեստագետներ	Plural
կլիմաների	Plural
հալածանքներին	Plural
նավահանգիստներ	Plural
բենգալերեն	Singular
չկախարդեցին	Plural
դոլար	Singular
արհամարհում	None
լուսանկարչություն	Singular
ատեր	Singular
վնասվածքը	Singular
պտերներ	Plural
տեսիլքը	Singular
չեմպիոններիցդ	Plural
այցելելու	None
ձիթապտուղը	Singular
հնացած	None
չհասցնող	None
մոնոմեր	Singular
վիճաբանելու	None
դողացող	None
նեռին	Singular
քայլող	None
անեկդոտներ	Plural
գեղմնավորին	Singular
մշակույթներ	Plural
փոր	None
արմերը	Plural
նատրիումը	Singular
զետեղել	None
որոճացնել	None
ուղղություններդ	Plural
ներգաղթ	Singular
ուղեկցվել	None
արահետների	Plural
կուրին	Singular
տեսարաններում	Plural
ուղարկ	None
ուսանող	Singular
տասնամյակներում	Plural
գնահատած	None
գերանների	Plural
քանդեցին	Plural
նանա	Singular
միզելու	None
գաղտնի	Singular
սգում	None
ագուցված	None
բուդդիզմ	Singular
փչեն	Plural
կանխամտածած	None
չհետեւել	None
հառաչանքների	Plural
ճրագալույց	Singular
չմոլեգնած	None
բաժանումները	Plural
լիզող	None
չճամփորդող	None
խայթը	Singular
խառնաշփոթությունս	Singular
վերընթերցում	None
տանձը	Singular
սովորեցի	Singular
աճումդ	Singular
զգեստներումս	Plural
օքսիդենտալ	Singular
վիճակներ	Plural
արարչի	Singular
այբուբենին	Singular
չափվել	None
թզուկներ	Plural
ջայնիզմում	Singular
թալիում	Singular
հայտարարելու	None
չինարենի	Singular
չսարսափեմ	Singular
աղեղներ	Plural
մուշ	Singular
թանգարաններից	Plural
ելուզակների	Plural
խաչակիրներ	Plural
սեզերը	Plural
նեղացած	None
բեկանած	None
ադրբեջաներենով	Singular
բողբոջել	None
խցան	Singular
սառեցնել	None
միզապարկի	Singular
հանգեցնել	None
չներքինանալ	None
տանձենի	Singular
ապավենիս	Singular
նացիստներից	Plural
թզուկներին	Plural
մարաջախտ	Singular
չկասկածած	None
կայացող	None
շնորհած	None
անկան	None
տարածում	None
հառնող	None
իզոտոպներից	Plural
աղվամազը	Singular
լուսամուտի	Singular
սայթաքել	None
կմիանա	Singular
օդանավեր	Plural
մարզեր	Plural
ընդեղենի	Singular
ոզնիների	Plural
ոստրեներ	Plural
ասպականուցս	Singular
ուսուցանում	None
մաքսերը	Plural
ոսկրեր	Plural
շեշտելու	None
դեկտեմբերին	Singular
ուսումնասիրած	None
նահանգում	Singular
աքսորվում	None
երիկամում	Singular
գերանի	Singular
ուսուցչուհի	Singular
լվացվող	None
հասկանում	None
խնամվել	None
բուրբոնները	Plural
ալյումինիցդ	Singular
գտածոների	Plural
հմայող	None
թթվասեր	Singular
կայանալու	None
ինքնաթիռով	Singular
պատճենը	Singular
մեթոդից	Singular
ակներով	Plural
ակնածոտդ	Singular
հղիությունը	Singular
ամիրան	Singular
վեզիրները	Plural
հաճարենու	Singular
մտմտալու	None
ճախարակ	Singular
լավաշ	Singular
խորովածներովս	Plural
մարգարտածաղիկներս	Plural
մազուրկա	Singular
լրջամիտովդ	Singular
ակադեմիաներից	Plural
առաքինությունը	Singular
լքող	None
շարժը	Singular
ստելու	None
աշուղներ	Plural
խնջույքին	Singular
կոթողներից	Plural
հագեն	Plural
խույրերը	Plural
կցորդմամբ	Singular
ֆրիզյան	Singular
վկայություն	Singular
կատարը	Singular
դողալ	None
կրկեսի	Singular
ստեղծագործությունների	Plural
ֆաշիստականս	Singular
առաջնությունից	Singular
ամրոցներում	Plural
մերձերդ	Plural
ամերիկահայերի	Plural
հաշվումների	Plural
մատերիալիզմ	Singular
չմեկնեց	Singular
լոգարաններ	Plural
բացառվի	Singular
վեզիրը	Singular
բանակցություններից	Plural
սառցադաշտ	Singular
ազգականի	Singular
օգտագործեցի	Singular
բազալտում	Singular
չմագլցած	None
մայաների	Plural
տասնամյակը	Singular
մակերիկամների	Plural
ճղոպուրներս	Plural
ծանուցումը	Singular
գորոված	None
աշխարհայացքով	Singular
սառույցներ	Plural
ասորով	Singular
սլանալ	None
ահագնանալ	None
արարը	Singular
տոհմածառը	Singular
հոգեբանդ	Singular
վերելակով	Singular
փնտրելիս	None
քշվել	None
չստամբակել	None
հրահրող	None
կալցիումով	Singular
բարք	Singular
գոյ	Singular
աղբանոցի	Singular
խնամքով	Singular
ճիգի	Singular
կերպարանք	Singular
բերիլիումի	Singular
նորույթներիցս	Plural
օճառներ	Plural
կուզեի	Singular
մրջնակերիցս	Singular
շոկոլադ	Singular
շեքի	Singular
ճրագալույցին	Singular
ալուճներիս	Plural
հաշտեր	Plural
զորախմբեր	Plural
առկայծեիր	Singular
չհարսնացնող	None
հնարամտություն	Singular
մեծարել	None
արմունկոսկրիցդ	Singular
մետաղում	Singular
բողոքող	None
ֆուտբոլիստները	Plural
նվագել	None
հեղափոխություններից	Plural
մոռացա	Singular
նադիրի	Singular
սպա	Singular
աքսորել	None
կանխում	None
թլվատելու	None
ունքերը	Plural
կատակերգություններից	Plural
շարժապատկերը	Singular
բուրժուազիան	Singular
խրճիթ	Singular
ձմեռայինիցս	Singular
վկաներից	Plural
ծառայությամբ	Singular
կալբասովս	Singular
գուրզերովդ	Plural
մաղթում	None
հոգացել	None
ճաքերի	Plural
փուլերով	Plural
պարտությունները	Plural
արձագանքող	None
լայնությունիցս	Singular
չլկստել	None
մորուքներիդ	Plural
նվագախմբին	Singular
կզարթնեիք	Plural
ճյուղերով	Plural
չբուսանել	None
շաքարովս	Singular
աղալու	None
պտերներին	Plural
սիրւել	None
տեսնում	None
բնակչով	Singular
նորում	Singular
հոռովելի	Singular
տերեփուկ	Singular
հյուծել	None
թութակներին	Plural
պատարագով	Singular
հերոսուհիների	Plural
բանեցնել	None
ճամփորդ	Singular
ֆոնոն	Singular
ազնիվովս	Singular
դադարի	Singular
ըմբշամարտով	Singular
մարմնեղներիցդ	Plural
բժիշկները	Plural
ծնվում	None
զարդարանքները	Plural
ռուսների	Plural
գետաձիեր	Plural
պաշարների	Plural
շինարարի	Singular
պայմանագրերը	Plural
զոմբին	Singular
աղաղակել	None
ամեոբայի	Singular
աղավաղվել	None
ձկնկուլներս	Plural
հիվանդություններ	Plural
անցքի	Singular
մեղքիցս	Singular
քանդած	None
գնչելիս	None
քրտնում	None
կայծակը	Singular
բնույթի	Singular
մարդագայլի	Singular
չորդ	Singular
կատարող	None
գագաթնաժողովը	Singular
ուզեմ	Singular
կաղկանձելիք	None
փոխարինվել	None
խաբարը	Singular
մթերում	Plural
չձուլեմ	Singular
հանգ	None
չզեռացին	Plural
քայլելիս	None
հայրենիիցս	Singular
թեմը	Singular
պատանյակ	Singular
ամուսնացնում	None
ավելին	Singular
երկմտելու	None
աշխատավարձը	Singular
բեկան	None
ֆլամինգո	Singular
հորդել	None
կզակում	Singular
դիսպրոզիումներումս	Plural
խեժում	Singular
ծնվ	None
սովորույթի	Singular
գործարկելու	None
վճարեց	Singular
հեծանիվ	Singular
փոխարիներ	Singular
հրամայել	None
ռեժիսորների	Plural
նշանաբանի	Singular
շքերթներում	Plural
վիպասանները	Plural
փայտիկով	Singular
կրոնական	Singular
իժերի	Plural
հրապույր	Singular
կայանից	Singular
զրուցելիս	None
աղյուսե	Singular
ընթերցումների	Plural
չվերթի	Singular
հոտեր	Singular
մայրցամաքից	Singular
համացանցի	Singular
չափ	None
որսորդների	Plural
ավազակները	Plural
չուզեց	Singular
կարմրուկովդ	Singular
հատկացնում	None
բավարարել	None
ձորս	Singular
մատերիալիզմը	Singular
մագմաներիցդ	Plural
բեկտելիս	None
հորդորում	None
գն	None
կառավարի՛ր	Singular
արկը	Singular
ծագում	Singular
փարավոնների	Plural
հորթի	Singular
պատվաստումը	Singular
փլվելիք	None
լիմոն	Singular
կանչվել	None
հյութեղով	Singular
զոդում	Singular
զորապետը	Singular
ռոմանշովդ	Singular
եղջյուրներից	Plural
բարեկամություն	Singular
բալետը	Singular
բացառությունների	Plural
իմունիտետը	Singular
խաղամոլ	Singular
մեծից	Singular
ավելացնենք	Plural
ջղայնացող	None
ծեծում	Singular
ձվաձեւ	Singular
զեռուններից	Plural
բեկորներով	Plural
տերտերը	Singular
քամել	None
հանձնում	None
շքամուտք	Singular
կուսակցություններումս	Plural
հուշարձաններով	Plural
արկղը	Singular
քաջալերանքումս	Singular
վարկածների	Plural
հայտնագործության	Singular
ստորագրել	None
կախարդված	None
միացող	None
հեռուն	Singular
նվագ	None
բիզնեսով	Singular
վայրերում	Plural
պարիսպներից	Plural
հալածեն	Plural
անգլիացիներ	Plural
երազող	None
կաղկանձովս	Singular
հիվանդությունից	Singular
լեռնաշխարհում	Singular
բարիկադների	Plural
շողա՛	Singular
լեյտենանտը	Singular
սեռականում	Singular
սխտորով	Singular
մաղթանքը	Singular
լողանալու	None
ականջների	Plural
կանչած	None
կէտի	Singular
տրամաչափերի	Plural
օժանդակումս	Singular
ինքնասպանությունից	Singular
խանությունից	Singular
քարտուղարուհի	Singular
կլանելիս	None
մանդարինը	Singular
դրվատեր	Singular
ներբողներ	Plural
չբողոքել	None
ծառայություններին	Plural
փայլակդ	Singular
մատն	None
կեղեւի	Singular
լվացած	None
համակարգիչներ	Plural
չազդել	None
նիդերլանդացի	Singular
պյուռոսյաններովդ	Plural
նժույգները	Plural
դղեզիս	Singular
բարելավվել	None
հովտում	Singular
բաճկոնով	Singular
կեռնեխների	Plural
բոլորում	Singular
ուռեցնել	None
տեսարանը	Singular
ընդերքից	Singular
սրերով	Plural
հյուպատոսությունները	Plural
ցուլը	Singular
հարեմ	Singular
չզրնգացած	None
լեզգիովդ	Singular
խնձորիցդ	Singular
ապրուստիս	Singular
ջուլհակների	Plural
ծնոտով	Singular
հավելեն	Plural
տաղանդավոր	Singular
սոցիալիստականի	Singular
սորալու	None
մեղեդուն	Singular
փչող	None
գոհացնեն	Plural
մոռացնել	None
սիգալիս	None
անգամների	Plural
կողքից	Singular
բնութագրելիս	None
ֆաշիզմից	Singular
տարաները	Plural
ատեն	Plural
երկբայանքովս	Singular
ճանապարհորդության	Singular
հարվածներով	Plural
մօտենալու	None
պարով	Singular
գրպանովդ	Singular
վայրերից	Plural
ապահովացնել	None
ցին	Singular
ստիպել	None
բացառել	None
աղքատներին	Plural
թավա	Singular
լուծենք	Plural
օգտագործելիս	None
մեղադրելու	None
պրակրիտի	Singular
ճիզվիտները	Plural
սեղանատան	Singular
վաճառելու	None
դոլարի	Singular
կվարցդ	Singular
գնած	None
չհուսալքած	None
բանսարկու	Singular
շիթերի	Plural
վերնագիր	Singular
հալածանքներ	Plural
զեբրը	Singular
դատողություն	Singular
ճմռթելիք	None
գրանիտով	Singular
հեծնել	None
առաքող	None
մեռելների	Plural
կստիպեիք	Plural
փոխարինելիք	None
սպիտակով	Singular
նավաստիներին	Plural
ամբարտակից	Singular
սանրել	None
ապահովվող	None
համակարգ	None
տիվում	Singular
սելավի	Singular
բլոգում	Singular
առակներով	Plural
վանում	None
մարիխուանայի	Singular
գիսաստղերը	Plural
հաճախություն	Singular
արքունի	Singular
չմղեցիր	Singular
ուսումնասիրեց	Singular
արյունահոսում	None
ջորի	Singular
ուղարկեն	Plural
կետչուպս	Singular
արագություններով	Plural
հար	None
կուրսը	Singular
ուժեղների	Plural
խիթացել	None
ամորձիներիս	Plural
կախած	None
կոմս	Singular
բարձրից	Singular
էյնշտեյնիում	Singular
մարզադաշտը	Singular
խոսալու	None
պայմաններին	Plural
երկաթգծից	Singular
խոպոպացրել	None
օգտագործելիք	None
տարածքի	Singular
թոք	Singular
մեղուն	Singular
նախընտրեցին	Plural
գողանա	Singular
գիտակցել	None
պատմություններ	Plural
ավտոմեքենայից	Singular
օրհներգում	Singular
ազդանշանին	Singular
ձիրքեր	Plural
օրակարգի	Singular
հղանային	Plural
կճուճները	Plural
պտույտներ	Plural
զարթնել	None
նահանգներիցդ	Plural
հավելվածով	Singular
վտանգներով	Plural
նախահայրը	Singular
ակոսներ	Plural
տրամադրում	None
չպատկանել	None
մանգաղը	Singular
վիճեցին	Plural
տասերորդներովս	Plural
կանգնի	Singular
շնչում	None
հեղեղներ	Plural
հարցազրույցին	Singular
պատյանը	Singular
կշռելու	None
խրծիկներիս	Plural
ահաբեկչությունների	Plural
վասալների	Plural
իսպանացի	Singular
մեղք	Singular
գնող	None
կենդանաբան	Singular
շահագործում	None
փախած	None
պատրաստող	None
ենթարկելու	None
հաղարջենին	Singular
խրամատները	Plural
թվարկելիք	None
ներբեռնած	None
զարմացած	None
աշխատավարձ	Singular
մետաղալարով	Singular
վարորդ	Singular
պահպանեցին	Plural
գաղտնաբառերը	Plural
վուշ	Singular
կենսաբանության	Singular
լվացել	None
նախաճաշովդ	Singular
ծաղրվել	None
սգացող	None
բնակչությանը	Singular
քյոխվայի	Singular
գետառի	Singular
բակից	Singular
ուսանած	None
ծակոտկեններում	Plural
եփեն	Plural
անձնագրերում	Plural
կայֆերին	Plural
դանիական	Singular
հայագետներից	Plural
ճեմասրահի	Singular
չորացող	None
ընկղմած	None
պղպեղներ	Plural
համաձայն	Singular
շախմատով	Singular
քարտը	Singular
հայկականից	Singular
հարգել	None
ողբումդ	Singular
իրականից	Singular
չնքողող	None
շարժումներ	Plural
սոուլը	Singular
բառապաշարի	Singular
կհիմարացնեն	Plural
շաղգամ	Singular
իոնը	Singular
քավում	Singular
ուսուցիչներից	Plural
գնեցին	Plural
գոհացնում	None
չբաղբաջած	None
մտադրվում	None
քերականագիտական	Singular
սաղավարտ	Singular
կող	Singular
կաթնուկը	Singular
թաղելու	None
արածեցնելիս	None
խորերս	Plural
չհանգած	None
գլյուոնների	Plural
ապացուցվող	None
առաջադրանքներիցս	Plural
փիլիսոփայության	Singular
սնդուկներ	Plural
տիեզերագնաց	Singular
համալսարան	Singular
սարդը	Singular
մուղամ	Singular
պատվանդաններ	Plural
գանգրածածկս	Singular
ռինգ	Singular
կանոններից	Plural
վարորդին	Singular
առյուծով	Singular
հողմերը	Plural
ջրածինները	Plural
կենսաբանները	Plural
կաշառելու	None
բացատրութիւնը	Singular
հեղեղում	Singular
չվող	None
օսի	Singular
ասորի	Singular
առոգանելիս	None
սարդիներեններից	Plural
բացատրությունների	Plural
խեղդելու	None
վախեցածներին	Plural
հյուրանոցը	Singular
լաբիրինթոսով	Singular
մագլցելիք	None
գործվածքներ	Plural
վաշտին	Singular
ընկուզենի	Singular
թագավորներ	Plural
չըլնող	None
կոալա	Singular
մտցնում	None
խելագարը	Singular
հանգելիք	None
գանգրածածկից	Singular
խայտառակից	Singular
ղասաբներովդ	Plural
շքախումբդ	Singular
հրաշքները	Plural
ոռոգում	None
մոլորակների	Plural
թողության	Singular
կայանների	Plural
հարցումներով	Plural
ժամացույցների	Plural
բնակվելու	None
խնամելու	None
ուղղությունները	Plural
ոսոխի	Singular
խռիկներ	Plural
կայուն	Singular
դատապարտած	None
իրականին	Singular
հայտնիներ	Plural
լուրթով	Singular
նախկինին	Singular
զոդող	None
աղանդերին	Singular
մետաղադրամիս	Singular
մոգեր	Plural
գույքով	Singular
տեղեկացնում	None
կոչումներին	Plural
հայացքներից	Plural
զետեղում	None
խուզող	None
նավի	Singular
ազատքեղներիցս	Plural
ապահովացնելիս	None
ջուլհակի	Singular
հազից	Singular
գետակներ	Plural
սկանդիումը	Singular
քթանցքից	Singular
ցուցանակի	Singular
գաղտնիքի	Singular
չկատաղել	None
թանա	Singular
աղալիս	None
նավ	None
կցել	None
թույներով	Plural
արտասահմանցիներ	Plural
գնվել	None
պահակները	Plural
խալիֆայությունում	Singular
խօսած	None
առեղծվածներ	Plural
հեծանները	Plural
ծագումը	Singular
երկայնաբազուկի	Singular
պատյանով	Singular
գյուղացիներից	Plural
հայրենակից	Singular
էականը	Singular
չծանուցես	Singular
տրոհվել	None
չակերտները	Plural
փետրվարի	Singular
տոկալու	None
ներգաղթել	None
անպատեհ	Singular
տնօրինում	None
մրցույթը	Singular
անմոռուկ	Singular
մարդագայլերիցս	Plural
տոներ	Plural
մայ	None
քանակից	Singular
հուռթացող	None
գործարքին	Singular
այծենիներում	Plural
վիճեց	Singular
բորիում	Singular
դարբին	Singular
մրցույթ	Singular
սյունակում	Singular
թախտի	Singular
կիրառվում	None
արմունկների	Plural
լուծող	None
չհոլանող	None
խոպոպեցր	None
սովորույթներում	Plural
հաստոցների	Plural
բացատրելու	None
տանիքում	Singular
լիզում	None
վայելքների	Plural
ցեղասպանությունը	Singular
մեյդանի	Singular
քննվել	None
արատում	Singular
տեսակում	Singular
հաշտերին	Plural
ամեոբան	Singular
կազակ	Singular
աղատելու	None
հաստոցից	Singular
հանգույցներով	Plural
կմահանա	Singular
քննարկելու	None
չզարմացրած	None
ապրանքների	Plural
կշռող	None
անգամից	Singular
կոչենք	Plural
սուզանավը	Singular
գողանալու	None
խմել	None
դարպասում	Singular
վայր	Singular
հառած	None
չկանխամտածված	None
կեռասը	Singular
մետաղների	Plural
նահանգներում	Plural
աղերսելիք	None
շարունակ	None
քարշող	None
բանականություններումդ	Plural
աղում	None
փամփուշտի	Singular
սիրու	None
թաղանթների	Plural
լեռնաշխարհը	Singular
տաշում	Singular
մերսման	Singular
գրախանութների	Plural
արդարացի	Singular
փոխհատուցեցիք	Plural
վաճառականներ	Plural
պառկած	None
կերպարանքի	Singular
բալետների	Plural
մուշում	Singular
կերտվել	None
հավակնորդների	Plural
գլյուոնները	Plural
նիստից	Singular
ներողությունը	Singular
հաճախորդը	Singular
մեքսիկացիներովս	Plural
աջակցելու	None
վառված	None
իշղար	Singular
խանձատած	None
զտող	None
գործընկեր	Singular
ուղու	Singular
սովորեցնել	None
կուլին	Singular
խառնել	None
լիճը	Singular
մայրուղիներում	Plural
խայթել	None
աշխատավարձերիս	Plural
վերծանում	None
հղելու	None
ընթերցասրահովս	Singular
թենիսիստուհիները	Plural
կոսմոպոլիտայիններովս	Plural
այցելում	None
խորհրդանշելու	None
ներխուժելու	None
չառաքել	None
ապաշխարել	None
համախոհներ	Plural
ճառագայթներիդ	Plural
պաշտոններից	Plural
էտ	None
չանհանգստացող	None
բավարարող	None
պարտավորությամբդ	Singular
լուծում	None
կորյուններիդ	Plural
առաքյալի	Singular
հրվանդաններ	Plural
արագացում	Singular
ուրիշին	Singular
չսորայի	Singular
կտեղեկացնեմ	Singular
կառչել	None
սրտառելու	None
սեղանապետ	Singular
օժանդակեց	Singular
չհամաձայնեց	Singular
հոբելյաններ	Plural
կիթը	Singular
խորհրդում	Singular
չբաջաղող	None
ծիծեռնակը	Singular
մոլորակ	Singular
զտել	None
շնորհ	Singular
մակեդոնացուն	Singular
պեղում	None
վճարելու	None
ցերեկով	Singular
հյուսած	None
բարելաված	None
ամլիկովս	Singular
պատմություններին	Plural
կարտիս	Singular
չօթել	None
հաղթում	Singular
վճռել	None
կոսմոսին	Singular
գեղագանգուրներովս	Plural
թեկնածուի	Singular
թարթիչներով	Plural
նախընտրելիս	None
սպիտակուցին	Singular
տարածելու	None
քաղցած	None
ճկունությունը	Singular
բղավել	None
լոյսով	Singular
չկեղտոտող	None
թագը	Singular
հրեշտակի	Singular
յուղաներկումդ	Singular
հյուսեին	Plural
աղոթելիք	None
սառցադաշտեր	Plural
կարստի	Singular
շորով	Singular
կազմակերպիչ	Singular
հանգամանքների	Plural
սառչելու	None
կատարած	None
բացատրեցի	Singular
պատուհաններից	Plural
հիպնոսի	Singular
կենդանի	Singular
թորիում	Singular
չվռնդեմ	Singular
առէջքներից	Plural
կամակոր	Singular
զարմացնող	None
ավետիքներումդ	Plural
անձնանունները	Plural
արծվին	Singular
բացատրեմ	Singular
չարաց	None
կրկեսից	Singular
սալորենի	Singular
գոյացած	None
փորձած	None
վառարան	Singular
գյուտարարից	Singular
ոսկեծաղկի	Singular
Հոհենցոլերններիցդ	Plural
բիֆշտեքսը	Singular
կռատուկ	Singular
կարծեցին	Plural
հովիտ	Singular
պատվաստումներ	Plural
ճանդան	Singular
չիրս	Singular
եղծան	None
կոներով	Plural
անուշ	Singular
փականը	Singular
սպանություններդ	Plural
գոմեշ	Singular
ուշի	Singular
ցտող	None
արդյունաբերությունները	Plural
գերանները	Plural
որսալու	None
հղումից	Singular
կոգեն	Plural
սկյուռ	Singular
բողոքի	Singular
խռիկների	Plural
ճանապարհներին	Plural
վայելող	None
կորում	None
համոզվել	None
հուլիսից	Singular
այգուց	Singular
պարտվելու	None
մագիլները	Plural
բարձունքում	Singular
շպռտող	None
հրթիռներում	Plural
մեկներ	Singular
նախածանց	Singular
ժամկետից	Singular
ներքինանում	None
փողոտ	None
պոռոչագինումդ	Singular
չորանալու	None
մեջք	Singular
լիմոնադ	Singular
պառկում	None
հիվանդություններին	Plural
ծանուցումները	Plural
արձագանքելիս	None
սրճի	Singular
հարվածների	Plural
մտցնելու	None
անոթի	Singular
արիություն	Singular
չզարմացող	None
դաշնությունդ	Singular
հրաշքների	Plural
հայրը	Singular
շարունակած	None
մեկնել	None
խափանվել	None
հմայվել	None
լծեն	Plural
խոյացել	None
նախագահությունը	Singular
արյունահոսությունները	Plural
ձիթապտուղներս	Plural
թայֆունի	Singular
կրաքարը	Singular
հուշարձաններ	Plural
հողմերի	Plural
հանդեսներում	Plural
դելֆինի	Singular
գոյացող	None
նաժիշտներից	Plural
հեղցին	Singular
խմածներովս	Plural
հիասթափեցնող	None
մոլ	None
կափարիչները	Plural
հրապուր	None
կազմակերպելու	None
կանգնած	None
նորիցս	Singular
տարածեց	Singular
լծվել	None
չկռթնել	None
մարգարեներից	Plural
չսգացած	None
իրականի	Singular
պտույտ	Singular
առաքինին	Singular
գնացած	None
գրախանութում	Singular
կոմսը	Singular
կտցարներ	Plural
ֆրանսուհի	Singular
խթում	None
յոգուրտով	Singular
տեսությամբ	Singular
հերոսով	Singular
լվացքատանը	Singular
արջներս	Plural
ընկուզենու	Singular
լողանալ	None
չպատկանող	None
վագոնում	Singular
հիմնավորեի	Singular
եպերանքիդ	Singular
խօսել	None
մեներգ	Singular
մնջախաղ	Singular
խեչակովս	Singular
աղանդ	Singular
կռիվները	Plural
այցելություններից	Plural
մեծաքիթներ	Plural
ապտակ	Singular
մեծի	Singular
գոյանալիս	None
առնին	Singular
լվացող	None
խոցող	None
բասկետբոլով	Singular
զարմանում	None
չընտրվեց	Singular
սպանել	None
արագիլի	Singular
պանծալիք	None
մատյան	Singular
կույտ	Singular
չապշեի	Singular
չծնված	None
լուսանկարչությունը	Singular
հողմի	Singular
չարիքի	Singular
նուշ	Singular
մերձենալու	None
արյունահոսություններ	Plural
չճվատած	None
ռենիումը	Singular
կպագնեն	Plural
որսացել	None
սովորող	None
տուժվել	None
դատողության	Singular
խմբագրել	None
զորախմբերը	Plural
կնճիթ	Singular
բնութագրեցին	Plural
կռնչալիս	None
կրծքում	Singular
կայանները	Plural
զվարճանալու	None
առաքում	None
կամարով	Singular
կրծող	None
հաշիվներին	Plural
արտադրանքներ	Plural
հոշոտել	None
եղերական	Singular
բոզոնը	Singular
տժվժիկ	Singular
նախատինքներին	Plural
բազմամարդը	Singular
չուրացող	None
արարողություններում	Plural
վանել	None
ստորագրելու	None
երակից	Singular
համերգով	Singular
այծենիովս	Singular
որսորդի	Singular
հեղեղվել	None
սկլերոզներովս	Plural
հագնելու	None
փայծաղը	Singular
մտրակով	Singular
լվանում	None
կառչելիք	None
կաղամար	Singular
չփարվեց	Singular
արվեստները	Plural
շատանալիս	None
կոկիկներ	Plural
խնձորենին	Singular
տունդրայի	Singular
ներբեռնել	None
խեղկատակ	Singular
սարդերից	Plural
մարզադաշտից	Singular
հորաներից	Plural
ձող	Singular
մատուցելու	None
ճամպրուկի	Singular
հավք	Singular
փոխհատուցելու	None
չագարակացնող	None
հնարքին	Singular
էյնշտեյնիումով	Singular
տնօրինելու	None
վարդենու	Singular
մրցում	None
երկարությունների	Plural
հնագետին	Singular
զարմացրած	None
ծովակալովս	Singular
շահագործել	None
չլողացող	None
վարող	None
չպաղատել	None
առյուծներից	Plural
ահազանգե՛ք	Plural
ընթերցումից	Singular
չեռացող	None
ձգտեն	Plural
աշխարհամասերում	Plural
թակարդների	Plural
հույլերիցդ	Plural
կապտում	Singular
չօգտագործել	None
աշորայիս	Singular
տառադարձում	None
դեկանը	Singular
սփռվել	None
արվեստագետի	Singular
թռնող	None
հերքող	None
շոկոլադդ	Singular
գնահատելու	None
մասրենիներին	Plural
արգելքները	Plural
մաքրելիս	None
մարտնչած	None
սորի	Singular
գովում	Singular
ալյումին	Singular
արահետներ	Plural
ցուցասրահ	Singular
ներկայացուցչություններ	Plural
ոսպնյակները	Plural
չսրամտենք	Plural
զարմացնեին	Plural
վախ	Singular
բուլղարացիների	Plural
երեւում	Singular
լենինիզմիցս	Singular
սխտորներովս	Plural
փորոքներում	Plural
ուռենու	Singular
դրդել	None
խմիչքները	Plural
ալկոհոլիզմով	Singular
կոշկակար	Singular
փչացավ	Singular
արթնանում	None
գրանիտ	Singular
քաղաքականությունների	Plural
կալանքը	Singular
օազիս	Singular
տնտեսագետների	Plural
պեղել	None
ձաղել	None
ճոնին	Singular
արվեստագետովս	Singular
թարգմանեցի	Singular
բաժանվում	None
սառած	None
հնձանը	Singular
մայրուղին	Singular
օմարի	Singular
մղձկալու	None
տեքստերով	Plural
առյուծները	Plural
խափանել	None
թանգարաններում	Plural
հանձնել	None
ժանի	Singular
էլեմենտի	Singular
չապստամբող	None
լեղապարկը	Singular
չսրճեցիք	Plural
մայրցամաքի	Singular
ձուլելու	None
բիլս	Singular
լվանալիս	None
սնուցումը	Singular
փոթերից	Plural
ալանները	Plural
հղեց	Singular
քրտնելիս	None
մերկապարումդ	Singular
այծ	Singular
կաղամախներում	Plural
մոլեկուլ	Singular
թուրինջներ	Plural
բռնությանը	Singular
սերուցք	Singular
նկուղում	Singular
պահպանակները	Plural
վաննաներ	Plural
կանաչավունովս	Singular
լեպտոններ	Plural
օգտագործել	None
տպում	None
հիդրոլիզ	Singular
ֆլեշմոբը	Singular
գերմանիում	Singular
էակը	Singular
քանորդը	Singular
ծածանների	Plural
անապատի	Singular
հնէաբան	Singular
գետառ	Singular
բալետներից	Plural
հատկանիշները	Plural
գերշուկաներումդ	Plural
փաստաթղթով	Singular
հորդորանքը	Singular
սեզոններիցդ	Plural
նադիր	Singular
խիթքով	Singular
զգեստապահարանիդ	Singular
կայծքարի	Singular
խեչակները	Plural
ընձառյուծների	Plural
մատյաններում	Plural
հատուցել	None
թաքցնում	None
կնքում	None
պատրաստելու	None
հուսահատվելիք	None
ատ	None
հուշանվերներիցս	Plural
խեթերենի	Singular
խաղալիքներովդ	Plural
երգեհոնը	Singular
ռութենիումի	Singular
ծախում	Singular
Մխիթարին	Singular
ուղտերից	Plural
պոզիտրոնի	Singular
պիլասոսիցս	Singular
արտաքին	Singular
խորհրդարաններում	Plural
փռշտալիք	None
ճնճղուկը	Singular
սրճարանում	Singular
հուշարձանում	Singular
լուցվել	None
թեմում	Singular
գետաձիերի	Plural
առիթների	Plural
այսբերգ	Singular
պոլիմերներ	Plural
հեծանների	Plural
հնչյուններից	Plural
կաղամախու	Singular
չկիրառել	None
կազմախոսությանդ	Singular
կեղծերում	Plural
հղեցող	None
երեքնուկ	Singular
արդարեւ	Singular
փաթեթներ	Plural
բացատրում	None
քավելու	None
քաոսականներ	Plural
հեռուստատեսության	Singular
կղզիներդ	Plural
չսիրւէինք	Plural
սիրելի	Singular
կորնչում	None
որովայնը	Singular
արքայադստրերի	Plural
մագմայից	Singular
ծափահարվ	None
քարոզելու	None
անցքով	Singular
թութը	Singular
կընտրվեն	Plural
սաղարթի	Singular
գրառող	None
վաշտ	Singular
արարածը	Singular
գյուտեր	Plural
ներգաղթած	None
բլթակներով	Plural
ապտակներովդ	Plural
թաթուլը	Singular
քաղաքով	Singular
առողջովս	Singular
ստորակետ	Singular
փունջ	Singular
հորդոր	None
տիպաբանական	Singular
կորեր	Singular
կենսալիցիցդ	Singular
բուսակերությունը	Singular
չծնեին	Plural
օլիգարխիաներիդ	Plural
տեղեկատվությանը	Singular
բախումներում	Plural
փայծաղում	Singular
փաստերով	Plural
ակումբով	Singular
արտասահմանից	Singular
շուշանը	Singular
խաչքարերի	Plural
կաստայի	Singular
կոնֆետի	Singular
մկրատով	Singular
մատուցելիս	None
պարսկերենի	Singular
գառնենիներիդ	Plural
մեդալները	Plural
սերուցքի	Singular
հավատներիցդ	Plural
թենիսից	Singular
աջաբսանդալներում	Plural
սիգալ	None
փչել	None
գովեց	Singular
որբացած	None
զգեստը	Singular
առհավատչյաներումդ	Plural
բնույթից	Singular
այտուցի	Singular
միացնող	None
պատկանել	None
խաղաղություն	Singular
ավազակներից	Plural
ազնիվին	Singular
գմբեթներով	Plural
զարկերակներով	Plural
սղոցիցդ	Singular
աշակերտների	Plural
առաջադիմող	None
տրակտորներ	Plural
բնագիրը	Singular
գրասեղանով	Singular
նավահանգստի	Singular
մրցավարի	Singular
խաշը	Singular
շարժվել	None
արքայախնձոր	Singular
հեղինակությամբ	Singular
չորացնելու	None
կկելու	None
գույքից	Singular
ֆլեյտաները	Plural
շքանշանի	Singular
երաժշտությանը	Singular
հուժկուն	Singular
խազ	None
ուրագ	Singular
հաստույրից	Singular
