brigads	Singular
fågelvingen	Singular
krypterats	None
offentlighetens	Singular
förebyggande	None
grusbana	Singular
presstödet	Singular
arkiveras	None
mataffären	Singular
urinoar	Singular
finskans	Singular
rättelsen	Singular
retirerade	None
giftets	Singular
logiska	Plural
spioner	Plural
leggen	Plural
besökte	Singular
käkarna	Plural
nunan	Singular
bifalla	None
skyddsvärdes	Singular
Fouriertransformernas	Plural
bedömningar	Plural
kartlagt	None
omvärderade	None
kvarskatts	Singular
dal	Singular
missuppfattar	None
avkodar	None
gömt	Singular
diskussionssidan	Singular
missionerades	None
kallnar	None
styrelseordförandens	Singular
sadelpunkternas	Plural
välsigna	None
holken	Singular
nominativ	Singular
protokollföra	None
orgasms	Singular
dynamiks	Singular
psalmens	Singular
nuddas	None
slagna	Plural
demagogs	Singular
videos	Singular
slutlig	Singular
skreks	None
felmeddelande	Singular
utgjorde	None
överväga	None
otroliga	Plural
verkar	None
erotiken	Singular
hastade	None
engagerat	Singular
tillbringade	None
funktorn	Singular
postmodernismen	Singular
betecknande	None
överdirektörer	Plural
positioneras	None
solrosens	Singular
nattugglas	Singular
statskupp	Singular
glänste	None
skuldran	Singular
ryskt	Singular
antagande	Singular
musicerade	None
förfarande	Singular
ledarsidor	Plural
känneteckna	None
kryptons	Singular
disponerad	None
surra	None
axlar	None
släck	None
livegna	Plural
prestationen	Singular
personbilarnas	Plural
sovjetiske	Singular
ubåtens	Singular
törstig	Singular
förkortade	None
grävmaskiners	Plural
rätta	None
finansmarknaderna	Plural
vingården	Singular
avtalat	Singular
flamländskan	Singular
brygden	Singular
kontringen	Singular
sakpolitiske	Singular
amplituder	Plural
motorväg	Singular
exploatera	None
dörja	None
trädojans	Singular
luftbubblor	Plural
lian	Singular
viceamiral	Singular
hörd	Singular
förståelig	Singular
flikarna	Plural
försäljningslistan	Singular
miljonärerna	Plural
sågad	None
vävnadens	Singular
kärringen	Singular
lur	Singular
växellådor	Plural
överföras	None
barrig	Singular
sjukvårdsrådgivningen	Singular
rättstavningen	Singular
laddas	None
häftiga	Plural
serverade	None
exemplifierat	Singular
obducent	Singular
tilldelad	None
hamstern	Singular
upphävande	None
adlande	None
termodynamikens	Singular
frotté	Singular
primärkällor	Plural
klimatologi	Singular
modifieras	None
hittande	None
upplåten	None
hovrättsfiskal	Singular
wikipedianen	Singular
ärligheten	Singular
bladen	Plural
arab	Singular
omsattes	None
koksaltet	Singular
euklidiskt	Singular
samverkade	None
snut	Singular
hallåan	Singular
iriskan	Singular
synlige	Singular
skåror	Plural
cricketmatcher	Plural
svastikor	Plural
prepositionen	Singular
dalripa	Singular
marxismen	Singular
refektorium	Singular
hederlighet	Singular
ventilerna	Plural
utgivet	Singular
konjugationerna	Plural
ändelsen	Singular
vardagliga	Plural
spirituellt	Singular
hövdingens	Singular
garderar	None
skocks	Singular
trivseln	Singular
rätvinkligt	Singular
kålrötter	Plural
åkningen	Singular
uppnådd	None
betydliga	Plural
nosen	Singular
utrikespolitiska	Plural
vildkatter	Plural
sandslottet	Singular
isväg	Singular
exporterar	None
fixera	None
jamaican	Singular
kompromissernas	Plural
fjortisarna	Plural
militärstyrkan	Singular
paddornas	Plural
huvudfrågor	Plural
spanjorernas	Plural
arbetsfördelning	Singular
chefredaktör	Singular
behå	Singular
skymtars	Plural
spöade	None
propagerar	None
restaureras	None
vårdas	None
dvärgplaneter	Plural
summeras	None
brödrost	Singular
växeltungorna	Plural
daoisms	Singular
rannsakade	None
dokumenterats	None
hyllet	Singular
lyten	Plural
oktagonen	Singular
behärskade	None
barbarisk	Singular
snickarverkstad	Singular
konsumentens	Singular
turbanen	Singular
pruttens	Singular
match	Singular
passad	None
förena	None
joxets	Singular
påpekat	None
tjugofjärdedel	Singular
pingvinen	Singular
övervinnas	None
noterade	None
plastpåse	Singular
vipporna	Plural
kröner	None
medling	Singular
kondenserat	None
dike	Singular
systemkamera	Singular
stoltserande	None
israeliternas	Plural
särk	Singular
licensierades	None
stumfilmens	Singular
finansierande	None
lämmars	Plural
mantelns	Singular
transformerat	None
förläggs	None
tuktas	None
bildordboks	Singular
granatäpplet	Singular
hyponymernas	Plural
orkesterledaren	Singular
subversiv	Singular
våglängderna	Plural
besudlades	None
25-öringars	Plural
histidin	Singular
förbanna	None
pentanoler	Plural
svärdottern	Singular
fortifikation	Singular
packade	None
klöv	Singular
tåliga	Plural
pansar	Singular
kombinerats	None
respektabel	Singular
axelmakterna	Plural
förkortningarna	Plural
markörens	Singular
symbolisera	None
dals	Singular
salvas	Singular
näsets	Singular
vackre	Singular
underklasser	Plural
mugg	Singular
servades	None
tolkade	None
teoretisk	Singular
ettans	Singular
baddräkten	Singular
världsstjärna	Singular
regisserats	None
rede	Singular
biltvätt	Singular
Stockholmssyndromet	Singular
förutsetts	None
baddräkter	Plural
tyste	Singular
bröllopsdagen	Singular
uppskattat	None
hovrätt	Singular
jämlikhets	Singular
bygdegården	Singular
bögar	Plural
nedsättning	Singular
givaren	Singular
jämnades	None
arkeologer	Plural
opererades	None
värmande	None
fiberoptiskt	Singular
sammets	Singular
kabeln	Singular
stockholmsk	Singular
inmatningar	Plural
emblemet	Singular
näbb	Singular
ristning	Singular
landsförrädaren	Singular
vites	Singular
armledernas	Plural
dyrkades	None
tutun	Singular
nyckelknippor	Plural
prinsessor	Plural
longituders	Plural
distansminuters	Plural
kalender	Singular
minderårige	Singular
röjas	None
virknål	Singular
inspireras	None
önationer	Plural
konteramiralen	Singular
påvemakten	Singular
textformaten	Plural
kristallkronan	Singular
ritad	None
handelsministern	Singular
decennium	Singular
raspas	None
hastar	None
fackspråklig	Singular
vanföreställningarna	Plural
räntesatsers	Plural
cystan	Singular
domänerna	Plural
filialers	Plural
kriminologisk	Singular
tamilens	Singular
nymåne	Singular
händer	None
livsmedelsbutikerna	Plural
arkivering	Singular
wikifierad	None
kroaternas	Plural
snuddande	None
förete	None
attesterades	None
orienterats	None
perenn	Singular
landgången	Singular
medlas	None
diarieförts	None
morfemens	Plural
tjatig	Singular
dogmatiker	Singular
hänsynen	Singular
dikterande	None
hemelektroniks	Singular
överbryggar	None
flate	Singular
utlösas	None
teleporterad	None
utväljas	None
motsägelserna	Plural
kokbok	Singular
konungarikets	Singular
mambo	Singular
ångerfulla	Plural
läroverkens	Plural
biobränsle	Singular
nudda	None
dromedar	Singular
högsäsong	Singular
tvilling	Singular
vilda	Plural
semikolonens	Plural
alaninet	Singular
tändstickas	Singular
ambassadörens	Singular
kopierats	None
befrielse	Singular
interferera	None
metern	Singular
förordningar	Plural
överdrev	None
blödiga	Plural
radera	None
mö	Singular
pianisterna	Plural
alfabetiseringen	Singular
lyror	Plural
aktiva	Plural
häktas	None
generaldirektörens	Singular
ledarskapet	Singular
subtile	Singular
frimuraren	Singular
stickmyggor	Plural
sända	None
banjos	Singular
väderlekor	Plural
enslinjen	Singular
hällkistorna	Plural
försvarsmakterna	Plural
knapptelefonernas	Plural
konfrontera	None
vänsterkidets	Singular
motsvarat	None
ergonomi	Singular
karolinen	Singular
supermakter	Plural
falbjuden	None
celldelningen	Singular
räkningen	Singular
spås	None
coverbanden	Plural
attraktiva	Plural
suttit	None
pragmatisk	Singular
flasköppnarna	Plural
motsägas	None
bevarandes	Singular
studsade	None
koffert	Singular
utterns	Singular
funktors	Singular
billigt	Singular
brukat	Singular
infordrats	None
gäliske	Singular
tänkas	None
els	Singular
tjurens	Singular
öglor	Plural
kontrollfältet	Singular
davnades	None
reklamerats	None
renhållning	Singular
nordisk	Singular
folkskola	Singular
flykthastigheters	Plural
vitet	Singular
tågfärjorna	Plural
tredjeland	Singular
tågande	None
stjärtfenors	Plural
countryn	Singular
infiltrerat	None
stället	Singular
utvärderar	None
kläcktes	None
gladiatorerna	Plural
fattigt	Singular
specialiseras	None
slutna	Plural
japanskan	Singular
dogmerna	Plural
prövat	None
arbetskamrater	Plural
irländska	Singular
folkstyret	Singular
odlar	None
kopplen	Plural
iriskans	Singular
ordförandens	Singular
kapitulerar	None
hangaren	Singular
extremiteterna	Plural
förgätmigejerna	Plural
dalad	None
åkrarna	Plural
hypotesen	Singular
gudfar	Singular
falske	Singular
åtföljande	None
konsulterats	None
belägen	Singular
korsfästning	Singular
pyjamasen	Singular
samhällsvetenskap	Singular
stövlarna	Plural
etablissemangen	Plural
centrifuger	Plural
redogjordes	None
nödvändige	Singular
socialförsäkringen	Singular
störmarginalen	Singular
terrorister	Plural
nässlan	Singular
delsträckas	Singular
farao	Singular
stenade	None
historikerna	Plural
diabild	Singular
tiokronors	Plural
jättarna	Plural
bearbetningen	Singular
säkerställande	None
anföraren	Singular
gillat	None
girar	None
barnbörds	Singular
urspårning	Singular
para	None
rättmätigt	Singular
svävat	None
tung	Singular
ritande	None
rånar	None
ersätt	None
maskerats	None
entreprenörers	Plural
filformaten	Plural
gärdesgård	Singular
snart	Singular
funktionslistorna	Plural
kommunister	Plural
ansiktsuttrycket	Singular
variation	Singular
deltävlingens	Singular
telefoni	Singular
elchockerna	Plural
lies	Singular
livsstil	Singular
rappa	None
rättfärdigt	Singular
meteorerna	Plural
baserar	None
indrev	None
bankkonton	Plural
näktergalen	Singular
transformatorer	Plural
medförande	None
sympatiserat	None
clowner	Plural
indianskt	Singular
försäljas	None
ärvs	None
normaliserats	None
kvartsfinalist	Singular
faktaruta	Singular
eftersträvat	Singular
formellists	Singular
förstört	None
integral	Singular
svågern	Singular
tunnelbanestation	Singular
myriader	Plural
immigrerade	None
infernon	Plural
arbetskamraters	Plural
undervisad	None
behöver	None
isolator	Singular
citerad	Singular
definitionsmängdernas	Plural
bovs	Singular
sup	Singular
riksåklagarens	Singular
offentliggjorde	None
musköt	Singular
engiftenas	Plural
milisen	Singular
desinficeras	None
stolpes	Singular
adoptiv	Singular
rökte	Singular
kulturmiljövård	Singular
tyngdkraften	Singular
utsändande	None
somalierna	Plural
falsarier	Plural
kört	Singular
läpparnas	Plural
hyaline	Singular
fräckhet	Singular
stegens	Singular
kortleken	Singular
uppslagsordets	Singular
älskar	None
mimade	None
kvantifierade	None
fallen	Singular
granaterna	Plural
anemi	Singular
presskonferensen	Singular
växten	Singular
vicepresidents	Singular
likformighet	Singular
slovakiske	Singular
tillkommer	None
fruktsockers	Singular
roddarens	Singular
anstalter	Plural
kommendörens	Singular
momsens	Singular
varmkorv	Singular
synsätten	Plural
kutens	Singular
orörligt	Singular
lämnades	None
dekorerar	None
psalmer	Plural
hämmar	None
skilling	Singular
kollisionerna	Plural
kombinationsfältet	Singular
matlagningens	Singular
flyttfåglarnas	Plural
hajen	Singular
ekolali	Singular
synkroniserad	None
mysteriers	Plural
kubisk	Singular
barbaren	Singular
dvärgstjärnan	Singular
kylen	Singular
vindrutor	Plural
uteliggarna	Plural
snabelns	Singular
insektens	Singular
postkodens	Singular
fikusar	Plural
inställ	None
absidens	Singular
putiniseringens	Singular
dämpad	Singular
uppmanade	None
evige	Singular
stralat	None
utför	None
morfism	Singular
seglat	None
ortodox	Singular
tångens	Singular
lussekatt	Singular
tävlar	None
näsborren	Singular
blodpudding	Singular
tävlande	None
bedömande	None
ondskan	Singular
förfaller	None
alfanumerisk	Singular
utbildningsplan	Singular
andremannen	Singular
kungsörnar	Plural
föreställde	None
begynnelsebokstav	Singular
fraserna	Plural
bijektioner	Plural
jakats	None
helium	Singular
tummen	Singular
stöttes	None
skruvad	None
anländer	None
vinröd	Singular
konserverades	None
feerna	Plural
yttrandefrihetsgrundlagen	Singular
tålmodige	Singular
anarkisten	Singular
formaterat	Singular
prislistor	Plural
utbildad	None
hierarkin	Singular
lärosätena	Plural
nyttjades	None
utvandrat	None
tvillingar	Plural
träkyrkors	Plural
raljerar	None
gravera	None
brottar	None
tryggar	None
bakteriernas	Plural
begärande	None
anförtrotts	None
mila	Singular
spekulerade	None
eventuell	Singular
läsbarhet	Singular
dressyrernas	Plural
införts	None
shah	Singular
spingarens	Singular
spaltbredds	Singular
höjande	None
räknings	Singular
värdshusets	Singular
löjtnanten	Singular
palladiums	Singular
hänseenden	Plural
tillgodogjord	None
förslog	None
kontextuella	Plural
missionerar	None
passusen	Singular
utmanas	None
replikerade	None
metafor	Singular
ägiljetter	Plural
träl	Singular
förutsäga	None
låt	None
delbetänkande	Singular
enhetspartiet	Singular
pornografiskt	Singular
medförd	None
kamerans	Singular
råttan	Singular
späd	Singular
krympande	None
bunke	Singular
skymningens	Singular
ansatsens	Singular
hägrarna	Plural
animera	None
kaffekoppar	Plural
kaffebönor	Plural
stavningarna	Plural
roar	None
låtas	None
burgne	Singular
dräpa	None
amning	Singular
plankorsningarnas	Plural
böjt	Singular
predikar	None
kräftan	Singular
undvikits	None
gränderna	Plural
akademin	Singular
kronologiernas	Plural
efterträder	None
preliminära	Plural
analoga	Plural
världsmästaren	Singular
böjligt	Singular
alligators	Singular
polackerna	Plural
regeringsförklaring	Singular
användes	None
beskådat	None
sköldpaddorna	Plural
oberäknelig	Singular
trastar	Plural
smaklig	Singular
säkerhetspolisens	Singular
finländsk	Singular
ätbart	Singular
revisionssekreteraren	Singular
försämringarna	Plural
utbildningsnivåns	Singular
praktiserades	None
tömde	None
nödiga	Plural
multiplicerad	None
herdar	Plural
kvävt	None
konstarterna	Plural
omvärdera	None
synagogföreståndaren	Singular
träffen	Singular
förkämpar	Plural
dogmatiskt	Singular
plasttallriks	Singular
neon	Singular
gräsmånaden	Singular
infart	Singular
adressbok	Singular
mjukaste	Singular
liknelse	Singular
begravningsplatsens	Singular
stormakten	Singular
ansökande	None
sågverken	Plural
sköldkörteln	Singular
nomineras	None
cylinderhattars	Plural
matarens	Singular
bordlade	None
determinant	Singular
avsättningar	Plural
unisont	Singular
solfångarens	Singular
härligt	Singular
skötena	Plural
olivfärgad	Singular
genitivs	Singular
kork	Singular
gungstolarnas	Plural
opponerade	None
fornfranska	Singular
agronomer	Plural
festat	None
drakkulans	Singular
förvaltningsmyndighet	Singular
slitaget	Singular
pappersknivars	Plural
sedens	Singular
värnpliktskonferenserna	Plural
wikis	Singular
fördelade	None
taxi	Singular
ryssjan	Singular
illustrerats	None
vakansen	Singular
ordklassers	Plural
antimateria	Singular
blecket	Singular
borstes	Singular
hallåas	Singular
grannskap	Singular
förkylning	Singular
stressad	None
currys	Singular
isvägar	Plural
oden	Plural
altruisten	Singular
upphovsrätt	Singular
härligheternas	Plural
genmanipulation	Singular
borgaren	Singular
stökiometri	Singular
häftigt	Singular
prostar	Plural
broschen	Singular
tjugoandradelar	Plural
engelskan	Singular
slangbella	Singular
armenisk	Singular
brandgula	Plural
fittig	Singular
ifrågasätter	None
urinröret	Singular
historiker	Plural
ordning	Singular
misstänker	None
oönskad	Singular
dämpats	None
spadarnas	Plural
återställt	Singular
kromet	Singular
förbränningsmotorn	Singular
törstade	None
smalaste	Singular
intervjuar	None
sjukaste	Singular
släkttavlas	Singular
flygvapnens	Plural
kategorisera	None
teckenstorleken	Singular
hovrätten	Singular
gnällande	None
sistnämnde	Singular
slevades	None
lopporna	Plural
räds	Singular
topplistor	Plural
pur	Singular
klarskinnets	Singular
halogenalkan	Singular
råda	None
bisonoxars	Plural
asgarvar	None
persiska	Singular
dödliga	Plural
geoteknik	Singular
kompletterar	None
fördelades	None
accelerationen	Singular
utställde	None
X-kromosomen	Singular
referensen	Singular
primärkälla	Singular
anständiga	Plural
rådhusrätt	Singular
pensionerats	None
ulvar	Plural
arvedel	Singular
mordbrands	Singular
guvernörs	Singular
slevade	None
linjekartans	Singular
krympte	None
asylen	Singular
vicekonsul	Singular
livstids	Singular
skotskt	Singular
assistera	None
sötande	None
kvalde	None
okända	Plural
pandemiska	Plural
blyertspennor	Plural
systemkameror	Plural
dagsverser	Plural
urna	Singular
växellådan	Singular
saklighet	Singular
konverserar	None
avskrivet	Singular
diplomen	Plural
speldosor	Plural
servrar	Plural
attraherar	None
allu	Singular
projekterar	None
koncentrationslägrens	Plural
fjäderns	Singular
mättat	Singular
föraktfull	Singular
gotlännings	Singular
generationers	Plural
snäckans	Singular
nyfiket	Singular
blodtrycket	Singular
överbryggas	None
returneras	None
vegetations	Singular
chilenska	Singular
spisoffrens	Plural
tilltalsnamnen	Plural
beväpnat	Singular
monarkerna	Plural
stampat	None
förkunnat	None
chinchillas	Singular
rannsakades	None
hoppades	None
evangelisten	Singular
bekämpning	Singular
prästgårdars	Plural
mimar	None
kolonnen	Singular
oberoendets	Singular
pilgrimer	Plural
vansinnet	Singular
grinden	Singular
förakts	Singular
faraon	Singular
dynors	Plural
dyrkas	None
proffsligan	Singular
säkerhetständstickor	Plural
avlägsnaste	Singular
fermentera	None
missbruks	Singular
antikvarien	Singular
sansa	None
konstrueras	None
ledamots	Singular
prinsessa	Singular
utforskarens	Singular
varulvarnas	Plural
rostad	None
gurkskivan	Singular
förutsätt	None
bojkotta	None
förtydligat	None
avvisades	None
grundämnets	Singular
ensemblerna	Plural
gränsvärdets	Singular
uppfylld	None
plagieras	None
bordsduken	Singular
uppdateras	None
exfru	Singular
duktige	Singular
joggar	None
länder	Plural
verbs	Singular
modifierade	None
enfaldiga	Plural
spottkörtelns	Singular
riksmarskalkarnas	Plural
cymbalerna	Plural
amalgam	Singular
emulerats	None
tingsrätts	Singular
cirrosens	Singular
dansarnas	Plural
tebjudningen	Singular
upphävd	None
socialdemokraters	Plural
svarvad	None
parametrar	Plural
himlakropp	Singular
märkts	None
tillåten	None
pandeiro	Singular
aktivist	Singular
samarbetena	Plural
killa	None
teleporterande	None
ovanan	Singular
femtiondelens	Singular
fortsätts	None
sökmotorernas	Plural
ombudsmannen	Singular
tröstats	None
gendriver	None
djurpark	Singular
teism	Singular
ruinerades	None
gränsvärden	Plural
spåras	None
samfundet	Singular
slaktat	None
affärsresors	Plural
blattarnas	Plural
urgammal	Singular
reformerande	None
insexnycklarna	Plural
försvarsstyrkor	Plural
termistorer	Plural
teven	Singular
skrivne	Singular
skämtsamt	Singular
muraren	Singular
vurmar	None
kalven	Singular
pornografi	Singular
exponentialfunktionen	Singular
kroppsvätskorna	Plural
uppmärksammad	None
spetsiga	Plural
förbundne	Singular
misskrediterats	None
antropologen	Singular
grotta	Singular
neutronstjärnan	Singular
plasterna	Plural
cediljerna	Plural
utvecklas	None
kapitaliserat	None
besuttit	None
uppgående	None
dräpande	None
tveksamheter	Plural
talespersoner	Plural
glaselektriciteten	Singular
tappades	None
generalöverstar	Plural
överraska	None
tvivla	None
teknetium	Singular
eposets	Singular
lyckta	Plural
limpa	Singular
antikommutativitets	Singular
kristadelfianer	Plural
arbetats	None
vidgas	None
glassbil	Singular
återförsäkrande	None
mellanrummet	Singular
koncessionen	Singular
reviderar	None
regionkommitté	Singular
undergrävs	None
beduinerna	Plural
hissats	None
ordstävets	Singular
framträdd	None
haj	Singular
rationaliserade	None
lida	None
besynnerlig	Singular
debatterad	Singular
road	Singular
cyniskt	Singular
begränsa	None
muntligt	Singular
befaller	None
bergochdalbana	Singular
avstående	None
rättsskola	Singular
samtidige	Singular
rollatorn	Singular
regionens	Singular
helsvenska	Plural
linjärkombinationers	Plural
cylinderhatten	Singular
sker	None
förkroppsliga	None
allegoriske	Singular
överlämnas	None
idrottsarenan	Singular
förankringen	Singular
nykter	Singular
tomtars	Plural
aktualiserad	Singular
trädstam	Singular
identifierat	Singular
blöt	Singular
klistra	None
vandrarhem	Singular
licentiaten	Singular
strö	None
akalkyli	Singular
avhölls	None
öringen	Singular
omgivningen	Singular
puttade	None
låts	None
konvojer	Plural
associera	None
dokumentförstöraren	Singular
asymmetriskt	Singular
insatsstyrkor	Plural
gnagande	None
färgbilders	Plural
väven	Singular
aktivisternas	Plural
hyperbolisk	Singular
småspovens	Singular
kombinationerna	Plural
fenylalaninets	Singular
pantrarnas	Plural
norrmän	Plural
ekorrens	Singular
oljekällorna	Plural
förleder	None
hammaren	Singular
ljuskronorna	Plural
inkastet	Singular
noterar	None
telegan	Singular
sik	Singular
burkas	Singular
riddarna	Plural
disk	Singular
kickar	None
trygghet	Singular
runsvenskans	Singular
fororna	Plural
förhålla	None
ursinnig	Singular
avledningarna	Plural
misshandlar	None
överdriven	Singular
integrationsministern	Singular
fokkat	None
kammarrätten	Singular
avbilda	None
bov	Singular
gagnar	None
certifikaten	Plural
sökte	Singular
svärfadern	Singular
undertecknades	None
curare	Singular
hållplatsen	Singular
tillägnad	None
ljuskrona	Singular
approximeras	None
vald	Singular
padda	Singular
legeringarna	Plural
kusk	Singular
utvecklar	None
kvasarers	Plural
insjukna	None
dubblerat	Singular
förvägrat	None
besöktes	None
dröja	None
rökrutan	Singular
cyniska	Plural
valkretsens	Singular
tillträder	None
rättfärdigheten	Singular
kontrings	Singular
matad	None
göl	Singular
ficktjuv	Singular
halsar	None
kasernen	Singular
anglicismerna	Plural
försona	None
utlösningarnas	Plural
årtiondets	Singular
rebell	Singular
miljonärer	Plural
flyglinjes	Singular
dominikanernas	Plural
utsträcks	None
knivskurits	None
jordgubbsjuicer	Plural
begynnelser	Plural
nämnde	None
disken	Singular
geolog	Singular
övertid	Singular
longituden	Singular
hamburgaren	Singular
singellistorna	Plural
gåendes	Singular
etapp	Singular
valp	Singular
licensierar	None
manifesterad	None
georgiskans	Singular
applåderande	None
svävade	None
tillträdde	None
rosfebers	Singular
mandarinen	Singular
arbetskraftens	Singular
sovsäckar	Plural
debatterande	None
utarbetande	None
försålts	None
utspelats	None
granskar	None
huvudsaken	Singular
kabinettets	Singular
abskissorna	Plural
nunnorna	Plural
spaltad	None
sockenkyrkan	Singular
spränga	None
stjärtfenor	Plural
individualiserar	None
urinens	Singular
bromsen	Singular
avancerat	Singular
vattenrutschbana	Singular
skator	Plural
bluffar	Plural
saltsyran	Singular
stiftad	None
tynger	None
krokodil	Singular
felaktigheter	Plural
dubbelt	Singular
varmt	Singular
krämen	Singular
koalitionsregerings	Singular
sprängs	None
angelägna	Plural
sekretessens	Singular
ackjor	Plural
bjuden	Singular
beställnings	Singular
formlerna	Plural
utformar	None
träkyrka	Singular
gitarristen	Singular
ubåten	Singular
antisemit	Singular
hårdnade	None
vibrera	None
förgången	None
tätorternas	Plural
jaks	Singular
enhetsvektor	Singular
borttagen	Singular
blödningen	Singular
nåldyna	Singular
odes	Singular
utrustas	None
noaorden	Plural
honblommorna	Plural
tjuvlyssnar	None
neutronstjärnas	Singular
prövar	None
mildaste	Singular
ellipsoids	Singular
återhämtar	None
butikskedjan	Singular
differentiell	Singular
bröstfenan	Singular
vd	Singular
förmörkelse	Singular
bakgrundsfärger	Plural
observerades	None
barmhärtighet	Singular
skohornet	Singular
blankande	None
regisserade	None
tillåtits	None
kastanj	Singular
clownerna	Plural
privatbana	Singular
papegojan	Singular
rekryterades	None
elegin	Singular
amöbor	Plural
jäst	Singular
attityd	Singular
laptoparnas	Plural
analfabetismen	Singular
brädspelet	Singular
statsmannens	Singular
sidbrytningar	Plural
järnmalm	Singular
personligheten	Singular
slaktades	None
professionella	Plural
makrona	Plural
populariserats	None
karpar	Plural
fän	Plural
backa	None
roderytor	Plural
grekiskan	Singular
baljan	Singular
haverera	None
tangenterna	Plural
tiokrona	Singular
offentlighets	Singular
världsmakt	Singular
nattskärras	Singular
malströmmen	Singular
halverar	None
tystaste	Singular
fruktas	None
antisemitism	Singular
journalistik	Singular
kansliet	Singular
avböjande	None
rustade	None
glaciärernas	Plural
anrätta	None
skyhögt	Singular
fästingarnas	Plural
farmakolog	Singular
befolkningstätheten	Singular
underminera	None
golfklubbarna	Plural
encyklopedi	Singular
månatligt	Singular
nominerar	None
stambanorna	Plural
spionerar	None
kvick	Singular
kosmologen	Singular
unionsrätt	Singular
samvetet	Singular
oundviklighets	Singular
elektromagneten	Singular
sparken	Singular
ankister	Plural
reklamation	Singular
tillträde	Singular
befunnits	None
brottades	None
miljöfrågorna	Plural
kulturarv	Singular
botar	None
operatörernas	Plural
fontäner	Plural
seaborgiumets	Singular
tändsticksask	Singular
sekunderades	None
färöiska	Singular
fine	Singular
avannonserades	None
rasta	None
botanikens	Singular
anlagde	Singular
beståndet	Singular
nebulosans	Singular
beslog	None
barnombudsman	Singular
bulevarden	Singular
odjuret	Singular
kunskapareen	Singular
deporterats	None
fritiden	Singular
sandpappren	Plural
hyttens	Singular
abonnenterna	Plural
tillåt	None
sök	None
mobiltelefonernas	Plural
solnedgången	Singular
kulturbudgeten	Singular
vrida	None
betapartiklar	Plural
lekkamrater	Plural
osynlige	Singular
inkorporerades	None
anordnande	None
riksförbundets	Singular
programmet	Singular
elfiolernas	Plural
kartläggningar	Plural
kraftverken	Plural
projicerar	None
säkerställas	None
missuppfattad	Singular
sparkas	None
ostkaka	Singular
nazist	Singular
bränd	Singular
återstå	None
argentinska	Singular
ovanor	Plural
blogga	None
cannelloni	Singular
barnvagnar	Plural
postades	None
betraktas	None
amöbors	Plural
snygge	Singular
obetalbart	Singular
betjänad	Singular
fokuserades	None
karaktäriserade	None
fastigheternas	Plural
gelés	Singular
njuten	None
gummisnoddarnas	Plural
diskades	None
dagtingar	None
repetitions	Singular
ögonvittnen	Plural
neger	Singular
intresserande	None
behållne	Singular
medfödda	Plural
barnsoldaters	Plural
lagar	None
regeringsrådet	Singular
entreprenaden	Singular
vägledde	None
derivaten	Plural
handelsvarorna	Plural
kulturminister	Singular
långsam	Singular
recensionen	Singular
riskerar	None
tryckfrihetsförordning	Singular
hörsägnernas	Plural
stimmen	Plural
självbindaren	Singular
sekunderad	None
diamagnetiskt	Singular
förfogat	None
skäggbiffens	Singular
ramade	None
karaktäriserades	None
coachen	Singular
löjet	Singular
avkommor	Plural
förmedling	Singular
byttan	Singular
kvittade	None
tänkbar	Singular
lemurer	Plural
fjärtarna	Plural
instituten	Plural
arabs	Singular
idrottsledaren	Singular
hållbaraste	Singular
försänks	None
avskrivas	None
raderingarna	Plural
rockaders	Plural
verksamhetsområdets	Singular
akvedukternas	Plural
trygghetens	Singular
vårdkasars	Plural
flickväns	Singular
föreskrivs	None
orientalist	Singular
rättvisans	Singular
abscessen	Singular
avbilder	Plural
remsorna	Plural
kryptans	Singular
kånka	None
handledningen	Singular
dirigera	None
engelske	Singular
veteranen	Singular
knacka	None
fräses	None
oxiderar	None
rymma	None
uthärdande	None
vänsterhänta	Plural
aktiverats	None
svuren	None
stämplats	None
ljuskälla	Singular
utrustats	None
rym	None
lugnas	None
sanktionen	Singular
infoga	None
anslutas	None
avgått	None
huvudfrågan	Singular
aktiniums	Singular
dalades	None
fostermodern	Singular
beskrivs	None
myckna	Plural
bläckfiskar	Plural
etylacetat	Singular
ruttna	None
artondedelens	Singular
avlägsnat	Singular
solande	None
tolkas	None
hemlandets	Singular
diplomet	Singular
konjugation	Singular
kväv	None
svartsjuk	Singular
pressekreteraren	Singular
distributioners	Plural
sökvägen	Singular
livslängd	Singular
ankare	Singular
postrar	Plural
flöjterna	Plural
videon	Singular
tröttnar	None
datavetenskap	Singular
miliser	Plural
atombombas	None
kommunisterna	Plural
mysterierna	Plural
tallkottens	Singular
trumhinnor	Plural
blanke	Singular
gnistrande	None
arbetsmarknadsministern	Singular
knopparna	Plural
uppställande	None
tillägnande	None
omoraliskt	Singular
inträffad	None
indiansk	Singular
sysselsättningen	Singular
kuben	Singular
adresserad	Singular
atombomberna	Plural
datamaskinens	Singular
krullparentesernas	Plural
vigg	Singular
idrottsarenor	Plural
skjutfältet	Singular
doktrinen	Singular
slutne	Singular
misskrediterat	None
avslutande	None
bålgeting	Singular
millimeters	Singular
gissat	None
synagogorna	Plural
skyldrande	None
påbjuder	None
försagt	None
ateism	Singular
gerillorna	Plural
flodhästs	Singular
almanackor	Plural
civilingenjör	Singular
violinisten	Singular
sprängladdningar	Plural
producerades	None
exploderar	None
alkemiske	Singular
lindat	None
bakhållen	Plural
medelvärdet	Singular
cyklobutan	Singular
realiserad	None
vidga	None
petarderna	Plural
etymologin	Singular
rädda	Plural
eket	Singular
tyglat	None
finansråden	Plural
överförd	Singular
förmedlades	None
tioörings	Singular
patrullerades	None
förenad	Singular
posterns	Singular
huvudgatornas	Plural
världsmästarna	Plural
ofarliga	Plural
ekonomerna	Plural
intelligensens	Singular
strukturerades	None
kapad	None
fallskärmshopparen	Singular
barnstorlekens	Singular
japans	Singular
kvädet	Singular
kollektivavtalens	Plural
midjorna	Plural
gillad	None
egenrum	Singular
avhålls	None
assistenten	Singular
antropologi	Singular
tuktade	None
cirkusdirektörers	Plural
kondensera	None
kryptologi	Singular
finter	Plural
överlevnaden	Singular
favoriserande	None
cabriolet	Singular
skyll	None
lagstiftningar	Plural
lussekatternas	Plural
kexen	Plural
lårbenet	Singular
kusken	Singular
droppar	None
lilltån	Singular
listige	Singular
placering	Singular
tenderade	None
sökmotorn	Singular
historik	Singular
tjugotredjedelen	Singular
avtalad	Singular
övergången	None
medmänniskors	Plural
präglade	None
bokar	None
nederländskors	Plural
munkarna	Plural
styvfadern	Singular
utarmade	None
beskriven	Singular
dispyter	Plural
utvärderingar	Plural
vänsterpartiernas	Plural
vaktad	None
introducera	None
bombarderats	None
grodans	Singular
gudinnors	Plural
dunkarna	Plural
suggas	Singular
monoteism	Singular
hed	Singular
torterat	None
lektor	Singular
ovanligt	Singular
avleds	None
asiatiske	Singular
samordnad	Singular
vävde	Singular
seglaren	Singular
befogenhet	Singular
bokstavskod	Singular
gondol	Singular
accenterna	Plural
fruktat	None
hyttor	Plural
tystnar	None
hångla	None
bosatte	Singular
replikerades	None
oktaedrars	Plural
sydafrikanskor	Plural
smederna	Plural
kompassers	Plural
jämnar	None
motionen	Singular
dirigerades	None
flyttat	Singular
gymnasieskolor	Plural
tillökning	Singular
beredd	Singular
zoologer	Plural
företrätts	None
vänsterkidet	Singular
skämmas	None
stockens	Singular
förbättringars	Plural
huvudfrågors	Plural
ena	None
kruciverbismens	Singular
ingångna	Plural
omdanat	None
täppte	None
egenvärdenas	Plural
skyttegrav	Singular
vissa	Plural
omfattat	None
papp	Singular
dåres	Singular
glassbils	Singular
godkänna	None
ovanans	Singular
överstökad	Singular
örtagård	Singular
fickparkerats	None
igels	Singular
matcherna	Plural
gnagt	None
brevlådors	Plural
zoologiska	Plural
frihetskämparna	Plural
syddes	None
industrielle	Singular
klaff	Singular
dyrk	Singular
entreprenör	Singular
transformatorers	Plural
försäkra	None
kontraktsprosten	Singular
infekterat	None
käkas	None
kryssprodukts	Singular
jobbet	Singular
gammal	Singular
teckensnittet	Singular
förnimmas	None
argentinskans	Singular
stimulerats	None
dammlucka	Singular
topologiske	Singular
bakgrundsmusiken	Singular
kommunicerats	None
spanjorskan	Singular
härligheten	Singular
räderna	Plural
finansutskottets	Singular
koppargruvorna	Plural
lägligt	Singular
imperier	Plural
skruten	None
absurditet	Singular
tände	Singular
odödliga	Plural
vilseleddes	None
karmosinröd	Singular
gärdet	Singular
kyrkklockornas	Plural
förvägrats	None
svastikans	Singular
amalgamet	Singular
transmissionen	Singular
kompletta	Plural
teologer	Plural
framtidsforskaren	Singular
flygledaren	Singular
medeltidslatin	Singular
nyckeln	Singular
veckotidningen	Singular
editerades	None
Laplacetransformen	Singular
grundsatsers	Plural
landarna	Plural
förstatliga	None
sock	Singular
dölja	None
socialministern	Singular
tatueringar	Plural
passerats	None
linsen	Singular
fackliga	Plural
höljande	None
ficktjuvens	Singular
mods	Singular
köpingen	Singular
kompassen	Singular
planande	None
våldsamme	Singular
handdukar	Plural
specialistsjuksköterska	Singular
vildsvinet	Singular
sammet	Singular
portföljer	Plural
myrans	Singular
generalisera	None
dalsänkan	Singular
västlig	Singular
bortses	None
lånats	None
världsdelens	Singular
uppdaterat	Singular
preciseras	None
fattades	None
föreskriver	None
rödvin	Singular
flagellerats	None
tänks	None
hyperboliskt	Singular
fredsrörelsen	Singular
skruv	Singular
saka	None
spekuleras	None
slike	Singular
polaren	Singular
stridsfrågornas	Plural
textblockens	Plural
duktigaste	Singular
stump	Singular
betecknar	None
tältade	None
ögonhålan	Singular
oxes	Singular
beviljad	None
bumeranger	Plural
rättvis	Singular
versal	Singular
legaliserades	None
solnedgångens	Singular
kulturell	Singular
eurons	Singular
elsäkerhet	Singular
krypta	Singular
skottats	None
förnummen	None
tanzanierna	Plural
snöboll	Singular
skoja	None
alfanumeriska	Plural
ingås	None
legget	Singular
framfusig	Singular
vinylutgåvorna	Plural
opinionssiffrorna	Plural
syllogismer	Plural
spädbarnets	Singular
uttalande	Singular
ungdomsorganisationer	Plural
generaliserad	None
illustrerades	None
uppgång	Singular
arbeta	None
kvittats	None
domherrars	Plural
tryckarnas	Plural
sveks	None
görs	None
chefsåklagarna	Plural
pragmatiskt	Singular
mystiken	Singular
gapar	None
lärjungarnas	Plural
gångbanor	Plural
slutspelet	Singular
darra	None
fattat	Singular
jobbade	None
lagrande	None
staffli	Singular
verkande	None
partiledarna	Plural
hingstar	Plural
kategoriserar	None
stiwardshepets	None
nationell	Singular
skymtas	None
sötsaker	Plural
bekännande	None
meningslöst	Singular
ättlingarna	Plural
försämringen	Singular
termometern	Singular
samlar	None
salskrakes	Singular
stressas	None
involverar	None
utmanövrerad	None
vingen	Singular
amnestin	Singular
orientalisten	Singular
askkopp	Singular
externt	Singular
exponerades	None
ämbeten	Plural
himlakroppar	Plural
kobra	Singular
spirituell	Singular
guvernörerna	Plural
besegrats	None
maningar	Plural
elpiano	Singular
komponera	None
krigsskådeplatsers	Plural
värderad	Singular
officiellt	Singular
rotes	Singular
lineär	Singular
ekvilibristens	Singular
vårdcentralerna	Plural
befolkningstäthetens	Singular
spelar	None
lysts	None
rättande	None
annullerande	None
protokollen	Plural
öken	Plural
valsedelns	Singular
däcksstolarna	Plural
civilsamhälle	Singular
fördröjs	None
listigt	Singular
hällkistan	Singular
frasera	None
författning	Singular
manchester	Singular
existentiellt	Singular
knullets	Singular
manifestationer	Plural
överföra	None
överskrifts	Singular
inflikad	None
länsledningen	Singular
mitokondrier	Plural
maskinteknisk	Singular
sånglärka	Singular
smyckats	None
avsätter	None
minkar	Plural
agnostikers	Singular
kraftiga	Plural
kronofogden	Singular
kondensatorn	Singular
simbassäng	Singular
globale	Singular
köpingarna	Plural
tvivlens	Plural
implementeras	None
nekad	None
sammanlagd	Singular
prognoser	Plural
föreställande	None
ärlig	Singular
kungamakaren	Singular
golfklubb	Singular
knyta	None
erövras	None
killingarna	Plural
veckotidningar	Plural
naturliga	Plural
invandringens	Singular
dumburkar	Plural
svavelsyra	Singular
föranlett	None
hytter	Plural
jordfärgens	Singular
bloggande	None
gorillan	Singular
ökända	Plural
enkelhetens	Singular
medförde	None
förvägrad	None
anmälande	None
musikhögskolans	Singular
debatterades	None
inkomstkällorna	Plural
gräslöks	Singular
femmor	Plural
älskats	None
satelliternas	Plural
enhetsvektorn	Singular
besvärad	Singular
smedja	Singular
särskilt	Singular
transistorns	Singular
krockar	Plural
styvbror	Singular
sändaren	Singular
rörliga	Plural
recenserat	None
arors	Plural
krigskorrespondenten	Singular
patrullens	Singular
uppkomma	None
jobbande	None
bowlings	Singular
ettstrukne	Singular
gruppera	None
dagstidningarna	Plural
afton	Singular
konfronteras	None
iver	Singular
svartnade	None
tabellers	Plural
ristningarnas	Plural
rengörs	None
tänkarna	Plural
servers	Singular
hävder	Plural
hövdings	Singular
pirats	Singular
sjukvårdaren	Singular
stadsstaters	Plural
bråkat	Singular
fontens	Singular
immigration	Singular
morfemet	Singular
formateringen	Singular
aldehyders	Plural
högskoleenheternas	Plural
lemmanas	Plural
intergalaktiskt	Singular
modifierad	None
betyda	None
kristadelfian	Singular
cellskräcken	Singular
autokratins	Singular
hemlandet	Singular
ljuder	None
centripetalkraft	Singular
stifta	None
kommentarer	Plural
disputerats	None
huserade	None
löpnumren	Plural
studerande	None
snacks	Singular
sondotters	Singular
riggades	None
implementerat	None
synagogan	Singular
förseglas	None
batteriets	Singular
fala	Plural
maskulint	Singular
övervakningskameror	Plural
barkas	None
liberalismen	Singular
absid	Singular
konsumerades	None
sökordet	Singular
politiske	Singular
nystade	None
persika	Singular
fiskets	Singular
varme	Singular
abelska	Plural
reduktionens	Singular
ideologin	Singular
inspirerats	None
örfilen	Singular
uppladdad	Singular
störd	Singular
specialisten	Singular
gårdagen	Singular
domsagan	Singular
ackumulerad	Singular
kandidaters	Plural
församlingskyrkan	Singular
förändrande	None
genomskinliga	Plural
oroa	None
substantivets	Singular
släpades	None
osvensk	Singular
ansedde	Singular
cembalistens	Singular
behövda	Plural
ruineras	None
globaliserat	None
gymnast	Singular
misstänk	None
mungigor	Plural
besiktningarnas	Plural
fatta	Plural
modets	Singular
stockholmaren	Singular
holländskans	Singular
tågfärjan	Singular
olivfärgat	Singular
sladdades	None
metad	None
kubanska	Plural
försöksballonger	Plural
spädbarnet	Singular
sprängladdningarna	Plural
inbördeskriget	Singular
kartografen	Singular
vinklade	None
iranska	Singular
eddans	Singular
protestera	None
tjugoåttondelens	Singular
världsherraväldet	Singular
deister	Plural
normaliserade	None
seminariet	Singular
matchens	Singular
tideräkningens	Singular
ikosaedrar	Plural
kommentar	Singular
pungdjuren	Plural
utövat	None
örlogsskolor	Plural
osannolika	Plural
paranormalt	Singular
kaoset	Singular
maritima	Plural
motsatsförhållandenas	Plural
kommutatorns	Singular
spå	None
avvisande	None
regionale	Singular
borde	None
gemensamma	Plural
omhändertaganden	Plural
anglicismens	Singular
donat	None
alkoholmissbruk	Singular
arbetsenheter	Plural
förråd	None
riksledningen	Singular
neutrala	Plural
betalad	Singular
gränsa	None
avleda	None
isolerar	None
raderats	None
begreppsklassers	Plural
transformators	Singular
mallar	Plural
kolmilor	Plural
pelikanen	Singular
överses	None
exekvera	None
äktenskapsförorden	Plural
samuraj	Singular
spillts	None
fluffs	Singular
standardbrevet	Singular
ungrarna	Plural
imponerande	None
förtydligats	None
tävla	None
buk	Singular
ukrainske	Singular
manifestationernas	Plural
antiferromagnetiskt	Singular
kånkade	None
visionerna	Plural
bekräftelsernas	Plural
stöta	None
bisonoxarna	Plural
erbjöds	None
anläggens	Plural
taktisk	Singular
trefoten	Singular
trädgårdsmästarna	Plural
tvättbjörnens	Singular
avsetts	None
verktygslistens	Singular
utvärderad	None
påminnas	None
abbedissor	Plural
anförtro	None
kickat	None
lidit	None
virke	Singular
leksak	Singular
skyddsobjektet	Singular
datamaskinen	Singular
husera	None
opinionsbildarens	Singular
riksbibliotekarie	Singular
urladdningen	Singular
växthusen	Plural
bygget	Singular
institutions	Singular
adagions	Plural
ramlar	None
private	Singular
befordrad	Singular
initiera	None
kvartsfinalerna	Plural
kägelsnittet	Singular
konstmuseets	Singular
knäckts	None
lyckosamt	Singular
prisad	None
neutraliserade	None
bedömningsgrundens	Singular
babian	Singular
utvecklingssamarbetet	Singular
gafflade	None
riksledningens	Singular
intresserades	None
vågad	None
rattens	Singular
karaktäristik	Singular
ansvarsområdena	Plural
statschefens	Singular
variera	None
färgar	None
duckande	None
stigmatiserar	None
rönnen	Singular
saknande	None
manövrerade	None
bordeller	Plural
kittlande	None
riskera	None
invandrade	None
snödroppen	Singular
kritiseras	None
nalles	Singular
osvenska	Plural
tycka	None
förvaltande	None
avlösts	None
ärvd	None
stadskärnornas	Plural
killingar	Plural
rengöra	None
regleras	None
trakasserad	None
vanilj	Singular
flygvapnet	Singular
tveksamheten	Singular
ingressen	Singular
venuspassagen	Singular
överraskar	None
filatelisten	Singular
flikar	Plural
urnordisk	Singular
hajar	Plural
jättestora	Plural
minimal	Singular
analogierna	Plural
klistras	None
applådera	None
kväde	Singular
äppeljuice	Singular
skuldror	Plural
vanka	None
instruerat	None
urnans	Singular
minimera	None
blyge	Singular
kontrahenter	Plural
desinficera	None
rektangel	Singular
medelmåttige	Singular
råttor	Plural
reproducerade	None
reparerad	None
rättstavningskontroll	Singular
kopplades	None
hedersbetygelser	Plural
gondoler	Plural
saboteras	None
brun	Singular
plast	Singular
umgänge	Singular
korniska	Singular
etapper	Plural
pärm	Singular
biläggs	None
finansiera	None
livsstils	Singular
fotbollslaget	Singular
inkorporerats	None
porrstjärnorna	Plural
albaner	Plural
kronofogdes	Singular
friande	None
framhåller	None
jultomte	Singular
besynnerliga	Plural
asteriskerna	Plural
anvisat	Singular
insjuknade	None
serverat	None
protesterande	None
kalenderflickorna	Plural
försörjas	None
appellativiserande	None
hökuggla	Singular
meteors	Singular
barnsoldat	Singular
rävsaxens	Singular
metallurgin	Singular
skarvens	Singular
influerats	None
antikvariatet	Singular
kartlägga	None
topplistors	Plural
anmält	Singular
extrahera	None
konvergerat	None
utformat	None
brytarna	Plural
antisemitismen	Singular
allmänningars	Plural
åtföljt	None
grodorna	Plural
grottornas	Plural
toors	Plural
arbetsledaren	Singular
processerna	Plural
sjövärdig	Singular
karakteristik	Singular
anställs	None
tjuvlyssna	None
publicerande	None
menlösa	Plural
keruber	Plural
otillräckligt	Singular
småplanets	Singular
välling	Singular
flertalet	Singular
girat	None
ingenjörsvetenskapen	Singular
missionera	None
elektricitet	Singular
frodiga	Plural
semlor	Plural
höjt	None
berömda	Plural
sovjetisk	Singular
drifterna	Plural
institutens	Plural
pensionatets	Singular
tvär	Singular
biologiskt	Singular
storleksordningen	Singular
arkeologerna	Plural
dammsögs	None
körd	Singular
blödande	None
sevärdheten	Singular
flödesplan	Singular
stjärtpennornas	Plural
nationalföreningens	Singular
lyster	Singular
orens	Plural
jordreformerna	Plural
filmande	None
mäklad	None
rävsaxarnas	Plural
vinkelparenteser	Plural
komplettera	None
tangentborden	Plural
resocialiserade	None
accelererats	None
ogynnsamma	Plural
romansen	Singular
järnsparvarna	Plural
polyteism	Singular
påsättande	None
bokföra	None
vaskad	None
sfär	Singular
frukosten	Singular
överlevt	None
estniskornas	Plural
förlagor	Plural
gadolinium	Singular
skyldiga	Plural
urklippets	Singular
kaktusar	Plural
önskningar	Plural
hållbara	Plural
diskvalificerad	Singular
användarnas	Plural
låtlistan	Singular
streckande	None
konfiskerad	None
sammansluten	None
gördeln	Singular
bolagiserats	None
kontrafaktisk	Singular
segla	None
väsentliga	Plural
hyn	Singular
bemödar	None
holmium	Singular
jargongen	Singular
hummern	Singular
puddingar	Plural
medlemsstaterna	Plural
analyserad	Singular
trädstammarna	Plural
pråmarna	Plural
audiovisuella	Plural
etablissemanget	Singular
kolonisera	None
innebar	None
bergarternas	Plural
handledens	Singular
postulerande	None
axiomen	Plural
handgranat	Singular
fräsar	Plural
erfaret	Singular
vårpropositionen	Singular
margarinets	Singular
norska	Singular
påvarnas	Plural
förmodad	None
vackert	Singular
läsas	None
torterats	None
projicerades	None
käranden	Singular
hypotenusa	Singular
kongruenta	Plural
frälsnings	Singular
missats	None
stolte	Singular
dåre	Singular
innebörden	Singular
integralkalkylen	Singular
druvan	Singular
häfta	None
vävs	Singular
talmannen	Singular
nappar	Plural
överskridas	None
rena	None
förståelsen	Singular
delresultatets	Singular
flygen	Plural
grannaste	Singular
essentialisternas	Plural
kaffekopp	Singular
knäppa	None
minderårig	Singular
plantorna	Plural
psalmerna	Plural
överskridande	None
lyriska	Plural
vagt	Singular
riktats	None
delirium	Singular
slikt	Singular
barack	Singular
tjatande	None
flygförbudszonen	Singular
arbetslösheten	Singular
inrikesdepartementets	Singular
sport	None
midjan	Singular
trollande	None
trasor	Plural
kvalificerat	Singular
elektroniska	Plural
amorteras	None
märker	None
gafflar	None
subbars	Plural
kattugglans	Singular
ätts	Singular
härdarna	Plural
skottdagar	Plural
utövar	None
köa	None
cembalon	Singular
jama	None
mäta	None
skämtsamma	Plural
mjölnaren	Singular
omvandlande	None
essensen	Singular
byråchef	Singular
seden	Singular
hårde	Singular
utrullningslists	Singular
harmoniserar	None
torpet	Singular
väntat	Singular
infogningarnas	Plural
guvernörer	Plural
potentiell	Singular
utnämnd	None
frihetsgrader	Plural
önskad	Singular
suppleanterna	Plural
folkvisor	Plural
direktiven	Plural
snygg	Singular
nämns	None
antikaffären	Singular
deklarera	None
grävskoporna	Plural
pressas	None
kroppsvätska	Singular
underlättade	None
stadsbiblioteket	Singular
hummer	Singular
morgondag	Singular
trivts	None
oroligt	Singular
röstsiffror	Plural
sångsvanens	Singular
riksdagsdirektör	Singular
lösande	None
drucken	Singular
kontrolleras	None
uteslöt	None
asymptoter	Plural
inbrotten	Plural
server	Singular
missens	Singular
ränderna	Plural
bibel	Singular
ormbunkar	Plural
invaderat	None
erhållna	Plural
cesset	Singular
ersattes	None
hörande	Singular
luftat	None
veta	None
avgränsning	Singular
piltarna	Plural
hingsten	Singular
elektriske	Singular
amöbornas	Plural
sägande	None
svågers	Singular
apostlarnas	Plural
valkyrian	Singular
armeniske	Singular
hamstras	None
spöregnar	None
gastar	Plural
lagningar	Plural
järnsparv	Singular
kämpade	None
ståndarna	Plural
stängda	Plural
stång	Singular
pråmen	Singular
svänga	None
lamt	Singular
korkar	Plural
utvandra	None
italienskans	Singular
pilten	Singular
tjärn	Singular
tumregel	Singular
vänsterkid	Singular
mongoliska	Singular
kulturinstitutionerna	Plural
kurvintegral	Singular
överensstäm	None
överbibliotekarie	Singular
abborrars	Plural
slingorna	Plural
lapas	None
censurs	Singular
realiseringarnas	Plural
spädbarnens	Plural
kröntes	None
myggan	Singular
apati	Singular
bekänt	Singular
ogifte	Singular
semifinaler	Plural
arkiverat	Singular
legeras	None
tröskeln	Singular
tarmen	Singular
isomorfe	Singular
saboterad	None
hysts	None
atomärt	Singular
nebulosa	Singular
ruinerande	None
bostadslånet	Singular
duat	None
lagad	None
bosoner	Plural
svordomen	Singular
sfären	Singular
skymnings	Singular
resistorer	Plural
accepteras	None
begeende	None
fermenterat	Singular
uppnå	None
kvarlevors	Plural
befästa	None
abderitiskt	Singular
kratta	Singular
ho	Singular
beredningen	Singular
prestation	Singular
fälgarna	Plural
farligaste	Singular
samarbeten	Plural
relaterat	None
rödskjortor	Plural
tokiga	Plural
upphandlades	None
accent	Singular
pokalers	Plural
gäsp	Singular
käftar	Plural
välkomnat	Singular
halverade	None
föreskrifter	Plural
sömnlös	Singular
sväng	None
tvistefrågas	Singular
influten	None
approximerande	None
gerillor	Plural
vaktade	None
oktanterna	Plural
inflika	None
påvlig	Singular
riporna	Plural
rödstjärt	Singular
kortlekar	Plural
sjukt	Singular
asymptotens	Singular
undersöks	None
ålderdom	Singular
sallad	Singular
upptäckte	None
politikernas	Plural
buskar	Plural
akademikern	Singular
chassits	Singular
mists	None
kartografisk	Singular
målmängd	Singular
äggröra	Singular
gosedjuren	Plural
absorptionslinjer	Plural
dona	None
länsstyrelsen	Singular
typsnitten	Plural
bromspedalen	Singular
hyvlas	None
plutonens	Singular
klartexten	Singular
fångenskapen	Singular
trädkronorna	Plural
återlämnad	None
blickar	None
undgått	None
mallarnas	Plural
memorerade	None
ystades	None
fixstjärnorna	Plural
töande	None
glöggen	Singular
epiteten	Plural
syntetiserats	None
testikeln	Singular
nödbromsen	Singular
farmarna	Plural
missas	None
bekostar	None
metallurgs	Singular
betonad	Singular
passera	None
smutsen	Singular
bedrövad	Singular
databasen	Singular
enbuskar	Plural
filatelisternas	Plural
andrum	Singular
lågtrycket	Singular
etsningar	Plural
knoparna	Plural
tryggas	None
eponymerna	Plural
filtrerar	None
klyka	Singular
subtraherade	None
dassen	Plural
klorerats	None
anslöts	None
bakterien	Singular
makron	Plural
förordning	Singular
arrenderande	None
utbildningsdepartementen	Plural
westfalisk	Singular
talar	None
bibelns	Singular
påven	Singular
konsuln	Singular
bunden	Singular
vänsterjusterad	None
särskildes	None
patenterades	None
departementschefer	Plural
havre	Singular
åldrad	None
rättschefers	Plural
topplistorna	Plural
kaffekoppen	Singular
brandsoldater	Plural
spektakulär	Singular
stavningskontrollens	Singular
gubbens	Singular
tidigt	Singular
friskolas	Singular
konungadöme	Singular
öknamnet	Singular
papegojorna	Plural
mekaniken	Singular
mutism	Singular
danskans	Singular
klippdassarnas	Plural
korrigerat	None
medeltidskyrkor	Plural
federala	Plural
ättföljden	Singular
kopplat	Singular
dagstidningarnas	Plural
fornkunskap	Singular
samhällsvetenskapen	Singular
hänvisande	None
kväva	None
dill	Singular
jagades	None
stavkyrkans	Singular
trögheten	Singular
stormsvalas	Singular
historielös	Singular
administratörers	Plural
konungarikena	Plural
industriella	Plural
värdelös	Singular
muckat	None
bretonskan	Singular
teologiska	Plural
katedralskolor	Plural
hypotenusan	Singular
katedral	Singular
konkande	None
holländskan	Singular
arbetsmarknadens	Singular
drevet	Singular
breds	None
prognosticerat	None
tjärnen	Singular
trubadurer	Plural
förenklade	None
lyssnande	None
genomgång	Singular
cykliska	Plural
musicerat	None
upplevelser	Plural
gitarristers	Plural
kommenterades	None
förstatligas	None
räknar	None
tåga	None
strimman	Singular
zoologerna	Plural
förvara	None
olidligt	Singular
viskösa	Plural
ursprunglig	Singular
tamp	Singular
oskyldige	Singular
raggades	None
konsulterad	None
levererats	None
stekplåtarna	Plural
fuskande	None
böjlig	Singular
uppmärksamma	Plural
frontalkrock	Singular
facetterar	None
onanerad	None
bakteriers	Plural
adertondelens	Singular
kontringarna	Plural
slöjds	Singular
rubbades	None
kompilerat	None
vädrade	None
ringaren	Singular
konvergerar	None
ansöker	None
utrensning	Singular
surströmming	Singular
stylister	Plural
herravälde	Singular
såpan	Singular
framställer	None
armborsten	Plural
förnimmer	None
adertondedel	Singular
jaka	None
final	Singular
kryckor	Plural
underminerade	None
återstått	None
omvandla	None
tillbringa	None
högerparti	Singular
förfogandens	Plural
adelskap	Singular
undersida	Singular
grundlagarna	Plural
oreda	Singular
rätt	Singular
strategisk	Singular
skämt	Singular
olidliga	Plural
sett	None
programledarnas	Plural
månsken	Singular
orka	None
cowboys	Singular
operativsystemen	Plural
duplicerande	None
repatrierats	None
fördärvas	None
mopsarnas	Plural
algers	Plural
lutheraners	Plural
alléns	Singular
tillgänglig	Singular
kulminerade	None
fackföreningsledaren	Singular
existerar	None
skjuta	None
destillerades	None
mopsen	Singular
kopplet	Singular
ämna	None
förnyaren	Singular
armera	None
möjlige	Singular
nazister	Plural
godsaker	Plural
tideräkning	Singular
nötts	None
läts	None
altruister	Plural
yrkesutbildningar	Plural
hatet	Singular
avhandlats	None
utgivning	Singular
strömming	Singular
bebos	None
lämpligt	Singular
historiskt	Singular
kriteriums	Singular
förhandlas	None
förvalta	None
gnagaren	Singular
anförtrott	None
radiotens	Singular
rejäla	Plural
ändrat	Singular
kontanthantering	Singular
granskat	None
hästkrafters	Plural
terroristgruppen	Singular
hissas	None
underrättad	Singular
lönat	None
mänskliga	Plural
valutaenheten	Singular
knektarna	Plural
uthärda	None
kryckan	Singular
ruinerad	None
fulla	Plural
förestod	None
eggad	None
valinet	Singular
övernattad	None
otåliga	Plural
derivatorna	Plural
uträttade	None
premiera	None
gerillornas	Plural
examensarbete	Singular
kompassens	Singular
dissar	Plural
plastpåses	Singular
isländsk	Singular
stentavlas	Singular
låta	None
häktad	None
fanan	Singular
rovdjurets	Singular
avtalar	None
stadsstater	Plural
befordras	None
uppräkneliga	Plural
bildsidorna	Plural
restaurerats	None
biten	Singular
femtondedelar	Plural
frälsning	Singular
tordön	Singular
mött	None
kompanis	Singular
tibetan	Singular
finansierad	Singular
säkerställdes	None
olikt	Singular
tillkom	None
experimentera	None
cyklade	None
tillämpas	None
grundlagens	Singular
enklaste	Singular
ståndpunkterna	Plural
arbetslös	Singular
ekosystemen	Plural
personlige	Singular
publiceringen	Singular
bommad	Singular
sonsons	Singular
hertiginnor	Plural
dojorna	Plural
altruistiska	Plural
kejsardöme	Singular
specialstyrka	Singular
timman	Singular
ursinnige	Singular
kokade	None
välkomne	Singular
egne	Singular
ryckande	None
iller	Singular
mikrofonerna	Plural
nederbörden	Singular
svor	None
vispgrädde	Singular
landkrabbors	Plural
konsumeras	None
blont	Singular
numrera	None
framställde	None
föranleds	None
ladugårdar	Plural
amorfa	Plural
gratulerande	None
kalkylator	Singular
gulsippa	Singular
ankommit	None
tjuvlyssnat	None
börjades	None
märks	None
fullgjorda	Plural
kännetecknades	None
adjunkt	Singular
täckets	Singular
allmännyttiga	Plural
strykningen	Singular
högskoleverket	Singular
tillgängliggöras	None
brukaren	Singular
anmäla	None
etikettera	None
lit	Singular
emancipationen	Singular
samspela	None
kramat	None
folkbildnings	Singular
regndroppen	Singular
globaliseras	None
beaktar	None
sabbaten	Singular
afrikanskan	Singular
stiwardshepende	None
desillusioneras	None
förman	Singular
teologins	Singular
döljande	None
expanderar	None
påvisande	None
bebott	Singular
förarbetet	Singular
stenas	None
clementinerna	Plural
integrera	None
matvanorna	Plural
kontextuell	Singular
lagrar	None
konstnärligt	Singular
stortå	Singular
gotländska	Singular
brandsoldaten	Singular
landningsbanor	Plural
änkemannen	Singular
kroppskameror	Plural
kolgruvor	Plural
isotoper	Plural
reciterade	None
gränden	Singular
bostadskrediter	Plural
beskuret	Singular
skottes	Singular
ramlade	None
konstaterar	None
kursiverade	None
förordnade	None
rolig	Singular
fastetids	Singular
fästing	Singular
vinterkräksjuka	Singular
fyrfaldigt	Singular
kalkylatorer	Plural
sägnerna	Plural
biografisk	Singular
ackja	Singular
utrustad	Singular
fyrtaktsmotorer	Plural
konsoliderat	None
avsättas	None
skyllas	None
hjässors	Plural
produktionerna	Plural
grävd	None
fakulteternas	Plural
veteran	Singular
imperiets	Singular
effektiva	Plural
arvingar	Plural
sägner	Plural
kolumn	Singular
frisiskors	Plural
monologen	Singular
trävaruindustrin	Singular
rebelliske	Singular
träsket	Singular
elimineras	None
uppmärksammas	None
signalerat	None
borttagningars	Plural
inbegripande	None
avslutar	None
pressmeddelande	Singular
antändes	None
antisymmetrisk	Singular
pajer	Plural
kuststräckan	Singular
utbrustit	None
tänd	Singular
bortser	None
inbrottet	Singular
citadellet	Singular
alfabetiska	Plural
arbetstagarnas	Plural
högskolors	Plural
chansons	Singular
info	Singular
invänt	None
rödräven	Singular
skarvades	None
olikheterna	Plural
alfastrålning	Singular
terapeutens	Singular
överstinnan	Singular
aminosyror	Plural
förankrar	None
os	Singular
gränsflodernas	Plural
formaliseras	None
bakterie	Singular
kramisen	Singular
kartläggs	None
legitimeras	None
behörigheterna	Plural
interaktioner	Plural
bestens	Singular
kompenserande	None
förmögenhetens	Singular
finaler	Plural
centen	Singular
övergångsbestämmelsernas	Plural
valsverket	Singular
vitmenade	None
golfklubba	Singular
förfader	Singular
alkyner	Plural
intäkten	Singular
hasta	None
skylldes	None
vattenmelonen	Singular
uttråkad	None
hästkrafternas	Plural
sprängde	None
humlan	Singular
fjords	Singular
nationalmuseum	Singular
kvantifierar	None
olikheter	Plural
politikern	Singular
kriminaltekniker	Singular
mineral	Singular
egyptiskan	Singular
chefredaktören	Singular
undersidorna	Plural
begrundas	None
ornitologin	Singular
serpentinernas	Plural
kakaduan	Singular
sultanatet	Singular
övermänskligt	Singular
bipolärt	Singular
piltangenterna	Plural
gulsippan	Singular
datas	Singular
beskan	Singular
skriftligt	Singular
befogenheten	Singular
konfigurera	None
aiolins	Singular
attackerande	None
debatteras	None
fastigheterna	Plural
medmänniskorna	Plural
klassat	None
medfördes	None
rullstol	Singular
käck	Singular
lämpas	None
lärosäten	Plural
kraftmaskin	Singular
damask	Singular
ringmärkningens	Singular
nationsflaggan	Singular
lyrors	Plural
gallimatiasen	Singular
tvättmaskin	Singular
copywriters	Singular
hajens	Singular
fryspunkt	Singular
prestationer	Plural
persiskans	Singular
mikrovågsugn	Singular
nervöst	Singular
studsmatta	Singular
rullstolen	Singular
adoption	Singular
stressade	None
designens	Singular
valpa	None
tecknat	None
bajonett	Singular
långfingret	Singular
rektorn	Singular
författningar	Plural
boktryckarkonsten	Singular
födde	Singular
dolkarna	Plural
baskerna	Plural
könskromosomerna	Plural
cyklist	Singular
spräcktes	None
infiltreras	None
spådd	None
doja	Singular
citationstecknens	Plural
adopteras	None
kvävets	Singular
inrättad	None
skenbenen	Plural
promenerar	None
inläggande	None
väcktes	None
trasdocka	Singular
alka	Singular
materiell	Singular
kemiska	Plural
laddades	None
utgrävning	Singular
mast	Singular
äppelpajernas	Plural
nordlig	Singular
byråchefer	Plural
stärk	None
australiskan	Singular
distanserad	Singular
delstatens	Singular
afghanerna	Plural
överskrida	None
tuppen	Singular
våldsam	Singular
lysdioder	Plural
artbestämma	None
invasionsstyrkor	Plural
kommerskollegiet	Singular
vrister	Plural
antikvarier	Plural
klimatologen	Singular
ockuperat	None
tias	Singular
arvinge	Singular
tibetaner	Plural
certifikatet	Singular
europeiskt	Singular
försäljningssiffror	Plural
genomfördes	None
bredande	None
årgångarna	Plural
byfånen	Singular
klyftiga	Plural
aminosyra	Singular
observerats	None
händelsehorisonten	Singular
projektorer	Plural
vitaktiga	Plural
påbjuds	None
regla	None
migrationsministern	Singular
senatorer	Plural
förhindrade	None
drängs	Singular
aftnar	Plural
osade	None
latin	Singular
rysskräck	Singular
förbränningsmotorers	Plural
cellväggarna	Plural
shahs	Singular
vänsterpolitiks	Singular
fåtöljerna	Plural
ödlan	Singular
vadar	None
materiellt	Singular
profetiskt	Singular
arseniktrioxid	Singular
albumet	Singular
språkats	None
skamlös	Singular
vidlyftig	Singular
glasrutor	Plural
allemansrätten	Singular
intervjuats	None
hoppborgar	Plural
suckarna	Plural
avbrutna	Plural
LP-skivor	Plural
lojalitet	Singular
akademisk	Singular
komposteras	None
kunglig	Singular
motsägande	None
messades	None
halverats	None
orangutangen	Singular
inses	None
konstantinopolitanskt	Singular
lyxigt	Singular
belades	None
kissen	Singular
teknokratiernas	Plural
pornografiska	Plural
återhämtning	Singular
granatäpple	Singular
dramat	Singular
liknade	None
testaren	Singular
husfolks	Singular
tunge	Singular
kvasarer	Plural
kulminerar	None
kulturbudgetar	Plural
företagsledaren	Singular
tipeln	Singular
ärliga	Plural
ruvande	None
hägers	Singular
genomförbar	Singular
biologer	Plural
tandvärk	Singular
konfronterades	None
tjecken	Singular
pekskärm	Singular
armeniern	Singular
elektroniskt	Singular
historisk	Singular
instämt	None
ordades	None
beteckningen	Singular
debattera	None
recenserats	None
inferno	Singular
luftstrupens	Singular
upphovsrätten	Singular
ytterörat	Singular
bretts	None
loppor	Plural
obstetrikens	Singular
korkad	None
kaviaren	Singular
ledarsida	Singular
offrad	None
kommutativ	Singular
älskas	None
applicerar	None
uttagningen	Singular
presenningar	Plural
löparbanan	Singular
sponsrings	Singular
rappar	None
homogena	Plural
geopolitik	Singular
födelsedagspresenters	Plural
lärkan	Singular
subventionerat	None
dollarn	Singular
akvedukt	Singular
vindruvorna	Plural
underlättad	None
terrorists	Singular
filmat	Singular
vitlökens	Singular
förskjuter	None
minimala	Plural
klassats	None
lindar	None
mandarin	Singular
ordningsföljden	Singular
korsningens	Singular
lyran	Singular
misstrotts	None
klet	Singular
sextondedelars	Plural
bridge	Singular
ansiktsuttrycken	Plural
statisk	Singular
furan	Singular
dansöserna	Plural
efemära	Plural
redaktionen	Singular
prognoserna	Plural
präktigt	Singular
särbo	Singular
redovisade	None
amulett	Singular
logaritm	Singular
ferromagnetisk	Singular
nyanserat	None
högtyskas	Singular
världsåskådningen	Singular
galges	Singular
servitörernas	Plural
dikes	Singular
sammanfatta	None
målens	Plural
besökts	None
oväntad	Singular
samtidiga	Plural
gagn	Singular
antika	Plural
betalarnas	Plural
kronologiskt	Singular
femtedel	Singular
ikraftträdande	Singular
porer	Plural
teleskopen	Plural
gurkmeja	Singular
syftande	None
ministerium	Singular
njurar	Plural
släppt	None
postmodernism	Singular
oktanternas	Plural
konventionerna	Plural
begynnas	None
befolkningssiffror	Plural
östtyskor	Plural
svanskotor	Plural
skockars	Plural
läska	None
furstes	Singular
affixen	Plural
syrianskas	Singular
argumentationen	Singular
handgranaters	Plural
flygrutterna	Plural
trettiondedels	Singular
svika	None
förtryckte	Singular
voteringen	Singular
millions	Singular
veven	Singular
ursprungskällorna	Plural
tillsatsens	Singular
summerad	None
placeringar	Plural
ritade	None
hövdingarna	Plural
skäms	None
såpoperor	Plural
adelssläkts	Singular
efterlyste	Singular
handelsvaror	Plural
anslutits	None
golfbana	Singular
partikelfysik	Singular
cykloperna	Plural
codan	Singular
puddingen	Singular
kvartsfinal	Singular
vetenskapsakademins	Singular
distribueras	None
tålige	Singular
uven	Singular
deporterad	Singular
normerad	None
axelryckningarnas	Plural
sannolik	Singular
fornhögtyskans	Singular
böjda	Plural
kejsarsnittet	Singular
kaviar	Singular
förvirrande	None
fängelsehålorna	Plural
rapporterande	None
attraherad	Singular
estnisk	Singular
granat	Singular
gafflad	None
kvalifikation	Singular
presenterat	None
säkerhetstjänster	Plural
skalpellers	Plural
kålrot	Singular
negligéer	Plural
frälsningen	Singular
brevlådor	Plural
diskussionssidor	Plural
förkroppsligat	None
förankras	None
manifestationerna	Plural
celldelningar	Plural
besökas	None
ny	Singular
experimenterande	None
positionerade	None
hindars	Plural
kulspruta	Singular
mena	None
ot	Singular
tunnlarna	Plural
tillägnades	None
föredettingars	Plural
diskontinuerlig	Singular
åtfölja	None
placeringen	Singular
regeringsformen	Singular
förgjorts	None
vansinnige	Singular
empatiska	Plural
nedslogs	None
sjået	Singular
skandinavisk	Singular
kvinnliga	Plural
möblerad	None
förbannades	None
utställts	None
bergssidornas	Plural
dubblerar	None
bangade	None
förnya	None
falska	Plural
siktats	None
diskborste	Singular
randig	Singular
sprängande	None
druvornas	Plural
masters	Plural
akademierna	Plural
fjompigt	Singular
gillas	None
spenat	Singular
stavande	None
uppmjukad	None
ratificerats	None
misshagade	None
rötmånadens	Singular
omsätter	None
trädgårdsstäderna	Plural
kyrkbänkarna	Plural
axen	Plural
kemikalies	Singular
spindelnätet	Singular
riksarkivets	Singular
metionin	Singular
genmäles	Singular
gångna	Plural
begåtts	None
brittiske	Singular
inkomstkälla	Singular
samarbetande	None
jättestort	Singular
ymnighetshornen	Plural
nedsatts	None
massproducerad	None
trasdockan	Singular
månadstidning	Singular
infarten	Singular
jäktades	None
urmakaren	Singular
problematiserande	None
vänja	None
försvann	None
bordsbön	Singular
svavelvätets	Singular
västlige	Singular
underskattats	None
kortslutningen	Singular
fonts	Singular
arbetsmarknaden	Singular
utgår	None
simuleringen	Singular
lugnade	None
riksantikvarien	Singular
konvojerna	Plural
uppenbarar	None
tillgängliggör	None
telefonsamtalet	Singular
bor	Singular
toalettpapperet	Singular
antänts	None
importerats	None
tenderat	None
rockringar	Plural
homogen	Singular
vilseledande	None
deporterades	None
räkna	None
jojons	Singular
involveras	None
schakaler	Plural
dödsdoms	Singular
utrikesministerns	Singular
förtydligades	None
befanns	None
kyrkklockans	Singular
upprättandes	Singular
glassbilen	Singular
profilerande	None
psykologerna	Plural
farlige	Singular
hymns	Singular
pumans	Singular
plåts	Singular
tensorer	Plural
krymp	None
oförutsägbar	Singular
databaserna	Plural
tystat	None
förvandlar	None
bekämpad	Singular
uppmana	None
betraktar	None
terms	Singular
reformera	None
onani	Singular
tingsrätt	Singular
smålänningens	Singular
restaurerad	None
adoptiva	Plural
dikterar	None
kittlat	None
uppställs	None
gravvårdar	Plural
gradienternas	Plural
animations	Singular
gymnasters	Plural
tilltro	Singular
finalist	Singular
regeringskansli	Singular
agrar	Singular
stentavlor	Plural
litteraturen	Singular
livstid	Singular
kronprinsens	Singular
brandsäkerhets	Singular
prickar	None
järnvägsförvaltningen	Singular
försälja	None
basuns	Singular
presidentvalen	Plural
västtyskor	Plural
debuterat	None
medvetna	Plural
kriminell	Singular
fora	Singular
tonsätts	None
utvärderas	None
simpel	Singular
kånkat	None
öm	Singular
slik	Singular
brassar	None
myrsyra	Singular
cembalors	Plural
eventuellt	Singular
papperskorgen	Singular
kriminaltekniska	Plural
processer	Plural
sjöstjärnor	Plural
inträffar	None
glob	Singular
förenkla	None
returerna	Plural
apostoliska	Plural
docenterna	Plural
etniske	Singular
köande	None
citrins	Singular
grekiskors	Plural
brandsäkerheten	Singular
accentuerad	Singular
matsalarna	Plural
adelssläkterna	Plural
underordna	None
halskotor	Plural
accelerationer	Plural
karakteriserades	None
behandlad	Singular
singellista	Singular
docerade	None
evangelium	Singular
svensexan	Singular
katoliks	Singular
vänliga	Plural
efterrätt	Singular
nyttjar	None
begynnelse	Singular
styrd	Singular
fysiologi	Singular
världsproblemets	Singular
spelas	None
rycktes	None
perrong	Singular
konferensens	Singular
utgöras	None
ligga	None
kottar	Plural
häxans	Singular
spröjsar	Plural
åttondelsfinaler	Plural
sparre	Singular
evolutionen	Singular
fäll	Singular
svikit	None
beställd	Singular
lättade	None
relativitetens	Singular
omnämna	None
poolen	Singular
sovjeternas	Plural
fasettera	None
orangutang	Singular
bäddjackor	Plural
bondpermissions	Singular
skarvsladden	Singular
tyng	None
fortsättningar	Plural
publicering	Singular
stabilisera	None
djärva	Plural
gestaltar	None
reformerar	None
monterade	None
bulles	Singular
dators	Plural
attesterad	Singular
sociologisk	Singular
germanskans	Singular
gråt	None
fogade	None
provas	None
ettbarnspolitik	Singular
jämställdhetsdepartementet	Singular
kommando	Singular
återställts	None
astronauterna	Plural
sorterar	None
destillerats	None
monetär	Singular
miljardär	Singular
pooler	Plural
riksbanken	Singular
väldig	Singular
transponerande	None
förhållnings	Singular
premiärministern	Singular
erbjudna	Plural
käkar	Plural
getingen	Singular
riksföreståndarna	Plural
siktande	None
värmeböljors	Plural
gallium	Singular
levererar	None
badvädret	Singular
soluret	Singular
bryggkaffets	Singular
brandvarnarens	Singular
fristaden	Singular
stadsstaterna	Plural
motverkat	None
egyptiske	Singular
mångfasetterad	Singular
referera	None
blogg	Singular
grupperas	None
krossar	None
upphovsmannen	Singular
projicera	None
hessianen	Singular
upphovsmannens	Singular
praktiserade	None
valfrågornas	Plural
grekers	Plural
kriminologiska	Plural
näringsdepartementets	Singular
subtraherar	None
kunskapsutvecklingen	Singular
kylskåpet	Singular
egendomliga	Plural
beskrevs	None
ensam	Singular
lexikografiskt	Singular
satsning	Singular
petade	None
dvärgstjärna	Singular
segelbar	Singular
narren	Singular
hårdvara	Singular
gode	Singular
grävlingen	Singular
dieselmotorns	Singular
toppat	None
pyramiden	Singular
direkte	Singular
förvärvar	None
avvisas	None
misskrediteras	None
predikades	None
läsplatta	Singular
fullgörs	None
topplistans	Singular
berömd	Singular
musikhögskolan	Singular
irländarnas	Plural
et-tecken	Singular
hasselmusen	Singular
kulturpropositionerna	Plural
inramningar	Plural
skådade	None
kassetten	Singular
maltesiska	Singular
tarsen	Singular
kortslöts	None
skårorna	Plural
daggkåpan	Singular
fogas	None
riskbedömningar	Plural
sexhörningarna	Plural
störtkrukan	Singular
esperanto	Singular
holländsk	Singular
pekskärmar	Plural
problematisk	Singular
abonnent	Singular
reglerats	None
siamesen	Singular
fyratav	None
medfödd	Singular
premiärministrarna	Plural
förenklats	None
framfördes	None
välkomnad	Singular
skrinlägga	None
arrenderats	None
njutande	None
redigeringarna	Plural
utmanar	None
ambassadens	Singular
puttat	None
autograf	Singular
biplanet	Singular
pruttars	Plural
avbildande	None
snickrande	None
autografer	Plural
iriserade	None
bildtexter	Plural
antiloperna	Plural
kvaldes	None
alaninets	Singular
boren	Singular
koordinerad	None
baserad	Singular
tippade	None
förfäder	Plural
diplomati	Singular
uppräkningen	Singular
nordpolen	Singular
cellmembranets	Singular
föreskrevs	None
missbruka	None
devisen	Singular
släden	Singular
anständigt	Singular
karp	Singular
middagars	Plural
kommunminister	Singular
bearbetande	None
avgångstid	Singular
sarkofagers	Plural
utfärdas	None
ogärningsmans	Singular
mångfasetterat	Singular
deldokumentens	Plural
hypotetisk	Singular
tvekande	None
ketoner	Plural
förledens	Plural
målande	None
diskursiv	Singular
klarinettister	Plural
tidsåldrarnas	Plural
diameter	Singular
femtegradsfunktionens	Singular
tråkigaste	Singular
härdens	Singular
försäljningslista	Singular
kinetik	Singular
traditionellt	Singular
splittrar	None
bearbetades	None
ornitologerna	Plural
lånordet	Singular
handpenningen	Singular
obehaglig	Singular
orienterades	None
genererad	None
pseudovetenskap	Singular
katalysator	Singular
omnämnanden	Plural
salladen	Singular
vegetationen	Singular
underhölls	None
koalitionsstyrkans	Singular
inventeras	None
uträknad	Singular
låsande	None
sångsvan	Singular
menas	None
entréer	Plural
cykelpumpen	Singular
gäddornas	Plural
gröngölings	Singular
profilerar	None
bensinstationer	Plural
drunknat	Singular
filnamnens	Plural
sömnlösheten	Singular
erinrande	None
nässlorna	Plural
fjäderdräktens	Singular
qvick	Singular
pitten	Singular
somnat	None
levererad	None
trucken	Singular
konstitutionsutskottet	Singular
privatskolans	Singular
djuriska	Plural
konfronterat	None
nedsätts	None
allitterations	Singular
jätte	Singular
kärnkraftverkens	Plural
indianska	Plural
alpers	Plural
återuppbyggdes	None
tåligt	Singular
plånet	Singular
knullade	None
instruerade	None
meterna	Plural
dvärgstjärnorna	Plural
trädstammen	Singular
efterblivna	Plural
sprängt	None
breddgraderna	Plural
rättmätig	Singular
akademi	Singular
detekterat	Singular
assimilerats	None
vingar	Plural
rapportera	None
dubbel	Singular
framträd	None
gafflat	None
utmanat	None
bokats	None
kompenserade	None
digitalkameran	Singular
absurda	Plural
utövas	None
uvars	Plural
genomförde	Singular
pinsam	Singular
önskelista	Singular
venuspassagens	Singular
annullerad	Singular
slagor	Plural
serin	Singular
bergskedjan	Singular
ärkefienders	Plural
signalementets	Singular
receptbelagd	Singular
pizzorna	Plural
uttryckta	Plural
dylike	Singular
ångaren	Singular
tillbringande	None
integrationskonstants	Singular
isbjörnar	Plural
sydnäktergalars	Plural
väders	Singular
erkänt	Singular
ödmjukt	Singular
skärps	Singular
infiltrera	None
födelsedagstårta	Singular
författande	None
baskens	Singular
växlas	None
citronfjärilar	Plural
underrubriken	Singular
skarva	None
rusttjänsten	Singular
gömd	Singular
dvärg	Singular
hajmalarna	Plural
lagats	None
sånglärkan	Singular
målmängden	Singular
bullers	Singular
tredjedelar	Plural
köttfärsen	Singular
handlägg	None
föreslagit	None
enhetspartiets	Singular
tvättbjörnar	Plural
fullmakter	Plural
skärmytslingar	Plural
koppar	Singular
anstalt	Singular
engagerande	None
determinanternas	Plural
återuppbyggt	None
gulnat	None
brigadgenerals	Singular
hitlistan	Singular
dansats	None
oförskämdhet	Singular
gymnasist	Singular
bekändes	None
prestanda	Singular
folkskolorna	Plural
revolvers	Singular
meteorologisk	Singular
elakt	Singular
barmhärtig	Singular
tagarens	Singular
skurkarna	Plural
behagats	None
trycktes	None
kompostera	None
värnpliktens	Singular
roterad	None
abstraktionen	Singular
hinds	Singular
haltar	None
astronauts	Singular
födelsedagsfesterna	Plural
skolkamratens	Singular
valls	Singular
järnsparven	Singular
lugne	Singular
momsen	Singular
soluren	Plural
tjänsteadel	Singular
införas	None
redovisande	None
digitalkamerans	Singular
kvitta	None
klonerna	Plural
dramer	Plural
nitarna	Plural
odonet	Singular
packa	None
underavdelningar	Plural
astrologer	Plural
lagrumshänvisning	Singular
allmäntjänstgöring	Singular
antyder	None
bukar	Plural
bombarderad	Singular
kampanjs	Singular
förnyelser	Plural
utesluts	None
lagledarna	Plural
derivata	Singular
avstå	None
hallickar	Plural
simsnäppas	Singular
logor	Plural
invalet	Singular
undergruppen	Singular
publicerades	None
ficktjuven	Singular
furstarnas	Plural
bered	None
hallonen	Plural
kantades	None
administration	Singular
skattades	None
gångbanornas	Plural
vägledas	None
stativet	Singular
kokosnöten	Singular
olika	Plural
aducerar	None
droppas	None
drivet	Singular
dvärgpudel	Singular
godkända	Plural
församlingskyrkor	Plural
förutsade	None
navelns	Singular
upplöst	None
diskmedlet	Singular
marknadsför	None
basket	Singular
leddjuren	Plural
objektivt	Singular
kaffeböna	Singular
uppfylls	None
rättats	None
vietnamesiskas	Singular
gisslat	None
profetian	Singular
prestandans	Singular
ekolog	Singular
samtids	Singular
omelett	Singular
arkeologin	Singular
behåll	None
konserverna	Plural
grundlägga	None
klassklyftorna	Plural
kikat	None
väldet	Singular
samvete	Singular
IP-adresser	Plural
infiltrerad	None
arméer	Plural
tunga	Plural
härskaror	Plural
kommerskollegium	Singular
återgivningens	Singular
kaffeblandning	Singular
bokstavskodens	Singular
nöj	None
livsmedelsbutik	Singular
röstningar	Plural
projektilens	Singular
zombies	Singular
landningsbana	Singular
meteorologer	Plural
mejlen	Plural
girighet	Singular
ammoniaken	Singular
coolt	Singular
participen	Plural
raderingarnas	Plural
tjeckisk	Singular
medvurst	Singular
älgarnas	Plural
tokors	Plural
pendeltågens	Plural
ambassadörer	Plural
utformats	None
runt	Singular
upphävs	None
amfiteater	Singular
överser	None
miniatyriserades	None
kallat	Singular
statsbidragens	Plural
stångens	Singular
oroande	None
yngsta	None
trigonometri	Singular
bogserat	Singular
laddat	None
kroater	Plural
inneburit	None
kontroverser	Plural
kurdiskas	Singular
oxens	Singular
anständig	Singular
högtyskans	Singular
mexikanskorna	Plural
översvämning	Singular
dressingen	Singular
armeras	None
gratulations	Singular
späddes	None
bistå	None
saxofonisterna	Plural
äppelträdens	Plural
kissade	None
graverande	None
brända	Plural
strumpbyxor	Plural
rumänsk	Singular
fåtöljens	Singular
klichéer	Plural
kammen	Singular
gradienter	Plural
magre	Singular
onde	Singular
provat	None
socialdemokratin	Singular
variationer	Plural
biflod	Singular
offert	Singular
förloraren	Singular
socialbidraget	Singular
rems	Singular
kantonen	Singular
åttondelsfinalen	Singular
kortvåg	Singular
returnerats	None
folkmassan	Singular
bränn	None
användarnamnen	Plural
länsstyrelserna	Plural
käpphästs	Singular
beskyddarens	Singular
textramar	Plural
kokosnöt	Singular
partimedlemmarna	Plural
möjliggjorts	None
faktorisering	Singular
rodnadernas	Plural
skyttegraven	Singular
svarades	None
registratorn	Singular
centralbankerna	Plural
mustasch	Singular
värdefull	Singular
länsrätt	Singular
alkotesten	Plural
långfredagen	Singular
entusiaster	Plural
heds	Singular
aningslöst	Singular
nedsätt	None
konsumera	None
indoktrinerat	None
födelsedagsfest	Singular
värnande	None
insisterade	None
förmans	Singular
tvåorna	Plural
gesällen	Singular
delstaterna	Plural
perronger	Plural
dividendernas	Plural
motiverande	None
ettbarnspolitiken	Singular
multiplicerar	None
sökmotorer	Plural
erinras	None
gäckande	None
armeniers	Singular
generalagenten	Singular
hemslöjd	Singular
mörkna	None
säckpipors	Plural
uppdatera	None
kukars	Plural
invasionsstyrkan	Singular
förmedlat	None
registrator	Singular
hemlands	Singular
kopierade	None
autopilot	Singular
folkhälsan	Singular
slappt	Singular
åran	Singular
klargörande	Singular
synkroniserande	None
hyenorna	Plural
förmiddagen	Singular
fixad	Singular
förfallande	None
översätta	None
ruinera	None
utvidgats	None
forskarutbildningen	Singular
resultatlistan	Singular
synagogor	Plural
posta	None
kattor	Plural
våldtäktens	Singular
avledas	None
bokförts	None
tvåöringars	Plural
önskningarna	Plural
inlett	None
statsbudgetars	Plural
vattenhundarna	Plural
instämma	None
danar	None
arbetsmiljös	Singular
invandrar	None
kompilera	None
utökar	None
spöregnade	None
legerades	None
förvärvas	None
diskmaskiners	Plural
signalera	None
knivskär	None
rättad	None
avgränsningen	Singular
stadsstadgorna	Plural
elektroskop	Singular
egyptiskt	Singular
gardiner	Plural
förstatligades	None
promenerade	None
förgiftade	None
processers	Plural
introducerande	None
brottade	None
trafikerande	None
sultans	Singular
litar	None
celibatet	Singular
överdriver	None
epilogen	Singular
teknikerna	Plural
diagnostiserar	None
citrusfrukter	Plural
konka	None
standarderna	Plural
evigheten	Singular
feg	Singular
köpings	Singular
förberedas	None
reaktiva	Plural
polerat	None
akustiskt	Singular
bibliska	Plural
förstatligat	None
mellanfotsbenen	Plural
grevinnans	Singular
fotograferad	Singular
envise	Singular
finansmarknader	Plural
högtider	Plural
editera	None
lyras	Singular
modifierar	None
barrskogar	Plural
uttalades	None
lantbruken	Plural
reglerande	None
roterar	None
statskupper	Plural
avgångarna	Plural
betraktades	None
frälsa	None
urvattnad	Singular
haitierna	Plural
likformig	Singular
musikhögskola	Singular
varsla	None
israeliter	Plural
anspelat	Singular
fanor	Plural
kryssprodukten	Singular
färgblinda	Plural
girande	None
räknestickan	Singular
jordnöten	Singular
migrationer	Plural
förrådd	Singular
stridsvagn	Singular
mineringarna	Plural
entreprenad	Singular
nobelpristagaren	Singular
bedrövar	None
husvagn	Singular
kinesernas	Plural
domkapitlet	Singular
adresseringsstrukturens	Singular
skrotat	None
tzatzikin	Singular
lyriskt	Singular
bijektiv	Singular
mobiliseras	None
grekiskans	Singular
dispyt	Singular
pausade	None
skogsstjärnan	Singular
extrema	Plural
stralades	None
förrått	Singular
pinglar	None
operera	None
brorsan	Singular
reciterades	None
tjänsteadeln	Singular
starar	Plural
filtyper	Plural
kineser	Plural
klassisk	Singular
framträda	None
virats	None
lemmat	Singular
beslutad	Singular
slopande	None
fläsket	Singular
älskande	None
konstaterande	Singular
blesserad	None
duktig	Singular
uteslutit	None
dröjsmålets	Singular
spalta	None
visselpipor	Plural
fraktionen	Singular
flykthastigheterna	Plural
tekakor	Plural
regndroppar	Plural
anagrammens	Plural
surrat	None
vägledning	Singular
patriarkernas	Plural
arabiske	Singular
missförhållande	Singular
borgarrådet	Singular
surdeg	Singular
lansera	None
nationalsånger	Plural
genomför	None
tonsätta	None
barrikaderande	None
pendel	Singular
drygt	Singular
buketten	Singular
ispravnikers	Plural
islänningen	Singular
kolliderade	None
hårdföra	Plural
kvalificerar	None
australierna	Plural
dysprosiumets	Singular
slaktar	None
överlämna	None
lexikograf	Singular
stickprovens	Plural
världsmakten	Singular
filformatets	Singular
avsågs	None
lastar	None
delegera	None
disputerade	None
sjörövarna	Plural
strukturera	None
näktergal	Singular
verifieras	None
begravda	Plural
fästena	Plural
sympatiska	Plural
lönas	None
koalornas	Plural
använd	Singular
fettsyrorna	Plural
låstes	None
nöjt	None
diket	Singular
infogas	None
landsman	Singular
avslutas	None
topologier	Plural
predikantens	Singular
doftar	None
skaffar	None
domino	Singular
fjärrkontroll	Singular
diamant	Singular
bisonoxarnas	Plural
ugglornas	Plural
konsonanten	Singular
tvättmaskiners	Plural
gördel	Singular
negligerade	None
titulerad	None
lits	Singular
begreps	None
anslut	None
fordrade	None
elektriskt	Singular
debattörer	Plural
brottslighetens	Singular
krock	Singular
hänvisad	None
flygning	Singular
allordboks	Singular
armbågsbenets	Singular
näringslivets	Singular
upplåtits	None
hårdnande	None
påmindes	None
koka	None
koreansk	Singular
utgåvans	Singular
utrikesdepartementets	Singular
negligera	None
förstärkningarna	Plural
miljöministern	Singular
krackelera	None
radioöverföring	Singular
devalverande	None
druckne	Singular
överstökat	Singular
glasstruts	Singular
delbart	Singular
militärstyrkor	Plural
paddors	Plural
värdigaste	Singular
motorvägen	Singular
deklarerades	None
omformulera	None
slippande	None
paplarna	Plural
axlades	None
nagelfilars	Plural
abelsk	Singular
grindens	Singular
frimurarna	Plural
strålblommor	Plural
filatelistens	Singular
katoliken	Singular
traditionelle	Singular
avslutades	None
nedslående	None
överflödig	Singular
råder	None
urskiljas	None
piercing	Singular
redovisning	Singular
kalvar	Plural
brygders	Plural
tornfalken	Singular
bilagans	Singular
kustbevakningen	Singular
doktriner	Plural
säkerhetspoliser	Plural
intellektuellt	Singular
pucken	Singular
poemet	Singular
vanföreställningen	Singular
mäts	None
embargot	Singular
fiskats	None
besiktningar	Plural
kraftkablar	Plural
sjukförsäkringars	Plural
uppfyllelsen	Singular
finalens	Singular
prästgårdar	Plural
organisera	None
justering	Singular
snabbar	None
alkemisten	Singular
fyrarna	Plural
stormsvalorna	Plural
extremitetens	Singular
skoningslöst	Singular
långan	Singular
detonera	None
relaterades	None
täpptes	None
gentekniken	Singular
obligatoriske	Singular
brytets	Singular
citerar	None
spårbundna	Plural
initierade	None
ljungens	Singular
puppan	Singular
lianen	Singular
tabbar	Plural
klassificerande	None
bors	Singular
begagnande	None
marsvinen	Plural
statssekreteraren	Singular
kollas	None
charms	Singular
allitterationer	Plural
trumslagaren	Singular
försonat	None
fräckaste	Singular
statsbanor	Plural
raffinaderna	Plural
klistrat	None
mappade	None
nyckelns	Singular
subbas	Singular
minskat	None
pinsamma	Plural
recensera	None
dominerar	None
barriär	Singular
suspensoar	Singular
spaltens	Singular
investerades	None
stila	None
barndomens	Singular
bergskedjorna	Plural
kategoriserats	None
premiärer	Plural
gallas	Singular
sjöröveri	Singular
alver	Plural
konsulterat	None
hårdvaran	Singular
paramagnetism	Singular
skrivkramps	Singular
studentkårens	Singular
elektron	Singular
jeepar	Plural
räkor	Plural
basunen	Singular
årstiders	Plural
näckar	None
kanslichefen	Singular
tankesmedjor	Plural
sparvar	Plural
antisymmetriska	Plural
skriftställaren	Singular
övertalar	None
skånkar	Plural
avlös	None
orkesterledarna	Plural
tideräkningar	Plural
obegriplig	Singular
ansvarsområden	Plural
hintades	None
qväfvd	None
skata	Singular
högas	None
genomförs	None
gravvårdarna	Plural
förespråkad	None
grundsatsen	Singular
störämnen	Plural
papel	Singular
djuriskt	Singular
presenterar	None
atomkärnor	Plural
alkyl	Singular
o	Singular
sankt	Singular
kokboken	Singular
inställd	None
kalvat	None
syntaxen	Singular
perifera	Plural
sköte	Singular
drömt	Singular
himlakroppars	Plural
dockad	Singular
ungt	Singular
persondator	Singular
bostadskrisers	Plural
applåderna	Plural
slutta	None
pedagogiske	Singular
etablera	None
ellipsoiden	Singular
arklimästarens	Singular
eldstad	Singular
gångbanorna	Plural
slits	Singular
sekundanterna	Plural
atomens	Singular
korpar	Plural
sensorns	Singular
kryptor	Plural
upptäckt	None
kackerlackorna	Plural
välkommen	Singular
kompensationen	Singular
våld	Singular
landsdelen	Singular
samkördes	None
rötters	Plural
inspirationskällor	Plural
prosten	Singular
kylningen	Singular
singellistan	Singular
kvarleva	Singular
höstande	None
modulerna	Plural
underordnat	Singular
sköldpaddornas	Plural
vävas	None
nekat	None
häkta	None
grundad	Singular
karamell	Singular
gungstolen	Singular
dåra	None
begrips	None
tiondels	Singular
åldras	None
kletet	Singular
svallande	None
lussekatter	Plural
cybernetik	Singular
gästgiveriets	Singular
holk	Singular
armbands	Singular
koltrastens	Singular
hörde	Singular
väntad	Singular
procentenheten	Singular
säkerhetsvakten	Singular
bysten	Singular
ansluta	None
ceremonierna	Plural
språngbrädans	Singular
sysselsättningar	Plural
tryckeriets	Singular
filosofierna	Plural
assessor	Singular
symmetriska	Plural
olivträden	Plural
överstinnornas	Plural
flundras	Singular
elakaste	Singular
tonårings	Singular
kontoutdrag	Singular
ändrad	Singular
ramas	None
kanadensiska	Singular
mörker	Singular
fyrfaldige	Singular
tröttats	None
föredetting	Singular
utrikespolitik	Singular
eldgaffeln	Singular
federationers	Plural
oxar	Plural
föremålets	Singular
intellektuelle	Singular
upplåta	None
arrende	Singular
gärdsgård	Singular
bihålor	Plural
kartograferna	Plural
bearbetning	Singular
landgång	Singular
telefemet	Singular
släppte	None
ändamålen	Plural
utrensningarna	Plural
skedar	Plural
urvalsfönstrets	Singular
disponerade	None
kategoriserades	None
skams	Singular
rådmans	Singular
kedjebråket	Singular
krympt	None
kubikroten	Singular
bryggeriets	Singular
ombrytnings	Singular
rikt	Singular
geofysik	Singular
prost	Singular
svartingar	Plural
avgång	Singular
aktande	None
fullföljde	None
ankomsttid	Singular
pakt	Singular
tomrummen	Plural
handelshögskolor	Plural
tvivlande	None
myra	Singular
horoskopens	Plural
överskridit	None
klotter	Singular
förtvivla	None
duetters	Plural
gissade	None
slagskugga	Singular
ritats	None
vidgat	Singular
tillsätta	None
klarnat	None
friskolor	Plural
automation	Singular
kammarrätt	Singular
katalysatorn	Singular
kroppsdel	Singular
oegennyttas	Singular
trasorna	Plural
samlande	None
konsumenten	Singular
skyddsvärdet	Singular
stjärtarnas	Plural
sakta	None
personbilar	Plural
avade	None
meck	Singular
delfinens	Singular
eskimåer	Plural
hyresvärds	Singular
strutsarnas	Plural
rotationsfältet	Singular
tidningsredaktionerna	Plural
bloggens	Singular
huvudgatorna	Plural
baskern	Singular
slutaren	Singular
tribunalen	Singular
apatin	Singular
oskyldigt	Singular
årtalen	Plural
omvärderande	None
elektromagneter	Plural
intressesfären	Singular
ölmagars	Plural
redaktionssekreteraren	Singular
tätorts	Singular
baracker	Plural
regin	Singular
bunken	Singular
uzbekerna	Plural
pakterna	Plural
minervaugglornas	Plural
uppenbarats	None
farmaren	Singular
diffunderande	None
enet	Singular
agronomens	Singular
slovak	Singular
pastor	Singular
räkenskapers	Plural
qvinnan	Singular
soliga	Plural
bättrat	None
honblomman	Singular
väggplankor	Plural
musikaliske	Singular
överansträngda	Plural
skiktats	None
niqaber	Plural
solcellen	Singular
borttaget	Singular
evolutionsbiologer	Plural
territorium	Singular
skärvas	Singular
manuskriptets	Singular
lid	None
symmetriaxelns	Singular
moget	Singular
förnekas	None
avvisats	None
handpenning	Singular
vampyrerna	Plural
katalogiserades	None
gästgiveri	Singular
katalogiserar	None
korta	None
venuspassager	Plural
ändelser	Plural
procentenheters	Plural
bålgetingen	Singular
femtedelen	Singular
odet	Singular
funktional	Singular
brigadernas	Plural
företräden	Plural
yrkat	Singular
signaleras	None
recitera	None
infarternas	Plural
kameliorna	Plural
återvinningen	Singular
polypeptiderna	Plural
växthuseffekt	Singular
inbegripet	Singular
briserar	None
invandra	None
övergångsbestämmelses	Singular
konstatera	None
parar	None
näbbar	Plural
arbetskamrat	Singular
marginaler	Plural
inseglet	Singular
försök	None
fredsförhandlingarna	Plural
angelägenhetens	Singular
realiserat	None
countrymusiken	Singular
böjde	Singular
trovärdighet	Singular
förstods	None
grönskan	Singular
funnits	None
antikvitet	Singular
avträden	Plural
redbarhet	Singular
knivskärs	None
produktive	Singular
bevakad	Singular
anmärkningsvärda	Plural
sting	None
dödligt	Singular
räkenskapsårets	Singular
ägnar	None
hyresnämnden	Singular
nordamerikanska	Singular
morfin	Singular
sub	Singular
loppisar	Plural
krattors	Plural
gnistans	Singular
ätternas	Plural
vindruta	Singular
drömde	Singular
hyrt	Singular
mättes	None
sjua	Singular
hissad	None
skrivkrampen	Singular
konceptets	Singular
transporteras	None
övervägd	None
begärts	None
gondolen	Singular
skämtaren	Singular
ockuperats	None
ackompanjemangen	Plural
förlorarens	Singular
anande	None
kronofogdens	Singular
underlagen	Plural
kammarrätternas	Plural
strontiumets	Singular
långsiktigt	Singular
misse	Singular
bröstvårtor	Plural
linets	Singular
kulramarnas	Plural
rövades	None
mörka	Plural
voterande	None
kortslut	None
kvickt	Singular
stakar	Plural
dalkarlarnas	Plural
folkbildarna	Plural
erkänn	None
kolerans	Singular
seedas	None
gnagarens	Singular
halvbrors	Singular
lugnar	None
förändrar	None
skådeplatser	Plural
guldmedalj	Singular
engelsk	Singular
kanslichef	Singular
rumänskt	Singular
kroaters	Plural
amirals	Singular
bokmärke	Singular
disponerades	None
ecuadorianen	Singular
ivern	Singular
skidskyttet	Singular
kika	None
falsifiera	None
turkduvan	Singular
roligt	Singular
symboliserad	None
entusiasten	Singular
sladdarna	Plural
ämnade	None
summerats	None
fälgen	Singular
knäpper	None
patriarks	Singular
signalerades	None
diskettens	Singular
överlämnar	None
trumpetaren	Singular
städet	Singular
trollkona	Singular
forensiska	Plural
komponenternas	Plural
grönska	Singular
översättas	None
förvånat	Singular
boka	None
skådebanor	Plural
trollkarlens	Singular
rödgrön	Singular
förestått	Singular
cancan	Singular
svepande	None
knivskar	None
datalogi	Singular
koordinatsystemets	Singular
gotländskan	Singular
singlas	None
publikationsbyrån	Singular
detonerats	None
rörlig	Singular
motionerna	Plural
konsoliderad	None
gummin	Plural
ramades	None
växts	Singular
böjen	Singular
ofarlige	Singular
tandkräm	Singular
ordningsföljd	Singular
ignorerande	None
skyldigt	Singular
deklarerar	None
ruinen	Singular
individualiserat	None
försedde	Singular
morförälders	Singular
kilar	Plural
tillkommande	None
registrerad	None
stipendiat	Singular
panteismen	Singular
skottkärra	Singular
utvandrar	None
rosta	None
förstatligade	None
resonera	None
tallkottkörteln	Singular
toppade	None
kokkaffe	Singular
tjänat	None
flakets	Singular
omsatt	None
genuine	Singular
erhölls	None
knackades	None
fastnande	None
sladds	Singular
märktes	None
analysera	None
sakfelet	Singular
dansbana	Singular
förlora	None
lukta	None
deniers	Singular
sidnumren	Plural
rumänen	Singular
ödesgudinna	Singular
totalspråksordbok	Singular
bakelsen	Singular
negrinnans	Singular
bråkdelarnas	Plural
utnämner	None
uttalas	None
gåshuden	Singular
mystikens	Singular
hymner	Plural
banga	None
odödlige	Singular
hushållerskan	Singular
fraser	Plural
argumenteras	None
breddgrader	Plural
brittisk	Singular
förvaltat	None
solvinden	Singular
snodde	None
ordinärt	Singular
samarbetat	None
pille	Singular
östkyrkans	Singular
knivskärande	None
räfflor	Plural
brändernas	Plural
flodhäst	Singular
välsignat	Singular
inhemsk	Singular
tangenten	Singular
kartografi	Singular
verktygslådan	Singular
kontinentalplattor	Plural
älska	None
linser	Plural
sjövärdigt	Singular
förmedlas	None
spisas	None
karameller	Plural
bottenkvark	Singular
rensning	Singular
cymbal	Singular
installerades	None
magnetism	Singular
extraknäckte	None
sågas	None
koalor	Plural
mörke	Singular
miliserna	Plural
lämpande	None
packades	None
bultarnas	Plural
demonstrerande	None
överskriden	None
barnmorskorna	Plural
ons	Plural
själv	Singular
varaktiga	Plural
qvalificerar	None
kidnappa	None
nyårsdags	Singular
reformutrymme	Singular
gruvstolparnas	Plural
ytspänning	Singular
lågmält	Singular
fagre	Singular
enkelhet	Singular
svann	None
vandrarens	Singular
torparen	Singular
slitage	Singular
facetternas	Plural
förhållande	None
allegorisk	Singular
motorvägssträcka	Singular
viskats	None
bländar	None
hundskatterna	Plural
gulaktigt	Singular
erfor	None
snälltåget	Singular
mellanfolkliga	Plural
pendeltåget	Singular
försetts	None
upprepar	None
livsstilar	Plural
hemslöjden	Singular
genomförandets	Singular
etsas	None
ursprungligt	Singular
relaterar	None
semifinalisterna	Plural
tröskverket	Singular
vinstdelningens	Singular
urgammalt	Singular
vasen	Singular
förgå	None
spillet	Singular
uppfyllts	None
satta	Plural
fästet	Singular
sjuans	Singular
kritikerns	Singular
skattar	None
återuppbyggande	None
ordlista	Singular
apostelns	Singular
ackuschör	Singular
milde	Singular
avgränsningarna	Plural
stadskärna	Singular
transformeras	None
dasset	Singular
pressats	None
bronkits	Singular
håg	Singular
rumän	Singular
felmeddelandet	Singular
turistfällans	Singular
granna	Plural
kudden	Singular
trumpetsteken	Singular
kyliga	Plural
satsningen	Singular
mjukna	None
fjärtat	None
parameterns	Singular
erkännande	Singular
motorvägs	Singular
brandväggar	Plural
norskans	Singular
tior	Plural
folkrätt	Singular
logaritmerna	Plural
revirets	Singular
brydde	Singular
skygga	Plural
mellanslagen	Plural
måttbandet	Singular
karakteristiker	Plural
undkomma	None
bero	None
lövverken	Plural
huvudområden	Plural
långfredagens	Singular
vattenmelon	Singular
överanstränger	None
gränsar	None
krickan	Singular
arabers	Plural
komplicerande	None
körde	Singular
vinrött	Singular
segelbåt	Singular
samurajers	Plural
urinoarernas	Plural
försvaras	None
buddhisterna	Plural
inspekterade	None
tillägga	None
astrologens	Singular
rikskronofogdars	Plural
influerade	None
bofink	Singular
slopade	None
bifogade	None
altare	Singular
dygnens	Plural
utgiftstaket	Singular
överraskad	None
ursprungliga	Plural
världsliga	Plural
ansträngts	None
sjuksyster	Singular
stekplåts	Singular
trampoliner	Plural
mördades	None
sistnämnda	Plural
sälja	None
generallöjtnantens	Singular
neutraliserar	None
jamaicanskt	Singular
uppföljts	None
laddning	Singular
tystande	None
värderande	None
kaffebryggningar	Plural
geologins	Singular
misstyckande	None
plåstret	Singular
summerande	None
blåmesarna	Plural
stegades	None
erkänna	None
salvor	Plural
korpen	Singular
arian	Singular
röstsiffrorna	Plural
torterad	None
arbetat	Singular
hård	Singular
långsamt	Singular
tjänande	None
singellistor	Plural
vaxad	None
tjutit	None
omgivningar	Plural
avskedat	Singular
chimär	Singular
flänsen	Singular
besiktnings	Singular
hemisfärerna	Plural
stimulerat	None
missbrukar	None
förstasidor	Plural
genereras	None
stängslet	Singular
avgången	Singular
värnas	None
slutattackers	Plural
skendränkning	Singular
frekvenserna	Plural
kammarna	Plural
irriterande	None
sockenkyrkorna	Plural
bländaren	Singular
mineralerna	Plural
stadskärnorna	Plural
medmänniskans	Singular
beundrande	None
bunta	None
drängars	Plural
tvekat	None
visad	Singular
tillägnat	None
lessnande	None
hejdar	None
boktryckarkonstens	Singular
isolera	None
stoltheten	Singular
kontrasterad	None
balalajkan	Singular
gnistor	Plural
vicepresidenterna	Plural
noterades	None
federale	Singular
vävar	Plural
stavkyrkan	Singular
avtjäna	None
respekten	Singular
preposition	Singular
nätverket	Singular
apoteket	Singular
reproducerad	None
grapefrukts	Singular
allmän	Singular
programvaran	Singular
ljusstakarna	Plural
mopsarna	Plural
högskolelektorers	Plural
oundvikligheter	Plural
kombinatorik	Singular
färgblindheten	Singular
maximeras	None
korall	Singular
långt	Singular
vippor	Plural
ritningarna	Plural
gädda	Singular
villfarelse	Singular
kotteriernas	Plural
maximera	None
vässas	None
olympiaden	Singular
riggas	None
hämmande	None
vankat	None
bötad	None
acklimatisera	None
gemensamme	Singular
kommunikation	Singular
befinns	None
åsiktsregistrerad	None
missilen	Singular
gräsmånader	Plural
förföljas	None
grävling	Singular
långsidans	Singular
bukett	Singular
legitimerats	None
konkurrent	Singular
talformatets	Singular
porerna	Plural
zombie	Singular
aktriser	Plural
lågmälda	Plural
investerat	None
förloras	None
arkeologins	Singular
ässja	Singular
länkat	None
kärnkraftverken	Plural
röriga	Plural
optik	Singular
stridsyxornas	Plural
parat	None
distribuerar	None
jojo	Singular
exponentialfunktioner	Plural
julafton	Singular
översvämmad	None
rovdjurens	Plural
avskrivit	None
hutlösa	Plural
huvudmannen	Singular
alkor	Plural
krymptes	None
utrikesdepartementet	Singular
körbanor	Plural
blåhaken	Singular
rodnat	None
isomorfa	Plural
halvön	Singular
skalärprodukts	Singular
oförtövad	Singular
prostens	Singular
utrensningen	Singular
rök	None
somnad	None
hök	Singular
bitvisa	Plural
knarkat	None
röjande	None
glänser	None
sidfläsk	Singular
optimistiskt	Singular
centralafrikan	Singular
hänvisar	None
leven	Singular
sprits	Singular
reviderad	None
handtruck	Singular
dvärgens	Singular
hotfulla	Plural
hangarens	Singular
hemsidornas	Plural
varslad	None
häradsrätten	Singular
extrempunkter	Plural
jordreformen	Singular
förbehåller	None
immaterialrätt	Singular
kvadrerade	None
trävaruindustrier	Plural
sockenstämmans	Singular
renhållnings	Singular
bolånets	Singular
magnetiskt	Singular
hia	None
flöjten	Singular
attentatet	Singular
kantade	None
bokas	None
värmer	None
offrade	None
försvarats	None
dokumenteras	None
utsaga	Singular
avsättning	Singular
opinionssiffror	Plural
studieförbundet	Singular
fysikern	Singular
författningarna	Plural
avhandlat	Singular
purjolök	Singular
gesäller	Plural
fåtöljen	Singular
baskets	Singular
delegerats	None
standardens	Singular
lagrades	None
abstrahera	None
hypnagog	Singular
affint	Singular
hitlista	Singular
plundrats	None
duschar	None
nyansen	Singular
obetydliga	Plural
gissar	None
avsatta	Plural
glad	Singular
uppförde	None
moskéerna	Plural
valsedeln	Singular
tvåor	Plural
lönnmordet	Singular
hånglade	None
näringsutskottet	Singular
ytornas	Plural
vegan	Singular
förfäktade	None
bortsett	None
passerande	None
avsatte	Singular
åttondel	Singular
projekterande	None
ösa	None
begagnades	None
arrenderat	Singular
inventera	None
faktoriseringarna	Plural
utgrävningen	Singular
strategins	Singular
valensbandet	Singular
flyddes	None
övningsfält	Singular
kalendrarna	Plural
gången	Singular
matematikern	Singular
showers	Plural
hjälpprästers	Plural
muggen	Singular
övergicks	None
hjälpprästen	Singular
trakterna	Plural
värderas	None
honblommornas	Plural
slagsmålens	Plural
processen	Singular
formulerats	None
studsar	None
bråkdel	Singular
stridsspetsar	Plural
olik	Singular
överför	None
fartkameror	Plural
befästande	None
hyddor	Plural
reparationerna	Plural
kartläggning	Singular
kompromissen	Singular
meteoren	Singular
civilingenjörer	Plural
användarsidorna	Plural
satte	Singular
intervjuat	None
skeds	Singular
piruetter	Plural
jordmassa	Singular
socialminister	Singular
missuppfattas	None
arbetstagaren	Singular
överansträng	None
diktaturer	Plural
tjockt	Singular
pristagarna	Plural
julsång	Singular
motorcyklarna	Plural
luften	Singular
drogerna	Plural
isotons	Singular
stanna	None
kompletterats	None
plogen	Singular
dravlets	Singular
resulterad	None
rengöring	Singular
huvuddiagonalers	Plural
ursäktar	None
hyst	None
scouten	Singular
bildskärms	Singular
sparkades	None
soluppgången	Singular
förfäktande	None
konstnärliga	Plural
vägras	None
förändrats	None
förläggas	None
profiterande	None
bilade	None
förmodande	None
tjecker	Plural
fixas	None
tabelldokumenten	Plural
departementscheferna	Plural
barbarer	Plural
spätta	Singular
upptagna	Plural
tjugofemöringarna	Plural
tyd	None
gödseln	Singular
sucks	Singular
soundcheck	Singular
flygande	None
stenkyrkans	Singular
bleknar	None
lineära	Plural
expeditionschefer	Plural
utrikesministrarna	Plural
utnämningarnas	Plural
psaltaren	Singular
källingens	Singular
kvietism	Singular
replikerat	None
rockringens	Singular
prosts	Singular
lifvets	Singular
oxiderande	None
utvärderat	None
varumärke	Singular
ragg	Singular
testiklarnas	Plural
spridde	Singular
dramats	Singular
förhalades	None
elegins	Singular
allegori	Singular
förleddes	None
hyndan	Singular
ekoturism	Singular
klaffar	Plural
stjälp	None
fölet	Singular
matfisk	Singular
hetväggarna	Plural
reproducera	None
lutfiskens	Singular
utbilda	None
vädra	None
kunskapare	Singular
comeback	Singular
blottar	None
pluralformerna	Plural
grödans	Singular
småplaneten	Singular
kärnvapenkriget	Singular
kakkalasets	Singular
assisterar	None
titlar	Plural
tittande	None
isolerade	None
vokalernas	Plural
bekännas	None
förgätas	None
ärta	Singular
metade	None
frodig	Singular
ömsesidig	Singular
alkemin	Singular
tyristor	Singular
nordpol	Singular
prokrastinering	Singular
svennernas	Plural
sims	Singular
bildsidan	Singular
glasrutorna	Plural
tändsticka	Singular
betygsatta	Plural
blekta	Plural
försäkringskassans	Singular
hämnades	None
sansar	None
eldflugor	Plural
berikar	None
justitierådet	Singular
minimalt	Singular
pluton	Singular
skattande	None
beundrad	Singular
jordägaren	Singular
trovärdig	Singular
brynjornas	Plural
fortsattes	None
bojor	Plural
slagfältet	Singular
definierat	Singular
aktivism	Singular
renas	None
anteckningarna	Plural
biolog	Singular
överträdelse	Singular
doktorand	Singular
upprättats	None
e-demokrati	Singular
insjuknar	None
längsta	None
anarkist	Singular
magneten	Singular
halshuggen	None
isometriers	Plural
golfbanorna	Plural
rötternas	Plural
cilier	Plural
brusat	None
syr	None
proklameras	None
cykloner	Plural
transformatorn	Singular
draperi	Singular
samurajens	Singular
skiktande	None
paradoxen	Singular
klargjord	None
tentans	Singular
bekämpa	None
glitters	Singular
rostar	None
cyprioterna	Plural
processens	Singular
minskades	None
ten	Singular
stentavlan	Singular
storskarven	Singular
decimalpunkt	Singular
uppfördes	None
apatisk	Singular
århundradena	Plural
föranleda	None
bisköldkörtel	Singular
samexistera	None
mentorer	Plural
socialutskotten	Plural
emirens	Singular
ryske	Singular
onanerats	None
erbjudas	None
nedsätta	None
dygden	Singular
stått	None
utlösa	None
landmassan	Singular
stabilt	Singular
luftad	None
taggarna	Plural
kidnappad	None
backande	None
malls	Singular
överbibliotekariens	Singular
besatts	None
dialogerna	Plural
regionalt	Singular
sinne	Singular
hallåor	Plural
begäras	None
natriumet	Singular
elbasarna	Plural
inordnad	None
diarier	Plural
röstat	None
påverkade	None
utmanarens	Singular
lillfinger	Singular
topologin	Singular
kritiskt	Singular
isländskans	Singular
gubbar	Plural
pippats	None
fastighet	Singular
gestaltat	None
algeriska	Singular
byk	Singular
skarp	Singular
antändande	None
förkläden	Plural
tillhörigt	Singular
tinar	None
kaffebönan	Singular
satellits	Singular
minoriteternas	Plural
disponerat	None
bryggeri	Singular
toleranser	Plural
klassificera	None
organist	Singular
förebygg	None
javanesiskas	Singular
blöda	None
sabbatsåret	Singular
konstmuseet	Singular
accentueras	None
talespersonens	Singular
snöar	None
tälta	None
evangeliernas	Plural
barberande	None
disponeras	None
bläckfisken	Singular
mikrovågsugnars	Plural
medverka	None
alkynerna	Plural
tibetaners	Plural
favorisera	None
anhängarna	Plural
tomten	Singular
jämna	None
liknas	None
mojna	None
rasismens	Singular
borrmaskinen	Singular
simpelt	Singular
rätoromanska	Singular
diamanterna	Plural
könsroller	Plural
rovs	Singular
passerades	None
blodplasma	Singular
medeltids	Singular
exploderat	Singular
stärkas	None
hjässa	Singular
nunnor	Plural
vegetarianer	Plural
räknades	None
arresterar	None
voteringar	Plural
anförtrodde	None
ostlig	Singular
tunnlades	None
avböjdes	None
granska	None
kvadrater	Plural
arbetsmiljöer	Plural
enkelhets	Singular
nukleära	Plural
läroverken	Plural
tillbeds	None
patriarkatets	Singular
aktiverar	None
caddierna	Plural
nationalister	Plural
nagelfilarnas	Plural
smyckande	None
mågar	Plural
atollens	Singular
lastad	None
samtid	Singular
25-öringarnas	Plural
lej	None
hårklyveri	Singular
fjällvråk	Singular
autostradans	Singular
funktionella	Plural
rimligt	Singular
försäkrar	None
vaccinationens	Singular
baserat	Singular
lojaliteter	Plural
realskolans	Singular
samordningen	Singular
blåsinstrumentet	Singular
spisad	None
brandsoldatens	Singular
samordnades	None
kissat	None
flygningar	Plural
spioners	Plural
tillkännagivandet	Singular
överträtt	None
beställningsarbete	Singular
blixtrar	None
stjälpas	None
hejade	None
fogat	None
enkla	Plural
baciller	Plural
basuner	Plural
kombinerar	None
slukade	None
valrossen	Singular
hörlur	Singular
tv-arkivens	Plural
subtraktion	Singular
nedsatt	None
käbbel	Singular
bemötte	None
sjuan	Singular
titulera	None
mikros	Singular
kultursidorna	Plural
förortsbanas	Singular
åttiondelarnas	Plural
sammanslöts	None
uppkommer	None
passerat	None
sanne	Singular
kråkan	Singular
anlades	None
konversations	Singular
hurrar	None
behärska	None
praktiska	Plural
vegetariskt	Singular
renoverad	None
ensamvargarnas	Plural
katedralen	Singular
hända	None
zappande	None
undergrävde	None
missen	Singular
motverkats	None
njuren	Singular
implicerat	None
drängar	Plural
förrådande	None
odjurens	Plural
riksföreningen	Singular
kolumners	Plural
girerad	None
handelsterm	Singular
förses	None
dvärgflodhästen	Singular
putsa	None
trollkonor	Plural
markisernas	Plural
laddande	None
pantrarna	Plural
betecknats	None
kolibrier	Plural
matta	Plural
rippats	None
betyder	None
halsbandet	Singular
stapels	Singular
atomenergis	Singular
kvadranter	Plural
söktes	None
nominativen	Singular
arsenik	Singular
registrera	None
ekonomernas	Plural
tentorna	Plural
natriumhydroxid	Singular
avgjorda	Plural
förutseende	None
bryggkaffe	Singular
ögonfransar	Plural
promiskuöst	Singular
framgångsrika	Plural
häradsrätternas	Plural
vampyrer	Plural
qvalde	None
riggs	Singular
havererade	None
plankets	Singular
värks	None
sladdats	None
aningslös	Singular
medlingarna	Plural
isometrisk	Singular
translation	Singular
teve	Singular
korsfästande	None
äcklet	Singular
överdrivits	None
sjöfarten	Singular
överväger	None
revisionsrätternas	Plural
prognosen	Singular
dokumentmall	Singular
upphovsrättens	Singular
avats	None
odlades	None
fetaste	Singular
blockader	Plural
holme	Singular
bondgårdar	Plural
avgångstiders	Plural
bekämpande	None
bogseras	None
slinga	Singular
böjarna	Plural
fixerades	None
modige	Singular
sari	Singular
förehållande	None
numrerade	None
överdriva	None
klottret	Singular
buttre	Singular
minerals	Singular
stabiliserad	None
missil	Singular
fornforskaren	Singular
repeterande	None
traktens	Singular
ruinerna	Plural
accepterat	Singular
porträtterar	None
framåtskridande	Singular
firas	None
planeringar	Plural
institutionens	Singular
maneter	Plural
näringslivssamverkan	Plural
skygg	Singular
stoftets	Singular
slappat	None
apostoliske	Singular
tupplurar	Plural
pekaren	Singular
postmoderna	Plural
psykologiskt	Singular
webbsajter	Plural
utvecklats	None
rulltårta	Singular
fog	Singular
uppkomst	Singular
dröjsmålens	Plural
entitan	Singular
jamaicanerna	Plural
utvärdera	None
teolog	Singular
flicknamnets	Singular
driven	Singular
kulminerande	None
verksamme	Singular
frisinnad	Singular
sjuder	None
teaterledaren	Singular
stubin	Singular
skottkärror	Plural
sovsäck	Singular
advents	Singular
samexisterande	None
örten	Singular
länsrättsfiskaler	Plural
ansåg	None
engelskas	Singular
ystar	None
systematiserade	None
underlättat	None
förefall	None
slömdats	None
sovsäckens	Singular
anknytningar	Plural
bröstkotorna	Plural
brunbjörn	Singular
byggde	Singular
bedrivit	None
svensexa	Singular
davna	None
luftstrupe	Singular
självständigt	Singular
schematiskt	Singular
åklagarna	Plural
undergrävd	None
dalens	Singular
torterar	None
svinn	None
trubbigt	Singular
gemen	Plural
servrarna	Plural
kasuset	Singular
synligt	Singular
samordnarnas	Plural
skiftnyckeln	Singular
fixades	None
vårtan	Singular
vittnesbörden	Plural
införd	None
plåtar	Plural
huvuddelars	Plural
krackelerade	None
döv	Singular
pariserhjulet	Singular
ettstruket	Singular
revolver	Singular
autofokusen	Singular
sjöfararna	Plural
timvisaren	Singular
vaggmedsdekorens	Singular
registreringen	Singular
snickeri	Singular
injektion	Singular
medborgarkriget	Singular
skyldig	Singular
förmögenhets	Singular
möllorna	Plural
alkemister	Plural
vinkades	None
exponeras	None
höstas	None
bageriet	Singular
polerad	None
förutsätta	None
inkludera	None
tvistat	None
bortse	None
onödigt	Singular
gymnasten	Singular
stele	Singular
besök	None
primärkällorna	Plural
domedagsmaskiners	Plural
engagemangen	Plural
sakfrågor	Plural
missförhållandena	Plural
förespråkat	None
chanson	Singular
huggormar	Plural
parkeringsplatserna	Plural
statsrådsberedningen	Singular
piraten	Singular
sfärens	Singular
lakoniskt	Singular
solvindens	Singular
ämnats	None
investeringsbankernas	Plural
aldehydens	Singular
pocketar	Plural
oviktigt	Singular
kampanilen	Singular
kammar	Plural
opponera	None
facettera	None
kranar	Plural
värmebehandlad	None
passade	None
folkrättens	Singular
klarade	None
axelvadds	Singular
ty	None
okinawianskans	Singular
trädkronornas	Plural
underskattat	Singular
initiativtagarna	Plural
semifinalernas	Plural
betygsätter	None
positron	Singular
piercingen	Singular
hjulgrävarna	Plural
startade	None
ministeriet	Singular
brorson	Singular
hanarnas	Plural
svarandens	Singular
stenar	None
förfarna	Plural
utrymts	None
klagar	None
centrerar	None
medgrundaren	Singular
modigaste	Singular
improviserade	None
kapsylöppnarens	Singular
förbundit	None
tippar	None
späde	Singular
fåfängans	Singular
memorera	None
visningarna	Plural
väsendet	Singular
författningens	Singular
överskuggades	None
separerades	None
standarder	Plural
fågelskådaren	Singular
överansträngts	None
ulven	Singular
visning	Singular
ratas	None
försiktige	Singular
beskådande	None
gatumusikanter	Plural
tigit	None
naturvården	Singular
offra	None
vetenskapsakademierna	Plural
rymd	Singular
fockade	None
trefots	Singular
dödsdag	Singular
förmörkelser	Plural
startsnöres	Singular
förvirrat	None
anlända	Plural
avkomma	Singular
kratrarna	Plural
vektorer	Plural
nationsflagga	Singular
slö	Singular
fixeras	None
pensionera	None
skjulet	Singular
renderas	None
brandmannen	Singular
twittrats	None
övervaras	None
plagiatet	Singular
förlåtit	None
sudda	None
anvisande	None
piruetternas	Plural
oppositionsledaren	Singular
fotsula	Singular
utvecklingsarbetenas	Plural
ladusvalan	Singular
snöade	None
golfklubbens	Singular
kastanjen	Singular
brandstationen	Singular
socialförsäkringar	Plural
krossad	None
2-öringens	Singular
banderollen	Singular
jagad	None
webbplatsens	Singular
huvudkällor	Plural
knycker	None
pärlugglors	Plural
hävdas	None
förtvivlande	None
croissanterna	Plural
öbon	Singular
flegman	Singular
axelryckningarna	Plural
applicera	None
glaselektricitets	Singular
selektivt	Singular
återförsäkrar	None
profileras	None
sattpå	None
utgåva	Singular
persikoträdet	Singular
vakansernas	Plural
kulturområdet	Singular
skärtorsdagen	Singular
pacifister	Plural
skeppsredaren	Singular
samspelat	None
metaforen	Singular
kartografiska	Plural
knivskära	None
broschernas	Plural
kapitäler	Plural
bildstodens	Singular
oförskämdheter	Plural
inhemske	Singular
digitaliseringen	Singular
geologer	Plural
kloreras	None
explodera	None
operatörsansvars	Singular
spontana	Plural
webbplatser	Plural
ribborna	Plural
sälgen	Singular
vederlagslösa	Plural
rymden	Singular
gratulationen	Singular
kommunikationerna	Plural
kära	Plural
förfogade	None
hållbart	Singular
upprättar	None
arenans	Singular
begrundar	None
förteckningen	Singular
googlande	None
konsumenternas	Plural
misstroddes	None
åkerstycke	Singular
besiktigas	None
sjöfararens	Singular
egoism	Singular
inslaget	Singular
injektioner	Plural
önskelistan	Singular
högande	None
enzymet	Singular
lösta	Plural
landskommuns	Singular
termonukleär	Singular
platoniska	Plural
backades	None
tryckeris	Singular
fotbollsligans	Singular
urskilde	None
skyddats	None
smycken	Plural
opererat	None
agnar	None
fotonen	Singular
jagande	None
konundrumet	Singular
adiabatiskt	Singular
rigg	Singular
minderåriga	Plural
medveten	Singular
storleksordningar	Plural
davnande	None
ollon	Singular
ferromagnetiskt	Singular
zappad	None
tidige	Singular
presenterades	None
neurologernas	Plural
springs	Singular
töntarna	Plural
dienens	Singular
informatören	Singular
strategin	Singular
dalsänka	Singular
våldsammaste	Singular
heta	Plural
reagerat	None
nakne	Singular
axiomet	Singular
förarbetets	Singular
amfora	Singular
flodhästarnas	Plural
oskrivna	Plural
influerande	None
utbildningsministern	Singular
fallerat	None
struket	Singular
efterrätten	Singular
kalendrarnas	Plural
bombarderat	Singular
husrannsakningsorders	Singular
nunnan	Singular
förkortningar	Plural
vurmande	None
förfaranden	Plural
skärmdump	Singular
truckarna	Plural
dokumenterades	None
cyklonerna	Plural
torteras	None
samiskan	Singular
vulgärt	Singular
kirrad	None
huvudkontoren	Plural
minimerades	None
läses	None
glasögon	Plural
klarinettens	Singular
fagotten	Singular
återvanns	None
immigrationen	Singular
absolutismen	Singular
moskén	Singular
flugen	None
differentialekvation	Singular
utvärderingen	Singular
ansatserna	Plural
tolvorna	Plural
flykthastigheten	Singular
vardaglig	Singular
återförsäkrat	None
menuetten	Singular
styrutrustning	Singular
fruktansvärd	Singular
släckts	None
krediterade	None
kulspetsen	Singular
tillträds	None
redaktion	Singular
raffinera	None
rebellen	Singular
bakterierna	Plural
nådegåvor	Plural
luktad	None
platonisk	Singular
menuett	Singular
strömkällor	Plural
orena	Plural
kilometerns	Singular
kommitténs	Singular
husmödrar	Plural
trävaror	Plural
fyr	Singular
sajter	Plural
petas	None
åstadkommit	None
nådegåvors	Plural
följd	None
löses	None
inslagen	Singular
förnyad	None
försvarad	None
legitime	Singular
uppgått	None
assyriskans	Singular
konkursar	None
vall	Singular
azerer	Plural
persiskan	Singular
gäspande	None
spenderas	None
stortåns	Singular
gestaltad	None
distanseras	None
hospitalens	Plural
justisen	Singular
pojkvännernas	Plural
räkningarna	Plural
fyrhörning	Singular
grundlagts	None
stimulerade	None
privatskolan	Singular
prenumererad	None
maktkamper	Plural
avsett	Singular
godkännande	None
ursinnigt	Singular
avfarter	Plural
kvadranten	Singular
parabler	Plural
nyaste	Singular
trädgårdsstaden	Singular
pastorer	Plural
dubbelklickats	None
lanternan	Singular
omnämnandes	Singular
släpas	None
pyramidens	Singular
ägnade	None
utarmat	None
krossas	None
vräktes	None
mjukvarans	Singular
tillgodogöras	None
subventioneras	None
bluffat	None
reciterande	None
marksubstansers	Plural
ringmärkningen	Singular
tribunalens	Singular
företrädets	Singular
avgick	None
kvoters	Plural
avse	None
instängd	Singular
cheviotens	Singular
sysselsätts	None
betalas	None
skomakarens	Singular
adepten	Singular
distribuerad	Singular
nedsatte	None
kamera	Singular
arbetsmarknaders	Plural
handleders	Plural
simpla	Plural
egyptologen	Singular
hopa	None
margariner	Plural
bestämde	Singular
cyklopropan	Singular
dekretera	None
julgransplundring	Singular
transparensens	Singular
örtteerna	Plural
centrifug	Singular
glömde	None
rötan	Singular
känslokalla	Plural
relative	Singular
fruktats	None
asps	Singular
förföll	None
odets	Singular
rånad	None
curry	Singular
kvittat	None
lindrade	None
tunnbrödsrulle	Singular
fastigheter	Plural
ukrainskt	Singular
oscillationer	Plural
hämtades	None
krigsorganisation	Singular
besiktning	Singular
normering	Singular
alkov	Singular
terapeutisk	Singular
svartnande	None
jämställer	None
spenderats	None
signalerade	None
stigman	Plural
rymdfärjor	Plural
gillar	None
prioriterades	None
beställningen	Singular
hospitalets	Singular
elektromagnet	Singular
resurser	Plural
förändrad	Singular
tonas	None
ättlings	Singular
förstörde	None
statschef	Singular
brygd	Singular
nedsättningarna	Plural
thymusars	Plural
optimeringen	Singular
produktions	Singular
julgransplundringen	Singular
stavats	None
gudinna	Singular
åtnjut	None
fabrikaten	Plural
kategoriseras	None
chilins	Singular
glädjens	Singular
terapeuters	Plural
planering	Singular
associerades	None
riksföreningarna	Plural
svavelväte	Singular
förvarat	None
getingarnas	Plural
halvöar	Plural
invertera	None
plöjt	None
befriad	Singular
amfiteatern	Singular
besvaras	None
ekosystemet	Singular
huvudsakens	Singular
crescendo	Singular
omstrukturerats	None
läppstiftet	Singular
ymniga	Plural
bistådd	None
mänsklig	Singular
sälgarnas	Plural
scouts	Singular
gäspat	None
suddade	None
kulturinstitutioner	Plural
parad	None
lyriken	Singular
alpen	Singular
klumpen	Singular
alléer	Plural
vinterspelen	Plural
förmått	None
förtryckets	Singular
konstruktionsteknikens	Singular
mordiska	Plural
ångpannorna	Plural
ursäktats	None
hormon	Singular
talesmän	Plural
mellanfolklig	Singular
puma	Singular
medvursts	Singular
kammarrättspresidents	Singular
ålen	Singular
nalle	Singular
gulna	None
städats	None
vindruvan	Singular
profetiorna	Plural
avgränsas	None
klistret	Singular
pansaret	Singular
pedagogiken	Singular
rusar	None
grupperingarna	Plural
ejakulationen	Singular
partiellt	Singular
empatiskt	Singular
zebran	Singular
torkad	Singular
parvisa	Plural
hjärnhalvan	Singular
mobiltelefoner	Plural
sola	None
bly	Singular
thailändska	Singular
arkitekturerna	Plural
tampen	Singular
tryckfrihetsförordningen	Singular
narvalar	Plural
överskred	None
racingbanor	Plural
kaviarens	Singular
bedöms	None
julgransfot	Singular
bitsocker	Singular
spräckte	None
snutar	Plural
ismassor	Plural
vitryssens	Singular
arbetsliv	Singular
prövningarnas	Plural
diskursivt	Singular
referenser	Plural
överenskommas	None
guvernör	Singular
producerad	None
samlat	Singular
presentationens	Singular
transistors	Singular
punktlistan	Singular
elektrifierades	None
slagits	None
solidariteten	Singular
sponsors	Singular
genererats	None
nedförsbackar	Plural
sylten	Singular
förvåning	Singular
sockenstämmorna	Plural
graviditeternas	Plural
näcka	None
eskimåerna	Plural
påvisad	None
löjen	Plural
lunginflammationer	Plural
stack	Singular
hökens	Singular
inställas	None
brevduvor	Plural
armerats	None
partistyrelsens	Singular
genomslaget	Singular
identifierades	None
dagstidningars	Plural
saxofonister	Plural
tjurfäktningars	Plural
utomjordings	Singular
ansvarsområdet	Singular
empatisk	Singular
förgätmigejers	Plural
riksarkivet	Singular
sorteras	None
vristerna	Plural
bandledaren	Singular
undkommen	None
byggsätten	Plural
artilleriet	Singular
infarter	Plural
ämnesrådet	Singular
uppvaktat	None
grusbanorna	Plural
legitimera	None
domkyrkor	Plural
skyldra	None
alkemisterna	Plural
ökad	Singular
ljug	None
styvföräldrars	Plural
evigt	Singular
överflödigt	Singular
brödskrivaren	Singular
yra	Plural
beviljar	None
moped	Singular
jämförd	Singular
befalla	None
realskolor	Plural
improviserande	None
pitt	Singular
storkar	Plural
säljer	None
regeringskansliet	Singular
firar	None
naglars	Plural
luktar	None
prostarna	Plural
hungers	Singular
värderingsförmågas	Singular
skruven	Singular
kampanjerna	Plural
optimering	Singular
församlad	None
stendövt	Singular
signerat	None
elektricitets	Singular
LP-skiva	Singular
vinkats	None
begär	None
armén	Singular
problematiserar	None
ärtan	Singular
strålarna	Plural
absorberades	None
stängde	Singular
sömnapnés	Singular
brisers	Plural
varaktig	Singular
diskvalificera	None
intressesfär	Singular
förvaltades	None
kinesiskans	Singular
rederierna	Plural
förskjutit	None
vått	Singular
slopar	None
länsrätter	Plural
kvällstidningen	Singular
vänlig	Singular
allmännyttigt	Singular
sökta	Plural
oktagonens	Singular
enhetscirkels	Singular
eftertext	Singular
spindlar	Plural
avvikelser	Plural
olivträdet	Singular
fulaste	Singular
joniskt	Singular
dekorerats	None
bronsmedaljers	Plural
ansågs	None
utnämningen	Singular
kulturverksamheten	Singular
tunnelns	Singular
åttiondels	Singular
snar	Singular
bemöda	None
kammarrättspresident	Singular
behöriga	Plural
dogmatiska	Plural
årtusendes	Singular
tysthets	Singular
följ	None
bojkotters	Plural
tornugglan	Singular
biltvättarnas	Plural
ackompanjerad	Singular
praktiske	Singular
mikro	Singular
diskuterande	None
mikron	Singular
konfigurerade	None
funderas	None
psalm	Singular
surdegar	Plural
armbandsuret	Singular
pagoden	Singular
astrolog	Singular
nederländsk	Singular
däggdjuren	Plural
dömda	Plural
femmorna	Plural
sångbok	Singular
transmission	Singular
dialogen	Singular
astronauten	Singular
radikala	Plural
operatörs	Singular
kartografer	Plural
ackumulerat	Singular
lövgroda	Singular
elektronen	Singular
förstatligad	None
sabbat	Singular
brandvägg	Singular
införande	None
nationalbibliotekets	Singular
akrobat	Singular
dockat	Singular
årgång	Singular
signalementen	Plural
förstått	None
lexikografis	Singular
manifesterade	None
kortvågs	Singular
ungdomsförbunden	Plural
diskad	Singular
knackande	None
brottad	None
serpentiner	Plural
förleda	None
grävskopor	Plural
konvojen	Singular
laggat	None
blankar	None
motivering	Singular
sjuor	Plural
hovrätter	Plural
hamstra	None
lösnings	Singular
superstjärna	Singular
reparerar	None
kroatiskas	Singular
exilen	Singular
korsning	Singular
värdera	None
handflata	Singular
utbytande	None
bigamin	Singular
igenkännings	Singular
trävaruindustri	Singular
utställande	None
ockupation	Singular
hjorten	Singular
distribuerades	None
prisas	None
argumenterats	None
tryckfriheten	Singular
aktiverad	Singular
araben	Singular
ingånget	Singular
företrädet	Singular
tillhöriga	Plural
ministerrådet	Singular
allmänt	Singular
förpliktelser	Plural
förvaltas	None
andlige	Singular
motverkande	None
avgasers	Plural
fungerat	None
omformulerad	None
bränderna	Plural
baksäte	Singular
nordanvinden	Singular
sponsrad	None
lyxiga	Plural
raggmunk	Singular
undertecknade	None
pizzan	Singular
jordmassor	Plural
gepardens	Singular
femkronorna	Plural
gardiners	Plural
målad	Singular
trefot	Singular
prekariat	Singular
kartlagd	None
glött	None
polisonger	Plural
korsfästs	None
miljonärs	Singular
svarvas	None
faste	Singular
gräsligt	Singular
algoritmen	Singular
myriaden	Singular
trakasserande	None
fågelinfluensan	Singular
teckna	None
lingvistiska	Plural
utökas	None
återförsäkrade	None
täkter	Plural
radiator	Singular
konfigurerades	None
imperfekten	Plural
tittarsiffran	Singular
neptunium	Singular
artbestäms	None
medelklassens	Singular
pensionerades	None
rövande	None
provade	None
svarven	Singular
byteshandel	Singular
desinformation	Singular
kommatecknet	Singular
parameter	Singular
donade	None
retronym	Singular
krisinformation	Singular
förgät	None
husans	Singular
pendeln	Singular
periodvis	Singular
skalven	Plural
brottning	Singular
blinkande	None
barnmorska	Singular
bergartens	Singular
golfbanan	Singular
rapphönors	Plural
beundrat	Singular
meteorologiska	Plural
länsledningar	Plural
ringmärkning	Singular
katodstrålarnas	Plural
bultarna	Plural
lånorden	Plural
erfarne	Singular
skörlevnaden	Singular
surjektioner	Plural
disputerades	None
slovenskt	Singular
luftballong	Singular
kärrings	Singular
pingviner	Plural
runa	Singular
tiondelar	Plural
principalens	Singular
australiska	Singular
förlorad	None
kantonerna	Plural
ödmjukaste	Singular
mödosamt	Singular
klistrade	None
allergis	Singular
upprättad	None
förarbete	Singular
esplanaden	Singular
svågrar	Plural
farmarliga	Singular
distribuerats	None
trädgårdsstäder	Plural
försänkte	None
extraknäckens	Plural
årtalet	Singular
guldmedaljer	Plural
spikar	None
testad	None
vattenmeloners	Plural
satsar	None
negligéns	Singular
ockupationerna	Plural
grytt	None
upprätta	None
insekt	Singular
cyklotronen	Singular
läsande	None
lysin	Singular
slaktas	None
släktens	Plural
berömmer	None
korallen	Singular
bulgar	Singular
bordell	Singular
jugoslavisk	Singular
rappad	None
trombocyter	Plural
erövrades	None
dugligt	Singular
jordägarna	Plural
underhållas	None
proffset	Singular
singlar	Plural
imperativen	Plural
svara	None
åtel	Singular
raggad	None
sädesärlans	Singular
summerades	None
videor	Plural
nätverkens	Plural
skriken	None
länsstyrelsernas	Plural
kapitalist	Singular
handböckerna	Plural
bollklubbars	Plural
isometriskt	Singular
nikotin	Singular
ulv	Singular
lemurerna	Plural
beviljandegraden	Singular
vingårdens	Singular
basun	Singular
klorets	Singular
gäddor	Plural
adepter	Plural
återförsäkra	None
åtnjöts	None
adressat	Singular
långsidan	Singular
övergick	None
flyga	None
upptiderna	Plural
konstapel	Singular
göken	Singular
domstol	Singular
spårbunden	Singular
amhariska	Singular
undervisas	None
ställen	Plural
marknadsförts	None
anakondor	Plural
svartskjortors	Plural
decenniums	Singular
förordnandet	Singular
anteckningsboken	Singular
vidgats	None
kartlade	None
algebraiska	Plural
valde	Singular
sommarstugan	Singular
ymnig	Singular
bragdernas	Plural
nagels	Singular
erkännas	None
segra	None
bostadsförhållandena	Plural
försvarsmakten	Singular
akta	None
saftigt	Singular
debile	Singular
utarmande	None
kallna	None
örngottens	Plural
infogningen	Singular
helige	Singular
kemikaliernas	Plural
avancerar	None
satelliterna	Plural
bottenkvarkarnas	Plural
orkande	None
övningsflygningarnas	Plural
bakelse	Singular
surjektiv	Singular
mobiliserade	None
resvagnarnas	Plural
israeliskorna	Plural
pung	Singular
drogens	Singular
fräser	None
lånets	Singular
dinarer	Plural
underhållen	None
substanserna	Plural
faraonerna	Plural
nekas	None
ramlag	Singular
konselj	Singular
butikskedjas	Singular
hyveln	Singular
enkrona	Singular
portugisiske	Singular
slädens	Singular
obebodd	Singular
bärnstenen	Singular
tillgängliggjordes	None
huvudägaren	Singular
firad	Singular
översätts	None
livsmedelsbutikers	Plural
oxen	Singular
spår	None
dissekera	None
partimedlemmen	Singular
pubs	Singular
vabbade	None
ätet	Singular
adamsäpple	Singular
valresultaten	Plural
klorid	Singular
nyfiken	Singular
rutschkanor	Plural
egyptierna	Plural
besittande	None
hamstring	Singular
kapat	None
husvagnar	Plural
fasetterar	None
anförarna	Plural
skyfallen	Plural
redigeringskrigande	None
avgjorts	None
tråddragarens	Singular
stjälpte	None
båtat	None
trafikolyckan	Singular
himlakropparnas	Plural
förutsägbara	Plural
applicerats	None
tryta	None
ersatts	None
förlåts	None
skifts	Singular
vicekonsuln	Singular
asparaginsyra	Singular
översågs	None
sexhörningar	Plural
privatlivet	Singular
mineralogiers	Plural
subventionerad	None
kortat	None
uträttat	None
droppen	Plural
tetraedern	Singular
katedralskolan	Singular
treenigheternas	Plural
väldiga	Plural
folkhälsans	Singular
skamlig	Singular
graverat	None
kreaturens	Plural
testats	None
croissanten	Singular
kassaskåpens	Plural
kvasarerna	Plural
autonomi	Singular
syende	None
svavelsyran	Singular
predikande	None
berörs	None
granskningsnämnden	Singular
klusilerna	Plural
bläddrade	None
dvärgstjärnornas	Plural
blekarnas	Plural
säkringar	Plural
nyckelpiga	Singular
uppställt	None
skolkamraterna	Plural
containerns	Singular
svängde	None
egnahemmets	Singular
agrara	Plural
liftaren	Singular
glutamin	Singular
spörja	None
metanols	Singular
fornnordiskans	Singular
genvägen	Singular
