Tierschützers	Genitive
Metallgittern	Dative
denunzierten	None
Muttergesteins	Genitive
Waldkauzes	Genitive
Fingerknöcheln	Dative
Onkels	Genitive
Speichereiweißes	Genitive
katapultiert	None
Tragflügelbooten	Dative
wetteifern	None
Einwanderers	Genitive
Snaresinselpinguinen	Dative
Nachzüglern	Dative
ejakuliert	None
Fotoempfängers	Genitive
Umständen	Dative
Beinen	Dative
Kaffeeweißers	Genitive
rödeln	None
manipulierte	None
Geschöpfes	Genitive
Vorfällen	Dative
Hammerhaien	Dative
Segelflugzeugen	Dative
umarmtet	None
Risses	Genitive
picknicke	None
rutsch	None
Auslösers	Genitive
Bezirksausschusses	Genitive
Leierschwanzes	Genitive
Fünftels	Genitive
Feinden	Dative
fotografierten	None
Dortmundern	Dative
Verwaltern	Dative
beäugen	None
Kriegszustandes	Genitive
Unterseebooten	Dative
Ovaren	Dative
Kursbuches	Genitive
Lätzchens	Genitive
Toypudels	Genitive
Weltfriedens	Genitive
Bäuchen	Dative
Kauzes	Genitive
fiep	None
Beitels	Genitive
Landräten	Dative
roste	None
Bundestrainers	Genitive
Gefäßen	Dative
steinigen	None
Honoraren	Dative
Endprodukten	Dative
Molochen	Dative
Spaniers	Genitive
Episkopates	Genitive
Mittwochabends	Genitive
einreichen	None
Auszuges	Genitive
Reismehlen	Dative
glitt	None
Motivs	Genitive
drillest	None
Sünders	Genitive
Magistrats	Genitive
Arabers	Genitive
Rangierbahnhöfen	Dative
verformt	None
begründen	None
Zeitpunkten	Dative
verliebst	None
Ritters	Genitive
Trainern	Dative
Zytochromen	Dative
Mischlingen	Dative
Ersuchens	Genitive
Abschlüssen	Dative
beschimpft	None
enttarnest	None
Grizzlybär	Nominative
Kaisern	Dative
erfolge	None
bröckeln	None
nachschlagen	None
popp	None
Dirigent	Nominative
schiss	None
Uranerzen	Dative
überprüf	None
jammern	None
lancierten	None
Brecheisens	Genitive
staubt	None
Fruchtsalaten	Dative
Haines	Genitive
Hobeln	Dative
Werdern	Dative
Fakirs	Genitive
Empfanges	Genitive
abbekommen	None
Werkstückes	Genitive
Kelchblättern	Dative
Briefen	Dative
Klägers	Genitive
benötigte	None
Frechdachsen	Dative
versetzte	None
evangelisieren	None
Firmensitzen	Dative
Urwäldern	Dative
Pfarrern	Dative
Zaubern	Dative
Frequenzbereichen	Dative
Experimenten	Dative
Stickstoffatoms	Genitive
Laie	Nominative
Sprösslingen	Dative
Ritualen	Dative
Anionen	Dative
Klons	Genitive
Einsatzorten	Dative
pochiere	None
Kadett	Nominative
Pensionären	Dative
Gewinden	Dative
liebet	None
Abfalls	Genitive
horten	None
Teufeln	Dative
schwing	None
schimpfst	None
Stieres	Genitive
Baumaterials	Genitive
flüchtet	None
Schulterblattes	Genitive
Industriezweiges	Genitive
knutschtest	None
agierst	None
Sprachwandels	Genitive
Hinterhöfen	Dative
Argentiniern	Dative
Asiate	Nominative
Kohlenstoffgehalten	Dative
Armeniers	Genitive
assimiliert	None
Botschaftern	Dative
mauert	None
Hamsters	Genitive
genügen	None
Unpaarhufern	Dative
Unterschiedes	Genitive
Elektroschweißens	Genitive
Asses	Genitive
Proviants	Genitive
Umrissen	Dative
galoppierte	None
Entzuges	Genitive
Bankers	Genitive
Inspirators	Genitive
Gleichnisses	Genitive
Steinbruches	Genitive
Abschlägen	Dative
Beobachters	Genitive
freuen	None
Schreien	Dative
Nennern	Dative
Frühlings	Genitive
Empfängern	Dative
Bienenzüchters	Genitive
Flugkapitänen	Dative
scanne	None
Tetramers	Genitive
Gipfeltreffens	Genitive
Kriminalromans	Genitive
Fragebogens	Genitive
bierten	None
sprengten	None
konsolidieret	None
Gigant	Nominative
Halbmetallcharakteren	Dative
verschmutzt	None
eingegriffen	None
abonnierte	None
Schrägstriches	Genitive
Fürst	Nominative
erwähntest	None
Imbisses	Genitive
Schwimmers	Genitive
Drahtseilen	Dative
Verfahrens	Genitive
Viewporten	Dative
Suiziden	Dative
Gefüges	Genitive
Exzentrikers	Genitive
evakuierten	None
schändete	None
Staubwedeln	Dative
boykottieren	None
Erythrozyt	Nominative
Faches	Genitive
Kleiderstoffes	Genitive
Ruders	Genitive
Verderbens	Genitive
Kopfläusen	Dative
schauspielerst	None
Schmierstoffen	Dative
pumpte	None
Bundesländern	Dative
Mehles	Genitive
Wasserstoffisotopen	Dative
Lorbeerblättern	Dative
Schmucksteinen	Dative
verknallten	None
Isoprens	Genitive
Akteurs	Genitive
destillieret	None
Sesseln	Dative
Freiherr	Nominative
Auslösern	Dative
geraubt	None
Aggregates	Genitive
Kesseln	Dative
Chlorwasserstoffs	Genitive
Adjektives	Genitive
akzeptier	None
Vagabund	Nominative
Loches	Genitive
Fertighäusern	Dative
Bedürfnissen	Dative
Entwicklungslandes	Genitive
argumentieren	None
fokussiertest	None
Fünfers	Genitive
Kämpfers	Genitive
Individuums	Genitive
Söhnen	Dative
Nabels	Genitive
Fotopapiers	Genitive
Anwesens	Genitive
hindert	None
Kilometers	Genitive
Diskurses	Genitive
Kanufahrern	Dative
Nebensatzes	Genitive
hoffst	None
schmeichelt	None
peroxidiert	None
Flussufern	Dative
loben	None
Theologe	Nominative
begrabschst	None
orgele	None
Wenns	Genitive
Felgenbändern	Dative
Atollen	Dative
Bergführers	Genitive
gelandet	None
Todesopfers	Genitive
Befürworters	Genitive
Staatsgebietes	Genitive
Agent	Nominative
hinterlässt	None
verschmutzen	None
Halogeniden	Dative
Berylliumerzen	Dative
Randes	Genitive
trotzet	None
konvertiert	None
Steges	Genitive
Edelmetalls	Genitive
Sturmes	Genitive
Raubwürgers	Genitive
Glasbläsern	Dative
Bilches	Genitive
Grossvaters	Genitive
Nierenversagens	Genitive
überwacht	None
kassiert	None
blamieren	None
scheiden	None
Nerzes	Genitive
Männchens	Genitive
schikanieren	None
Spanners	Genitive
Schabernackes	Genitive
Zobels	Genitive
saunierte	None
Standardwerten	Dative
putztest	None
kühl	None
zerstöre	None
gewundert	None
Kuboktaedern	Dative
Kampfflugzeugen	Dative
Kultes	Genitive
Geschossen	Dative
Halbgottes	Genitive
faschieren	None
Hörnern	Dative
Abschlusses	Genitive
Nichtrauchern	Dative
gegengezeichnet	None
Flusssedimenten	Dative
profitierte	None
Innensenators	Genitive
Ministers	Genitive
Dielektrikums	Genitive
Chirurg	Nominative
Internierungslagers	Genitive
Scheinwerfern	Dative
türmt	None
Falsettes	Genitive
Auslassventilen	Dative
Riesensternen	Dative
Dichtern	Dative
Müllern	Dative
krallt	None
Flors	Genitive
Korridors	Genitive
vernickelte	None
Radikalen	Dative
Elixiers	Genitive
gaff	None
Brennstoffen	Dative
Münchnern	Dative
Duranusits	Genitive
eskalieren	None
klassifizieren	None
tastend	None
Madrigalen	Dative
überprüfst	None
Sichtgeräten	Dative
bezeuge	None
Elektronenpaaren	Dative
Schulleitern	Dative
Fundortes	Genitive
süss	None
Andorraners	Genitive
Vorurteils	Genitive
triebest	None
Fundorten	Dative
Vermessern	Dative
Rauben	Dative
kacheln	None
Einvernehmens	Genitive
Türstehern	Dative
ramponierte	None
unterzog	None
Produktionsländern	Dative
Vertriebes	Genitive
zerlasen	None
abweisend	None
Stromnetzes	Genitive
Gesetzgebern	Dative
Verbrechern	Dative
Magens	Genitive
Anzuges	Genitive
Sizilianern	Dative
Neurotransmittern	Dative
Manövern	Dative
schluckt	None
Anhaltspunkten	Dative
Phosphinen	Dative
Kanoniers	Genitive
Sonntagnachmittagen	Dative
husche	None
Tabletten	Dative
Blütenstiels	Genitive
Kellnern	Dative
vermasselt	None
Pheromons	Genitive
Brutblättern	Dative
Gottesurteilen	Dative
Bilderstürmers	Genitive
untermauerte	None
auftauchend	None
Straßenverkehrs	Genitive
fabulierest	None
Botschafters	Genitive
Fingerhüten	Dative
Ergüssen	Dative
Präsidiums	Genitive
beleidigten	None
Hohlleitern	Dative
Zankapfels	Genitive
Gerüchtes	Genitive
Kampfstoffes	Genitive
Hochstaplern	Dative
Farbfernsehens	Genitive
stornierte	None
Kaliumdichromats	Genitive
Ejakulates	Genitive
ordneten	None
Heilmittels	Genitive
quarze	None
Nasenbär	Nominative
gezeugt	None
ritzend	None
Weltkrieges	Genitive
Schulze	Nominative
Freibriefen	Dative
Saukerlen	Dative
kauerten	None
Absendern	Dative
Abkömmlingen	Dative
wurzeln	None
koppelnd	None
verehr	None
Kirchturmes	Genitive
Schreibtischtätern	Dative
Juniors	Genitive
Ignorant	Nominative
teilend	None
Direktors	Genitive
Strömen	Dative
Akademikern	Dative
masturbierst	None
Selbstversuchen	Dative
Heizers	Genitive
verlangsamen	None
erschöpfe	None
vergewaltig	None
befasse	None
Gebräuchen	Dative
Querschnittes	Genitive
Greisen	Dative
reiben	None
Schweißens	Genitive
Kompasses	Genitive
sickerten	None
Anpfiffen	Dative
Stammlagern	Dative
Sprachkurses	Genitive
verschränkte	None
Äxten	Dative
Kähnen	Dative
erfüllen	None
übertreibst	None
Kaimanen	Dative
geleiteten	None
Stickstoffatomen	Dative
Glückwunsches	Genitive
gewickelt	None
bemächtigten	None
Sulfonen	Dative
Schuldscheinen	Dative
katalogisieren	None
Pudels	Genitive
Industrieländern	Dative
Potentialen	Dative
Hüben	Dative
hinterlasst	None
blubbern	None
paraphrasiertet	None
entnahmen	None
Universums	Genitive
Hühnergottes	Genitive
Steckbriefen	Dative
fertigst	None
Sommerlöchern	Dative
Schicksalen	Dative
schmieden	None
Badezimmers	Genitive
Downers	Genitive
entwendeten	None
Ire	Nominative
enttäuschen	None
Auftragsmörders	Genitive
Reporters	Genitive
Schelmen	Dative
Rituals	Genitive
Futtermitteln	Dative
Nichteisenmetallen	Dative
Briefträgers	Genitive
Anreizen	Dative
Schritttempos	Genitive
Erdrutschen	Dative
Stammes	Genitive
Läusen	Dative
Hunten	Dative
Erlebnisses	Genitive
summe	None
Geschäftsjahren	Dative
Umfeldern	Dative
Katamaranen	Dative
Omens	Genitive
verschlimmern	None
bevölkerte	None
Departementen	Dative
dimerisiere	None
Provokateuren	Dative
Kleinhirnes	Genitive
Blickwinkels	Genitive
Aware	Nominative
verzehrt	None
Lehnwörtern	Dative
Theaterstückes	Genitive
Schäferhundes	Genitive
Ariern	Dative
Peptidhormons	Genitive
Staatsstreichen	Dative
Hirnstämmen	Dative
Crystals	Genitive
zischen	None
Klanges	Genitive
erklärest	None
windend	None
verbauen	None
Knicken	Dative
Informatikers	Genitive
Bannern	Dative
Abteilungsleitern	Dative
Tributen	Dative
Referent	Nominative
Teilchens	Genitive
Dampfschiffes	Genitive
Erlösers	Genitive
Atriums	Genitive
Bienenhauses	Genitive
beurteile	None
Leiharbeitern	Dative
Blutkörperchens	Genitive
Ansatzes	Genitive
Markennamens	Genitive
Rondellen	Dative
sickerte	None
Siegeln	Dative
Pfennigs	Genitive
Türstehers	Genitive
Zuhälters	Genitive
Walzern	Dative
Tänzern	Dative
Flaumes	Genitive
abweisen	None
Henkeln	Dative
Benehmens	Genitive
Autofahrers	Genitive
Brauches	Genitive
Urlaubern	Dative
turn	None
Totschlages	Genitive
ELs	Genitive
Porzellanen	Dative
Kleinwagens	Genitive
Nachschüben	Dative
versuche	None
malst	None
Kompositums	Genitive
Transporters	Genitive
Einsiedlers	Genitive
Pimmels	Genitive
Synonymen	Dative
Augenärzten	Dative
Fremdwörtern	Dative
Grunzens	Genitive
gekappt	None
Pakten	Dative
Präparats	Genitive
annullierte	None
Verbrauchers	Genitive
benachrichtige	None
Ulmers	Genitive
Antisemit	Nominative
fälschen	None
Pfirsichen	Dative
knickt	None
Felsens	Genitive
Gottesbeweisen	Dative
Blutfarbstoffs	Genitive
knickte	None
Halbfinales	Genitive
Sprechens	Genitive
bepflanztest	None
Wipfeln	Dative
Terpineolen	Dative
Namensvetters	Genitive
Gottesdienstes	Genitive
offenbarst	None
Diktators	Genitive
Namensgebern	Dative
Rutherfordiums	Genitive
verlebte	None
Unters	Genitive
vermisstet	None
Nationalsozialist	Nominative
Wahlrechtes	Genitive
Silikaten	Dative
Altwassern	Dative
Genkinits	Genitive
bewertet	None
Fundamenten	Dative
titelt	None
Dodekaeders	Genitive
Einwürfen	Dative
gesprüht	None
Chalkogenidgläsern	Dative
Köppern	Dative
versprödetest	None
Feldzügen	Dative
globalisiert	None
Verstoßes	Genitive
Häretikern	Dative
aase	None
Zuschauers	Genitive
durchzucke	None
Vollwaschmittels	Genitive
Kongressen	Dative
entfernten	None
Widerständen	Dative
ringst	None
Things	Genitive
Kaufmannes	Genitive
Anrufbeantworters	Genitive
schimmert	None
Laubbäumen	Dative
Chören	Dative
Sonntagabenden	Dative
Flaneurs	Genitive
Kugelhaufenreaktors	Genitive
verschweigt	None
Blutkreislaufes	Genitive
Rathauses	Genitive
Höckers	Genitive
flatternd	None
Interpret	Nominative
Buchstabe	Nominative
frottieret	None
Mardern	Dative
Bürzeln	Dative
durchwühltest	None
riffle	None
Rekorden	Dative
Carboxyen	Dative
Milliardstels	Genitive
Basses	Genitive
Flüchen	Dative
Aufschlusses	Genitive
Kaufpreises	Genitive
Biergartens	Genitive
Primfaktors	Genitive
Anfängern	Dative
Gebinden	Dative
Symbols	Genitive
Arbeitsplatzes	Genitive
Kellners	Genitive
Spielzeugen	Dative
Kanzlern	Dative
lenkte	None
Niederschlages	Genitive
Sockels	Genitive
balanciert	None
Schadens	Genitive
Flüssigtreibstoffes	Genitive
wildert	None
spannend	None
Gitarrist	Nominative
Bornes	Genitive
Anstoßes	Genitive
Gütesiegels	Genitive
Alchemist	Nominative
ernährten	None
Nanosystems	Genitive
Rächern	Dative
Wirtschaftswunders	Genitive
koexistiert	None
streckten	None
Geiers	Genitive
Gaspedals	Genitive
vergälten	None
Bezirken	Dative
Wortspielen	Dative
Umsatzes	Genitive
Börgen	Dative
Baldachins	Genitive
Stadtbezirkes	Genitive
Hydrochinonen	Dative
Koordinatensystems	Genitive
gemeißelt	None
Ärgernisses	Genitive
Höchstwerten	Dative
Postfächern	Dative
Anthocyanen	Dative
Scheiterns	Genitive
Baryons	Genitive
Erwachsenenalters	Genitive
Eigenwertproblems	Genitive
Europäers	Genitive
Mäuschens	Genitive
Briketten	Dative
Iranern	Dative
Bergwerken	Dative
Bottichen	Dative
gekippt	None
eröffnen	None
Stadtparlamenten	Dative
Kalibers	Genitive
Schwiegersöhnen	Dative
dämm	None
gelächelt	None
Vorstoßes	Genitive
verrichte	None
Seeigeln	Dative
handelten	None
Briefwechseln	Dative
Heapes	Genitive
Lebensmitteln	Dative
geborsten	None
fusionierte	None
übertreibest	None
laberte	None
buh	None
griffe	None
Dropdown-Listenfeldern	Dative
vertut	None
pfleg	None
Absorbers	Genitive
Tintenfischen	Dative
verübten	None
Krämpfen	Dative
Wärtern	Dative
Schwämmen	Dative
stockt	None
Anträgen	Dative
Verschlüssen	Dative
Wanderfalke	Nominative
Axioms	Genitive
formiert	None
marodierst	None
Erdnüssen	Dative
Bipolartransistors	Genitive
schlurfest	None
gelutscht	None
testete	None
Pestiziden	Dative
Amtsgerichtes	Genitive
annektierte	None
Einflusses	Genitive
Immunsuppressivan	Dative
Dateiname	Nominative
Vorschusses	Genitive
Rechnern	Dative
Ortolans	Genitive
Gewändern	Dative
Rettern	Dative
unterstützte	None
Narkoleptikern	Dative
Sausewindes	Genitive
Amtsträgern	Dative
Mathematikers	Genitive
Afroamerikaners	Genitive
Kurators	Genitive
Lesezeichens	Genitive
Grande	Nominative
missbrauchen	None
Geschichtenerzählers	Genitive
Dickschnabelpinguinen	Dative
Freistaates	Genitive
verdecken	None
Heilbuttes	Genitive
Informant	Nominative
billigen	None
Täufers	Genitive
wappnetest	None
Phosphiden	Dative
korrumpierte	None
eingeschlossen	None
Marktanteils	Genitive
Fensterladens	Genitive
Nachweisen	Dative
Lithiumisotopen	Dative
kröchet	None
respektierten	None
Abbaues	Genitive
Kriegsschiffes	Genitive
kapituliere	None
beeinträchtigend	None
Bremsbelägen	Dative
Reimes	Genitive
Kunststoffen	Dative
Metern	Dative
Gesimses	Genitive
Seiteneinganges	Genitive
Wasserhündchens	Genitive
kritisierst	None
Gitterdefekts	Genitive
Anwendungsgebieten	Dative
entthronte	None
Einkaufszentrums	Genitive
Umlaufes	Genitive
Verstärkern	Dative
Alls	Genitive
Esprits	Genitive
Gegners	Genitive
Kanzlers	Genitive
Luftstroms	Genitive
Bürogebäuden	Dative
Brautkleides	Genitive
Zwirnen	Dative
Geisterstädten	Dative
Höhenunterschieden	Dative
Schauspielen	Dative
Flegeln	Dative
Atolls	Genitive
pharyngalisiertest	None
Sommern	Dative
Altarmes	Genitive
Abszesses	Genitive
Enzianen	Dative
Sportlers	Genitive
Riechstoffes	Genitive
gejagt	None
Pilot	Nominative
bedankte	None
Enterichen	Dative
Farbpigmenten	Dative
Apportierhundes	Genitive
Photons	Genitive
Füllfederhalters	Genitive
Schwätzern	Dative
Sandsteinen	Dative
pauken	None
Supermarktes	Genitive
Stickoxiden	Dative
Erpressers	Genitive
Bargeldes	Genitive
verstärkten	None
Pflanzenstoffen	Dative
weihen	None
Zuschusses	Genitive
Läufen	Dative
Weltmeeren	Dative
Molchen	Dative
würfeln	None
Albträumen	Dative
analysiert	None
Pflastern	Dative
Einstürzen	Dative
probierst	None
gezwängt	None
Akzenten	Dative
Halbkreisen	Dative
Nutzern	Dative
Wassermolekülen	Dative
randalierte	None
Mikrofons	Genitive
begibst	None
Treibern	Dative
eingreifen	None
schmauchte	None
Klavieren	Dative
Einsatzkräften	Dative
Diamantgitters	Genitive
Abrisses	Genitive
exen	None
Egoist	Nominative
Marmoren	Dative
brenn	None
Durchbruches	Genitive
Chromosoms	Genitive
Gleichrichtern	Dative
probiert	None
Bistums	Genitive
Gipfeln	Dative
grüßten	None
separierten	None
Bakteriziden	Dative
segmentierten	None
Weltraumes	Genitive
erwärmten	None
Kernwaffenversuchen	Dative
unterschlug	None
Aminen	Dative
Tiegeln	Dative
Haies	Genitive
Notstandes	Genitive
Penissen	Dative
entkokainisiertest	None
eingegangen	None
Kornettes	Genitive
Scheffeln	Dative
existiere	None
Sedimenten	Dative
Röntgenstrahlen	Dative
gefetzt	None
sichert	None
Zwangsarbeitern	Dative
Statthalters	Genitive
Genkiniten	Dative
Postulaten	Dative
Glasgeräten	Dative
wägen	None
Diesels	Genitive
Rasenmähern	Dative
Spielzeugverkäufers	Genitive
Liedes	Genitive
Köhlers	Genitive
Gottesgnadentums	Genitive
wurde	None
Wasserstoffatomen	Dative
kritzeln	None
betrachteten	None
erkalten	None
verbessernd	None
verhör	None
Gymnasiums	Genitive
Gelen	Dative
Psychothrillers	Genitive
horchte	None
Flugzeugträgern	Dative
Geländern	Dative
Speerwerfers	Genitive
Borwasserstoffen	Dative
Schwertwalen	Dative
nagt	None
entdeckten	None
Hauptwörtern	Dative
Hedonist	Nominative
Prozenten	Dative
Außenministers	Genitive
Muttersprachlers	Genitive
Marktplätzen	Dative
radierest	None
Einverständnisses	Genitive
bereitet	None
gepennt	None
duldete	None
punkteten	None
sperrend	None
Schlegels	Genitive
Abendmahles	Genitive
Kindergeldes	Genitive
erlassen	None
Strichelchens	Genitive
Herausgebern	Dative
Baritons	Genitive
Mineralölen	Dative
Indizes	Genitive
Rückwärtsgängen	Dative
kontrollierte	None
Rosenkriegen	Dative
Brunnens	Genitive
Kugelschreibers	Genitive
Wärmeaustauschs	Genitive
Omnibusses	Genitive
Nickelarsenkieses	Genitive
überfordere	None
Assyrern	Dative
Argyroditen	Dative
Normalen	Dative
Oligopolen	Dative
Kumpeln	Dative
geläppert	None
Leuchtturmes	Genitive
Homodimers	Genitive
demontieren	None
evangelisierte	None
Aggregaten	Dative
Korridoren	Dative
Luftangriffen	Dative
versicherten	None
Arbeitskreises	Genitive
Fernverkehres	Genitive
Funkgerätes	Genitive
Löwe	Nominative
lodern	None
angelt	None
Laufwerken	Dative
domestizieren	None
kalfatern	None
Landstreichern	Dative
ruiniertest	None
kontrahiere	None
Weibchens	Genitive
Mackern	Dative
behinderten	None
tätigen	None
Wurfes	Genitive
duckmäusern	None
flankiertest	None
mildere	None
sichern	None
brate	None
Übertragers	Genitive
Rektors	Genitive
crèmst	None
Kultusministers	Genitive
strahlte	None
Pyrrhotins	Genitive
Plüschen	Dative
Esels	Genitive
Libanese	Nominative
flirrte	None
foul	None
Brandanschlägen	Dative
Schulbüchern	Dative
markierte	None
brandschatzten	None
unterdrücke	None
Silberwangen-Ameisenwürgern	Dative
Dekanen	Dative
Steuerzahlers	Genitive
Binnenlandes	Genitive
kaue	None
Maules	Genitive
Furnieren	Dative
Systems	Genitive
klärte	None
Golfplatzes	Genitive
Rubeln	Dative
Spielen	Dative
Fluoracetaten	Dative
schirmte	None
erübrigen	None
schwirrtest	None
Männleins	Genitive
Rhodochrosits	Genitive
Aachenern	Dative
Verkehrsflugzeugen	Dative
Kons.-Stammes	Genitive
Verhören	Dative
meckertest	None
Alkylresten	Dative
Molybdäniten	Dative
Natriumsalzes	Genitive
Aprilscherzen	Dative
Dealers	Genitive
Dudelsackes	Genitive
Nasenringen	Dative
Grenzwertes	Genitive
Fäustlings	Genitive
verplempernd	None
erleidet	None
ertrüge	None
Datenträgers	Genitive
Sammlers	Genitive
Öltankers	Genitive
vereinfachest	None
Silberbestecken	Dative
Eigentümers	Genitive
beantworteten	None
weigerte	None
Putern	Dative
foulst	None
Ankern	Dative
beschafften	None
Erzählers	Genitive
erhitzte	None
Goldschopfpinguinen	Dative
angeschaltet	None
geizt	None
Eisbrechern	Dative
Sitzes	Genitive
mehrten	None
Fahrgestellen	Dative
Fegefeuers	Genitive
Kühltürmen	Dative
Kristalliten	Dative
Stadtparlamentes	Genitive
Fesselspieles	Genitive
hauste	None
Leichnams	Genitive
Arschlöchern	Dative
Pianist	Nominative
Amoklaufes	Genitive
Mitarbeiters	Genitive
Vorurteilen	Dative
Vespers	Genitive
Mangelsymptomen	Dative
sitzen	None
Mock-Objektes	Genitive
Wiesbadenern	Dative
Druide	Nominative
Arbeitszimmers	Genitive
erdrückt	None
Vorständen	Dative
Durchmessers	Genitive
foltert	None
Martyrologiums	Genitive
Schmierpapieren	Dative
Freibergits	Genitive
Stahlhelmen	Dative
Rauches	Genitive
Illyrern	Dative
Österreichern	Dative
Tangen	Dative
Bauarbeiters	Genitive
Korbes	Genitive
Flippern	Dative
zerrst	None
lehnen	None
dümpelte	None
jubelten	None
reformierest	None
Mangrovenwäldern	Dative
Ölfasses	Genitive
erstatten	None
sparen	None
Augsburgern	Dative
schwelt	None
Panters	Genitive
Verbrechens	Genitive
erbarmt	None
verliebte	None
Magiern	Dative
Kammerjägers	Genitive
Opals	Genitive
Hochaltären	Dative
dramatisieren	None
Satyrs	Genitive
Drache	Nominative
Skriptoriums	Genitive
recherchierst	None
Alkaloiden	Dative
Gebirgen	Dative
kenterten	None
Schleimen	Dative
Planetariums	Genitive
beglich	None
angefasst	None
Allgemeinwissens	Genitive
Korrespondent	Nominative
Beckens	Genitive
Blindenhunden	Dative
duldet	None
Gärtners	Genitive
Kursbüchern	Dative
Trichtern	Dative
Stiefsohnes	Genitive
krachten	None
rekapitulieren	None
Finanzmarktes	Genitive
abgewartet	None
passet	None
Produktvergleichs	Genitive
Schöpfen	Dative
terrorisieren	None
Krämern	Dative
kotend	None
Bundespräsident	Nominative
Geruches	Genitive
töten	None
verpressen	None
Protons	Genitive
Druckwasserreaktors	Genitive
Chlorids	Genitive
Ordens	Genitive
Drillings	Genitive
Pflegern	Dative
akkreditierten	None
Hydrant	Nominative
Rucksäcken	Dative
fochten	None
partitioniere	None
Klatschen	Dative
Bindern	Dative
Eisenwerkstoffen	Dative
Disputes	Genitive
Pantheist	Nominative
Sprengstoffen	Dative
Streifzügen	Dative
Gefäßwänden	Dative
zusammenziehend	None
Hauptinhaltes	Genitive
Breitengrades	Genitive
Rotbarsches	Genitive
vergehen	None
Freudenhäusern	Dative
zuordnen	None
Suboxides	Genitive
Regenwäldern	Dative
interpolierten	None
Staubgefäßen	Dative
Kochtopfes	Genitive
Fallstricken	Dative
Rabatten	Dative
dank	None
Chelatbildners	Genitive
Antriebssystems	Genitive
Marschalls	Genitive
verdreifachten	None
aufnehmen	None
geworfen	None
Dioxiden	Dative
Immigrant	Nominative
Helikoptern	Dative
verwüsten	None
Kosmopolit	Nominative
Rußen	Dative
skizziertet	None
raffinierten	None
versäume	None
Datenblättern	Dative
beamte	None
Homonymen	Dative
favorisieren	None
Chemikers	Genitive
mahle	None
verbleiest	None
Tölpeln	Dative
galvanisier	None
ersteigern	None
reproduzierte	None
Zugriffes	Genitive
Jasminen	Dative
Automatikgetriebes	Genitive
überwältigen	None
Hinterkopfes	Genitive
Stadtvierteln	Dative
Inhalten	Dative
widerlegte	None
beklagt	None
Skarnen	Dative
Oberlandesgerichtes	Genitive
Jüngers	Genitive
kieken	None
Öfchens	Genitive
schwöre	None
Nachlässen	Dative
Umzuges	Genitive
Pflaumensäften	Dative
Freilichtmuseums	Genitive
Schmierblattes	Genitive
Vorbehalten	Dative
Arsentrichloriden	Dative
Freskos	Genitive
Kalbes	Genitive
Untertagebauen	Dative
Esperantist	Nominative
Kerbels	Genitive
boykottiert	None
Schleiern	Dative
Beispieles	Genitive
Aufwandes	Genitive
Schätzen	Dative
Ibissen	Dative
Handelsdefiziten	Dative
stick	None
salzen	None
Lymphsystems	Genitive
Erlkönigs	Genitive
Glücksspieles	Genitive
trocknen	None
begehst	None
Familienmitgliedern	Dative
Phenakiten	Dative
Cermets	Genitive
Minimums	Genitive
Altarmen	Dative
beruht	None
Kriechtieren	Dative
Gewichthebern	Dative
Tempeln	Dative
Wahlgängen	Dative
Schlagzeugern	Dative
Schutzengels	Genitive
beherrschen	None
Satanist	Nominative
Eisennägeln	Dative
Potsdamern	Dative
Milchproduktes	Genitive
konvertiere	None
verurteilen	None
Horten	Dative
Apfelstrudels	Genitive
Dieners	Genitive
Essstäbchens	Genitive
Gerüchten	Dative
platziert	None
Quarzes	Genitive
Deckels	Genitive
rennend	None
Ankömmlingen	Dative
Deist	Nominative
bedeckten	None
Arsabenzols	Genitive
betonten	None
Strohdächern	Dative
Feuerwerkes	Genitive
rupfet	None
konzentrierte	None
Zaddiks	Genitive
Weihers	Genitive
Fressfeinden	Dative
Laubwäldern	Dative
erkundigte	None
Bauherr	Nominative
Funkgeräten	Dative
erscheint	None
individualisieren	None
Gegenständen	Dative
Berichterstatters	Genitive
wedelt	None
variiert	None
bezaubernd	None
Fehlschlages	Genitive
Uhrwerken	Dative
empörte	None
Tibetfüchsen	Dative
Dozent	Nominative
Bigamist	Nominative
Segelschiffes	Genitive
Piemontesern	Dative
Fehlschlägen	Dative
Hirschkäfers	Genitive
Kämmen	Dative
Schmugglers	Genitive
Verlöbnisses	Genitive
Gehörnes	Genitive
Karlsruhern	Dative
Stachels	Genitive
montiert	None
Zaunes	Genitive
Sulfits	Genitive
Taifuns	Genitive
Löslichkeitsproduktes	Genitive
veranlassten	None
Blickfelds	Genitive
Brandenburgern	Dative
Gesamtkunstwerkes	Genitive
Rutheniridosmins	Genitive
Trinkgeldern	Dative
internationalisierten	None
Komponist	Nominative
Klammeraffe	Nominative
Android	Nominative
Kontextes	Genitive
Detektivs	Genitive
kanalisierte	None
erobern	None
Spielautomat	Nominative
Grenzflusses	Genitive
beschimpfen	None
Unterarmen	Dative
Verdiensten	Dative
Albes	Genitive
Sperlings	Genitive
Gesichtsausdrücken	Dative
Ackers	Genitive
Mandelbäumen	Dative
Verteidigungsministeriums	Genitive
Fanatikern	Dative
summierte	None
Verschlusses	Genitive
Unfällen	Dative
erhoffen	None
Kontrollraumes	Genitive
Ariers	Genitive
Gauklern	Dative
Postämtern	Dative
Lüstern	Dative
Nachtmahls	Genitive
erinneret	None
Norwegern	Dative
Epoxiden	Dative
streikten	None
vermutete	None
Identitätsnachweises	Genitive
Einsatzortes	Genitive
Halsabschneidern	Dative
Pharisäern	Dative
Nebenprodukten	Dative
Stockes	Genitive
Dämons	Genitive
privatisierte	None
pulsierend	None
behob	None
rationiert	None
Amtsinhabern	Dative
titeln	None
Säbels	Genitive
entstammend	None
Kiefernwäldern	Dative
unterzeichnete	None
Nachrufen	Dative
entmischt	None
markier	None
Karteikastens	Genitive
Messwerten	Dative
Vergehens	Genitive
Adeliepinguins	Genitive
Axons	Genitive
Infant	Nominative
Ganters	Genitive
Halbmondes	Genitive
säusle	None
Bürgermeisters	Genitive
Provisoriums	Genitive
verschneiden	None
Beschleunigers	Genitive
erholten	None
bekriegen	None
Justizministers	Genitive
wagte	None
protestieren	None
chiffriertet	None
Zyklons	Genitive
entschlosst	None
gewährleistete	None
Fundamentalist	Nominative
ortete	None
Räten	Dative
lockert	None
Mongole	Nominative
Stickstoffmoleküls	Genitive
Fließes	Genitive
Giftes	Genitive
Warzenkopfes	Genitive
radieren	None
grunz	None
Holländern	Dative
Kreationist	Nominative
Geschäftsjahres	Genitive
rege	None
Jahrganges	Genitive
Strandbades	Genitive
Roggenvollkornbroten	Dative
Zeichnern	Dative
schwören	None
Schweinepriestern	Dative
Halbdoppellauten	Dative
Ziegelsteines	Genitive
gehungert	None
Geschäftsbereiches	Genitive
Violinkonzerten	Dative
Antagonist	Nominative
klüngelt	None
ausgeschüttelt	None
Prädialadels	Genitive
Kissens	Genitive
Chloroplast	Nominative
Quirlen	Dative
recyceln	None
wogen	None
streiche	None
Dichtstoffen	Dative
bewarb	None
Prozesses	Genitive
Arbeitspasses	Genitive
Organogermans	Genitive
Adeninen	Dative
Antikörpern	Dative
verdächtigt	None
Verbrauchern	Dative
kapitalisiert	None
erntete	None
Storches	Genitive
Laufens	Genitive
Sarges	Genitive
Loparits	Genitive
ernähre	None
Thiolen	Dative
Ballspielen	Dative
Scherzes	Genitive
Fadens	Genitive
schnitten	None
kupierte	None
Lichtjahren	Dative
Umhängen	Dative
Abflüssen	Dative
Magnetrons	Genitive
Halses	Genitive
Fallschirmspringern	Dative
musterte	None
Maßstabes	Genitive
etabliert	None
Autogramms	Genitive
begründeten	None
Pharisäers	Genitive
Bremsschuhen	Dative
Justizirrtums	Genitive
möpperst	None
Beschusses	Genitive
Flugzeugtriebwerken	Dative
Wellenreihern	Dative
Kontoren	Dative
Abteilen	Dative
Fortgängen	Dative
geziert	None
marschiere	None
Fermions	Genitive
Spannes	Genitive
Augenlides	Genitive
Elektrofahrzeugen	Dative
Halbtönen	Dative
Verbundwerkstoffen	Dative
Luftschiffen	Dative
Feldmäusen	Dative
überrascht	None
Christdemokrat	Nominative
artikulierte	None
Präparaten	Dative
Psalmes	Genitive
Eingeweihte	Nominative
Wahlkreisen	Dative
Gedärmen	Dative
Horizonten	Dative
brütend	None
ringen	None
begegnest	None
Schinkens	Genitive
Instrumentalen	Dative
Magistraten	Dative
Grossvätern	Dative
diffamierte	None
Nukleons	Genitive
Rückgängen	Dative
walze	None
erlöse	None
Maibäumen	Dative
Bundesgerichtshofes	Genitive
Töpfen	Dative
kassier	None
Lagerfeuers	Genitive
berechnet	None
aufwachen	None
Giftschränken	Dative
geschehen	None
Distriktes	Genitive
Wohltäters	Genitive
Arsenikessers	Genitive
Mannheimers	Genitive
Diadems	Genitive
Kampfspielen	Dative
Quadrant	Nominative
Klient	Nominative
Knurrhähnen	Dative
Passagierschiffen	Dative
horch	None
Sprachteiles	Genitive
umhüllen	None
Agnostikern	Dative
Bazziten	Dative
Distibans	Genitive
gesprengt	None
Chymikers	Genitive
Skifahrers	Genitive
sprudle	None
bevölkert	None
Untern	Dative
nennt	None
kamst	None
Temperamenten	Dative
kompensiertet	None
gemeckert	None
Ladern	Dative
nummerierend	None
Dämmen	Dative
Wohnzimmern	Dative
Geplauders	Genitive
Zirkels	Genitive
erkundigen	None
Kriegsendes	Genitive
Schattenspielen	Dative
Prangern	Dative
begrenzend	None
Gewichtsprozenten	Dative
Apothekers	Genitive
Aneurysmas	Genitive
Butylalkohols	Genitive
entwich	None
Sandgüssen	Dative
Endproduktes	Genitive
tränest	None
Atoms	Genitive
Fernstudiums	Genitive
verschiebt	None
Fleets	Genitive
käbbelst	None
Fußballers	Genitive
Zweiges	Genitive
Kontrapunktes	Genitive
Vermögens	Genitive
anstellend	None
versäumten	None
Lunden	Dative
Lurchen	Dative
regele	None
Wirtschaftsministers	Genitive
Bauxits	Genitive
Erdgasen	Dative
Schüben	Dative
erwischen	None
ficht	None
Seiles	Genitive
Orchesters	Genitive
Geschehens	Genitive
Messwertes	Genitive
Suizides	Genitive
Missverständnissen	Dative
Selenit	Nominative
Käfigen	Dative
Kliffs	Genitive
Zügels	Genitive
entstammte	None
Stadtviertels	Genitive
Wirtschaftsministeriums	Genitive
Wirkstoffen	Dative
Sprechers	Genitive
Beichtvaters	Genitive
Vormittagen	Dative
Knotens	Genitive
betoniert	None
entsprangen	None
Reaktorunfalls	Genitive
Knäueln	Dative
Halogenwasserstoffen	Dative
patrouillier	None
ärgere	None
nütz	None
Mädchenname	Nominative
Ökonom	Nominative
Zivilist	Nominative
Inventaren	Dative
Produktionsmitteln	Dative
Antitranspirants	Genitive
Giftschrankes	Genitive
Inbegriffen	Dative
Herrschers	Genitive
Eckzähnen	Dative
lanciert	None
Meeresfischen	Dative
chill	None
Kurzschlusses	Genitive
Nebenflüssen	Dative
bewahrt	None
stürmet	None
Sängerfesten	Dative
spinnen	None
knipsen	None
Basstölpeln	Dative
Pentagramms	Genitive
kühlend	None
Glühstrümpfen	Dative
beklagte	None
beflügeln	None
Untergangs	Genitive
Gestirnen	Dative
Aushanges	Genitive
Pencen	Dative
Arzneimittelgesetzes	Genitive
schiesst	None
Charakters	Genitive
Speichern	Dative
Retters	Genitive
schaufeln	None
versorg	None
Spitzenreiters	Genitive
Kirchhofes	Genitive
Dobermannes	Genitive
Penisknochens	Genitive
umkehren	None
zensieren	None
geklatscht	None
Elementes	Genitive
Karthagern	Dative
entwürfen	None
Schädeln	Dative
läppert	None
Domizils	Genitive
Nähten	Dative
Sulfosalzes	Genitive
gestikulieret	None
dividierten	None
Platzhaltern	Dative
Bürgerhausern	Dative
Thiocyanaten	Dative
Backblechen	Dative
Gastarbeitern	Dative
Phenolen	Dative
Magisters	Genitive
Losen	Dative
Frosches	Genitive
Banketten	Dative
Blattläusen	Dative
Azteke	Nominative
verlagern	None
Fruchtfleisches	Genitive
Garant	Nominative
Berichtswesens	Genitive
verweilte	None
orientierest	None
Granatäpfeln	Dative
briet	None
Kreuzzeichens	Genitive
Armenhäusern	Dative
Kleintieren	Dative
Beistandes	Genitive
eskalierte	None
Antialkoholikern	Dative
verstärkt	None
Diplomen	Dative
Stückes	Genitive
Knochens	Genitive
Lübeckern	Dative
Administrators	Genitive
Haftbefehlen	Dative
Wirtschaftszweiges	Genitive
brennt	None
geklaut	None
Marktplatzes	Genitive
schleim	None
Affenbrotbäumen	Dative
Wandgemälden	Dative
Staatsbürgern	Dative
Apostrophen	Dative
Beraters	Genitive
Chlorophylls	Genitive
bezeugte	None
verklärt	None
Kirschbäumen	Dative
glasierten	None
Ausbünden	Dative
gediehen	None
Kaiserreiches	Genitive
Elfe	Nominative
Gärtnern	Dative
negieren	None
Loten	Dative
Reitpferdes	Genitive
Griffeln	Dative
Tubist	Nominative
Handbuchs	Genitive
adressierte	None
vertritt	None
Erzbischöfen	Dative
Prügelknabe	Nominative
Erzkanzlern	Dative
Würfelspieles	Genitive
Apfelsinenbäumen	Dative
Auskünften	Dative
Dividend	Nominative
erkaltete	None
Deserteurs	Genitive
Kamacits	Genitive
gerinne	None
reih	None
Oberlandesgerichten	Dative
abgeschlossen	None
enttäuschten	None
Jagdbombers	Genitive
Manteltieren	Dative
Rudern	Dative
Asthmas	Genitive
Wuchers	Genitive
Urinals	Genitive
vermenschlicht	None
manipulierst	None
Fluids	Genitive
Hammerhaies	Genitive
verfingt	None
fotografieren	None
Buckelwalen	Dative
Hunne	Nominative
Bergsteigers	Genitive
Nichtmetallen	Dative
Gewässern	Dative
Gepäckträgern	Dative
Triglyceriden	Dative
schüttelt	None
gleichen	None
verjagt	None
Lokführers	Genitive
Blutgefäßes	Genitive
Haushaltes	Genitive
Kontaktes	Genitive
Zitaten	Dative
Gersdorffits	Genitive
verführe	None
gehorchten	None
Sicherheitsdienstes	Genitive
Homologen	Dative
überfällt	None
Sehern	Dative
strickt	None
kompensieren	None
Schimmelpilzen	Dative
Fotoapparaten	Dative
Kontors	Genitive
Axiomen	Dative
erstaunen	None
Katalysatorgiftes	Genitive
Doktorvaters	Genitive
Aushelfers	Genitive
steigern	None
Arsenalen	Dative
Tausendschönen	Dative
schwadronierte	None
verkacket	None
Dampfschiffen	Dative
Broterwerbers	Genitive
Fahrern	Dative
Befehlen	Dative
Hindernissen	Dative
überschritt	None
Altersunterschiedes	Genitive
Sattlers	Genitive
Halophyt	Nominative
duftend	None
Wirbeln	Dative
Aromastoffen	Dative
Nahkämpfen	Dative
massakrierten	None
Raubüberfällen	Dative
Einschlüssen	Dative
deal	None
liquidiert	None
Erdbebens	Genitive
Dokumenten	Dative
gesäuselt	None
Winterzaubers	Genitive
Wirkungsquerschnitten	Dative
Scheffels	Genitive
Stieles	Genitive
Arbeitskreisen	Dative
Interessent	Nominative
Implantaten	Dative
wacht	None
entrichtete	None
Fasses	Genitive
hinterließen	None
Hartungs	Genitive
bedauern	None
Gummistiefeln	Dative
Juwelieren	Dative
erscheinen	None
Kännchens	Genitive
gebrauchten	None
Chromophors	Genitive
Eisenarseniden	Dative
Renderern	Dative
Saxophons	Genitive
Schulbuchverlages	Genitive
Melanterits	Genitive
schälen	None
Flugzeugmutterschiffen	Dative
Einträgen	Dative
empfahl	None
Kühlschmierstoffen	Dative
Imperators	Genitive
Winzern	Dative
Kaufhauses	Genitive
Archivars	Genitive
Fönen	Dative
Mastern	Dative
vernichten	None
Röhrchens	Genitive
Epitaphs	Genitive
bejagend	None
schwächten	None
Spektroskops	Genitive
Spaßes	Genitive
Wischen	Dative
grünst	None
verschlechtere	None
schult	None
klaffest	None
stiehlt	None
Schwabe	Nominative
schimmelt	None
Bündnissen	Dative
querten	None
Kreiseln	Dative
Braunbär	Nominative
Busses	Genitive
Aufenthalts	Genitive
verfasse	None
Gründern	Dative
plädiert	None
hasstet	None
verabredet	None
Alterungsprozesses	Genitive
Flugzeugträgers	Genitive
Stempels	Genitive
Hafenmeistern	Dative
Weißweinen	Dative
Eierkuchens	Genitive
Erzeugers	Genitive
beteiligte	None
Autobussen	Dative
Weinfässern	Dative
Maaten	Dative
Baches	Genitive
gepachtet	None
Schmucken	Dative
bahn	None
Schade	Nominative
Sportwettkämpfen	Dative
mobilisierten	None
verschlang	None
verschonen	None
regulierend	None
Nachname	Nominative
Zugriffen	Dative
Kalifats	Genitive
Rennpferdes	Genitive
Sportlerherzens	Genitive
Gecks	Genitive
Organes	Genitive
absolvierend	None
defiliere	None
reibet	None
bevorzugte	None
Nanometers	Genitive
geheiratet	None
foule	None
Spieltags	Genitive
erlitt	None
Turnieren	Dative
Astronom	Nominative
Autoklav	Nominative
interessierte	None
Geizen	Dative
Imperiums	Genitive
verfliege	None
Libyern	Dative
Erzeugern	Dative
Oldtimers	Genitive
trauend	None
fixiert	None
Sockeln	Dative
Hausschafen	Dative
Redoxpotentialen	Dative
Verständnisses	Genitive
Streckenverläufen	Dative
Cortisons	Genitive
Heimtieren	Dative
würdet	None
Leibern	Dative
Gewichtes	Genitive
sexele	None
glosten	None
anstoßen	None
Leibwächtern	Dative
Geheges	Genitive
löge	None
verlangen	None
rührte	None
schätzten	None
Behindertensports	Genitive
Paares	Genitive
Visieren	Dative
Tritten	Dative
Tierversuchen	Dative
Begleiters	Genitive
Analphabet	Nominative
Goldrausches	Genitive
Rastplätzen	Dative
Standes	Genitive
Isländers	Genitive
häuten	None
Ödemen	Dative
klontest	None
Meißeln	Dative
Dekans	Genitive
verschleiere	None
Fremdkapitals	Genitive
Lexemen	Dative
Wettkämpfen	Dative
Landgerichtes	Genitive
Höhlenbewohnern	Dative
speise	None
Schuldnern	Dative
Videospielen	Dative
Epigramms	Genitive
Amalgamen	Dative
Buckelwales	Genitive
Schadstoffen	Dative
Schächten	Dative
inhalieren	None
Streusalzes	Genitive
Aufsehers	Genitive
Salärs	Genitive
Gefechten	Dative
wellet	None
runzeln	None
kommentier	None
Ansteckern	Dative
entrichtet	None
Maschinenraumes	Genitive
Parametern	Dative
Kranichs	Genitive
Köttern	Dative
beleuchten	None
Walmdächern	Dative
Tributes	Genitive
Küstengewässern	Dative
erklinget	None
Wacholdern	Dative
Eckzahns	Genitive
schweigt	None
rekapituliere	None
Müllers	Genitive
Helmen	Dative
Extremist	Nominative
Laubsturmes	Genitive
Wandergeselle	Nominative
entrümpeln	None
Bisphosphonaten	Dative
Desktop-Computers	Genitive
Erzherzogtums	Genitive
Laufes	Genitive
Spießern	Dative
Tongaers	Genitive
Zehnkampfes	Genitive
bezahl	None
Rangierbahnhofes	Genitive
malmest	None
Teufels	Genitive
Durchschnitten	Dative
Erdapfels	Genitive
Halluzinogenen	Dative
Flussbetts	Genitive
Containern	Dative
gewettet	None
Gewehres	Genitive
gerückt	None
Nebenschauplatzes	Genitive
Kinderschändern	Dative
placieret	None
Schulleiters	Genitive
betriebt	None
Segners	Genitive
Busches	Genitive
Amins	Genitive
Bauwesens	Genitive
geschwächt	None
schürfen	None
erfrischt	None
Plänen	Dative
spezifizierte	None
bedenken	None
stier	None
Hobels	Genitive
Ausbaues	Genitive
Weibes	Genitive
gurren	None
stürmtet	None
Betriebsergebnissen	Dative
niesen	None
Rollenspielen	Dative
Segens	Genitive
Steppenfuchses	Genitive
Maßstäben	Dative
Konsonantenstammes	Genitive
Dienstagmittagen	Dative
Antigenen	Dative
abgestiegen	None
ergießen	None
Ozeanen	Dative
Fingerknöchels	Genitive
Kriegsschauplatzes	Genitive
Verhältnissen	Dative
Dotierens	Genitive
Orgelmetallen	Dative
Bergschuhen	Dative
verbau	None
Stenograf	Nominative
Landwirts	Genitive
Bastards	Genitive
projiciert	None
Fallrohren	Dative
weggenommen	None
bejahet	None
Krawallen	Dative
Sprengstoffes	Genitive
packte	None
Bergfink	Nominative
Beschlusses	Genitive
Aufenthaltsorten	Dative
Wandteppichs	Genitive
Lügners	Genitive
handelte	None
Tonnengewölben	Dative
Feinstäuben	Dative
entstand	None
fassen	None
Haushalten	Dative
meisterten	None
gart	None
Zuschüssen	Dative
Forschern	Dative
glückst	None
Toxikologe	Nominative
Nachtsichtgeräten	Dative
Effektes	Genitive
Schutzmannes	Genitive
Mageninhalten	Dative
aufbewahren	None
Grabens	Genitive
Armenhauses	Genitive
Kreiselkompasses	Genitive
desertierten	None
Längengrades	Genitive
wackelet	None
Molybdophosphats	Genitive
verdunstet	None
Exilant	Nominative
Gedankenspielen	Dative
ableitend	None
Kuttern	Dative
Rücksprüngen	Dative
imprägniere	None
quöllen	None
misslungen	None
Übergabeparametern	Dative
Dialektes	Genitive
Nachlasses	Genitive
Hütern	Dative
Elb	Nominative
Pigmentes	Genitive
Flößers	Genitive
Ausgangsstoffes	Genitive
Anlegers	Genitive
Mägden	Dative
Journals	Genitive
Reflexionsgrades	Genitive
ertrag	None
Grönländern	Dative
Vertretungsberechtigters	Genitive
Ansprüchen	Dative
Weißpigmenten	Dative
Adduktes	Genitive
Dreirades	Genitive
Schlaraffenländern	Dative
entfesseln	None
Rosenkränzen	Dative
Feldzuges	Genitive
Ballens	Genitive
Zieles	Genitive
Etikettes	Genitive
Rabbinern	Dative
Abnehmertauschs	Genitive
Aspartamen	Dative
Gruppennachbar	Nominative
Abbildes	Genitive
Gedankenspieles	Genitive
schneiet	None
konsumiere	None
imitierten	None
parlier	None
pople	None
Hadrons	Genitive
identifizieren	None
Ursprunges	Genitive
Triebwerken	Dative
Bibelforschern	Dative
Fehlschlusses	Genitive
Bestsellern	Dative
anpassend	None
addiert	None
stapf	None
Superoxiden	Dative
Brauhauses	Genitive
Schlägers	Genitive
Natronsalpeters	Genitive
Daches	Genitive
verarbeiteten	None
chargierten	None
Brennofens	Genitive
Klosters	Genitive
feilsche	None
wringst	None
Turinern	Dative
Schnitzeln	Dative
verlauten	None
Urteilen	Dative
Streiten	Dative
Robotern	Dative
beschwertest	None
Schauplätzen	Dative
Reisfeldes	Genitive
Gelübdes	Genitive
Chorälen	Dative
Machthabers	Genitive
Maibaumes	Genitive
Wächters	Genitive
entwickelst	None
verarbeitete	None
Lebensmittelfarbstoffen	Dative
Durchgängen	Dative
Kielers	Genitive
Olympiasiegers	Genitive
Ehegatte	Nominative
Quadrates	Genitive
Etiketten	Dative
turne	None
Vorläufern	Dative
Salmen	Dative
Häuschens	Genitive
Salzteigen	Dative
erstauntet	None
Speicherkraftwerken	Dative
erfrischst	None
Rezeptes	Genitive
mineralisierest	None
Hecken	Dative
Bauernhöfen	Dative
Stadtbezirken	Dative
welk	None
Raubes	Genitive
schieben	None
Fruchtknotens	Genitive
Jurist	Nominative
Kelchen	Dative
verschlacke	None
Schiefern	Dative
Chronist	Nominative
verspielt	None
Epigone	Nominative
amputieren	None
Stoffwechselprodukten	Dative
Parketten	Dative
vergrößert	None
beschwor	None
zerfallen	None
Eintrittes	Genitive
Staatsbesuchen	Dative
siedelt	None
Ecuadorianern	Dative
Gletschers	Genitive
übertrifft	None
schämte	None
Köhlern	Dative
erstreckt	None
erstrecken	None
Renners	Genitive
verzehr	None
Erdstoßes	Genitive
Kurbades	Genitive
Bauelementen	Dative
kuckt	None
Zageln	Dative
erlöschest	None
Campingplatzes	Genitive
Assyriologe	Nominative
Stadtrates	Genitive
imprägnieren	None
Kastenwagens	Genitive
Halbfinalen	Dative
Futurs	Genitive
Talges	Genitive
Raumschiffes	Genitive
Boraten	Dative
versorgte	None
Schaukelpferdes	Genitive
Bestrebens	Genitive
Blindenhundes	Genitive
Appellen	Dative
Zugängen	Dative
Boddens	Genitive
Koteletts	Genitive
Ufern	Dative
Betreibers	Genitive
schwanden	None
akkreditiert	None
hökerst	None
Seeskorpions	Genitive
Gemeinplätzen	Dative
signalisiere	None
Rettungswegen	Dative
Graureihers	Genitive
Petschaften	Dative
Kredithaien	Dative
Rettungsbootes	Genitive
Raumschiffen	Dative
Möbeln	Dative
Blasenkrebses	Genitive
grollten	None
Syndroms	Genitive
verspeisend	None
Kultusministeriums	Genitive
Katholik	Nominative
deaktivierst	None
verstieße	None
vergiltst	None
gejätet	None
adressieren	None
Systemen	Dative
pexierten	None
Markenname	Nominative
Depps	Genitive
durchwandern	None
Herzmuskels	Genitive
Gesellschafters	Genitive
Balitigern	Dative
Beobachtern	Dative
Energieträgers	Genitive
Phloemen	Dative
dämpft	None
bestiege	None
Krake	Nominative
Bartenwalen	Dative
Oligosaccharids	Genitive
Steinbutten	Dative
Spinners	Genitive
Rechtsbruches	Genitive
freilassen	None
Elfers	Genitive
Olivenbäumen	Dative
aussprechen	None
Holunderbüschen	Dative
wichst	None
Glycolipiden	Dative
Piratensendern	Dative
Umspannwerkes	Genitive
untersage	None
Kampfeinsätzen	Dative
Nanoobjekten	Dative
Abbildern	Dative
Bundesfinanzministers	Genitive
präget	None
Tetroxides	Genitive
Kartograph	Nominative
Pärchens	Genitive
Verstärkers	Genitive
repräsentiere	None
Brüsselern	Dative
Supermärkten	Dative
Zwangsarbeiters	Genitive
blockiere	None
Vereinen	Dative
Geigern	Dative
Impulses	Genitive
Spielgefährte	Nominative
Domen	Dative
Erzlagers	Genitive
Falke	Nominative
Luminophors	Genitive
schiefertet	None
gewertet	None
Polders	Genitive
Meridians	Genitive
Stiefelknechten	Dative
beförderten	None
bedrohen	None
Idolen	Dative
Aktivist	Nominative
einsetzend	None
liehest	None
Halls	Genitive
Frontantriebes	Genitive
Kautschuks	Genitive
Rohstoffes	Genitive
explodiert	None
Streusalzen	Dative
Messkolbens	Genitive
verfügte	None
Abschnitts	Genitive
Flanells	Genitive
Belichtungsmessern	Dative
Regenwaldes	Genitive
zugefügt	None
Bewohnern	Dative
krall	None
Niobaten	Dative
Einsturzes	Genitive
Sonnenbadens	Genitive
Zinkselenids	Genitive
Kreuzworträtseln	Dative
klettertest	None
Dolmetschers	Genitive
renoviert	None
Stanniten	Dative
lispeln	None
Bausteinen	Dative
Schleppern	Dative
Resonatoren	Dative
bekräftigen	None
differenzieret	None
Adlern	Dative
Emails	Genitive
Herstellungsprozesses	Genitive
stahl	None
begegnet	None
Nebenflusses	Genitive
Sachbegriffen	Dative
Kästchens	Genitive
Autokrat	Nominative
Igeln	Dative
Tagebaues	Genitive
Keimen	Dative
Landgerichten	Dative
Thoraxes	Genitive
Zentralnervensystems	Genitive
Arbeitsärzten	Dative
Predigern	Dative
Eies	Genitive
löffelten	None
Balletten	Dative
tätigst	None
spiegelnd	None
vermerktest	None
kandidiere	None
Fadenkreuzes	Genitive
Beweises	Genitive
Bonze	Nominative
Käufen	Dative
Ministeriums	Genitive
Evangelist	Nominative
Leberkäses	Genitive
Wesfällen	Dative
Alkanen	Dative
Satyrn	Dative
Walisers	Genitive
Immunsystems	Genitive
Gelübden	Dative
Gerüchen	Dative
Leibwächters	Genitive
Feststoffes	Genitive
stopftet	None
rauschte	None
Ausrutschern	Dative
Kanute	Nominative
Abstiegs	Genitive
Gemeinplatzes	Genitive
verschleißest	None
Hochchinesischen	Genitive
Titelverteidigers	Genitive
Kindermädchens	Genitive
Landrates	Genitive
Archivaren	Dative
ersuchten	None
Walrosses	Genitive
Ohrringen	Dative
furzten	None
taue	None
Fahrstuhls	Genitive
Stielen	Dative
Kabeln	Dative
Straßenmusikant	Nominative
bebest	None
Hufeisens	Genitive
Staates	Genitive
Hämmerchens	Genitive
verstauten	None
Geldgebern	Dative
Fahrstühlen	Dative
Kryovulkans	Genitive
Unterschieden	Dative
Zeitnormalen	Dative
behüten	None
Kumane	Nominative
Tabaks	Genitive
Litern	Dative
vertrieb	None
Bergbaus	Genitive
meditiere	None
Beugfällen	Dative
hallte	None
Gesetzen	Dative
Kaufleuten	Dative
Reinstoffen	Dative
Eseln	Dative
Psychotherapeut	Nominative
Vorsatzes	Genitive
Veterinären	Dative
Wintern	Dative
flehe	None
Heimcomputers	Genitive
Gutachtern	Dative
Großhändlern	Dative
etikettiere	None
überwältigend	None
zerstreust	None
jährte	None
Pulsaren	Dative
Messgerätes	Genitive
beflügelt	None
begnadigten	None
Panzerschränken	Dative
Sonnenscheins	Genitive
ermutigt	None
Pfiffen	Dative
Nitriten	Dative
verdächtige	None
Stegosauriern	Dative
Märchenbüchern	Dative
Beilen	Dative
Teufelskreises	Genitive
Führers	Genitive
assimilieren	None
Rabe	Nominative
Vorjahrs	Genitive
Fotoalbums	Genitive
Mutexen	Dative
umschmelzest	None
erbracht	None
deckend	None
Gehölzen	Dative
Doge	Nominative
Eisenkrautes	Genitive
Kontrahent	Nominative
Kühlern	Dative
Tiefschlägen	Dative
heilend	None
Riechstoffen	Dative
dienend	None
Marokkaners	Genitive
Gasmolekülen	Dative
Leders	Genitive
Ombudsmannes	Genitive
Inbusschlüsseln	Dative
Geschmacksstoffen	Dative
Jahresumsatzes	Genitive
Bahnsteigen	Dative
Nasses	Genitive
Plättchens	Genitive
beamen	None
Bure	Nominative
serviert	None
Carbiden	Dative
Judenhasses	Genitive
expandierte	None
verwickelst	None
Werten	Dative
Elfenbeinturmes	Genitive
Gebisses	Genitive
Zündpunkten	Dative
Aufsatzes	Genitive
zerkleinerten	None
wahrgenommen	None
Dussels	Genitive
Grindwalen	Dative
Tälern	Dative
Spektralbereichs	Genitive
Führerhauptquartiers	Genitive
Monokeln	Dative
desillusionier	None
isomerisierten	None
Orgelkonzerten	Dative
Unterseebootes	Genitive
Bindestrichen	Dative
Selens	Genitive
Dreckskerls	Genitive
Stengeln	Dative
Anwendungsbereiches	Genitive
Hörspiels	Genitive
Chlorits	Genitive
entsonnen	None
Schülern	Dative
Berufes	Genitive
Armbandes	Genitive
Bussen	Dative
Antriebssystemen	Dative
Sozialamtes	Genitive
agieren	None
demonstrierten	None
Offizieren	Dative
Signalweges	Genitive
flackerte	None
bekämpft	None
herstellend	None
Knopfes	Genitive
Deserteuren	Dative
Begehrens	Genitive
gewurschtelt	None
Hortes	Genitive
Mittelpunkten	Dative
befürchtest	None
Sonnenlichts	Genitive
verjähr	None
Vorkommens	Genitive
erhebe	None
ringe	None
Backenbärten	Dative
verbitterten	None
reflektierte	None
säge	None
besprach	None
Grünkohlen	Dative
Alterungsprozessen	Dative
Elektronenstrahls	Genitive
Fernsehsenders	Genitive
Kohlenhydraten	Dative
Pedalen	Dative
manipuliert	None
Schwenkbügels	Genitive
Kernits	Genitive
Endspiels	Genitive
versänke	None
Arbeitsschritten	Dative
Gemahls	Genitive
basieren	None
verstößt	None
fluchend	None
schädigt	None
verluden	None
Thunfischen	Dative
Kojote	Nominative
Abkömmlings	Genitive
bequemest	None
Sketchen	Dative
blake	None
paraphrasieren	None
beurteilt	None
Hexern	Dative
verlädt	None
entziehe	None
stimmet	None
Aufmärschen	Dative
übernahm	None
Grauens	Genitive
versaute	None
einsetzen	None
Mazedoniern	Dative
Sohnes	Genitive
Verlusten	Dative
Deliktes	Genitive
Fledermäusen	Dative
Schweizern	Dative
Zweisitzern	Dative
Cadmiums	Genitive
einbringen	None
Diprotons	Genitive
Katzenwelpe	Nominative
Kugelschreibern	Dative
hecheln	None
Schakals	Genitive
Führern	Dative
Durchschnittseinkommens	Genitive
Rückstandes	Genitive
Spitznamens	Genitive
Endergebnisses	Genitive
Streichinstrumenten	Dative
Rotrückenwürgers	Genitive
Gedichten	Dative
Datenträgern	Dative
Querverweisen	Dative
ausgewandert	None
krächztet	None
Phenols	Genitive
Erzengels	Genitive
title	None
zerfetzt	None
Aufprallen	Dative
Betttuches	Genitive
Vorsprüngen	Dative
beschuldiget	None
verziert	None
schulten	None
Flüchtigkeitsfehlers	Genitive
Kerosins	Genitive
Firnes	Genitive
Regierungspräsidiums	Genitive
Knäufen	Dative
Staatsgebieten	Dative
Wasserrades	Genitive
Finanzämtern	Dative
eignet	None
Zöllners	Genitive
Glücksspielen	Dative
Schreinen	Dative
tätigte	None
dolmetsch	None
Telegrammen	Dative
grüßte	None
Ammoniaks	Genitive
Arbeitseinsätzen	Dative
verschoben	None
Held	Nominative
Funkfeuers	Genitive
Nichtmetalloxides	Genitive
flüsternd	None
Aquariums	Genitive
abstrahieren	None
prustete	None
befehlt	None
elektrisierte	None
verstreut	None
Dieben	Dative
Dekors	Genitive
Zuhältern	Dative
Weilern	Dative
reglementierte	None
Antiklopfmitteln	Dative
verlötetest	None
Protektoraten	Dative
Jägern	Dative
Evolutionist	Nominative
Durchschlägen	Dative
emittierte	None
Katalysators	Genitive
gelegt	None
manövriert	None
Vordergrundes	Genitive
Stören	Dative
Apfelbäumen	Dative
Ständers	Genitive
Dienern	Dative
geschwollen	None
Kampfstoffen	Dative
Marktanteilen	Dative
Beugfalles	Genitive
Geräten	Dative
Terrorist	Nominative
frisier	None
Tetraborats	Genitive
Büffels	Genitive
Hauptspiegeln	Dative
Schwagers	Genitive
Dachdeckers	Genitive
ertrank	None
Netzwerken	Dative
Dorfbewohners	Genitive
Blumenhändlern	Dative
Ohrensesseln	Dative
Paradoxons	Genitive
gelaicht	None
Chlororuthenats	Genitive
Zweikampfes	Genitive
krallte	None
fach	None
Braunflügel-Ameisenwürgers	Genitive
Hausmeisters	Genitive
Laufstegen	Dative
Betreffen	Dative
fassten	None
Fußabdrücken	Dative
rundeten	None
knautschet	None
Peruanern	Dative
verwahrloste	None
Selans	Genitive
geschuppt	None
Autopilot	Nominative
Tetrameren	Dative
jubelnd	None
entleere	None
Glockengießers	Genitive
Erlebnissen	Dative
Knochenfischen	Dative
gekentert	None
Tonmineralen	Dative
Aufschlüssen	Dative
Prunksälen	Dative
Gehorsams	Genitive
klone	None
Abgängen	Dative
Pressesprechers	Genitive
Horoskopen	Dative
Akutes	Genitive
Emissärs	Genitive
Objekten	Dative
fache	None
Franzose	Nominative
Psychiaters	Genitive
Tensiden	Dative
Auszügen	Dative
Staatsbürgers	Genitive
Impulsen	Dative
Grinden	Dative
Besuches	Genitive
widerstehe	None
Zuflüssen	Dative
Ersatzmannes	Genitive
Hinterzimmern	Dative
Garnes	Genitive
thuest	None
Festkörpern	Dative
gehäuft	None
ernährt	None
bemerkst	None
Staatssekretären	Dative
Süßstoffen	Dative
Sprachwissenschaftlern	Dative
verheißt	None
Fremdwortes	Genitive
Protestes	Genitive
Kraftfahrzeuges	Genitive
küss	None
Streuners	Genitive
Gemächern	Dative
Defiziten	Dative
Pfandes	Genitive
transformierten	None
Bräuten	Dative
grenze	None
Zeigefingern	Dative
bezwungen	None
vergeuden	None
Kapitänen	Dative
Geländewagens	Genitive
Pflugscharen	Dative
flankierest	None
Metalles	Genitive
Ventilen	Dative
Blutzeuge	Nominative
Sauerstoffgehaltes	Genitive
Nanodrahts	Genitive
Raffinats	Genitive
feil	None
mutieren	None
geheftet	None
Regelstabs	Genitive
Kamerad	Nominative
Schrotten	Dative
Beutelsäugers	Genitive
Igels	Genitive
erstatte	None
Astrozyt	Nominative
Unwohlseins	Genitive
Musikinstrumentes	Genitive
wäge	None
Polygons	Genitive
Reinheitsgraden	Dative
Aufenthalten	Dative
Thoriums	Genitive
Gauklers	Genitive
verbleibend	None
Allotrops	Genitive
Thermoelementen	Dative
Geräusches	Genitive
Zürchern	Dative
Chauffeurs	Genitive
befolgend	None
Ozonidanionen	Dative
Hüftgelenkes	Genitive
beseelen	None
Amtsinhabers	Genitive
schwörest	None
Blitzeises	Genitive
Rosenkrieges	Genitive
Flammschutzmittels	Genitive
Gebäcken	Dative
Reismehles	Genitive
Unteroffizieren	Dative
musicier	None
Gasthöfen	Dative
kill	None
Kurfürst	Nominative
Chlorwasserstoffmolekülen	Dative
Fußgehern	Dative
Oberschenkels	Genitive
Zyklop	Nominative
Umfeldes	Genitive
Spießers	Genitive
Freibeutern	Dative
Schäumen	Dative
küssend	None
Illustrators	Genitive
Weißbart-Ameisenwürgern	Dative
Betreuern	Dative
Rückkaufs	Genitive
lauschen	None
Fischhändlers	Genitive
Ausstandes	Genitive
Griffen	Dative
Pferchen	Dative
gekennzeichnet	None
teilte	None
haket	None
Zerfallsprodukten	Dative
Sperlingen	Dative
erzielst	None
Iridiums	Genitive
Grimmes	Genitive
Geschosses	Genitive
Alliierte	Nominative
Hauptsitzes	Genitive
sonn	None
Paranüssen	Dative
Exponaten	Dative
schmälere	None
Mikrometern	Dative
Mittwochmittags	Genitive
Segelbootes	Genitive
Bankern	Dative
gespürt	None
Rudels	Genitive
Aktienkurses	Genitive
Planers	Genitive
Laboratoriums	Genitive
Gurten	Dative
Lenzes	Genitive
Romanist	Nominative
Wurzelwachstums	Genitive
anschnallen	None
Zuschlagstoffen	Dative
träntet	None
bestick	None
Zahnschmelzes	Genitive
markieren	None
Akkorden	Dative
verschneidet	None
Henkels	Genitive
Paraffinölen	Dative
Keltiberern	Dative
Betriebsergebnisses	Genitive
Proteins	Genitive
Panzerschrankes	Genitive
Hahnenkämmen	Dative
Flaschenhalses	Genitive
Turnieres	Genitive
haaren	None
Gesanges	Genitive
gleicht	None
Myokardes	Genitive
Rückganges	Genitive
Seglern	Dative
kugeln	None
Europameistern	Dative
Anzügen	Dative
Farbstoffen	Dative
systematisiertest	None
Zeitstempels	Genitive
härtetest	None
Arzneimittels	Genitive
ejakulier	None
Pässen	Dative
erweitert	None
Fixierbads	Genitive
Suffixes	Genitive
Argumenten	Dative
Eintrages	Genitive
Hindernisses	Genitive
Kopfhörern	Dative
Bildes	Genitive
Gewahrsams	Genitive
Räubern	Dative
verdichtet	None
Madenkäses	Genitive
Analyst	Nominative
Happens	Genitive
Glückspilzen	Dative
Attentaten	Dative
Vergleiches	Genitive
Einsprengseln	Dative
Knallen	Dative
Lactats	Genitive
Erdkernes	Genitive
bestätigte	None
Heiles	Genitive
Jude	Nominative
Besitzern	Dative
Facharztes	Genitive
Gewächses	Genitive
Dateinamens	Genitive
durchwühlt	None
moppend	None
flittertet	None
kreuzigten	None
Marktführern	Dative
verwechsele	None
feilbieten	None
Skarns	Genitive
besinnt	None
Schleimhäuten	Dative
Spottes	Genitive
geboxt	None
Kompassen	Dative
Anglerfischen	Dative
checke	None
Sechsecken	Dative
Aldehyds	Genitive
Distrikten	Dative
Schalthebels	Genitive
Würfen	Dative
geduckt	None
Brennens	Genitive
Frühsommers	Genitive
entlasten	None
Lambdapunktes	Genitive
Scheiteln	Dative
Klebstoffen	Dative
Haffen	Dative
Fussgängern	Dative
Zaubersprüchen	Dative
Atemwegen	Dative
Währungskürzels	Genitive
gegerbt	None
bröseltet	None
Legierungselementen	Dative
vergreist	None
Musketieren	Dative
Rotgültigerzen	Dative
Traggases	Genitive
kullernd	None
Lepidolithen	Dative
Hexans	Genitive
Trögen	Dative
wühlt	None
Handlangern	Dative
Dezernaten	Dative
tadelest	None
Weihnachtsbaumes	Genitive
Frachtschiffen	Dative
Bürogebäudes	Genitive
Freibädern	Dative
formest	None
Geständnisses	Genitive
Bruders	Genitive
kümmerte	None
Langstreckenläufern	Dative
rösten	None
Tremors	Genitive
Zeithorizonten	Dative
Golfplätzen	Dative
Cobalts	Genitive
Rotgusses	Genitive
Gehäusen	Dative
Wählern	Dative
Erdgases	Genitive
Slawe	Nominative
Salafist	Nominative
Wirtschaftswissenschaftlern	Dative
verselbständigt	None
gemauert	None
verschwor	None
Richters	Genitive
Alkinen	Dative
surfe	None
Trägers	Genitive
verjüngt	None
Dissident	Nominative
Aufwänden	Dative
Mullen	Dative
verwirrend	None
rotzte	None
Eremit	Nominative
Reliquiars	Genitive
wetteten	None
Vorteilen	Dative
Münztelefons	Genitive
Klöstern	Dative
Dromedaren	Dative
Leuchttürmen	Dative
Töpfern	Dative
Loben	Dative
Pilzes	Genitive
überschwemmt	None
währest	None
Bombers	Genitive
Assen	Dative
Kitzlers	Genitive
Leutnanten	Dative
plissieret	None
zügle	None
Kleiderschrankes	Genitive
Zirkumflexen	Dative
Pomologe	Nominative
Überrests	Genitive
gestattete	None
Umrisses	Genitive
Carbonsäureamiden	Dative
Albatrossen	Dative
wurzelt	None
Selenonen	Dative
Geruchssinnes	Genitive
Fastens	Genitive
Grundgesetzen	Dative
Vorreitern	Dative
Disulfits	Genitive
Giftgasen	Dative
nummerierst	None
deuchtest	None
Homöopath	Nominative
Abszessen	Dative
vergrößere	None
belasteten	None
Halogenen	Dative
Vampires	Genitive
Wohnorten	Dative
Wallachen	Dative
Lazarettes	Genitive
Transportvorganges	Genitive
Gletschern	Dative
kontrahierest	None
Grundsätzen	Dative
Syndromen	Dative
Hochwassers	Genitive
Alphabetes	Genitive
rüsteten	None
Erzherzogshüten	Dative
widerstand	None
Kaplänen	Dative
Steinsalzes	Genitive
tappe	None
gestaltest	None
Paradoxes	Genitive
Sigels	Genitive
Hologramms	Genitive
sprühten	None
glaubte	None
Signales	Genitive
Joches	Genitive
Schwarzgesicht-Ameisenwürgern	Dative
Hochmuts	Genitive
verzehre	None
Kirschbaumes	Genitive
Kerfen	Dative
erklärt	None
Abfluges	Genitive
Forschers	Genitive
Arbeitslose	Nominative
Ablebens	Genitive
Klebebändern	Dative
quasseln	None
Speichers	Genitive
Schlusspfiffes	Genitive
Tresoren	Dative
Zweisitzers	Genitive
Schornsteinfegers	Genitive
Abordnungsgeldern	Dative
Koalitionspartners	Genitive
Karen	Dative
falzten	None
Malzes	Genitive
Einkommens	Genitive
türmten	None
Bauwerkes	Genitive
Symptomen	Dative
Zäunen	Dative
funktionalisierend	None
Landesvaters	Genitive
entspringen	None
Selensalzes	Genitive
prangt	None
Anhängern	Dative
konzipierten	None
Kopftüchern	Dative
schraffieren	None
fälschte	None
milderten	None
Sicherheitsdatenblättern	Dative
aufrufen	None
beerdigten	None
spreizte	None
Avocadosäften	Dative
Rotkopfes	Genitive
unterschriebet	None
Reihern	Dative
Ethylenoxids	Genitive
sabotierend	None
Pragern	Dative
musizierest	None
Habens	Genitive
Dachswelpe	Nominative
geähnelt	None
Trakten	Dative
pack	None
ergreifen	None
optimierend	None
Ansätzen	Dative
Urbaren	Dative
vertrauten	None
Talentes	Genitive
Bratwürsten	Dative
Violinist	Nominative
Schlössern	Dative
stopf	None
Erbiums	Genitive
Glücksrittern	Dative
Politikwissenschaftlern	Dative
gackertet	None
Schmutzes	Genitive
Stoffen	Dative
gemeldet	None
Benutzern	Dative
Energiezustands	Genitive
Skandals	Genitive
Meeresschwämmen	Dative
Lägern	Dative
Kristallsystems	Genitive
Verdauungssystems	Genitive
Ausschlüssen	Dative
Grüssen	Dative
dürften	None
Myons	Genitive
Stammtisches	Genitive
Bleichmitteln	Dative
Wertpapieren	Dative
Radfahrern	Dative
Schenkeln	Dative
Leutnants	Genitive
Knipsers	Genitive
Jongleuren	Dative
entzieht	None
Gesängen	Dative
Nagelknipsers	Genitive
Fetzens	Genitive
Digitalisats	Genitive
Theoremen	Dative
Hadithen	Dative
pendeln	None
Nutznießern	Dative
vereinten	None
Tieflandes	Genitive
Warzenköpfen	Dative
Junggeselle	Nominative
Tänzen	Dative
Avocadosaftes	Genitive
verschlechterst	None
beleidigend	None
Bundesverkehrsministers	Genitive
Metallen	Dative
Gaunern	Dative
Zirkonen	Dative
Feldversuchen	Dative
Tangs	Genitive
Sekundenbruchteilen	Dative
verzehren	None
löst	None
Einbringens	Genitive
Herkunftslandes	Genitive
flankieren	None
Impressums	Genitive
chattetet	None
Schmelzpunktes	Genitive
freut	None
Kompromisses	Genitive
Onkeln	Dative
überstanden	None
Schimmern	Dative
verkürzt	None
Idols	Genitive
Jochen	Dative
beschnittet	None
stampfen	None
Bundeswirtschaftsministers	Genitive
Birnbäumen	Dative
wälzen	None
Pyriten	Dative
Kunstmalern	Dative
Sitzplätzen	Dative
Xylophonen	Dative
Instinkten	Dative
Gelenken	Dative
Brennstoffes	Genitive
Guldens	Genitive
Keimes	Genitive
Rubinen	Dative
nähen	None
Großmächten	Dative
Schlicks	Genitive
Exporteuren	Dative
Insektiziden	Dative
realisierte	None
Psychologe	Nominative
ausgeschaltet	None
Schäferhunden	Dative
Parkplatzes	Genitive
bellen	None
Pflaumenbäumen	Dative
Kettenblättern	Dative
Beschützers	Genitive
Masseurs	Genitive
Graphitrohres	Genitive
vernickelet	None
Lehrkörpers	Genitive
annektieret	None
spazieren	None
Luftbildern	Dative
Wählers	Genitive
Wahllokalen	Dative
Vespern	Dative
Schaltern	Dative
Sitzbezügen	Dative
inhaftierte	None
wackeltet	None
schont	None
Bibern	Dative
präsentiert	None
speicherten	None
Diselanen	Dative
Geldgebers	Genitive
beschönigen	None
Postillons	Genitive
Vögleins	Genitive
Eckpfeilers	Genitive
Freistößen	Dative
quollt	None
Verbunden	Dative
Bedürfnisses	Genitive
verzögernd	None
kollationieren	None
schubste	None
logierte	None
Telefonbüchern	Dative
Stickstoffmolekülen	Dative
Röstern	Dative
Kortikoiden	Dative
sprössen	None
Essigsäurechloriden	Dative
geschönt	None
Elektrolyten	Dative
Suchbäumen	Dative
Hammeln	Dative
Waffenstillstandsabkommens	Genitive
garantiere	None
Karpfens	Genitive
Kerfes	Genitive
Buchhalters	Genitive
Skeletten	Dative
Karabinern	Dative
Mineralstoffes	Genitive
Vorhabens	Genitive
Irrtumes	Genitive
stapelte	None
Wunsches	Genitive
Innenstädten	Dative
Glaskörpers	Genitive
Oheims	Genitive
Freibades	Genitive
Heckantriebes	Genitive
Vergewaltigern	Dative
Propanols	Genitive
Krebsarztes	Genitive
duze	None
Holländers	Genitive
Lehrbüchern	Dative
Jahrtausends	Genitive
Doppelgängern	Dative
Abzuges	Genitive
Geigers	Genitive
tauchten	None
verhüllte	None
Segnern	Dative
Helmes	Genitive
Bundesverbandes	Genitive
Redners	Genitive
spitze	None
abgetrieben	None
Tritiden	Dative
Scheibenwischers	Genitive
duzte	None
scheuchend	None
Nebensätzen	Dative
übergab	None
Disputen	Dative
Ausschusses	Genitive
Alarmsignals	Genitive
Bisphosphonats	Genitive
Alauns	Genitive
Rahmens	Genitive
Servern	Dative
Souveräns	Genitive
Gasen	Dative
Ausländers	Genitive
moderieren	None
Heimwegen	Dative
Zundern	Dative
verärgern	None
Graphemen	Dative
meldete	None
Sekretärs	Genitive
Verhältnisses	Genitive
Süßwasserfischen	Dative
lege	None
martern	None
Döners	Genitive
Reisfeldern	Dative
futtert	None
Abenden	Dative
Einfärbens	Genitive
Bromdämpfen	Dative
schwinget	None
maß	None
Speicherkraftwerks	Genitive
diskriminieret	None
drapier	None
erleide	None
Thronen	Dative
Akteuren	Dative
Dampfers	Genitive
Azofarbstoffs	Genitive
Seehechtes	Genitive
verschränkt	None
titelst	None
demobilisierte	None
Wahlrechten	Dative
Schlüsselbeinen	Dative
zusammenziehen	None
Großpudeln	Dative
Rauchern	Dative
Wasserstoffoxiden	Dative
Nullpunktes	Genitive
Berichtes	Genitive
gebrandschatzt	None
Posters	Genitive
Tiefländern	Dative
behaltet	None
Intelligenzquotient	Nominative
Flugplätzen	Dative
Zinkerzen	Dative
Stützrädern	Dative
Genusses	Genitive
fügtet	None
Friese	Nominative
Barometers	Genitive
Rohren	Dative
Verrätern	Dative
schminktet	None
vernickelest	None
Verliesen	Dative
Kropfes	Genitive
Lesens	Genitive
Legierungsbestandteils	Genitive
Feindbildes	Genitive
Koalitionspartnern	Dative
Krankenstandes	Genitive
Erpels	Genitive
bettelnd	None
Schubes	Genitive
bestrafte	None
Gnadenstößen	Dative
Camphers	Genitive
vergleichend	None
Zwillingen	Dative
thuet	None
Bakterienstämmen	Dative
verlötet	None
Kavalieren	Dative
Anspruches	Genitive
Farmers	Genitive
Fluoratomen	Dative
Fischotters	Genitive
Dreckskerlen	Dative
Kollagens	Genitive
erkältete	None
Flügeln	Dative
Urteils	Genitive
Schwärmen	Dative
Lagerfeuern	Dative
beunruhigt	None
Sonnabendnachmittags	Genitive
Ledermänteln	Dative
blenden	None
Vorläufers	Genitive
Würfeln	Dative
Bezuges	Genitive
nanntest	None
Spruchbändern	Dative
dekorieren	None
vereinbarest	None
Weizenfeldes	Genitive
Geldscheinen	Dative
Wahlprogrammen	Dative
Samstagmittags	Genitive
Fliegenpilzes	Genitive
gejammert	None
Genealoge	Nominative
Gewitters	Genitive
einleitend	None
Meeressedimenten	Dative
filtert	None
Österreichers	Genitive
entfrostet	None
Perihels	Genitive
Avatars	Genitive
Frontallappens	Genitive
Raketentreibstoffen	Dative
verzweigen	None
probten	None
Pendels	Genitive
Untertagebaus	Genitive
Häuten	Dative
Flügen	Dative
inaktivierte	None
verschleiernd	None
verkünde	None
Türkenbünden	Dative
sticket	None
Arbeitgebers	Genitive
Bildungsromans	Genitive
Gegensatzes	Genitive
Wellenlängenbereichen	Dative
Eisenarsenids	Genitive
Einsteigern	Dative
rügt	None
Hölzchens	Genitive
Austragungsorten	Dative
miau	None
Nestes	Genitive
Stilen	Dative
Glossaren	Dative
Erzählern	Dative
Schöpfern	Dative
Geisterfahrern	Dative
Carbids	Genitive
töpfere	None
Medizinprodukten	Dative
Arschgesichtern	Dative
Verwaltungsgerichts	Genitive
outet	None
Grießen	Dative
Tadeln	Dative
Nitrids	Genitive
Pförtners	Genitive
Reittieren	Dative
Fruchteises	Genitive
Slowake	Nominative
Arbeitgebern	Dative
Phonemen	Dative
Erzkanzlers	Genitive
näherte	None
bemerkt	None
Funkens	Genitive
bedauerte	None
Arbeitsbereiches	Genitive
Ästen	Dative
Gynäkologe	Nominative
Kochfeldes	Genitive
marschier	None
Gebildes	Genitive
Metronoms	Genitive
verärgerten	None
unterschlage	None
Extremen	Dative
Wedeln	Dative
Bauches	Genitive
Geselle	Nominative
Bezugspunkten	Dative
Freibeuters	Genitive
Protestant	Nominative
Klavierkonzerten	Dative
Längengraden	Dative
Fußballspielen	Dative
Sexspielzeugen	Dative
anreden	None
Ansteckungsgebieten	Dative
verschweige	None
Kiefernwaldes	Genitive
Dimers	Genitive
Rednern	Dative
Rosenkohles	Genitive
Abflügen	Dative
Fischbestandes	Genitive
niete	None
Theorems	Genitive
Tischlern	Dative
Friseuren	Dative
Haltern	Dative
Nussknackers	Genitive
Umweltaspekten	Dative
Informatikern	Dative
Alkans	Genitive
gegraut	None
Amalgams	Genitive
Trägern	Dative
Softwareentwicklern	Dative
Hündchens	Genitive
verwiese	None
zerfetze	None
Kutschers	Genitive
Verschleißes	Genitive
Mähdreschers	Genitive
Bruchstückes	Genitive
Tibetern	Dative
Kulten	Dative
fütterte	None
feuerest	None
Feinschmeckers	Genitive
stammt	None
Ägyptern	Dative
Baronen	Dative
Baumarktes	Genitive
vereinte	None
Mutagenen	Dative
Reduktionsmitteln	Dative
Herdes	Genitive
eil	None
hinterzogen	None
Murrens	Genitive
Kriminalromanen	Dative
Umschlägen	Dative
Soprans	Genitive
begnügend	None
Weltmarktpreises	Genitive
Löwenzahnes	Genitive
Migrant	Nominative
Adrenalins	Genitive
Halstüchern	Dative
Fahrscheinautomates	Genitive
Wirtschaftswissenschaftlers	Genitive
konkurrieren	None
Grenzfällen	Dative
Kaders	Genitive
reglementieren	None
Bühnenautors	Genitive
Engpässen	Dative
Vorstellungsgesprächen	Dative
Bromaten	Dative
Werkstoffes	Genitive
Schwefeloxiden	Dative
Wasserstoffkernes	Genitive
Hirnstammes	Genitive
Zuschauern	Dative
Eisenspaten	Dative
kalkulieret	None
glorifizieren	None
blendeten	None
Blockes	Genitive
Bergführern	Dative
Souveränen	Dative
Oralverkehres	Genitive
entziffert	None
Rieslings	Genitive
Hinterzimmers	Genitive
Draufgängers	Genitive
Motorbooten	Dative
Elektrikers	Genitive
anbinden	None
Stöcken	Dative
Keschers	Genitive
entfalte	None
Abenteuern	Dative
Pfählen	Dative
Gigapascals	Genitive
Bestattern	Dative
Brüdern	Dative
Freunden	Dative
entrichtetest	None
schmelze	None
Nutzens	Genitive
Zusammenbrüchen	Dative
Kopfhörers	Genitive
Exhibitionist	Nominative
Schädlingen	Dative
Verbindungselementen	Dative
Bergarbeiters	Genitive
mißlinge	None
aufgehalten	None
Polarlichtern	Dative
kribbeln	None
Grundnahrungsmitteln	Dative
Anions	Genitive
Rauschroten	Dative
Anstrichs	Genitive
Nebenbuhlers	Genitive
begehrt	None
Wildgänsen	Dative
entpacken	None
Eisenoxiden	Dative
Genen	Dative
Klempners	Genitive
Genitivs	Genitive
Mediators	Genitive
gefeiert	None
Pegmatiten	Dative
Aprikosensaftes	Genitive
Stumpfes	Genitive
Austritten	Dative
rechnete	None
Schatzes	Genitive
Metallurg	Nominative
Schwänzen	Dative
hingenommen	None
Alleingängen	Dative
Pfaden	Dative
Achteln	Dative
Brandbeschleunigers	Genitive
Töpfers	Genitive
lehnst	None
Gebirges	Genitive
preise	None
Enzyms	Genitive
Sprechchören	Dative
Hellsehers	Genitive
beweist	None
Schützengrabens	Genitive
Senders	Genitive
Paradeisern	Dative
Schnellkochtöpfen	Dative
Kilometern	Dative
lobten	None
Abschiedsbriefen	Dative
klammert	None
Staatsstreiches	Genitive
Komplexen	Dative
Kritikern	Dative
Überbleibseln	Dative
Menschheitsbeglückers	Genitive
Seestücken	Dative
hüllen	None
Kraftfahrzeugen	Dative
systematisiert	None
Kernen	Dative
Verschwörungstheoretikern	Dative
Kretschamen	Dative
Superheld	Nominative
Einzelfalles	Genitive
Einkaufes	Genitive
Geschichtenerzählern	Dative
Vietnamese	Nominative
Streites	Genitive
Biograph	Nominative
Theatern	Dative
Sprudeln	Dative
Köpfchens	Genitive
symbolisierten	None
generalisierend	None
Alarmen	Dative
Erdstößen	Dative
Handgemenges	Genitive
Höhepunkten	Dative
Sultanates	Genitive
Waranen	Dative
Grates	Genitive
Horizontes	Genitive
signalisiert	None
Klassenzimmers	Genitive
verabschieden	None
verteidigt	None
Hüttenwesens	Genitive
Nennwertes	Genitive
Eisenerzen	Dative
Kommentaren	Dative
häufte	None
Akronyms	Genitive
Kieses	Genitive
Kümmeln	Dative
schmück	None
belastet	None
Vorbeiflügen	Dative
gealtert	None
Bewohners	Genitive
parametrisieren	None
Schwüren	Dative
Tübingers	Genitive
werfen	None
formatiere	None
Rekordes	Genitive
Umschlages	Genitive
Büschen	Dative
Sauerstoffatomes	Genitive
Turbinenblattes	Genitive
frikassiertet	None
mutmaßten	None
Mainzers	Genitive
lindern	None
sinken	None
Störchen	Dative
repliciere	None
Spitals	Genitive
Fettes	Genitive
Betrachters	Genitive
Kopierern	Dative
Freimaurern	Dative
Zinnerzes	Genitive
Zeuge	Nominative
kurbelt	None
Lurches	Genitive
Permanentmagnetes	Genitive
Stapels	Genitive
Ausgangsstoffen	Dative
Unterschenkels	Genitive
Bürgerrechtlers	Genitive
Bügels	Genitive
Bursche	Nominative
Nenners	Genitive
Zeichentrickfilmen	Dative
Lobes	Genitive
Umspannwerken	Dative
greifend	None
Siedepunktes	Genitive
Membranpotentials	Genitive
Klavierlehrers	Genitive
Stromes	Genitive
Bündnisses	Genitive
Drahtziehers	Genitive
Museumsstückes	Genitive
rauscht	None
chille	None
Haien	Dative
Potentials	Genitive
trauert	None
Exporteurs	Genitive
vermittle	None
Fischottern	Dative
Turnschuhen	Dative
föhnen	None
Optimist	Nominative
instrumentalisierten	None
missbrauchst	None
Trankes	Genitive
Solitons	Genitive
genutzt	None
Bügeln	Dative
Spitzenhäubchens	Genitive
spritzt	None
applizierten	None
Möbels	Genitive
Gesangslehrers	Genitive
Einsatzbereichen	Dative
Kielern	Dative
Seeadlers	Genitive
verladet	None
Hausmäusen	Dative
Urtextes	Genitive
holperte	None
entschleierte	None
Aufrührern	Dative
Flüchtlings	Genitive
schwingst	None
Kaplans	Genitive
Gerbern	Dative
Plasmaspiegeln	Dative
bisse	None
Portales	Genitive
Bekenntnisses	Genitive
Anfalls	Genitive
Predigers	Genitive
zier	None
umgestiegen	None
Oberstaatsanwälten	Dative
zitterte	None
Becherglases	Genitive
zugemacht	None
duften	None
kollert	None
umgebracht	None
Erlöses	Genitive
Krümelchens	Genitive
Kreiselkompassen	Dative
Drahtzaunes	Genitive
Internierungslagern	Dative
Kalmaren	Dative
Permafrostbodens	Genitive
Operationssälen	Dative
bessern	None
Bräuchen	Dative
Tätern	Dative
Erzpriesters	Genitive
verweile	None
kotztet	None
Äthiopiern	Dative
Hauptsatzes	Genitive
abgedeckt	None
Likören	Dative
Bollwerks	Genitive
Blickwinkeln	Dative
Abenteuers	Genitive
Pandabär	Nominative
Duellen	Dative
Belichtungsmessers	Genitive
Ödems	Genitive
tötetet	None
Kanake	Nominative
Könnens	Genitive
Anhangs	Genitive
Stauen	Dative
Okkultist	Nominative
verschärfte	None
Vormündern	Dative
Hohlraumresonators	Genitive
Befunden	Dative
bollern	None
rochieren	None
Herkünften	Dative
Mietverträgen	Dative
Melkers	Genitive
Wüchsen	Dative
Heptamolybdats	Genitive
angekündigt	None
Arbeitnehmern	Dative
Athlet	Nominative
Auslassventils	Genitive
schleudertest	None
quantisier	None
streiken	None
schikanier	None
meditierend	None
Abendes	Genitive
Münzgeldern	Dative
untersagten	None
gedemütigt	None
bemuttern	None
Molekülorbitalen	Dative
Jahrzehntes	Genitive
Obdaches	Genitive
verknüpfte	None
flackern	None
Briefkopfes	Genitive
gipfelest	None
rezitieren	None
überschreiten	None
Serienmördern	Dative
schwinde	None
usurpierend	None
Sprunggelenks	Genitive
Hirnhäuten	Dative
Abflusses	Genitive
Emirs	Genitive
Bohrern	Dative
stemmt	None
Minnesängern	Dative
manövriertest	None
aufgerufen	None
kampierte	None
abalienieren	None
Elchen	Dative
Silbersalzen	Dative
widerständen	None
Protesten	Dative
Wattenmeeres	Genitive
Molybdänerzen	Dative
Buddhist	Nominative
Todesopfern	Dative
Trichters	Genitive
Ministern	Dative
Liedern	Dative
vertagen	None
Kernreaktors	Genitive
Zungenbeinen	Dative
Erbfeindes	Genitive
Halogenkohlenwasserstoffen	Dative
Sprichwortes	Genitive
Mosten	Dative
massiertet	None
Chores	Genitive
Prangers	Genitive
wählte	None
Kohlenstoffatoms	Genitive
Präparators	Genitive
riss	None
Ureinwohnern	Dative
Klößen	Dative
Amateuren	Dative
Dackels	Genitive
Farmersalates	Genitive
ausdenken	None
Köchers	Genitive
Verwaltungsaktes	Genitive
strafe	None
Jasagern	Dative
Tischlers	Genitive
Anrufes	Genitive
Schrägstrichen	Dative
Gelegen	Dative
Dreieckes	Genitive
nennen	None
Fertiggerichten	Dative
Kugelfischen	Dative
Träumern	Dative
aufrunden	None
Disulfaten	Dative
Dendrit	Nominative
Akzentes	Genitive
Laborgeräten	Dative
ärgerest	None
chiffrierte	None
Magneten	Dative
initiierte	None
verallgemeinert	None
Grundbegriffen	Dative
Zahnstochern	Dative
Waffenstillstandes	Genitive
Fertiggerichts	Genitive
Angebotes	Genitive
mißbrauchst	None
Entdeckers	Genitive
Intrigant	Nominative
geduldet	None
Tumulten	Dative
Containerschiffen	Dative
Bürgers	Genitive
Linolschnitten	Dative
Strafraumes	Genitive
zielt	None
Androide	Nominative
säumt	None
bombardierte	None
Feuertürmen	Dative
Wahlsieges	Genitive
kloppt	None
Titels	Genitive
Komplize	Nominative
Grundstückes	Genitive
iahtet	None
Trotzkist	Nominative
Arbeitsbereichen	Dative
Chalkopyriten	Dative
Nierensteinen	Dative
rüste	None
stürzte	None
Inhabers	Genitive
Zeitpunktes	Genitive
Geschöpfen	Dative
Zwiebelturmes	Genitive
Silbererzen	Dative
Brandsätzen	Dative
Frühchens	Genitive
Metallteilen	Dative
Meiern	Dative
Füllstoffes	Genitive
Hausmeistern	Dative
Vielecken	Dative
Leichnamen	Dative
Käsebroten	Dative
stockte	None
ankündigen	None
Antifaschist	Nominative
Belegen	Dative
Huflattichs	Genitive
rase	None
Chloriden	Dative
Fliegern	Dative
grapschtest	None
Flugkapitäns	Genitive
schwiegst	None
geschwärmt	None
Triglycerids	Genitive
knutschten	None
Vorschlägen	Dative
implizieren	None
vertippt	None
Alpenbewohners	Genitive
Brokaten	Dative
Aushängen	Dative
Dachziegeln	Dative
Krämers	Genitive
Bahnüberganges	Genitive
wank	None
Prozentpunkten	Dative
Rates	Genitive
bemühen	None
Karaten	Dative
blitzt	None
geliert	None
ordnet	None
verabschiedeten	None
Investors	Genitive
überwachten	None
Maledivern	Dative
Kürassen	Dative
Pragers	Genitive
Lieferant	Nominative
verbessere	None
Erdalkalimetallen	Dative
Kerzenständern	Dative
Minnesängers	Genitive
Alkoholikern	Dative
Verkehrsunfalles	Genitive
Schlachtfeldern	Dative
Laurits	Genitive
Nomens	Genitive
Greif	Nominative
Erkers	Genitive
weihte	None
Sehnsüchten	Dative
radfahren	None
verliebt	None
ignorieren	None
geschüttet	None
Oberbegriffen	Dative
bahnte	None
Schnorcheln	Dative
beleidigen	None
Sprachwissenschaftlers	Genitive
Metallatomes	Genitive
Kadavergehorsams	Genitive
sparten	None
Fahrplänen	Dative
naschen	None
tratschen	None
Molches	Genitive
siege	None
Berufungsgerichtes	Genitive
kille	None
Pflasters	Genitive
Einhörnern	Dative
erstick	None
Abenteurern	Dative
Sperrgebieten	Dative
ackert	None
toleriertet	None
Zeigers	Genitive
Anschlages	Genitive
Politologe	Nominative
Elektrons	Genitive
Mittelfingers	Genitive
Passant	Nominative
Belägen	Dative
Chalkopyrits	Genitive
Anglern	Dative
Gänsen	Dative
Übergriffs	Genitive
Stieren	Dative
klappen	None
Exoplanet	Nominative
Handwerken	Dative
Chloralkenen	Dative
Tribunals	Genitive
Benzolringen	Dative
Zuhörern	Dative
digerierte	None
Schotts	Genitive
Hochleistungswerkstoffen	Dative
Altweibersommern	Dative
rationierte	None
Sulfosalzen	Dative
Frikativs	Genitive
Meeresschwammes	Genitive
fusionierten	None
sponsern	None
vergrault	None
Hartmetallen	Dative
Moleküls	Genitive
Derwischen	Dative
Wants	Genitive
Braunsteins	Genitive
idealisierte	None
Trugschlüssen	Dative
Rhodanids	Genitive
Hohlleiters	Genitive
Schwarzpulvers	Genitive
Prinzips	Genitive
Fiebern	Dative
Eingeweiden	Dative
verdanke	None
Sägezähnen	Dative
Geschwindigkeitsmessern	Dative
Verfassungsgerichten	Dative
klickt	None
Schmierfetten	Dative
Fundamentes	Genitive
versauernd	None
golfen	None
Wohnsitzes	Genitive
Stempeln	Dative
Laufwerkes	Genitive
Inkrafttretens	Genitive
Bilderbuches	Genitive
kastriert	None
Franke	Nominative
Zyklonen	Dative
Almanachen	Dative
Eiters	Genitive
vollzogen	None
Zinses	Genitive
verringere	None
Bordsteines	Genitive
Bildern	Dative
Fremdstoffen	Dative
Gotteshauses	Genitive
Bällchens	Genitive
Zipfeln	Dative
lancierte	None
Zeitnormals	Genitive
Kristallsystemen	Dative
zauberte	None
Fahrradfahrern	Dative
Diamantrings	Genitive
Bässen	Dative
Einfangquerschnittes	Genitive
Neuschnees	Genitive
Außenborders	Genitive
Salzstocks	Genitive
Indianern	Dative
Pflanzenölen	Dative
Armutszeugnisses	Genitive
Katapulten	Dative
Inditen	Dative
pfiffen	None
kaute	None
Gewächshäusern	Dative
interview	None
Schutzblechen	Dative
restaurieren	None
Borhydriden	Dative
Anhängseln	Dative
jucken	None
Balkonen	Dative
Domestik	Nominative
Volontären	Dative
Wahlkreises	Genitive
Gemurmels	Genitive
Filmemachern	Dative
Schmierblättern	Dative
fing	None
Ammoniumsalzen	Dative
Importeuren	Dative
Leumundes	Genitive
Rauchers	Genitive
ausgedrückt	None
transportierte	None
Quellflusses	Genitive
Barons	Genitive
Widerstandes	Genitive
siezten	None
Rätseln	Dative
geändert	None
verträten	None
Schmuckes	Genitive
Flugschreibers	Genitive
Preises	Genitive
hütetet	None
Marodeuren	Dative
Aufstiegs	Genitive
Seehafens	Genitive
getrommelt	None
Kapitels	Genitive
Zwischenproduktes	Genitive
Spanes	Genitive
Abwässern	Dative
gönnte	None
Quantencomputern	Dative
Vorgehens	Genitive
standardisiert	None
Alkalimetallsalzen	Dative
Falzes	Genitive
entzweite	None
Kämpen	Dative
bummeln	None
Anliegens	Genitive
verzählte	None
Stängeln	Dative
Bromiden	Dative
Erbobergespannes	Genitive
unterschreibt	None
galten	None
Dunkels	Genitive
Auerochse	Nominative
Haushaltsausschusses	Genitive
verbrauche	None
beabsichtigt	None
Honigbär	Nominative
Musters	Genitive
staube	None
kurbelet	None
Ornithologe	Nominative
begeisterten	None
Wohnsitzen	Dative
Mathematikern	Dative
Großonkels	Genitive
Hechten	Dative
moderiert	None
Jupitermonden	Dative
Strauches	Genitive
Selbstmordes	Genitive
Wertes	Genitive
Hesse	Nominative
Pflügen	Dative
Glycerins	Genitive
Einbrüchen	Dative
Verschwenders	Genitive
Kammes	Genitive
Werkstoffen	Dative
Weltalls	Genitive
schöne	None
Gauleitern	Dative
Fluorapatiten	Dative
Kardinals	Genitive
Oberbürgermeistern	Dative
ausrichten	None
verachten	None
läute	None
knackt	None
Drillingen	Dative
Anrufern	Dative
Risikos	Genitive
Indianers	Genitive
Beinamen	Dative
Federspitzes	Genitive
Sulfiden	Dative
Firmensitzes	Genitive
schockieren	None
späh	None
Friedensforschers	Genitive
Reaktionspartnern	Dative
Schutzengeln	Dative
Computers	Genitive
Dichtstoffes	Genitive
anstehen	None
erhebet	None
Gespenstern	Dative
Höllenfeuern	Dative
Cholesterins	Genitive
bettelten	None
versprachen	None
Sanatoriums	Genitive
Fließgleichgewichten	Dative
Friedensnobelpreises	Genitive
ummantelte	None
erkennten	None
abheben	None
Sarkophagen	Dative
beschneidet	None
Wildtieren	Dative
Zweigen	Dative
vereinfache	None
Abstürzen	Dative
Duetten	Dative
verständig	None
Gefäßes	Genitive
Nigerianers	Genitive
Trapezes	Genitive
unterlässt	None
Fußballern	Dative
äussertest	None
beeindruckte	None
Meteoriten	Dative
Fundstücken	Dative
Motorbootes	Genitive
Stadtgebietes	Genitive
übereingestimmt	None
Autoverkehrs	Genitive
Pütten	Dative
Knochenbrüchen	Dative
Flammschutzmitteln	Dative
versahen	None
Nanofarads	Genitive
Produkten	Dative
Ikosaedern	Dative
gestehe	None
Winters	Genitive
Referenzwerten	Dative
Hauptspiegels	Genitive
Eilanden	Dative
Fleischers	Genitive
Zeichners	Genitive
Cytostatikums	Genitive
Arbeitsschrittes	Genitive
Alpenvereinen	Dative
Verlages	Genitive
Pfennigen	Dative
schnüre	None
Premierministers	Genitive
Coventrierens	Genitive
Kabaretts	Genitive
Charmeuren	Dative
liefere	None
Speeres	Genitive
vermöchte	None
Babysitters	Genitive
Brotkastens	Genitive
Silbergehalts	Genitive
Kopfnüssen	Dative
Einsiedlern	Dative
Inkreises	Genitive
demokratisierst	None
Werkstücken	Dative
bremst	None
Feuers	Genitive
Graureihern	Dative
Bannes	Genitive
begehrte	None
empfing	None
Alkoholen	Dative
Achates	Genitive
Knies	Genitive
Füchsen	Dative
Vorschlages	Genitive
Phospholipiden	Dative
Bundesverbänden	Dative
laichet	None
Ufers	Genitive
spitzten	None
dechiffrieren	None
Arsenids	Genitive
fanatisierte	None
Quarzen	Dative
erkenntest	None
Ablegern	Dative
goutieren	None
Gerichtshofs	Genitive
Kranzes	Genitive
Engelhaien	Dative
Abschiedsbriefes	Genitive
Haltepunkten	Dative
fälsche	None
Abrissen	Dative
konnotierte	None
Geflügels	Genitive
Bannen	Dative
Bienenstöcken	Dative
strahl	None
kapiere	None
entsprängest	None
Afrikaners	Genitive
Nahrungsbestandteilen	Dative
filtern	None
Millionstelen	Dative
minderte	None
Leuchtkäfern	Dative
Handbüchern	Dative
Opfers	Genitive
Befehles	Genitive
Dönern	Dative
Treuhändern	Dative
simulierte	None
unterschätzte	None
verzögern	None
Dopamins	Genitive
flaniert	None
Heilkrautes	Genitive
regle	None
Ananassäften	Dative
fragmentierend	None
reichend	None
Tempels	Genitive
Departements	Genitive
Attentäters	Genitive
Kolbens	Genitive
Idiot	Nominative
bohrten	None
Ferroniobs	Genitive
Verdienstes	Genitive
zensiert	None
Radikals	Genitive
gekümmert	None
Sulfonamiden	Dative
kappt	None
plädierst	None
Albums	Genitive
dunkeln	None
Querschnitten	Dative
Dermatologe	Nominative
Haltepunktes	Genitive
perfektionieren	None
Behältern	Dative
Sedimentgesteinen	Dative
rührten	None
Glühfadens	Genitive
Heimatstädten	Dative
Barde	Nominative
Gewindes	Genitive
verklopptest	None
schnabulierte	None
necken	None
Plutoniums	Genitive
übernimmst	None
Schwanzes	Genitive
Gemäldes	Genitive
Autohöfen	Dative
beamt	None
schob	None
Buntbarschen	Dative
Verdecken	Dative
Aufstiegen	Dative
Bauelementes	Genitive
Lipiden	Dative
verifizieren	None
Fischmessers	Genitive
belle	None
kaueret	None
Türkenbundes	Genitive
emittiert	None
Gelenkes	Genitive
Sachse	Nominative
legalisierte	None
Feststoffen	Dative
Promotors	Genitive
Stiefsöhnen	Dative
Schlesiern	Dative
Zuckerphosphaten	Dative
Funkern	Dative
Rotscheitelreihers	Genitive
Autogrammen	Dative
Fagotten	Dative
treiben	None
materialisieren	None
absetzen	None
Weißpigments	Genitive
Aluminiumgalliumarseniden	Dative
Gegenspielern	Dative
Saphirs	Genitive
Paddels	Genitive
Schäfers	Genitive
Innenräumen	Dative
schießt	None
Sulfides	Genitive
Flugblatts	Genitive
Umsätzen	Dative
Hauptsätzen	Dative
Blitzableiters	Genitive
hydrolysiertet	None
Wirtschaftszweigen	Dative
Stannanen	Dative
gekratzt	None
Leopard	Nominative
Fliegers	Genitive
übermittelt	None
Absatzzeichens	Genitive
kompromittierst	None
Sonnenschirmes	Genitive
föntest	None
renommierten	None
Kommunarde	Nominative
Programmierers	Genitive
Furzers	Genitive
Lügnern	Dative
bewertete	None
Notfalles	Genitive
weidet	None
bier	None
Myzels	Genitive
Kares	Genitive
menstruiertest	None
versammelt	None
Versuches	Genitive
entflohen	None
besicherten	None
verkrochen	None
Tastsinnes	Genitive
Basaren	Dative
Habitaten	Dative
Heizleiters	Genitive
Mittelgebirges	Genitive
Pinguins	Genitive
Seeschiffes	Genitive
dürfen	None
Magiers	Genitive
Vergewaltigers	Genitive
vermittelte	None
Bienenwachses	Genitive
Ökologe	Nominative
Behältnissen	Dative
Kochtöpfen	Dative
Flaneuren	Dative
tendiert	None
Spannern	Dative
Felles	Genitive
Schiefers	Genitive
Wemfalles	Genitive
Aerosolen	Dative
Kriteriums	Genitive
avisierten	None
zermatschest	None
inhaftierten	None
begnügen	None
Fingerhandschuhs	Genitive
schnurren	None
Balte	Nominative
Feindbildern	Dative
Kanarienvögeln	Dative
Leerzeichens	Genitive
Sklavenhaltern	Dative
Logikgattern	Dative
Frühjahrs	Genitive
eskortieren	None
Sachbegriffes	Genitive
Kernes	Genitive
Vereines	Genitive
duellieren	None
ängstigest	None
Dotierelementen	Dative
Walzers	Genitive
liebe	None
Galaxienhaufens	Genitive
kühlen	None
spaziert	None
Briefes	Genitive
Klägern	Dative
Hochhauses	Genitive
Einbrechers	Genitive
Dorfbewohnern	Dative
interessiere	None
stocken	None
Funkers	Genitive
Kränzen	Dative
haar	None
überreichen	None
Grabhügeln	Dative
Kanonieren	Dative
Statthaltern	Dative
Ergusses	Genitive
Blauschimmelkäsen	Dative
Passes	Genitive
verüb	None
modifiziertet	None
Weltmärkten	Dative
kabeltet	None
Bekenntnissen	Dative
erstellt	None
Fernsehsendern	Dative
Anglers	Genitive
ringest	None
Nudelhölzern	Dative
Gehörnen	Dative
Gleitlagern	Dative
Hörern	Dative
gemästet	None
Germanist	Nominative
bersten	None
Ägypters	Genitive
hemm	None
genes	None
erfindest	None
Druckfehlern	Dative
Konklaves	Genitive
Verlegers	Genitive
rechnen	None
Stichtagen	Dative
Strichen	Dative
reimt	None
strich	None
Phosphates	Genitive
Mohr	Nominative
Springbrunnens	Genitive
Grusses	Genitive
Volksstammes	Genitive
Wärmetauschern	Dative
Rufen	Dative
Pennys	Genitive
Darmes	Genitive
eignete	None
Antidepressivums	Genitive
Unkrautes	Genitive
Wuchses	Genitive
Geheimdiensten	Dative
Antrages	Genitive
fliehend	None
formuliere	None
verweht	None
Prädikats	Genitive
Schlümpfen	Dative
Saitenspielen	Dative
Damhirschen	Dative
Bordells	Genitive
Notständen	Dative
Gemisches	Genitive
Querkopfes	Genitive
verschmilzt	None
Hexagons	Genitive
Tapiren	Dative
Samstagabends	Genitive
Edelweißen	Dative
Färbens	Genitive
verbarg	None
abwertend	None
Schlächtern	Dative
Regenpfeifern	Dative
veräußerte	None
Zauberspruches	Genitive
Großfürst	Nominative
Dynamits	Genitive
Niederländers	Genitive
Berylliumsalzen	Dative
klickte	None
Datensätzen	Dative
Zinngießers	Genitive
strafend	None
Jahreswechsels	Genitive
Unkräutern	Dative
Europäern	Dative
Anhaltspunktes	Genitive
Pessimist	Nominative
Planet	Nominative
Iodaten	Dative
Teichen	Dative
gedrängt	None
Journalen	Dative
prüfst	None
Angsthase	Nominative
Verboten	Dative
wärmte	None
verwehren	None
lobe	None
Seglers	Genitive
Konsument	Nominative
Schuldenschnitten	Dative
Schlagern	Dative
Ukrainern	Dative
Lotse	Nominative
zweifelte	None
Verlagen	Dative
erkaltend	None
Rappe	Nominative
fasest	None
Ebern	Dative
Rächers	Genitive
Halbfingerhandschuhs	Genitive
erschüfet	None
Rebhühnern	Dative
gepfropft	None
Koordinatensystemen	Dative
missachtetest	None
gespeichert	None
Grenzschutzes	Genitive
zählen	None
Präsident	Nominative
umgeschmolzen	None
Kandidat	Nominative
Hokuspokussen	Dative
entlädt	None
agierte	None
Aromas	Genitive
Ablässen	Dative
Mordanschlägen	Dative
Arbeitsdienstes	Genitive
ackeret	None
Enzymen	Dative
optimieren	None
Büffeln	Dative
schiel	None
Durchbrüchen	Dative
begrabsche	None
Biobauer	Nominative
Dreirädern	Dative
Bescheides	Genitive
Fahrradständers	Genitive
Blenders	Genitive
notierten	None
kompostiertet	None
Kiesen	Dative
Klötzen	Dative
Marschällen	Dative
Volltexten	Dative
Ledern	Dative
fällte	None
schwächelte	None
Herstellungsverfahrens	Genitive
Benutzernamens	Genitive
Mittelfeldern	Dative
Johannisbrotgewächsen	Dative
Meridianen	Dative
besonnen	None
verschleppt	None
Vertreters	Genitive
fließend	None
Abstimmungsortes	Genitive
gebremst	None
verfüge	None
Freitagabends	Genitive
Amiden	Dative
Blätterpilzen	Dative
Elfmeters	Genitive
Ökosystems	Genitive
Erstarrens	Genitive
Ukrainers	Genitive
lullte	None
Kaminen	Dative
Stellvertretern	Dative
verdunstete	None
Wirbeltieren	Dative
Leichtmetalls	Genitive
blockierend	None
besinne	None
Gebietes	Genitive
verwehte	None
Oligosacchariden	Dative
Herstellungsprozessen	Dative
vermische	None
Quelltexten	Dative
Griffels	Genitive
Antonymen	Dative
Patronymikons	Genitive
Tonnengewölbes	Genitive
Magnetfeldes	Genitive
Cytochromen	Dative
immunisieret	None
Steiges	Genitive
Lagers	Genitive
kontrastiert	None
Oberschenkeln	Dative
Markgraf	Nominative
blamiert	None
Afroamerikanern	Dative
beaufsichtigten	None
Phantomen	Dative
Besteckes	Genitive
Schwenkbügeln	Dative
veräußern	None
Versen	Dative
dokumentierst	None
Italieners	Genitive
Rückwärtsganges	Genitive
Belten	Dative
Bewerbungsgesprächen	Dative
bessere	None
Äpfeln	Dative
Bügeleisens	Genitive
kreis	None
verdammte	None
Brautkleidern	Dative
Nagers	Genitive
Minerals	Genitive
Weißpunktbuntbarsches	Genitive
begehr	None
Allgemeinbefindens	Genitive
triumphierten	None
Nachttisches	Genitive
Violinkonzerts	Genitive
oktroyierte	None
Rezepten	Dative
tätige	None
Schmerzmittels	Genitive
Findlings	Genitive
abgespeckt	None
Kniffen	Dative
Elektromotors	Genitive
Piratensenders	Genitive
beglückwünschtest	None
riehe	None
Transvestit	Nominative
Zusatzes	Genitive
Fruchtsäften	Dative
stampft	None
Funktionsbausteinen	Dative
Mehlen	Dative
Verwalters	Genitive
Gangstern	Dative
verdrängte	None
Gewürzen	Dative
nagle	None
Xylems	Genitive
Torhütern	Dative
Strontiummetallen	Dative
Geschmacksstoffes	Genitive
Hauptfaktors	Genitive
Eisbohrkernen	Dative
Leichtern	Dative
Pilotprojekten	Dative
Inertialsystems	Genitive
immigrierten	None
Tageslichts	Genitive
Divisors	Genitive
entstammten	None
Fechters	Genitive
Datenschutzes	Genitive
Zelot	Nominative
Eckchens	Genitive
Gaules	Genitive
Jagdpanzern	Dative
schwelle	None
Seeadlern	Dative
nähe	None
Augenglases	Genitive
Aktenordnern	Dative
bestätigend	None
Frostes	Genitive
Verbundstoffen	Dative
Generators	Genitive
besann	None
schluck	None
Ferngläsern	Dative
Leukozyt	Nominative
flirten	None
masturbiert	None
Felsbodens	Genitive
Kortholten	Dative
klatschen	None
Bilderbüchern	Dative
fangen	None
Globins	Genitive
beeindrucken	None
erklärten	None
markiere	None
Kohyponymen	Dative
Baders	Genitive
erfordern	None
mixt	None
Schöpflöffeln	Dative
Wohnheimen	Dative
betrifft	None
Vergleichen	Dative
Einschlägen	Dative
turnt	None
Golfschlägern	Dative
gesoffen	None
Pfeilern	Dative
unterwarf	None
Ködern	Dative
Paaren	Dative
empfänden	None
verwirrst	None
kompiliertet	None
Kernpunkten	Dative
Kalken	Dative
Republikflüchtlingen	Dative
beschäftig	None
Affekten	Dative
Atomreaktoren	Dative
induziert	None
Wahlmännern	Dative
Lazaretten	Dative
folgt	None
Fliegenpilzen	Dative
Bohrers	Genitive
Einwohners	Genitive
Leitkegels	Genitive
Gebrüdern	Dative
Kaffeehäusern	Dative
kontaminieren	None
Anschlägen	Dative
Kaninchens	Genitive
zelebriere	None
Prügeln	Dative
registrier	None
Bröseln	Dative
Ferkeln	Dative
Gemüsegeschäftes	Genitive
Notfällen	Dative
Klarinettist	Nominative
kieke	None
Faktums	Genitive
Bestecken	Dative
konzessionier	None
etabliere	None
verfärben	None
Metallocenen	Dative
Lüftern	Dative
Eigenwertproblemen	Dative
Zuckerbäckers	Genitive
Grenzwerten	Dative
Neujahrstagen	Dative
bezichtigte	None
eingesetzt	None
Vorhanges	Genitive
Märchens	Genitive
verschwöret	None
Ortsteines	Genitive
Schlachtschiffen	Dative
erriet	None
Gnomen	Dative
bequem	None
Lenkers	Genitive
winkt	None
Abiturs	Genitive
Überresten	Dative
Frauenzimmern	Dative
Serienmörders	Genitive
Ankömmlings	Genitive
Sauerstoffmangels	Genitive
Hämoglobins	Genitive
Aluminiumblechen	Dative
dublieren	None
meistert	None
Journalist	Nominative
Aragonits	Genitive
Vordenkern	Dative
Dokumentes	Genitive
Zügeln	Dative
gequatscht	None
Metallatomen	Dative
Asteroid	Nominative
verlangsam	None
Waschmitteln	Dative
Hungersnöten	Dative
lindere	None
Schwimmern	Dative
buchstabiert	None
Schäfern	Dative
Einstiegen	Dative
Abbrüchen	Dative
Oberkellners	Genitive
Gästezimmern	Dative
Arsenatomen	Dative
Surrealist	Nominative
Wikiwörterbüchern	Dative
genehmige	None
Faszikeln	Dative
Priorates	Genitive
Riedeln	Dative
verbeugt	None
Hurrikanen	Dative
Hafenbeckens	Genitive
naht	None
Vorsitzen	Dative
Kupfererzes	Genitive
Samstagnachmittags	Genitive
Festelektrolytes	Genitive
Erlösern	Dative
surft	None
begrenze	None
Treuhänders	Genitive
Attributes	Genitive
kram	None
Ausgangsmaterials	Genitive
striche	None
bedürfte	None
Eintöpfen	Dative
Fabrikaten	Dative
Bordsteinen	Dative
Rostflügel-Ameisenwürgers	Genitive
Scheitelpunkts	Genitive
fertige	None
Putzes	Genitive
Turbans	Genitive
Sitzbeines	Genitive
Filzen	Dative
Fremdenverkehrs	Genitive
Isotopen	Dative
stampfe	None
Belgiern	Dative
Emiren	Dative
gründeten	None
Additiven	Dative
beleidigst	None
Katamarans	Genitive
spitzest	None
Speichelleckern	Dative
transferierten	None
zugegeben	None
Metallstücken	Dative
Spielräumen	Dative
Stadiums	Genitive
nachvollziehen	None
Dienstgrades	Genitive
Eintritten	Dative
Zahnstochers	Genitive
Gewichten	Dative
Gräbern	Dative
Planetensystems	Genitive
versunken	None
downloadetet	None
Kanarienvogels	Genitive
Firmennamens	Genitive
gekotzt	None
Obergespannen	Dative
reduziere	None
Überschüßen	Dative
Monogrammen	Dative
Stoffwechselprodukts	Genitive
gesiegt	None
Freizeitzentrums	Genitive
Dromedars	Genitive
Kommens	Genitive
alarmiertest	None
Vampiren	Dative
Triebwerkes	Genitive
Pertechnetats	Genitive
Vorbildes	Genitive
infizierte	None
Fettalkoholen	Dative
liquidieren	None
Madrigales	Genitive
Muttersprachlern	Dative
Dinukleotids	Genitive
Kaisers	Genitive
Tierschützern	Dative
ermögliche	None
Heilmitteln	Dative
Pfeilers	Genitive
Hagels	Genitive
Beteiligte	Nominative
NAND-Gattern	Dative
kämpfend	None
zugeben	None
Föhnen	Dative
abgeschieden	None
Herings	Genitive
reiten	None
Stilllebens	Genitive
Apostels	Genitive
Neutrons	Genitive
erwähne	None
Nachweises	Genitive
priesest	None
wickelt	None
Entdeckern	Dative
arrangier	None
beschleunigend	None
krähte	None
Gutachters	Genitive
getadelt	None
abblitzen	None
klingelt	None
zerstört	None
Telegramms	Genitive
Entschlusses	Genitive
tätowieren	None
zerquetschet	None
berechtige	None
Mitläufern	Dative
Produktes	Genitive
Himmelsäquators	Genitive
Ausweises	Genitive
Säuglings	Genitive
Finalen	Dative
donnerte	None
Gläubigers	Genitive
Gestades	Genitive
Kongresses	Genitive
Protist	Nominative
Parallelogramms	Genitive
Peptids	Genitive
Magnesiumions	Genitive
parke	None
Jahresüberschusses	Genitive
Vetters	Genitive
Ersatzstoffen	Dative
Pfarrers	Genitive
Bordellen	Dative
transloziert	None
Wattenmeeren	Dative
begegneten	None
Bruchteilen	Dative
Zeiträumen	Dative
Containerschiffs	Genitive
Opalen	Dative
Segels	Genitive
geglüht	None
Taschentüchern	Dative
Zusammenhängen	Dative
Nachteilen	Dative
Benutzerkontos	Genitive
plädierten	None
ruderten	None
Stadions	Genitive
koagulierend	None
Adverbs	Genitive
Halbdoppellautes	Genitive
Kondomen	Dative
Besuchern	Dative
Anbieters	Genitive
Mammakarzinoms	Genitive
Krankenpflegern	Dative
Hyponyms	Genitive
Bierchens	Genitive
Wikipedianers	Genitive
fotografieret	None
Angriffen	Dative
schürfte	None
Zahnfleisches	Genitive
Fuhrwerken	Dative
Holzschnitten	Dative
vertonten	None
Durchschnitts	Genitive
Formularen	Dative
eskaliert	None
tage	None
Weltraumteleskops	Genitive
nominierten	None
Stegen	Dative
Giebeln	Dative
Druckbehälters	Genitive
Leichtmetallen	Dative
Verbrennungsprozessen	Dative
entkomme	None
Schlagers	Genitive
Luftschlägen	Dative
Rotgüssen	Dative
Mittelfeldes	Genitive
Idealen	Dative
funktionalisieren	None
Bierdeckels	Genitive
Schmugglern	Dative
Telefonaten	Dative
Lebensjahres	Genitive
Braumeisters	Genitive
vermeßen	None
rast	None
berührst	None
Erdmantels	Genitive
Apparates	Genitive
Hieben	Dative
Anbietern	Dative
katalysieren	None
Druckmitteln	Dative
Phantoms	Genitive
Grundstücken	Dative
bewirke	None
Kreistages	Genitive
Zeitstempeln	Dative
gezittert	None
Telluriums	Genitive
Blutgerinnsels	Genitive
pendle	None
Autobahnknotens	Genitive
errötet	None
Funke	Nominative
Flößen	Dative
streikt	None
Gemischen	Dative
beerdig	None
Empfängen	Dative
Lenzen	Dative
schieß	None
Chromaten	Dative
Fraßen	Dative
Zeitschlitzen	Dative
Geschichtsbüchern	Dative
Gebers	Genitive
kracht	None
Zitronenhaies	Genitive
Werkzeugen	Dative
Gestaden	Dative
Truthähnen	Dative
probte	None
Vortrages	Genitive
Goldhamsters	Genitive
Frikativen	Dative
Genetikern	Dative
Niets	Genitive
Sonnenfinsternissen	Dative
recherchiere	None
übersiehst	None
Lehmen	Dative
Anstrichen	Dative
intrigieret	None
Vorstößen	Dative
Stoffes	Genitive
Donners	Genitive
Addukten	Dative
Großmeistern	Dative
Kriegern	Dative
Weilers	Genitive
Flötist	Nominative
kategorisierten	None
Einzelgängers	Genitive
kapsle	None
veröffentliche	None
geleiten	None
Votums	Genitive
Passivrauchens	Genitive
Fischadlers	Genitive
lokalisierte	None
Gehabes	Genitive
Kühlschmierstoffes	Genitive
XNOR-Gatters	Genitive
Trampelpfaden	Dative
Brennelementen	Dative
Troges	Genitive
eingebrochen	None
unternehmen	None
Kunststoffes	Genitive
Guthabens	Genitive
peroxidierend	None
Klebern	Dative
Montagnachmittags	Genitive
Baldachinen	Dative
Übergriffen	Dative
Monologen	Dative
behalte	None
Beifahrersitzen	Dative
Spinates	Genitive
Polygonen	Dative
Beifahrers	Genitive
Warzenschweinen	Dative
Abhängen	Dative
hinterlassend	None
Hüttenwerkes	Genitive
Arsenkupfers	Genitive
Feuerkäfern	Dative
Beiräten	Dative
Bundesräten	Dative
plünderten	None
Amtsgerichten	Dative
verzieren	None
Phosphazenen	Dative
Favorit	Nominative
Stockwerken	Dative
Messgeräten	Dative
belassend	None
Treibhausgasen	Dative
Fröschen	Dative
Bambuswäldern	Dative
Steuerberatern	Dative
Strudels	Genitive
Prinz	Nominative
mampfend	None
Tennisplätzen	Dative
ereignete	None
Branntkalks	Genitive
zugehen	None
Steinkauzes	Genitive
bewaffnen	None
Oberbürgermeisters	Genitive
pochtest	None
Ferners	Genitive
Innenministers	Genitive
Sprosses	Genitive
Mörteln	Dative
Koteletten	Dative
quer	None
Arzneimitteln	Dative
Anrufers	Genitive
Coelestins	Genitive
Spielers	Genitive
Zahlwortes	Genitive
boxe	None
Bestandteilen	Dative
Coulombs	Genitive
Ständern	Dative
Vorräten	Dative
Kritikers	Genitive
Ausschüssen	Dative
Vierteljahrhunderts	Genitive
Automatikgetrieben	Dative
Sämlingen	Dative
Flaschenöffnern	Dative
Sekretären	Dative
Gases	Genitive
benachrichtigten	None
entstamme	None
räum	None
Fasanen	Dative
Ions	Genitive
grolle	None
Trolles	Genitive
schützten	None
Habichten	Dative
Geländen	Dative
Hauptgerichten	Dative
Vorstandsmitgliedes	Genitive
danktet	None
Morphems	Genitive
fliehet	None
Calvinist	Nominative
Bauchnabels	Genitive
gemehrt	None
Nachträgen	Dative
Bauernfrühstücken	Dative
Atomreaktors	Genitive
Aggressors	Genitive
Hufes	Genitive
Absturzes	Genitive
Einsatzes	Genitive
XOR-Gattern	Dative
Kryostaten	Dative
Vorwürfen	Dative
Gefangensein-Syndroms	Genitive
verletzte	None
kapitulierten	None
Kursen	Dative
Grieche	Nominative
bremstet	None
klingst	None
Windhunden	Dative
Instrumentes	Genitive
Durchschnittswerten	Dative
belüften	None
Vestibüls	Genitive
Ferchromiden	Dative
Leuchters	Genitive
Strontianiten	Dative
bestrafst	None
Fickern	Dative
Spielfeldes	Genitive
Kürschners	Genitive
Passagiers	Genitive
Dienstagabends	Genitive
Düften	Dative
Verlangens	Genitive
Offenbarungseides	Genitive
anfassen	None
Bodens	Genitive
Rumpfes	Genitive
negiert	None
Deltas	Genitive
Kapellmeisters	Genitive
Schiffsverkehrs	Genitive
Niobats	Genitive
Campingplätzen	Dative
kotz	None
Sümpfen	Dative
bedeckt	None
Testosterons	Genitive
Schlafsälen	Dative
Anfällen	Dative
Abstimmungsorten	Dative
starte	None
Hurritern	Dative
Übersetzens	Genitive
Etheren	Dative
Indikativs	Genitive
Strafstoßes	Genitive
verweiltest	None
Kegels	Genitive
Biwaks	Genitive
Buntstiften	Dative
schlachte	None
eingestanden	None
taste	None
Hermaphrodit	Nominative
Trottels	Genitive
Aktionärs	Genitive
Zwergschwänen	Dative
Sausewinden	Dative
einbauen	None
verbeugte	None
Silikonen	Dative
Boriden	Dative
Magnesiumsalzen	Dative
entfalteten	None
Chalkosins	Genitive
Beines	Genitive
Augapfels	Genitive
Wettkampfes	Genitive
Urinalen	Dative
schärfe	None
Bohrens	Genitive
Sammlern	Dative
lehren	None
Zoologe	Nominative
Kabeljaus	Genitive
Serbe	Nominative
kicherten	None
Nadelbäumen	Dative
brüniert	None
Hexacyanoferraten	Dative
antizipierte	None
Emmers	Genitive
Debakels	Genitive
Europameisters	Genitive
Zaubers	Genitive
scheiterte	None
deaktiviert	None
Luftströmen	Dative
Schwüngen	Dative
mißlungen	None
überreichst	None
Biologe	Nominative
Detektiven	Dative
Waschbär	Nominative
Quantenpunkts	Genitive
Fürwörtern	Dative
Verträgen	Dative
Stromnetzen	Dative
Stoffwechselwegen	Dative
Bebens	Genitive
Klassenkamerad	Nominative
Felses	Genitive
Vierteln	Dative
Einwohnern	Dative
Schildläusen	Dative
Grabes	Genitive
Drehimpulsen	Dative
Sklave	Nominative
Piktogrammen	Dative
taxierte	None
Fünfteln	Dative
schüttle	None
Zandern	Dative
laiche	None
Germans	Genitive
Hüttenwerken	Dative
integriere	None
Monogramms	Genitive
stationieren	None
weideten	None
Feldherr	Nominative
Stürmern	Dative
Beratern	Dative
Herbstwaldes	Genitive
Tetrafluoriden	Dative
Appenzellern	Dative
mariniertet	None
verästle	None
Rentenmarktes	Genitive
Baggers	Genitive
setztet	None
schädigte	None
versteckte	None
Geländers	Genitive
besiegt	None
Leguanen	Dative
genährt	None
Schädlingsbekämpfungsmitteln	Dative
Implantates	Genitive
Fremdkörpern	Dative
Denunziant	Nominative
Zuflusses	Genitive
Fängen	Dative
Spitzeln	Dative
betoniere	None
Teilnehmern	Dative
Piratenschiffen	Dative
Elementarteilchens	Genitive
Bandit	Nominative
Hundeführers	Genitive
Kondoms	Genitive
schnitzte	None
präsentieren	None
Hakenkreuzes	Genitive
Nationalspielern	Dative
bestell	None
Anthocyans	Genitive
Bolzplatzes	Genitive
Panzerschrecken	Dative
rauchen	None
Welpe	Nominative
Finks	Genitive
Geiern	Dative
protokollierte	None
Crickets	Genitive
Rufes	Genitive
Computern	Dative
belohnte	None
Gewittern	Dative
Augur	Nominative
Zuckerphosphats	Genitive
Rassist	Nominative
Fanals	Genitive
Rubels	Genitive
Heringen	Dative
Überfalles	Genitive
Putschist	Nominative
Blechteilen	Dative
Perlhühnern	Dative
Schwefelhalogenids	Genitive
Stichen	Dative
Gauners	Genitive
Dampfes	Genitive
Häftlingen	Dative
Parteitagen	Dative
Antibiotikums	Genitive
Dünsten	Dative
verbanntet	None
repräsentierte	None
geköpft	None
Verdachten	Dative
Übermensch	Nominative
Fluoreszenzfarbstoffen	Dative
justieren	None
profitieren	None
Fenneks	Genitive
Geständnissen	Dative
interpretier	None
Pergamenten	Dative
Stricken	Dative
Doppels	Genitive
Anlassens	Genitive
Küchengeräten	Dative
auslaugend	None
Kurieren	Dative
Landesverrates	Genitive
Mischoxiden	Dative
Prädikaten	Dative
Klebers	Genitive
Grundbesitzern	Dative
galoppiert	None
Vertretern	Dative
soufflieret	None
dissoziierten	None
Gemälden	Dative
knallt	None
Hodensackes	Genitive
Aberglaube	Nominative
gratulierten	None
intrigierte	None
Lindenbäumen	Dative
Schroten	Dative
Döschens	Genitive
verleihe	None
vernehmt	None
befassen	None
Edelgasen	Dative
sengte	None
Strukturproteinen	Dative
Papieres	Genitive
Heilkräutern	Dative
Transportern	Dative
Außenministern	Dative
Brandanschlages	Genitive
rawbtet	None
Förderländern	Dative
Peroxiden	Dative
Verkehrsunfällen	Dative
Phosphormolybdats	Genitive
Zementen	Dative
Obsidianen	Dative
billige	None
platzierten	None
Fachärzten	Dative
Blutfarbstoffen	Dative
Behufs	Genitive
Servers	Genitive
revolutionieren	None
Außenwänden	Dative
Granulaten	Dative
Diamantringeffekts	Genitive
Jongleurs	Genitive
Rundfunkgeräten	Dative
Sprichwörtern	Dative
Oolith	Nominative
erstäche	None
Maurers	Genitive
versprich	None
Lebensräumen	Dative
Lidern	Dative
Liters	Genitive
Aufpralles	Genitive
Affe	Nominative
Floren	Dative
Hypobromiten	Dative
Kasache	Nominative
Magistern	Dative
immigrierte	None
Winkeln	Dative
Behelfen	Dative
betätige	None
Puppenspielers	Genitive
Lebensmittelfarbstoffs	Genitive
Schreibers	Genitive
erlegen	None
Senates	Genitive
wandelnd	None
entvölkern	None
Fingerspitzengefühlen	Dative
Außenbordeinsätzen	Dative
Finanzministeriums	Genitive
Luchsen	Dative
Landstreichers	Genitive
Zebrahaien	Dative
Hirt	Nominative
Stammbaumes	Genitive
Freundes	Genitive
Pendlern	Dative
Pilgers	Genitive
bessert	None
Spieles	Genitive
autorisieren	None
Duckmäusers	Genitive
Signalen	Dative
Pioniers	Genitive
Hüttenkäses	Genitive
Essenern	Dative
erstach	None
Meißels	Genitive
bombardieren	None
verzichte	None
gekühlt	None
besteche	None
Leipzigers	Genitive
empörend	None
Krampfes	Genitive
Nervensystems	Genitive
Mitgliedes	Genitive
Drehimpulses	Genitive
Nomade	Nominative
Managers	Genitive
Untersuchungsausschusses	Genitive
Putzmännern	Dative
Gläubigern	Dative
Mitwissern	Dative
Transportwegen	Dative
Gegenpäpsten	Dative
Zinkats	Genitive
Freitoden	Dative
Zauberern	Dative
Fahndern	Dative
Bauwerken	Dative
Dampferzeugers	Genitive
gedeihend	None
verarbeitet	None
Zählern	Dative
Mohnen	Dative
Ärmeln	Dative
Elektromagneten	Dative
Arsentribromids	Genitive
Zirkeln	Dative
Straßenschildern	Dative
Kupfererzen	Dative
Nachkomme	Nominative
Podiumsgespräches	Genitive
Hüttenkäsen	Dative
kommerzialisierte	None
staubsaugen	None
Fullerenen	Dative
prognostizierst	None
Goldschakales	Genitive
Pfirsiches	Genitive
wiederentdeckten	None
Bowdenzuges	Genitive
Spitälern	Dative
Jahresberichtes	Genitive
Forums	Genitive
beruhend	None
Tellern	Dative
verworfen	None
Koogs	Genitive
Physikers	Genitive
Vorjahren	Dative
werten	None
Gebüschen	Dative
Ereignisses	Genitive
Verkäufen	Dative
Wassermoleküls	Genitive
Germaniums	Genitive
umgeben	None
Aristokrat	Nominative
kläffest	None
Produktionslands	Genitive
kalkulierten	None
Amphibienfahrzeuges	Genitive
stach	None
Überläufern	Dative
Geschwüren	Dative
Wahlergebnisses	Genitive
rülps	None
Angreifers	Genitive
Kinderbuches	Genitive
Bruchstücken	Dative
Veilchens	Genitive
Einzuges	Genitive
Nadelholzes	Genitive
Trampolinen	Dative
Trakts	Genitive
Praktikums	Genitive
Schlittschuhes	Genitive
erachtete	None
Entschlüssen	Dative
Sonntagabends	Genitive
bestand	None
Knappe	Nominative
Magenkrebses	Genitive
Klavieres	Genitive
Amtes	Genitive
Teslas	Genitive
Drahtes	Genitive
fotografierte	None
Gerbers	Genitive
Polysulfiden	Dative
Pflanzenschutzes	Genitive
Warenkorbes	Genitive
Hinweisen	Dative
Blühens	Genitive
Blümchens	Genitive
Bodybuilders	Genitive
enttäuschtest	None
Uhrglasnagels	Genitive
Wahlmannes	Genitive
Heilanden	Dative
Prozessabläufen	Dative
Jochbeinen	Dative
lauteten	None
Knüppeln	Dative
verschieb	None
penne	None
Daumens	Genitive
Isomeren	Dative
Akuten	Dative
U-Booten	Dative
berührend	None
quaken	None
Karthagers	Genitive
Kolbeckiten	Dative
Pharmakons	Genitive
Hautkontakten	Dative
rechtfertigt	None
schelle	None
mulchten	None
Wortstammes	Genitive
Reimen	Dative
Baumstämmen	Dative
Anthrazits	Genitive
Schornsteinfegern	Dative
Profiten	Dative
gestikuliert	None
Getrieben	Dative
Salzwassers	Genitive
Dezen	Dative
Erdbodens	Genitive
Inhaltsverzeichnissen	Dative
Foliensatzes	Genitive
Beständen	Dative
scheure	None
Austausches	Genitive
Thüringern	Dative
Vorträgen	Dative
Karbonatiten	Dative
gebaggert	None
Hauptreihensternen	Dative
Alveolaren	Dative
Gemütes	Genitive
Parkinsons	Genitive
Titelverteidigern	Dative
drang	None
gezackt	None
Nickelarseniden	Dative
Sozialarbeitern	Dative
Gleithörnchens	Genitive
oute	None
Pflanzenwachstums	Genitive
Bausoldat	Nominative
vermerkt	None
Trampeltieres	Genitive
Verlegern	Dative
Schnipseln	Dative
Schwächegefühles	Genitive
dämpfend	None
Gasthauses	Genitive
Orchestern	Dative
Hirnschädels	Genitive
Halsbandes	Genitive
Gasgemischen	Dative
Herrschern	Dative
Dompteuren	Dative
hascht	None
erzeugt	None
befinde	None
Drittels	Genitive
Bundesministers	Genitive
vernachlässigtest	None
Orkanen	Dative
Hochaltares	Genitive
Weibern	Dative
Staubblättern	Dative
Domes	Genitive
Hirtenhunden	Dative
stochern	None
überredet	None
stärkt	None
schalt	None
identifiziert	None
Beiles	Genitive
Siedepunkten	Dative
Wortstämmen	Dative
Planes	Genitive
Student	Nominative
Überfällen	Dative
knechte	None
Krampfanfällen	Dative
Müllmannes	Genitive
Parasit	Nominative
Einflüssen	Dative
Stücken	Dative
vandalieren	None
Wachhunden	Dative
Kaffeehauses	Genitive
multiplizierten	None
Rebstöcken	Dative
Zeitgenosse	Nominative
Blitzschlägen	Dative
Schießpulvers	Genitive
lobend	None
schalten	None
geschissen	None
Coenzyms	Genitive
Jagdbombern	Dative
Affenpinschers	Genitive
Fluorierungsmittels	Genitive
Geheimdienstes	Genitive
Därmen	Dative
Verbotes	Genitive
tröstetest	None
balancier	None
Teleskops	Genitive
Däne	Nominative
Saxophonist	Nominative
Exzessen	Dative
Weißrusse	Nominative
Sermones	Genitive
pubertiert	None
Kriegsschiffen	Dative
Münzmetalls	Genitive
Mineralen	Dative
Gedichtes	Genitive
Schwellenwerten	Dative
Ejakulaten	Dative
Empfängers	Genitive
Ankers	Genitive
knips	None
Impressionist	Nominative
wirke	None
erhoffe	None
Feigenbäumen	Dative
getropft	None
Auftritten	Dative
erachtest	None
bezahlten	None
fesselten	None
Präfekt	Nominative
qualmen	None
Separatist	Nominative
Sparpaketen	Dative
geklopft	None
hetzt	None
hinterlegen	None
Chaot	Nominative
Überschusses	Genitive
Abfallprodukten	Dative
kapern	None
Nährstoffen	Dative
blätterte	None
Standardwerkes	Genitive
Gedankens	Genitive
Antigens	Genitive
Ulmern	Dative
Massendefekts	Genitive
Unteroffiziers	Genitive
Profiles	Genitive
Kirchenbänken	Dative
Verlaufes	Genitive
Nitraten	Dative
Gneisen	Dative
Reichsfürst	Nominative
Epitaphen	Dative
entfaltet	None
eiterte	None
Dämpfen	Dative
Siegen	Dative
kauen	None
Großvätern	Dative
Hinterbänklern	Dative
Briketts	Genitive
Lichtjahres	Genitive
ausgeübt	None
Gemütern	Dative
Getriebes	Genitive
Künstlerromanen	Dative
Anführern	Dative
Inselbewohnern	Dative
Kadavers	Genitive
latinisiert	None
Hofnarr	Nominative
Hauptprozessor	Nominative
Bundesgrenzschutzes	Genitive
Wollhandschuhs	Genitive
Schlagbäumen	Dative
Scanners	Genitive
Buchladens	Genitive
Endokrinologe	Nominative
Premierministern	Dative
Bezugspunktes	Genitive
Schuhlöffeln	Dative
Zelten	Dative
prostituierest	None
Belgiers	Genitive
parken	None
Spendern	Dative
Bosniern	Dative
musizierten	None
schnüffelest	None
Schusswechseln	Dative
Komplexbildnern	Dative
Spaltproduktes	Genitive
Viertels	Genitive
bahntet	None
Hotelgästen	Dative
Gewächsen	Dative
Schuften	Dative
Flieders	Genitive
Anrufbeantwortern	Dative
Füllstoffen	Dative
Centers	Genitive
Zehnt	Nominative
Gressenichern	Dative
Skandalen	Dative
Luftschiffes	Genitive
Herausgebers	Genitive
weißsag	None
Kormorans	Genitive
empfange	None
Vorstandsmitgliedern	Dative
seufzend	None
missling	None
unterzeichneten	None
gekichert	None
Nestlingen	Dative
Privatpatient	Nominative
entlastet	None
Rammelsbergiten	Dative
Manuales	Genitive
Unfalles	Genitive
Mikronährstoffen	Dative
Schiffshebewerkes	Genitive
beschichtet	None
Fotopapieren	Dative
Rummels	Genitive
Fickers	Genitive
Zeitsoldat	Nominative
Todesfalles	Genitive
Zusammenbruches	Genitive
Instrumentals	Genitive
zerbreche	None
Autoabgasen	Dative
Lebensjahren	Dative
Brenners	Genitive
quadrierten	None
Archipelen	Dative
übernahmen	None
absondernd	None
Selendefizits	Genitive
bewehren	None
Selbstmorden	Dative
Donors	Genitive
Gauleiters	Genitive
konstruieren	None
Virtuose	Nominative
ausgestrahlt	None
sprenge	None
Sessels	Genitive
Gänsesägern	Dative
verschwendet	None
Wahlergebnissen	Dative
zertifizierten	None
Tetraiodiden	Dative
hinreißen	None
Eigenname	Nominative
fessle	None
vereinbarend	None
sezierend	None
Gesetzeshütern	Dative
Graten	Dative
Blumenmusters	Genitive
Archäologe	Nominative
Spornen	Dative
Chemikern	Dative
Generalsekretärs	Genitive
Konzertsaales	Genitive
Chipsätzen	Dative
modellierten	None
Schlingeln	Dative
Schneidwerkzeuges	Genitive
Adjutant	Nominative
leisteten	None
Gegenpapstes	Genitive
strecken	None
Aderhäuten	Dative
Rohstoffen	Dative
Sprachraumes	Genitive
Federspitzen	Dative
pikier	None
jagen	None
Schleppers	Genitive
Luftangriffes	Genitive
Einfallsreichtums	Genitive
Nackens	Genitive
Konsortiums	Genitive
belästigst	None
Kupferstichen	Dative
bedecken	None
Büstenhaltern	Dative
Resonators	Genitive
Flittern	Dative
pflegten	None
Laiben	Dative
Kabinetts	Genitive
Päckchens	Genitive
ersticke	None
liebäugelnd	None
Kontrapunkten	Dative
ext	None
kränkeltet	None
Dramas	Genitive
Festspielen	Dative
Atomgewichts	Genitive
Weltmarktpreisen	Dative
Notausgängen	Dative
Sadist	Nominative
Dezernates	Genitive
einwickeln	None
plädierte	None
Hochhäusern	Dative
Kunstwerkes	Genitive
Strängen	Dative
Akkumulators	Genitive
Torschütze	Nominative
bewahre	None
Fechtern	Dative
süßen	None
begnadigen	None
Schneefällen	Dative
Gewichtsanteiles	Genitive
Zyprers	Genitive
empfindet	None
Linksverkehren	Dative
Pulten	Dative
offenbaren	None
bescheren	None
Musketiers	Genitive
Gneises	Genitive
Standpunktes	Genitive
Aktienmärkten	Dative
Elches	Genitive
ergebet	None
Prüflings	Genitive
Löwenköpfen	Dative
Packgases	Genitive
Gasthäusern	Dative
Kontakten	Dative
Alkens	Genitive
Repräsentant	Nominative
angelegt	None
geschnitten	None
sticht	None
Kleinkindern	Dative
Dekreten	Dative
betonierten	None
Fluiden	Dative
Erdgeschoßes	Genitive
Hörspielen	Dative
Nachzüglers	Genitive
Bergwerkes	Genitive
kalkulier	None
Attentates	Genitive
Clusters	Genitive
Knubbeln	Dative
Sitzplatzes	Genitive
Ahn	Nominative
Gesamtverbands	Genitive
Weltkriegen	Dative
karikierten	None
streuen	None
gescheitert	None
quetschend	None
Stellenwertes	Genitive
erpressen	None
verwaisen	None
Pullovern	Dative
Ungar	Nominative
Halonen	Dative
Urlauben	Dative
Pionieren	Dative
Fanges	Genitive
debattiert	None
Verbindungsdrahtes	Genitive
Weihern	Dative
gehandhabt	None
Schuldners	Genitive
Mondfinsternissen	Dative
Segelflugzeuges	Genitive
Einsatzgebieten	Dative
parfümierte	None
Lehrlinges	Genitive
Daseins	Genitive
mitgebracht	None
entweich	None
Anscheins	Genitive
Honorars	Genitive
Euters	Genitive
Fraters	Genitive
Physikern	Dative
Azofarbstoffen	Dative
Kometenschweifen	Dative
injizierte	None
Irrgartens	Genitive
Marders	Genitive
Ziegelsteinen	Dative
karren	None
türme	None
winkte	None
etablierte	None
Warnschüssen	Dative
Internetzugangs	Genitive
Trinkers	Genitive
Seltenerdmetallen	Dative
Kavaliers	Genitive
Steppenwaranen	Dative
kuscheln	None
Edukten	Dative
töteten	None
Überläufers	Genitive
Städtern	Dative
Plattfischen	Dative
klemmte	None
fragmentiert	None
Bootsflüchtlingen	Dative
Ausgangspunkten	Dative
Eisbär	Nominative
Feuerwehrmannes	Genitive
Endpunkten	Dative
Radsatzes	Genitive
frohlocken	None
Gittern	Dative
inspiziert	None
Rondells	Genitive
Übels	Genitive
erniedrigte	None
Menschenhandels	Genitive
Exot	Nominative
Schlammes	Genitive
Chroms	Genitive
nährte	None
Verbundes	Genitive
mündend	None
Amuletten	Dative
Vorjahresquartalen	Dative
schwand	None
verhängten	None
outetest	None
Strontiumsalzen	Dative
Trostpreisen	Dative
Etymologe	Nominative
hinterzöget	None
Schützes	Genitive
Monarch	Nominative
Konzernes	Genitive
Krankenpflegers	Genitive
hopstet	None
Giebels	Genitive
halle	None
Polysems	Genitive
Einkäufen	Dative
Adaminen	Dative
deponierten	None
Eiskunstläufern	Dative
Scheibenwischern	Dative
Hausens	Genitive
Stiefkindern	Dative
Zaines	Genitive
prob	None
christianisier	None
Arzneistoffen	Dative
Geldautomat	Nominative
Hüters	Genitive
rupfte	None
Grabbeltisches	Genitive
Blutplasmas	Genitive
verwundert	None
Paters	Genitive
Köchen	Dative
Passagieren	Dative
kasernierte	None
Alkoholgehaltes	Genitive
wackeln	None
Datenblattes	Genitive
Tümpels	Genitive
predigend	None
initialisiert	None
Stativen	Dative
Anläufen	Dative
definierten	None
Kristallfeldern	Dative
Nährmediums	Genitive
Widders	Genitive
auslassen	None
lull	None
Aspirant	Nominative
Organen	Dative
Wohngebietes	Genitive
idealisiert	None
zentrifugiertest	None
besäßen	None
repliziert	None
gekuckt	None
Zimmermeisters	Genitive
Monaziten	Dative
Softwareentwicklers	Genitive
Diskursen	Dative
Erzeugnisses	Genitive
Apparaten	Dative
schäm	None
reicht	None
Irrtümern	Dative
gestanden	None
gespreizt	None
Stiches	Genitive
reif	None
Holunders	Genitive
überlisten	None
Druckers	Genitive
Heulers	Genitive
nutz	None
Tetragons	Genitive
Elementsymbolen	Dative
chattet	None
Mercaptans	Genitive
Rückschlüssen	Dative
Matchen	Dative
Zusätzen	Dative
geschöpft	None
Roboters	Genitive
Granatapfels	Genitive
Kegeln	Dative
Schillen	Dative
Iberern	Dative
Abschnitten	Dative
grinstest	None
Kratzern	Dative
priesen	None
empfindest	None
Monopols	Genitive
Schachtelhalmen	Dative
Blöcken	Dative
gabele	None
entfachen	None
Schlitzes	Genitive
Gallensteinen	Dative
Todesfällen	Dative
Krüppeln	Dative
Vliesen	Dative
besinnest	None
Platintiegels	Genitive
Strahlenschutzes	Genitive
Aufläufen	Dative
Gerätes	Genitive
Automat	Nominative
genüge	None
Werders	Genitive
Stengels	Genitive
gefaltet	None
Ermittlern	Dative
Felsenpfeifers	Genitive
Freimaurers	Genitive
Käfers	Genitive
sexelet	None
Kubikzentimeters	Genitive
implizierst	None
dealen	None
Stollens	Genitive
Ausländern	Dative
Meeresbodens	Genitive
Polarnachtf	Genitive
Quelltextes	Genitive
erfüllst	None
Wohltätern	Dative
Nachnamens	Genitive
wähnte	None
Laubfröschen	Dative
Teilchenbeschleunigern	Dative
stimmen	None
Abklatsches	Genitive
Deckes	Genitive
Fließen	Dative
Kokons	Genitive
Gleichrichters	Genitive
Vorfalles	Genitive
Cleveiten	Dative
Baumstammes	Genitive
Steigen	Dative
Äons	Genitive
Briefwechsels	Genitive
Almanachs	Genitive
Pfifferlingen	Dative
Übersetzers	Genitive
Transistors	Genitive
Unterarmes	Genitive
adoptieren	None
Durcheinanders	Genitive
Peptiden	Dative
Spänen	Dative
Lignins	Genitive
teilen	None
Wagners	Genitive
Duftes	Genitive
Reaktionsschritten	Dative
Cystinen	Dative
schiede	None
rechtfertig	None
Krankheitserregers	Genitive
Olivensteines	Genitive
paraphrasiert	None
Passagierschiffes	Genitive
Stoffwechselprozessen	Dative
flenset	None
Arabern	Dative
Regierungssprechers	Genitive
Desasters	Genitive
Lappe	Nominative
Phonems	Genitive
Verses	Genitive
andeutend	None
traumatisierte	None
Papieren	Dative
erschüttern	None
schockierte	None
trommeln	None
Reportern	Dative
Tauschen	Dative
einbezogen	None
debütierten	None
Gefechtes	Genitive
Schreibtischtäters	Genitive
Dienstes	Genitive
Vorquartals	Genitive
schnattern	None
Siamese	Nominative
Giften	Dative
Zeigefingers	Genitive
fahndete	None
fluchte	None
deklinierte	None
klopft	None
Programmierern	Dative
Niedergangs	Genitive
Enzians	Genitive
Sprossen	Dative
Sonnenaufgangs	Genitive
hinkend	None
Datensatzes	Genitive
Gasthofes	Genitive
entert	None
Blumenkohles	Genitive
Inhaltes	Genitive
Absorptionsgraden	Dative
Huminstoffen	Dative
Fußballspielern	Dative
Sizilianers	Genitive
kontrastierend	None
vergeudete	None
Erziehers	Genitive
Strukturelementen	Dative
Fahrwerkes	Genitive
urbanisiert	None
Schleiers	Genitive
knallst	None
Bebauungsplanes	Genitive
Sandbodens	Genitive
Oxidhalogenids	Genitive
Nebenblättern	Dative
logierten	None
Eisheilige	Nominative
beziehe	None
Fettwänsten	Dative
Enthaarungsmitteln	Dative
Leistungssporten	Dative
Polyolefinen	Dative
verwickelten	None
Assistent	Nominative
Geschichtenbuches	Genitive
Euxeniten	Dative
Instrumenten	Dative
Soziologe	Nominative
verlangsamend	None
Senaten	Dative
Jagdhundes	Genitive
Ausmaßes	Genitive
Freveln	Dative
Hydroxids	Genitive
Spezialstählen	Dative
Asphaltes	Genitive
mesmerisieret	None
Eroberungszügen	Dative
Beiträgen	Dative
Verläufen	Dative
Adventen	Dative
schützte	None
bildeten	None
Griffes	Genitive
Vorzügen	Dative
unterzeichnend	None
kacke	None
Hauptbestandteilen	Dative
treibend	None
bestehend	None
Abhanges	Genitive
Demagoge	Nominative
Jordaniers	Genitive
buhe	None
Kühlers	Genitive
Amtskollege	Nominative
Ellenbogens	Genitive
verstelle	None
beleuchte	None
Textils	Genitive
Baustoffes	Genitive
Podiums	Genitive
Habichts	Genitive
Grundgesetzes	Genitive
Walisern	Dative
foppt	None
Vorwurfes	Genitive
Einfängen	Dative
gekniet	None
Firnissen	Dative
Finanzministers	Genitive
Versicherers	Genitive
zerknitterst	None
schwenkt	None
verlangst	None
sortierten	None
Kristallen	Dative
Römern	Dative
simsen	None
erforderst	None
Zuname	Nominative
sezieren	None
Schlächters	Genitive
strahlt	None
Zipfels	Genitive
Kommentars	Genitive
eintreten	None
Atheist	Nominative
beschul	None
Schlafmitteln	Dative
Zöllnern	Dative
abschaffen	None
Wüstenfuchses	Genitive
Frevels	Genitive
Fürzen	Dative
Muskels	Genitive
Häuptlingen	Dative
Luftabschlusses	Genitive
Weltbildes	Genitive
pick	None
Ausstellern	Dative
Schlicken	Dative
verbreiten	None
Gleisen	Dative
Schöffe	Nominative
hinke	None
vermengend	None
Präfixen	Dative
kollabier	None
Grundsatzes	Genitive
verlade	None
befindest	None
verlängerte	None
Körben	Dative
skizzierte	None
löten	None
erkranken	None
operiert	None
Jagdhunden	Dative
Quadratzentimetern	Dative
Schlachtschiffes	Genitive
sinke	None
schütten	None
Gouverneurs	Genitive
Gesetzeshüters	Genitive
Aorists	Genitive
Metzgern	Dative
Datentyps	Genitive
Versehens	Genitive
Ohrwürmern	Dative
Nationalspielers	Genitive
Absorbern	Dative
Anklägers	Genitive
Zebrafink	Nominative
Nieten	Dative
Digitalisaten	Dative
buddeln	None
gelauscht	None
äußert	None
zerrüttete	None
Fürstentums	Genitive
Wirkungsgrades	Genitive
bedroht	None
Träumers	Genitive
Verbindungshalbleitern	Dative
Tölpels	Genitive
Flugbegleitern	Dative
stigmatisierten	None
Gaumens	Genitive
Abklatschen	Dative
poppest	None
Abfertigungsgebäudes	Genitive
verkörpert	None
park	None
Abzügen	Dative
Honigdachsen	Dative
beschuldigst	None
Marktwerts	Genitive
Bärendienstes	Genitive
Stadtzentrums	Genitive
Äthers	Genitive
pflücktet	None
versicherst	None
Gitarrenbauers	Genitive
Apothekern	Dative
Körpergewichtes	Genitive
Inders	Genitive
schanghaiet	None
verwandelte	None
befriedige	None
demütigen	None
verlässt	None
Rücktrittes	Genitive
verabreicht	None
Fakiren	Dative
Edamers	Genitive
Maklers	Genitive
Bassist	Nominative
verdoppelnd	None
Dieseln	Dative
Sonntagnachmittags	Genitive
Pyroskopen	Dative
Thuliums	Genitive
Gründers	Genitive
Vorwissens	Genitive
Säers	Genitive
Wohngebieten	Dative
Privatdozent	Nominative
wühlen	None
erzwingen	None
schneien	None
revoltierest	None
Zar	Nominative
Klumpens	Genitive
Mobilfunknetzes	Genitive
kristallisiert	None
Manualen	Dative
Borosilikates	Genitive
kommet	None
kommentiert	None
Teiches	Genitive
Feingehalts	Genitive
Statist	Nominative
Knöcheln	Dative
losen	None
beschuldigtest	None
Mantels	Genitive
Segelschiffen	Dative
installierst	None
Mangelsymptoms	Genitive
Verdachtes	Genitive
Halbbrüdern	Dative
getextet	None
schweb	None
Sehers	Genitive
erlagen	None
schworen	None
Becquerels	Genitive
Abstechern	Dative
Bombern	Dative
Höhlenforschern	Dative
Singhalese	Nominative
vereis	None
Ikonoklast	Nominative
Nukleotiden	Dative
pilgeret	None
Prioraten	Dative
Bezügen	Dative
Aufsteigers	Genitive
Endometriums	Genitive
Florist	Nominative
hinterfragte	None
Kirgise	Nominative
Abzeichens	Genitive
lynchest	None
tröstete	None
Fanatikers	Genitive
entdecken	None
Fluches	Genitive
respektieren	None
Isotops	Genitive
Lenkern	Dative
Herrgotts	Genitive
keul	None
Lungenkrebses	Genitive
erleben	None
Urwaldes	Genitive
Horoskops	Genitive
Musikinstrumenten	Dative
geweidet	None
Fallbeiles	Genitive
Trollen	Dative
Schnitzern	Dative
Naturstoffen	Dative
Löschpapieres	Genitive
Beleges	Genitive
Tausendsteln	Dative
verstärken	None
Rückweges	Genitive
Sonnenaufgängen	Dative
Millionenstädten	Dative
Schreiners	Genitive
Hälsen	Dative
Sekundant	Nominative
Berufen	Dative
Drückebergern	Dative
Diebstählen	Dative
Gesellschaftern	Dative
Einverständnissen	Dative
ummanteln	None
Gradient	Nominative
Forschungsgegenstandes	Genitive
Oppositionspolitikern	Dative
Bodensätzen	Dative
lautend	None
Perboraten	Dative
Endbetrages	Genitive
annulliert	None
halogenierte	None
wallfahrt	None
Benzols	Genitive
Sonnabendvormittags	Genitive
Agitators	Genitive
Kolosses	Genitive
gehoben	None
Chorals	Genitive
plazieren	None
spüre	None
Kations	Genitive
galoppieret	None
verbrüdert	None
fühlend	None
Halbleiterbauelementen	Dative
Koches	Genitive
Pokals	Genitive
Staatssekretäres	Genitive
Pflöcken	Dative
Gelbbleierzes	Genitive
weggeworfen	None
Frequenzbereiches	Genitive
restaurierten	None
Balkons	Genitive
huste	None
Endemit	Nominative
Riedels	Genitive
schweig	None
Este	Nominative
Laibchens	Genitive
Schulterblättern	Dative
Potenzials	Genitive
Auftraggebern	Dative
belächeln	None
Puppenspielern	Dative
Donoren	Dative
Iberers	Genitive
Böttchers	Genitive
spuken	None
Sommers	Genitive
testet	None
Oleanders	Genitive
wehren	None
Leinwänden	Dative
Sitzen	Dative
Kutschern	Dative
sanierest	None
Amputierte	Nominative
grausen	None
Paparazzos	Genitive
grien	None
gehofft	None
Bergkristallen	Dative
subventionieren	None
erbringen	None
verteilen	None
gabelt	None
erörterten	None
stockten	None
Wissenschaftlern	Dative
Mönches	Genitive
eröffne	None
Griesgramen	Dative
Erzpriestern	Dative
erinnerten	None
Spitzes	Genitive
Sattlern	Dative
verbarrikadierend	None
Zweikämpfen	Dative
Poles	Genitive
Königreiches	Genitive
Kohlenstoffatomen	Dative
Ämtern	Dative
küsste	None
Schutzwällen	Dative
Landwirten	Dative
recherchiert	None
Erhaltes	Genitive
verselbständigten	None
narrte	None
Scherzen	Dative
Lanthanoiden	Dative
Gasgemisches	Genitive
Dilettant	Nominative
marinierten	None
Vorstandssprechers	Genitive
Intendant	Nominative
mißbrauchte	None
bestrebt	None
engagier	None
Nadelwäldern	Dative
Vielecks	Genitive
Handwörterbuches	Genitive
Parisern	Dative
Sauerstoffatomen	Dative
Kultusministern	Dative
Schmierölen	Dative
überständet	None
verhöhnten	None
grinsen	None
Klinkern	Dative
gestreichelt	None
spreiztest	None
festigte	None
Ausbauen	Dative
strukturier	None
Generalsekretären	Dative
Halbmonden	Dative
Gotteshäusern	Dative
Dealern	Dative
Hebels	Genitive
Waffenschmieden	Dative
Hornes	Genitive
getrieben	None
Erzen	Dative
tränen	None
bromierten	None
verringern	None
gewöhne	None
schwanken	None
Strafstößen	Dative
Brechern	Dative
Jaguars	Genitive
entführen	None
Stoffwechselweges	Genitive
Führerhauptquartieren	Dative
Aktionären	Dative
Werdens	Genitive
Marxist	Nominative
Gebilden	Dative
Delfinen	Dative
Kernisomers	Genitive
hingelegt	None
Abgottes	Genitive
Hydroxyketons	Genitive
Ordners	Genitive
Tapirs	Genitive
informiert	None
Rückspiegeln	Dative
vermieteten	None
Benutzername	Nominative
Fernglases	Genitive
Aluminosilikaten	Dative
Bausches	Genitive
outen	None
Schildkrebses	Genitive
kompiliert	None
Liberianern	Dative
Herkunftsländern	Dative
Pegmatits	Genitive
einkaufen	None
Bengalfüchsen	Dative
Calciummangels	Genitive
Sportlern	Dative
entmischest	None
Nanometern	Dative
Endlagers	Genitive
Seeräubern	Dative
Benediktiners	Genitive
Pedals	Genitive
Tschernkens	Genitive
berichteten	None
Nudelteiges	Genitive
befördert	None
Alkoholikers	Genitive
Augenzeuge	Nominative
Stierkämpfen	Dative
untersagtet	None
Blumensträußen	Dative
Lippenstiften	Dative
heulest	None
Silbererzes	Genitive
Armbändern	Dative
Farbstoffes	Genitive
Fetten	Dative
Gleichgewichtes	Genitive
misshandele	None
Kerzenfisches	Genitive
scheitern	None
Paketnamens	Genitive
Sichtkontakten	Dative
Seemächten	Dative
ergreifend	None
Schonern	Dative
dopple	None
Zufällen	Dative
Herrenhäusern	Dative
Zahnwalen	Dative
verdrängten	None
Apfels	Genitive
schwärmte	None
Farbstiften	Dative
Ameisenbär	Nominative
Zauberers	Genitive
Seehase	Nominative
Eindringlings	Genitive
Gussteilen	Dative
Gebärmutterschleimhäuten	Dative
abgeblitzt	None
erteilst	None
Starters	Genitive
Eisbrechers	Genitive
Schlossern	Dative
Freiern	Dative
Dutzenden	Dative
Defekten	Dative
misslänget	None
Einschnittes	Genitive
Späßen	Dative
Besuchen	Dative
biwakierten	None
verfolgte	None
Wasserrädern	Dative
erwartend	None
billigtet	None
grollst	None
treibe	None
gefrieren	None
Gasplanet	Nominative
Kolloiden	Dative
genieren	None
Währungsmetallen	Dative
verwechseln	None
Tümpeln	Dative
Dachgeschossen	Dative
zapp	None
Bildpunkten	Dative
Chauvinist	Nominative
Bestatters	Genitive
versetzt	None
kratzte	None
reden	None
abalienierest	None
Musikant	Nominative
Anfluges	Genitive
Kabinetten	Dative
fechte	None
Schwärmern	Dative
Flussspaten	Dative
Flüssigkristallen	Dative
Halters	Genitive
Notenwerten	Dative
erwerbend	None
Preisen	Dative
Salamandern	Dative
Spornes	Genitive
Teleskopen	Dative
Schnorchels	Genitive
Glasbläsers	Genitive
mäkeln	None
verzähl	None
substituierte	None
Treibhausgases	Genitive
Basalten	Dative
Folterknechten	Dative
Aufenthaltsortes	Genitive
quetscht	None
erstelle	None
Gänseleberwürsten	Dative
Placeboeffektes	Genitive
kartographiert	None
rekrutierest	None
eskortieret	None
Laders	Genitive
Schmieröles	Genitive
drohe	None
kontaktieren	None
Elementen	Dative
ergraute	None
Carbenen	Dative
setzten	None
Bunkers	Genitive
Geologe	Nominative
Pirat	Nominative
Skelettes	Genitive
Rettungsbooten	Dative
Langschwertes	Genitive
Diskussen	Dative
emigrierten	None
zerrte	None
emulieren	None
Fußknöcheln	Dative
Flüssen	Dative
Bruttonationaleinkommens	Genitive
Eilandes	Genitive
verletz	None
vergastest	None
zweifelt	None
Teufelskreisen	Dative
Erbrechens	Genitive
Adlers	Genitive
Rettichen	Dative
Hüftgelenken	Dative
Mittelpunktes	Genitive
Begräbnisses	Genitive
Puffern	Dative
Zeitplänen	Dative
beschnittest	None
Assemblers	Genitive
Solen	Dative
Seeschiffen	Dative
Gleichnissen	Dative
schone	None
Gedächtnisses	Genitive
Weltbildern	Dative
Geflechts	Genitive
geklont	None
entmischen	None
Fahrers	Genitive
Heizelementen	Dative
Flusses	Genitive
stillt	None
erneuern	None
vulkanisier	None
überschätzte	None
Bakteriums	Genitive
gebootet	None
Biotopen	Dative
Rotweinen	Dative
Arzneistoffes	Genitive
Adjektiven	Dative
Spurenelementen	Dative
Hosenträgern	Dative
rekonstruierten	None
heilt	None
greine	None
hüllest	None
poppe	None
gedeihen	None
Armeniern	Dative
Graugänsen	Dative
zögere	None
Massenspektrometern	Dative
streicheln	None
Rostschutzmitteln	Dative
Anklägern	Dative
Anflügen	Dative
anzeigen	None
Herzogtums	Genitive
Torhüters	Genitive
Kalkes	Genitive
Pfeilen	Dative
gruppiertet	None
darstellend	None
Baseballschlägers	Genitive
modifizieren	None
Sektors	Genitive
Kartons	Genitive
Hodens	Genitive
Engpasses	Genitive
Forschungslabors	Genitive
enterten	None
peiniget	None
modelliert	None
Rauchen	Dative
parametrisierst	None
Missverständnisses	Genitive
Schößen	Dative
befolg	None
