mojados	None
divulgaron	Indicative
reiniciaron	Indicative
comer	None
adoquinados	None
enripiábamos	Indicative
extendían	Indicative
segado	None
cosen	Indicative
arbitrareis	Subjunctive
alojaron	Indicative
presididas	None
avanzarían	Conditional
desmovilizando	None
entrego	Indicative
arengando	None
implican	Indicative
simplificaban	Indicative
recondujo	Indicative
adecuando	None
expiro	Indicative
hurtar	None
cerré	Indicative
desesperábamos	Indicative
aparté	Indicative
encubertadas	None
laudes	Subjunctive
reinventó	Indicative
estipularon	Indicative
fusilaban	Indicative
anhelado	None
destornillares	Subjunctive
interponiendo	None
consejas	Indicative
barbada	None
piloteados	None
retumbando	None
privando	None
desembarques	Subjunctive
puntas	Indicative
planteé	Indicative
inculcaron	Indicative
anotará	Indicative
deliberaron	Indicative
mantén	Imperative-Jussive
ingresada	None
dedicaban	Indicative
desengañado	None
falsean	Indicative
bautizaban	Indicative
eslabonadas	None
finidos	None
enredado	None
asegurarían	Conditional
largar	None
participarían	Conditional
cohonderá	Indicative
despezasen	Subjunctive
enturbiaron	Indicative
asalto	Indicative
despertaran	Subjunctive
parecemos	Indicative
pigmentando	None
requerirían	Conditional
debilitaban	Indicative
emparedar	None
enojes	Subjunctive
egresaban	Indicative
establecieran	Subjunctive
retratar	None
persuadieron	Indicative
aludidas	None
atuvo	Indicative
sancionados	None
habré	Indicative
diferenciaran	Subjunctive
conllevaron	Indicative
amamantó	Indicative
bloqueará	Indicative
rivalizó	Indicative
requerido	None
respaldan	Indicative
dividen	Indicative
consigues	Indicative
lambo	Indicative
abaluartó	Indicative
graduado	None
osada	None
carecerán	Indicative
turban	Indicative
reduje	Indicative
medirá	Indicative
compran	Indicative
amagada	None
puntuaban	Indicative
investigó	Indicative
boleteasen	Subjunctive
subastaron	Indicative
arrinconados	None
coreas	Indicative
arruinadas	None
batallan	Indicative
impulsaron	Indicative
resbaló	Indicative
frecuentó	Indicative
preguntándose	None
emitirán	Indicative
consigno	Indicative
dorada	None
ripio	Indicative
disgregada	None
cursaron	Indicative
abordando	None
destazaremos	Indicative
dispensaron	Indicative
beatificó	Indicative
evité	Indicative
suscrito	None
consumando	None
desvinculado	None
inquietaron	Indicative
violes	Subjunctive
perdonaran	Subjunctive
lesionar	None
logres	Subjunctive
confeccionaban	Indicative
candé	Indicative
retornes	Subjunctive
ingresará	Indicative
mediatizaré	Indicative
alisada	None
basé	Indicative
seríamos	Conditional
albergues	Subjunctive
aplicaré	Indicative
asesinarán	Indicative
degustado	None
formaron	Indicative
avalar	None
varas	Indicative
enchufares	Subjunctive
obtienes	Indicative
impetrasteis	Indicative
otorgando	None
doliendo	None
abreviar	None
leyeras	Subjunctive
prosperado	None
enrutado	None
juramentaron	Indicative
entrecortada	None
destrabaremos	Indicative
enfermas	Indicative
muño	Indicative
contribuyeran	Subjunctive
desconoces	Indicative
cruzo	Indicative
suspendido	None
dialogan	Indicative
trilladas	None
publicaban	Indicative
excuséis	Subjunctive
indagarás	Indicative
odiaban	Indicative
paleo	Indicative
demandarán	Indicative
parafrasear	None
sostuvieren	Subjunctive
publicas	Indicative
dividían	Indicative
computar	None
germinan	Indicative
solidarizaras	Subjunctive
desacatando	None
emigran	Indicative
recibieran	Subjunctive
sedaríais	Conditional
eclosionan	Indicative
multiplicados	None
calcular	None
retes	Subjunctive
laudado	None
intercedió	Indicative
oraban	Indicative
opináis	Indicative
aferró	Indicative
inventariar	None
floreando	None
redistribuir	None
expatriado	None
revelada	None
fijémonos	Imperative-Jussive
circundando	None
excomulgó	Indicative
gesté	Indicative
interconectará	Indicative
subdivididas	None
instituyó	Indicative
padecerá	Indicative
concertados	None
plantásemos	Subjunctive
desintegrar	None
encauzadas	None
nadas	Indicative
fardando	None
truncó	Indicative
estimo	Indicative
faltarían	Conditional
aceptados	None
compensan	Indicative
desintegran	Indicative
afloró	Indicative
extendieron	Indicative
selló	Indicative
responsabilizada	None
coleccionó	Indicative
dejad	Imperative-Jussive
encasquetadas	None
inmiscúyanse	Imperative-Jussive
animaron	Indicative
ampliando	None
tramas	Indicative
curran	Indicative
fotografiado	None
acompañaran	Subjunctive
retumbo	Indicative
pavimentó	Indicative
atiesáremos	Subjunctive
ajustó	Indicative
cometiesen	Subjunctive
desprotegida	None
entregaran	Subjunctive
correspondían	Indicative
raptar	None
concordáremos	Subjunctive
casará	Indicative
fracturar	None
ahincáramos	Subjunctive
postergados	None
forzaran	Subjunctive
desclasificadas	None
enclaustrada	None
asesoradas	None
cernir	None
incorporado	None
cuestiones	Subjunctive
recibirán	Indicative
azadonaban	Indicative
engreído	None
difundir	None
defiriésemos	Subjunctive
precalentado	None
desosegares	Subjunctive
remataban	Indicative
regularizada	None
apachadas	None
dividí	Indicative
adentraran	Subjunctive
operarán	Indicative
aplicado	None
justas	Indicative
arrodillándose	None
huellas	Indicative
acostaron	Indicative
recalando	None
antojó	Indicative
acuño	Indicative
debieras	Subjunctive
flechas	Indicative
embarcaron	Indicative
efundido	None
comportó	Indicative
meten	Indicative
valorizada	None
reemplazaron	Indicative
atienden	Indicative
reacciono	Indicative
desplazabais	Indicative
apoderan	Indicative
canonicéis	Subjunctive
ocuparán	Indicative
descollaban	Indicative
encapsular	None
centralizaban	Indicative
alimentaron	Indicative
dinamites	Subjunctive
fundaran	Subjunctive
halo	Indicative
espiras	Indicative
gravada	None
alfombraras	Subjunctive
accionar	None
respaldasen	Subjunctive
afanan	Indicative
reconfiguran	Indicative
descargaban	Indicative
procurando	None
permear	None
jubilan	Indicative
triplicabas	Indicative
derrotan	Indicative
remezclaron	Indicative
atravesaran	Subjunctive
explores	Subjunctive
presagió	Indicative
psicoanalizabas	Indicative
copio	Indicative
plasman	Indicative
cifraban	Indicative
materializaban	Indicative
escapan	Indicative
esparcías	Indicative
lavas	Indicative
argumentaban	Indicative
trajeran	Subjunctive
corrugados	None
finalizo	Indicative
escapando	None
introdujeran	Subjunctive
traducidas	None
obscureciereis	Subjunctive
creímos	Indicative
enrarecerían	Conditional
ingenió	Indicative
multados	None
lanzaron	Indicative
cogieran	Subjunctive
entregaré	Indicative
acaudillases	Subjunctive
sopesado	None
incentivarían	Conditional
fascinaron	Indicative
romantizando	None
doctorado	None
divisé	Indicative
llegues	Subjunctive
parafrasean	Indicative
redundan	Indicative
destornillarías	Conditional
narcotizarán	Indicative
adquirió	Indicative
invitan	Indicative
comprometieron	Indicative
embellecen	Indicative
bloco	Indicative
cuido	Indicative
tonifiquéis	Subjunctive
odió	Indicative
adjuntaban	Indicative
acostumbrados	None
arquean	Indicative
adelantan	Indicative
aplastar	None
mides	Indicative
ahijado	None
conjeturaras	Subjunctive
cercas	Indicative
desquicio	Indicative
condicionan	Indicative
estofados	None
ennobleció	Indicative
apresando	None
observará	Indicative
economizar	None
implementadas	None
desacatados	None
contramandada	None
idean	Indicative
coheché	Indicative
detectará	Indicative
celebrasen	Subjunctive
desacreditó	Indicative
legislan	Indicative
zambulléndose	None
achacado	None
sal	Imperative-Jussive
enturbiado	None
euskaldunizáis	Indicative
aceró	Indicative
quemaban	Indicative
pitaron	Indicative
sobrestimar	None
remendaron	Indicative
ancho	Indicative
cernerás	Indicative
esconden	Indicative
diferían	Indicative
respaldaran	Subjunctive
confiscando	None
enorgulleció	Indicative
declinaron	Indicative
soportar	None
desgajaron	Indicative
surtirán	Indicative
fumigaron	Indicative
atrajeran	Subjunctive
impermeabilizada	None
tapiada	None
perfiladas	None
ofrecerían	Conditional
inventariada	None
bloquearon	Indicative
confíes	Subjunctive
barban	Indicative
empañaron	Indicative
cuadraban	Indicative
trocean	Indicative
reinados	None
estibados	None
enjaretasteis	Indicative
distraída	None
respiras	Indicative
predisponen	Indicative
cancelo	Indicative
degollado	None
brindas	Indicative
rastreadas	None
hozan	Indicative
despedirá	Indicative
capturarían	Conditional
ingiriendo	None
aclarada	None
precipitaron	Indicative
desgarrado	None
venden	Indicative
mullendo	None
conchabo	Indicative
despiojado	None
dejaron	Indicative
acribillados	None
rodé	Indicative
bordo	Indicative
sumieron	Indicative
fumó	Indicative
continuaré	Indicative
pesares	Subjunctive
desabejasen	Subjunctive
decomiso	Indicative
adiestraron	Indicative
amamantan	Indicative
cardas	Indicative
provenían	Indicative
reconstruyó	Indicative
subtituló	Indicative
destituyo	Indicative
registré	Indicative
lanzarán	Indicative
reforzarían	Conditional
escaneo	Indicative
aparejada	None
recomprar	None
acordé	Indicative
incendió	Indicative
generes	Subjunctive
parodiada	None
subseguirían	Conditional
póngase	Imperative-Jussive
emancipar	None
reemprenderás	Indicative
crujen	Indicative
aisladas	None
ignorados	None
obligarán	Indicative
encontraríamos	Conditional
invocaban	Indicative
imposibilitó	Indicative
tildaban	Indicative
fomentado	None
correspondiesen	Subjunctive
fluían	Indicative
llamaban	Indicative
aglutinaban	Indicative
remedo	Indicative
abandonarán	Indicative
ingresaran	Subjunctive
desprotegían	Indicative
llenan	Indicative
pelean	Indicative
conquistaré	Indicative
eludió	Indicative
aglutinan	Indicative
tecnificar	None
alienaron	Indicative
borré	Indicative
vegetarás	Indicative
reconciliarían	Conditional
mandaré	Indicative
trituradas	None
adelgazadas	None
plagiado	None
agobiar	None
entrevinieron	Indicative
conferiríamos	Conditional
concitó	Indicative
celada	None
insistieran	Subjunctive
impreso	None
brillar	None
toldas	Indicative
topó	Indicative
plegaron	Indicative
fracasasen	Subjunctive
embarradas	None
amilanáis	Indicative
intentabais	Indicative
descubriremos	Indicative
editará	Indicative
incorporé	Indicative
publicitadas	None
almibarada	None
apiadáremos	Subjunctive
represarais	Subjunctive
recuadréis	Subjunctive
importunar	None
perpetuada	None
cuentes	Subjunctive
robaste	Indicative
proponían	Indicative
embelesado	None
desertas	Indicative
ubicará	Indicative
conocida	None
boicotean	Indicative
individualizáramos	Subjunctive
brindarán	Indicative
iniciasen	Subjunctive
regodéense	Imperative-Jussive
cristalizaron	Indicative
extremadas	None
gemido	None
compondrá	Indicative
marean	Indicative
aludes	Indicative
cruzaban	Indicative
aseguraron	Indicative
respondo	Indicative
idealizado	None
entrenarán	Indicative
capturaban	Indicative
pesan	Indicative
extrañaban	Indicative
destacaran	Subjunctive
comentaste	Indicative
mimadas	None
inquietan	Indicative
vaciado	None
adhirió	Indicative
desproveída	None
ensayan	Indicative
salinizado	None
extraditó	Indicative
sustrajo	Indicative
citaremos	Indicative
desenamoraban	Indicative
delimitar	None
desearías	Conditional
descalificó	Indicative
consolidará	Indicative
demoraremos	Indicative
robusteciendo	None
metastatizadas	None
mascullar	None
presionó	Indicative
presentas	Indicative
parodiaban	Indicative
auspicio	Indicative
loquear	None
tropicalizáis	Indicative
carcajearse	None
proporciono	Indicative
desarraigues	Subjunctive
pisaran	Subjunctive
patrocino	Indicative
ludido	None
aconsejadas	None
repercutirá	Indicative
delimitan	Indicative
intercambiaran	Subjunctive
vetas	Indicative
voleáis	Indicative
forrajean	Indicative
vivificadas	None
tientan	Indicative
engastaras	Subjunctive
vagó	Indicative
pilotan	Indicative
densificad	Imperative-Jussive
refundió	Indicative
catalogados	None
cariciado	None
rebatidas	None
enfrascarse	None
sobrarían	Conditional
unieron	Indicative
exponían	Indicative
contaremos	Indicative
distribuyeran	Subjunctive
aclaran	Indicative
anotado	None
bastas	Indicative
contábamos	Indicative
acidulada	None
basculando	None
complazco	Indicative
soñé	Indicative
conformarían	Conditional
lechado	None
esculpido	None
yantares	Subjunctive
tabulas	Indicative
estrenaríamos	Conditional
aliado	None
linchada	None
participado	None
aburrido	None
geminando	None
opositásemos	Subjunctive
deshilacharen	Subjunctive
multiplicó	Indicative
emplearon	Indicative
oreada	None
tuneados	None
fresaras	Subjunctive
desobedecido	None
amontonados	None
robé	Indicative
reventaban	Indicative
agradecerá	Indicative
fallado	None
expresaste	Indicative
investigo	Indicative
expandí	Indicative
incordio	Indicative
acallado	None
acercaban	Indicative
hastías	Indicative
dispensas	Indicative
cuitarás	Indicative
incurrió	Indicative
tañeseis	Subjunctive
montaban	Indicative
plisadas	None
encuadrado	None
escoltó	Indicative
dibujaron	Indicative
justes	Subjunctive
apretarán	Indicative
pasteurizar	None
progresado	None
contribuirían	Conditional
curaron	Indicative
cotejáramos	Subjunctive
superasen	Subjunctive
arengó	Indicative
impagas	Indicative
sobreviví	Indicative
imitarán	Indicative
violaran	Subjunctive
pacto	Indicative
desengañadas	None
reagrupan	Indicative
afirmas	Indicative
masareis	Subjunctive
alocadas	None
desocupes	Subjunctive
amplío	Indicative
inmovilizadas	None
ponderada	None
novelados	None
postenso	Indicative
chambeada	None
devalúan	Indicative
ataron	Indicative
atalayas	Indicative
subestimó	Indicative
combatirá	Indicative
instituyas	Subjunctive
sobro	Indicative
botanices	Subjunctive
dudado	None
bajes	Subjunctive
presumió	Indicative
reimpulsaras	Subjunctive
desinhibida	None
aborregaran	Subjunctive
profeso	Indicative
trasladar	None
sido	None
contraprogramaren	Subjunctive
sudó	Indicative
resurgieron	Indicative
gestado	None
despoblaron	Indicative
desvanecían	Indicative
celebraran	Subjunctive
andes	Subjunctive
retrucada	None
enviudó	Indicative
bajas	Indicative
culminará	Indicative
extraigo	Indicative
difiriesen	Subjunctive
aparentar	None
tomaremos	Indicative
rememoran	Indicative
valuarás	Indicative
trenzó	Indicative
suscribían	Indicative
instalo	Indicative
montareis	Subjunctive
honró	Indicative
empujo	Indicative
registraban	Indicative
loó	Indicative
bailaron	Indicative
precaver	None
quedarás	Indicative
arqueadas	None
desguarneciendo	None
arboles	Subjunctive
taponees	Subjunctive
recordada	None
enraizados	None
repintada	None
denominarían	Conditional
socorrió	Indicative
sobrevoló	Indicative
permaneciesen	Subjunctive
convencen	Indicative
durasen	Subjunctive
fundamento	Indicative
noveló	Indicative
sustentó	Indicative
acreditadas	None
recordaron	Indicative
concurrió	Indicative
discriminaban	Indicative
prevenido	None
pelan	Indicative
mitificar	None
acosando	None
pisó	Indicative
intensificará	Indicative
azuzado	None
subvenir	None
extirpó	Indicative
alegan	Indicative
acabaré	Indicative
secundan	Indicative
engañada	None
saltarían	Conditional
llovió	Indicative
maquilladas	None
estructuraron	Indicative
desaliento	Indicative
cancelas	Indicative
influenciada	None
americanizados	None
capturo	Indicative
pergeñó	Indicative
dormido	None
ajustaban	Indicative
tollieres	Subjunctive
vestí	Indicative
aprovechas	Indicative
presidían	Indicative
descubro	Indicative
cavó	Indicative
programas	Indicative
sonrojaren	Subjunctive
hipotecarían	Conditional
tallo	Indicative
acumularan	Subjunctive
afinasteis	Indicative
desaparecerían	Conditional
demolió	Indicative
anonimizados	None
marchito	Indicative
vacilan	Indicative
servirían	Conditional
adversar	None
coreaban	Indicative
abdicadas	None
entusiasman	Indicative
alertados	None
desayunarse	None
conturbado	None
monetizan	Indicative
sanjar	None
gayan	Indicative
acopló	Indicative
llevarán	Indicative
vedadas	None
revertirá	Indicative
fogueando	None
aplazaron	Indicative
horrorizan	Indicative
transcurrieron	Indicative
disfrutas	Indicative
critico	Indicative
incursionan	Indicative
trinchado	None
herías	Indicative
robaran	Subjunctive
internaban	Indicative
amilanada	None
desdoblareis	Subjunctive
importas	Indicative
plantearon	Indicative
supervisada	None
emborrachándose	None
disculpará	Indicative
complementarían	Conditional
introdujo	Indicative
peregrinó	Indicative
agotes	Subjunctive
descargué	Indicative
arrepentirá	Indicative
retoman	Indicative
padecerán	Indicative
olvidas	Indicative
discurrirá	Indicative
ordenan	Indicative
indicio	Indicative
volviste	Indicative
observaban	Indicative
insinuar	None
pesco	Indicative
eliminando	None
pegué	Indicative
xerocopiada	None
sabemos	Indicative
quéjese	Imperative-Jussive
subrogó	Indicative
preveían	Indicative
cruces	Subjunctive
chuleadas	None
documentan	Indicative
emocionado	None
gastó	Indicative
compusieron	Indicative
deliberarais	Subjunctive
difamar	None
hallarán	Indicative
verificaran	Subjunctive
apaciguar	None
semejan	Indicative
inhabilitan	Indicative
llaman	Indicative
utilizaste	Indicative
repongáis	Subjunctive
llamo	Indicative
atisbadas	None
enriqueceríais	Conditional
anillas	Indicative
moldearon	Indicative
azucarando	None
avistada	None
reingresaron	Indicative
tensaras	Subjunctive
pavonearse	None
interrumpieran	Subjunctive
entro	Indicative
intenté	Indicative
acertaban	Indicative
gritará	Indicative
extendiesen	Subjunctive
nombrados	None
preguntaban	Indicative
purpurado	None
comerciaron	Indicative
comentaron	Indicative
sentís	Indicative
apoyó	Indicative
drenado	None
mezclan	Indicative
basásemos	Subjunctive
desarrollareis	Subjunctive
espumas	Indicative
avizorares	Subjunctive
esnifar	None
destiló	Indicative
fascinó	Indicative
mantuvo	Indicative
debatisteis	Indicative
desglosadas	None
predisponéis	Indicative
apearon	Indicative
envalentonáramos	Subjunctive
monopolizaron	Indicative
hiperventilas	Indicative
enmudecida	None
sobrepondremos	Indicative
entreno	Indicative
altero	Indicative
restablecieran	Subjunctive
radicaban	Indicative
generalizan	Indicative
unificaran	Subjunctive
aquejabas	Indicative
contrastes	Subjunctive
saludaban	Indicative
implementares	Subjunctive
desfiles	Subjunctive
disciplinar	None
anuncian	Indicative
bordean	Indicative
abuso	Indicative
normar	None
preocupó	Indicative
intuyeron	Indicative
trillada	None
cavaste	Indicative
dotado	None
acordonó	Indicative
inventado	None
coció	Indicative
silbar	None
sustentan	Indicative
apremiado	None
escombro	Indicative
sorteará	Indicative
habito	Indicative
edito	Indicative
produzco	Indicative
incursionaron	Indicative
contarían	Conditional
advenidos	None
reafirmaban	Indicative
seguíamos	Indicative
comulgáis	Indicative
invitáremos	Subjunctive
televisado	None
respaldados	None
atravesará	Indicative
manufacturaron	Indicative
pisada	None
remolques	Subjunctive
presenciarás	Indicative
distendieseis	Subjunctive
rebajaron	Indicative
durmieran	Subjunctive
contribuyen	Indicative
eludiendo	None
reservada	None
potenciado	None
cepillarse	None
tapones	Subjunctive
comentando	None
malparado	None
unificarían	Conditional
juran	Indicative
acaté	Indicative
ligo	Indicative
turnarían	Conditional
humilladas	None
facilitarán	Indicative
dinamizado	None
suspiro	Indicative
rugido	None
calcificáramos	Subjunctive
tergiversan	Indicative
ausentad	Imperative-Jussive
batidos	None
goces	Subjunctive
solidas	Indicative
poseer	None
avanzado	None
debates	Indicative
diversificaron	Indicative
recorremos	Indicative
apoyes	Subjunctive
difuminando	None
riegas	Indicative
sobrevendido	None
provengo	Indicative
blasfemaban	Indicative
desfilan	Indicative
explosiones	Subjunctive
asistiesen	Subjunctive
originaseis	Subjunctive
expiados	None
explosionados	None
finalizado	None
violentar	None
existieran	Subjunctive
urgieron	Indicative
doran	Indicative
arriesgaban	Indicative
regalada	None
solicitaste	Indicative
repuntaseis	Subjunctive
radiaban	Indicative
enquistado	None
navegando	None
descuidó	Indicative
retomaban	Indicative
codificaban	Indicative
repelieron	Indicative
coagulado	None
rehaciendo	None
comadrearías	Conditional
descongestionada	None
congregaban	Indicative
descontratar	None
saltaron	Indicative
libro	Indicative
abreviados	None
responsabilicéis	Subjunctive
prepararon	Indicative
arropadas	None
dedicará	Indicative
descohesionando	None
proclamásemos	Subjunctive
editar	None
turnes	Subjunctive
trabajan	Indicative
falsifican	Indicative
nidificasteis	Indicative
noveles	Subjunctive
radiar	None
venenciarais	Subjunctive
oprimen	Indicative
triunfarían	Conditional
recibían	Indicative
alambiques	Subjunctive
ocasiono	Indicative
despeínense	Imperative-Jussive
embriagados	None
agilizados	None
pululando	None
extorsioné	Indicative
calco	Indicative
saboreados	None
abrigar	None
marcaste	Indicative
alcanzada	None
capturan	Indicative
perdurará	Indicative
gustados	None
aligeraron	Indicative
usan	Indicative
saboreado	None
estafaron	Indicative
saldo	Indicative
pregonaste	Indicative
codiciado	None
contaminan	Indicative
barnizados	None
zaparéis	Indicative
reanudada	None
disfrutan	Indicative
rechaces	Subjunctive
nutrieron	Indicative
mareas	Indicative
segundadas	None
negarían	Conditional
indujeron	Indicative
licitado	None
borbollaran	Subjunctive
provocaron	Indicative
desmarcó	Indicative
expandirán	Indicative
vadeando	None
subvencionada	None
unieran	Subjunctive
metaforizado	None
siso	Indicative
petrificadas	None
tarará	Indicative
integro	Indicative
reiterado	None
lastran	Indicative
explicitaste	Indicative
confundidas	None
desarrollaremos	Indicative
rayaban	Indicative
rotada	None
bramar	None
justificaríamos	Conditional
legitimaron	Indicative
precipité	Indicative
portarán	Indicative
degradando	None
tejeré	Indicative
reiterada	None
desbloquearan	Subjunctive
filas	Indicative
repitieses	Subjunctive
expulso	Indicative
deseaban	Indicative
inyectados	None
rezumasen	Subjunctive
explican	Indicative
uncieron	Indicative
acentuaban	Indicative
aquilatadas	None
retomabas	Indicative
nominalizando	None
encomiar	None
ilustraban	Indicative
cafichando	None
quejes	Subjunctive
desollado	None
difractados	None
represados	None
arguyó	Indicative
encabritado	None
designarán	Indicative
aceleraron	Indicative
radiados	None
rebobinaban	Indicative
veraneado	None
motivo	Indicative
amurallar	None
abrasada	None
engrilletas	Indicative
olvidan	Indicative
lastraras	Subjunctive
controlan	Indicative
detectaríais	Conditional
gastaban	Indicative
infecto	Indicative
tematizarían	Conditional
forcejearéis	Indicative
despareciendo	None
clicados	None
ayunó	Indicative
transcritas	None
varan	Indicative
refinaron	Indicative
hiles	Subjunctive
desacomodando	None
deleitan	Indicative
impuse	Indicative
espantado	None
rivalizados	None
retan	Indicative
dinamitados	None
malvender	None
acudían	Indicative
debutaran	Subjunctive
deshicieran	Subjunctive
pulsó	Indicative
encaminan	Indicative
debutará	Indicative
desmanteló	Indicative
concurrida	None
zumbaran	Subjunctive
afirmarán	Indicative
oxidan	Indicative
jurasen	Subjunctive
pronunciarían	Conditional
desilusionaran	Subjunctive
engalanado	None
lías	Indicative
volvimos	Indicative
descontinuó	Indicative
pactados	None
cronometró	Indicative
churruscando	None
soñaste	Indicative
hospedaban	Indicative
maltrataban	Indicative
asentó	Indicative
prestaban	Indicative
duchar	None
entrevistada	None
rotan	Indicative
ostentarían	Conditional
laudas	Indicative
proporcioné	Indicative
regresaron	Indicative
reagruparon	Indicative
mecanografiadas	None
oxigeno	Indicative
tamborileo	Indicative
reacondicionado	None
abofeteado	None
extrajeron	Indicative
motivó	Indicative
templó	Indicative
despobló	Indicative
inauguró	Indicative
arrodillan	Indicative
profesaron	Indicative
sobrepasó	Indicative
bailado	None
royeres	Subjunctive
demando	Indicative
insuflar	None
urgió	Indicative
hacemos	Indicative
recluir	None
clausurados	None
lleváis	Indicative
odio	Indicative
bogado	None
marcaron	Indicative
trasladaron	Indicative
presentaban	Indicative
prolongan	Indicative
aplicaban	Indicative
erguidas	None
individualizado	None
pasaremos	Indicative
apreciando	None
airados	None
desgajan	Indicative
añadiré	Indicative
contactaron	Indicative
enriquecerían	Conditional
cosechados	None
trasnochado	None
comercializan	Indicative
particularizaban	Indicative
sabréis	Indicative
remarco	Indicative
agrupará	Indicative
reflexionado	None
atañen	Indicative
desplazando	None
triangulares	Subjunctive
encuentres	Subjunctive
adscribir	None
bogues	Subjunctive
concerniendo	None
hayáis	Subjunctive
aprobó	Indicative
repartidas	None
atendieron	Indicative
arrestaran	Subjunctive
adjudicará	Indicative
comprometerían	Conditional
obedecerían	Conditional
reembolso	Indicative
reinan	Indicative
derrotaron	Indicative
serrucho	Indicative
desespero	Indicative
cohibido	None
batean	Indicative
reflexiones	Subjunctive
jalará	Indicative
esperaríamos	Conditional
soterrarán	Indicative
ronco	Indicative
caemos	Indicative
incendiarás	Indicative
anidadas	None
perecían	Indicative
agudizan	Indicative
pasaran	Subjunctive
ayudes	Subjunctive
minaron	Indicative
estiradas	None
pinté	Indicative
flotar	None
traiciono	Indicative
portado	None
triplicarás	Indicative
localicé	Indicative
afinados	None
posé	Indicative
revistaríais	Conditional
expresaban	Indicative
brindarían	Conditional
prescinden	Indicative
antecedieron	Indicative
atenuases	Subjunctive
sabrá	Indicative
arriad	Imperative-Jussive
antepone	Indicative
calmó	Indicative
zampar	None
fraccionada	None
propusiste	Indicative
publicarían	Conditional
incapacité	Indicative
refugian	Indicative
mintió	Indicative
replicar	None
enmascaran	Indicative
peligro	Indicative
institucionalizado	None
exulcerada	None
rugida	None
cucharear	None
sedar	None
degollaron	Indicative
tasar	None
develada	None
colapsó	Indicative
injiriendo	None
ensañaron	Indicative
retrato	Indicative
indemnizó	Indicative
enlazaran	Subjunctive
disculpó	Indicative
congelan	Indicative
encintada	None
contraatacar	None
sobrepasada	None
destetáremos	Subjunctive
tardo	Indicative
acontecida	None
salpimentado	None
invitaran	Subjunctive
topando	None
obedecido	None
papada	None
reactivado	None
confundas	Subjunctive
computando	None
prescindieron	Indicative
degeneraron	Indicative
enjabonadas	None
enajenasteis	Indicative
enunciad	Imperative-Jussive
prefijaríamos	Conditional
decretó	Indicative
reputó	Indicative
tañen	Indicative
trampeó	Indicative
despiden	Indicative
meares	Subjunctive
acometen	Indicative
elaboraban	Indicative
repentizado	None
desplegados	None
repone	Indicative
salvaran	Subjunctive
rimados	None
dibujando	None
acrecentaron	Indicative
cableado	None
satisfecha	None
señalabas	Indicative
renovará	Indicative
demoré	Indicative
encolerizaron	Indicative
recrudecen	Indicative
acentúan	Indicative
financias	Indicative
huyen	Indicative
encantan	Indicative
decretaron	Indicative
batida	None
zafar	None
incautan	Indicative
preferirá	Indicative
inspiran	Indicative
escotes	Subjunctive
subordinados	None
ser	None
fondean	Indicative
transgredí	Indicative
prestas	Indicative
véase	Imperative-Jussive
residenciaré	Indicative
amputó	Indicative
llegasen	Subjunctive
fichas	Indicative
circunnavegado	None
blasonados	None
galardonando	None
educada	None
reactivas	Indicative
frotó	Indicative
desangrar	None
jodió	Indicative
prefijada	None
alunizáramos	Subjunctive
hallaren	Subjunctive
bordó	Indicative
chamuscado	None
visitarán	Indicative
reaccionarán	Indicative
determinadas	None
abatiéndose	None
exo	Indicative
dató	Indicative
presenciará	Indicative
enlodadas	None
sopesaron	Indicative
faranduleas	Indicative
fichan	Indicative
derroto	Indicative
reservará	Indicative
sublimes	Subjunctive
proliferaron	Indicative
metabolizados	None
madures	Subjunctive
proclamará	Indicative
disparan	Indicative
minimizaron	Indicative
euskaldunizar	None
albergó	Indicative
autorizado	None
restauré	Indicative
exorcizando	None
captando	None
distraerá	Indicative
referirá	Indicative
lloro	Indicative
aperturada	None
terciada	None
desaguaban	Indicative
expreses	Subjunctive
compartiendo	None
achuchó	Indicative
custodió	Indicative
cardó	Indicative
encuadernadas	None
perteneció	Indicative
trasportaréis	Indicative
disciplinares	Subjunctive
evalúan	Indicative
banderilleadas	None
convertirá	Indicative
asestó	Indicative
taponados	None
degolló	Indicative
capacitan	Indicative
apoyaban	Indicative
honraban	Indicative
guindáramos	Subjunctive
reservaran	Subjunctive
reembolsado	None
serenábamos	Indicative
desacreditada	None
erizo	Indicative
traducirá	Indicative
retomará	Indicative
liberarán	Indicative
listan	Indicative
influyen	Indicative
hablaran	Subjunctive
guarnecidas	None
cuadriculáis	Indicative
vulcanizar	None
sustituyo	Indicative
deleitareis	Subjunctive
desbloqueará	Indicative
fracaso	Indicative
perfilada	None
fallarían	Conditional
sonorizada	None
sorteado	None
callan	Indicative
localizadas	None
apoderarían	Conditional
triplican	Indicative
reescritos	None
remezclada	None
mangado	None
filetear	None
quintuplicar	None
proceso	Indicative
alborotó	Indicative
fluctuó	Indicative
aligeran	Indicative
descogollas	Indicative
enlistó	Indicative
canturreadas	None
cascáis	Indicative
cautelas	Indicative
basas	Indicative
atropello	Indicative
envalentonó	Indicative
redistribuyó	Indicative
hackear	None
engañaron	Indicative
recibieron	Indicative
trenzaron	Indicative
enrolaron	Indicative
evitaréis	Indicative
polas	Subjunctive
pronunciasen	Subjunctive
bloqueado	None
ofrecieseis	Subjunctive
contender	None
detectaseis	Subjunctive
desvalijar	None
reunían	Indicative
comenzaríamos	Conditional
negligieras	Subjunctive
sobresale	Indicative
inteligida	None
contaran	Subjunctive
desembarazadas	None
electrizarais	Subjunctive
desgarran	Indicative
replegaron	Indicative
diluida	None
disminuirá	Indicative
contrataron	Indicative
esparcíamos	Indicative
tardando	None
exultabas	Indicative
lucirá	Indicative
aceptaban	Indicative
congregada	None
disertando	None
dolido	None
humectando	None
instruyó	Indicative
riman	Indicative
subvencionando	None
quebrar	None
caducan	Indicative
fresando	None
desertando	None
comprobarás	Indicative
engallado	None
pasaré	Indicative
separándose	None
acusaseis	Subjunctive
arrestan	Indicative
fastidian	Indicative
musicalizar	None
juntado	None
inflamada	None
pronunciarán	Indicative
adelantada	None
acaeció	Indicative
bombardearían	Conditional
fuñida	None
disiento	Indicative
anexando	None
reconciliados	None
estilizad	Imperative-Jussive
decantado	None
empezaras	Subjunctive
zapatear	None
traicionaron	Indicative
desperezar	None
desaconsejaron	Indicative
replicada	None
afeitada	None
untaste	Indicative
contestada	None
cruzando	None
reconsideraran	Subjunctive
sufrió	Indicative
mugidas	None
hidrogeno	Indicative
gozará	Indicative
desmienten	Indicative
usábamos	Indicative
sobrevendieseis	Subjunctive
sumaran	Subjunctive
recaban	Indicative
subiré	Indicative
liada	None
arreglar	None
moviesen	Subjunctive
titularon	Indicative
dopados	None
perorada	None
permitió	Indicative
adulterar	None
etiquetan	Indicative
urbanizó	Indicative
conozcas	Subjunctive
salteareis	Subjunctive
atizada	None
deconstruyerais	Subjunctive
deleitaron	Indicative
pareciesen	Subjunctive
retitulada	None
reconfortado	None
cread	Imperative-Jussive
dilatan	Indicative
encajaran	Subjunctive
concluidos	None
modificada	None
revocaréis	Indicative
perforado	None
sufrí	Indicative
colaborarán	Indicative
comisarias	Indicative
falcaceados	None
celas	Indicative
apartas	Indicative
propaló	Indicative
pululan	Indicative
balanceados	None
ensuciar	None
involucrados	None
tensiones	Subjunctive
combinan	Indicative
vinculares	Subjunctive
medido	None
renqueásemos	Subjunctive
denominará	Indicative
vocalizados	None
nacieron	Indicative
retrocedidos	None
seccionó	Indicative
forzaron	Indicative
desviviéndose	None
papan	Indicative
consolidaseis	Subjunctive
socavando	None
cocido	None
delegaron	Indicative
juzgaban	Indicative
sofocan	Indicative
estigmatizados	None
cobras	Indicative
contrastó	Indicative
rozan	Indicative
pagué	Indicative
ocultada	None
tintas	Indicative
instado	None
pirateo	Indicative
descargaron	Indicative
colectas	Indicative
ionizar	None
indicarán	Indicative
enrolló	Indicative
desmadraremos	Indicative
expresando	None
justificó	Indicative
volverás	Indicative
descacharíamos	Conditional
madrugarais	Subjunctive
anidando	None
catapulto	Indicative
prefiguráremos	Subjunctive
aplegabais	Indicative
tremerá	Indicative
chistes	Subjunctive
estresaban	Indicative
empeñó	Indicative
departió	Indicative
orlan	Indicative
punteo	Indicative
haces	Indicative
repondrá	Indicative
endrogándose	None
agasajo	Indicative
pertenecieran	Subjunctive
espeto	Indicative
enojar	None
esclavizados	None
restauraran	Subjunctive
encasillaron	Indicative
grado	Indicative
despeinada	None
chufas	Indicative
ubican	Indicative
supondremos	Indicative
identifican	Indicative
entronizó	Indicative
recargaban	Indicative
cubriesen	Subjunctive
estrenar	None
fugues	Subjunctive
modorrasteis	Indicative
escuché	Indicative
excorias	Indicative
copresidir	None
desafino	Indicative
almacenarán	Indicative
canjear	None
dolió	Indicative
infestareis	Subjunctive
herrares	Subjunctive
cursará	Indicative
reconfortas	Indicative
desbancados	None
convertían	Indicative
desempañar	None
ovacionó	Indicative
entrevistó	Indicative
migran	Indicative
chiflo	Indicative
resonaban	Indicative
mecho	Indicative
encarcelar	None
excoriadas	None
brides	Subjunctive
idees	Subjunctive
apoderasen	Subjunctive
exonerado	None
infectaban	Indicative
repasabas	Indicative
fustigado	None
secuestraron	Indicative
gravitar	None
enmarcado	None
optimizadas	None
designará	Indicative
gasifiqué	Indicative
diezmando	None
criticas	Indicative
sometas	Subjunctive
defraudó	Indicative
rinden	Indicative
ostentará	Indicative
trampear	None
despertadas	None
condensó	Indicative
enfrascado	None
alcanzarán	Indicative
acantonar	None
candaré	Indicative
concedes	Indicative
hallarían	Conditional
catalogan	Indicative
mulgierais	Subjunctive
diplomados	None
recluyeron	Indicative
barbares	Subjunctive
materializando	None
oficio	Indicative
abdicaron	Indicative
alineé	Indicative
adjuntadas	None
booteaste	Indicative
identificaban	Indicative
apuntas	Indicative
fusionarán	Indicative
esperaron	Indicative
devastó	Indicative
postensado	None
desvirtuar	None
enclaves	Subjunctive
mires	Subjunctive
extinguieran	Subjunctive
sortear	None
pandeo	Indicative
posponen	Indicative
obtendrán	Indicative
conjuraras	Subjunctive
reaparecerían	Conditional
recapituláis	Indicative
redondearon	Indicative
espío	Indicative
olieron	Indicative
oscilaban	Indicative
llámense	Imperative-Jussive
achicaseis	Subjunctive
renunciaban	Indicative
ventilas	Indicative
incrustaron	Indicative
machetearon	Indicative
inmortalizó	Indicative
erguido	None
entresacar	None
desalojaron	Indicative
predicados	None
pincharon	Indicative
estaríamos	Conditional
preguntaste	Indicative
angosto	Indicative
perturbas	Indicative
enrumbada	None
publicar	None
malograda	None
columbrábamos	Indicative
domiciliabas	Indicative
agasajadas	None
caducó	Indicative
especiadas	None
adoptarían	Conditional
sugirieran	Subjunctive
entorno	Indicative
desarticulados	None
reflejando	None
dañará	Indicative
retransmitiendo	None
superpusieron	Indicative
acosté	Indicative
ideó	Indicative
reflexionaban	Indicative
muestreo	Indicative
alcanzasen	Subjunctive
redujeseis	Subjunctive
limitasteis	Indicative
diluviados	None
realzando	None
subsanó	Indicative
desvirtuada	None
estereotipados	None
agobiaran	Subjunctive
gritaron	Indicative
tapear	None
atendidos	None
andará	Indicative
abscedieses	Subjunctive
superaron	Indicative
notificará	Indicative
llegaran	Subjunctive
narrarías	Conditional
descompensadas	None
orientados	None
domesticaban	Indicative
conservaban	Indicative
encogeremos	Indicative
comenzando	None
aplatanaremos	Indicative
lecho	Indicative
porté	Indicative
descontaban	Indicative
forcejear	None
trozado	None
picoteo	Indicative
cumplió	Indicative
matriculases	Subjunctive
rentabilizados	None
lleves	Subjunctive
empezarían	Conditional
suicidan	Indicative
tachan	Indicative
simpatizando	None
opondrá	Indicative
murió	Indicative
fraguan	Indicative
despersonalizando	None
laureado	None
dirimió	Indicative
torturaban	Indicative
atacarán	Indicative
competirá	Indicative
triunfaban	Indicative
desorganizó	Indicative
sugerida	None
componemos	Indicative
disciplinado	None
trillas	Indicative
rumorearon	Indicative
reivindicó	Indicative
contactaban	Indicative
rondará	Indicative
bombardeo	Indicative
repostulando	None
aguzaste	Indicative
coaccionó	Indicative
correspondieron	Indicative
plegó	Indicative
pronuncio	Indicative
aserradas	None
matasellar	None
cerrarán	Indicative
colares	Subjunctive
formulo	Indicative
acompasan	Indicative
curtas	Subjunctive
sentiré	Indicative
tardaré	Indicative
luchan	Indicative
comprendieran	Subjunctive
pasmada	None
zancajeares	Subjunctive
metían	Indicative
incumben	Indicative
centras	Indicative
desorganizadas	None
entrecortaseis	Subjunctive
estacionan	Indicative
refrigeraran	Subjunctive
invistiésemos	Subjunctive
deshidrataras	Subjunctive
procedemos	Indicative
juntaron	Indicative
votad	Imperative-Jussive
inhibían	Indicative
sedas	Indicative
prendó	Indicative
increpando	None
avanzarais	Subjunctive
extirpar	None
desertados	None
gustaron	Indicative
encarecían	Indicative
respondes	Indicative
rebatió	Indicative
manejó	Indicative
gelatinizarían	Conditional
acrecentando	None
paralelé	Indicative
parir	None
inaugurará	Indicative
atañeríamos	Conditional
criopreservando	None
desmerecieron	Indicative
deslindaron	Indicative
aplazadas	None
antojan	Indicative
disipados	None
tabletearé	Indicative
enorgullecían	Indicative
desposó	Indicative
cueles	Subjunctive
terminaremos	Indicative
perduraron	Indicative
mesadas	None
dimitió	Indicative
aprisionaron	Indicative
soleados	None
zanjan	Indicative
prosperan	Indicative
aporreado	None
anexas	Indicative
reorientaron	Indicative
abarcadas	None
digas	Subjunctive
ligues	Subjunctive
procesados	None
archivé	Indicative
mulleres	Subjunctive
entrevistas	Indicative
mandaban	Indicative
barbo	Indicative
desovada	None
cribas	Indicative
endeudaron	Indicative
dedico	Indicative
cubrieran	Subjunctive
pivotaren	Subjunctive
avalaran	Subjunctive
tradujesen	Subjunctive
pasmáis	Indicative
reprimen	Indicative
flexionada	None
festoneada	None
recompuso	Indicative
predicho	None
deshacían	Indicative
almendres	Subjunctive
importados	None
matonearé	Indicative
devolvieran	Subjunctive
picaban	Indicative
quebrantaron	Indicative
retardan	Indicative
alimentado	None
fomentados	None
consumieran	Subjunctive
dinamizaron	Indicative
dificultaron	Indicative
abriesen	Subjunctive
pasteurizaré	Indicative
redistribuidos	None
enseñaron	Indicative
predicó	Indicative
enlatados	None
resguardados	None
recubrir	None
abdicas	Indicative
desencontrarse	None
tardado	None
pueblo	Indicative
embridados	None
caminaban	Indicative
estimulan	Indicative
perquirieren	Subjunctive
cierres	Subjunctive
condenada	None
ampararás	Indicative
reabsorber	None
quemadas	None
agradecidas	None
recalco	Indicative
glorificarán	Indicative
ensalzan	Indicative
ocultados	None
ambientó	Indicative
puntualizaríais	Conditional
reafirmaré	Indicative
desaparecida	None
etiquetado	None
desorientada	None
rogó	Indicative
estallados	None
suspended	Imperative-Jussive
utilizan	Indicative
boquees	Subjunctive
transmitieran	Subjunctive
enjaezados	None
amonestases	Subjunctive
envolverá	Indicative
blindado	None
planteo	Indicative
sentarán	Indicative
traicionando	None
predeterminaron	Indicative
vengo	Indicative
apresuraríamos	Conditional
rehabilitadas	None
garanto	Indicative
revueltos	None
sofocó	Indicative
encalada	None
pautando	None
escarpes	Subjunctive
cartelizando	None
intereses	Subjunctive
retraducid	Imperative-Jussive
comparecieres	Subjunctive
desfigurando	None
remozarían	Conditional
colectaron	Indicative
durará	Indicative
consistido	None
reinscritos	None
condenares	Subjunctive
insultas	Indicative
injertada	None
disolvió	Indicative
instalares	Subjunctive
cristalizados	None
golpearan	Subjunctive
caducaron	Indicative
amargo	Indicative
aportaran	Subjunctive
intrincados	None
concuerdo	Indicative
expondré	Indicative
discrepaban	Indicative
modelan	Indicative
tramo	Indicative
especificar	None
alistaban	Indicative
enrutar	None
occidentalizáremos	Subjunctive
reestructuraron	Indicative
movilizo	Indicative
comprendió	Indicative
surfeo	Indicative
idealizados	None
desaconsejaban	Indicative
observaremos	Indicative
despegaban	Indicative
evangelizaron	Indicative
propondrían	Conditional
curan	Indicative
premurió	Indicative
entenderemos	Indicative
encofrados	None
venenciadas	None
pautas	Indicative
sanitizado	None
contendían	Indicative
esponsorizados	None
despojaban	Indicative
domeño	Indicative
desagregado	None
redefiniríais	Conditional
remedio	Indicative
derrotas	Indicative
facilitarían	Conditional
recubrían	Indicative
chalo	Indicative
dejo	Indicative
descolonizar	None
dispersará	Indicative
ansiados	None
acreditasen	Subjunctive
enrevesáremos	Subjunctive
aplastado	None
desfasado	None
dentada	None
sensibilizados	None
despintado	None
registrada	None
estremecer	None
abjuraron	Indicative
ampliaremos	Indicative
internó	Indicative
activan	Indicative
despachados	None
encadenaron	Indicative
asignaran	Subjunctive
laxo	Indicative
rechinados	None
negociará	Indicative
fumaban	Indicative
espetó	Indicative
concertar	None
insertadas	None
convencidos	None
presidiendo	None
rendidas	None
solucionaran	Subjunctive
particularizar	None
abigarrasteis	Indicative
reintegró	Indicative
aclimatares	Subjunctive
constituyo	Indicative
ornan	Indicative
sobrecargadas	None
insistí	Indicative
privilegio	Indicative
poseemos	Indicative
empaquetadas	None
declamó	Indicative
taparon	Indicative
fantasean	Indicative
cavo	Indicative
reenvío	Indicative
desentierro	Indicative
glorifican	Indicative
delimitado	None
rezongando	None
psicoanalizar	None
rectifican	Indicative
testimonian	Indicative
peregrinan	Indicative
autentico	Indicative
acumulará	Indicative
aguijando	None
desenredando	None
fracturados	None
becado	None
corretean	Indicative
burocratizar	None
turbo	Indicative
bogas	Indicative
resurgidas	None
acuchillaremos	Indicative
garrapateados	None
comenzarás	Indicative
conllevó	Indicative
decrecido	None
granuladas	None
biografías	Indicative
abejorreadas	None
averiguaron	Indicative
trolead	Imperative-Jussive
exilio	Indicative
cultivando	None
añadirá	Indicative
queman	Indicative
pegan	Indicative
despistar	None
esnifadas	None
serenas	Indicative
compartiremos	Indicative
instadas	None
asaltaran	Subjunctive
entintaran	Subjunctive
ionizan	Indicative
reproducen	Indicative
agenciado	None
amplié	Indicative
caminarán	Indicative
avergonzó	Indicative
revientan	Indicative
facilitasen	Subjunctive
patrulladas	None
abofeteará	Indicative
postuló	Indicative
adversados	None
averiguarías	Conditional
calificaran	Subjunctive
zanjar	None
prosperaban	Indicative
dispersarías	Conditional
ocasionados	None
troncharemos	Indicative
caldeas	Indicative
limpio	Indicative
recomendé	Indicative
adosan	Indicative
cebo	Indicative
niveló	Indicative
adentro	Indicative
trascendió	Indicative
evito	Indicative
crecimos	Indicative
extrayendo	None
indignaron	Indicative
desdijeron	Indicative
arreciéis	Subjunctive
atraso	Indicative
distrajeron	Indicative
molinadas	None
filmados	None
satanizada	None
fraguaríamos	Conditional
electrocutada	None
asombraban	Indicative
asolaron	Indicative
reclamó	Indicative
ordenaron	Indicative
equilibró	Indicative
enamoré	Indicative
invadieran	Subjunctive
tocaremos	Indicative
licúan	Indicative
rebosar	None
estiró	Indicative
respaldó	Indicative
rumio	Indicative
exaltados	None
espigaron	Indicative
expresada	None
abrigaban	Indicative
inspiró	Indicative
taponó	Indicative
enroscaremos	Indicative
petrificada	None
remodelar	None
añoraban	Indicative
orinó	Indicative
volcares	Subjunctive
diagnosticando	None
exportaron	Indicative
desterrada	None
engarces	Subjunctive
procederemos	Indicative
premian	Indicative
progresada	None
blofeásemos	Subjunctive
trazan	Indicative
desterró	Indicative
entreabiertas	None
apagándose	None
grilles	Subjunctive
renguearíais	Conditional
extraídas	None
reservas	Indicative
bateas	Indicative
cometimos	Indicative
confinaban	Indicative
aposento	Indicative
derriten	Indicative
anebláremos	Subjunctive
giras	Indicative
recogieron	Indicative
refractar	None
rivalizaban	Indicative
adormezcas	Subjunctive
desconvocaren	Subjunctive
conmemoran	Indicative
enlutó	Indicative
reorganizo	Indicative
solicitasen	Subjunctive
adecuan	Indicative
desoyó	Indicative
canalicé	Indicative
asegurarán	Indicative
rociando	None
fallados	None
almorzaron	Indicative
pobláremos	Subjunctive
enseñará	Indicative
infravalorada	None
adolecían	Indicative
avistados	None
optimas	Indicative
heredan	Indicative
demeritar	None
autolesionarse	None
envilezco	Indicative
arrancaran	Subjunctive
escaldo	Indicative
afiliados	None
simuladas	None
condujo	Indicative
surten	Indicative
subió	Indicative
gesticulado	None
envolvió	Indicative
focalizada	None
respaldado	None
confió	Indicative
cubiertas	None
negaron	Indicative
almagrábamos	Indicative
consensúan	Indicative
traduje	Indicative
impersonalizado	None
labro	Indicative
recalificó	Indicative
controvirtierais	Subjunctive
extremo	Indicative
disueltas	None
forran	Indicative
comentan	Indicative
mecanografiado	None
concebida	None
asociaran	Subjunctive
unifico	Indicative
estremecieron	Indicative
esconderíamos	Conditional
arrasados	None
torear	None
propuesta	None
malogró	Indicative
caractericé	Indicative
conquistadas	None
acumularon	Indicative
apeteceríais	Conditional
acriminarías	Conditional
profetizados	None
opinando	None
curé	Indicative
cristianizásemos	Subjunctive
mencionéis	Subjunctive
aforará	Indicative
descendían	Indicative
apagado	None
globalizados	None
pausadas	None
resguardaron	Indicative
afilaran	Subjunctive
debatías	Indicative
bebido	None
lastres	Subjunctive
rondaban	Indicative
desempatada	None
empezó	Indicative
pregunto	Indicative
trasmitidos	None
aportar	None
blasfemas	Indicative
prefirió	Indicative
intentará	Indicative
desasiesen	Subjunctive
desagradado	None
blasones	Subjunctive
filmé	Indicative
contrahacer	None
aplacaréis	Indicative
profanas	Indicative
demorará	Indicative
determiné	Indicative
reprenden	Indicative
relates	Subjunctive
tañían	Indicative
mediatizados	None
atar	None
transporto	Indicative
asesinan	Indicative
urgían	Indicative
revolucionaron	Indicative
escondas	Subjunctive
magullada	None
repudiado	None
diversificó	Indicative
programadas	None
durmió	Indicative
coges	Indicative
recubiertas	None
reídas	None
sucumbirá	Indicative
imploro	Indicative
flagelada	None
consolido	Indicative
cerraré	Indicative
estiran	Indicative
caigo	Indicative
lustres	Subjunctive
adornó	Indicative
pregonaban	Indicative
habitarían	Conditional
disputaras	Subjunctive
bebió	Indicative
mercerizas	Indicative
templado	None
sustituían	Indicative
introducen	Indicative
salvaguardan	Indicative
engrillarías	Conditional
captará	Indicative
inhabilitaron	Indicative
olvidados	None
graficas	Indicative
imaginas	Indicative
solucionó	Indicative
engrosarían	Conditional
reconcilian	Indicative
basculado	None
entrecerradas	None
novelo	Indicative
tatuaron	Indicative
mutado	None
maduró	Indicative
recreadas	None
continué	Indicative
descolocó	Indicative
conjunto	Indicative
confesados	None
hurgar	None
desgranar	None
merodean	Indicative
parches	Subjunctive
atendían	Indicative
ensayar	None
atirantarán	Indicative
quedaron	Indicative
expulsada	None
perfilado	None
atravesarán	Indicative
falto	Indicative
apropió	Indicative
cortará	Indicative
trasladarán	Indicative
reconstituyeras	Subjunctive
detendrían	Conditional
anteponen	Indicative
fermentada	None
apuró	Indicative
oficializan	Indicative
conquistaban	Indicative
formulas	Indicative
volver	None
espantados	None
distribuyen	Indicative
predeterminada	None
pirateada	None
desconectaron	Indicative
relevados	None
desprestigiar	None
estreñidos	None
aseverar	None
proclamó	Indicative
desvencijarías	Conditional
tergiversando	None
contentaron	Indicative
cautivados	None
confundiesen	Subjunctive
decaen	Indicative
destiñó	Indicative
gorgotearen	Subjunctive
convertidas	None
izan	Indicative
acentuaron	Indicative
halagan	Indicative
menstruarais	Subjunctive
danzáremos	Subjunctive
acalorado	None
abarrotaron	Indicative
consentidos	None
enraizado	None
bastad	Imperative-Jussive
procederá	Indicative
astringí	Indicative
anunciada	None
cohondiéramos	Subjunctive
deberás	Indicative
recuadro	Indicative
chuto	Indicative
exudad	Imperative-Jussive
coso	Indicative
solté	Indicative
amaestrados	None
aliñad	Imperative-Jussive
conmocionar	None
alhajas	Indicative
aprehendido	None
podíais	Indicative
entenderíamos	Conditional
asoleó	Indicative
monopolizan	Indicative
individualices	Subjunctive
transmitirán	Indicative
erizabais	Indicative
expenderán	Indicative
asoció	Indicative
peticionar	None
arribo	Indicative
pudiste	Indicative
supongo	Indicative
predisponer	None
acudieran	Subjunctive
reclinasteis	Indicative
retornaran	Subjunctive
hurtó	Indicative
disculpo	Indicative
dejáramos	Subjunctive
pidiesen	Subjunctive
asistido	None
desterrando	None
portados	None
recogí	Indicative
identificaran	Subjunctive
formateo	Indicative
recompensadas	None
describo	Indicative
paseo	Indicative
ensartado	None
bombeo	Indicative
sonrojábamos	Indicative
reprocho	Indicative
acondicionas	Indicative
diezmaron	Indicative
asaeteando	None
asesinas	Indicative
profanó	Indicative
pliego	Indicative
cambies	Subjunctive
desenroscado	None
profundizaron	Indicative
glosas	Indicative
vacaciones	Subjunctive
dirigirán	Indicative
entronizados	None
litando	None
señalaran	Subjunctive
encuerando	None
volcará	Indicative
descoyuntábamos	Indicative
fascinarán	Indicative
abrid	Imperative-Jussive
cautivan	Indicative
hice	Indicative
asumí	Indicative
reconfigurar	None
envenenan	Indicative
desarrollé	Indicative
omitidos	None
debió	Indicative
ocultan	Indicative
autoproclamó	Indicative
impulsará	Indicative
caracterizar	None
repiques	Subjunctive
recobran	Indicative
gestada	None
garantizan	Indicative
inoculan	Indicative
introducimos	Indicative
colecto	Indicative
maravilló	Indicative
zombificados	None
recitado	None
oxigenadas	None
cenan	Indicative
reproches	Subjunctive
fungió	Indicative
estacas	Indicative
arrodillará	Indicative
vivirá	Indicative
debatirán	Indicative
acertadas	None
juzgo	Indicative
llamó	Indicative
domado	None
desproveyeses	Subjunctive
sufren	Indicative
crearé	Indicative
decaerá	Indicative
instauró	Indicative
escarpas	Indicative
amaestrado	None
patearon	Indicative
distraídos	None
envenenaron	Indicative
efectúo	Indicative
tapo	Indicative
acostaban	Indicative
inquietaban	Indicative
texteasen	Subjunctive
realojadas	None
generarán	Indicative
compensará	Indicative
embrides	Subjunctive
sorprenderán	Indicative
denunció	Indicative
enarbolan	Indicative
canalizan	Indicative
cuadricularen	Subjunctive
consagrados	None
incluyó	Indicative
interceptó	Indicative
aunaron	Indicative
sincronizó	Indicative
tachonar	None
tapeásemos	Subjunctive
oficializó	Indicative
vulcanizas	Indicative
sobreviene	Indicative
descuartizarais	Subjunctive
arreciaban	Indicative
plegados	None
hechizó	Indicative
estimes	Subjunctive
abotagarse	None
revistió	Indicative
guié	Indicative
conforto	Indicative
mediadas	None
reclamando	None
destronado	None
juzgaron	Indicative
masacraban	Indicative
rifas	Indicative
colegueares	Subjunctive
silbó	Indicative
estampaban	Indicative
espiradas	None
nacionalizó	Indicative
sincronizado	None
armonizado	None
comprenderéis	Indicative
fugar	None
engendrados	None
cableadas	None
esgrimirá	Indicative
colmada	None
interceptada	None
ajan	Indicative
subas	Subjunctive
testes	Subjunctive
empadronada	None
cotizó	Indicative
aireó	Indicative
compitieran	Subjunctive
enardecida	None
fecharon	Indicative
minado	None
desabotonada	None
inflamó	Indicative
lavaban	Indicative
templarías	Conditional
prolifero	Indicative
clavando	None
investigará	Indicative
cosquillead	Imperative-Jussive
historiada	None
maceran	Indicative
certificada	None
divorciaron	Indicative
respondieron	Indicative
registrarían	Conditional
adivinaban	Indicative
relampagueasteis	Indicative
soy	Indicative
trasladando	None
consolidad	Imperative-Jussive
calabrian	Indicative
siembras	Indicative
contradicen	Indicative
cocinó	Indicative
equilibrado	None
descubierto	None
blindé	Indicative
repuntó	Indicative
indican	Indicative
apodan	Indicative
agitaron	Indicative
doctorados	None
inmortalizadas	None
ladrada	None
raída	None
proveyeron	Indicative
bastará	Indicative
incumpliendo	None
cambió	Indicative
danzando	None
trabuco	Indicative
reinarían	Conditional
divorciarían	Conditional
ingresó	Indicative
rebozo	Indicative
sobrevivirán	Indicative
cualificar	None
pallar	None
zanjada	None
embalsaremos	Indicative
clasificarían	Conditional
adosar	None
usurpando	None
bromead	Imperative-Jussive
trasoísteis	Indicative
malvivían	Indicative
partieran	Subjunctive
emplean	Indicative
espoleado	None
sentían	Indicative
enamorado	None
bañan	Indicative
colectan	Indicative
abrumar	None
hirió	Indicative
bailará	Indicative
internadas	None
persuadió	Indicative
remplazado	None
pastaban	Indicative
ejecutó	Indicative
insultéis	Subjunctive
apegada	None
hago	Indicative
abrazado	None
bifurcar	None
arremedo	Indicative
acabarás	Indicative
deslizan	Indicative
véanse	Imperative-Jussive
restarán	Indicative
deflagrados	None
germinasteis	Indicative
riñas	Subjunctive
acometieron	Indicative
signaron	Indicative
condones	Subjunctive
retrasado	None
interviene	Indicative
rezan	Indicative
transcribir	None
cubrió	Indicative
inauguraban	Indicative
domas	Indicative
desenvolvíais	Indicative
pixeles	Subjunctive
preconizado	None
vayas	Subjunctive
encadenan	Indicative
necesitasen	Subjunctive
carcajeado	None
desinflando	None
detonaban	Indicative
temidos	None
lacrimas	Indicative
descalzaron	Indicative
desnudarais	Subjunctive
apropiaban	Indicative
almacenaron	Indicative
codirigiendo	None
enriquecieron	Indicative
arrollado	None
embargan	Indicative
atravesasen	Subjunctive
compuesto	None
martillo	Indicative
reprobaban	Indicative
habilitar	None
palideció	Indicative
solidados	None
decomisó	Indicative
enterrarían	Conditional
transitó	Indicative
bautizada	None
entubado	None
repobláremos	Subjunctive
prohibieron	Indicative
inmolaban	Indicative
preservan	Indicative
llevaran	Subjunctive
blasfeman	Indicative
obsesionan	Indicative
coaligaron	Indicative
neutralicé	Indicative
llenaron	Indicative
sustrajeron	Indicative
tapies	Subjunctive
sortean	Indicative
alistarais	Subjunctive
aviso	Indicative
contento	Indicative
conectando	None
confiscadas	None
exportan	Indicative
aprenderé	Indicative
cortejado	None
discriminan	Indicative
primaron	Indicative
aparecieran	Subjunctive
madreará	Indicative
prevalecidas	None
pedís	Indicative
activarán	Indicative
redirigen	Indicative
curasen	Subjunctive
colgaron	Indicative
remarcaban	Indicative
temas	Subjunctive
equipar	None
demandado	None
obtén	Imperative-Jussive
anidan	Indicative
recayeron	Indicative
andaban	Indicative
neviscaréis	Indicative
arreglaron	Indicative
descartes	Subjunctive
sorbo	Indicative
mosqueará	Indicative
consagraban	Indicative
cauterizar	None
flexibilizaron	Indicative
repercutió	Indicative
visitarías	Conditional
reproducirían	Conditional
observaran	Subjunctive
alucinada	None
afiebraran	Subjunctive
sojuzgaron	Indicative
monopolizados	None
jodido	None
parcelas	Indicative
vallado	None
aberraremos	Indicative
expliques	Subjunctive
ajustarían	Conditional
revisionáis	Indicative
lacrimo	Indicative
prendando	None
gustado	None
suplicares	Subjunctive
reproduzco	Indicative
mancho	Indicative
reelaborado	None
autoeditó	Indicative
guiarán	Indicative
cortasen	Subjunctive
cercenados	None
tapizar	None
estéis	Subjunctive
benefician	Indicative
pillan	Indicative
ejecutaran	Subjunctive
detiene	Indicative
abrogar	None
interconectarán	Indicative
eslabonado	None
violaron	Indicative
goteando	None
rivalizaron	Indicative
divorciándose	None
resumían	Indicative
aparcó	Indicative
recortaremos	Indicative
ambientaron	Indicative
incluido	None
desangraban	Indicative
fatigar	None
retocar	None
agradará	Indicative
guindases	Subjunctive
efectué	Indicative
remaron	Indicative
tomé	Indicative
desertará	Indicative
recalo	Indicative
exaltando	None
aciertan	Indicative
truncas	Indicative
proporcionando	None
recetas	Indicative
reforzar	None
caldeó	Indicative
avistaban	Indicative
corrijo	Indicative
sorteada	None
capitalizada	None
impactarán	Indicative
yuxtapuesta	None
contemplar	None
paparíamos	Conditional
autenticas	Indicative
tuteladas	None
disparando	None
reproducirá	Indicative
desnudaron	Indicative
estimulaban	Indicative
interiorizado	None
hostigan	Indicative
desprecias	Indicative
flirtean	Indicative
invernando	None
restablecían	Indicative
golpeará	Indicative
hinchó	Indicative
expresan	Indicative
estelarizó	Indicative
responderá	Indicative
truncados	None
ulcerada	None
cebados	None
decís	Indicative
arribó	Indicative
avisaré	Indicative
huronean	Indicative
tejían	Indicative
homenajeada	None
perdemos	Indicative
dependió	Indicative
abasteciendo	None
vulneran	Indicative
tumbo	Indicative
reconsidero	Indicative
santificada	None
iludida	None
homenajeó	Indicative
surcir	None
posará	Indicative
punzar	None
golpean	Indicative
refugiadas	None
desprecies	Subjunctive
afianzaban	Indicative
tallaron	Indicative
desheredaron	Indicative
emergidos	None
retrasarían	Conditional
supiéramos	Subjunctive
desbarataron	Indicative
señales	Subjunctive
descalificada	None
nutrirá	Indicative
abolieron	Indicative
hablarais	Subjunctive
evidenciaron	Indicative
enlosar	None
costó	Indicative
contrapone	Indicative
plasmas	Indicative
aprovecho	Indicative
preocupéis	Subjunctive
empadronado	None
denominada	None
levantará	Indicative
provocarán	Indicative
asesorar	None
parchar	None
reutilizó	Indicative
resurgiendo	None
acieméis	Subjunctive
azolvada	None
elevo	Indicative
derribó	Indicative
malograbais	Indicative
flamearen	Subjunctive
artillado	None
descontextualizado	None
acoladas	None
debatido	None
designaron	Indicative
liberarían	Conditional
clonada	None
colectados	None
atrapaban	Indicative
ahitarán	Indicative
dudéis	Subjunctive
operará	Indicative
agigantarás	Indicative
diezmado	None
empleaban	Indicative
esclerosadas	None
divergieron	Indicative
alejar	None
encuarteléis	Subjunctive
recordad	Imperative-Jussive
arabizado	None
gratinan	Indicative
interpusieron	Indicative
castellanizaron	Indicative
interferíais	Indicative
apedreáremos	Subjunctive
hacendado	None
prometimos	Indicative
abordará	Indicative
caducada	None
extremó	Indicative
entablados	None
derrelinquierais	Subjunctive
estalló	Indicative
apodó	Indicative
muleteáremos	Subjunctive
desbasto	Indicative
alcances	Subjunctive
apeo	Indicative
reprochados	None
parodiados	None
lapides	Subjunctive
congelado	None
obsequiarás	Indicative
enfatizada	None
amparada	None
impulsé	Indicative
drogado	None
reemplazas	Indicative
miraran	Subjunctive
escayolas	Indicative
constaban	Indicative
rendirían	Conditional
confirmaran	Subjunctive
rumorado	None
accedo	Indicative
atoro	Indicative
propagar	None
desenrollado	None
derogado	None
descarto	Indicative
lastraron	Indicative
jales	Subjunctive
pensó	Indicative
habló	Indicative
surcaban	Indicative
prostituyen	Indicative
somatizareis	Subjunctive
sustituyeran	Subjunctive
retrasaron	Indicative
convulsiones	Subjunctive
corresponder	None
desmayado	None
atores	Subjunctive
baldares	Subjunctive
descontinuada	None
extrudirás	Indicative
cambiaste	Indicative
musido	None
constaté	Indicative
enderezados	None
soportó	Indicative
gestas	Indicative
ensangrentada	None
arbitrada	None
dañaban	Indicative
lames	Indicative
inoculando	None
sodomizado	None
suplantaron	Indicative
estrechas	Indicative
aunar	None
rayo	Indicative
acerrojado	None
competirían	Conditional
imaginada	None
atribuirá	Indicative
retransmitir	None
instalaban	Indicative
acoplada	None
desoiré	Indicative
conjugar	None
recomiendo	Indicative
clarificarán	Indicative
girasen	Subjunctive
recuperó	Indicative
visitado	None
recusar	None
inundan	Indicative
rematan	Indicative
preludio	Indicative
vigilaran	Subjunctive
dejadas	None
impactaban	Indicative
jeringarán	Indicative
fertilizada	None
sabré	Indicative
desconoció	Indicative
cobijadas	None
nacionalizasteis	Indicative
traigo	Indicative
refrigerar	None
valorarán	Indicative
ingerían	Indicative
compareciendo	None
retractáremos	Subjunctive
permutada	None
sugiero	Indicative
soportará	Indicative
ennoblecer	None
resolver	None
llevó	Indicative
apañados	None
vitorean	Indicative
publicaran	Subjunctive
atreví	Indicative
refrendo	Indicative
subvencionases	Subjunctive
imposibilitaron	Indicative
triturados	None
decolaban	Indicative
cometes	Indicative
cimadas	None
río	Indicative
proveerán	Indicative
vaporizando	None
fallaban	Indicative
desbarrancó	Indicative
refutaron	Indicative
recabaron	Indicative
otorgó	Indicative
perpetrados	None
abarcabas	Indicative
adjudico	Indicative
procedidos	None
sancocharan	Subjunctive
atraído	None
recibid	Imperative-Jussive
va	Indicative
contiene	Indicative
proferida	None
reviso	Indicative
exponen	Indicative
sufrían	Indicative
merodeó	Indicative
salgas	Subjunctive
promovida	None
solventes	Subjunctive
discrepas	Indicative
acompañaron	Indicative
duché	Indicative
ahogo	Indicative
ninguneo	Indicative
islamicéis	Subjunctive
noto	Indicative
ajó	Indicative
diputó	Indicative
revisas	Indicative
mamo	Indicative
intentabas	Indicative
diversificarían	Conditional
conduzco	Indicative
moteada	None
despreciadas	None
convivirán	Indicative
telegrafió	Indicative
cuantifican	Indicative
seducíais	Indicative
ahorraremos	Indicative
segundábamos	Indicative
podremos	Indicative
anotaran	Subjunctive
gateadas	None
balbuceado	None
aprontéis	Subjunctive
cometen	Indicative
aseo	Indicative
tronabas	Indicative
empataban	Indicative
subieron	Indicative
electrificada	None
oses	Subjunctive
adaptarás	Indicative
fecundó	Indicative
drenes	Subjunctive
carreteo	Indicative
cimentadas	None
manducados	None
barrados	None
insuflados	None
autorizan	Indicative
pisaron	Indicative
parecían	Indicative
agilizan	Indicative
propugnó	Indicative
reacondicionadas	None
titulan	Indicative
eché	Indicative
perturbaban	Indicative
sigas	Subjunctive
decepciones	Subjunctive
oralizado	None
tomaras	Subjunctive
vagar	None
cucharearás	Indicative
veneráremos	Subjunctive
achatarradas	None
detentada	None
tocaron	Indicative
esquivando	None
desconfiada	None
esforzó	Indicative
enmoquetados	None
joteáis	Indicative
reincidió	Indicative
limo	Indicative
obedecieron	Indicative
transponen	Indicative
atenuasen	Subjunctive
aportando	None
cuidarán	Indicative
inducidas	None
asados	None
abrazases	Subjunctive
segmentan	Indicative
cobijar	None
esfuman	Indicative
retorciendo	None
pavimentan	Indicative
vislumbraron	Indicative
comisqueados	None
traigas	Subjunctive
chisporroteo	Indicative
elucidado	None
ansiaban	Indicative
ahitabais	Indicative
zampo	Indicative
desautorizados	None
hicieras	Subjunctive
succionar	None
ahorquillada	None
aplazan	Indicative
auguró	Indicative
raspan	Indicative
desdobladas	None
asas	Indicative
adecuaron	Indicative
hinchados	None
rescindieseis	Subjunctive
amotinada	None
compadecidos	None
escaneadas	None
depredado	None
vallas	Indicative
rechazo	Indicative
polarizados	None
ornamentareis	Subjunctive
escoltaré	Indicative
acorralan	Indicative
espigados	None
salvaban	Indicative
fluctuaseis	Subjunctive
comisionando	None
cotilleada	None
destartalado	None
condijéramos	Subjunctive
salves	Subjunctive
aluzados	None
radicadas	None
despersonalizábamos	Indicative
arengado	None
bordearon	Indicative
resucitada	None
ganaras	Subjunctive
condecorada	None
efectúan	Indicative
bamboleando	None
batían	Indicative
maniatado	None
alivianada	None
prestaron	Indicative
focalizado	None
chambees	Subjunctive
agilizó	Indicative
ubicáis	Indicative
tuvimos	Indicative
avecinan	Indicative
enrarecer	None
resecaban	Indicative
enumero	Indicative
expandidos	None
cías	Indicative
revestiste	Indicative
macollar	None
contienen	Indicative
personalizó	Indicative
molesté	Indicative
jalonaban	Indicative
disminuirían	Conditional
arabizada	None
agotaban	Indicative
basaban	Indicative
acceden	Indicative
sobrevivieron	Indicative
mutilaron	Indicative
bendecido	None
alquilo	Indicative
compartieran	Subjunctive
impermeabilizar	None
turisteado	None
conjeturado	None
propiciaron	Indicative
empezasen	Subjunctive
testimonies	Subjunctive
cercenadas	None
topada	None
rechinado	None
reunifiques	Subjunctive
cautelad	Imperative-Jussive
contrato	Indicative
almendrados	None
explayar	None
adaptan	Indicative
estaciones	Subjunctive
deshabilitados	None
macho	Indicative
ringaríais	Conditional
despatarrabais	Indicative
realojo	Indicative
gatear	None
separados	None
lograran	Subjunctive
cotejó	Indicative
documentó	Indicative
candidateado	None
aprenderán	Indicative
tirotearon	Indicative
empoderados	None
regionalizad	Imperative-Jussive
aduciríais	Conditional
consternó	Indicative
curradas	None
capitulares	Subjunctive
dinamitas	Indicative
fundará	Indicative
omites	Indicative
vivid	Imperative-Jussive
paginada	None
ambicionan	Indicative
fotografío	Indicative
maduro	Indicative
arraigaron	Indicative
cultivares	Subjunctive
patentadas	None
aliaban	Indicative
disputó	Indicative
retractes	Subjunctive
emitiesen	Subjunctive
preconizar	None
retipificadas	None
glosó	Indicative
muñó	Indicative
autenticados	None
enumerados	None
saludar	None
andan	Indicative
acorazadas	None
constará	Indicative
modelar	None
sampleada	None
averiguo	Indicative
trabajasen	Subjunctive
implementó	Indicative
formes	Subjunctive
despedazó	Indicative
atrancarás	Indicative
diagnosticaron	Indicative
tributaban	Indicative
despenar	None
partidas	None
menguadas	None
compartas	Subjunctive
menosprecies	Subjunctive
causaran	Subjunctive
candas	Indicative
respaldaban	Indicative
envían	Indicative
exasperó	Indicative
suputando	None
admitiríamos	Conditional
alborear	None
iluminará	Indicative
decolado	None
palpéis	Subjunctive
atreverá	Indicative
renovaban	Indicative
coqueteó	Indicative
patrulló	Indicative
termino	Indicative
pervertir	None
mellado	None
permean	Indicative
fertilizan	Indicative
amonados	None
desenvolvían	Indicative
retomaron	Indicative
versados	None
aconsejaríais	Conditional
enemistados	None
profundizarán	Indicative
dragando	None
candidateó	Indicative
ventiles	Subjunctive
pretendieran	Subjunctive
recreo	Indicative
intervenían	Indicative
quitará	Indicative
escenografio	Indicative
desorganizados	None
corregiré	Indicative
senté	Indicative
beatificares	Subjunctive
activará	Indicative
fluir	None
exterminó	Indicative
inyectada	None
asignada	None
reparó	Indicative
presidieron	Indicative
responderían	Conditional
charlas	Indicative
saboteada	None
incluí	Indicative
disminuyó	Indicative
replicó	Indicative
radian	Indicative
introducirá	Indicative
consiento	Indicative
atravesarían	Conditional
crecían	Indicative
atolondres	Subjunctive
buceó	Indicative
bateó	Indicative
surgiesen	Subjunctive
granuláramos	Subjunctive
lanzo	Indicative
tumbasteis	Indicative
asimilaban	Indicative
entretengáis	Subjunctive
fritas	Indicative
deformaron	Indicative
aterrorizan	Indicative
desposaron	Indicative
acuerdan	Indicative
fluís	Indicative
telefoneó	Indicative
hegemonizado	None
incumplieron	Indicative
mandarían	Conditional
desprender	None
invadiesen	Subjunctive
reunieron	Indicative
franquiciasteis	Indicative
dormís	Indicative
rodeaban	Indicative
reeligieron	Indicative
descarriada	None
rehabilitó	Indicative
defender	None
revolotearán	Indicative
acotoláramos	Subjunctive
cobijaban	Indicative
actuarán	Indicative
evangelizados	None
discontinuaríamos	Conditional
derrocaron	Indicative
pidieron	Indicative
desorganizar	None
llamad	Imperative-Jussive
ensordecíamos	Indicative
discuto	Indicative
escatimados	None
padecen	Indicative
expresasen	Subjunctive
conducida	None
radicalizaron	Indicative
obstruido	None
peregrinado	None
presionas	Indicative
limitasen	Subjunctive
alargaríais	Conditional
sugerí	Indicative
tartamudees	Subjunctive
cercenó	Indicative
laqueados	None
desató	Indicative
aclimataron	Indicative
alegrará	Indicative
zarandeáramos	Subjunctive
retires	Subjunctive
cercaban	Indicative
acaeciendo	None
procesionado	None
pedaleaseis	Subjunctive
residido	None
ciñendo	None
mead	Imperative-Jussive
estarían	Conditional
pactó	Indicative
encaraban	Indicative
forcejeando	None
removiste	Indicative
reconozcas	Subjunctive
arramblada	None
ingeniaron	Indicative
someter	None
improvisan	Indicative
cabildeó	Indicative
vivirán	Indicative
untan	Indicative
alejada	None
acondicionado	None
maniobró	Indicative
aguardadas	None
acoplaremos	Indicative
trenzan	Indicative
referían	Indicative
atacada	None
fenecieses	Subjunctive
tabletearan	Subjunctive
estorbar	None
distorsionadas	None
alimentó	Indicative
librar	None
aferran	Indicative
racionalizad	Imperative-Jussive
reconcilió	Indicative
topear	None
acogieron	Indicative
comunicasen	Subjunctive
pertenecido	None
jalada	None
minó	Indicative
conversas	Indicative
deshinchado	None
hipotecando	None
disfrutaban	Indicative
acontecían	Indicative
complicaban	Indicative
cacareo	Indicative
instruyeron	Indicative
instituyeron	Indicative
rallaríais	Conditional
divorciémonos	Imperative-Jussive
rebautizó	Indicative
descarriló	Indicative
aspiro	Indicative
huyeron	Indicative
reducimos	Indicative
ejecutaron	Indicative
tranquilizar	None
anonadados	None
deparado	None
derrocan	Indicative
echad	Imperative-Jussive
escaldada	None
ornes	Subjunctive
remarcan	Indicative
afectó	Indicative
visitan	Indicative
angostásemos	Subjunctive
incubo	Indicative
reprobó	Indicative
restablecer	None
bloqueé	Indicative
redondeados	None
recargué	Indicative
descabezáis	Indicative
arrobaremos	Indicative
desdigo	Indicative
aojaren	Subjunctive
ensoñares	Subjunctive
limpió	Indicative
socorrido	None
aquejados	None
moderaron	Indicative
estafando	None
prohijéis	Subjunctive
adivino	Indicative
concesiones	Subjunctive
prescindirá	Indicative
abrigando	None
entras	Indicative
despedían	Indicative
desdoblado	None
proclaman	Indicative
antecediendo	None
acarrearían	Conditional
lamo	Indicative
reines	Subjunctive
engancharon	Indicative
enteré	Indicative
indexes	Subjunctive
cosían	Indicative
soltarán	Indicative
rehuyó	Indicative
presenté	Indicative
reabasteció	Indicative
maché	Indicative
necesitarás	Indicative
engendrando	None
destrozo	Indicative
alijararéis	Indicative
hederéis	Indicative
compartimento	Indicative
medirían	Conditional
jerarquizando	None
obviaron	Indicative
describirían	Conditional
desobstruyeses	Subjunctive
bojan	Indicative
renunciaron	Indicative
cuestionada	None
osas	Indicative
frustró	Indicative
finalizan	Indicative
tachonada	None
psicoanalizaren	Subjunctive
deslenguándose	None
enajenó	Indicative
equivocándose	None
cejados	None
silenciar	None
explicasteis	Indicative
capto	Indicative
repostando	None
viro	Indicative
parí	Indicative
masculinizadas	None
sobrevolaban	Indicative
desaniman	Indicative
aconsejaron	Indicative
reunieren	Subjunctive
someterá	Indicative
resorber	None
granas	Indicative
zapeo	Indicative
estimando	None
atorgaren	Subjunctive
tarada	None
mirarán	Indicative
piqueteará	Indicative
barajear	None
confesar	None
armaron	Indicative
refrigerada	None
gozaran	Subjunctive
obtengo	Indicative
consumados	None
ingresados	None
existirá	Indicative
desvió	Indicative
clausuraron	Indicative
enamórate	Imperative-Jussive
cementados	None
derraman	Indicative
remarcando	None
explotaron	Indicative
abasteciésemos	Subjunctive
hicieren	Subjunctive
llegaré	Indicative
arrugar	None
menguado	None
desprecio	Indicative
subestiman	Indicative
marginalizada	None
contentan	Indicative
atronáis	Indicative
optimizados	None
desagregada	None
socializando	None
recorrió	Indicative
ultimas	Indicative
desnivelar	None
achocolatados	None
fusionaban	Indicative
esclavizan	Indicative
disputo	Indicative
franelearíamos	Conditional
desregularan	Subjunctive
legitiman	Indicative
recurren	Indicative
registran	Indicative
titubeada	None
comento	Indicative
hiriendo	None
obsequio	Indicative
obró	Indicative
nacionalizar	None
debas	Subjunctive
desescombro	Indicative
tejidos	None
barnizado	None
apapachar	None
faltaremos	Indicative
resumir	None
cilindraremos	Indicative
estampadas	None
repararan	Subjunctive
orearais	Subjunctive
leed	Imperative-Jussive
renuncies	Subjunctive
debilitado	None
dignificaran	Subjunctive
escabeches	Subjunctive
frotaban	Indicative
enfatizar	None
jalonando	None
rapes	Subjunctive
alunizaron	Indicative
situar	None
afianzas	Indicative
devenidas	None
abuchear	None
sincopados	None
encarcelan	Indicative
sazonado	None
desmandando	None
trasladan	Indicative
anclaron	Indicative
taponeando	None
estafan	Indicative
abducido	None
reiterareis	Subjunctive
nombrasen	Subjunctive
peinará	Indicative
esgrimieron	Indicative
escasearon	Indicative
poblados	None
documentas	Indicative
multar	None
descalificadas	None
plantearan	Subjunctive
turno	Indicative
laurear	None
desencallabas	Indicative
aprestó	Indicative
tejida	None
trotes	Subjunctive
empezaste	Indicative
destraillaremos	Indicative
trapicheabas	Indicative
repetirá	Indicative
encaran	Indicative
citan	Indicative
rielados	None
hostigaríais	Conditional
emplazando	None
empleará	Indicative
remodeló	Indicative
demandas	Indicative
personalizado	None
extienden	Indicative
retrotraída	None
aguijonearán	Indicative
imitar	None
apareada	None
atrapaste	Indicative
subordinaron	Indicative
calafatearían	Conditional
curtidos	None
concretará	Indicative
metimos	Indicative
habiendo	None
reposan	Indicative
mezclo	Indicative
tergiversar	None
signadas	None
reproducido	None
integraban	Indicative
carbonizado	None
pensaste	Indicative
llamabas	Indicative
abominarían	Conditional
encajar	None
defenderé	Indicative
eructaban	Indicative
comido	Indicative
abonar	None
olvidarás	Indicative
juntados	None
lanzadas	None
tuvieren	Subjunctive
relegadas	None
saqueásemos	Subjunctive
inspiro	Indicative
tuiteó	Indicative
esclarecieron	Indicative
agradecerían	Conditional
desmembraríais	Conditional
migrarán	Indicative
desdramatizada	None
menas	Indicative
pergeñáremos	Subjunctive
convocados	None
masados	None
sitiáremos	Subjunctive
acabándose	None
enmohecidas	None
asomó	Indicative
chapas	Indicative
succionados	None
aprecio	Indicative
subrayado	None
romanzo	Indicative
terminar	None
movían	Indicative
sobrecumplir	None
percibió	Indicative
trasmitida	None
heredaran	Subjunctive
hagas	Subjunctive
giro	Indicative
digitados	None
brillaron	Indicative
coincidieres	Subjunctive
dialogaban	Indicative
impartirán	Indicative
pilotará	Indicative
chantajeados	None
adulterando	None
rujas	Subjunctive
fragmentaste	Indicative
comedido	None
recurrirá	Indicative
cuecen	Indicative
tapizando	None
derivarás	Indicative
educar	None
facilitar	None
pajareares	Subjunctive
impostada	None
romances	Subjunctive
eliminaban	Indicative
sudan	Indicative
contendieron	Indicative
llevados	None
pescueceado	None
wikificada	None
primes	Subjunctive
lucran	Indicative
convivían	Indicative
deglutiéremos	Subjunctive
personificaron	Indicative
revitalizan	Indicative
conmocionó	Indicative
trabajar	None
gugleáramos	Subjunctive
comercializó	Indicative
estrechados	None
acodadas	None
dividirán	Indicative
triangulabais	Indicative
configurando	None
adoptaron	Indicative
catalogó	Indicative
pretendió	Indicative
rechazarían	Conditional
disminuido	None
embrujareis	Subjunctive
chapoteo	Indicative
profieren	Indicative
defiendo	Indicative
aclimatándose	None
autorrealizándose	None
lucrado	None
contrataran	Subjunctive
incentivaron	Indicative
anunciaran	Subjunctive
ironizar	None
consigo	Indicative
rascabais	Indicative
afianzo	Indicative
esperanzarás	Indicative
activó	Indicative
picar	None
iluminaban	Indicative
apodaran	Subjunctive
preciémonos	Imperative-Jussive
sumiendo	None
disecar	None
variaron	Indicative
interpretó	Indicative
rotaron	Indicative
resucitarán	Indicative
lavada	None
rastrearon	Indicative
cristianizó	Indicative
racionaréis	Indicative
apelarás	Indicative
combatido	None
sincronizaríamos	Conditional
desposados	None
acabo	Indicative
derives	Subjunctive
organizas	Indicative
hacíamos	Indicative
hemos	Indicative
enfrió	Indicative
averiguará	Indicative
gozar	None
diseminado	None
simplificarías	Conditional
corrida	None
traspones	Indicative
percuten	Indicative
adyacidos	None
rastreaban	Indicative
electrificó	Indicative
metió	Indicative
fungen	Indicative
justaban	Indicative
tomado	None
casaríamos	Conditional
reenviaréis	Indicative
aproximan	Indicative
entreabiertos	None
exid	Imperative-Jussive
amémonos	Imperative-Jussive
comencé	Indicative
escuchan	Indicative
alertas	Indicative
atraco	Indicative
certificados	None
comieran	Subjunctive
demarco	Indicative
demandarían	Conditional
señalaremos	Indicative
noqueó	Indicative
gestaron	Indicative
tardaron	Indicative
rescató	Indicative
sugerirían	Conditional
desnacías	Indicative
ultimo	Indicative
impactando	None
arraigó	Indicative
hidratan	Indicative
engañado	None
vagaron	Indicative
impresionadas	None
monopolizó	Indicative
alineo	Indicative
apiñada	None
reembolsaseis	Subjunctive
fosforiladas	None
apaches	Subjunctive
licito	Indicative
integró	Indicative
atraerían	Conditional
previnieron	Indicative
hidratáramos	Subjunctive
redujesen	Subjunctive
multas	Indicative
doctorar	None
franeleará	Indicative
rescatados	None
decaer	None
enrolar	None
antagonizando	None
referenciado	None
fuñido	None
defino	Indicative
suicidando	None
estarán	Indicative
testareis	Subjunctive
coronaban	Indicative
testimoniaras	Subjunctive
avecinaban	Indicative
conseguiríamos	Conditional
recolectó	Indicative
desorganizada	None
sobreponiendo	None
revisitaseis	Subjunctive
tripuló	Indicative
desestructuráremos	Subjunctive
coincidieran	Subjunctive
eligiendo	None
apadrinó	Indicative
movilizaban	Indicative
cubrieron	Indicative
baldeéis	Subjunctive
exorcizados	None
versaron	Indicative
colocaremos	Indicative
hartan	Indicative
resolvieran	Subjunctive
maquinó	Indicative
noqueada	None
emborracharon	Indicative
bastan	Indicative
tapando	None
enmarañada	None
moran	Indicative
costeado	None
reseño	Indicative
carpen	Indicative
transportaban	Indicative
atalayes	Subjunctive
violado	None
rectificada	None
escapaban	Indicative
publicitaban	Indicative
tendemos	Indicative
enviaban	Indicative
ubicaban	Indicative
investigado	None
divisó	Indicative
llegué	Indicative
serpenteo	Indicative
copresidierais	Subjunctive
resolved	Imperative-Jussive
desmoronan	Indicative
proyectó	Indicative
fundó	Indicative
sobreponen	Indicative
pagasen	Subjunctive
cartearse	None
nublada	None
esbozar	None
arengados	None
descalificas	Indicative
traspirado	None
abovedada	None
desdeñan	Indicative
encendida	None
recorrerá	Indicative
confiscó	Indicative
edificó	Indicative
desautorizó	Indicative
microscopio	Indicative
transpirarais	Subjunctive
provocó	Indicative
concursadas	None
afrontó	Indicative
alfabetizasteis	Indicative
trepidaré	Indicative
inhiben	Indicative
destituyó	Indicative
destruido	None
ganasen	Subjunctive
pallas	Indicative
enloquecidas	None
dispondrían	Conditional
acamparon	Indicative
nombraremos	Indicative
despejada	None
evoluciono	Indicative
notaras	Subjunctive
fríen	Indicative
quedaban	Indicative
encasquillados	None
blasfemo	Indicative
pastes	Subjunctive
reinscribiéremos	Subjunctive
correspondías	Indicative
lavando	None
infestarías	Conditional
triunfaran	Subjunctive
regaron	Indicative
boicotearon	Indicative
obtenían	Indicative
googleando	None
huronear	None
faltarán	Indicative
hicisteis	Indicative
laces	Subjunctive
desmembrar	None
diamantaban	Indicative
profanaron	Indicative
acompañan	Indicative
conjugaron	Indicative
cubrir	None
compungiendo	None
empacarán	Indicative
fascinan	Indicative
asediadas	None
atenúan	Indicative
engulló	Indicative
celebraríais	Conditional
reencontrarían	Conditional
aproximada	None
glorificareis	Subjunctive
fusionan	Indicative
inactivado	None
causarían	Conditional
callaron	Indicative
derrotó	Indicative
engrandecer	None
desembarcaron	Indicative
empecé	Indicative
elogiaban	Indicative
traslapados	None
ridiculizaban	Indicative
desconsuelo	Indicative
rebautizo	Indicative
ansían	Indicative
calcinó	Indicative
pulidos	None
esperó	Indicative
incubado	None
percibían	Indicative
ventarás	Indicative
desviadas	None
perpetrar	None
añadirían	Conditional
saciabas	Indicative
arrasadas	None
forzarían	Conditional
clamaran	Subjunctive
computes	Subjunctive
soplada	None
calculábamos	Indicative
afirmarían	Conditional
aturdida	None
desplazan	Indicative
arremetió	Indicative
contabilizada	None
recusadas	None
practican	Indicative
escolarizando	None
suministraran	Subjunctive
organizaron	Indicative
dirimirá	Indicative
implico	Indicative
oficiaron	Indicative
teorizó	Indicative
reubicaran	Subjunctive
recreó	Indicative
edificaban	Indicative
prolongará	Indicative
contendidos	None
acicalar	None
enyerbarás	Indicative
organizaban	Indicative
comprarían	Conditional
adoptarás	Indicative
revender	None
añorarás	Indicative
conminases	Subjunctive
rehusó	Indicative
obstaculizar	None
rebajo	Indicative
significar	None
echas	Indicative
estallo	Indicative
encubrir	None
encubrió	Indicative
indagan	Indicative
enamoradas	None
fío	Indicative
apoyan	Indicative
recargó	Indicative
permutarían	Conditional
vares	Subjunctive
insultando	None
engendro	Indicative
arrasaron	Indicative
fraccionó	Indicative
salto	Indicative
enseñaré	Indicative
inseminábamos	Indicative
restituyen	Indicative
sepultasen	Subjunctive
recalcando	None
sumaban	Indicative
inhibió	Indicative
abarrotaseis	Subjunctive
ayuntada	None
obtendríamos	Conditional
ascenderá	Indicative
rebelo	Indicative
empataran	Subjunctive
alzadas	None
añadían	Indicative
desenchufado	None
recibí	Indicative
incubados	None
acezada	None
muestres	Subjunctive
alargará	Indicative
apretados	None
conquistaron	Indicative
fracturas	Indicative
moldeaban	Indicative
refutan	Indicative
acabas	Indicative
variaran	Subjunctive
admirabais	Indicative
curaremos	Indicative
capitalizadas	None
irrigan	Indicative
subvencionado	None
encerrado	None
linchados	None
coincidieron	Indicative
hojaldres	Subjunctive
rectifico	Indicative
clasificar	None
yació	Indicative
agachados	None
bocinabais	Indicative
trascenderá	Indicative
discutíamos	Indicative
sedujo	Indicative
techar	None
desertices	Subjunctive
suministraban	Indicative
aprobasen	Subjunctive
agradecer	None
ripiaríamos	Conditional
revisad	Imperative-Jussive
adular	None
rentó	Indicative
acusó	Indicative
fundió	Indicative
revisionadas	None
brillarán	Indicative
determinaron	Indicative
recomenzando	None
recortaban	Indicative
halarás	Indicative
atajaré	Indicative
libras	Indicative
subrogarán	Indicative
debían	Indicative
traicionadas	None
incendiado	None
soltadas	None
llovían	Indicative
embarrancó	Indicative
reunificando	None
interactuada	None
ciñeron	Indicative
examinada	None
embestido	None
calibraré	Indicative
amohinando	None
infundidos	None
entrecruzaras	Subjunctive
simpatizo	Indicative
mirar	None
desposeyó	Indicative
desplegarán	Indicative
engalanan	Indicative
riendo	None
presumieron	Indicative
revolcando	None
hinchadas	None
fortificar	None
bufas	Indicative
masacres	Subjunctive
aperturó	Indicative
regrabaremos	Indicative
aprovisionar	None
comulgaban	Indicative
merco	Indicative
trocear	None
irrumpió	Indicative
chichas	Indicative
sabed	Imperative-Jussive
amarró	Indicative
salté	Indicative
revitalizaron	Indicative
obscurecer	None
removidos	None
arañó	Indicative
manteo	Indicative
supondrá	Indicative
confundían	Indicative
arrasaban	Indicative
afianzada	None
solidarizaron	Indicative
peto	Indicative
embargando	None
chichada	None
disimular	None
calles	Subjunctive
encantaren	Subjunctive
olvidaban	Indicative
estremecida	None
atendieran	Subjunctive
solapas	Indicative
ocasionan	Indicative
planifican	Indicative
sacrificará	Indicative
cursaban	Indicative
atormentada	None
declarado	None
coreados	None
arrojan	Indicative
avivo	Indicative
editas	Indicative
explotan	Indicative
dignareis	Subjunctive
guardaban	Indicative
amándose	None
toses	Indicative
satirizan	Indicative
capitulan	Indicative
sobradas	None
facho	Indicative
enterrasen	Subjunctive
descifró	Indicative
deseáis	Indicative
verifiques	Subjunctive
polarizan	Indicative
hubieran	Subjunctive
frotadas	None
preocupar	None
cohabitan	Indicative
estipulaban	Indicative
apedrearon	Indicative
enloso	Indicative
ejercen	Indicative
publicité	Indicative
devanadas	None
tincarías	Conditional
nutrió	Indicative
agregados	None
optarían	Conditional
degollando	None
empadronados	None
medicado	None
dignas	Indicative
reurbanizadas	None
empollado	None
humedecidas	None
apuntados	None
transmito	Indicative
educaban	Indicative
figurar	None
atribuyeran	Subjunctive
continuada	None
cuadricular	None
relacionan	Indicative
empachadas	None
desechas	Indicative
friesen	Subjunctive
expuestas	None
desarticulan	Indicative
sustraen	Indicative
desbandó	Indicative
persistió	Indicative
abeldados	None
atraviesan	Indicative
estandarizó	Indicative
proliferando	None
franeleadas	None
hubieras	Subjunctive
reentrados	None
halló	Indicative
degeneran	Indicative
renombré	Indicative
labraron	Indicative
estorbaron	Indicative
reexpidiesen	Subjunctive
enfilaron	Indicative
dificultar	None
humillado	None
pergeñado	None
adujarías	Conditional
alargan	Indicative
lees	Indicative
rebullésemos	Subjunctive
teatralizado	None
sonreís	Indicative
evaporará	Indicative
oré	Indicative
trivializada	None
ampollaste	Indicative
cuidó	Indicative
odié	Indicative
cardo	Indicative
seguid	Imperative-Jussive
protegida	None
sintetizar	None
acostumbras	Indicative
fallas	Indicative
objeto	Indicative
conocieras	Subjunctive
enjaulaste	Indicative
tartamudeado	None
propusieron	Indicative
significaron	Indicative
irrumpen	Indicative
pareciste	Indicative
imanéis	Subjunctive
sonsacados	None
profundizará	Indicative
tuteadas	None
muestrear	None
represaliada	None
inventan	Indicative
lubricando	None
asuelan	Indicative
repitieran	Subjunctive
inactivar	None
amarillecíamos	Indicative
embalsar	None
decantada	None
avalaron	Indicative
sintetizan	Indicative
faltasen	Subjunctive
ayudaran	Subjunctive
ablandándose	None
disfrazará	Indicative
explayó	Indicative
emigrasen	Subjunctive
desarboló	Indicative
responsabilizásemos	Subjunctive
menospreció	Indicative
germinó	Indicative
solapan	Indicative
mazan	Indicative
honorar	None
desacatarías	Conditional
cerco	Indicative
sindico	Indicative
necesitáis	Indicative
realizaron	Indicative
distraído	None
segregad	Imperative-Jussive
prevalecerá	Indicative
estipuló	Indicative
gestes	Subjunctive
solventados	None
atenderán	Indicative
permites	Indicative
fundidos	None
censar	None
liberté	Indicative
desaparecidas	None
encuestéis	Subjunctive
chaquetearé	Indicative
vas	Indicative
baleas	Indicative
repartirán	Indicative
procurad	Imperative-Jussive
ofrendados	None
detraigáis	Subjunctive
anexionó	Indicative
capitalizan	Indicative
agredieron	Indicative
redobladas	None
recetan	Indicative
especializaron	Indicative
tildes	Subjunctive
gobernarais	Subjunctive
sanó	Indicative
reflejaban	Indicative
creerás	Indicative
finada	None
chirriáis	Indicative
oficializo	Indicative
macollaré	Indicative
atesorando	None
alzarán	Indicative
trasportes	Subjunctive
truco	Indicative
almagrados	None
amanecí	Indicative
existo	Indicative
enjugábamos	Indicative
venerando	None
alzó	Indicative
honran	Indicative
actualicé	Indicative
desbloqueé	Indicative
moralicéis	Subjunctive
imprimieran	Subjunctive
liberalizarás	Indicative
certificado	None
perjudicando	None
cité	Indicative
pronunciar	None
cierras	Indicative
presentarían	Conditional
refutados	None
dimisionada	None
implementaron	Indicative
desarbolada	None
esculpían	Indicative
metalizados	None
encontraren	Subjunctive
hackeo	Indicative
observasen	Subjunctive
computarizada	None
legado	None
estructurarás	Indicative
compartí	Indicative
encaramó	Indicative
negoció	Indicative
acartonado	None
resumí	Indicative
escobares	Subjunctive
calculada	None
invernó	Indicative
descogollad	Imperative-Jussive
revisada	None
reaniman	Indicative
dejó	Indicative
alteraban	Indicative
retoques	Subjunctive
atestiguaban	Indicative
chasco	Indicative
ingresas	Indicative
descalificabais	Indicative
derrumbaste	Indicative
enlodaríamos	Conditional
escuchad	Imperative-Jussive
esleída	None
visites	Subjunctive
recularan	Subjunctive
incomodaban	Indicative
anunciaban	Indicative
ensartados	None
fraternizaban	Indicative
necesitaremos	Indicative
zigzaguead	Imperative-Jussive
enterrada	None
contraerá	Indicative
pitado	None
aseguré	Indicative
editaré	Indicative
amuralladas	None
almendro	Indicative
sazonan	Indicative
consentir	None
calculan	Indicative
sobrecoges	Indicative
condiciones	Subjunctive
subsistir	None
descachimbaré	Indicative
repuestas	None
vitrificados	None
reverencian	Indicative
discrepando	None
hacinada	None
reintroduciendo	None
revelará	Indicative
aprobarían	Conditional
combatidos	None
atinar	None
analizados	None
suspendió	Indicative
encariñó	Indicative
pudriesen	Subjunctive
paséis	Subjunctive
rezar	None
introdujeron	Indicative
exigirán	Indicative
simulan	Indicative
intensificaban	Indicative
encaro	Indicative
humectadas	None
desprendieron	Indicative
importaron	Indicative
propones	Indicative
temo	Indicative
afincando	None
cambiar	None
perdieran	Subjunctive
acalló	Indicative
reparadas	None
repercutían	Indicative
imitando	None
convocaron	Indicative
ficada	None
postulan	Indicative
encaminaron	Indicative
diptongo	Indicative
acaparó	Indicative
jurará	Indicative
encomendó	Indicative
agrupadas	None
recorrido	None
anclaban	Indicative
zanjados	None
comprobaremos	Indicative
desintegrará	Indicative
disputas	Indicative
procreados	None
filé	Indicative
aguijonees	Subjunctive
entrecortado	None
internalizadas	None
condensaron	Indicative
salid	Imperative-Jussive
rifar	None
desasosegadas	None
reflejarán	Indicative
jaspeasen	Subjunctive
libraran	Subjunctive
fraternizaré	Indicative
refino	Indicative
mofada	None
tamizar	None
lidiados	None
incursionó	Indicative
publicasen	Subjunctive
residenciado	None
parlarás	Indicative
cafichasteis	Indicative
sumergió	Indicative
bojo	Indicative
pretendida	None
aspiraban	Indicative
armada	None
excavaban	Indicative
trabajó	Indicative
resides	Indicative
depredareis	Subjunctive
borraste	Indicative
algopaos	Imperative-Jussive
zarpar	None
comercian	Indicative
rejuveneció	Indicative
criticaron	Indicative
anexado	None
atrevida	None
reubican	Indicative
adjuntó	Indicative
esculpiríamos	Conditional
mendigar	None
preconizáremos	Subjunctive
tontead	Imperative-Jussive
dañar	None
enfermó	Indicative
metas	Subjunctive
chamuscaras	Subjunctive
cobraren	Subjunctive
exultar	None
despertará	Indicative
pactadas	None
flaquearíais	Conditional
cotizando	None
despliegues	Subjunctive
avellanas	Indicative
expresaremos	Indicative
razones	Subjunctive
desempañados	None
sobrevienen	Indicative
dañaran	Subjunctive
rearmas	Indicative
abollada	None
capada	None
agonizó	Indicative
permanecemos	Indicative
describiremos	Indicative
estrenadas	None
curves	Subjunctive
menoscabadas	None
recubriste	Indicative
independizados	None
revended	Imperative-Jussive
destacaríamos	Conditional
detestando	None
sobrealimentaremos	Indicative
escoltares	Subjunctive
abofeteó	Indicative
asaltabais	Indicative
estrenaran	Subjunctive
garrapiñada	None
asean	Indicative
coleo	Indicative
sucumbían	Indicative
degüello	Indicative
anunciarán	Indicative
destacabas	Indicative
incorporasen	Subjunctive
expandieron	Indicative
macharse	None
desmesurada	None
disgregaron	Indicative
encendido	None
vandalicéis	Subjunctive
borro	Indicative
destilan	Indicative
estallaremos	Indicative
soborno	Indicative
filosofo	Indicative
racionalizando	None
acalorares	Subjunctive
desprendieses	Subjunctive
empeñas	Indicative
asturianizásemos	Subjunctive
corones	Subjunctive
abriremos	Indicative
ocultando	None
descanso	Indicative
empeñaban	Indicative
unificar	None
homenajearon	Indicative
actúes	Subjunctive
discriminada	None
poseerían	Conditional
traducidos	None
entonada	None
seréis	Indicative
poseen	Indicative
desvían	Indicative
sorteando	None
chaqueteadas	None
predico	Indicative
utilizarían	Conditional
residenció	Indicative
implorado	None
concentraban	Indicative
evalúo	Indicative
codificados	None
conceden	Indicative
terminaré	Indicative
desbordan	Indicative
encontraban	Indicative
neutralizarais	Subjunctive
licuaré	Indicative
especifiqué	Indicative
desmintiendo	None
materializarían	Conditional
dudé	Indicative
suplida	None
formulados	None
evidenciaban	Indicative
ligado	None
retocó	Indicative
robarán	Indicative
restas	Indicative
enconaren	Subjunctive
combatieran	Subjunctive
atraerá	Indicative
maravillan	Indicative
supervisados	None
marcasen	Subjunctive
euskaldunizadas	None
sacrificada	None
expelido	None
nazcas	Subjunctive
descentralizaren	Subjunctive
decodificada	None
chateando	None
emulaban	Indicative
recargan	Indicative
nominada	None
significo	Indicative
denominado	None
aleccionado	None
tacharé	Indicative
intuirá	Indicative
valorados	None
consistirán	Indicative
reprochó	Indicative
amenguaste	Indicative
inflarán	Indicative
gangrenada	None
contienden	Indicative
indignad	Imperative-Jussive
impartirá	Indicative
calcularon	Indicative
pasaste	Indicative
relajado	None
sentaran	Subjunctive
indicases	Subjunctive
fotocopiado	None
temí	Indicative
descalificaron	Indicative
reingresadas	None
ensartaron	Indicative
allegarán	Indicative
dejaríamos	Conditional
invité	Indicative
atribuirían	Conditional
aceites	Subjunctive
derivo	Indicative
revelas	Indicative
encabezó	Indicative
levántate	Imperative-Jussive
reutilizaron	Indicative
acatadas	None
debiendo	None
entraban	Indicative
hospedados	None
purgados	None
caté	Indicative
nació	Indicative
usaremos	Indicative
frotados	None
inyectadas	None
escavadas	None
acicalándose	None
grabaran	Subjunctive
enfureció	Indicative
persiguieran	Subjunctive
llevarían	Conditional
fusionó	Indicative
prestaran	Subjunctive
apiñaseis	Subjunctive
traficar	None
prepagada	None
pides	Indicative
flambeada	None
adicionadas	None
guardados	None
rebobinado	None
propagaran	Subjunctive
atarearemos	Indicative
informar	None
repitió	Indicative
muestrearán	Indicative
escocieren	Subjunctive
patalear	None
diplomó	Indicative
empezaban	Indicative
cocidas	None
dilucidó	Indicative
proporcionasen	Subjunctive
alegro	Indicative
lloraron	Indicative
chillo	Indicative
abocada	None
decoro	Indicative
pilló	Indicative
interpretarían	Conditional
notada	None
desterraron	Indicative
escaldará	Indicative
apostillando	None
recaudaron	Indicative
empaló	Indicative
escenificadas	None
aplicaren	Subjunctive
asentarán	Indicative
neutralizó	Indicative
servirán	Indicative
embrutecierais	Subjunctive
trepareis	Subjunctive
pelearon	Indicative
robo	Indicative
digitadas	None
escindió	Indicative
embaucados	None
ultracentrifugar	None
enfundadas	None
procurabas	Indicative
mecanizando	None
replegaran	Subjunctive
cocían	Indicative
adelantadas	None
rehilaron	Indicative
decantó	Indicative
dicto	Indicative
instauradas	None
tenso	Indicative
improvisó	Indicative
enjaulada	None
convoco	Indicative
creced	Imperative-Jussive
reconvengas	Subjunctive
innovaron	Indicative
comidas	Subjunctive
calafateo	Indicative
enamoro	Indicative
implicará	Indicative
encargaré	Indicative
asignó	Indicative
campada	None
enripiada	None
exiges	Indicative
lograrían	Conditional
balarás	Indicative
opiné	Indicative
apetecida	None
revelasteis	Indicative
dividió	Indicative
juzgan	Indicative
segregaron	Indicative
huidas	None
echasen	Subjunctive
alarman	Indicative
veneraríais	Conditional
trabajo	Indicative
renacemos	Indicative
agilizando	None
complaciésemos	Subjunctive
patrullo	Indicative
convertiré	Indicative
blasfemasen	Subjunctive
validan	Indicative
ionizadas	None
reuniremos	Indicative
inducen	Indicative
refinó	Indicative
engarzados	None
sacuden	Indicative
trascurriste	Indicative
reforestadas	None
anduvieron	Indicative
enseñado	None
perecerían	Conditional
utilices	Subjunctive
momificados	None
sereno	Indicative
fisgoneando	None
juzgaran	Subjunctive
concretaban	Indicative
apretaron	Indicative
obrado	None
aglomerábamos	Indicative
antedijesen	Subjunctive
congregó	Indicative
pasé	Indicative
dolámonos	Imperative-Jussive
henchidos	None
desmoralizaron	Indicative
fortalecer	None
entrarán	Indicative
has	Indicative
especifican	Indicative
dramatizarían	Conditional
televisaron	Indicative
reconocerás	Indicative
eclipsados	None
aprovecharán	Indicative
olvido	Indicative
apongo	Indicative
sortearán	Indicative
solicitan	Indicative
desdeñaren	Subjunctive
atreverían	Conditional
pasábamos	Indicative
instigó	Indicative
poseyó	Indicative
encastillarás	Indicative
garbaron	Indicative
admirados	None
cascaron	Indicative
ascendiendo	None
reformas	Indicative
hablaste	Indicative
comprometido	None
tumbas	Indicative
enramaras	Subjunctive
barrando	None
juramento	Indicative
comprimió	Indicative
sometían	Indicative
encarnizada	None
silenció	Indicative
castro	Indicative
preceded	Imperative-Jussive
meneadas	None
guerrearon	Indicative
vejarás	Indicative
descongelar	None
desfalcad	Imperative-Jussive
ecualizo	Indicative
arramplado	None
besuqueado	None
clareo	Indicative
fingieron	Indicative
invadirán	Indicative
revertí	Indicative
conmemorará	Indicative
remó	Indicative
compruebo	Indicative
acusan	Indicative
transportará	Indicative
causó	Indicative
plastificábamos	Indicative
escobadas	None
desenroscares	Subjunctive
nevé	Indicative
suscribieran	Subjunctive
trazará	Indicative
inactivo	Indicative
rehúyen	Indicative
accidentados	None
remontaron	Indicative
mazo	Indicative
insertará	Indicative
faltas	Indicative
reprimidas	None
perpetuareis	Subjunctive
encargó	Indicative
persignada	None
crepitaren	Subjunctive
fondeo	Indicative
implantaron	Indicative
presumen	Indicative
entrelazó	Indicative
revivirá	Indicative
robarás	Indicative
zapateados	None
enrollar	None
atropellan	Indicative
agotan	Indicative
pedorreada	None
depravada	None
contratares	Subjunctive
zurradas	None
venenciando	None
rebuscada	None
lucen	Indicative
estuviésemos	Subjunctive
sucedieran	Subjunctive
narrados	None
acepté	Indicative
traducimos	Indicative
asesinar	None
origino	Indicative
durabas	Indicative
acoplaban	Indicative
guarnecéis	Indicative
liberando	None
photoshopeado	None
recrudecierais	Subjunctive
enfatizando	None
envolvían	Indicative
abrían	Indicative
aliaran	Subjunctive
sostendrán	Indicative
experimentaran	Subjunctive
vapuleada	None
echarán	Indicative
aclares	Subjunctive
engalanaban	Indicative
maravillando	None
depilado	None
empastes	Subjunctive
abismándose	None
desbarajustasteis	Indicative
orlando	None
conservo	Indicative
coagulo	Indicative
remodelan	Indicative
moduladas	None
desearan	Subjunctive
coronó	Indicative
autentificar	None
cruzarían	Conditional
introduzco	Indicative
fugó	Indicative
machacan	Indicative
consisten	Indicative
jurando	None
tardó	Indicative
segó	Indicative
revisará	Indicative
consideré	Indicative
abeldáremos	Subjunctive
cubrid	Imperative-Jussive
infravalorar	None
alimentarían	Conditional
intrigó	Indicative
tomasen	Subjunctive
fungirá	Indicative
balbucieses	Subjunctive
empastadas	None
preocupan	Indicative
seducirá	Indicative
dominará	Indicative
descafeinarais	Subjunctive
desfavorecerá	Indicative
dorad	Imperative-Jussive
batió	Indicative
contribuían	Indicative
atribuyó	Indicative
afrentaren	Subjunctive
centraron	Indicative
hables	Subjunctive
impuso	Indicative
apercibidas	None
supuesta	None
alejándose	None
incentivó	Indicative
gatillada	None
ligaban	Indicative
acábese	Imperative-Jussive
pretendías	Indicative
suspendieron	Indicative
intermediada	None
adelantaban	Indicative
perturban	Indicative
refreída	None
prendieran	Subjunctive
erigirá	Indicative
asentaran	Subjunctive
detuvo	Indicative
encapsulado	None
murmuró	Indicative
insinúan	Indicative
trasfirió	Indicative
aprovechadas	None
monitorizar	None
infatuadas	None
lubrico	Indicative
reúnen	Indicative
cosechó	Indicative
reclamarían	Conditional
acostumbro	Indicative
guías	Indicative
dominarían	Conditional
esculpida	None
emocionó	Indicative
jaspeado	None
pensaré	Indicative
dilapidáis	Indicative
destrabaréis	Indicative
borrarían	Conditional
horneases	Subjunctive
remedió	Indicative
promulgadas	None
reporté	Indicative
pastoreaban	Indicative
hueveados	None
angostada	None
estimularon	Indicative
repatriado	None
premiasen	Subjunctive
comandaremos	Indicative
sello	Indicative
desacertada	None
lamido	None
ciegas	Indicative
prefiguré	Indicative
reelaboró	Indicative
asentando	None
rapeado	None
alternas	Indicative
infringido	None
manejaran	Subjunctive
menstruar	None
parió	Indicative
cementando	None
aneblasteis	Indicative
informé	Indicative
despintada	None
aplicasen	Subjunctive
entenebrecido	None
sintonizaban	Indicative
hojearíais	Conditional
tomará	Indicative
tendré	Indicative
cesaron	Indicative
reescriben	Indicative
afectasen	Subjunctive
barajaron	Indicative
descorchados	None
besad	Imperative-Jussive
actualizará	Indicative
rechazas	Indicative
destrozaron	Indicative
temes	Indicative
suicidar	None
mandarán	Indicative
destreparon	Indicative
desobstruidas	None
aeradas	None
acuchillados	None
agrisado	None
acampo	Indicative
gasificaran	Subjunctive
conocías	Indicative
moralizada	None
constaron	Indicative
devinieron	Indicative
ataques	Subjunctive
desacostumbradas	None
informo	Indicative
descuidados	None
tematizaseis	Subjunctive
ahondaron	Indicative
estresado	None
reincorporó	Indicative
rugidas	None
ensanches	Subjunctive
congratulada	None
guardasen	Subjunctive
dialogada	None
adelantó	Indicative
malogrado	None
provocaban	Indicative
mentido	None
notificó	Indicative
obviarás	Indicative
llenándose	None
acartonarán	Indicative
garantir	None
encareció	Indicative
comisionó	Indicative
distraeréis	Indicative
perdimos	Indicative
demoran	Indicative
rusificaréis	Indicative
sale	Indicative
remediados	None
arbitró	Indicative
conmovieron	Indicative
relaciones	Subjunctive
retrucar	None
modelada	None
invierno	Indicative
corroboro	Indicative
estrechar	None
enfiló	Indicative
moví	Indicative
becas	Indicative
anexan	Indicative
prometió	Indicative
jorobaríamos	Conditional
preconoced	Imperative-Jussive
anadear	None
despojó	Indicative
aterir	None
ocasionaban	Indicative
engatusaseis	Subjunctive
mando	Indicative
gustaban	Indicative
arrendó	Indicative
agruparán	Indicative
cubierta	None
instrumentó	Indicative
interrelaciones	Subjunctive
contraindicábamos	Indicative
congelados	None
bachearán	Indicative
implosionéis	Subjunctive
permanecerían	Conditional
esquilmar	None
tranzaras	Subjunctive
saliendo	None
encogidas	None
iniciaré	Indicative
protegió	Indicative
decepcionado	None
pirateado	None
rogando	None
aleo	Indicative
electrificaren	Subjunctive
tienden	Indicative
desinteresas	Indicative
agilizar	None
extrajo	Indicative
promulgó	Indicative
retumban	Indicative
costearon	Indicative
continúan	Indicative
encerrasteis	Indicative
recurrirían	Conditional
seducen	Indicative
infusionaréis	Indicative
importan	Indicative
arraigan	Indicative
comisarió	Indicative
compradas	None
acrecentar	None
perreáramos	Subjunctive
domo	Indicative
antediré	Indicative
rebelarían	Conditional
abarréis	Subjunctive
tuviéramos	Subjunctive
aventuraron	Indicative
usándose	None
estabilizaban	Indicative
marginalizáremos	Subjunctive
besó	Indicative
tocan	Indicative
nadan	Indicative
encalabozando	None
descifran	Indicative
primada	None
alabo	Indicative
aventurada	None
atorgaseis	Subjunctive
acertaron	Indicative
conseguiste	Indicative
firmasen	Subjunctive
independizan	Indicative
empleó	Indicative
viraron	Indicative
hostigó	Indicative
radiaron	Indicative
contrabandeando	None
revocaseis	Subjunctive
conectará	Indicative
explico	Indicative
regaño	Indicative
investigadas	None
conculcada	None
traspasaran	Subjunctive
diezmar	None
satinada	None
enjambrado	None
presumían	Indicative
recrearon	Indicative
cerraban	Indicative
enmiendas	Indicative
cortejó	Indicative
delatan	Indicative
escandalizado	None
coexistían	Indicative
échate	Imperative-Jussive
asumían	Indicative
desistida	None
escaparan	Subjunctive
alisando	None
computarizadas	None
perdonaron	Indicative
traspirando	None
desembarazar	None
almendras	Indicative
pulverizan	Indicative
incoado	None
ratifican	Indicative
designaran	Subjunctive
alistan	Indicative
sombraríamos	Conditional
embarcar	None
enlazando	None
desenterraron	Indicative
insidiados	None
subsanada	None
derrochada	None
llenaran	Subjunctive
justificaran	Subjunctive
esmerado	None
desatino	Indicative
forzados	None
aprovechaban	Indicative
aplico	Indicative
renderizaran	Subjunctive
concluían	Indicative
trasladé	Indicative
escondió	Indicative
echaré	Indicative
permitiendo	None
cuidad	Imperative-Jussive
inundo	Indicative
conservasen	Subjunctive
retiran	Indicative
enfermé	Indicative
optaban	Indicative
fracturan	Indicative
fermentar	None
irrespetaban	Indicative
beneficiaban	Indicative
producían	Indicative
tergiversadas	None
abates	Indicative
abordó	Indicative
deprecados	None
rodarían	Conditional
pretenden	Indicative
entregaban	Indicative
lamidas	None
mortificares	Subjunctive
desconvocarais	Subjunctive
gimen	Indicative
secundaban	Indicative
adentraban	Indicative
practicáis	Indicative
disimulan	Indicative
preguntas	Indicative
revalorizada	None
contribuido	None
silencio	Indicative
creces	Indicative
ordenas	Indicative
rezongada	None
referenciarían	Conditional
orinan	Indicative
devine	Indicative
extraditaseis	Subjunctive
adecuaban	Indicative
esperábamos	Indicative
viabilizando	None
fracasó	Indicative
sintetizaban	Indicative
acanalaré	Indicative
flaquear	None
guisado	None
dirías	Conditional
titulada	None
atornillada	None
empataron	Indicative
tienes	Indicative
subastan	Indicative
refutó	Indicative
medicasteis	Indicative
jineteásemos	Subjunctive
ofendieron	Indicative
descalzas	Indicative
cuadruplicaron	Indicative
gorjeados	None
combinaran	Subjunctive
regeneradas	None
amaño	Indicative
reestructurar	None
adivinado	None
desaliñados	None
encumbráremos	Subjunctive
invoco	Indicative
zarparon	Indicative
desacertado	None
modifiques	Subjunctive
prestigio	Indicative
acreditan	Indicative
picó	Indicative
votaron	Indicative
desparraman	Indicative
coincidiesen	Subjunctive
predicar	None
cachondeado	None
tumbes	Subjunctive
dormirá	Indicative
extraerán	Indicative
agrediendo	None
ofendían	Indicative
carcomidos	None
entendían	Indicative
juras	Indicative
conllevando	None
cortó	Indicative
salir	None
desviaron	Indicative
bachear	None
empañó	Indicative
prefiguraban	Indicative
recalaban	Indicative
solucionan	Indicative
entropezando	None
adineradas	None
tipifican	Indicative
extraído	None
desentierran	Indicative
difamadas	None
acudió	Indicative
tapiaban	Indicative
invalidada	None
conoceríamos	Conditional
exculpados	None
inicies	Subjunctive
radicalizó	Indicative
masada	None
debilitó	Indicative
extenderían	Conditional
respondían	Indicative
prologará	Indicative
tapiando	None
produciremos	Indicative
desvirtuaste	Indicative
sondean	Indicative
encontrarías	Conditional
africanizados	None
arropes	Subjunctive
prohibidos	None
excluir	None
incrementados	None
degollaban	Indicative
renegociar	None
etiquetaban	Indicative
comunican	Indicative
patrullan	Indicative
robará	Indicative
taxiado	None
recriminando	None
embotar	None
citaste	Indicative
encastrada	None
fincar	None
incurridas	None
trasladaran	Subjunctive
estamos	Indicative
exijo	Indicative
tendrían	Conditional
proyectar	None
acordaban	Indicative
tendieran	Subjunctive
gafes	Subjunctive
dentelleando	None
infligen	Indicative
poses	Subjunctive
publicitado	None
ablandarse	None
decoraron	Indicative
arrastrarían	Conditional
encabezarían	Conditional
predisponiendo	None
apuñalada	None
insinuaban	Indicative
exiliado	None
fecundo	Indicative
inventó	Indicative
apretadas	None
alistando	None
secretan	Indicative
aludo	Indicative
frecuentaron	Indicative
procedió	Indicative
apuntan	Indicative
bajé	Indicative
autocremándose	None
enumeró	Indicative
confunden	Indicative
cacé	Indicative
silabas	Indicative
automatizando	None
otorgan	Indicative
resurgieren	Subjunctive
saltaban	Indicative
destacaren	Subjunctive
explicases	Subjunctive
optimizar	None
convences	Indicative
desprendió	Indicative
perpetuó	Indicative
alternan	Indicative
consto	Indicative
favorecido	None
refieren	Indicative
apoyando	None
inculpado	None
prosiguen	Indicative
encaramada	None
encabestraren	Subjunctive
clonó	Indicative
testificó	Indicative
resentidas	None
patentaron	Indicative
desocupados	None
saciará	Indicative
desbancó	Indicative
troleando	None
experimentan	Indicative
escaneando	None
hendido	None
preservó	Indicative
asaban	Indicative
jerarquizan	Indicative
promociono	Indicative
nacían	Indicative
cometí	Indicative
vitrificado	None
topetando	None
hiladas	None
rocío	Indicative
podas	Indicative
hundían	Indicative
gustará	Indicative
detenemos	Indicative
sedes	Subjunctive
estabilizados	None
condicionará	Indicative
tensionada	None
figurados	None
cogido	None
pico	Indicative
fracasaban	Indicative
aperturaras	Subjunctive
evaden	Indicative
chantajeadas	None
harían	Conditional
moriremos	Indicative
sublimaríamos	Conditional
pululásemos	Subjunctive
sobres	Subjunctive
disputada	None
frecuentando	None
monopolizáremos	Subjunctive
dependían	Indicative
sulfuradas	None
esperes	Subjunctive
excedieran	Subjunctive
convergerían	Conditional
decomisaron	Indicative
acuarteles	Subjunctive
describen	Indicative
desunida	None
denigrar	None
vibrando	None
filmará	Indicative
meto	Indicative
inhibiesen	Subjunctive
sobraron	Indicative
atravesando	None
anotarán	Indicative
mantendrán	Indicative
juraban	Indicative
cebaron	Indicative
consiguen	Indicative
anheléis	Subjunctive
desconvocáremos	Subjunctive
discurriendo	None
designado	None
denostó	Indicative
comercializaban	Indicative
obtendrían	Conditional
viviré	Indicative
desplegó	Indicative
estuviste	Indicative
hinchándose	None
atravesadas	None
atrancareis	Subjunctive
desencajo	Indicative
felicitaron	Indicative
recubiertos	None
volcaron	Indicative
figurarían	Conditional
aglomeradas	None
justifican	Indicative
lograda	None
perderíamos	Conditional
inscribieran	Subjunctive
entrarás	Indicative
garantizaban	Indicative
forcejeo	Indicative
compartiesen	Subjunctive
plisáremos	Subjunctive
agencias	Indicative
infártese	Imperative-Jussive
reconquistáremos	Subjunctive
añadirás	Indicative
abundaban	Indicative
transportaran	Subjunctive
unas	Subjunctive
perduró	Indicative
escarnecido	None
boxearíamos	Conditional
patalearás	Indicative
exonerando	None
operasen	Subjunctive
menguaste	Indicative
imputó	Indicative
orillarías	Conditional
auxiliadas	None
chivo	Indicative
felicitó	Indicative
halagó	Indicative
autenticada	None
convocarán	Indicative
relacionarán	Indicative
giraran	Subjunctive
cairelaste	Indicative
sistematizan	Indicative
diezmaran	Subjunctive
consagraron	Indicative
gestiones	Subjunctive
llenar	None
conmocionaremos	Indicative
sugirió	Indicative
empacadas	None
heredaban	Indicative
dispersó	Indicative
aclaró	Indicative
despegaron	Indicative
pacifico	Indicative
mermo	Indicative
atrevían	Indicative
responded	Imperative-Jussive
entintada	None
desguazar	None
estrechando	None
acaparaban	Indicative
plasmando	None
opondrán	Indicative
endeudados	None
ejecutada	None
agujereado	None
sobrábamos	Indicative
blasonan	Indicative
resaltada	None
desjudicializado	None
condenar	None
blandían	Indicative
excusó	Indicative
tiño	Indicative
mantuvimos	Indicative
auxiliarán	Indicative
sosegado	None
postrados	None
incurrían	Indicative
reabsorbiéramos	Subjunctive
sumasen	Subjunctive
natos	None
monitoreando	None
fildeasen	Subjunctive
ensortijáramos	Subjunctive
suspendían	Indicative
descompusieses	Subjunctive
dentelleada	None
faltar	None
reajustados	None
desbaratados	None
encarnando	None
ejercerán	Indicative
aproximaban	Indicative
sintiendo	None
inscriben	Indicative
enojo	Indicative
roció	Indicative
suplicaron	Indicative
florecerán	Indicative
exhibieron	Indicative
apellidar	None
amparan	Indicative
evolucionaban	Indicative
entalladas	None
despliegan	Indicative
desdiciendo	None
incinerada	None
brindares	Subjunctive
restringió	Indicative
visualizaban	Indicative
albergadas	None
ahitaré	Indicative
riesen	Subjunctive
lucho	Indicative
frecuentada	None
vigilada	None
cocinadas	None
sellará	Indicative
seguían	Indicative
intimó	Indicative
sortearon	Indicative
taconearán	Indicative
revisé	Indicative
recopilada	None
vuelco	Indicative
orbitó	Indicative
complementó	Indicative
contratada	None
desacatáremos	Subjunctive
fracturaron	Indicative
atesorados	None
discrepó	Indicative
narró	Indicative
lloviznas	Indicative
desactivaron	Indicative
segundo	Indicative
carburizaríais	Conditional
eluden	Indicative
humanizado	None
vuelvas	Subjunctive
atascan	Indicative
reglas	Indicative
entrevistaron	Indicative
vedábamos	Indicative
prevalecen	Indicative
demoró	Indicative
segundas	Indicative
equivoques	Subjunctive
atascada	None
inviernas	Indicative
continuado	None
escucharían	Conditional
reencontraron	Indicative
domiciliados	None
ocasionadas	None
refundieron	Indicative
cartografió	Indicative
cito	Indicative
cuadrada	None
substituyo	Indicative
anegó	Indicative
desconectado	None
entrecortadas	None
cilindro	Indicative
amohinares	Subjunctive
hacías	Indicative
pernoctaban	Indicative
embelleció	Indicative
decayeseis	Subjunctive
oían	Indicative
omitió	Indicative
alzo	Indicative
chicho	Indicative
riñendo	None
recoges	Indicative
entremezclaban	Indicative
citaron	Indicative
necesitaríamos	Conditional
andados	None
simbolizada	None
advertían	Indicative
balé	Indicative
votarían	Conditional
domados	None
trasmitir	None
rellenó	Indicative
mantendríamos	Conditional
avivan	Indicative
troceadas	None
internan	Indicative
personificases	Subjunctive
devaluadas	None
impartir	None
resaltadas	None
escapo	Indicative
manejados	None
acreditaban	Indicative
apesadumbrasen	Subjunctive
propago	Indicative
cometido	None
curvas	Indicative
adjetivado	None
fortificaban	Indicative
vandalizan	Indicative
mascaras	Subjunctive
borraban	Indicative
completaran	Subjunctive
olvidaras	Subjunctive
insinuáramos	Subjunctive
procuran	Indicative
espacies	Subjunctive
topetarías	Conditional
hablaremos	Indicative
contadas	None
heñida	None
subestimando	None
prepararían	Conditional
convencerán	Indicative
escleroso	Indicative
recaudo	Indicative
retornábamos	Indicative
injiriéndose	None
moraréis	Indicative
escucharemos	Indicative
cubren	Indicative
nivelan	Indicative
secuestran	Indicative
agradecieron	Indicative
hallaremos	Indicative
retraían	Indicative
consideraste	Indicative
compungid	Imperative-Jussive
planificaban	Indicative
inmovilizando	None
transcurren	Indicative
descuidaron	Indicative
editaran	Subjunctive
saldan	Indicative
bombardean	Indicative
vacías	Indicative
prescribir	None
loncheada	None
corriges	Indicative
presidido	None
execrados	None
extrudís	Indicative
pereceabais	Indicative
irradiando	None
calmas	Indicative
sosiego	Indicative
braceará	Indicative
propinaban	Indicative
tuve	Indicative
recordó	Indicative
derrumbaban	Indicative
fraccionado	None
incurrieron	Indicative
almacenarían	Conditional
desprotegidos	None
volviesen	Subjunctive
cenaron	Indicative
acobardaríamos	Conditional
rebelar	None
perseguían	Indicative
descodificares	Subjunctive
energizaré	Indicative
cabrahigó	Indicative
fabrican	Indicative
practicará	Indicative
deslegitimar	None
apuñalan	Indicative
destapan	Indicative
marcidos	None
embebiendo	None
soportado	None
memorizó	Indicative
formó	Indicative
aforrad	Imperative-Jussive
acogió	Indicative
refulges	Indicative
destinadas	None
instruyen	Indicative
desenfundados	None
desesperan	Indicative
intoxicado	None
desearán	Indicative
usufructuando	None
lites	Subjunctive
frías	Subjunctive
tendió	Indicative
mencioné	Indicative
situarían	Conditional
negaran	Subjunctive
bulleron	Indicative
galopó	Indicative
cautivaseis	Subjunctive
henchido	None
golpeaban	Indicative
asfixiaron	Indicative
depositando	None
esfumarse	None
puntualizó	Indicative
parlamento	Indicative
anché	Indicative
interrelacionan	Indicative
untó	Indicative
requisó	Indicative
ofrecí	Indicative
encestar	None
abovedaban	Indicative
torpedeo	Indicative
rumoreado	None
resultaren	Subjunctive
humectada	None
gimoteaste	Indicative
alarmaron	Indicative
quebraban	Indicative
postradas	None
aglutinó	Indicative
acerrojes	Subjunctive
esperado	None
pestañeaste	Indicative
supervenidos	None
pendido	None
doblegar	None
contemporizáramos	Subjunctive
rehabilitas	Indicative
descosierais	Subjunctive
discutiré	Indicative
despenalizan	Indicative
abrieran	Subjunctive
convergerán	Indicative
puteares	Subjunctive
pegues	Subjunctive
adaptarían	Conditional
utilizaré	Indicative
exigidas	None
socavada	None
desfogada	None
escenificado	None
forró	Indicative
holgazaneando	None
reconquistan	Indicative
fundieran	Subjunctive
realzó	Indicative
dirimieron	Indicative
reincorporan	Indicative
avisaban	Indicative
contratado	None
alcanforado	None
compres	Subjunctive
autobombeadas	None
oído	None
dominaréis	Indicative
nacionalizando	None
rapados	None
aceleran	Indicative
divines	Subjunctive
ausentar	None
dijeran	Subjunctive
transvaséis	Subjunctive
dudaran	Subjunctive
restablecidos	None
reciclaron	Indicative
amaran	Indicative
licenciaron	Indicative
claman	Indicative
desconfiaré	Indicative
versionan	Indicative
subsidias	Indicative
fundada	None
rearmó	Indicative
glosada	None
ducho	Indicative
labradas	None
sobrerreaccionados	None
redundó	Indicative
coordinan	Indicative
protagonizó	Indicative
balada	None
intimo	Indicative
emplazadas	None
bordan	Indicative
cían	Indicative
desprestigiado	None
despampanaremos	Indicative
migrado	None
conmutando	None
trencéis	Subjunctive
analicé	Indicative
desarrollado	None
desconcentraríamos	Conditional
desguarnecida	None
agitó	Indicative
autodenominarse	None
niego	Indicative
mereció	Indicative
represas	Indicative
rieran	Subjunctive
extrapoladas	None
recalcaron	Indicative
aboyaré	Indicative
eclosionó	Indicative
midieran	Subjunctive
botó	Indicative
debuto	Indicative
alentando	None
figuras	Indicative
inculcados	None
otorgará	Indicative
apresaran	Subjunctive
uncidos	None
vislumbrando	None
muertos	None
dificultarán	Indicative
constituyen	Indicative
centrados	None
confeccionar	None
animado	None
dominé	Indicative
calefaccionados	None
censuró	Indicative
zarandean	Indicative
entablaseis	Subjunctive
expoliar	None
migrar	None
robó	Indicative
desahuciadas	None
embargada	None
retrocedían	Indicative
envainadas	None
cohabitaron	Indicative
brillará	Indicative
enfurecido	None
trastornados	None
embrago	Indicative
evitarás	Indicative
bromeas	Indicative
explicitarás	Indicative
palmotear	None
radican	Indicative
barbadas	None
almacenes	Subjunctive
rojeéis	Subjunctive
evaluada	None
ingresarán	Indicative
dividido	None
nubló	Indicative
empobreció	Indicative
relajados	None
odiaron	Indicative
quemé	Indicative
acércate	Imperative-Jussive
pesará	Indicative
rizarán	Indicative
drogó	Indicative
criticó	Indicative
ordenó	Indicative
cuerpeará	Indicative
liberaran	Subjunctive
reunirán	Indicative
decelerar	None
segarais	Subjunctive
plagas	Indicative
residirían	Conditional
dilucidado	None
haciendo	Indicative
enfocados	None
entrañados	None
respiro	Indicative
dices	Indicative
comparados	None
calefacciones	Subjunctive
desparecen	Indicative
raspando	None
concentrarían	Conditional
tiene	Indicative
pasará	Indicative
chocaban	Indicative
tiritabais	Indicative
somatizaran	Subjunctive
enramado	None
enrojecidas	None
compartirá	Indicative
inspirada	None
escudan	Indicative
presenciaron	Indicative
alían	Indicative
castellanizar	None
aterrorizaron	Indicative
transportes	Subjunctive
enlisto	Indicative
empañasteis	Indicative
rechacé	Indicative
hormigones	Subjunctive
borroneando	None
bachearás	Indicative
murmurada	None
nacimos	Indicative
falló	Indicative
ingirieron	Indicative
educados	None
uniformáramos	Subjunctive
adoraron	Indicative
terminaríamos	Conditional
avergonzados	None
licenció	Indicative
publiqué	Indicative
abogaron	Indicative
escrutado	None
complicadas	None
federó	Indicative
auditados	None
posó	Indicative
aquejan	Indicative
portas	Indicative
amarilleando	None
bautizará	Indicative
ilustrando	None
administro	Indicative
es	Indicative
desacostumbrada	None
perderemos	Indicative
recombinarais	Subjunctive
moldeo	Indicative
conectaron	Indicative
protesto	Indicative
sublimada	None
microscopiado	None
exhibir	None
regeneraron	Indicative
comenzará	Indicative
gozaban	Indicative
moralizados	None
aplazo	Indicative
cachondeo	Indicative
habitad	Imperative-Jussive
inundarían	Conditional
vueltos	None
repensabas	Indicative
quemaron	Indicative
reestructurado	None
zarandeo	Indicative
segundad	Imperative-Jussive
lloraran	Subjunctive
acomodaban	Indicative
sofocando	None
abucheó	Indicative
llamaré	Indicative
observado	None
construiremos	Indicative
gestionada	None
gimoteabas	Indicative
anexiones	Subjunctive
dinamitó	Indicative
prepago	Indicative
adivinaron	Indicative
sobreentendida	None
solidarizado	None
pactan	Indicative
avalado	None
sumir	None
adolecieses	Subjunctive
pallo	Indicative
mallan	Indicative
realojar	None
resollada	None
niveles	Subjunctive
destruir	None
selladas	None
gerenciar	None
disparar	None
ultrajas	Indicative
ahorraríamos	Conditional
escarban	Indicative
peques	Subjunctive
domestico	Indicative
quitaste	Indicative
lonchearais	Subjunctive
englobadas	None
posicionaran	Subjunctive
insuflando	None
regales	Subjunctive
desbrozados	None
echaban	Indicative
huroneaste	Indicative
visionando	None
agregada	None
costean	Indicative
incrementadas	None
responsabilizo	Indicative
tiznadas	None
perdonas	Indicative
debías	Indicative
pilotares	Subjunctive
agonizando	None
molestaré	Indicative
cesaran	Subjunctive
marcan	Indicative
hormigonarás	Indicative
sobrevalorada	None
abrochábamos	Indicative
volveré	Indicative
adversas	Indicative
golpeó	Indicative
avances	Subjunctive
gruñidos	None
extirpados	None
nacías	Indicative
discutirían	Conditional
están	Indicative
fortificó	Indicative
defenestrado	None
relativizasen	Subjunctive
acarreaban	Indicative
recombinadas	None
señalado	None
adherían	Indicative
bordeaban	Indicative
comerás	Indicative
incluirían	Conditional
derrumbará	Indicative
bancado	None
obtienen	Indicative
muero	Indicative
conseguiré	Indicative
preguntasen	Subjunctive
azucararías	Conditional
adaptará	Indicative
reprochaseis	Subjunctive
recaen	Indicative
suplicó	Indicative
asaeteaban	Indicative
computares	Subjunctive
terraplenado	None
alejo	Indicative
disparó	Indicative
cimentando	None
suspendidos	None
arrastrados	None
parapetareis	Subjunctive
zafados	None
encarecidas	None
caerá	Indicative
interpelasen	Subjunctive
auxiliaron	Indicative
perpetuaron	Indicative
rallas	Indicative
edificaron	Indicative
parchados	None
autoproclamaban	Indicative
indispusieran	Subjunctive
sirves	Indicative
reaccionó	Indicative
entremezclado	None
preservaban	Indicative
prefiriesen	Subjunctive
rezagados	None
compaginó	Indicative
afrontas	Indicative
debilitando	None
abatido	None
fermentadas	None
costeada	None
tachadas	None
contextualizado	None
redoblaron	Indicative
resarció	Indicative
entusiasmados	None
asociada	None
escurrió	Indicative
reclutaron	Indicative
enrolada	None
reunirá	Indicative
causan	Indicative
vadeó	Indicative
solicité	Indicative
fortificando	None
decantaron	Indicative
reemprendieron	Indicative
atraques	Subjunctive
seducidos	None
formaseis	Subjunctive
empatizábamos	Indicative
abochornar	None
redescubren	Indicative
cegados	None
resplandecen	Indicative
reformulé	Indicative
condecoró	Indicative
rechazasen	Subjunctive
precederíamos	Conditional
guacareabas	Indicative
embolsó	Indicative
reescribí	Indicative
creían	Indicative
duplicará	Indicative
salió	Indicative
usurpó	Indicative
aploméis	Subjunctive
pisas	Indicative
plantearían	Conditional
ensartó	Indicative
fluctuaban	Indicative
institucionalizados	None
revisadas	None
entalles	Subjunctive
amedrentó	Indicative
cribados	None
autografías	Indicative
derrelinquieses	Subjunctive
desinstalar	None
haremos	Indicative
trovará	Indicative
proveerá	Indicative
reportearon	Indicative
adeudada	None
lindes	Subjunctive
homenajean	Indicative
adelantar	None
drogas	Indicative
recuses	Subjunctive
permearé	Indicative
utilizáramos	Subjunctive
tornan	Indicative
vanagloriémonos	Imperative-Jussive
absorbida	None
requirieron	Indicative
requisando	None
peticionó	Indicative
guisan	Indicative
acuartelada	None
tornaríais	Conditional
rehacen	Indicative
emito	Indicative
almuerzo	Indicative
botado	None
aconsejaran	Subjunctive
renuevo	Indicative
reiteras	Indicative
difundirá	Indicative
guardé	Indicative
resintiéndose	None
repases	Subjunctive
herrando	None
generaron	Indicative
esperanzada	None
fecundan	Indicative
atentasen	Subjunctive
putañeéis	Subjunctive
deambularon	Indicative
reposó	Indicative
componían	Indicative
reprehendiendo	None
comercializaran	Subjunctive
guayada	None
emocionan	Indicative
cayesen	Subjunctive
compras	Indicative
escurren	Indicative
descended	Imperative-Jussive
supusieron	Indicative
quebrantó	Indicative
finados	None
lijas	Indicative
codirigieron	Indicative
concatenadas	None
siseando	None
temeréis	Indicative
enojada	None
atusaban	Indicative
cobijado	None
protegen	Indicative
ordenaban	Indicative
carburo	Indicative
sobrecogido	None
indagó	Indicative
maduraron	Indicative
sintonizan	Indicative
estaban	Indicative
delimitaban	Indicative
partirías	Conditional
carburicé	Indicative
consultaron	Indicative
rendirán	Indicative
asemejando	None
motorizásemos	Subjunctive
evitaron	Indicative
develaron	Indicative
vandalizó	Indicative
clausuran	Indicative
pegada	None
lito	Indicative
empuñó	Indicative
actualizaron	Indicative
mantenida	None
trascendido	None
fulminados	None
comercializo	Indicative
mantienes	Indicative
silueteado	None
votan	Indicative
estimó	Indicative
atero	Indicative
congraciado	None
excuso	Indicative
enviudaron	Indicative
domiciliar	None
charló	Indicative
repartiesen	Subjunctive
delineó	Indicative
jaspeados	None
agrandando	None
reanudaran	Subjunctive
inciden	Indicative
reescritas	None
cruzó	Indicative
brindaran	Subjunctive
avisad	Imperative-Jussive
pónganse	Imperative-Jussive
renegaron	Indicative
entubada	None
sensibilizó	Indicative
alentado	None
he	Indicative
cesando	None
midiendo	None
incinerando	None
saldes	Subjunctive
volví	Indicative
portaron	Indicative
desazonareis	Subjunctive
ensamblan	Indicative
terminas	Indicative
subcontratada	None
molí	Indicative
soportaron	Indicative
abducida	None
influencian	Indicative
subirá	Indicative
hablado	None
huido	None
entrecomillando	None
gatillaréis	Indicative
precederán	Indicative
indices	Subjunctive
masco	Indicative
perjudican	Indicative
tonificado	None
virada	None
destornilles	Subjunctive
recapitalizar	None
adhirieran	Subjunctive
condenará	Indicative
corcovean	Indicative
alimentados	None
aúnan	Indicative
remontaríais	Conditional
compré	Indicative
caricaturizados	None
rezuman	Indicative
remozó	Indicative
detentado	None
quebráis	Indicative
dominareis	Subjunctive
mostró	Indicative
generalizaron	Indicative
prevalecieran	Subjunctive
airear	None
disculpad	Imperative-Jussive
reestableciste	Indicative
intuyo	Indicative
acecharon	Indicative
mermados	None
prendidos	None
denotó	Indicative
alimentarías	Conditional
malinterpretan	Indicative
selfiásemos	Subjunctive
señalizaríamos	Conditional
peligrando	None
descansaron	Indicative
gobernasen	Subjunctive
estampando	None
soslayaremos	Indicative
filtrando	None
rodearían	Conditional
transpusieseis	Subjunctive
desembarcaban	Indicative
enseñadas	None
sobrevivirá	Indicative
entregas	Indicative
maltratadas	None
premiaste	Indicative
ayudando	None
requisas	Indicative
deletrean	Indicative
guiaran	Subjunctive
recaudan	Indicative
surgieran	Subjunctive
entres	Subjunctive
rellenando	None
aconsejando	None
transitaban	Indicative
archivaron	Indicative
participados	None
prensas	Indicative
trascienden	Indicative
rehuyendo	None
intensificaron	Indicative
asumió	Indicative
colectó	Indicative
manufacturan	Indicative
enfrentadas	None
penséis	Subjunctive
contarán	Indicative
simplificada	None
formé	Indicative
supurásemos	Subjunctive
tematizando	None
resguardado	None
ignoréis	Subjunctive
batallado	None
agorases	Subjunctive
combatían	Indicative
franqueada	None
relleno	Indicative
contemplaseis	Subjunctive
chocan	Indicative
vegetan	Indicative
cuantificar	None
descascaráremos	Subjunctive
desato	Indicative
desoyeron	Indicative
disputaron	Indicative
retocado	None
anotar	None
zahiriendo	None
adecuada	None
bebidos	None
aterrorizar	None
proporcionadas	None
proveyó	Indicative
votaré	Indicative
pudieran	Subjunctive
mejorarán	Indicative
decantaban	Indicative
abismados	None
curso	Indicative
duermen	Indicative
trazado	None
requiero	Indicative
resido	Indicative
necesitas	Indicative
evocaron	Indicative
robustecerás	Indicative
inventariaron	Indicative
sancionó	Indicative
accedí	Indicative
aglutinarás	Indicative
labras	Indicative
desapalancar	None
obstaculizó	Indicative
agradecerán	Indicative
reglamentando	None
expuse	Indicative
decoran	Indicative
rindieran	Subjunctive
cemento	Indicative
antepagados	None
cohondidas	None
impregnando	None
galopes	Subjunctive
celebró	Indicative
impulsarán	Indicative
diríjase	Imperative-Jussive
arrollando	None
felicitaban	Indicative
incubar	None
restan	Indicative
falsada	None
evolucionó	Indicative
torturando	None
individualizarían	Conditional
invenidos	None
ganaremos	Indicative
timbres	Subjunctive
relegando	None
enfrentar	None
listada	None
consentían	Indicative
unto	Indicative
sodomicéis	Subjunctive
superponían	Indicative
vanagloriado	None
autorrealizadas	None
escasearemos	Indicative
insinúo	Indicative
equivocar	None
licenciará	Indicative
exterminarán	Indicative
deslocalizaréis	Indicative
categoricé	Indicative
huyesen	Subjunctive
inventariados	None
cortejo	Indicative
recomendaban	Indicative
manad	Imperative-Jussive
angostados	None
enlucidas	None
consumieron	Indicative
sobrellevado	None
caricias	Indicative
comentes	Subjunctive
atentando	None
materializados	None
disfrutaron	Indicative
dictó	Indicative
masáis	Indicative
victimizando	None
enfureciendo	None
resopléis	Subjunctive
amargas	Indicative
estranguló	Indicative
concernidas	None
pican	Indicative
esquilaré	Indicative
contrataban	Indicative
internacionalizados	None
afeados	None
cloradas	None
regularizó	Indicative
centrada	None
revolucionan	Indicative
posibilitaban	Indicative
vertebras	Indicative
bridado	None
zapateado	None
deshinchasteis	Indicative
engañas	Indicative
sobrevendiereis	Subjunctive
preguntarás	Indicative
fabricar	None
perforaron	Indicative
cooptarais	Subjunctive
atesar	None
parodiaron	Indicative
golosearé	Indicative
proveídas	None
reaparecerá	Indicative
afianzando	None
pixeladas	None
demolieron	Indicative
uncid	Imperative-Jussive
rajado	None
produces	Indicative
testimoniaron	Indicative
simuló	Indicative
polinizado	None
novelado	None
enviados	None
pugnando	None
portará	Indicative
organizasen	Subjunctive
motorizarán	Indicative
forjada	None
malentiendas	Subjunctive
atacaban	Indicative
acolchonabas	Indicative
dejaras	Subjunctive
materializadas	None
manas	Indicative
roes	Indicative
educaran	Subjunctive
supuso	Indicative
conformes	Subjunctive
atrasan	Indicative
desposar	None
preñáis	Indicative
cardéis	Subjunctive
contravienen	Indicative
asumiremos	Indicative
pecando	None
derriban	Indicative
obsesionada	None
leerá	Indicative
disfrutarán	Indicative
oralizó	Indicative
expedientes	Subjunctive
constando	None
maravillada	None
apoderaron	Indicative
echadas	None
horizontalizadas	None
pensarían	Conditional
aflojando	None
alarmadas	None
levantó	Indicative
apusieres	Subjunctive
contrariada	None
muestran	Indicative
prohíben	Indicative
originado	None
disgregues	Subjunctive
rescindió	Indicative
nidificado	None
garantías	Indicative
regurgitaban	Indicative
retiró	Indicative
manaban	Indicative
charlarían	Conditional
sueñan	Indicative
grapo	Indicative
traspuso	Indicative
aparecerá	Indicative
reconciliaron	Indicative
prevaleció	Indicative
finiquito	Indicative
enfatizaron	Indicative
sujetaban	Indicative
divisando	None
permanecieran	Subjunctive
acciones	Subjunctive
sostuvieron	Indicative
deshonrado	None
examinaban	Indicative
encontrasen	Subjunctive
introducirían	Conditional
afectaran	Subjunctive
trampeo	Indicative
creídos	None
fio	Indicative
reintegraron	Indicative
internados	None
agrietaron	Indicative
descargó	Indicative
broncearse	None
machacar	None
marzas	Subjunctive
respingaren	Subjunctive
profesado	None
enviarían	Conditional
alebrestaríamos	Conditional
visualizará	Indicative
inhibir	None
presentar	None
seguiste	Indicative
embarcan	Indicative
encaminando	None
enumeran	Indicative
figuró	Indicative
abarbetéis	Subjunctive
pesquisar	None
planificaron	Indicative
hegemonizo	Indicative
apersonadas	None
desvanecen	Indicative
retardado	None
ultracentrifugando	None
generalizados	None
adoptan	Indicative
participó	Indicative
contraprogramando	None
despojo	Indicative
explotará	Indicative
identificaron	Indicative
removieran	Subjunctive
pulsaron	Indicative
acechan	Indicative
repetidos	None
cosíais	Indicative
fiad	Imperative-Jussive
ratificar	None
opusiésemos	Subjunctive
devoraron	Indicative
pallan	Indicative
incentivaríamos	Conditional
escaecí	Indicative
diamantes	Subjunctive
acurrucados	None
admitieron	Indicative
aglutinando	None
despatarrarás	Indicative
garantizará	Indicative
permiten	Indicative
desaparecerá	Indicative
mutilada	None
albergaran	Subjunctive
dejaban	Indicative
acuartelaran	Subjunctive
movió	Indicative
despiertan	Indicative
propinas	Indicative
rodear	None
reemplazados	None
satisfizo	Indicative
asentisteis	Indicative
coaccionados	None
macolléis	Subjunctive
homologó	Indicative
olvides	Subjunctive
cañoneo	Indicative
preservará	Indicative
abonarse	None
esprintados	None
lapido	Indicative
diseñadas	None
monopolizaban	Indicative
jadeo	Indicative
achacó	Indicative
prestan	Indicative
abarracado	None
firmaban	Indicative
menstruando	None
impartían	Indicative
fajo	Indicative
metidas	None
almagraron	Indicative
ordenes	Subjunctive
holgadas	None
ameritado	None
acetificados	None
lacras	Indicative
prosperases	Subjunctive
adheridos	None
supervalorarán	Indicative
escudriñar	None
pelarían	Conditional
informan	Indicative
funes	Subjunctive
amplificaren	Subjunctive
otorgarán	Indicative
marginaran	Subjunctive
calientan	Indicative
cambiaremos	Indicative
percatada	None
publicitar	None
ayudan	Indicative
entrechocar	None
asfaltaron	Indicative
biografiados	None
merecemos	Indicative
marcaran	Subjunctive
magnificas	Indicative
grabé	Indicative
abandonando	None
bifurcan	Indicative
entabló	Indicative
zarpan	Indicative
aborregada	None
bebes	Indicative
sobrevinieron	Indicative
indicó	Indicative
traumatizó	Indicative
abstenerse	None
guardaré	Indicative
abandonó	Indicative
invernaríais	Conditional
monitoreados	None
alimentabais	Indicative
transé	Indicative
remodelando	None
inclino	Indicative
desembocaseis	Subjunctive
enganchan	Indicative
abandones	Subjunctive
partirán	Indicative
guaracheada	None
absuelven	Indicative
enviudo	Indicative
espumar	None
parcelado	None
vitalizado	None
conmovidos	None
escaseaban	Indicative
retransmitidos	None
presencian	Indicative
palpo	Indicative
litado	None
auxiliaran	Subjunctive
captásemos	Subjunctive
consideres	Subjunctive
cuidas	Indicative
salvan	Indicative
anidaríais	Conditional
desconectar	None
complicada	None
desquiciar	None
compliques	Subjunctive
empadronaríais	Conditional
destaques	Subjunctive
esquivaron	Indicative
liberad	Imperative-Jussive
requirió	Indicative
durmieron	Indicative
coronas	Indicative
involucrada	None
asimiló	Indicative
abanicó	Indicative
brotó	Indicative
domesticados	None
liquenizada	None
hirieron	Indicative
intimidan	Indicative
desemboco	Indicative
fabricada	None
sentencio	Indicative
sucederían	Conditional
enredáremos	Subjunctive
rozases	Subjunctive
describían	Indicative
desperdiciaras	Subjunctive
inmunizar	None
convocó	Indicative
perjuro	Indicative
repartían	Indicative
pagará	Indicative
comprometió	Indicative
conquistas	Indicative
viertas	Subjunctive
devengo	Indicative
resultarían	Conditional
coincides	Indicative
reseteo	Indicative
maldicen	Indicative
temperarían	Conditional
hormigueo	Indicative
muto	Indicative
opinaban	Indicative
dosificando	None
reservan	Indicative
propagó	Indicative
aleados	None
perfiló	Indicative
cometemos	Indicative
desmarcaron	Indicative
agrietó	Indicative
bailas	Indicative
concluirían	Conditional
escotada	None
amaitinados	None
puntuará	Indicative
recobraron	Indicative
aportará	Indicative
perdidas	None
tildó	Indicative
colorado	None
continuó	Indicative
acensuaron	Indicative
sugerirá	Indicative
escandían	Indicative
aconsejada	None
administrarían	Conditional
aumentan	Indicative
expoliado	None
oteadas	None
presupone	Indicative
gorreasteis	Indicative
comulgó	Indicative
patrocinados	None
alborotaríamos	Conditional
puñada	None
acordarás	Indicative
fundarán	Indicative
enceres	Subjunctive
filtrado	None
reviertes	Indicative
inscribirían	Conditional
centellabas	Indicative
polarizaron	Indicative
sangran	Indicative
desechadas	None
conmutan	Indicative
restructuró	Indicative
apodados	None
desnivelado	None
actué	Indicative
ciego	Indicative
decoró	Indicative
progreséis	Subjunctive
cimentaron	Indicative
arriesgará	Indicative
reencuentran	Indicative
lagarteando	None
lían	Indicative
reencantaran	Subjunctive
cebó	Indicative
volteo	Indicative
comunicas	Indicative
castigarais	Subjunctive
defecar	None
lastimo	Indicative
lidiar	None
boicoteó	Indicative
acumularán	Indicative
confecciones	Subjunctive
mezclaron	Indicative
refrescó	Indicative
negrecierais	Subjunctive
confinan	Indicative
sobreponían	Indicative
islamizados	None
cavaran	Subjunctive
acampan	Indicative
corroborarían	Conditional
apoderó	Indicative
llámese	Imperative-Jussive
atirantando	None
razonada	None
asustados	None
protagonizarán	Indicative
dictando	None
enfervorizado	None
promediaban	Indicative
absorberán	Indicative
verticalizando	None
empequeñecido	None
plagiadas	None
acurrucando	None
entrelazada	None
habitado	None
bombardeados	None
jodida	None
cobrarían	Conditional
desenamorados	None
reactivan	Indicative
salpican	Indicative
injertan	Indicative
puenteadas	None
lisonjeados	None
jalonear	None
elegían	Indicative
testificando	None
jugueteados	None
