mektuptan	None
dolmuş	Present
kirişte	None
sahiplerin	None
batısın	Present
yara	Present
aradın	Past
çalışacağız	Future
dirimlerinizin	None
eziyordu	Past
cezalandırır	Present
yumuşakçamızdan	None
bulunacaklar	Future
kurtçuklardınız	Past
vahada	None
yazıtlarının	None
topluyorum	Present
yetiştiler	Past
diyecekler	Future
tabansın	Present
cihanınızın	None
marangozdu	Past
uzak	Present
enstrümanın	None
derleyicisi	None
geçiniyordu	Past
uyarlar	Present
ittirilmeyeceksin	Future
mantilerimiz	None
giyiyor	Present
uzunluklara	None
lahananda	None
oyuncularmışsınız	None
çıkacaksınız	Future
demlerler	Present
amcayı	None
salonuna	None
bükülmüyorsunuz	Present
damlar	Present
yardımının	None
çıkıyorlardı	Past
kalplerinizde	None
sistemlerinin	None
aldırıyordum	Past
kalkacak	Future
birleştirdi	Past
kuruyoruz	Present
kazana	None
istiyorlar	Present
içiyor	Present
hanımlardın	Past
inlerden	None
çılgına	None
bankasını	None
güdüminde	None
doydu	Past
sesleniyoruz	Present
otomobilin	None
orospulardım	Past
öğretiyordun	Past
bekletir	Present
ayırır	Present
dinozorlardır	Present
açtık	Past
pompaya	None
soğur	Present
çıkardı	Past
sıfatlara	None
kurtlar	None
sultanlardık	Past
eşofman	None
yatak	None
onarır	Present
hindileriz	Present
savunuyordu	Past
çöllerden	None
dürtmedi	Past
patlamadı	Past
izlersin	Present
inanmadım	Past
veriler	None
atılıyordu	Past
övüyorlar	Present
nüfusta	None
yabancıyım	Present
yaratıklar	None
kılıçlardan	None
çıkaracağım	Future
ölülerin	None
ayakkabınız	None
şaşırtacaklar	Future
pişirir	Present
ikizlerin	None
kitabeyi	None
yazıyoruz	Present
dilmeyeceğiz	Future
vurguydun	Past
sunu	Present
üzülüyor	Present
uyumuyoruz	Present
çiftliklerini	None
kaldırım	None
yendirmiyorduk	Past
sekti	Past
yaratır	Present
öğreniyorlar	Present
bakmanızı	None
atışmıyordular	Past
harfi	None
yönetiminin	None
küçülmeyeceğim	Future
yoldaşım	Present
katmıyor	Present
kazmaz	Present
ölçerler	Present
nükleotitte	None
etkiler	Present
dalmazsın	Present
otogar	None
döker	Present
göbeğinde	None
deldi	Past
ürküyor	Present
kusuyorum	Present
görüyorum	Present
sunmam	Present
sesçiydim	Past
utanır	Present
öptü	Past
şarkıcı	Present
sıvılardan	None
yıkmıyorsun	Present
futbolcusunun	None
düşünürsünüz	Present
hukukta	None
çağırıyorum	Present
geliştirirler	Present
müezzin	Present
bildirecek	Future
itiyor	Present
öptüm	Past
kelimeyiz	Present
tanrıların	None
adından	None
önceliğinin	None
atmaz	Present
çedardık	Past
katıldım	Past
aktörden	None
güreşçilere	None
almam	Present
oynamıyoruz	Present
değişkenlerini	None
kullanılacak	Future
ustaları	None
kırışıklıkların	None
kirişe	None
kurbağayı	None
tanrı	Present
kokar	Present
gerekiriz	Present
içiyordu	Past
geldin	Past
çıktının	None
telefonunu	None
taslak	None
saparlar	Present
ziyaret	Present
kaçamaklar	None
heyecanlandıracaksın	Future
bildirmedi	Past
oynatıcıya	None
içmezler	Present
askerimiz	None
öldürüyorlar	Present
çalışırım	Present
girdim	Past
masumlar	Present
uyandık	Past
cücesin	Present
erkelere	None
yeriz	Present
denizyıldızlarının	None
soğurur	Present
izlerler	Present
sayfalarım	Present
kanıtladılar	Past
sultanım	Present
öğrenciyim	Present
giysimi	None
siğili	None
ittirilmezler	Present
koydular	Past
para	None
veriyorsunuz	Present
götverenlerdiniz	Past
oluruz	Present
geçti	Past
kek	None
yapmadı	Past
tutuşturmadılar	Past
gelişecek	Future
huzurum	Present
eklersiniz	Present
torunlardım	Past
bıçağımı	None
tükenmiyorum	Present
delimizden	None
paylaştım	Past
gösteriyorum	Present
emmiyorlar	Present
senaryosunda	None
devrim	None
flaşa	None
makyajlarını	None
dilerler	Present
endüstride	None
dönüyorum	Present
it	Present
mezarlıktan	None
yazdık	Past
ezer	Present
soğandan	None
kapasitelerine	None
iblisini	None
kıllarını	None
şaşırıyorsun	Present
filmim	None
müzikalimden	None
şikayetten	None
verilecek	Future
sanırlar	Present
özeldi	Past
ölçtürmezsin	Present
inanmıyordu	Past
konarlar	Present
ayrımcılıklarsınız	Present
avukatın	None
acır	Present
salıyor	Present
kazandık	Past
satıyorlardı	Past
kistti	Past
taktılar	Past
uçuyordun	Past
kahramanlarız	Present
yağlamadılar	Past
kullanıyorum	Present
iner	Present
saklanacak	Future
sektim	Past
yardımseverliği	None
yağdı	Past
şivelerinin	None
yonganın	None
geçiyorsun	Present
şırınga	Present
ibnelerden	None
göçlerin	None
karne	Present
irdeleyecekler	Future
imrenmem	Present
kırtasiyesi	None
gelişmez	Present
nöronumun	None
bıçaklar	Present
cenazelerimin	None
yerleşmiyordun	Past
bildirmem	Present
kazanırlar	Present
içtiler	Past
duruyorlardı	Past
taklitçilerim	Present
davranırsınız	Present
dizeleri	None
ışınından	None
kullanacak	Future
kayığı	None
almayacak	Future
yoldurtmazsınız	Present
yeterlik	Present
yörelerin	None
istedim	Past
borç	None
oynuyorsun	Present
dalgıçlardım	Past
ayılarsınız	Present
daldırtırsınız	Present
sınıfları	None
sindirir	Present
uyuyacaklar	Future
ayinlerden	None
karartı	Past
yorar	Present
inanmadı	Past
destanlarında	None
hata	Present
yapmıyorlar	Present
kullandılar	Past
unutacaksınız	Future
köçek	Present
dönmediler	Past
kuzularsınız	Present
volkanizmadan	None
şivesi	None
sekiyordum	Past
şerbetçi	Present
iğne	None
geçmezler	Present
doktorlardır	Present
imamıma	None
ayırdı	Past
katarlar	Present
dayar	Present
astılar	Past
sakladım	Past
kurabiyeleri	None
yapmayacağım	Future
döneceksiniz	Future
kazağı	None
yağmıyordu	Past
seksten	None
kolejden	None
kaynaştık	Past
kartını	None
İngilizceleştirdim	Past
giriyorlardı	Past
sinirlendirmiyordun	Past
kodda	None
çıktı	Past
gizliyor	Present
anlatırız	Present
süzgeci	None
dindarlar	Present
yedeklersin	Present
gözlüyoruz	Present
öğreniyorduk	Past
aradılar	Past
kazarız	Present
topluyordu	Past
bitirmiyorum	Present
güvenleri	None
vereceksiniz	Future
avlarına	None
yıkadı	Past
savunurum	Present
optimizasyonlarınızın	None
memelerinde	None
derginin	None
rüyalardır	Present
puanı	None
savaşmaz	Present
çöpçatandı	Past
ustaydılar	Past
çalışmam	Present
olmuyorsunuz	Present
değişmeyecek	Future
gösterdi	Past
ağladı	Past
silerim	Present
oturdular	Past
iletmezsin	Present
balinalarda	None
ürer	Present
iletiyi	None
sinmez	Present
kimyacılar	None
alışacağım	Future
izleyeceğiz	Future
kardeştiler	Past
öneriniz	None
dalgıçsınız	Present
yaptılar	Past
saydım	Past
kuvvetlerdim	Past
yıpranır	Present
yalvardı	Past
benzerlerim	Present
destanların	None
flaşı	None
ağlamaz	Present
dürmeyecek	Future
tiyatrosun	Present
kuşunu	None
battılar	Past
ağdacılarınızdan	None
körü	None
güler	Present
okulunda	None
yordama	None
depresif	Present
istemeyecek	Future
savunacak	Future
kavimlerinde	None
mandalina	Present
büyüleyiciydim	Past
sosislilere	None
öldürdü	Past
artıyordu	Past
konferansında	None
güvendik	Past
ustalarım	Present
üzülürler	Present
gönderirim	Present
dönersin	Present
göçmez	Present
düşündü	Past
yasaklarınızda	None
germiyorum	Present
istiyorduk	Past
abajurcuydular	Past
kullanıyordum	Past
darılmıyoruz	Present
yongalarının	None
inanıyorum	Present
beklemedik	Past
burnunun	None
sanmam	Present
gezmeyeceksiniz	Future
duracaksınız	Future
çökermediniz	Past
öldürmediler	Past
üreticisi	None
vermediniz	Past
tanrısı	None
istiridyemde	None
kullanılıyor	Present
savaş	None
eskir	Present
bulmuyordu	Past
katılmıyor	Present
sorun	None
garajlarında	None
yaramıyorlar	Present
çiziyorlardı	Past
kullanılmadın	Past
çetesinde	None
üşendim	Past
kalmıyor	Present
saklanacaklar	Future
seviyorum	Present
makinalarsınız	Present
yanıyor	Present
basacak	Future
ermiyor	Present
Zagreplilersiniz	Present
ölüme	None
laboratuvarlarını	None
savunuyor	Present
karıncayım	Present
koylardan	None
geliştireceğim	Future
üzgünler	Present
düşünmüyoruz	Present
kısıyorlardı	Past
boşalır	Present
akım	None
balkanlara	None
aşıyor	Present
daldırmıyordum	Past
davrandılar	Past
sönmez	Present
gayzerin	None
saçtan	None
uzaylılardan	None
saldım	Past
çıkarır	Present
kolyesini	None
peynirlere	None
sıralamasından	None
ağaca	None
inciymiş	None
şaşmadık	Past
üretmeyeceksin	Future
takmayacaksın	Future
düştüler	Past
olmuyor	Present
döküyorduk	Past
tanışıyoruz	Present
kesecek	Future
ilkelerinin	None
katıldı	Past
kullanılmazsınız	Present
Zagrepliydik	Past
bilirim	Present
biniyorlar	Present
sonlarını	None
evcikkıranlardır	Present
rahiplerdir	Present
ölümsüzleştirmedim	Past
sevmiyorsun	Present
iletir	Present
seçiyorsunuz	Present
baykuşu	None
yağmurdan	None
tabancası	None
uçaklarını	None
inanıyoruz	Present
eziyetçiydim	Past
savaştım	Past
öğretiyordu	Past
sunduk	Past
olayım	None
yıpratıyorlardı	Past
şaşılmadım	Past
yolundunuz	Past
bölüme	None
kakar	Present
duydun	Past
seçmen	Present
hızlı	Present
film	None
makarnalar	None
teşhisin	None
görmüyordu	Past
balkandı	Past
dedikodularından	None
saldırmazlar	Present
kapatıyor	Present
kaldık	Past
bazını	None
yaralanmasını	None
gönderiyor	Present
binmiyordular	Past
seslenir	Present
maskara	Present
yoksullaştırmıyordun	Past
yeniliklere	None
atomunda	None
bakmadılar	Past
büktürüleceksin	Future
moleküllerinde	None
yanıtlarınız	None
titreşimden	None
geliştireceksiniz	Future
indik	Past
ustaydınız	Past
palyaçoyuz	Present
otel	None
savunurlar	Present
takvimdiniz	Past
durmazlar	Present
başkentin	None
bekledim	Past
duyacaksınız	Future
kılacak	Future
görüntülerine	None
büktüreceğim	Future
küsmedim	Past
eskiyorduk	Past
silecek	Future
kedicik	Present
katılıyorsunuz	Present
serdim	Past
arıyorlardı	Past
seçmeniz	Present
sıralamaya	None
irdeliyorum	Present
eğlendim	Past
kurul	None
voleybolcusun	Present
sattırtırmıyorduk	Past
cücelerdir	Present
olurum	Present
mahzenleri	None
çöküyor	Present
içiyorum	Present
inin	None
verilerinizi	None
ziyaretçilerim	Present
türemedim	Past
germiyordunuz	Past
olmayacağız	Future
fikrimiz	None
karıştıracak	Future
açacak	Future
boşanacak	Future
menteşe	None
ağa	Present
teoremlere	None
coşacaksınız	Future
korkutmam	Present
üyeliklerine	None
taşır	Present
etkilerler	Present
cümlelersin	Present
cezeryesinden	None
süs	Present
kanmaz	Present
kılkapanlarda	None
Yahudiydi	Past
yapıldılar	Past
sitelerde	None
yavru	Present
korkuyor	Present
adamlarımızın	None
üşenmedi	Past
bakarsınız	Present
çağırmıyordum	Past
bulamıyoruz	Present
konuğu	None
kılıflarımız	None
tutmayacak	Future
beklemedi	Past
anlatmıyor	Present
mevzu	Present
kaybolmuyorlar	Present
bekletiriz	Present
kapamazlar	Present
sıralaması	None
rehine	Present
dışının	None
hendeselerine	None
içermedi	Past
onarmayacaksınız	Future
yetersizliktin	Past
ürüyeceksin	Future
parıltılardınız	Past
algoritmaya	None
baslardınız	Past
istemeyiz	Present
yarmadı	Past
objeydiler	Past
küstük	Past
vereceğiz	Future
mallardan	None
geğirmeyeceğiz	Future
kışkırtır	Present
boğazın	None
kışkırtmayacağız	Future
direksin	Present
kantinlerinden	None
uyanmayacak	Future
kıskandım	Past
daldırıyordum	Past
belediyesinde	None
geçtiler	Past
içti	Past
pimsiniz	Present
karşılığını	None
yelkensin	Present
kıskanırım	Present
kokuyordu	Past
dövüştü	Past
dondurur	Present
bekliyordum	Past
düşünmüyordum	Past
durmuyordu	Past
coşarsınız	Present
bağlamadık	Past
büyürler	Present
çalışmıyordu	Past
girdaptın	Past
itim	Present
ortaklardır	Present
kılarlar	Present
itilecek	Future
uğrattı	Past
heteroseksüellermişsiniz	None
nal	None
sürtüyordunuz	Past
kanıtlamıyor	Present
gözlemez	Present
fabrikanın	None
şey	Present
bölecek	Future
üyelere	None
açılıyor	Present
dayamadınız	Past
koyulaşır	Present
dumanlardın	Past
atıldı	Past
geldi	Past
dayadı	Past
tükenmez	Present
taşımıyordu	Past
örteceksin	Future
kapmaz	Present
vurdun	Past
yemişler	None
koşulacak	Future
sahife	Present
bülbüllerdiniz	Past
unutuyoruz	Present
indim	Past
gidilmedi	Past
üretmezler	Present
soğurum	Present
bulundular	Past
acıdı	Past
ayrıldılar	Past
titremiyordunuz	Past
teşkilatımıza	None
satırtıyordunuz	Past
kışkırttı	Past
üzülüyorduk	Past
kararır	Present
nedime	Present
sıradan	Present
sağlayıcı	Present
hücremize	None
cindi	Past
homoseksüeldik	Past
bastın	Past
bileğe	None
gelmediler	Past
birleştiriyor	Present
tanrıyı	None
çiziyorum	Present
ibneyiz	Present
kurtaracak	Future
kızdılar	Past
idarelere	None
doğusun	Present
hacılarsınız	Present
tutuyoruz	Present
döneriz	Present
izler	Present
belleklerinin	None
inmezler	Present
vasat	Present
ölçecek	Future
çıldırtır	Present
yetiştirdi	Past
soruda	None
temizlerim	Present
yetmezlikleriz	Present
burkacaksınız	Future
bozanızın	None
varoşları	None
ermedi	Past
etkilemedi	Past
göstermedik	Past
sihirli	Present
köylülerimize	None
silerler	Present
satrançlarından	None
patronundan	None
yıkmıyorum	Present
öğretirler	Present
payınız	None
kürkün	None
bitimini	None
başkanlarız	Present
tükürüyorum	Present
kondu	Past
terziydi	Past
sanıyorsun	Present
korkuyorum	Present
değişmem	Present
hücresinden	None
okuduk	Past
kılmaz	Present
doymadı	Past
batmıyor	Present
kıskanmazsınız	Present
umutsuzlar	Present
özlem	None
mıhımdan	None
izlediler	Past
otomobilciliklersin	Present
sürtük	Present
belirtmede	None
boşandı	Past
yayaların	None
füzeyi	None
düşmanlardır	Present
bileşiklerden	None
yağmurda	None
duymadı	Past
altıgen	None
evliliklerine	None
yetenekliler	Present
lunaparktılar	Past
tanelerini	None
kalmazsınız	Present
sızarlar	Present
geciktirtmez	Present
beldelerin	None
doğururlar	Present
gösteriyorlar	Present
koşulmazsınız	Present
duymam	Present
kıymayacak	Future
yapmayacaksın	Future
şalgamın	None
basıyor	Present
kaçıracak	Future
sapan	Present
gemisinin	None
buluştum	Past
sildim	Past
kütüğünde	None
yetersizliklermişiz	None
dük	Present
örüntünün	None
saklamaz	Present
evlendi	Past
yoldurtmayacaksın	Future
sıkıntıyı	None
kapmazsın	Present
yanlış	Present
duydular	Past
liseleri	None
saldırıyorlardı	Past
açacağım	Future
girmem	Present
küstü	Past
sünmüyorum	Present
tanımazlar	Present
döktü	Past
peri	Present
önemliliklerimizi	None
anlatıyorlardı	Past
seziyoruz	Present
saymaz	Present
doymadım	Past
katil	Present
karı	Present
itecek	Future
çapları	None
veriye	None
cimcime	Present
ilköğretim	None
bulunuyorum	Present
kertenkeleleri	None
rotorda	None
geçinir	Present
aldırdı	Past
yazmaz	Present
cumhurlardım	Past
sürüyorlardı	Past
tercihlerim	Present
gireriz	Present
enfeksiyondan	None
haritası	None
hadisleri	None
çökelek	Present
dondurmadın	Past
yuvarlamıyordun	Past
almıyordu	Past
kuyu	Present
çalışmalarından	None
telaffuzdun	Past
dadıydınız	Past
ördeğine	None
şoktan	None
çökersin	Present
mucizesinin	None
yazdın	Past
ekonomistlerin	None
kavramlarına	None
basketbolcuydu	Past
banliyölere	None
enişte	Present
kasını	None
sargıydılar	Past
bular	Present
acıtmıyordular	Past
silmiyor	Present
aktrisi	None
ölçtü	Past
ısıya	None
oluyorlar	Present
keseceğiz	Future
seçiliyorlar	Present
yaradı	Past
çaldın	Past
davrandı	Past
büyüklüklere	None
geometrilerde	None
lezyonlar	None
davranışçılığını	None
derslere	None
fikirlerimize	None
durmadılar	Past
bakanlardın	Past
otocuydular	Past
kıyafete	None
cinsin	Present
ölmüyorsunuz	Present
dolmuştu	Past
küçük	Present
doktorları	None
küser	Present
bas	Present
eğitir	Present
akbaba	Present
şerbetçisin	Present
yanardağlardan	None
aygırlarsınız	Present
sinüsleri	None
göçsün	Present
çığınızda	None
dağıttı	Past
iletiyor	Present
dövüştüler	Past
öldürürler	Present
diyoruz	Present
ayrılacak	Future
jokeye	None
Duşanbelilerinizden	None
eğildi	Past
çeviriyorum	Present
kolonlarım	Present
astık	Past
yetişiyordu	Past
bulunuruz	Present
bakireleri	None
karakterlermişsiniz	None
kaybolacak	Future
sevişeceksiniz	Future
giriyoruz	Present
seveceğim	Future
direklerine	None
biniyorsun	Present
atılmadı	Past
eğriler	None
sorumluluğuma	None
deliriyorum	Present
bekliyorlar	Present
etkilediler	Past
öldüreceksin	Future
şatolar	None
kapatırım	Present
beklemiyor	Present
sunulmaz	Present
bulursun	Present
unutacak	Future
yenildim	Past
değişmez	Present
abacı	Present
gelmiyordu	Past
Lefkoşalılarım	Present
dinsizliklerinizde	None
kaçırırlar	Present
gelirler	Present
yapmayacağız	Future
gidiliyor	Present
yetişirim	Present
pusulaları	None
dalmadın	Past
sözcülerdin	Past
tutacağım	Future
anasonsunuz	Present
maratoncu	Present
kesyapıma	None
uçar	Present
vampir	Present
kesyapımızı	None
iğrenir	Present
doğada	None
hazırdı	Past
oylarını	None
mantiymişsiniz	None
reaktörleri	None
paskalyası	None
ayırıyoruz	Present
rehber	None
emmeyiz	Present
kuvvetliliğiniz	None
bohçayı	None
bulunuyordu	Past
usta	Present
tüylerden	None
evlatlarımızdan	None
alışırlar	Present
kılığımızı	None
pelikanlarsın	Present
benek	Present
utandırırım	Present
ayakkabıcıydınız	Past
sahneyi	None
öldürdük	Past
videolarına	None
korkuluk	None
tükendi	Past
kuşlarında	None
güreşçiydi	Past
kurtaracağız	Future
çeliğiz	Present
aletti	Past
körfezleri	None
bekletmeyiz	Present
oynuyor	Present
başarıyorlar	Present
koşuculardım	Past
istemiyor	Present
sığmıyor	Present
deliyor	Present
sorumlulukta	None
kravatlarıma	None
cin	Present
tatlılardınız	Past
Belgratlılardınız	Past
kelebeklerin	None
erdim	Past
bağlıyor	Present
dayarsın	Present
seviyorlar	Present
koşucu	Present
yardımcısına	None
bükülmeye	None
porsuğun	None
lunapark	Present
gayzerimde	None
seyahatlerde	None
ilminden	None
kurutmuyordunuz	Past
büyür	Present
bitirirsiniz	Present
ördü	Past
köpürtürsünüz	Present
alıyordunuz	Past
sevmiyor	Present
yasaklarım	Present
ropdöşambırlarımızda	None
leşlerdik	Past
sözlükçüsünde	None
şarkıcısı	None
oyalar	Present
gücendiniz	Past
şaşırıyordu	Past
çözeltiyi	None
ayakkabıcılarım	Present
sayacağım	Future
ulamlardınız	Past
paylaşır	Present
yapışma	None
yüzüncüleriz	Present
küsüyorlar	Present
göstermediler	Past
çerçilerdin	Past
getireceğiz	Future
şarkıcılardır	Present
yanıt	None
bildiler	Past
papağanı	None
akbabalarının	None
utanmaz	Present
yamyamını	None
oğullarımız	None
düşünüyorlardı	Past
huzur	Present
sayıyor	Present
anlatmam	Present
yalanları	None
anlattılar	Past
cadılığın	None
geçmelerinde	None
giriyor	Present
yaralarından	None
romandı	Past
pirinç	Present
gelmem	Present
ovmayacaksınız	Future
katılaşır	Present
diriliyorum	Present
meydanların	None
korkmuyordular	Past
uzanmayacağım	Future
öper	Present
öldün	Past
mezarlıklarsınız	Present
götürüyorlar	Present
kurbağalarıma	None
dizilerde	None
yakamızdan	None
sıçanmışsın	None
kaynaşırlar	Present
kapatmayacak	Future
fikrinize	None
bazlarımızı	None
sıralamanızın	None
abajurcuydu	Past
yeşimlerinize	None
mikroorganizmalardır	Present
çalışır	Present
tatları	None
manitaydın	Past
severler	Present
izlemiyor	Present
sınadı	Past
gizlerler	Present
satılacaklar	Future
getirir	Present
ateşin	None
yanarsın	Present
cinlerdik	Past
acemi	Present
topluluğuz	Present
kapatacak	Future
sapmıyorsunuz	Present
tütünden	None
istediler	Past
yollarınızdan	None
etkiledi	Past
fikirlerini	None
birleşmeyeceksin	Future
yağın	None
erkeceyinin	None
sisteminizde	None
sagalarından	None
ölümsüzleştiriyorsunuz	Present
masumiyet	Present
hatalarım	Present
mızrap	None
yapışıyor	Present
koşulur	Present
yenilmezler	Present
sikişmiyordunuz	Past
öğrenmez	Present
anketinin	None
çöplerde	None
fizikçinin	None
temsilciliklerim	Present
ettiriyordunuz	Past
yapmayacaksınız	Future
delirecekler	Future
diriliyor	Present
acısın	Present
kalktın	Past
yalamazlar	Present
İngilizceleştiriyorduk	Past
gelmiyorlar	Present
birleştirdim	Past
koyarsınız	Present
etkilemez	Present
çağırırız	Present
batacak	Future
şaşırdık	Past
korkuyordum	Past
ölçer	Present
fotoğrafçıya	None
bileşiklerin	None
kürkten	None
serdi	Past
korkutur	Present
seyrettim	Past
kazmazsınız	Present
yerleşmiyorsunuz	Present
sarılır	Present
doğurmadık	Past
dezenfektanımızda	None
kaçıyorduk	Past
pisletmeyeceğiz	Future
yardılar	Past
örneğin	None
iniyoruz	Present
katılaşmazlar	Present
şapkacı	Present
tecrübeye	None
koşuldu	Past
sürücüsü	None
gözledi	Past
desenlerinin	None
iskender	Present
yanlıştı	Past
kullanılmazlar	Present
bildiririm	Present
gürzlerimizden	None
üzülecek	Future
derdi	Past
dizemlerimizden	None
görüyor	Present
konulardır	Present
kızıyorum	Present
açılmadım	Past
düşünceliydik	Past
attırdı	Past
taştı	Past
Müslümanlardan	None
hamburgerlerimizde	None
ağlarlar	Present
eğiyoruz	Present
ısınır	Present
tecrübesinden	None
açmaz	Present
kapamalarsınız	Present
saçmayız	Present
katılıyor	Present
öğreniyoruz	Present
çürümeyecek	Future
deliyim	Present
yerleştik	Past
öğrenirim	Present
kurbağacığına	None
abartmadı	Past
iyileşmedi	Past
kaygılara	None
seçmez	Present
fare	Present
giysisinin	None
kayakları	None
yaratı	Present
çıkarıyor	Present
kaşın	None
açarım	Present
sevgililerdir	Present
alındırıyoruz	Present
duyunu	None
eğlendik	Past
kızar	Present
dövüşçüydün	Past
kullanıldılar	Past
çalarım	Present
dolamıyordunuz	Past
şampiyonluklarında	None
kaşende	None
kardeşliğe	None
satmadı	Past
bekledik	Past
bulmuyorlar	Present
görmüyorsunuz	Present
demeyiz	Present
koyacak	Future
kıskanmayacaklar	Future
anguttu	Past
ortaydım	Past
makinamdan	None
kaçar	Present
çalışacaklar	Future
atomlara	None
ummandık	Past
boğacak	Future
ilklendirmeydiniz	Past
ışınım	Present
yağlarlar	Present
bulunacak	Future
klostrofobi	None
hinterlantlarından	None
zeval	None
karıştırtmayacağız	Future
devlerdir	Present
devir	Present
uyanmayacaksın	Future
biler	Present
sığmayacak	Future
makinelerinin	None
çıkıyorsunuz	Present
göstereceksiniz	Future
sever	Present
düşmanlarının	None
doğumun	None
koyunu	None
bakıyorsun	Present
yapacaklar	Future
ittirtildin	Past
delirdim	Past
oynuyoruz	Present
geçiniyorsunuz	Present
sezdim	Past
fındığı	None
anlattık	Past
yolmayacaklar	Future
istemedim	Past
ramazanın	None
bilmem	Present
ölümünde	None
yalvardılar	Past
umar	Present
sevmezler	Present
dağılma	None
eşcinselleri	None
koymadım	Past
birleşti	Past
havlularımızın	None
zibidilersin	Present
küvet	None
sunmayacaksın	Future
öğretilerimizi	None
doğuyordum	Past
yapıldım	Past
açmayacağım	Future
kızacak	Future
çaplardınız	Past
gelinmeyeceksiniz	Future
geziyor	Present
bulunduk	Past
evlilikte	None
fundalar	None
üşüdüler	Past
açmadım	Past
takmam	Present
dedikoducu	Present
diliyoruz	Present
lensler	None
taradılar	Past
dumanına	None
arkadaşlığa	None
kırbacı	None
gülmedi	Past
türedi	Past
gerinmiyor	Present
beklemeyecek	Future
kanıtlarlar	Present
alıyorsun	Present
kurtçuk	Present
vekil	Present
hareketsizliklerimizde	None
kaçmadı	Past
kurabiye	None
bürümem	Present
kullanmadım	Past
dedikoducularsın	Present
öperler	Present
dineceksiniz	Future
değişken	Present
boşanır	Present
donduruyorlardı	Past
yıprattı	Past
bulunuyorlardı	Past
şaşılmıyorlar	Present
sürünmez	Present
gülüyorum	Present
börülceniz	None
düşünüyorum	Present
tükenmedik	Past
çizdi	Past
katıldınız	Past
duymayacak	Future
otocunuzdan	None
batı	Present
göndermeyeceğim	Future
ekranlardan	None
araçlardır	Present
şeriattiniz	Past
gafı	None
çağıracak	Future
salacak	Future
idareler	None
böceğinden	None
kurtardı	Past
bağlamaz	Present
gezer	Present
büyük	Present
mümessil	Present
kattı	Past
rüyayı	None
buzuluna	None
sonlara	None
sorum	None
meyhaneleri	None
tutacağız	Future
sucuk	Present
şeriat	Present
önceliklerini	None
asanın	None
sözlüklerdir	Present
kapadılar	Past
açılmıyordu	Past
dağıtacak	Future
verecekler	Future
irdeliyorsun	Present
siner	Present
paylaşmıyordunuz	Past
işleiyoruz	Present
evlenirler	Present
oto	Present
krizlerde	None
aramıyorum	Present
olmayacaklar	Future
silmiyoruz	Present
istiyorsunuz	Present
günahkâr	None
zamanlarımızda	None
karakterin	None
delirdi	Past
yolundurtuyorlardı	Past
sızmaz	Present
bohça	Present
heceleri	None
hikâyeden	None
varıyorum	Present
İngilizceleştirdiler	Past
deli	Present
yakınım	Present
kovdurtmazsın	Present
güvenmedi	Past
cezalandırırsınız	Present
albatroslar	None
hocamızın	None
basarlar	Present
yazmıyorum	Present
geberecekler	Future
seçiliyorlardı	Past
gösterdin	Past
pelten	None
öküzdüler	Past
dua	None
külünden	None
örslerini	None
gülmüyor	Present
mermisine	None
canlandırttım	Past
bitim	Present
tecrübeyi	None
çorbalara	None
üzgünüm	Present
dövüşüyorsun	Present
diner	Present
düşünceli	Present
bakacak	Future
albümün	None
önlerimizde	None
sunuyorlar	Present
sanıyor	Present
asmaz	Present
altınlarımızı	None
başvurumun	None
ilkesinin	None
kasmayacaksın	Future
kaynıyor	Present
anlatıyor	Present
çevirdiler	Past
bluzlumu	None
uzanmıyorlar	Present
omuzların	None
ekiz	Present
alışır	Present
yığdı	Past
ısırmayız	Present
temsilciliklerin	None
ıspanaklarımız	None
bulmazlar	Present
inerler	Present
küremedim	Past
betiklerimize	None
götverenlerdir	Present
kabukların	None
gelmeyecek	Future
manivelanız	None
bakacaksın	Future
dönecekler	Future
temsilciliklerdir	Present
topolojilere	None
mühendislikten	None
algoritmalarda	None
gizlendi	Past
avukattı	Past
öğretiyor	Present
gelmedi	Past
aşacak	Future
umdular	Past
yazıların	None
davranışta	None
ejderhaları	None
kazır	Present
son	Present
kıydınız	Past
durağına	None
yalancısın	Present
alışmadık	Past
hedef	None
sürtüklersin	Present
bunayacağız	Future
çizer	Present
sempozyumda	None
öğretti	Past
marangoz	Present
böleriz	Present
teklif	Present
uyarıyorlardı	Past
doktor	Present
istedik	Past
başparmak	None
gördün	Past
tabansızım	Present
açmıyor	Present
tepmiyordu	Past
cinsiyetin	None
gereksinimi	None
batmaz	Present
bekletmiyorlar	Present
ovuyor	Present
eriklerimizin	None
kuğulardınız	Past
gecikti	Past
yörüngeler	None
haçını	None
bamya	Present
palyaçolarsın	Present
pişiyorum	Present
koymazlar	Present
otomobilciliktim	Past
doğrular	Present
küsmediniz	Past
sağlarsınız	Present
çıkıyoruz	Present
öksürmüyorsun	Present
istemiyorsunuz	Present
kasıyorsunuz	Present
üyelerdir	Present
oluyorlardı	Past
savunursun	Present
istemediler	Past
barışırlar	Present
bitkileri	None
yolundurtmuyorum	Present
tütmüyorsunuz	Present
kurtarıyorduk	Past
solar	Present
çiğdem	None
oyalayacağız	Future
sildik	Past
zibillerinizin	None
patronum	Present
tabansızlarda	None
yetmezlik	Present
hastalarda	None
demiyorlar	Present
inanıyorlardı	Past
rüya	Present
hücrelerinde	None
konusunu	None
ısırmıyorsunuz	Present
susacak	Future
gelindi	Past
anasızlığımıza	None
basketbolcusu	None
ekti	Past
yazacağım	Future
beklemiyorum	Present
bunuyorsunuz	Present
gizemli	Present
geberirsin	Present
bindiler	Past
yalar	Present
kanserlere	None
bildirir	Present
üretiriz	Present
düşünüyordum	Past
bulacaksın	Future
dolmuşlardım	Past
kalmayacağım	Future
onamadı	Past
kurtarmadın	Past
tarihçiydi	Past
duvarlarının	None
itiliyor	Present
kılar	Present
köpürtmezsiniz	Present
yangınım	Present
titremiyoruz	Present
silmez	Present
dullara	None
cücelersiniz	Present
patlama	None
yoksullaştıracağız	Future
gözyaşlarına	None
tanışacak	Future
ayrılıyorlardı	Past
ortaklıklar	None
kolona	None
kuyuydular	Past
programlanmıyorduk	Past
aldırmıyor	Present
baldız	Present
işçisini	None
anlatacaksınız	Future
sayacaklar	Future
yazdım	Past
doktorun	None
kaynaşmıyorsunuz	Present
sönmüyor	Present
kolyenizin	None
seviyoruz	Present
atmamadı	Past
ölürüz	Present
çarpar	Present
düzeliyorum	Present
kaybolur	Present
giriyorsunuz	Present
ulur	Present
yaralanmalarında	None
hayırseverdiler	Past
bağlıyordu	Past
videosunun	None
hatalardan	None
beyittiler	Past
benzemiyordular	Past
yağarsın	Present
pancardan	None
dolmuyor	Present
umuyorlar	Present
ayılarımda	None
keşfettik	Past
gösteriyordum	Past
ayırmam	Present
sağar	Present
abartıyorsunuz	Present
çeliklerinin	None
makinaymış	None
vaktinde	None
hatırımı	None
dişleri	None
kanunlarımızı	None
kurutuyor	Present
örnek	Present
durağının	None
sucuğuma	None
sağlarım	Present
dediler	Past
etkiliyordu	Past
dolacak	Future
severim	Present
etlerim	None
masumsunuz	Present
bildirdiler	Past
aşığa	None
kütükte	None
ısırdı	Past
deşmedi	Past
öksürecekler	Future
poposuna	None
umarım	Present
ilklendirme	Present
karıncasın	Present
ateşini	None
ispatlamayacaksınız	Future
çağırır	Present
büyülüler	Present
cepheydi	Past
Mogadişulularım	Present
işçi	Present
canlanmıyor	Present
aramam	Present
yazmıyorlar	Present
türemeyeceğim	Future
vedaydın	Past
bildireceğim	Future
çalışmazlar	Present
astın	Past
giyerler	Present
küçülüyorlardı	Past
varırız	Present
ararım	Present
girecekler	Future
uğratır	Present
pederdim	Past
görürsünüz	Present
gemisi	None
takıyordu	Past
kâinatının	None
yarış	None
blogcularız	Present
buharlaşıyor	Present
yoldaşının	None
atılmadık	Past
taşmıyorsun	Present
paylaşıyorum	Present
böbrek	None
sıradansın	Present
sekmeden	None
sıvılaştırırsın	Present
futbolcuydu	Past
otobüslerde	None
başrahiplerdin	Past
değişkenlere	None
kantodan	None
bahçesinde	None
kazımayacaksınız	Future
duvarda	None
sayıyorum	Present
süzgeçte	None
eziyetin	None
heyetlerimiz	None
barışmazsın	Present
okur	Present
vurur	Present
velet	None
ayrılmazlar	Present
bölgesinin	None
bilmiyoruz	Present
dilimlerini	None
ağlamasından	None
birliklerini	None
cenazeleri	None
gizlemiyoruz	Present
canlandırtacak	Future
dondurmazlar	Present
külde	None
mumyaydınız	Past
doğuyor	Present
üyeyim	Present
karıştırdım	Past
bulmam	Present
meşesi	None
yumdu	Past
çıkarmam	Present
hareketsizliğinde	None
duyuyorlar	Present
ayırmaz	Present
gizliyorum	Present
küreyeceksin	Future
fizikçilerime	None
şaşarız	Present
kastı	Past
üyeydi	Past
demler	Present
abajurlarımdan	None
sürüyordu	Past
geri	None
metresi	None
çizeceksin	Future
heteroseksüellerdiniz	Past
gübre	Present
önceden	None
ebelerimden	None
eğleneceğiz	Future
yazacaksın	Future
yetenekli	Present
ecesin	Present
umarız	Present
karanlıklardan	None
köylülerdir	Present
moda	Present
bildiriyordu	Past
hızlarının	None
gecikmez	Present
peronumu	None
geçindi	Past
zulmünün	None
girer	Present
hastanesi	None
yollarını	None
bulamıyorlar	Present
takıyoruz	Present
araç	Present
yıkmıyordu	Past
becerikli	Present
yormadım	Past
mezarlıklardan	None
sorularına	None
göç	Present
değiştiriyorsunuz	Present
oturuyorum	Present
yetenekliydi	Past
kardı	Past
yazarlar	Present
davranırım	Present
çattın	Past
dersin	Present
büktürtü	Past
uymayacak	Future
börülcelerdik	Past
beklemiyoruz	Present
sikilirler	Present
kastın	Past
ısındı	Past
düşer	Present
gelinir	Present
odacılardık	Past
köpürttünüz	Past
okudun	Past
kıskanıyorum	Present
çalgıcılarsınız	Present
temizlemediniz	Past
dolmuştuk	Past
deşmiyorum	Present
çıkmadı	Past
saldırırlar	Present
huzurlusunuz	Present
metres	Present
istiyoruz	Present
güldüm	Past
oda	Present
erirler	Present
katlarda	None
değişkenlerdim	Past
evlatlarımda	None
toplumdan	None
atılacak	Future
yaptın	Past
dayamayacaksınız	Future
kıskanmadım	Past
diskotek	None
sitem	None
kravatı	None
tatlının	None
vapurun	None
çölden	None
pişireceksiniz	Future
yaparsınız	Present
esrarengiz	Present
sonuçlardır	Present
belediyemiz	None
göstermeyecek	Future
davranmazlar	Present
sevmedik	Past
köylülerim	Present
mükemmelmişsiniz	None
koklar	Present
mezuniyetini	None
büyücüsün	Present
bilmeyiz	Present
yemeninizin	None
çıkıyorlar	Present
malamozlardınız	Past
kanıtlayacaksın	Future
konferanslarda	None
sindirmiyorsunuz	Present
iniyordu	Past
balıkçı	Present
çalışacaksınız	Future
konferansa	None
gelişiyorsunuz	Present
kul	Present
sikilir	Present
savunmam	Present
katılmıyordu	Past
babasız	Present
yaklaşıyor	Present
taslağından	None
maratoncularmış	None
kurtarmayacak	Future
keseye	None
boşanırız	Present
yaratmadı	Past
dürtmezsin	Present
bağladı	Past
uyarıları	None
kapama	Present
giriyordu	Past
otomobillerdir	Present
pozisyonda	None
tükenir	Present
yaptı	Past
klorofile	None
bloglarda	None
bölümlere	None
sisleri	None
yapıştı	Past
coştu	Past
çıkarız	Present
tıklıyorsun	Present
verimsizleştiriyor	Present
ceylanım	Present
tasarımınızı	None
kaçmayacağız	Future
korktuk	Past
sıktı	Past
banliyöde	None
bencil	Present
şişiyor	Present
koymuyor	Present
yetersizliklerden	None
savaşçılardır	Present
tayfaydım	Past
tekili	None
ürür	Present
ellemez	Present
sunmadı	Past
tanımaz	Present
kansızlık	None
yıkamıyordular	Past
denilmiyor	Present
benzerdi	Past
çökelekten	None
kokusundan	None
öldürüyordu	Past
kansızlığında	None
sözlüğünde	None
biralar	None
bilemedin	Past
istemiyordum	Past
buluşuyor	Present
yığmıyorduk	Past
öğretmendin	Past
çizmeyeceksin	Future
bileceğim	Future
tekfuru	None
sildiniz	Past
tıkladı	Past
savaşıyordu	Past
düşmüyor	Present
programlattınız	Past
kurumaz	Present
ağlarım	Present
ketçaplarınız	None
kirletmedin	Past
öldürdüler	Past
küllerinden	None
yaratmayacak	Future
öğütürüm	Present
omuzlarını	None
varıyorlar	Present
tıktım	Past
yandı	Past
programlandın	Past
ölmedim	Past
çıkarmazlar	Present
mucize	Present
tanıştılar	Past
verdirdiler	Past
heyecanlandırtıyordun	Past
maya	None
amaca	None
dönüyoruz	Present
sesleniyorum	Present
verirsiniz	Present
pozisyonlarında	None
kurbağasının	None
karakterim	Present
öldüler	Past
düşünürüm	Present
iletmezsiniz	Present
topluyorlar	Present
kaygıdan	None
yayıncılığının	None
alırsınız	Present
pişer	Present
doğuracak	Future
yağmaydık	Past
alkışları	None
öleceğim	Future
seçiyor	Present
duman	Present
bitki	Present
girdiniz	Past
varışı	None
çiftin	None
kasımda	None
katılaşacağız	Future
ölçüşecek	Future
sürücüme	None
eklerim	Present
maçına	None
bulmadı	Past
uğrattılar	Past
kullanmadı	Past
uğratılırlar	Present
saydırmıyordum	Past
sığmıyorsun	Present
çiçelerdir	Present
dökmez	Present
yıkacağız	Future
aşkımıza	None
bakacağım	Future
eğitmeyeceksiniz	Future
kipin	None
boğazlardan	None
insanımsıydılar	Past
oyuncun	None
gizleyecek	Future
davranacak	Future
mekiğe	None
buzdolabından	None
duyarım	Present
aşıkdın	Past
makaramızı	None
boğadan	None
hissine	None
sevdiler	Past
dikkatleri	None
bitirir	Present
götürdü	Past
gördü	Past
kururlar	Present
içeriz	Present
acıtırlar	Present
hırsızdınız	Past
derecelerinde	None
açmadı	Past
bulunursunuz	Present
kaynaştırtmadın	Past
konu	Present
çaldılar	Past
yağacak	Future
bayılıyorum	Present
umutluydu	Past
teklifimde	None
heyecanlandı	Past
tıklıyoruz	Present
şaşırmam	Present
yoğurdum	Past
yetiştiriyorlar	Present
kaçırır	Present
sürgünlerinin	None
kazasına	None
ziyaretçi	Present
tütüyorsunuz	Present
dururum	Present
getiriyoruz	Present
mikroorganizman	None
komikleşmeyeceksiniz	Future
çeviririm	Present
çırak	Present
geçersiniz	Present
unuttum	Past
öfkelendireceğiz	Future
kalıplarının	None
ışınlardır	Present
dışkıların	None
etekten	None
bindik	Past
gerekmiyordu	Past
bulunur	Present
bilir	Present
tanıyorum	Present
uğratılır	Present
susmam	Present
saklanmaz	Present
kotumuzdan	None
düzüyor	Present
payların	None
seçtim	Past
yaptım	Past
maymun	Present
yaklaşırlar	Present
araçlarını	None
eşcinselim	Present
kahramanda	None
bilerler	Present
bıçaklıyordum	Past
ısınacak	Future
vitrini	None
kabalığından	None
kanatlarda	None
yaparsın	Present
uyarınıza	None
eşiğinden	None
ısılarda	None
bölgesin	Present
prenslerden	None
ısırıktan	None
burkmadılar	Past
bitişine	None
pehlivanları	None
seçmenlerinin	None
sıfatın	None
kalktı	Past
aşmaz	Present
mısraları	None
soluyacağım	Future
bağlamıyordular	Past
uyursunuz	Present
dakikalarında	None
flaşlarmış	None
dağıtımın	None
şikayette	None
uzaktılar	Past
arar	Present
saymadılar	Past
istemezler	Present
dönmeyecek	Future
fizikçiydin	Past
elma	None
ofisini	None
geometriyi	None
embriyosun	Present
duyacağım	Future
otogarınız	None
açmam	Present
yaralanması	None
sezdiler	Past
ayakkabıcılarız	Present
birleştiriyorum	Present
ispatlamıyoruz	Present
barıştı	Past
yıprandık	Past
dönüşlerimize	None
salonunda	None
sepetlerini	None
donma	None
şemsiyelerdiniz	Past
damlarım	Present
verilirler	Present
seveceksiniz	Future
kutlamada	None
okurum	Present
seçmenleri	None
yazıyorum	Present
yeterliliğimden	None
sıfatlarını	None
birleşiyor	Present
kumaşların	None
güçlüğünden	None
uğratılmıyordum	Past
kovulduk	Past
kıldık	Past
polinomunu	None
çökmez	Present
kartlarının	None
canlandırılmadı	Past
öğütmüyordu	Past
adamda	None
cihanlarımızın	None
aletlerden	None
almanak	None
yetiştirir	Present
duymuyorlar	Present
göçlere	None
büktürmediler	Past
kalıyorsunuz	Present
sikiyordun	Past
levreği	None
ayılıyorlar	Present
çökmeyiz	Present
meyhane	None
devim	Present
inanırız	Present
üşeniyor	Present
sürülmez	Present
salonlarından	None
finalinize	None
tatlıyı	None
balinalardır	Present
duruyorsunuz	Present
üretiyorlardı	Past
vermedim	Past
milyarder	Present
övdüler	Past
kılavuz	Present
çete	Present
çıkarırlar	Present
satacak	Future
gazellere	None
kırılmıyordu	Past
ölçülmez	Present
süzüyorduk	Past
yakına	None
yayıyordu	Past
dururlar	Present
fonksiyon	None
gösteririm	Present
koymuyoruz	Present
ağladık	Past
vidamda	None
boşanırlar	Present
devirdik	Past
aldırmaz	Present
sporcu	Present
işer	Present
paylaşım	None
avlardım	Past
sosis	Present
geberdiniz	Past
yapıyorum	Present
ısınmaz	Present
öğrendin	Past
kedilerdir	Present
tütsü	Present
gülünçleşirsiniz	Present
yapıyorsun	Present
tiyatrolarına	None
olacağım	Future
durur	Present
ölçtürtmüyorum	Present
geçtik	Past
almadılar	Past
canlanırlar	Present
inanıyorlar	Present
sağduyusu	None
okudum	Past
birleşmedi	Past
nohut	Present
parçacıktan	None
bulduk	Past
teklifti	Past
ayrıldım	Past
huri	Present
lezbiyen	Present
seyretti	Past
üzüldü	Past
dokurlar	Present
bekliyorduk	Past
avcıydı	Past
geçmeyecek	Future
göstermedi	Past
değerliler	Present
tütüyorsun	Present
dalar	Present
tıklıyorum	Present
oyuncu	Present
tanışıyordu	Past
yalvarırlar	Present
cümlen	None
girmiyorlar	Present
tanışmam	Present
bağırsaklarda	None
ağlıyorum	Present
iletiyoruz	Present
bilemedim	Past
imrenmedi	Past
başkanımızın	None
tasarrufları	None
kalıbını	None
alanından	None
ittirilmiyor	Present
korkuttu	Past
dilberlerdir	Present
döküyorlardı	Past
gözlemedi	Past
yapılacak	Future
gelmeyecekler	Future
saldırıyordu	Past
efe	Present
fahişeye	None
çetenin	None
seçilir	Present
unutur	Present
menekşe	Present
ekşitmezsin	Present
görür	Present
işçilerdim	Past
geçmiyor	Present
kullanıyordu	Past
çerçilerdir	Present
anlattım	Past
ayrılmadılar	Past
mantığı	None
dokur	Present
verildiler	Past
kağıdına	None
oylarından	None
bozmuyor	Present
gecelik	None
kullanıyoruz	Present
kağıtlardan	None
dükkânlarında	None
sunuldu	Past
yapmadık	Past
çıkarırsınız	Present
tebeşir	None
günüm	None
çizgilerdin	Past
üretirler	Present
gidilmez	Present
yaklaştı	Past
düşünmüyorum	Present
şerbetçilerinizde	None
büstlerin	None
ütülerdir	Present
izlersiniz	Present
idaresinin	None
annelere	None
kuvvetlerinin	None
çağırmadı	Past
temizledi	Past
seker	Present
ulusunun	None
sindirmiyordular	Past
ölçüşmeyeceksin	Future
oyunculuğun	None
psikiyatr	None
umuyor	Present
bulunmuyorlar	Present
temsilciliğinde	None
dönüşümden	None
yeniliğimden	None
canlandırmaya	None
vampirlersin	Present
kuşa	None
değiştirdik	Past
dişlin	None
gösterisine	None
ömür	None
kullanıyorsun	Present
otizmden	None
protestosunu	None
bulamıyordu	Past
ilginçti	Past
orta	Present
öğretmenim	Present
darılmayacağız	Future
bekliyor	Present
kılıyordu	Past
demirci	Present
bulunuyorsunuz	Present
akbabaydın	Past
kullanmadılar	Past
ürettiler	Past
görmüyor	Present
balıksın	Present
seversin	Present
açmayacaksınız	Future
konuyordu	Past
diriydim	Past
bulunmam	Present
avcılardır	Present
soğanlarının	None
tecrübesine	None
döverler	Present
atmamıyordum	Past
kavun	Present
geleceğiz	Future
kısarlar	Present
tartıyorum	Present
şarkıcıydı	Past
üreticilerden	None
yardım	Past
kaldınız	Past
çalışıyorduk	Past
yetişiyor	Present
satar	Present
tutmuyor	Present
kırmaz	Present
bankı	None
gönderdik	Past
yenilmeyecekler	Future
kullanırız	Present
kavakları	None
istedi	Past
taşıdınız	Past
kraliçenin	None
üşüdün	Past
prenslerdir	Present
sererler	Present
şamarlayacaksın	Future
okumadın	Past
saptı	Past
torun	Present
kuyumcu	Present
getirmez	Present
hafriyatın	None
eylemden	None
tarar	Present
medresesinde	None
demezler	Present
denilmez	Present
büyümedim	Past
alıyorlardı	Past
evrime	None
yalarlar	Present
damadını	None
nargileye	None
geçiyoruz	Present
titredim	Past
sacın	None
Belgratlıydık	Past
kedilermiş	None
sahibim	None
öleceğiz	Future
doyar	Present
fındık	Present
balinalara	None
konuydu	Past
vikipedistlerdir	Present
pelikan	Present
kapatmam	Present
tütüyordu	Past
soydu	Past
satrançlarımdan	None
yoğuracağız	Future
çıldırtmayacaksın	Future
sıradandım	Past
imreneceğim	Future
kurumlarında	None
devirin	None
askerine	None
savaşıyor	Present
müzikallerinden	None
kaçmayacak	Future
düşünmedik	Past
istirahatımın	None
kıyar	Present
öpmedi	Past
ağadan	None
arpanın	None
korkacak	Future
kalkmıyorlar	Present
sandık	Past
eklemeliyim	Present
denilecek	Future
işlerim	Present
kalabalıktan	None
kulüp	None
iyileşir	Present
kararıyor	Present
getirmem	Present
çalacak	Future
argoya	None
saksocuydular	Past
ziyaretçilere	None
atılmaz	Present
birleşir	Present
satılır	Present
bulamadık	Past
iyileşiyorum	Present
futbolculardır	Present
neden	Present
yazmalarımızdan	None
musonları	None
batıyor	Present
bademimde	None
evlilik	None
tabana	None
süpürür	Present
ikazımızın	None
boyar	Present
taslağımız	None
ettirdin	Past
memleketini	None
manivela	None
gezdim	Past
kokuyorlar	Present
efeleri	None
varacak	Future
deştiler	Past
bağırsağını	None
benziyorlardı	Past
saklandılar	Past
yumurtadan	None
sessizlikleri	None
oynatıcıların	None
sanır	Present
sarardı	Past
satmaz	Present
temizler	Present
alacağım	Future
müezzinlerdim	Past
bombalarının	None
saldıracak	Future
alıyorlar	Present
gelirden	None
kanayacağım	Future
pelikandık	Past
duracağım	Future
rahatsızlanmadın	Past
dürmediniz	Past
sanatlardan	None
seksi	Present
kanmam	Present
abece	None
metrdotelin	None
ejderhaydı	Past
şahların	None
getirdiler	Past
katılıyorum	Present
kopmayacaksın	Future
kitabeler	None
dadanacak	Future
aikidonun	None
çökerler	Present
okiyaydınız	Past
üyelerinden	None
eğitecek	Future
vurdu	Past
fakire	None
bilmiyorsun	Present
doğurmaz	Present
sevmiyordu	Past
cisimlerden	None
doğurur	Present
beldesi	None
kayboluyor	Present
şamisenlerinizin	None
garbımı	None
start	None
savaşçıyı	None
haritanızın	None
ölüyorum	Present
uyarırlar	Present
birleşeceksiniz	Future
üşeneceksiniz	Future
bozmadım	Past
okumam	Present
giyer	Present
eşyalardın	Past
uçurtmaların	None
söner	Present
sunulmadı	Past
gezerim	Present
attırmadınız	Past
kuvvetten	None
oturuyordum	Past
haberleşirler	Present
pandaları	None
merkezlerin	None
boksun	None
anneliğin	None
ağaçkakana	None
doktorum	Present
buzullardın	Past
öldürttüler	Past
atılmayacak	Future
verdirtdi	Past
metreslerdim	Past
migrenden	None
geyim	Present
matlalardınız	Past
kakıyordunuz	Past
izliyorum	Present
izleyici	Present
telaffuzlardınız	Past
dondurmanın	None
savunuyorsunuz	Present
sildin	Past
bayın	None
ongunlara	None
uyanacak	Future
garajına	None
buharlaşırsınız	Present
yatağında	None
kolonya	Present
seçersiniz	Present
oluyordu	Past
kardeşlerim	Present
dönmedin	Past
öldürüyor	Present
alacağız	Future
uyandı	Past
bitirteceksin	Future
kokmayacaksınız	Future
kıldım	Past
kipalarıma	None
tanıyoruz	Present
camilerinin	None
salmaz	Present
erkeneğe	None
yapmıyoruz	Present
tanıtıyorum	Present
seçmeni	None
yarattı	Past
yoldurursun	Present
örüyordunuz	Past
getiriyorum	Present
olmam	Present
çevirecek	Future
katillerdik	Past
koyacağız	Future
onardılar	Past
azmıyorsunuz	Present
Tiranlıyım	Present
papa	Present
çizgilerdir	Present
lokummuşuz	None
heyecanlandırtıyor	Present
kürküne	None
göndermedi	Past
teşkilatlar	None
evlenmedi	Past
kazandınız	Past
denizanası	None
üyeliklere	None
homoseksüel	Present
olmuyoruz	Present
kazanıyordu	Past
seçilmiyor	Present
teper	Present
profiterol	None
dövüşüyordu	Past
satırtacağım	Future
okullarda	None
kovulacağım	Future
götürdüm	Past
öğütüyorlardı	Past
kabuklarında	None
çalgıcı	Present
heteroseksüel	Present
kocası	None
kazan	None
sezmiyorum	Present
sporcuydu	Past
öldürdünüz	Past
horluyorlar	Present
imam	Present
geçiyordum	Past
bitirttiririm	Present
kovuldu	Past
okumuyorum	Present
bastonlarınızda	None
ayakkabılarmışsın	None
tanıtacak	Future
umuyorum	Present
gülmedim	Past
çalışmalardan	None
yakınlardır	Present
siliyorum	Present
kazıdı	Past
gösterdim	Past
Yahudilerinden	None
bandajımın	None
yangından	None
asansörün	None
tercihin	None
kurbağalamasına	None
katılmayacağım	Future
yetmediniz	Past
sunmadım	Past
yaratmadım	Past
haberiniz	None
pişirirsiniz	Present
düşünmez	Present
dövüşür	Present
dinmez	Present
oğlancılarınızda	None
programlandı	Past
götürürler	Present
odaya	None
kaynaştırtılırsın	Present
çarparlar	Present
bitiyordu	Past
yüzüncüyünüzde	None
koymaz	Present
bakmıyorsun	Present
yalvarıyordu	Past
çarpmazsınız	Present
tanrılardır	Present
kesiyorum	Present
bitmiyor	Present
otofobiye	None
yapışmam	Present
olmuyorlar	Present
anlatıyordu	Past
inecek	Future
yıktı	Past
sonuçtu	Past
kıracak	Future
katılırım	Present
sarılıyor	Present
mıknatıslarımı	None
kullanılmayacak	Future
gelmeden	None
uğratmayacak	Future
diyorum	Present
ülkelerdir	Present
gücenmiyorsunuz	Present
grubunu	None
yerleşecek	Future
öpüşüyorsunuz	Present
geziyordu	Past
duruyorsun	Present
fizikçiydi	Past
anacak	Future
ittirtileceğim	Future
yaratacak	Future
vadeden	None
uluslarda	None
örmedi	Past
kaynaştırılıyorsunuz	Present
çeyreğin	None
oluyorsun	Present
boğanın	None
kapasitesinden	None
astım	Past
sunulur	Present
dizdin	Past
referanslara	None
duyuyordu	Past
şaştım	Past
gezersin	Present
ölürüm	Present
kirişlerini	None
taslağa	None
yapmadılar	Past
olmaz	Present
olacak	Future
ceylanda	None
parlatıcıydın	Past
arıyorlar	Present
kaynarız	Present
fişeklersiniz	Present
veririz	Present
hastalıklar	None
çırağını	None
kesmedim	Past
saklandı	Past
anlatıyorlar	Present
koyuyoruz	Present
duyarsınız	Present
komikleşmiyorum	Present
küçükler	Present
heyecanlandırmıyordun	Past
kullanıcılardır	Present
geliştiririm	Present
hedeflerin	None
düşünmüyorsunuz	Present
öperim	Present
yanar	Present
kesmiyordular	Past
kumaydılar	Past
kaçmaz	Present
çarşılarımızın	None
baharda	None
saklamıyordunuz	Past
yapmazsınız	Present
öfkelendiriyordunuz	Past
vermeyecekler	Future
yedeklere	None
parçalanmazsın	Present
kaldılar	Past
deniliyordu	Past
hemşireleri	None
mutsuzum	Present
tecrübelere	None
haberlerini	None
düzeliyor	Present
yerleşti	Past
getiriyorlar	Present
kalıyorsun	Present
dedikodumdan	None
yaratıyorlardı	Past
deneylerini	None
rahiplerine	None
kalkar	Present
akşamı	None
dindar	Present
tepiyor	Present
ayırırım	Present
şahı	None
sapmayacaksın	Future
bekletmiyorsun	Present
kaçaklardan	None
göstermiyordu	Past
rahatsızlanmaz	Present
küçüğüm	Present
yıkmadın	Past
ürürler	Present
birleştirteceksin	Future
dondurmadık	Past
soğurmuyorsunuz	Present
sunmaz	Present
okuyorsun	Present
otellerimde	None
sayımların	None
golünü	None
vazolardınız	Past
kaynaşacak	Future
salarlar	Present
değişti	Past
avukat	Present
dediniz	Past
komikleşiyordunuz	Past
teptiler	Past
açılırlar	Present
duyuyordum	Past
üzülürüm	Present
yürekten	None
getirdiniz	Past
gömleği	None
bölerler	Present
balamozlardık	Past
varırsınız	Present
dilberi	None
laboratuvarlarının	None
yoldurttum	Past
kovboyların	None
çizmeci	Present
götürüyor	Present
kapattı	Past
kurumda	None
yakın	Present
kervansarayları	None
yağar	Present
örtüde	None
okudunuz	Past
istiyordum	Past
emmi	Present
vurgulardık	Past
rakımın	None
yerleşmedim	Past
yakınız	Present
protestolara	None
gişeye	None
dirsekte	None
listemizde	None
Nusayrî	None
koku	Present
yardımcıya	None
oynarlar	Present
davranırlar	Present
dövüşlerinizi	None
gürgen	None
yasasında	None
şüphesini	None
inandık	Past
bulunuyorlar	Present
öbekleri	None
dirilmemeyeceğim	Future
masalları	None
bulunmadın	Past
öğütür	Present
açıldınız	Past
çanlarının	None
yüzüncülerdik	Past
tabansızdı	Past
inanmıyorum	Present
izliyorlar	Present
albümlerden	None
güleriz	Present
almıyorum	Present
odam	None
gizlemezler	Present
sokaklarına	None
gelmedin	Past
ziyaretçinin	None
milyonerin	None
varoşlarına	None
eldiven	None
verdirmeyecekler	Future
değişmedi	Past
fakültesinin	None
ayı	Present
rüzgarda	None
öfkelendiriyorlar	Present
piyanosunu	None
kalır	Present
alçak	Present
almıyorsunuz	Present
eskemeyecekler	Future
ıspanaktan	None
maymunlardır	Present
gelmelerinin	None
piyano	None
zulümleri	None
yaptık	Past
sempozyumunda	None
cikletimizi	None
masumiyetlerdir	Present
sürüyorlar	Present
aleme	None
filim	Present
değiştirmem	Present
varmıyor	Present
dizdiler	Past
atmamadınız	Past
yaymazlar	Present
özelsiniz	Present
öykü	Present
görmedik	Past
bayılmazsın	Present
yolculuklarına	None
gelmezler	Present
duyar	Present
yasaklarının	None
taşırız	Present
dönmez	Present
birleştirmez	Present
derdim	Past
bağlamıyordunuz	Past
burunda	None
ömrümüz	None
koltuğu	None
buluttan	None
çağırdılar	Past
lezyona	None
iletmeyeceksin	Future
kâğıtlardan	None
taşıdılar	Past
erimeler	None
izlencemize	None
kapamaz	Present
geçtim	Past
yıpratmadınız	Past
okuyacak	Future
yandık	Past
yayıncılığını	None
korsanlarım	Present
götürdüler	Past
müşterilerden	None
şaşırtıyorlardı	Past
güreşçiydiler	Past
gelişiyor	Present
bulurum	Present
pisletmedi	Past
kaygılar	None
fillerdir	Present
beklerim	Present
kullanıcıyım	Present
artacak	Future
öğretmenine	None
geliyoruz	Present
üyeydiler	Past
başardım	Past
uçacak	Future
verilmez	Present
cebini	None
usullardan	None
inanırım	Present
sevmez	Present
barbarlar	Present
çeliğimizden	None
özelsin	Present
kaçakları	None
paraya	None
ilkelerini	None
tiplerine	None
artıklarının	None
mantıklısın	Present
tundralardık	Past
kesesinin	None
balamozlarsınız	Present
kaynıyordu	Past
radyosunu	None
bağımlılıkları	None
taslağının	None
döktüler	Past
anasızlığınıza	None
karşılar	None
sayımı	None
oynamadılar	Past
dağılıyor	Present
dağılırlar	Present
ayakkabıydılar	Past
karıştırdı	Past
tükendim	Past
gönderiyordu	Past
unuttu	Past
delisin	Present
saklayacağım	Future
noktalarım	Present
üzdü	Past
kovuldun	Past
ışındık	Past
kesiyordu	Past
üstveri	Present
sunulurlar	Present
böceğine	None
dadı	Present
kaldın	Past
açarız	Present
oyaladı	Past
utandırmam	Present
mandallardınız	Past
ölümsüzleştirdi	Past
almazlar	Present
yaprağın	None
mastürbasyon	None
yanağına	None
kırılmaz	Present
giriyordum	Past
kamçından	None
alametlerinin	None
alametlerdin	Past
dağlara	None
izleriz	Present
dönüyordun	Past
acayip	Present
fagot	None
doğuyordu	Past
karneydi	Past
yaklaşıyorsunuz	Present
süpürgeleri	None
tükürür	Present
harçlıkları	None
kapadı	Past
çalıyorlardı	Past
idadide	None
soğumuyordun	Past
şerbetçilersin	Present
acemisin	Present
saldırmıyordum	Past
müstahdemlersiniz	Present
gerekiyor	Present
girdapsın	Present
getirdin	Past
yığar	Present
evleniyordunuz	Past
götürecek	Future
benziyordu	Past
ölümüz	Present
sıçan	Present
çökeriyorlardı	Past
yasakların	None
ittirtmezsin	Present
korkarlar	Present
yazmayacağım	Future
verilmiyordu	Past
nedenlerdir	Present
öküzlere	None
topluyor	Present
indeksi	None
dönerim	Present
tartmıyorlar	Present
yaptırtacaksınız	Future
nohutların	None
yersiniz	Present
durağımdan	None
cihanda	None
bindi	Past
kaplanının	None
yapıyorduk	Past
kullanıcıydım	Past
yasası	None
patlıyordu	Past
üşüdük	Past
geliştiriyor	Present
vezirdi	Past
satıldılar	Past
ürker	Present
üzüldüler	Past
yetişecek	Future
referansında	None
deistlerinize	None
gidilmezsin	Present
gerekiyordu	Past
devin	None
yönü	None
kullanıcıydı	Past
yitiyordunuz	Past
kazmayı	None
inanmam	Present
savaşıyorlardı	Past
istediniz	Past
seçmedim	Past
dolmuyordun	Past
çukurlara	None
adınıza	None
bağladım	Past
kaçtık	Past
buldu	Past
tanıtırlar	Present
gerekti	Past
uyanır	Present
sözlük	Present
kapak	Present
umuyorlardı	Past
unuturuz	Present
bulmuyoruz	Present
intiharlarınız	None
giymezler	Present
kapayacak	Future
baydı	Past
papatya	Present
bereketin	None
şapkacımızda	None
sustum	Past
dışında	None
koordinatlarımı	None
derim	Present
düşündünüz	Past
geliştirdiler	Past
gücenmiyorlar	Present
eklerden	None
makina	Present
yıpranmıyorlar	Present
toplar	Present
durmaz	Present
yapışıyorduk	Past
bölüyorlardı	Past
kaslardan	None
yorumlarına	None
bilemem	Present
andım	Past
sağlarız	Present
soymuyordum	Past
valizi	None
siler	Present
tanıyacak	Future
yolmayacağım	Future
bakmıyordu	Past
çalgı	Present
sökmüyoruz	Present
alındırırsınız	Present
başarır	Present
büktürültünüz	Past
osururlar	Present
yapıyorlardı	Past
dönüyor	Present
saldırıyorlar	Present
prostat	None
vazo	Present
boyacısınız	Present
büyükler	Present
mayonezlerimizi	None
kılavuzuz	Present
bittim	Past
uzanıyor	Present
türemiyoruz	Present
bilemiyoruz	Present
ibne	Present
katından	None
yapmayız	Present
davranmıyordular	Past
ayakkabılara	None
buladı	Past
götürmüyor	Present
kıyısında	None
seçmedi	Past
bildirdim	Past
güveniyor	Present
sarmaşığın	None
birlikteliğinin	None
lordundan	None
balkanlardır	Present
basmadı	Past
tanımadım	Past
yazmalarının	None
altınları	None
otomobilciliğiz	Present
korunmasının	None
göndermiyorlar	Present
tavanlarını	None
girdaptan	None
ölülerdim	Past
gösterirsiniz	Present
çevirmedim	Past
dağıldılar	Past
beyitten	None
içermez	Present
ilçelere	None
göstermez	Present
havuzlarda	None
ekimin	None
yerleşiyordu	Past
çıldırtmıyor	Present
atmamayacaksın	Future
kalıyorlardı	Past
çıkacak	Future
fizyolojiye	None
alameti	None
gülmeyecek	Future
içerirler	Present
abajurcuydunuz	Past
konduk	Past
sezer	Present
iffetinizde	None
geçiyordu	Past
yersin	Present
bitmiyorum	Present
onadın	Past
vezirsiniz	Present
gördüler	Past
örter	Present
üzüyordu	Past
keçi	Present
çardı	Past
kazanıyor	Present
kaldı	Past
çarpıyor	Present
korkutacak	Future
koyunuz	None
erdemli	Present
aldırıyordu	Past
soğuyordunuz	Past
izleyicisinin	None
öğretisine	None
karıncalardın	Past
seviyordu	Past
ucumuzu	None
cismimizde	None
eğlendi	Past
açıyorlar	Present
açılacak	Future
aldattım	Past
üyelerine	None
onur	None
tuttun	Past
aşmıyorlar	Present
müzikalden	None
üzgünsün	Present
bıkacağız	Future
çıkardılar	Past
onamıyorduk	Past
kıracağım	Future
kıyafet	Present
zağardın	Past
sunacağım	Future
amcaydın	Past
şaşılacaksınız	Future
varoşlarından	None
geçiniyorlardı	Past
öldürüyorum	Present
keserler	Present
paylaşacak	Future
yoldaşları	None
satılacak	Future
yazarız	Present
takmaz	Present
hüzünlere	None
oyundan	None
küçüldü	Past
pehlivanların	None
ayrılmaz	Present
öğütücüydük	Past
embriyoydun	Past
işkenceci	Present
doğuyorum	Present
cisim	Present
davranıyor	Present
kapatmıyorum	Present
alacak	Future
yuvarlar	Present
deist	Present
kazanıyoruz	Present
yapmazsın	Present
bitiyor	Present
kod	None
futbolcuyum	Present
tanırsınız	Present
tarayacak	Future
helvası	None
Cakartalılarım	Present
ayrıldı	Past
yazıyorsun	Present
kazandı	Past
yoksullaştırmıyordunuz	Past
bitiyorsunuz	Present
verisine	None
kımızlara	None
andık	Past
bitirtmiyorsunuz	Present
dadılarımıza	None
Duşanbeliydik	Past
anjiyografilerimde	None
düşündün	Past
kıro	Present
uçuyordu	Past
yapılmadı	Past
tarihçilerdin	Past
fahişe	Present
çeşnisi	None
içeriyordu	Past
fakirleştirdik	Past
taramayacaksın	Future
Monakoluydum	Past
girdik	Past
kutsallığa	None
yazıyorlardı	Past
sığacaksınız	Future
çizgilerden	None
ağdacıydım	Past
solumuyordular	Past
yaklaşıyoruz	Present
ölürsün	Present
uyuşturucularımızdan	None
deneyimlerin	None
enfeksiyonların	None
takıyordunuz	Past
jelatine	None
aramaz	Present
karakterlerdir	Present
sporcularda	None
tadının	None
bağlıyorlar	Present
büyülü	Present
atılmayacağız	Future
bekleyeceksin	Future
inmeyecekler	Future
unutuyorsunuz	Present
yaralardır	Present
vedalarıma	None
gitarın	None
erdi	Past
kapatıyorlar	Present
hacı	Present
çürümeyeceğim	Future
kalacaksınız	Future
modelinden	None
iskeletlerin	None
kaside	Present
rehberlerinde	None
ayarlatmıyordunuz	Past
kuğusun	Present
önerimin	None
sucuksun	Present
büyüyordu	Past
babasızlarsın	Present
birleştiler	Past
ağlaşadım	Past
öğrencilerimize	None
bayılıyor	Present
dolabından	None
bakmıyoruz	Present
toplumlarında	None
eğdi	Past
bilgin	None
etkiliyorlar	Present
yıpratıyorlar	Present
uyarıyorum	Present
yolduruyorlar	Present
inandılar	Past
güvenmiyorsunuz	Present
bulursunuz	Present
uğratırlar	Present
dökerler	Present
duymadık	Past
üşenirim	Present
rehineyi	None
dokamadılar	Past
şeyini	None
ağlayacağım	Future
yapacağız	Future
bildirdi	Past
kulduk	Past
hayırsever	Present
izliyordu	Past
düşmüyordu	Past
mühendisliğe	None
öpüşür	Present
asitten	None
yamuğun	None
dalgalanmadı	Past
uyardım	Past
saydırmıyor	Present
bağımlılık	None
bulunurlar	Present
aştı	Past
tartıyor	Present
kıskandı	Past
yetiştik	Past
severiz	Present
uçuyorum	Present
vururum	Present
takıyorlardı	Past
kavimler	None
uçurtmayım	Present
salacağım	Future
leylekten	None
okyanus	None
bozayısı	None
miskettiniz	Past
döndüm	Past
sonranın	None
sosyoloji	None
saçar	Present
ettiriyorum	Present
aldırtacağım	Future
inanır	Present
kazandım	Past
server	Present
anketlerde	None
geliyor	Present
vaktini	None
katmadım	Past
bahtsız	Present
darıldın	Past
öldürürsün	Present
küsmeyeceksiniz	Future
değirmeni	None
sinirlendirmiyordu	Past
çalışmadılar	Past
girdin	Past
tiyatroda	None
bakarız	Present
artmıyordum	Past
çıkmıyoruz	Present
defterlerinin	None
yasak	Present
peskütanlarımızın	None
çıkıyordu	Past
yorgunluktan	None
istersiniz	Present
kılıflar	None
masumum	Present
kâğıda	None
eğitimlerimize	None
fil	Present
duymaz	Present
derleyicilerini	None
demedi	Past
geçecek	Future
güvenlerden	None
yalvarıyorum	Present
sınar	Present
güzün	None
nüfuslar	None
yollarında	None
yollarından	None
kimliklere	None
çalıştınız	Past
kağıdının	None
Kürtlerden	None
boğazımda	None
ettireceğiz	Future
savaşçıların	None
diyordun	Past
değişkenlerde	None
aldırtmamıyordunuz	Past
albümünden	None
içermiyordu	Past
bekledi	Past
düşmanından	None
vapurlarıma	None
kaydediciler	None
hücrelerinden	None
çıkacağım	Future
işlemedim	Past
kızgınım	Present
ustaydım	Past
dondurmam	Present
övgüyü	None
tepmiyordum	Past
yaratıyorlar	Present
artar	Present
çizmezsiniz	Present
kenarlardan	None
işitmez	Present
duyuyorum	Present
sınırlarda	None
manti	Present
titriyordu	Past
basıyorsun	Present
değiştirdiler	Past
sesleniyorlardı	Past
kesesi	None
hisler	None
kuruma	None
sevmedin	Past
durumu	None
kalkmıyorum	Present
görüşümden	None
derecesine	None
amaçlardan	None
sempozyumuna	None
eşya	Present
çizgilerine	None
gizledim	Past
gelmiyor	Present
katıyordu	Past
diyorlardı	Past
ölüyordu	Past
kalkıyordu	Past
âlimlerdin	Past
atletik	Present
verilmedim	Past
isterler	Present
örtüyor	Present
kullanıyorsunuz	Present
yalancı	Present
abartmayacaklar	Future
eğerler	Present
ovmadım	Past
yazdınız	Past
değiştirmeyecek	Future
kelliğinin	None
evleniyor	Present
yenilmez	Present
tümceydiler	Past
embriyonuzun	None
çevirdi	Past
eğitimlerini	None
okumuyorsun	Present
makta	Present
göbeklerine	None
fişek	Present
işletimlerdik	Past
savaşından	None
çevirir	Present
misketsin	Present
işittik	Past
yaklaşmadı	Past
pasif	Present
zibillerim	Present
ısırırlar	Present
kaçamağı	None
kestim	Past
periden	None
sıyırdı	Past
koyuyordu	Past
rakamına	None
sözcülerdik	Past
titremiyordular	Past
katılaştırmıyordunuz	Past
alışırım	Present
huzurlu	Present
tabancalarına	None
avlarınız	None
kanıtlamıyordu	Past
yabancıydı	Past
sağacağım	Future
gösterecekler	Future
örnekti	Past
yongam	None
üzülmedik	Past
striptizinizde	None
kuklanın	None
sendromlara	None
yayacak	Future
öğretir	Present
tenisçilerin	None
kullanmıyorsunuz	Present
teorilerinin	None
dulu	None
Yahudilerde	None
çevirirler	Present
iffet	Present
müzikallerinde	None
kavağı	None
ölümüm	Present
eridiler	Past
hazırdın	Past
savundular	Past
koktular	Past
basım	Present
kesiyordunuz	Past
unundan	None
adınız	None
evrim	Present
kuvvetti	Past
yolunmayacaklar	Future
kılıyor	Present
ombudsmansınız	Present
duyduk	Past
bitirdim	Past
elementlerin	None
odacı	Present
şampiyonluğumuza	None
şerbetçilerinizden	None
psikiyatrı	None
baykuşların	None
dirilecek	Future
insanımsılardır	Present
sultandı	Past
göndereceğim	Future
köçektiniz	Past
kullanıcı	Present
canlandırılmazlar	Present
savaşını	None
barıştılar	Past
kızmıyoruz	Present
varacağım	Future
tutuyordu	Past
yapılar	None
yalancının	None
geysiniz	Present
biniyor	Present
koyuyorum	Present
küsüyorum	Present
kullanımlarından	None
maratona	None
gösteriyorsun	Present
paylaşacağım	Future
mantıksız	Present
barışmadın	Past
seviyorlardı	Past
ahtapotunun	None
sönüyorlar	Present
cephelerinin	None
görmüyorduk	Past
erkeceylermişim	None
uymuyorlar	Present
babacandı	Past
bağ	Present
gelmez	Present
kanıtlar	Present
çökermedin	Past
uçarlar	Present
sandviçe	None
bloguna	None
duydunuz	Past
benziyor	Present
bekliyorlardı	Past
bakıcıları	None
yazmıyor	Present
dinozorsunuz	Present
pipet	Present
seyrettiler	Past
telefonun	None
bitirttirmedik	Past
gidiliyoruz	Present
kaptı	Past
içtim	Past
kotları	None
bölgesine	None
kapadım	Past
kalmayız	Present
yapışır	Present
görürüz	Present
aşar	Present
kazmalarımıza	None
çizgi	Present
eğilir	Present
binmez	Present
kısmıyordun	Past
düzelmez	Present
yetmedin	Past
itilirler	Present
gerecek	Future
değiştirir	Present
izliyoruz	Present
kurtarır	Present
dalarlar	Present
öpüşmüyorduk	Past
sindirdin	Past
yazacağız	Future
fakirleri	None
sağım	Present
başarılıydı	Past
yüzeyinden	None
eğlenmeyeceksin	Future
inmedi	Past
soğuruyordun	Past
bulacak	Future
girecek	Future
çorapta	None
fulyaları	None
üzülüyorum	Present
filmde	None
çokgen	None
dul	Present
keçiyim	Present
mallardır	Present
kısar	Present
kulum	Present
seçmiyoruz	Present
avları	None
kazanıyorlar	Present
akreptiniz	Past
sevdim	Past
uyarıyoruz	Present
tanışıyorlar	Present
üzgün	Present
parlatır	Present
ikilemimizde	None
okuyordu	Past
akrep	Present
saklanır	Present
yolcusunun	None
kırmadım	Past
evrimlersiniz	Present
değiştiriyordu	Past
tercümeden	None
temsilci	Present
öğrencilerdir	Present
karakter	Present
kullanılır	Present
silkeceğiz	Future
yavrularsınız	Present
Musevi	Present
kalıplarını	None
bayılması	None
vezirin	None
artacağız	Future
daldırtmayacaksın	Future
korsemizi	None
yarayacak	Future
flaşlardım	Past
düşüyordu	Past
frekanslarından	None
peçetelerdiniz	Past
mermi	Present
öğretimin	None
toplumumuz	None
hocasın	Present
sunularmışım	None
tanımadı	Past
kalesine	None
ağlarsın	Present
kırdım	Past
üyeliğin	None
bulamıyorum	Present
üşüdüm	Past
battaniyesi	None
konum	None
katkılara	None
verecek	Future
öldürmeyeceksin	Future
işçilerdir	Present
nişanlıydı	Past
bekleyeceğim	Future
oynuyorum	Present
papalara	None
eklerdir	Present
huzurlarında	None
şaşırdılar	Past
alametiz	Present
açacağız	Future
mantiydi	Past
katılırız	Present
goller	None
sevişmeyeceğiz	Future
kaplumbağa	None
ortam	Present
tanırız	Present
oldular	Past
sululuğunuzu	None
lügatçenin	None
ağaçkakanınızdan	None
yayarsınız	Present
ilklendiriyordunuz	Past
lokantaların	None
bulunuyorsun	Present
gününde	None
gelirim	Present
eğitmiyor	Present
yer	Present
büyümedi	Past
müzisyene	None
savaşmıyordu	Past
öpüyorum	Present
kanallar	None
böbreğini	None
vişnenin	None
kullanacaklar	Future
pozisyonuna	None
susuzluğun	None
kazması	None
savunuyoruz	Present
kalkmaz	Present
vermiyoruz	Present
saklıyorum	Present
elmaslardım	Past
toplayacaksınız	Future
çıkarmadı	Past
barbar	Present
parçalanırlar	Present
özetinin	None
eşantiyonumu	None
görmeyiz	Present
deler	Present
bilecek	Future
torunlardınız	Past
yardımcısının	None
nedimeleri	None
kırarlar	Present
mistik	Present
seçerim	Present
kanıtlayacağım	Future
gerekmem	Present
duyuyorlardı	Past
süslersiniz	Present
listelerinde	None
sileceğim	Future
Türkçeleştirmiyordum	Past
elipslerine	None
beklemiyordum	Past
aseksüellersin	Present
ölçmüyordunuz	Past
büyüktü	Past
oldun	Past
bulundu	Past
öğretmem	Present
kıydılar	Past
donduruyorsun	Present
hazırlıkta	None
sürgünlerden	None
dönemi	None
samuraylardan	None
kolaylıklardan	None
kaçırmadınız	Past
kandı	Past
tuttu	Past
ortağından	None
dansçıyı	None
ayrılmıyor	Present
asidini	None
üretecek	Future
izliyorduk	Past
dansçının	None
korsanlarına	None
kazanacağız	Future
bakire	Present
vilayetten	None
kloroplastlar	None
güldük	Past
abajurumun	None
gerekmiyor	Present
vedası	None
günümü	None
iyileştirdiler	Past
sunucuyuz	Present
tahtına	None
aşmadı	Past
ispatladılar	Past
gerinmiyorduk	Past
sanırım	Present
görüyorsunuz	Present
aldılar	Past
oyuncaklardır	Present
bezmiyordum	Past
basmaz	Present
iletmezler	Present
acemilerin	None
otomobildi	Past
sendrom	None
çelik	Present
cihanın	None
yontulmayacak	Future
ölür	Present
kullanıyorlar	Present
ortamlardır	Present
kireçlerinizi	None
irdeler	Present
donduracak	Future
güveniyoruz	Present
ılımadım	Past
bakmıyordunuz	Past
kaldıraçtın	Past
toplardan	None
bölmüyordum	Past
unuttuk	Past
kataloğunda	None
inanıyordun	Past
sıvılaşır	Present
ayıracağım	Future
yiter	Present
sümürüyoruz	Present
unuturum	Present
davranıyorsun	Present
yarasın	Present
benzedi	Past
atışacak	Future
içermezler	Present
fişeğe	None
keşfettiler	Past
aksanına	None
savundu	Past
ece	Present
geçtiniz	Past
barbardınız	Past
çıkarıyoruz	Present
davranacaksın	Future
şeyim	Present
güreşçilerin	None
yiteriz	Present
kurulunu	None
yandım	Past
andan	None
şivesinde	None
bilgisayarlı	Present
unutmayacağız	Future
burktu	Past
emer	Present
örmezler	Present
patlar	Present
mermilerdir	Present
bilemeyeceğiz	Future
sevdin	Past
seçilmedi	Past
çıkmadım	Past
yönetimini	None
koyuyorsunuz	Present
arayacak	Future
yaklaşıyordu	Past
sığacak	Future
oturmaz	Present
koydun	Past
dizdi	Past
geyiklere	None
bulacaksınız	Future
giyecekler	Future
fanusun	None
beyit	Present
çaldık	Past
tutulmayı	None
tercihlerini	None
kılları	None
patlayacak	Future
başlangıçtan	None
bazaltı	None
avcı	Present
öpüşmeyecekler	Future
parlatıcı	Present
tanımıyordum	Past
cümle	Present
geliştiririz	Present
bilemiyorum	Present
zafer	Present
penisilinin	None
yetersizlik	Present
olmayacak	Future
kaybolmaz	Present
uçlara	None
değiştiririz	Present
kasar	Present
sürünmedim	Past
izledim	Past
yamyamlardım	Past
övgüde	None
düşerim	Present
anıyorum	Present
yetmez	Present
birleştireceğim	Future
almadı	Past
yendirtmiyordum	Past
çandık	Past
demem	Present
kedileri	None
ettirtmiyorsun	Present
dikişin	None
vahaydı	Past
ileteceğim	Future
tutacaklar	Future
susar	Present
varmaz	Present
acımadılar	Past
parçayı	None
göstermiyorlar	Present
ettiriyorlar	Present
tuttum	Past
umutsuzdu	Past
şaşırdım	Past
büküldüm	Past
istemiyorlar	Present
sayacak	Future
asmadı	Past
heyecanlandırdı	Past
yaratmadan	None
pişmediniz	Past
coşmuyorsunuz	Present
kömümüzden	None
takıları	None
yarışmalardan	None
antropolojide	None
çalışıyordum	Past
primitifiz	Present
geldim	Past
saymam	Present
köylülerde	None
soğuyacak	Future
çizdiler	Past
sıvılaştırmayacağım	Future
azdı	Past
pederdiniz	Past
örtecek	Future
sitesinin	None
güvenmez	Present
katılaşacağım	Future
saklanıyor	Present
tayfalardınız	Past
yarasa	Present
dakikalarımızdan	None
tariflerimin	None
gerekmiyorum	Present
belden	None
taşımam	Present
vurmuyordu	Past
dağıtıyordu	Past
öksürmeyecek	Future
lezyonu	None
hasta	Present
öpüştü	Past
geçiyor	Present
tanıdı	Past
giderlerinde	None
aşlar	None
vampiriz	Present
bilmez	Present
tanıtacaklar	Future
acımadım	Past
bamyasını	None
yamyamdın	Past
davranmazsın	Present
geciktirir	Present
önemini	None
mobilyalarını	None
seslendiler	Past
seçer	Present
keseleri	None
davranıyorlardı	Past
ölçülüyordunuz	Past
paralelkenarın	None
vermeyecek	Future
kovdurduk	Past
tutacak	Future
satıyordum	Past
aygırı	None
aşkımı	None
beldelerimden	None
nene	Present
kapatıyordu	Past
işler	Present
yanlışsın	Present
otellerinden	None
dışkılarının	None
fırınlarsın	Present
yola	None
eşcinsellere	None
sivrisineğimizin	None
kaçıyor	Present
yitmedin	Past
plektrumlarının	None
şaşılacak	Future
coşkuya	None
üyelerimizden	None
kattılar	Past
doğduk	Past
temsilcilik	Present
kistin	None
yaydılar	Past
nöronlarını	None
artacaksın	Future
üreticilerinden	None
kayboluyordu	Past
düzeltirim	Present
kullanım	None
üretici	Present
değiştiriyorum	Present
ilkeyi	None
mektupları	None
mutsuzsun	Present
öğrenci	Present
hece	Present
giymez	Present
doğu	Present
filozoflarımızdan	None
bokslarımız	None
bölümünüzü	None
benziyorsun	Present
kalkmadı	Past
öncelerde	None
geğirirsiniz	Present
canlandırılacaklar	Future
çerçilersiniz	Present
karadulları	None
dışımda	None
öğrenecek	Future
osurmuyorsunuz	Present
bilmiyor	Present
haritasında	None
çalıştılar	Past
oynamam	Present
açmayacak	Future
veriyorlar	Present
yumuyordum	Past
İngilizceleştirmiyor	Present
ustaydı	Past
çarmıhı	None
kullanıcısın	Present
birleştiriyordu	Past
yağışlarda	None
akvaryumunun	None
uydulardır	Present
güvercin	Present
jokeylerin	None
çağırmaz	Present
uyduydular	Past
yetmeyecek	Future
takarlar	Present
düzersin	Present
gizleniyor	Present
soğururlar	Present
katılır	Present
dilberdim	Past
bulacağız	Future
hocası	None
tatlılardır	Present
çöpçatan	Present
cinselliğe	None
sapmıyorum	Present
elmas	Present
çıkacaklar	Future
cezalandırırlar	Present
uyumaz	Present
solur	Present
derini	None
dondurmuyorsunuz	Present
iletiyordu	Past
ağlayacaksınız	Future
üşüyorum	Present
doğuruyor	Present
sıpasından	None
çalıyorum	Present
soğuyordum	Past
kullanırsınız	Present
kuyularının	None
benzemiyor	Present
futbolcuları	None
büktürtülür	Present
bülbül	Present
basketbolcuydum	Past
fırçanın	None
erimiyordu	Past
kullanıcısınız	Present
uzağız	Present
öldürmedi	Past
doldun	Past
tarttım	Past
unutmadı	Past
ayının	None
laçolardır	Present
seçilmiyorsun	Present
yetiştiririz	Present
sıkmam	Present
gelişiyordu	Past
satırtmadık	Past
kümesleriz	Present
kullanmamı	None
üzülmem	Present
platformda	None
voleybolcuların	None
otomobilciliklerimizden	None
verdiniz	Past
babacandım	Past
boyacı	Present
istemem	Present
demeyeceğiz	Future
bitirdiler	Past
saydırtmıyorlar	Present
zombilere	None
gelinmez	Present
göçlerinden	None
mısramın	None
büyücüydü	Past
kaplanları	None
götverensiniz	Present
taşıdım	Past
aktördün	Past
ayakkabı	Present
imrenmedik	Past
mutfağından	None
gelişmedi	Past
bıyıklar	None
katıyor	Present
uyacak	Future
kıymadılar	Past
dedikoduyu	None
bulacağım	Future
sargılarımızın	None
yendirmeyeceğim	Future
doğurmuyor	Present
alışmam	Present
karakterimizin	None
ayrılmaya	None
avın	None
delirdik	Past
kanıtlayacak	Future
iğneler	None
kaçırıyorsunuz	Present
ulamda	None
lunaparktınız	Past
kataloğun	None
sıvıların	None
umuyorsun	Present
toz	Present
katılaşıyordum	Past
giymiyordun	Past
kurtarmaz	Present
kestiler	Past
hanımlardım	Past
tanıtır	Present
dikkatlerden	None
kırılacak	Future
solucan	Present
ışın	Present
hindi	Present
imamlara	None
bilyelerin	None
meni	None
bedevi	Present
soyarlar	Present
şelaleleriz	Present
indirimimde	None
değerliydi	Past
kolonuz	Present
döküyor	Present
serper	Present
yönünü	None
yangın	Present
işçiymiş	None
olmuyordu	Past
taçları	None
güvenirler	Present
koydum	Past
saymıyoruz	Present
kasidelermiş	None
bağım	Present
evleniyoruz	Present
dalgalanıyor	Present
amatörlerdin	Past
istemcilersiniz	Present
kocam	None
girmiyor	Present
sunmuyor	Present
ağırlar	Present
düşmanlara	None
değiştirmiyor	Present
gelmedik	Past
öldüm	Past
dalgalandırdın	Past
yorumu	None
katılmadılar	Past
asalarıma	None
seçilecek	Future
hastanede	None
kaplanlarınızda	None
gitarlara	None
kandillerde	None
hanım	Present
güvenmiyoruz	Present
mekiğinden	None
sayfalardır	Present
içerdi	Past
Türkçeleştirdiniz	Past
sunacaksın	Future
birleştirtir	Present
tepersiniz	Present
jeolojide	None
erimez	Present
veriyorsun	Present
ünlerine	None
unutmazlar	Present
gerdi	Past
yaklaştık	Past
kağıttan	None
taşımaz	Present
menin	None
marangozların	None
teoremler	None
işkencecilersin	Present
canlandırtılıyor	Present
sözlükçü	Present
üzer	Present
ağımıza	None
davranıyorsunuz	Present
kızarlar	Present
koordinatlar	None
tıkladım	Past
çağırıyorlardı	Past
aramıyor	Present
damlanın	None
kirpi	Present
deneyinizden	None
hastalıkları	None
paten	None
sikiliyorlardı	Past
geleceksin	Future
köylüyüm	Present
seçecek	Future
azmazlar	Present
emniyetten	None
çağırıyor	Present
saymadı	Past
sunarım	Present
seçiliyor	Present
yufkan	None
germiyordun	Past
lokumlardık	Past
güveniyordu	Past
oluyorum	Present
zulmünü	None
eğlenirim	Present
futbolcularda	None
sekiyordun	Past
izleyecek	Future
ortası	None
âlimlerine	None
şemsiyeydi	Past
yorgunum	Present
videolara	None
seyahatten	None
itilir	Present
göreceksin	Future
sevkiyatlarımızdan	None
karıncalarımdan	None
yazmalarına	None
frene	None
tanır	Present
girmedim	Past
devirdiler	Past
kaşır	Present
ezmeyeceksin	Future
görmüyordum	Past
harçlık	None
brokolileri	None
mezarlığı	None
çöllerinde	None
çökmüyordu	Past
çökertiyorlar	Present
kiliseleri	None
manasının	None
bayılırlar	Present
kümelerini	None
der	Present
yıldıza	None
unutmam	Present
müşterilerdik	Past
devirdi	Past
adamlarım	None
kahramanlardın	Past
oldum	Past
nergisi	None
düşmandım	Past
ölmezler	Present
vakitlerinde	None
gecikmediler	Past
girdi	Past
ekşimez	Present
gömlek	None
tasarruf	None
sayfayız	Present
görmüyorlar	Present
gergedanların	None
disleksi	None
bozuyordu	Past
beklediler	Past
umuyordu	Past
iyileşti	Past
keselerinde	None
çevireceğiz	Future
dönüyordu	Past
polinomu	None
tercih	Present
kırmıyorsunuz	Present
olayları	None
sönecek	Future
teoride	None
kaçmıyorlar	Present
kışkırtıyordu	Past
ayrıldınız	Past
tren	None
pusula	Present
uğratıldı	Past
aktristiler	Past
söktüler	Past
inmez	Present
paşaydın	Past
kızmaz	Present
eklemesizdiniz	Past
bayıldı	Past
bluzlumuza	None
atılır	Present
gereksinimler	None
kelimelerde	None
kalacaklar	Future
sürtmüyorsun	Present
kardeleni	None
sunulacaksınız	Future
şamandıra	None
saklanırlar	Present
korunmayı	None
bildiriyorum	Present
çevirmez	Present
gizlenir	Present
yapılıyor	Present
uyarıya	None
günebakan	None
sanıyorlardı	Past
görüyorlardı	Past
şovlarda	None
koz	Present
dakikamda	None
fırınında	None
mobilyası	None
yabancıyı	None
hükûmetinde	None
çanız	Present
karıştırıyorum	Present
alıştık	Past
ağıda	None
değiştiriyoruz	Present
tutuşturmuyorum	Present
savaştı	Past
saçlarına	None
tıkar	Present
kalenin	None
girmediler	Past
kovulmuyorsun	Present
uydum	Past
ispatlamıyordunuz	Past
demiyoruz	Present
yolculuklar	None
mevkisinin	None
sıkmıyordun	Past
bulacaklar	Future
yoracaklar	Future
açmazlar	Present
yabancılarım	Present
olta	Present
çarşıların	None
perilerini	None
diliyor	Present
eksikliğinin	None
deşer	Present
övüyordu	Past
çalgıçlarınızı	None
kaygı	None
anmayacak	Future
ölçülürler	Present
evrimleri	None
yayar	Present
düşünüyorsun	Present
papalardın	Past
kamerasına	None
karıydı	Past
yapıyorsunuz	Present
üretiyordu	Past
oynayacağım	Future
yıpratır	Present
örtü	Present
verdirtmiyordular	Past
marangozduk	Past
seslendi	Past
müzede	None
beklemeyi	None
doğmaz	Present
oylarına	None
durak	Present
bilemeyeceğim	Future
sıkıyor	Present
utandım	Past
sayacağız	Future
işletim	Present
dalmıyordular	Past
kovalar	None
canlanılmıyordunuz	Past
kazanırım	Present
kesti	Past
günde	None
bastılar	Past
dalgalanırlar	Present
seçtiniz	Past
köpeklerde	None
vapurların	None
işlemcilerden	None
taban	Present
maşaları	None
aygır	Present
düşünüyorduk	Past
basdılar	Past
kaçacak	Future
tutuyorsunuz	Present
döndürdüler	Past
dilber	Present
kutum	None
korktular	Past
dokadılar	Past
eklemesiziz	Present
vapurunun	None
şimalinizde	None
ürküyorum	Present
kurtların	None
ağalarsın	Present
atıştık	Past
ısınırız	Present
sağmadılar	Past
lordunu	None
kıskanıyordu	Past
varmadı	Past
dizer	Present
çıktın	Past
mikrofiberinin	None
irkeyellerdim	Past
aynayı	None
yanıtlarının	None
jeolojiyi	None
teğetin	None
içgüdülerinde	None
benzemez	Present
sarıldım	Past
getirirler	Present
oluyordum	Past
bozmadı	Past
beyitlerin	None
model	Present
geliştirdim	Past
bunar	Present
süsmüyorduk	Past
yönlerinde	None
ilkesinde	None
teoriler	None
buluşurlar	Present
bitirirler	Present
sıkarlar	Present
işçiydi	Past
yendirtiyorsun	Present
etkilemeyeceğiz	Future
uzanırlar	Present
vahayı	None
yonttuk	Past
kahvelerde	None
çizgiyi	None
bağlarlar	Present
tanımıyoruz	Present
konumuza	None
açıldı	Past
hastalıklardan	None
silindirlerimde	None
çöpçatanlığımıza	None
eklemeli	Present
ana	None
coşkulu	Present
asılları	None
olurlar	Present
şişer	Present
oturacak	Future
bölge	Present
bildirirler	Present
tepkimelerini	None
beytin	None
oturuyorduk	Past
kolyemizi	None
kalkanı	None
itmez	Present
kıçının	None
evlendiler	Past
geleceğim	Future
yuvaya	None
dönmezler	Present
eksenlerinden	None
bileceğiz	Future
buluşacak	Future
bildiriyorlar	Present
dersiniz	Present
sürüyorum	Present
çığırtkanlığı	None
müşteride	None
yoldurtmayacağım	Future
bilgilerinize	None
kesmez	Present
geliştirir	Present
buzul	Present
cemaatlere	None
öfkelendireceksiniz	Future
yenildiler	Past
çiftlerinden	None
girmeyeceğim	Future
tatlı	Present
açıyorlardı	Past
izolasyona	None
eceye	None
solucanlarına	None
ulumuyordular	Past
kararıyoruz	Present
galaksiyi	None
bulunuyordum	Past
kapattım	Past
bitirdi	Past
kazısında	None
kuyruklarına	None
ablayım	Present
müdürler	None
yardımcılık	Present
yorumlarından	None
birleşmez	Present
adlar	None
dirilir	Present
verilere	None
gülüyor	Present
eğittiler	Past
savaşmıyorsunuz	Present
ayrılmalara	None
barışır	Present
görmezler	Present
tarabalarınız	None
korkuyorlardı	Past
duylarınız	None
temsilciliğe	None
çiziyordu	Past
canlandırılıyordu	Past
tanelerden	None
bulamam	Present
köçeklerin	None
kazanmadılar	Past
ette	None
kozası	None
getirmedi	Past
ararız	Present
baktı	Past
kokluyoruz	Present
adsızdım	Past
sarmaşığımdan	None
üzülmez	Present
vardın	Past
kameralarda	None
solacak	Future
ucubeyi	None
oturuyorlardı	Past
gidilecek	Future
sızdılar	Past
yardı	Past
baylarının	None
götürmeyecek	Future
cihazları	None
ittirtilmiyordu	Past
baktık	Past
votkaydık	Past
kırılıyor	Present
bozdu	Past
yoksullaştırmıyordular	Past
memenin	None
yıldızlarında	None
gördünüz	Past
aktristi	Past
bıyığı	None
şaşırtır	Present
bakıyorum	Present
şehirlerinde	None
tabansızlardır	Present
ülke	Present
süpürdü	Past
taştık	Past
göstermiyorsunuz	Present
kuramda	None
karısınız	Present
yumuyorlar	Present
kaydedicilerinde	None
bozayı	Present
Musevilerinin	None
sönmezler	Present
gönül	None
ettiriyor	Present
gösteriyor	Present
lahana	Present
ortağım	Present
satılırlar	Present
içerler	Present
emlak	None
göstereceğiz	Future
kuruyorum	Present
kaynaştırdık	Past
aygırının	None
kurumlarda	None
sikmedi	Past
enfeksiyona	None
limonu	None
açıyorsunuz	Present
golünden	None
çalışıyordu	Past
taradı	Past
yorgun	Present
içerdiniz	Past
sürgünde	None
leş	Present
kardeşlerdir	Present
gazeteleri	None
memleketlere	None
yaparım	Present
tiyatrolarının	None
azmazsınız	Present
diler	Present
heyecana	None
yapmadın	Past
katılıyoruz	Present
inanıyor	Present
tiyatro	Present
cezeriyemiz	None
güvendi	Past
tükürmedim	Past
böler	Present
bulamıyor	Present
kırıldılar	Past
aktör	Present
diyorlar	Present
düşüyorsunuz	Present
günah	None
mukavemet	None
fizikçi	Present
vermeyeceğim	Future
falcı	Present
gönderirler	Present
düşünür	Present
sığar	Present
sinecek	Future
övmezsin	Present
savaşıma	None
maltlara	None
osuruyordu	Past
dönmeyeceğim	Future
sezdi	Past
bekletti	Past
verdirtmiyoruz	Present
tekfur	Present
topiklerim	None
başvurulara	None
pelininizin	None
toplamadı	Past
doyduk	Past
döndürdüm	Past
yaklaşıyorlar	Present
ayakkabıcı	Present
kötüleşti	Past
batmadı	Past
yerleşiyorlar	Present
demez	Present
fizikçiye	None
dedikodunuzu	None
içmiyor	Present
dağıtıyorlar	Present
bilyelerim	Present
tutarlar	Present
düşmandı	Past
yetiştiriyor	Present
savunmuyorum	Present
yağlamıyordun	Past
gönderiyordum	Past
kardeşimin	None
veriliyordunuz	Past
tanıttılar	Past
sandı	Past
eklerdim	Past
supaplarının	None
yermez	Present
savunuyorsun	Present
oluyoruz	Present
balinalardan	None
savundum	Past
depresiftiler	Past
keseceğim	Future
bilemeyiz	Present
sunacak	Future
küçülüyor	Present
yalvarır	Present
katarının	None
kozlardık	Past
doğruyum	Present
vurmaz	Present
telesiyejler	None
koleksiyonunu	None
bitiş	None
saçıyordu	Past
dalmaz	Present
izlemem	Present
brokoli	None
utandı	Past
şaşırtacak	Future
övgüleri	None
düşündüm	Past
düşünmüyordunuz	Past
cevherin	None
büyüdüler	Past
kardın	Past
yarımadayı	None
baltalarız	Present
kırılıyordu	Past
isteyeceğiz	Future
aldatıyor	Present
keşfederler	Present
hastalanır	Present
şeylerdir	Present
fotoğraf	None
düşünmedi	Past
yeniliriz	Present
kışkırtmazsın	Present
girdiler	Past
kalmadı	Past
otururlar	Present
yazmam	Present
soylulara	None
ışıktan	None
karıncalarınız	None
sonuçsunuz	Present
oynuyordun	Past
emlakçının	None
etki	None
korkuttunuz	Past
peltelerimizde	None
çöküyordu	Past
tariflerden	None
koleksiyonlarda	None
yetenekliydik	Past
seveceğiz	Future
balina	Present
ölçtürtmüyorsun	Present
panda	None
masörlerime	None
teorilerinde	None
dövmez	Present
dolapta	None
taşar	Present
otomobilcilik	Present
bozmaz	Present
kaldım	Past
geldiniz	Past
devirlerden	None
bikininden	None
doğrar	Present
bilginden	None
yazacaksınız	Future
kağıtta	None
saldırdılar	Past
cinlere	None
solurlar	Present
canlanmaıyordum	Past
yedeğiz	Present
acılarını	None
kovboyundan	None
delirir	Present
tutmadı	Past
yaparlar	Present
yolcu	Present
ölümsüzleştirmeyeceğim	Future
kaldıraç	Present
medreselerine	None
canlanacak	Future
tanesi	None
paylaşırlar	Present
benziyorlar	Present
kanserden	None
buluşuyorlardı	Past
çevrede	None
sesleniyordu	Past
kaçırıyor	Present
aramadı	Past
bulur	Present
döndüreceğim	Future
yoldaşız	Present
aşıklarım	Present
anlatıyorum	Present
paylaşıyor	Present
nedenim	Present
kırdırmadın	Past
giyeceğim	Future
aznavurlarım	Present
sessizliğe	None
gidiliyorsunuz	Present
çıkarmadım	Past
başrahiplerimiz	None
kapamasına	None
çevirmem	Present
işlemciye	None
pişti	Past
içermezsiniz	Present
yapmıyorum	Present
krizlerinden	None
sapmıyorsun	Present
kamustum	Past
ürümeyeceğim	Future
ideale	None
öldürmezler	Present
abartır	Present
kıyılarda	None
lordlarına	None
yırttı	Past
radarlar	None
temizliyordu	Past
yapıldı	Past
bekleriz	Present
ibneyim	Present
daldım	Past
aldırmadı	Past
fırınmış	None
bitiririm	Present
öneriyi	None
tarafım	None
yönetimler	None
bakıyorsunuz	Present
bohçalarımıza	None
ayırırız	Present
bekleyeceğiz	Future
soğuyor	Present
uzanmaz	Present
yetişiyordun	Past
kalmayacağız	Future
bitkilerimize	None
ütünüzde	None
ölümsünüz	Present
kumandayı	None
doyumsuz	Present
çattı	Past
binek	Present
pikniğe	None
asmam	Present
geçmem	Present
devirleri	None
boğar	Present
kardeşim	Present
öldürürüm	Present
işlemiyordu	Past
keşfetiyorsun	Present
kötüleşir	Present
yontulmuyordun	Past
verdirir	Present
sevmeyeceğim	Future
bilmiyorsunuz	Present
istemiyorsun	Present
rahipsiniz	Present
yaratmıyordular	Past
duyarız	Present
kötüleştirir	Present
gönderiyorum	Present
kirpilerde	None
haberleşmiyordu	Past
mumya	Present
bazında	None
otobüsleri	None
tabancaya	None
yalanım	Present
satarlar	Present
yolundurtacaksınız	Future
değiştireceğim	Future
teşkilatlarında	None
yetiyor	Present
rehineydik	Past
acımayacak	Future
boşalıyor	Present
aktris	Present
içeceksin	Future
gelmezsin	Present
okulda	None
mükemmeldi	Past
batar	Present
buzullardır	Present
silgisin	Present
gösterdik	Past
çamları	None
eğiliyor	Present
özetleri	None
lügatçe	None
kahvenin	None
öğretmen	Present
dalgalanır	Present
tercihlersin	Present
devineceksiniz	Future
rahatsızlandı	Past
votka	Present
paşa	Present
ışınımın	None
çıkmıyorum	Present
almaz	Present
baylarım	Present
inmiyor	Present
geliriz	Present
elçilerini	None
işlemenin	None
silahlarını	None
tutuyorlardı	Past
götverenlerdim	Past
mektubu	None
adlarının	None
başrahip	Present
sindirirler	Present
yatağı	None
deneylere	None
anıyoruz	Present
boşalırsınız	Present
dükkânlardır	Present
giydim	Past
rahatsızlanıyorsun	Present
takvim	Present
gülerim	Present
sincaplar	None
verdirtirsiniz	Present
kaltak	Present
pimdim	Past
dürttün	Past
kemençe	None
haberleşiyorduk	Past
kıymıyordum	Past
katlarından	None
homoseksüellerimde	None
kelimelerimi	None
duyuyor	Present
söyleşiyi	None
bitmedi	Past
hatasını	None
şuurun	None
kararmıyordular	Past
yaramayacak	Future
satılmadı	Past
çıkarlar	Present
sunuluyorduk	Past
boğayı	None
değiştirmez	Present
öküz	Present
şaşırdı	Past
müzisyen	None
fonksiyonu	None
etkilemezsin	Present
sileriz	Present
seçiyorum	Present
temsilcilerin	None
olmadım	Past
sızdı	Past
amaçlara	None
kurtçuğu	None
yerer	Present
angut	Present
düşünürler	Present
sayıyorsunuz	Present
girersiniz	Present
kahveleri	None
güldü	Past
kaynıyordunuz	Past
ayırmadı	Past
üşeniyorum	Present
oturur	Present
paylaşırız	Present
uzandı	Past
manitalarımızın	None
aldık	Past
yön	Present
bakıyordu	Past
topolojilerine	None
kullanmıyoruz	Present
peruğu	None
batılardınız	Past
gitmeniz	None
boşanıyorum	Present
tipografyaya	None
bamyanın	None
bankalarda	None
çıkarım	Present
övecek	Future
artarlar	Present
satacaksınız	Future
güvenmezler	Present
sivrisinekleri	None
biterler	Present
ölçülür	Present
takacak	Future
ittirttiniz	Past
aleti	None
kusar	Present
saldırıyorsun	Present
toplayacak	Future
dakikandan	None
imrendiniz	Past
sekerler	Present
örer	Present
cephe	Present
soldu	Past
rehberler	None
uzanacak	Future
güveniyorlardı	Past
sansar	None
savunuyorlar	Present
ilköğretimlerimi	None
bahçıvan	Present
savaşçısının	None
bacalara	None
hurimde	None
uymuyor	Present
malsınız	Present
roman	Present
manasınız	Present
terörizmi	None
azınlık	None
düşeriz	Present
boyuyordu	Past
semerlerinden	None
soğuyorum	Present
eşik	Present
yaklaşmıyor	Present
sözcüyüm	Present
kumalarınızı	None
sarılacaksın	Future
dedeleri	None
irdelemiyordum	Past
nargileden	None
otostopçularını	None
evleneceğim	Future
büyüleyiciydiniz	Past
alkış	None
çürümüyordun	Past
kalkmayacak	Future
yumuşakçalarda	None
anmaz	Present
torunlarsınız	Present
Aşkabatlılardır	Present
erimiyorsunuz	Present
gütmez	Present
kullanırlar	Present
okumadınız	Past
kaybolduk	Past
konumu	None
piskoposlarına	None
dizin	None
cehenneminin	None
tabutlarınızdan	None
buluşur	Present
kullanmıyorum	Present
yaramazlar	Present
defterinden	None
incimden	None
geldiler	Past
dilberim	Present
başardın	Past
yenildi	Past
tutar	Present
bulamazsın	Present
kazımadım	Past
sürünür	Present
mayamıza	None
eşikten	None
şuurlarım	None
büktürtülüyordunuz	Past
tütüncülerdim	Past
tabansızlarız	Present
bildirmez	Present
girmedik	Past
bakıcıydılar	Past
programlanmam	Present
cinsiyetten	None
yapışmaz	Present
mevkiden	None
acemilerimize	None
zaferlerde	None
birleşecek	Future
izleyeceğim	Future
şaşırmadım	Past
duyuları	None
menüsünden	None
alımlı	Present
sattırtırıyorlardı	Past
yıktılar	Past
dururuz	Present
döverim	Present
yetiştirirler	Present
kuruyor	Present
üyelikte	None
perdeler	None
kalplerini	None
gelişir	Present
doğurdu	Past
acıkmıyorduk	Past
beklemez	Present
kesesini	None
vezirlerdir	Present
koyarsın	Present
kullanılmaz	Present
rahip	Present
göndermiyor	Present
birleşiyordun	Past
veriyor	Present
görmem	Present
göstermezler	Present
kalıyorum	Present
anlatacağız	Future
köfteleri	None
olursun	Present
köpürtüyordun	Past
sattırtırmıyorsun	Present
seyretirim	Present
değirmenlerin	None
verdi	Past
okuyacağım	Future
göçmeyeceksin	Future
gazetesini	None
yorumda	None
duymuyorum	Present
gezdi	Past
vururuz	Present
bükülme	None
kullandık	Past
sileceğiz	Future
konar	Present
artmadık	Past
sıcaklıklara	None
benzerlerinin	None
atılıyor	Present
yolar	Present
çalışıyor	Present
bastı	Past
mezra	None
bitiriyorum	Present
bilmiyorum	Present
çarpacak	Future
dayadılar	Past
devinirler	Present
hemşireydiniz	Past
güder	Present
kaçarlar	Present
seyretirsin	Present
basketbolcuyuz	Present
rüyanda	None
ayinin	None
kuruttum	Past
bulayacaksınız	Future
tarihçilerini	None
tıklar	Present
eşeklerde	None
topikler	None
sesleniyor	Present
fakültesi	None
hemşireye	None
boyadı	Past
ittirdin	Past
düşünmüyordu	Past
patlamaz	Present
kılavuzuna	None
etkilemezler	Present
misketlerinden	None
canlandırılmıyorduk	Past
takmıyorum	Present
giysilerde	None
çalışıyorum	Present
sevmedim	Past
eksenini	None
gelininizde	None
yardımcılıktım	Past
kırıldı	Past
girmez	Present
davrandım	Past
telefonumu	None
gününe	None
iğreniyorsun	Present
çatarlar	Present
seccade	None
dokamıyordum	Past
gösteriyorsunuz	Present
ördeklerinizi	None
satılmadın	Past
uydulardan	None
firavunlardan	None
içmez	Present
kırmadı	Past
dolmayacağım	Future
kelimeciğinizden	None
müstahdemlerdik	Past
almıyor	Present
atıldılar	Past
unutmadık	Past
malamozlardım	Past
figüranlarınız	None
tümörlerden	None
diskoteğine	None
baharların	None
kapatacağım	Future
kardeşlerin	None
bulamaz	Present
karıştırtıyordum	Past
sinirlendirir	Present
diyecek	Future
giysi	Present
kahramanımızı	None
unuturlar	Present
çap	Present
ipinin	None
oğul	Present
görecek	Future
yağlamıyoruz	Present
yoldaş	Present
çizecek	Future
ettiriyordu	Past
uzanır	Present
hurin	None
düşünmüyor	Present
saklanmayacaklar	Future
itileceksiniz	Future
peder	Present
konusun	Present
kilimin	None
aktörlerdir	Present
düşünmeyeceğim	Future
getirdik	Past
ikazları	None
gidildi	Past
ömre	None
izledi	Past
börülce	Present
eğecek	Future
örerler	Present
oldunuz	Past
yanlışım	Present
yaptırtmayacağız	Future
ernektin	Past
benekdim	Past
mihrabım	None
sargı	Present
düştüm	Past
kalıyordu	Past
satılmıyor	Present
lehçelerimizi	None
güreşçilerini	None
battaniyelerine	None
değiştiriyorlar	Present
koklamıyor	Present
aradım	Past
şaşırıyorum	Present
boksunuzu	None
cisimlerini	None
kaynadı	Past
denilmiyordunuz	Past
azmıyor	Present
bağladın	Past
ortak	Present
otomobilcilikmiş	None
fındığım	Present
kovulurlar	Present
doğmadı	Past
basdı	Past
volkanizmasında	None
sezdik	Past
düşecekler	Future
laboratuvarlarda	None
romanlarız	Present
Tiranlılardın	Past
sürücüsünde	None
yayıyor	Present
huzurdunuz	Past
dileklere	None
korkmuyor	Present
ettirirler	Present
ormanlar	None
sanıyorum	Present
alındırmıyordular	Past
tutulmalar	None
inanmazlar	Present
derviş	None
korkuyorlar	Present
gönderir	Present
bulamadım	Past
koyarım	Present
sevabını	None
köpürtüyorlardı	Past
hamamlarda	None
hastaya	None
içerir	Present
şaşırtıyor	Present
kazıyacaksın	Future
küçüksün	Present
bulmuyordun	Past
uyardılar	Past
bölüyorlar	Present
kaşlarıma	None
fakirleştirmezler	Present
koydu	Past
isteyeceksiniz	Future
meyhaneye	None
yakındı	Past
maçta	None
karınca	Present
gemiyi	None
hatalardır	Present
değişmiyor	Present
seyretmiyordular	Past
kapsamlarının	None
çığırtkan	Present
dalgalanmıyordunuz	Past
saldırmadı	Past
kocayım	Present
evrene	None
tütmedi	Past
çapa	Present
melodilere	None
baytarınız	None
cihazda	None
düşünmedim	Past
adalete	None
çiziyor	Present
kopacak	Future
turşu	Present
işçilerimde	None
tanımıyordu	Past
satış	Present
Yahudiye	None
buzukilerimde	None
pencereden	None
izlemedim	Past
ölçülecek	Future
iletiyorum	Present
öğretmenlermişim	None
yabancıları	None
aşıksın	Present
bilardolar	None
alamet	Present
toplayacaksın	Future
kazanacak	Future
çalışıyorsun	Present
kapamanızdan	None
ceylan	Present
hatalarında	None
sararmayız	Present
abacılardır	Present
ayağınızı	None
cephelerin	None
diyordum	Past
telaffuz	Present
mekiğini	None
kuvvet	Present
sivilce	Present
sunucularınızın	None
iletirim	Present
yordu	Past
obje	Present
güderler	Present
ninni	Present
sakaları	None
kaybolacağım	Future
serer	Present
inanıyordunuz	Past
hedeflerde	None
ilimlerinde	None
giyiyoruz	Present
arınmıyorsunuz	Present
çıkardın	Past
alet	Present
düşüyor	Present
parçacıkta	None
kamera	Present
yalayacağım	Future
sürüdün	Past
paylaşıyoruz	Present
iyileştirir	Present
bakıyorlardı	Past
coşmadım	Past
dövüyordu	Past
karında	None
paylaşıyorlardı	Past
yutak	None
tanıdık	Past
yapmaz	Present
panendeistlersin	Present
hazırlar	Present
tarihçiyim	Present
karıncaydın	Past
sapıyor	Present
kardeşlerdin	Past
yapmıyordu	Past
bulunmayacak	Future
kulun	None
seçiliyordu	Past
duymuyordu	Past
yazacak	Future
futbolcu	Present
kaçacağım	Future
sakladı	Past
tekila	Present
ayağımın	None
artmaz	Present
kıldılar	Past
dizmiyorsun	Present
kıldı	Past
yerleşiyor	Present
acıtmıyordun	Past
embriyo	Present
sanmıyorum	Present
bağına	None
yüzüncü	Present
kalacak	Future
öğrenirler	Present
çökmeyecekler	Future
soğudu	Past
kapatmaz	Present
sunucuydun	Past
kandınız	Past
Müslümanları	None
hahamdı	Past
istiyorsun	Present
balık	Present
böceklerini	None
büyümez	Present
susuyordunuz	Past
abartmayacaksın	Future
vuracak	Future
okyanusa	None
öğrendik	Past
pisleteceksiniz	Future
yorumlarınıza	None
oynamaz	Present
tahtından	None
saklayacak	Future
palmiye	None
yerlerdiniz	Past
bütünleşiyor	Present
avında	None
parçalara	None
bezer	Present
kurbağalamada	None
burnundan	None
yangınlara	None
korkmaz	Present
pişirmiyorlar	Present
canlandırtılmadın	Past
tarak	None
paparazilerdin	Past
tutuyor	Present
köylüydü	Past
grubunuz	None
aradı	Past
öğütmez	Present
ettirdiler	Past
ayılır	Present
ebe	Present
sikeriz	Present
bitişe	None
paylaşıyorlar	Present
modeline	None
getirdim	Past
tükeniyor	Present
katılırsınız	Present
çarpıydılar	Past
vurdum	Past
fotoğrafçılarından	None
eriyik	None
tanımıyor	Present
taktım	Past
düzeltiriz	Present
yongalarınızdan	None
daldırdınız	Past
kiliselerinde	None
vereceksin	Future
giyiyorlardı	Past
savaşacaklar	Future
yayıncılıklarımızın	None
tiyatrolara	None
sosun	None
mana	Present
yaprağını	None
vurdular	Past
banliyölerinde	None
satışlara	None
iskeletin	None
lisenin	None
noktalarda	None
aldırmayacağız	Future
polisim	Present
eşiktiler	Past
buluşuruz	Present
göğsümüze	None
ayarlanır	Present
çarmıh	None
kurutmaz	Present
tutulmadan	None
sürekliliğimin	None
andılar	Past
pirinçlere	None
günlükten	None
kirden	None
sızar	Present
kaçırmaz	Present
değiştireceğiz	Future
dükkânlardan	None
bekliyoruz	Present
tekliflere	None
yazmıyordu	Past
pehlivandı	Past
tutuşturdular	Past
koyduk	Past
burkmaz	Present
birleştirir	Present
ölçtüler	Past
cehennemimize	None
tarafınızdan	None
uygulamalara	None
kullanıcılardın	Past
çalar	Present
düşünüyorsunuz	Present
kasetlerin	None
ikiz	None
telefonlara	None
çöpçatansın	Present
bütünlerimde	None
zurna	Present
durdular	Past
ayvaz	Present
bakirlerinize	None
baytarınızı	None
sürülürler	Present
savunmuyordunuz	Past
örneği	None
sözlükleriz	Present
ısırmayacağız	Future
olmazsın	Present
uyanıyor	Present
ölçüldü	Past
davranıyoruz	Present
sandım	Past
diriliyorsunuz	Present
türevlerde	None
deniliyor	Present
mısırlar	None
üniversitede	None
tararlar	Present
gişelerden	None
toplarız	Present
sürüleri	None
peçetesin	Present
listenize	None
sabahtan	None
temsilcilerdir	Present
dilsizliğinizi	None
ölmedi	Past
gırtlağını	None
ispatladı	Past
otomuzu	None
aşarlar	Present
devdi	Past
koyar	Present
davranır	Present
cinsiyetlerden	None
eğitirsin	Present
uzağım	Present
vurgu	Present
kaçırdık	Past
Türkçeleştirdim	Past
tanışıyor	Present
anı	None
müelliflerdir	Present
mikroorganizmalarız	Present
isteyecek	Future
geğirdi	Past
şüphesinden	None
çift	Present
değiştirdim	Past
solumazsınız	Present
sinirlendiriyordu	Past
işitir	Present
faresine	None
coşar	Present
uğratacak	Future
savaşçı	Present
öldürüyorlardı	Past
çökermiyorlar	Present
gelmiyorsun	Present
gönüllerimizi	None
inanırlar	Present
dönmedi	Past
psikoloğa	None
yönelimden	None
soludum	Past
aktördü	Past
bilirsin	Present
düşünüyor	Present
övgülerin	None
diyeceğim	Future
oyumda	None
katılaşıyorsun	Present
sövüyorlar	Present
içermeyecek	Future
üzmez	Present
tanıyordu	Past
doğdular	Past
deneylerinde	None
manama	None
yetmedi	Past
bozarlar	Present
yitiyorum	Present
öptüler	Past
üzüyorum	Present
gülüşün	None
yazıtına	None
yenilirler	Present
bükmemelerden	None
bakıyoruz	Present
dalgalandırıyordu	Past
bahçelerinde	None
acıkmam	Present
şüphelerim	Present
saldırmayacak	Future
ölçtürdüm	Past
dizdiniz	Past
cümlelerin	None
yazıyor	Present
yitmiyorum	Present
dağıldık	Past
irdeliyor	Present
saklanıyordu	Past
makaranın	None
yetiştirdim	Past
bulunmadılar	Past
bıçağını	None
satışlarım	Present
Türkçeleştirdi	Past
bayılmayacaksınız	Future
telaffuzunda	None
cevherde	None
döndürürler	Present
yağıyor	Present
biter	Present
çeşnilerinizin	None
büyüdünüz	Past
bağdın	Past
karıncaların	None
tütümüzün	None
olursunuz	Present
bıçakladı	Past
benzemezler	Present
kıskançtın	Past
hırsız	Present
ayıracak	Future
topladım	Past
denilir	Present
gazel	Present
yolundurtuyordu	Past
kulağıma	None
vermiyor	Present
bakıyordum	Past
gruplarına	None
yaparız	Present
evlatlarını	None
kovulur	Present
tacizler	None
yaklaşmaz	Present
bakmadınız	Past
sözleşmeleri	None
tanırlar	Present
saçıyor	Present
diliyorum	Present
anlattı	Past
zurnasını	None
kızgındı	Past
bastonlarımızın	None
suallerden	None
göndeririz	Present
yardımlarınızı	None
büktürmüyordular	Past
yazmadık	Past
cumhur	Present
üretti	Past
köftemizden	None
geçerler	Present
sinmiyor	Present
topladılar	Past
robotu	None
örneklerinden	None
gerzeklersin	Present
kırdırıyorum	Present
kunduz	Present
ileride	None
çıkmadılar	Past
yağacağız	Future
odalarda	None
gübreydim	Past
depresyonlarda	None
yumar	Present
sanıyorsunuz	Present
bürokrasiden	None
konmadı	Past
uzunluğunun	None
vilayetimizin	None
kuma	Present
dönüyorsunuz	Present
görüntüsüne	None
alametiniz	None
eğmedi	Past
göndermeyiz	Present
uyduk	Past
kursiyersin	Present
seriyor	Present
endüstrilerden	None
doğru	Present
çalışmaz	Present
kaçamakları	None
çizerler	Present
seçmenlere	None
kullanmayacak	Future
verilmiyor	Present
kanadın	Past
istersin	Present
dildolarımızda	None
kullanır	Present
basketbolcuydun	Past
duymazsınız	Present
yanmadın	Past
yetkilerde	None
bıçakları	None
ağlayacak	Future
dalgıç	Present
gizler	Present
koşulurım	Present
götürmedi	Past
beklersin	Present
bölüyoruz	Present
ayrılmayacak	Future
izlerim	Present
yolundurmuyorum	Present
altınlarına	None
alırlar	Present
uca	None
aldattın	Past
gerekmez	Present
seçiyorduk	Past
değişkenin	None
yetecek	Future
düştük	Past
müzikallerini	None
irkeneğiniz	None
üzmüyorlar	Present
göreceksiniz	Future
tepiyordum	Past
Duşanbelilerdir	Present
gelmedim	Past
olmadın	Past
kırıtıyordu	Past
saçı	None
sıpamın	None
açtınız	Past
kaçırırız	Present
şelalesi	None
tüyünden	None
bulamazsınız	Present
başardık	Past
kaçtılar	Past
omuzdan	None
âlim	Present
olayların	None
soydular	Past
kullanılmıyordu	Past
koyuyor	Present
çukur	None
polen	Present
sayarım	Present
isteyeceğim	Future
unutursun	Present
kahvesine	None
sonuca	None
istisna	Present
çar	Present
takmazsın	Present
vaha	Present
yasağına	None
ürerim	Present
ileriden	None
verilerinin	None
oturmuyor	Present
tuttuk	Past
maskaralarmışım	None
sunacağız	Future
götürürüz	Present
cenaze	Present
alır	Present
babacan	Present
eğitiyor	Present
uydusuna	None
güneşler	None
siliyorsun	Present
ekşimiyorum	Present
ayırıyor	Present
gönderecek	Future
kurudu	Past
fizikçisi	None
unda	None
mermilerini	None
aşmayacak	Future
geriye	None
çıkmazlar	Present
sayıyordu	Past
programlanıyordum	Past
manalarınıza	None
varacağız	Future
otobüslerinin	None
yönlerin	None
oturdu	Past
sayfalarında	None
bulurlar	Present
tabiyetine	None
derdin	Past
daldırır	Present
topladık	Past
yönetimlerin	None
duyarlar	Present
temizliyor	Present
ererler	Present
korkmuyorum	Present
toplamadık	Past
açtın	Past
otostopçu	Present
seyreteceksiniz	Future
kaynaştırtılmam	Present
kuruşun	None
reçeli	None
türülerimi	None
geliştirecekler	Future
korkmuyoruz	Present
memeler	None
güveniyorum	Present
kılım	None
dersimi	None
paylaşacaksın	Future
bulunmuyorum	Present
ayakkabıcılarda	None
piknik	None
lokumlardın	Past
tanıtıyordu	Past
siliyor	Present
düşecek	Future
birleştirecek	Future
överler	Present
sunuyordu	Past
külek	None
utandırır	Present
çıkardık	Past
sattırtırmayacaklar	Future
geliştiriyoruz	Present
aşıkdı	Past
göstermem	Present
sürünüyorum	Present
konserden	None
toplara	None
gözlüyorum	Present
kantini	None
korkutmayacaklar	Future
ölürler	Present
altlarını	None
sakinim	Present
sevmem	Present
vazonun	None
türevde	None
rubaiydiniz	Past
eğlenirler	Present
öğrencilerim	Present
paylaştı	Past
kardeşiz	Present
haşefede	None
dolmuşun	None
atıştırtınız	Past
takı	Present
perdelerden	None
yaratmamız	None
bakmamı	None
şaşırttıracaklar	Future
dinmiyor	Present
delmeyeceğim	Future
birliktelik	None
sayfalarımızı	None
bürüyordum	Past
romanlardan	None
değişmedin	Past
şaşırmayacak	Future
yontmuyordular	Past
hissi	None
geciktiriyordun	Past
Monakolu	Present
kazasında	None
deneyimimden	None
tenine	None
keman	None
gönderiyorlardı	Past
sökmedim	Past
düşmedi	Past
onar	Present
vilayetlerinden	None
yorgunlar	Present
ağdan	None
yangınlarından	None
avcısı	None
çedar	Present
korkmadı	Past
çalışmadı	Past
sümük	None
yamyamımdan	None
ağladım	Past
sevmiyorum	Present
namazlarına	None
lügatimiz	None
kuğulardım	Past
mısradan	None
amatördüler	Past
kalpleri	None
duvarlarında	None
sınır	None
papazdın	Past
işemiyordun	Past
oyunculuğu	None
hançer	Present
terzi	Present
mikroorganizma	Present
gösterimin	None
oluyorsunuz	Present
çalışmanın	None
işkencecisiniz	Present
durmadı	Past
bilmezsiniz	Present
bulamayız	Present
orospu	Present
satılacaksın	Future
şimşekten	None
topluyoruz	Present
dövdüler	Past
sonucu	None
karakterlerdin	Past
sermiyor	Present
tanlarınızın	None
sunucularım	Present
gerer	Present
değişkendi	Past
sıçanlardım	Past
savaşıyorlar	Present
sevgili	Present
kırarım	Present
öncelerden	None
bulmadım	Past
davranış	None
çekirgeleri	None
külfete	None
yağmaz	Present
ideallerinin	None
düşüyoruz	Present
yol	Present
yabancılarımız	None
işlemez	Present
ilettim	Past
evlenecek	Future
vermedik	Past
geçindiler	Past
göstermiyor	Present
ejderhalardır	Present
ovuyoruz	Present
bülbülyuvalarını	None
cisimlerin	None
bulunmadım	Past
indirimden	None
sultan	Present
çerçi	Present
gülünçleşmiyor	Present
kurallarından	None
karakolu	None
kutusu	None
deliriyordum	Past
ilacını	None
günlerinden	None
üşüyecekler	Future
battı	Past
ojelerini	None
karılarının	None
kazanır	Present
istemciyiz	Present
dervişe	None
yıkayacaksınız	Future
açılmayacak	Future
çıkmayacak	Future
prens	Present
çizgisini	None
dövüyorlar	Present
sunulacak	Future
yakındılar	Past
kakmadınız	Past
arıyorum	Present
göğüslerde	None
yapacaksınız	Future
masör	Present
balıktan	None
erkeceylerinin	None
okuyorlardı	Past
kayboldum	Past
izlemez	Present
karnım	None
üzüyor	Present
saldırır	Present
öğreniyor	Present
oturuyorsun	Present
sunacaklar	Future
istemiyoruz	Present
sevgilisinin	None
popunun	None
seçtik	Past
sundular	Past
bilmiyorlar	Present
wikilerimizden	None
kopmuyorsunuz	Present
boşanmayacağım	Future
kazanmıyorsunuz	Present
anmadınız	Past
boşaldı	Past
kazanmaz	Present
sanıyoruz	Present
kastınız	Past
canlandırtmazsınız	Present
değiştirmedi	Past
yumurtalarından	None
falcılardınız	Past
ceplerine	None
öğrenecekler	Future
ölüsünün	None
korsan	Present
düzelecek	Future
etkilemedik	Past
okuyoruz	Present
geliyorsun	Present
masayı	None
canlanır	Present
örerim	Present
şampanyayı	None
kurtardım	Past
fındıklarından	None
yeter	Present
kanadı	Past
mühendis	Present
döneceğiz	Future
unutmadım	Past
hemşire	Present
gireceğiz	Future
baltalardınız	Past
beceriklisiniz	Present
erdik	Past
mucizelerdim	Past
paylaşmazlar	Present
çöker	Present
hahamın	None
mekiğimizi	None
girdap	Present
saçında	None
görürler	Present
sunuyorum	Present
fillerdik	Past
ölümsün	Present
oyalarlar	Present
acı	Present
yapmadınız	Past
getiriyordu	Past
batarlar	Present
unutmayacaklar	Future
ilçeler	None
öğrendiniz	Past
işlemiyor	Present
borçtan	None
korkutuyor	Present
içgüdünün	None
derlemesinde	None
çökertir	Present
sürtmeyecekler	Future
batıyordu	Past
sakladılar	Past
bularız	Present
yorumunuz	None
oğullarım	Present
kışkırttılar	Past
maaşlar	None
sikilmiyorduk	Past
canlandı	Past
öğreneceğiz	Future
tümce	Present
omuzunun	None
gözlüyor	Present
davranmıyor	Present
insanımsılardınız	Past
boğuyordu	Past
çıkarıyordu	Past
balamozlarsın	Present
eğleniyordu	Past
birleşirler	Present
kururum	Present
geyşanın	None
değişiyoruz	Present
yırttılar	Past
bulunmuyordu	Past
öğreniyordu	Past
gülünçleşmezsiniz	Present
kazanıyorum	Present
topçu	Present
romanım	Present
panendeistinize	None
abazanlar	Present
tutmazlar	Present
öğretecek	Future
eğitmeyecekler	Future
kanıtlamıyordum	Past
öveceğim	Future
araçtı	Past
namazlarından	None
vardılar	Past
cemaatlerini	None
fırın	Present
yapılır	Present
düşerler	Present
aştılar	Past
ölecekler	Future
sustu	Past
seyahatlerini	None
ayrılıyordu	Past
kuzuyu	None
döndük	Past
kullanıyor	Present
hazırım	Present
düşmanlarım	Present
elman	None
tahtın	None
kaçıyordu	Past
üretmediler	Past
çalışmıyorum	Present
ziyarettiler	Past
yumuşakça	Present
yeniliyor	Present
ününden	None
heyecanlanmayız	Present
buzukimin	None
başvurunuzda	None
alıyoruz	Present
yırtmayacağım	Future
savunacağım	Future
ipekleri	None
ortağınızda	None
güveniyordun	Past
çalışırsınız	Present
alevdik	Past
güzelleştirir	Present
kurutur	Present
içiyorlar	Present
yorumlarınızı	None
kaynaştırmadılar	Past
zaferdin	Past
uydusunda	None
tercihim	Present
topolojide	None
çarpmayacak	Future
geçecekler	Future
ombudsman	Present
avcıydık	Past
pusar	Present
sevgililerine	None
attırmayacaksınız	Future
musluklarının	None
paparazi	Present
kızdım	Past
bilemez	Present
yanıtının	None
kırıldım	Past
yağlar	Present
katılmaz	Present
tanrının	None
oynadı	Past
kardınız	Past
pisletirız	Present
doğar	Present
lokantasının	None
televizyonundan	None
öpüşmediniz	Past
kalacağım	Future
direk	Present
istemedin	Past
yapılmayacak	Future
yontulur	Present
sürünüyor	Present
attırıyordunuz	Past
farelersiniz	Present
alışmazsın	Present
savaştılar	Past
bildiriyor	Present
tarakları	None
kaçırdılar	Past
saklayacaklar	Future
görmüyorum	Present
havuzuna	None
cemaatin	None
topluluk	Present
şaşırıyor	Present
limona	None
zibidiydiler	Past
almadık	Past
bakmıyorlar	Present
kullanmıyorlar	Present
efsunlarımın	None
frambuazım	None
gerinmiyordun	Past
yağma	Present
derdik	Past
yaklaştım	Past
yetkiyi	None
sürür	Present
cezalandırdı	Past
dağınık	Present
içeceklerinin	None
tensörleri	None
komikleşeceğim	Future
şaşırtmayacaksın	Future
dağıtıyor	Present
seçmeyecek	Future
kovaları	None
buluşacağız	Future
kıskançlıkta	None
bıkmaz	Present
bekletiyordu	Past
örtmedik	Past
koylarımızı	None
bireylerden	None
çıkarmaz	Present
mevkilerinde	None
eğmez	Present
fibrinojen	None
büyüğüm	Present
gerekir	Present
okumuyor	Present
yoğurtçu	Present
bitmeyecek	Future
yetişmiyor	Present
hazırdılar	Past
çıkaracak	Future
ilerletir	Present
tayfa	Present
dumanınızı	None
umutsuz	Present
aktrislerdir	Present
bulgurun	None
sekme	None
bilecekler	Future
yedirtecek	Future
salonların	None
ibnesin	Present
acıtır	Present
daldırtmazlar	Present
paşalardın	Past
dolapları	None
dişlerinden	None
gösteririz	Present
ilaçlarını	None
boyun	None
türevlerin	None
çıkarırız	Present
binmiyoruz	Present
katılmazsınız	Present
oyunculardır	Present
atmamayacağım	Future
aldırmazlar	Present
seçti	Past
şalvar	None
kurallarımıza	None
içermiyor	Present
savunur	Present
zibidilerin	None
saldı	Past
blogların	None
bildi	Past
yenilmeyiz	Present
öğrenir	Present
örtüydük	Past
saksının	None
verdik	Past
katılmadım	Past
şurubu	None
kullanılıyordu	Past
yuvası	None
ettirtiyordunuz	Past
açıyorum	Present
sayar	Present
çarpmıyor	Present
müşteri	Present
fakirleştiriyoruz	Present
odakları	None
kaçmıyor	Present
karıştırtdın	Past
bereketlerdir	Present
tiyatrolardır	Present
savunuyorum	Present
saydılar	Past
pamuğunuza	None
hayvanlardan	None
daldırtır	Present
taklitçilerdim	Past
bıktın	Past
avlarda	None
tanışırız	Present
sığıyor	Present
geçiyorum	Present
teklifinizi	None
önemde	None
ongunları	None
çalışırız	Present
saksocularsın	Present
özetten	None
üretiyoruz	Present
izleyicilerim	Present
okumaz	Present
yarattın	Past
kelimelerdik	Past
saymazlar	Present
dergi	None
düşünürüz	Present
yenilmedi	Past
okuyorum	Present
pijama	Present
yaklaşıyorum	Present
geriniyordu	Past
finallerini	None
taşmazlar	Present
damattınız	Past
satılıyor	Present
mekiğinde	None
açar	Present
kurtaracağım	Future
düşmez	Present
madalyaları	None
omuzlarından	None
düşüneceğim	Future
kazası	None
güreşçilerinden	None
çeviriyoruz	Present
otocularım	Present
yollarım	Present
kategorisine	None
yapılırlar	Present
sıçanlarını	None
unuttular	Past
ortaktı	Past
kitabemden	None
çıkar	Present
utanırım	Present
deliğe	None
seviyorsun	Present
şaşırmazsınız	Present
itmiyor	Present
dönemine	None
ayrılırlar	Present
kuğuyduk	Past
öğrenciydi	Past
değişiyordu	Past
müşteriyiz	Present
aştım	Past
oynatıcılarının	None
uçağımıza	None
getireceğim	Future
okurlar	Present
kazanacaksınız	Future
kötüleştirdi	Past
kursiyerimde	None
âşıktın	Past
kirletir	Present
eğdiniz	Past
eğer	Present
çağırıyordu	Past
arttı	Past
sorumluluğunun	None
noktalardır	Present
birleştirdiler	Past
menekşeleri	None
seçeriz	Present
salmadın	Past
bankalar	None
diyorsunuz	Present
seveceksin	Future
alıyorum	Present
sekmiyorlar	Present
almıyoruz	Present
katılmayacak	Future
beceriksizler	Present
derslerinin	None
sundum	Past
adım	None
arıyordum	Past
armutların	None
ulam	Present
uçaklarına	None
bakmıyorsunuz	Present
ip	None
yıpranacağım	Future
saksocunuz	None
saldırıyorsunuz	Present
işledi	Past
türemiyordunuz	Past
kobralar	None
bakarsın	Present
masum	Present
bitiyorduk	Past
fakiri	None
istemedi	Past
satılmıyorum	Present
dağılmıyorsun	Present
uzaktı	Past
seçilirsin	Present
sözlüğü	None
oyunculukları	None
beklemedim	Past
alırım	Present
sancaklardan	None
denildi	Past
hastanelerden	None
övüyor	Present
sunuyorsunuz	Present
birliktelikleri	None
kusmuyor	Present
cehennemden	None
sunuyorduk	Past
semere	None
bezmezsin	Present
tasarruflarımızdan	None
gerersin	Present
yoldurtacağız	Future
diyeceksiniz	Future
düzeltirsiniz	Present
devinde	None
buharlaşmıyor	Present
duydu	Past
oynarız	Present
balamozumu	None
eklere	None
çıkmam	Present
giyiyorum	Present
lehçesinden	None
sayımına	None
içerecek	Future
savunmadınız	Past
ittirtmiyordun	Past
bütünleşir	Present
cezalandıracak	Future
bakanım	Present
keserymışım	None
gelir	Present
yağıyoruz	Present
ekşimedin	Past
ülkesi	None
yetkimin	None
katıldılar	Past
elmaslardır	Present
yetkilerinin	None
yığıyorum	Present
parlatmıyor	Present
seksiler	Present
kovuldular	Past
çarptı	Past
köygöçüren	Present
alındırmazsınız	Present
çaptınız	Past
primitif	Present
ideal	Present
yapacaksın	Future
nedeninden	None
kokarsın	Present
bekletiyor	Present
bağcığımız	None
vardı	Past
dişli	None
çıkmanın	None
yerlerdir	Present
üzüldüm	Past
garsona	None
uyarır	Present
böğürtlen	Present
cihana	None
gönderiyoruz	Present
tutku	Present
satıyordu	Past
salıyorlar	Present
kazanmadı	Past
gayzer	None
değiştiriyor	Present
firavunları	None
pırasa	Present
kapağım	Present
jokeyinizin	None
serverlersin	Present
idealdi	Past
kedisiniz	Present
yazanaklar	None
aldatmayacağım	Future
evrenin	None
zibidiydik	Past
ernekleriz	Present
başarırsınız	Present
meşe	None
eriklerine	None
müstahdem	Present
belleklere	None
kullanıldı	Past
konuyor	Present
piskoposun	None
şaşar	Present
geyiğe	None
hamsilerin	None
açılmıyor	Present
uyarının	None
yetiştim	Past
tanıyordum	Past
büyürüz	Present
kırıtacaksınız	Future
erkecellersiniz	Present
çalgıcıydım	Past
düşünmeyecekler	Future
eceleriz	Present
kolyem	None
yalansın	Present
bilemezsiniz	Present
kurutacaksın	Future
çakalların	None
tabelalar	None
tuzlu	Present
devirlerimize	None
kirişini	None
silmem	Present
dayamıyorsunuz	Present
ölümsüzleştireceksiniz	Future
çekirdeklerine	None
köpüreceksiniz	Future
sürüyor	Present
serpeceksiniz	Future
bakmıyorum	Present
uzandılar	Past
uyaracak	Future
canlandırılır	Present
saklar	Present
kör	Present
çöküyordum	Past
adama	None
saldırmaz	Present
başarırlar	Present
yapıyorlar	Present
katilim	Present
doğarlar	Present
vermeyiz	Present
yanarım	Present
çarpmaz	Present
çiğdemi	None
beldenin	None
düşünmediler	Past
bireylere	None
koyarlar	Present
sirkten	None
içiyoruz	Present
omuzlarının	None
radyolarda	None
geçeceğim	Future
verilmeyecek	Future
taradık	Past
kesyapımı	None
süseceğim	Future
yoruyor	Present
gelinecek	Future
bahçemde	None
kolonyalardın	Past
maratoncusun	Present
sevdi	Past
dönmeyeceksin	Future
açıyoruz	Present
sözleşmenin	None
amcalarmışsın	None
doğarız	Present
kaynaşmıyordular	Past
kapmayacaksınız	Future
pederlerinden	None
yardımcılarınızdan	None
tekrarlarını	None
oturuyor	Present
siliyorlar	Present
buzuluz	Present
vida	Present
başardılar	Past
ablalarından	None
basar	Present
homoseksüellersiniz	Present
yormuyordu	Past
satıyorlar	Present
koymuyorum	Present
aldı	Past
istemedik	Past
giderlerinin	None
söndü	Past
anlatacak	Future
fizyoloji	None
etiketlere	None
ağdacın	None
kıyafetlermişiz	None
çerçilersin	Present
şaşıyorum	Present
Duşanbelilersiniz	Present
ulusumuzun	None
ayırıyordu	Past
görüyordum	Past
yetersizlikti	Past
bilmeyecek	Future
Belgratlımızın	None
fakirleştirirler	Present
dudaklar	None
göçer	Present
cepleri	None
bürümeyiz	Present
kedilerin	None
içersin	Present
ayırdılar	Past
gölgeleri	None
yenilir	Present
yıprandı	Past
duvarlarda	None
demedik	Past
döndürecek	Future
kanmadınız	Past
istisnaydı	Past
çalmaz	Present
öldürüyordunuz	Past
çalıştı	Past
silecekler	Future
uçuyor	Present
süzerler	Present
plaklara	None
rakamımıza	None
izliyor	Present
Cakartalıyım	Present
yanlışlar	Present
bölüyor	Present
kocaları	None
bereket	Present
gecikmedi	Past
vedayım	Present
yapmıyorsun	Present
baktınız	Past
bakmaz	Present
bilemedi	Past
bıktım	Past
canlanılmıyordun	Past
değiştirdin	Past
kalıyor	Present
soyar	Present
konuyduk	Past
lahmacun	None
yerleşir	Present
kapatır	Present
ittirtilmiyordum	Past
durursunuz	Present
ejderha	Present
çatıyorduk	Past
yapmayacak	Future
röntgenlerimiz	None
düşmüyoruz	Present
örneklerdir	Present
geçerim	Present
hindiydin	Past
basıyoruz	Present
başarıyordu	Past
geçiniyor	Present
sitemizde	None
utanıyorum	Present
doymaz	Present
odalarında	None
geçer	Present
getiriyor	Present
misafirler	None
babalığı	None
masasında	None
ağırdı	Past
ümitli	Present
öykülerdir	Present
cevaplarında	None
ağır	Present
üretir	Present
çıkarıyorlar	Present
küllerinin	None
kızgın	Present
deneyimin	None
fizikçiydik	Past
sevgiliydiniz	Past
doğuyoruz	Present
kelimeydi	Past
işemezsiniz	Present
temizledik	Past
bakıyorlar	Present
nedendi	Past
sikiliyorum	Present
titrer	Present
çevirimlerinize	None
tahditlerimiz	None
nohudum	Present
musluk	Present
horladın	Past
ölü	Present
bitirirsin	Present
bütünleşmediler	Past
dağıtır	Present
ilköğretimini	None
vermiyordu	Past
bağlayacak	Future
sebeplerinin	None
eşcinseldi	Past
sattı	Past
yapmıyor	Present
dükkândın	Past
yarattılar	Past
getiriyordun	Past
demircilerde	None
enflasyondan	None
vaktimi	None
açılmayacağız	Future
çalgılardır	Present
kelimeyi	None
kullanmıyor	Present
videolarının	None
kediyim	Present
döner	Present
çalarlar	Present
taşımayacak	Future
bölgelerdir	Present
adalelerinizde	None
kispetlerimizi	None
açtım	Past
ağan	None
ortaklıktan	None
güzelleştirmeyeceğiz	Future
kasetlerde	None
dükkânım	Present
inanmaz	Present
gününden	None
güttü	Past
yelken	Present
sikmem	Present
kataloglarınızı	None
verim	None
satranç	None
büküleceğiz	Future
mumdan	None
dileriz	Present
duymayacağız	Future
programlanacak	Future
evleneceksin	Future
ölçüşüyorlar	Present
betiklerimizin	None
şarkıcılardınız	Past
mevkisine	None
defterlerin	None
bakıyor	Present
tasarımın	None
kedi	Present
canlanıyor	Present
alfabe	None
sanatının	None
satılıyorlardı	Past
saydı	Past
sararmadı	Past
varır	Present
alıçlarımda	None
ölümdü	Past
doğacak	Future
geliyorlardı	Past
bileceksin	Future
kocaya	None
yetişti	Past
kovdurtmam	Present
ölüm	Present
üzüm	None
yetkileri	None
zamanınız	None
dağlarından	None
yayarlar	Present
emerler	Present
tabancalarınızı	None
çiziyordunuz	Past
ayrılır	Present
almayacağım	Future
övdü	Past
hecelerde	None
sözdiziminin	None
kuyruklarınıza	None
bekliyorsun	Present
çizmecilerdir	Present
şaşılmıyordular	Past
Yahudilerinde	None
ısıyı	None
ayırırlar	Present
dadanır	Present
kanamıyordunuz	Past
pusmayacaklar	Future
sunakta	None
üşenmiyorlar	Present
duymuyor	Present
kamus	Present
kırdı	Past
âleminden	None
yakının	None
ayrımcılık	Present
şairi	None
yolacaksınız	Future
köprüler	None
ettirecek	Future
kalkanda	None
sığmaz	Present
geliştirmem	Present
üzecek	Future
içmiyorsunuz	Present
döndürdü	Past
yetişirler	Present
kurtardık	Past
saklıyordu	Past
durmuyorlar	Present
öyküsünün	None
ayarlatmadın	Past
göçüyorum	Present
çalışıyoruz	Present
seçilmez	Present
gazetelerinde	None
evlendim	Past
imrenmediniz	Past
vezirlerinin	None
çökeceksiniz	Future
gemiden	None
dağılmıyordum	Past
tıkarlar	Present
etkiliyordum	Past
bütünleşti	Past
saymıyorum	Present
orospusunu	None
kodlarda	None
parçacıkları	None
süner	Present
döndürür	Present
özette	None
akrabalarına	None
savaşımda	None
basarım	Present
gidilmeyeceğiz	Future
çıkarıyorsunuz	Present
geçiyorlar	Present
kesmedin	Past
yendirmeyecekler	Future
eklemelisiniz	Present
verilmiyordun	Past
elmaslarımın	None
sevenlerden	None
doktrinim	None
sözcüğün	None
sarıldılar	Past
varıyoruz	Present
masalının	None
uçacaksın	Future
mayalardan	None
ayarlatırım	Present
sürülüyordu	Past
makinalarında	None
çıktım	Past
satırtmadınız	Past
bakir	Present
gerekecek	Future
çalışıyorlar	Present
çekmecelerimden	None
sanacak	Future
sindi	Past
veriliyor	Present
geçmediler	Past
iyileşmez	Present
örterler	Present
gösteriyordu	Past
çıkardım	Past
çağırdın	Past
kanıtlıyordu	Past
ışığını	None
bayılırım	Present
oyuncak	Present
sarılırlar	Present
geyşa	Present
çavuş	Present
ziyaretsiniz	Present
bugünü	None
toplumlara	None
dinozorumuz	None
süstü	Past
otelin	None
yerleştiler	Past
saldırdı	Past
soslara	None
atmamıyordunuz	Past
kururuz	Present
baylardın	Past
döndüler	Past
gördük	Past
görmedin	Past
istemez	Present
biçimlerden	None
hemşireydi	Past
koyacağım	Future
bakıcılarının	None
arzuhalci	Present
cezalandırıyordu	Past
bulmaz	Present
kuvvetsizlik	None
kazar	Present
oyları	None
değişmezler	Present
çarpmadı	Past
etkileyecek	Future
karnabaharlarda	None
bağırsaklardan	None
iyileştirecek	Future
taşıdık	Past
vereceğim	Future
başarılı	Present
yolum	Present
kaçırdı	Past
sözlüktünüz	Past
seçildi	Past
kaldırımımıza	None
oynuyordum	Past
parçasına	None
öldürür	Present
sevdik	Past
iğrenmiyordum	Past
telefonların	None
teklifim	Present
kalmayacak	Future
kanamayacaklar	Future
uymadılar	Past
lastiklerine	None
geyleri	None
bağlardır	Present
katılmadı	Past
öldürttü	Past
çipe	None
bürokrat	None
tanıtıyoruz	Present
üzülüyordu	Past
figüran	Present
götüreceğim	Future
tuttular	Past
yerimde	None
nişanlı	Present
bozdular	Past
öğrettiler	Past
dumanlarımızı	None
dağıttım	Past
istemcilerdim	Past
yapmadım	Past
yaptınız	Past
kırdılar	Past
çıktınız	Past
atışır	Present
kaçıyorlar	Present
seviyor	Present
açılıyordu	Past
katamaran	None
bahçıvanda	None
çağırdı	Past
puanlara	None
efelerinin	None
izledik	Past
aşığım	Present
kalmıyordu	Past
benzeyecek	Future
taşıyacağım	Future
şarapçısın	Present
geciktirtmiyorduk	Past
duvarlarımdan	None
vermiyorlar	Present
paylaştılar	Past
düşmanım	Present
tekliflerinden	None
okuyorlar	Present
kullanacağız	Future
öfkelendirdi	Past
katacak	Future
otta	None
nenesin	Present
gelininiz	None
sıyırmayacağız	Future
düşündük	Past
köpürür	Present
sayfa	Present
dinlenmeleri	None
yolcuyum	Present
lokumduk	Past
yolunuyorsunuz	Present
pandispanya	Present
görmediler	Past
sararır	Present
vermem	Present
bayıldım	Past
götürürüm	Present
kesmedi	Past
küçüktünüz	Past
fakülteye	None
sildi	Past
şaşıyorlar	Present
duvarın	None
