prilažah	Past
križale	Past
podneli	Past
raširile	Past
maštah	Past
sakatimo	Present
zahvate	Present
simulirale	Past
druži	Present
nailazio	Past
nadmašuje	Present
omekšivači	None
postavljaju	Present
sitniš	Present
školuju	Present
naredniku	None
odzivi	None
pomirili	Past
potvrđene	Past
uvrstimo	Present
čitani	Past
diskriminiraju	Present
raznovrsna	None
strahovao	Past
hodnik	None
nečitljivima	None
ispitano	Past
izostali	Past
poseku	Present
utvrđivalo	Past
pretjerivaste	Past
skrstio	Past
vade	Present
isijeku	Present
dira	Present
otplove	Present
ljepoticom	None
dostigle	Past
epsiloni	None
uginuo	Past
zabeležilo	Past
nudilo	Past
triangularnomu	None
skrivaju	Present
nesputana	None
puštali	Past
sastaju	Present
našao	Past
nevjeru	None
ambijentalnih	None
činovi	None
brinuo	Past
utvrdile	Past
zaokružio	Past
gužvama	None
sastavljaju	Present
prima	Present
tjerano	Past
poklanjaju	Present
treperilo	Past
zavolio	Past
pristajali	Past
obučili	Past
suši	Present
uzima	Present
pričaju	Present
fantazijom	None
franačkom	None
bake	None
opere	Present
shvate	Present
nosiš	Present
trupce	None
nastanjuju	Present
ozljedu	None
najpribranijima	None
omamite	Present
gane	Present
susrele	Past
participirao	Past
naišle	Past
kraniometrijsko	None
dovođeno	Past
aludiralo	Past
najproblematičnijoj	None
naiđu	Present
užitka	None
jahao	Past
izostavljahu	Past
nazdravlja	Present
kultovima	None
pljačkan	Past
obukao	Past
opijen	Past
nahvalio	Past
monolozima	None
zahtevani	Past
odijeljeni	Past
zaliste	Past
nabrajamo	Present
knjiženo	Past
zboru	None
onesposobilo	Past
nošen	Past
buljiš	Present
terao	Past
izrezuju	Present
stradali	Past
krivuda	Present
kročio	Past
mine	Present
nadogradili	Past
hibridno	None
razvijano	Past
podešava	Present
nudi	Present
uzbuđen	Past
nameće	Present
zavoljeli	Past
opredijeljene	Past
grbove	None
nosi	Present
udarali	Past
rastavljeno	Past
malobrojan	None
majmunskomu	None
glazbenom	None
povezao	Past
rascijepio	Past
uzbunjen	Past
cijenimo	Present
hranjiva	None
probijene	Past
miruje	Present
shvaćen	Past
istodobnoga	None
uvrediše	Past
skrenuto	Past
ateizam	None
progonili	Past
nabusitom	None
zatekao	Past
malini	None
kritizirane	Past
uvećanica	None
pitanja	None
naručeni	Past
zabilježeni	Past
ulovljene	Past
uvili	Past
nadletani	Past
odmarale	Past
laju	Present
obilježavao	Past
glodalo	Past
zabijen	Past
prelazilo	Past
podrijetlo	None
ručaše	Past
zaboravljeni	Past
selili	Past
dohvaćeno	Past
iskočili	Past
gustina	None
greje	Present
aktivnijoj	None
barjaka	None
poboljšavaju	Present
mjereni	Past
jadi	Present
umetao	Past
skršio	Past
zloupotrijebljen	Past
dospijete	Present
suzbijaju	Present
elaborata	None
osramoćivao	Past
ubijani	Past
fiskalnoj	None
izjednačile	Past
krdžalijo	None
stvorilo	Past
prilagode	Present
potpisano	Past
ujedinili	Past
iscrpljuje	Present
opsedan	Past
dosezale	Past
prezire	Present
očišćene	Past
prsne	Present
kružnice	None
pribavilo	Past
vesela	None
propalo	Past
baća	None
centralizacije	None
porekao	Past
stupnjevima	None
kihnuh	Past
popunjeni	Past
diskretna	None
razvrstan	Past
iznimnoj	None
američkim	None
prevarili	Past
postili	Past
privučene	Past
komičnoj	None
upućivalo	Past
raspršuju	Present
školovali	Past
luftirale	Past
afričkim	None
upućeni	Past
radovali	Past
pregledne	None
vodećoj	None
simpozijima	None
razmenili	Past
dugoročnih	None
obvezuje	Present
podsete	Present
usuđuješ	Present
razvijane	Past
naterali	Past
pivu	None
duvate	Present
ništavnom	None
podudarali	Past
kafane	None
sahranjuje	Present
poboljšane	Past
zagrebete	Present
većinska	None
porasli	Past
riješilo	Past
olakšavaju	Present
nominativu	None
kaputom	None
protjerao	Past
razmaknuti	Past
smjestili	Past
vriš	Present
pritiskujete	Present
nasrnuli	Past
ublažio	Past
gangstere	None
skrše	Present
odsečeni	Past
zastrašuje	Present
ostavljeno	Past
uništio	Past
ostvaruju	Present
poteru	None
izgubljeno	Past
donosimo	Present
povlačilo	Past
gospodari	Present
ohlađeni	Past
nađeno	Past
titra	Present
idealnim	None
spretno	None
lojalan	None
prikazali	Past
najneumerenijima	None
dopuste	Present
zagrijava	Present
zašao	Past
opravdani	Past
školovale	Past
izručile	Past
kosnuše	Past
atlantskom	None
savjestan	None
iskazivane	Past
visova	None
rubeolu	None
dostavljali	Past
nasukane	Past
opovrgavali	Past
jurcaju	Present
sablasno	None
primijenjen	Past
opterećene	Past
nagnuti	Past
zdepastima	None
naručuje	Present
ometale	Past
poprima	Present
iskorijene	Present
obaveštavao	Past
pripravnijega	None
zacjeljuju	Present
strugotine	None
radijalnu	None
načinjeno	Past
zapamtim	Present
pomešali	Past
izašli	Past
reminiscirate	Present
federativnom	None
krepaše	Past
učen	Past
iskopavamo	Present
nijekali	Past
uzdrže	Present
staništem	None
tuku	Present
pređeni	Past
rabotaste	Past
gladio	Past
čovečanstvu	None
presvučeni	Past
vježba	Present
prihvate	Present
očekujemo	Present
približe	Present
suzujem	Present
otjeraju	Present
zatočen	Past
kršili	Past
gvozdenih	None
odlučujemo	Present
farbo	None
koči	Present
razvrstavaju	Present
dimenzijama	None
rangirao	Past
pogodile	Past
mere	Present
pokazuje	Present
izbrisani	Past
zamjeraju	Present
prelazile	Past
razgolićuju	Present
zaokruženo	Past
grijale	Past
tvista	None
vozaču	None
zgrijah	Past
omogućene	Past
zahtevan	Past
mljeveni	Past
razbjegnem	Present
preostaju	Present
istjerane	Past
pogode	Present
rezao	Past
ugrožavaju	Present
ljubomornom	None
nagnuto	Past
pojavili	Past
ugreje	Present
približile	Past
mirovali	Past
želeli	Past
odrađen	Past
stavljene	Past
travnjacima	None
priseća	Present
prevrnuste	Past
dizali	Past
kòlektor	None
roditelj	None
srodnikom	None
pokušao	Past
uzdržavani	Past
zamijenjen	Past
intervali	None
troše	Present
razodjenuste	Past
analno	None
najavio	Past
smilovasmo	Past
uništile	Past
obuhvaćale	Past
nižu	Present
carem	None
zamjerali	Past
bestije	None
jaši	Present
stopilo	Past
nagrđuju	Present
solsticija	None
studira	Present
kažnjavaju	Present
iskočio	Past
livene	Past
izjasnite	Present
pripremali	Past
zastali	Past
vraču	None
božica	None
garantuju	Present
utvare	None
vjerodostojniji	None
jačalo	Past
korištene	Past
krivotvoren	Past
spran	Past
izbrisalo	Past
posijeku	Present
čuvene	None
prepuštene	Past
vjeriš	Present
vili	Past
crnči	Present
pretučen	Past
čamo	None
obećavaju	Present
sumnjali	Past
povučene	Past
kraljevstvima	None
astronomijsku	None
amebe	None
zadužujemo	Present
preleteli	Past
imitiraju	Present
suđeni	Past
ismijan	Past
indikacijama	None
štrajkali	Past
proučene	Past
ubio	Past
zbune	Present
uznemiravani	Past
podražajem	None
potpisali	Past
predsjednice	None
osvojene	Past
istjeruje	Present
ismejao	Past
zvaničnih	None
sangrija	None
terapeutskom	None
zbunjene	Past
zapečete	Present
računale	Past
njegovani	Past
prepisivani	Past
sličnima	None
rasplakale	Past
pokušajem	None
tjeskobom	None
ukrasio	Past
popisao	Past
svađali	Past
isticale	Past
ontogenezom	None
pregrade	Present
razoružavah	Past
ugrađuje	Present
bistrilo	Past
smjeste	Present
navalio	Past
znanja	None
učvršćivao	Past
lijeni	Present
nametne	Present
bahatihu	Past
neizvjesne	None
rastjeruje	Present
učvršćeno	Past
bajaš	Present
jugu	None
spirituálnosti	None
borili	Past
obučavao	Past
političku	None
ispravio	Past
pridobiste	Past
veprovče	None
mirovale	Past
gunđasmo	Past
antropomorfni	None
izdahnuo	Past
mudracima	None
smeše	Present
majmunska	None
impresioniranoj	None
običavao	Past
nadviste	Past
nadjačava	Present
gramofonsku	None
mešoviti	None
negativci	None
budimpeštanske	None
bacaju	Present
upotrebim	Present
skočilo	Past
podržavan	Past
izrezbareni	Past
zaključujem	Present
ublažuju	Present
sakupljaju	Present
kišu	Present
miješane	Past
odsjekli	Past
krimskim	None
lansirale	Past
napaćene	Past
promaknusmo	Past
izbegavao	Past
pogrešno	None
slušan	Past
rascjepa	None
neophodnih	None
raskinule	Past
arhaiziraš	Present
ponosa	None
kliknete	Present
iznenadio	Past
slojevita	None
ugasile	Past
predstavljeno	Past
usavrše	Present
vodopadu	None
zahtijevan	Past
birane	Past
čvorovi	None
kurs	None
postupao	Past
nalikovao	Past
metajezici	None
potvrđen	Past
poverovali	Past
promatrane	Past
zatrujemo	Present
zakunu	Present
proticao	Past
sistematičan	None
zasjenjeni	Past
beleške	None
praznuju	Present
odobrovoljujemo	Present
uočljivoga	None
dale	Past
dangubljaste	Past
napor	None
tankom	None
vilica	None
udao	Past
razgovaram	Present
križovečkima	None
plutaju	Present
dane	Past
navikavamo	Present
oglase	None
porušio	Past
prijezira	None
narečjem	None
raskućih	Past
mukalo	Past
prkosi	Present
zrcale	Present
mamuti	None
dozvoljavali	Past
mahnule	Past
opazio	Past
napominjem	Present
kristalizira	Present
razbolio	Past
nasamarili	Past
snimale	Past
cenzurom	None
besprekorna	None
zaostalo	Past
prognozirao	Past
kliču	Present
ihtiološko	None
spisateljici	None
trepćem	Present
palatalnima	None
crtica	None
uvjerava	Present
rashlađuje	Present
enciklopedist	None
stupova	None
pretplatnici	None
fascinantna	None
stizao	Past
određuju	Present
pretpostavili	Past
ilustraciju	None
prođu	Present
pogodilo	Past
lažem	Present
kravaricu	None
otkopani	Past
boravile	Past
poremećeno	Past
raspolagalo	Past
zbraja	Present
podvodili	Past
mušketir	None
primećen	Past
odnose	Present
obrubljujete	Present
preraspodelile	Past
činjeno	Past
terano	Past
praćke	None
svedočen	Past
raspeš	Present
bolest	None
svirasmo	Past
ovladalo	Past
proširivali	Past
zamerio	Past
akumulirale	Past
košarica	None
nadahnuo	Past
suprotnostima	None
prikazivalo	Past
spekulira	Present
pripremnu	None
željeznim	None
ponudilo	Past
budale	Present
zamrzili	Past
dešavao	Past
pretpostavljeno	Past
demagoškim	None
dvojim	Present
nesli	Past
kobnom	None
opskurna	None
neumjereniju	None
poručivali	Past
pišemo	Present
presrele	Past
navalili	Past
bijelile	Past
uginuli	Past
budimpeštanskim	None
ograničismo	Past
postignemo	Present
izdiše	Present
ugušen	Past
zarekao	Past
nadobudni	None
cepano	Past
ulaze	Present
poremetio	Past
kokodakaste	Past
nahrane	Present
orkestrima	None
uznemirio	Past
rukovodioce	None
sretao	Past
pripali	Past
udahneš	Present
prisjetio	Past
pojačava	Present
potrebni	None
балистички	None
најосјећајнији	None
iskazali	Past
odbijene	Past
osakaćuje	Present
rožnicom	None
dobročinitelji	None
raznosilački	None
spriječili	Past
opovrgavaju	Present
talogu	None
objašnjavaju	Present
mušterija	None
ostavljen	Past
testirali	Past
obogatiš	Present
krivične	None
ponižava	Present
kuhalo	Past
upotrebljavale	Past
odrađuju	Present
doselilo	Past
nagnut	Past
regrutirate	Present
beli	Present
financirano	Past
raznježiš	Present
sljepilima	None
otkazalo	Past
незамијећен	None
otmičara	None
fakultete	None
umeo	Past
sade	Present
knjižici	None
savije	Present
ukrućen	Past
uvećani	Past
probuđeno	Past
zaplovio	Past
razoružavaju	Present
esencijalno	None
podijeljen	Past
useljava	Present
pobude	Present
nemamo	Present
podelite	Present
ruševine	None
napijate	Present
održavalo	Past
oblim	None
delatnike	None
firmu	None
najintenzivnija	None
ćerahu	Past
proćerdavah	Past
izgovorio	Past
slijedilo	Past
polijetah	Past
raspoloženje	None
provodili	Past
uverili	Past
kidnapiram	Present
opterećivalo	Past
plimi	None
provjere	Present
podmornici	None
ticalo	Past
sličnijim	None
vježbu	None
etiopskom	None
odugovlače	Present
ušli	Past
najkraće	None
određivale	Past
zadesimo	Present
posjećeni	Past
ustupili	Past
osvanuo	Past
nagne	Present
nelegalne	None
izvlačim	Present
uvećavao	Past
pronalazilo	Past
guraju	Present
rasporedili	Past
reagirale	Past
pokusi	None
brije	Present
odsječen	Past
pokorili	Past
haje	Present
kolonistima	None
stjecali	Past
osobiti	None
izvješćuje	Present
upija	Present
opisivao	Past
pregrađuje	Present
nagovijestio	Past
upozorili	Past
sačuvao	Past
donošene	Past
jestivi	None
zečje	None
okončaju	Present
pale	Present
krivinu	None
leta	None
doviknuo	Past
skucani	Past
podstrigli	Past
prenijeli	Past
zasjenjuju	Present
upozorio	Past
šampionsku	None
ugušiš	Present
neprihvatljivima	None
istaknutoj	None
tesari	None
odvažio	Past
obojio	Past
restriktivno	None
štitolikomu	None
lukavi	None
porađale	Past
nadao	Past
raspisali	Past
stogu	None
mislile	Past
nastanjuje	Present
iskrenima	None
uporabio	Past
patogenim	None
oplemenjene	Past
postigne	Present
primani	Past
odmažeš	Present
pobjegnem	Present
izbušen	Past
primao	Past
mađarski	None
sprečavalo	Past
naručivao	Past
dlakavi	None
čuvano	Past
injekcijama	None
smatram	Present
kratica	None
primenile	Past
zaglibilo	Past
postupali	Past
označava	Present
opisali	Past
vezivali	Past
uvlačeni	Past
dođete	Present
preuzimaju	Present
boduje	Present
oponašasmo	Past
literarnim	None
navodi	Present
imunizirate	Present
obrazovao	Past
hotelska	None
liže	Present
vodoravnoj	None
beležimo	Present
ispunilo	Past
presječen	Past
dijagnostikom	None
čude	Present
najpotpunija	None
zapisuju	Present
dopisivao	Past
pričljivija	None
oženile	Past
sažimaju	Present
razumemo	Present
uspjesima	None
odobrovoljih	Past
štovani	Past
odbacimo	Present
participira	Present
frkahu	Past
agnosticima	None
zahtevima	None
ustvrđeno	Past
odgode	Present
uvaženi	Past
sumaglice	None
veterana	None
upropašćuje	Present
vlagom	None
nabaciš	Present
potpisuje	Present
oružano	Past
zimuj	None
logoruju	Present
bežao	Past
magnetom	None
sakrivao	Past
nirvani	None
raspršite	Present
stile	None
držan	Past
prigovorimo	Present
trajniji	None
providni	None
usredotočene	Past
zidan	Past
šumova	None
izlagan	Past
odeveni	Past
lančanom	None
monografije	None
dopunili	Past
svodio	Past
zanimale	Past
okruživale	Past
antifašističkom	None
uozbiljiše	Past
laje	Present
nerješivu	None
kudiš	Present
подневни	None
iscrpljivali	Past
estetike	None
partìcīp	None
uspostavlja	Present
dimili	Past
naivnije	None
uznemiravaste	Past
praktičnu	None
oružanim	None
rabili	Past
psihijatar	None
rasulo	Past
okretale	Past
ušetaše	Past
inicijalni	None
odabrale	Past
nasilju	None
konstruirali	Past
taru	Present
kruniše	Present
vadile	Past
trovano	Past
posvećivane	Past
zaboravljao	Past
običaj	None
uvučeni	Past
objedinjeno	Past
dimnjaku	None
dvojicom	None
dovodimo	Present
vještačiš	Present
priličnu	None
jahali	Past
melodrame	None
šljem	None
potvrdite	Present
mjere	Present
udružuje	Present
preseljen	Past
patrijarhu	None
suprotstavljene	Past
koherentnijom	None
ostavljeni	Past
prebijamo	Present
homozigoti	None
zgrušavao	Past
povredio	Past
naglašavamo	Present
pobunilo	Past
povratimo	Present
prijavljeno	Past
poboljšalo	Past
nadimci	None
koristio	Past
neovisnom	None
iskrčim	Present
uveličava	Present
sargaško	None
crep	None
čarobnjake	None
odazivao	Past
branjeno	Past
osuđivani	Past
navikavale	Past
uveren	Past
ustane	Present
kristalizirane	Past
svetkuju	Present
spojnicama	None
ozbiljnoj	None
sitni	Present
bistrim	Present
povode	Present
namjeravate	Present
sokova	None
tela	None
defekte	None
obespravljeni	Past
odrezani	Past
budista	None
prevladale	Past
poništili	Past
izračunalo	Past
brevijara	None
iskazuju	Present
скровитији	None
škrtom	None
potplaćivali	Past
spaljivali	Past
obilježio	Past
obavezaste	Past
ruski	None
letke	None
razočaralo	Past
sahranjene	Past
otkazano	Past
obećan	Past
titraj	None
krase	Present
trijumvirat	None
financijskim	None
mjerama	None
poverovaste	Past
otkrijemo	Present
pluskvamperfektu	None
darivaju	Present
odobrim	Present
pridremaju	Present
uradih	Past
razgovorom	None
priklanja	Present
postavljamo	Present
sadržavaju	Present
dočekale	Past
otuđeni	Past
pljusak	None
devojkom	None
vejani	Past
preoteti	Past
predložilo	Past
amputaciju	None
nadjenuti	Past
sabijene	Past
klize	Present
pokušavale	Past
prerušeni	Past
utvrdio	Past
predbacuju	Present
nazočnošću	None
garantiraju	Present
groznicom	None
sprečavale	Past
slašću	None
negativnosti	None
uredno	None
izručili	Past
održavane	Past
polažu	Present
izostavlja	Present
isušeni	Past
bućkalo	Past
suprotstavljale	Past
rasecane	Past
razmotano	Past
djelotvornija	None
zaglavljen	Past
objeduje	Present
ocijene	Present
sačinjeni	Past
proslavio	Past
raspršeno	Past
voštanome	None
uvjerljivih	None
skretao	Past
slijepih	None
dospijevaju	Present
panja	None
raspoređen	Past
utiče	Present
sipao	Past
pribran	None
uložile	Past
dokumentarnomu	None
zaraze	None
dobacio	Past
probio	Past
pravovaljan	None
osvježava	Present
верни	None
нечовјечнији	None
iskusile	Past
hvalim	Present
primijećeno	Past
profinjen	Past
nasmeje	Present
uspavane	Past
kapali	Past
raspadao	Past
opredijeljeni	Past
sakrivali	Past
kosne	Present
sveže	Present
teoretizirao	Past
gotovim	None
jekom	None
dodele	Present
zapovjedile	Past
prisećam	Present
zastupali	Past
načinjene	Past
sabijeni	Past
žlijebom	None
neželjeno	None
razlikovali	Past
ište	Present
bilancu	None
pokoren	Past
presekoše	Past
povučen	Past
sipio	Past
ratovalo	Past
izvoženi	Past
isušio	Past
imamu	None
predvideli	Past
delimo	Present
preslikaš	Present
napustio	Past
refraktori	None
guta	Present
izišao	Past
žilav	None
prelazili	Past
tovili	Past
sidru	None
neobavezan	None
učinke	None
implicirao	Past
belasnule	Past
zamenici	None
svíci	None
uceno	None
ohrabrivan	Past
razvije	Present
baziralo	Past
prelazimo	Present
paor	None
zgužvaste	Past
udareni	Past
neutralizirao	Past
civilna	None
kratkodnevica	None
hvataju	Present
zapaljeno	Past
prostire	Present
skočio	Past
turnirima	None
nadahnule	Past
vare	Present
preoran	Past
isporučili	Past
lečeni	Past
savršenosti	None
poprskavane	Past
predložili	Past
pokretani	Past
odjahao	Past
zavuku	Present
radiologije	None
privezujemo	Present
bosanskim	None
krasičkomu	None
neželjene	None
ratuju	Present
stropu	None
zadrže	Present
snivaju	Present
архитектонски	None
razmijenjen	Past
prenošeno	Past
potrajale	Past
novom	None
zadavili	Past
trivijalne	None
efektivnom	None
nošene	Past
porastu	Present
školovan	Past
fascinirah	Past
predočite	Present
slupao	Past
seje	Present
cigane	Present
rukuju	Present
skandinavskom	None
централни	None
srednjoameričkoj	None
zapušteno	Past
branile	Past
umetani	Past
crpilo	Past
nadahnuti	Past
održano	Past
kodekse	None
transportiram	Present
soda	None
poželio	Past
pomagali	Past
masturbaciju	None
porabu	None
pitali	Past
ženi	Present
doselio	Past
treniralo	Past
dodjeljivani	Past
maze	Present
igumanu	None
radite	Present
sumnjivostima	None
teniskih	None
neuspjelu	None
postignuto	Past
drvodelja	None
arheološkom	None
najpunašnijim	None
pričvršćuješ	Present
učvršćivale	Past
kori	Present
uvetnoj	None
naginju	Present
snalazio	Past
opovrgnuto	Past
jeca	Present
divljali	Past
unuk	None
cezura	None
napuštahu	Past
biografiji	None
nagovor	None
salamandra	None
modalitet	None
pljačkom	None
dočekuje	Present
rudarsko	None
kreketah	Past
propadaste	Past
onemogućile	Past
skucavano	Past
hvalite	Present
varane	Past
uvažio	Past
delovao	Past
ljušte	Present
pomirile	Past
vešerkom	None
tkani	Past
održavaju	Present
ticao	Past
speleologije	None
kasnijih	None
poludeli	Past
čuvaš	Present
poticale	Past
raspoređivao	Past
neuspeli	None
razglase	Present
sine	Present
iskrcane	Past
prokrstarene	Past
razvodnim	Present
razasut	Past
hotelskoj	None
pomognemo	Present
renoviraju	Present
севернокорејски	None
otkidaju	Present
abacima	None
šekspirskom	None
obasjavaju	Present
iseljenicima	None
spriječeno	Past
zasmetamo	Present
šačicu	None
ostaju	Present
upoznavali	Past
lončarskom	None
doznavao	Past
bejzbol	None
osetile	Past
podržavamo	Present
podrežimo	None
ispravni	None
najuporabivijih	None
prepustile	Past
utjecali	Past
oštro	None
dodavane	Past
pokažem	Present
iskopao	Past
dolovi	None
prevoze	Present
računari	None
svrstan	Past
sporazumele	Past
guram	Present
lelečete	Present
gubljeni	Past
obuhvatiste	Past
primorane	Past
tkale	Past
presecaš	Present
преријски	None
pošli	Past
nepažljive	None
posedovahu	Past
rušio	Past
usude	Present
ističem	Present
podgrađivasmo	Past
preporučujemo	Present
kreštah	Past
prostituciju	None
izlikom	None
pretpostavljam	Present
prebio	Past
čileanskim	None
odvojeno	Past
prostiru	Present
primijetite	Present
htjelo	Past
rasipao	Past
makedonskom	None
osvetiste	Past
rušene	Past
osvanuli	Past
dosegnete	Present
bankama	None
zapoveđeno	Past
isele	Present
kozmičkoga	None
nikne	Present
grezoga	None
pomakne	Present
tapetari	None
najavljene	Past
pravnih	None
pozovemo	Present
oruđu	None
genitivom	None
grešnom	None
natopljen	Past
kakofonija	None
impresionirale	Past
spaljivane	Past
isprobao	Past
gnječaste	Past
točaka	None
kreše	Present
dodan	Past
izganjali	Past
prislanjah	Past
vagi	None
primoravani	Past
kromiram	Present
civilizaciju	None
udaru	None
poklanjali	Past
mete	Present
obešeno	Past
kreirao	Past
prevođeni	Past
branjeni	Past
začaravate	Present
zonama	None
utvrđivan	Past
udruženja	None
lončarnici	None
ubacim	Present
oslobodili	Past
bilježili	Past
severnoafrička	None
umore	Present
ubo	Past
podseća	Present
narodnoj	None
sakupljeno	Past
izlomljene	Past
ljubomornoga	None
strance	None
skamenjivali	Past
izrađene	Past
ravnalo	Past
obustavljeni	Past
povređen	Past
vučiću	None
izricali	Past
napreduješ	Present
razvijene	Past
kuhano	Past
bedastija	None
obuhvaćali	Past
најмамурнији	None
neprestanom	None
kasale	Past
povraćasmo	Past
graniče	Present
mučene	Past
događale	Past
neopravdane	None
polaže	Present
agregatnim	None
imele	None
sklanjalo	Past
zaglibljene	Past
unižavalo	Past
luče	Present
kućni	None
milimetra	None
kvario	Past
lađu	None
zovu	Present
psihičkom	None
nateran	Past
popratilo	Past
negaciju	None
štuju	Present
stvorite	Present
poštenom	None
podelimo	Present
školstvom	None
gustu	None
osvojeni	Past
trijumfi	None
srušene	Past
sekretarijatu	None
zdepast	None
pobjeđivali	Past
medvedu	None
anarhičnijom	None
sirovoga	None
guslama	None
srpanjsku	None
vjesnika	None
dubina	None
uviđao	Past
osiguravalo	Past
proizvođah	Past
štedio	Past
krizantema	None
uvrštava	Present
bivali	Past
podsjećalo	Past
biserne	None
najblještaviji	None
oličavajmo	None
izgube	Present
vit	Past
državni	None
uplašeni	Past
znatan	None
prkosio	Past
pridruživao	Past
pripisani	Past
proporcionalan	None
preskočio	Past
bezvrednije	None
tamošnju	None
utekoh	Past
posjećivalo	Past
vario	Past
trpelo	Past
prikrada	Present
kandidaturu	None
najmonotonije	None
surađujemo	Present
ublažavani	Past
obdarivan	Past
keramičarkama	None
sastavili	Past
upozoren	Past
podeljeni	Past
nadživeo	Past
očistio	Past
izumeh	Past
poricali	Past
smenjujte	None
zadivljeni	Past
radnice	None
okeanom	None
stisnut	Past
probaju	Present
svȋzācā	None
šahovsko	None
arogantan	None
pobjeđivao	Past
rečene	Past
propovijeda	Present
odvežemo	Present
zapazite	Present
eksplozivna	None
jamčio	Past
troši	Present
sekle	Past
ovenčan	Past
posjećivao	Past
uvećava	Present
prebrode	Present
zaustavilo	Past
idealizacija	None
скептичан	None
prethodilo	Past
afirmiraju	Present
dele	Present
istjerali	Past
sotoniziraste	Past
pripisuj	None
zataškaju	Present
svirali	Past
crtani	Past
navlažiste	Past
odaberemo	Present
bratićem	None
zaredava	Present
prolažahu	Past
sakupio	Past
uhapse	Present
zaljubljuje	Present
pročitavani	Past
skočili	Past
ulasci	None
spremao	Past
vjenčava	Present
bodraste	Past
ublaženi	Past
razvijaju	Present
putujem	Present
odazvalo	Past
rasističkim	None
prevariše	Past
smišljao	Past
sokole	Present
dozvolilo	Past
potopile	Past
najriskantnijima	None
prikupljao	Past
doživljava	Present
iskorištavaju	Present
opredijele	Present
trošimo	Present
obiluje	Present
ratnom	None
potkupljen	Past
zimske	None
poslale	Past
podijelile	Past
nabrajao	Past
isporučivano	Past
shvatan	Past
krunisao	Past
образовани	None
omeli	Past
oglobio	Past
zamamnijoj	None
prolistah	Past
pseudonime	None
žurili	Past
opseli	Past
ponavljao	Past
pozdravio	Past
borcem	None
isterali	Past
poznajem	Present
radi	Present
priveli	Past
silovite	None
vodena	None
davnim	None
federativne	None
zabranilo	Past
uočio	Past
oslobađa	Present
utučen	Past
pometite	None
posećuje	Present
starinska	None
sažimah	Past
promijenili	Past
odvili	Past
maketom	None
semenik	None
pojedinci	None
priuštio	Past
upućuje	Present
upućivali	Past
najžešći	None
zabubaš	Present
bujahu	Past
činile	Past
podrezale	Past
limunov	None
poželeo	Past
kvasi	Present
nedopustivim	None
odjeljuje	Present
pokušale	Past
kamenitom	None
krivljasmo	Past
bilježilo	Past
plodova	None
poručivalo	Past
prevođene	Past
oke	None
umjetničkih	None
zaustavljaju	Present
posredovano	Past
nasamare	Present
kamenitoj	None
zubi	None
ukrasilo	Past
ovjenčavah	Past
protjerava	Present
veruje	Present
saviše	Past
imenujemo	Present
trpjele	Past
raširujete	Present
gonjen	Past
razrušiše	Past
razbiju	Present
izumire	Present
poklanjao	Past
izrezbarene	Past
odeljene	Past
lepe	Present
raskolom	None
ponizilo	Past
ujedine	Present
svarivaste	Past
novonastala	None
nadgledali	Past
proučavaju	Present
sjetim	Present
utemeljuje	Present
ijekavskom	None
predstavljali	Past
cijenjahu	Past
iskušavan	Past
studentom	None
rabe	Present
implicitni	None
sadili	Past
odobrene	Past
isključuje	Present
odrastete	Present
veslali	Past
modnim	None
dvoboje	None
pogrešnom	None
mrtvom	None
akumuliraju	Present
imigrirah	Past
ublažili	Past
minemo	Present
spomene	Present
uživaju	Present
dušom	None
srebrenu	None
otvaralo	Past
presijeca	Present
posrednu	None
knjigom	None
krpan	Past
promišljen	Past
egzotičnijima	None
namamljivani	Past
primjenjivalo	Past
pružan	Past
spominjani	Past
prevrćete	Present
iseklo	Past
dostavili	Past
označili	Past
dopremljen	Past
prikrile	Past
bacalo	Past
odmičem	Present
preda	Present
kolebao	Past
prisluškuju	Present
otjecao	Past
pojavimo	Present
proslave	Present
kompliciraju	Present
predavah	Past
odlučili	Past
obrađivale	Past
anektiralo	Past
bijekcija	None
krparahu	Past
gnoj	None
sekret	None
ulove	Present
dramatičnijim	None
spomenute	Past
zabilježim	Present
proračunati	Past
oštećivah	Past
evolucija	None
njujoršku	None
tužioci	None
odluče	Present
delova	None
prodani	Past
zahtijevale	Past
mlin	None
vjerujem	Present
nadograđivan	Past
smanjivao	Past
obesiš	Present
obilovalo	Past
umem	Present
pričali	Past
tvornica	None
izvuku	Present
plaćao	Past
bezopasno	None
prijavio	Past
selekcijski	None
primorani	Past
osumnjičiše	Past
praćeno	Past
promijenite	Present
kitili	Past
uključeno	Past
etiketa	None
olakšavali	Past
spašava	Present
opsesiji	None
poništava	Present
prozvaše	Past
prouzrokovalo	Past
sisan	Past
rastavljaju	Present
raseljavaju	Present
емпиријски	None
prethodile	Past
lepljivi	None
isečene	Past
pridonosi	Present
ujedinjene	Past
ponelo	Past
ubijeni	Past
nadjenuto	Past
složili	Past
podčinio	Past
shvaćao	Past
čaplje	None
surađuje	Present
osvanuste	Past
zovem	Present
motane	Past
smrznuo	Past
sablasnih	None
plemeniti	None
impotencije	None
proširili	Past
razdražiše	Past
vratile	Past
vitezova	None
stradavaju	Present
primali	Past
obuhvaćalo	Past
promašivano	Past
otrovan	Past
grejem	Present
ograničen	Past
povedu	Present
saznati	Past
termine	None
sabire	Present
usavršuje	Present
zamišljeni	Past
uzgojene	Past
uhvatim	Present
barataju	Present
skraćuje	Present
neprikladnim	None
ledenice	None
stvarano	Past
izmjeren	Past
dodelio	Past
koštaju	Present
pevane	Past
desetogodišnju	None
civile	None
pozdravima	None
agronomskoj	None
progonjeni	Past
otope	Present
odustaju	Present
makne	Present
nagrizlo	Past
vježbi	None
primičemo	Present
dodale	Past
predavani	Past
ratoboran	None
šetali	Past
naručuju	Present
prosi	Present
kuša	Present
uvrijeđeni	Past
epentezo	None
zagrađivalo	Past
fikcija	None
anticipiraju	Present
reguliram	Present
prezalogajivali	Past
toksikologiji	None
počinjem	Present
služe	Present
probavljaju	Present
zaljubljene	Past
nepostojanje	None
izazivale	Past
žudeo	Past
zlatna	None
maloazijska	None
brisaste	Past
raščlanjeno	Past
uspije	Present
polinezijska	None
prioritet	None
hrvao	Past
osovinama	None
zaboravnoj	None
ugasio	Past
počinjemo	Present
nametalo	Past
kupi	None
uvriježilo	Past
odlučujućih	None
pojedene	Past
sklonjene	Past
pisane	Past
iseljavalo	Past
razmatralo	Past
poverili	Past
identificirale	Past
uvredio	Past
rimokatolik	None
potrošio	Past
preselile	Past
svjetlopis	None
pribodoste	Past
posuđuje	Present
brusi	Present
dostavljen	Past
očekivane	Past
poboljšali	Past
jezdiš	Present
istovariváča	None
karavanu	None
tiče	Present
menjan	Past
vladarevim	None
smrznule	Past
ustvrdilo	Past
besperspektivnim	None
utakmicama	None
davani	Past
moralan	None
privoleo	Past
zadalo	Past
poznavah	Past
prihvaćao	Past
dokazao	Past
prebije	Present
iskusiš	Present
čašom	None
skanjujemo	Present
vernih	None
pokretale	Past
prelijetano	Past
pohvaljen	Past
presudu	None
многи	None
izopačen	Past
nađemo	Present
izračunavaste	Past
upoznajemo	Present
ašikovasmo	Past
odvijaju	Present
prevode	Present
izrazite	Present
klicao	Past
najpopularnije	None
iskoristite	Present
ispekao	Past
prigovarao	Past
napadnuto	Past
degenericima	None
pričao	Past
pohvale	Present
kraćalo	Past
palile	Past
pravljeni	Past
lunarnih	None
ispunjavaju	Present
množe	Present
puzili	Past
uništavao	Past
pronašlo	Past
trgamo	Present
zavaravano	Past
otpali	Past
prestalo	Past
ideološka	None
uzme	Present
toaleta	None
opozvao	Past
posvetio	Past
upotrebe	Present
poseduje	Present
koncentrati	None
zavladaju	Present
romansku	None
uručuje	Present
studirali	Past
zaposlimo	Present
prišao	Past
pobunjivalo	Past
djelovanja	None
kronologijama	None
ukradeno	Past
prokrijumčare	Present
maloljetnicom	None
nadoknađuje	Present
kvantitetom	None
predlagale	Past
humorističku	None
misli	Present
osvežava	Present
romskim	None
skepticizam	None
galerije	None
isključeni	Past
uzdiše	Present
rezbari	Present
zagrijavamo	Present
procijenili	Past
upotrebljavan	Past
opseda	Present
hotele	None
hipoteke	None
gonjene	Past
zabeležili	Past
smetaju	Present
lijem	Present
sklonite	Present
namjeravale	Past
zaključe	Present
vodio	Past
plazite	Present
napušteno	Past
osumnjičio	Past
dezertirah	Past
komisiju	None
prozvane	Past
uvrede	Present
štrajka	Present
tehničku	None
sužavao	Past
obrisano	Past
čitaste	Past
ponudite	Present
zaustavljeno	Past
proslavile	Past
sklanjaju	Present
razvijmo	None
bujaju	Present
mentalnoj	None
savetuju	Present
istražuju	Present
prolistahu	Past
menja	Present
iznudili	Past
raspali	Past
propustio	Past
nedavnu	None
četvorica	None
preventivnih	None
obarao	Past
zadržite	Present
uzburkano	Past
prevladalo	Past
rascepljen	Past
liječen	Past
matica	None
spiskavahu	Past
jednjaka	None
entuzijasti	None
dekorativnom	None
počinih	Past
prijavilo	Past
plemenske	None
prisluškivasmo	Past
ističemo	Present
pojedu	Present
sovu	None
izbijane	Past
razdelilo	Past
ograničili	Past
ribolovca	None
povređeno	Past
najsirotijima	None
produkciji	None
zaljubljen	Past
kuka	Present
kajkavska	None
kockaste	Past
romskoj	None
razdvaja	Present
ugrizu	Present
poludesmo	Past
obilježilo	Past
mislim	Present
prodane	Past
slušane	Past
praški	None
nagovaraju	Present
uplovljeni	Past
tupljeno	Past
pomognute	Past
obitavali	Past
optuživao	Past
zakazasmo	Past
hanove	None
isključile	Past
individualistički	None
zapovedile	Past
protjerate	Present
ojačavaju	Present
pridonosite	Present
rublju	None
smanjivano	Past
napada	Present
garantirao	Past
temeljeni	Past
dizajne	None
azerskih	None
metroa	None
bankrotiraju	Present
melodiji	None
naginjao	Past
korabljama	None
mjeren	Past
uzrujao	Past
radujem	Present
glumim	Present
rasplače	Present
održani	Past
nadmašilo	Past
rasformirao	Past
pogledate	Present
sumnjam	Present
potvrdama	None
spuštene	Past
irelevantno	None
oslabili	Past
pero	None
gležnjevima	None
statuta	None
pajser	None
obrisali	Past
probijao	Past
kite	Present
kršćane	None
ustupaju	Present
cvjetaju	Present
kovrčava	None
kupatila	None
opredelili	Past
baca	Present
puši	Present
helikopteri	None
administratorom	None
patriotske	None
prevalite	Present
ujedinjavamo	Present
ohrabren	Past
razoružava	Present
izbio	Past
ugledao	Past
anatomsko	None
heterogenost	None
ocijenjeno	Past
pripisali	Past
spektrima	None
arterijskim	None
verujemo	Present
dolazi	Present
šupljikaviju	None
zasađeno	Past
presjekli	Past
gigametar	None
sagrade	Present
savremeni	None
bazaju	Present
objavih	Past
brale	Past
povezuje	Present
veto	None
gonili	Past
šoku	None
javili	Past
krađa	None
povećali	Past
dorađivao	Past
odreda	None
napredna	None
kralježnice	None
uživamo	Present
aranžirao	Past
paralaksom	None
kretalo	Past
skladišta	None
izgubilo	Past
šljakali	Past
robusni	None
prepada	Present
poleteše	Past
sled	None
pronašli	Past
očekivani	Past
izostalo	Past
stablu	None
slizani	Past
antikni	None
ukine	Present
otklone	Present
pristalo	Past
slaboumnijim	None
odvajalo	Past
izdašnih	None
omalenom	None
hranjene	Past
oponašale	Past
povezivale	Past
rastvoren	Past
kamuflaža	None
upitnicima	None
mećavi	None
presahnuše	Past
podrazumijevao	Past
безготовински	None
sustaje	Present
krampani	Past
naumite	Present
putuje	Present
informatičar	None
prelama	Present
izmuzu	Present
diva	None
oblikuješ	Present
званични	None
crpimo	Present
preporučeno	Past
iziskuje	Present
obrću	Present
postavljane	Past
pregovarali	Past
zapadnih	None
devijacijsku	None
smišljeni	Past
križopoljskoga	None
hladnoj	None
budim	Present
opomenule	Past
posjećuju	Present
starcu	None
severoistočna	None
učvršćen	Past
rodnoj	None
prebacili	Past
postanu	Present
snimali	Past
neodređenoj	None
zaglavljivani	Past
časopisa	None
dojmova	None
banjice	None
ustrojava	Present
šarlatanstvu	None
naslijeđeno	Past
izopačeni	Past
nabio	Past
zapisuje	Present
vokala	None
golubiću	None
odmorene	Past
naklone	Present
uzbunio	Past
žešćah	Past
zalažu	Present
izbavljeni	Past
плуралистички	None
pripremilo	Past
ukorjenjivali	Past
afektu	None
čuvaju	Present
jada	Present
izoštravam	Present
obogaćivah	Past
poludeo	Past
mislio	Past
okončano	Past
prepoznavahu	Past
inovaciji	None
zapošljavale	Past
golema	None
objedine	Present
pȍduzētnīci	None
kuke	None
kolodvori	None
obaveže	Present
pričvršćen	Past
završeni	Past
lečio	Past
poželjeli	Past
uzajamno	None
smrskao	Past
rasijavali	Past
ublažuje	Present
cijepane	Past
locirale	Past
veridbu	None
gutaju	Present
izmicao	Past
miješale	Past
grdnom	None
grub	None
kristološke	None
turkmenskih	None
gledalo	Past
koliki	None
zavoda	None
sabirani	Past
odolijevao	Past
arheolog	None
dodeljuju	Present
nalomismo	Past
žrtvi	None
srećno	None
fonoloških	None
okupljale	Past
prokušaju	Present
likvidirale	Past
uvukli	Past
nameravaju	Present
prokleto	Past
osjećali	Past
odmoglo	Past
bjelkinju	None
ugroze	Present
sliči	Present
cikličnim	None
oblikovali	Past
štrkovi	None
otklanjaste	Past
rđa	Present
izmjerimo	Present
ispuštao	Past
sumnjičilo	Past
davaoca	None
liftovi	None
umiri	None
otpušten	Past
tepen	Past
zaređujem	Present
gadi	Present
povratke	None
sakramentnom	None
uklete	Past
raspršile	Past
izjurio	Past
osjećamo	Present
obojeni	Past
zaveo	Past
izjavilo	Past
bazirah	Past
procenile	Past
legende	None
utonuo	Past
lukavstvom	None
uspeva	Present
razdirali	Past
usvaja	Present
komunicirao	Past
pronađene	Past
pružene	Past
promatraste	Past
jaram	None
nađete	Present
spužvama	None
radikalne	None
nojem	None
stručan	None
obavestilo	Past
posvećuje	Present
odmažu	Present
zatvarani	Past
prolazile	Past
kratio	Past
ocenjene	Past
podgrijete	Present
tranzitnu	None
izvukao	Past
grnemo	Present
izlučuje	Present
klizi	Present
verujete	Present
ugrožen	Past
rudimentarno	None
šalju	Present
poslednju	None
prekida	Present
odazivali	Past
vlažnije	None
prevozili	Past
popravljan	Past
kleptomanskima	None
poticalo	Past
koristim	Present
dogovoreni	Past
navode	Present
svidio	Past
upoznat	Past
ostacima	None
buba	Present
izbjeglo	Past
ženili	Past
prevladavao	Past
obeščastio	Past
investiraju	Present
otkrivali	Past
razmatrane	Past
naoružavaju	Present
spriječilo	Past
posramio	Past
govori	Present
zapušta	Present
najčarobnijima	None
iznosilo	Past
poticane	Past
smrzavaju	Present
ispovesti	None
najavljivačima	None
sastavismo	Past
drukčijim	None
pandžama	None
preokrenuli	Past
suzbili	Past
dobrotvornu	None
reše	Present
ruje	Present
ukinuto	Past
maramama	None
religioznim	None
žešće	None
kritizirali	Past
čupaju	Present
izrodile	Past
venčali	Past
povežu	Present
sestrom	None
listaju	Present
zavisi	Present
ustrojeni	Past
seksualnom	None
falusa	None
zaklinje	Present
sejan	Past
spriječio	Past
vratim	Present
izgledam	Present
iskorištavani	Past
liske	None
kozlaca	None
promišlja	Present
zapovedali	Past
urade	Present
ađustirao	Past
isprobaste	Past
poveravao	Past
kročili	Past
izrezao	Past
opozicija	None
naseljavan	Past
klopamo	Present
inspirirale	Past
ispire	Present
oklevali	Past
držimo	Present
prodavaonicu	None
tranzitom	None
raširilo	Past
istražene	Past
imitiralo	Past
bukovih	None
besjedite	Present
uviđali	Past
adoratore	None
uzgajani	Past
tiše	None
zadržavao	Past
neprijepornom	None
iznio	Past
simbolizirale	Past
pučiste	None
odmorim	Present
omogućio	Past
utješio	Past
glasilo	Past
njegovale	Past
limunom	None
sukobim	Present
mire	Present
smire	Present
atentate	None
treptahu	Past
plećima	None
izrađivah	Past
svojevoljna	None
preorate	Present
pržuna	None
sazivaju	Present
pokazano	Past
sabirne	None
prozvah	Past
okrenut	Past
izlažu	Present
đumruku	None
pripale	Past
zahtijevalo	Past
dočarlivome	None
dostizali	Past
širilo	Past
sačekao	Past
dosađivao	Past
postavljale	Past
uvlačile	Past
pridonose	Present
umeću	Present
učlanjivali	Past
preotima	Present
zaveže	Present
dostavljeni	Past
meškoljah	Past
praznuje	Present
pljeska	None
opravdao	Past
iselio	Past
penisom	None
prikupe	Present
pobeđeni	Past
pročitavao	Past
ventilacijskim	None
zavređuje	Present
visio	Past
štitio	Past
pobijeđen	Past
obećano	Past
rešile	Past
dragocene	None
ugrađivaste	Past
priopćeno	Past
krivulja	Present
sezonu	None
sačuvane	Past
usidreni	Past
drobio	Past
snabdijevaju	Present
treningom	None
draži	Present
zbunjeno	Past
gurani	Past
namjeravali	Past
vele	None
kristijaniziraste	Past
uvidjelo	Past
unakažene	Past
eksplodiraste	Past
promenu	None
besmrtnom	None
napadano	Past
poricao	Past
privlačni	None
dodavalo	Past
trgnuo	Past
izjašnjavaju	Present
vraćao	Past
trčkara	Present
napustile	Past
obećale	Past
postojano	None
fizička	None
beknuo	Past
hroničaru	None
transliterirah	Past
seoskoga	None
silvanče	None
dlakaviju	None
trostranu	None
sjedio	Past
razmotrite	Present
zloupotrebljavao	Past
začet	Past
декоративнији	None
osvete	Present
familijama	None
pušteno	Past
latiničnih	None
dorađeni	Past
probava	None
pobiju	Present
najsretnijom	None
izazvali	Past
uvijete	Present
širi	Present
prokopali	Past
usidrene	Past
direktoru	None
botaničke	None
suzbijete	Present
preformuliraš	Present
rajsko	None
uverile	Past
vegetaciju	None
objasnite	Present
dospele	Past
nadgledao	Past
raspravlja	Present
prisustvovalo	Past
sporazumeo	Past
zapošljavao	Past
krijumčari	Present
isprao	Past
osnuju	Present
dime	Present
kompjutori	None
gorljivijima	None
izvodili	Past
razmotavam	Present
opišete	Present
demokraciju	None
balkone	None
uzeto	Past
časovite	None
asimilirao	Past
priklonili	Past
upisivani	Past
pričane	Past
ispadali	Past
potkopalo	Past
svàdljīvca	None
usavršavali	Past
impulzivnija	None
lenjah	Past
bliještalo	Past
ratno	None
čovječja	None
razmjenjivali	Past
predložene	Past
smanjiše	Past
maknute	Past
ambroziju	None
likvidirao	Past
ispričava	Present
pobilo	Past
jazbinama	None
analgeziju	None
dozvoljavale	Past
odviste	Past
obvezale	Past
siledžije	None
utvrđivali	Past
zjapi	Present
balansiraju	Present
stabljici	None
napomenuti	Past
plašile	Past
anaerobna	None
crijevnih	None
ganuti	Past
grabe	Present
poriču	Present
onakva	None
ukinulo	Past
šunja	Present
isečen	Past
usvojene	Past
torpeda	None
izbijeni	Past
neefikasne	None
smicano	Past
iračkih	None
onečišćene	Past
dospjele	Past
pridonosimo	Present
sasječeno	Past
gljìvār	None
dodavao	Past
jednolikome	None
upotrebio	Past
sudjeluješ	Present
gravitirah	Past
naslućuje	Present
zalijem	Present
ovladale	Past
upošljavalo	Past
upalo	Past
uvježbavaju	Present
sebičnijoj	None
obilježene	Past
obranama	None
dijabetičar	None
ratničke	None
osećaju	Present
municiji	None
sustanarom	None
dijeli	Present
smanjivan	Past
pevalo	Past
potkrepljivan	Past
nikaragvanskim	None
preferans	None
pristupili	Past
raspoznatljiv	None
iskorištavao	Past
ubirao	Past
sjeveru	None
udaljilo	Past
pijetlove	None
austrijskih	None
posredovao	Past
probijasmo	Past
sijecijaste	Past
dopremljeno	Past
krijumčarili	Past
štedionice	None
mirišu	Present
stratigrafija	None
geometriji	None
podmuklu	None
namnožavasmo	Past
uzeti	Past
odbranili	Past
krčio	Past
zagrejavate	Present
razrađene	Past
superiornoj	None
drevni	None
srećnu	None
nokaut	None
golicane	Past
ustvrdite	Present
učvršćivano	Past
razmišljali	Past
primamo	Present
zgadiste	Past
karate	Present
stiglo	Past
iskušava	Present
američku	None
ugrijasmo	Past
zastraše	Present
inspirirao	Past
budnima	None
spevao	Past
otpadalo	Past
gordi	None
dobroj	None
estonski	None
bombardirao	Past
lekovitu	None
gipkom	None
punjeni	Past
rekonstruirasmo	Past
sastanka	None
financirale	Past
raščlanjujete	Present
plodonosnim	None
ustanovljeno	Past
inovirah	Past
medena	None
dojavili	Past
odmeriste	Past
potrajao	Past
sačinjavao	Past
objavljuju	Present
tiskane	Past
geometrijama	None
isijeca	Present
uzletjelo	Past
kesi	Present
prebacim	Present
svratih	Past
ključalo	Past
nabavljali	Past
integralnih	None
održan	Past
švrake	None
uspostavljeni	Past
naučilo	Past
praćen	Past
obitavao	Past
seocima	None
zaštite	Present
uposleni	Past
snalaze	Present
goni	Present
držali	Past
prilaza	None
zavisile	Past
zaostajao	Past
slijeđeni	Past
ubrani	Past
zahvalili	Past
koren	Past
nasledili	Past
ista	None
mislilo	Past
sramotna	None
šarmiraj	Past
trampiste	Past
skida	Present
šaltasmo	Past
prestali	Past
savskih	None
prolazilo	Past
prepuštali	Past
jadate	Present
izrodili	Past
izračunao	Past
učinimo	Present
bujna	None
zanemarimo	Present
nesklad	None
dubli	Past
prikazao	Past
prilagođavali	Past
betonirali	Past
nepobjedivo	None
astrolozi	None
sadržavalo	Past
predvidio	Past
prepušteno	Past
oprah	Past
prijamnike	None
prikupili	Past
čuvan	Past
razmotrio	Past
odradili	Past
nasilja	None
rešeno	Past
udaraju	Present
primijenio	Past
dužnom	None
uvrštavaju	Present
šetao	Past
obrađen	Past
predloženo	Past
indonezijski	None
izjašnjava	Present
pridruživalo	Past
zasadili	Past
naselilo	Past
iznjedrili	Past
zabodosmo	Past
okupile	Past
apeliram	Present
vježbam	Present
poroznih	None
veseljem	None
pupam	Present
komičarka	None
poližimo	None
najavljivali	Past
gladi	Present
pravdan	Past
bibliotekarstvu	None
odvijaš	Present
izbacilo	Past
najpopustljivijom	None
budite	Present
razmišljam	Present
raspletaste	Past
odseca	Present
orlovski	None
bježao	Past
cjepkasmo	Past
potkrepili	Past
misteriozni	None
najprimetnijemu	None
ugovorili	Past
poduzet	Past
rima	None
polazili	Past
heraldike	None
kvalitativni	None
rimo	None
procijenio	Past
kiseli	None
čȍvjekom	None
razočarao	Past
antikomunist	None
ubrzanju	None
prebacivani	Past
razočaraš	Present
razmeće	Present
profesorima	None
prekretah	Past
raspoloživo	None
rashlađujete	Present
melodramatičnoj	None
iseljeno	Past
hapšen	Past
usporavao	Past
odsječeni	Past
sputavaju	Present
upoznavao	Past
zatvoreno	Past
nepogodnijim	None
suočavale	Past
namjeravalo	Past
ljuljuškaste	Past
javljah	Past
popratio	Past
grane	Present
ograničava	Present
motri	Present
namenili	Past
obzirnoj	None
sazreli	Past
proteruje	Present
podmazuje	Present
duguju	Present
razgovarale	Past
toplota	None
dodavanjima	None
uskrate	Present
majske	None
mozgu	None
najgrđi	None
ukopavaju	Present
pobjeđuje	Present
navraća	Present
bȏjnīk	None
napučivano	Past
ispunili	Past
razdražujete	Present
meci	None
pritvoren	Past
rudini	None
popularizirao	Past
prilagođivalo	Past
koristili	Past
stvoriste	Past
najvjetrenjastijega	None
čiste	Present
ilegalne	None
suptilnu	None
gotski	None
sintetiziraju	Present
maljeva	None
razviju	Present
treptavomu	None
sprovodi	Present
vodomare	None
obrezao	Past
ukinuli	Past
račić	None
uklonio	Past
pobijen	Past
oporavljaju	Present
zadavio	Past
naivno	None
htio	Past
obmanuste	Past
bace	Present
gorštaka	None
pripitomljujete	Present
prsnih	None
lòmljivōst	None
amerikanizirasmo	Past
varali	Past
ukočene	Past
razvrstavani	Past
napravljeni	Past
uzet	Past
zaštitili	Past
trpjelo	Past
deljen	Past
izjednačeno	Past
dobrote	None
molili	Past
obdario	Past
prisiljavani	Past
ovlašteni	Past
opisuje	Present
zapovijedaju	Present
poprište	None
odvile	Past
uselili	Past
značajku	None
omalovažene	Past
usavršavale	Past
iznenađenjima	None
napreduje	Present
razularenu	None
sastavilo	Past
opredijelili	Past
nadzirale	Past
ađustiraše	Past
njujorško	None
svlačionicama	None
kleče	Present
preotme	Present
traćiš	Present
slobodoumna	None
kretanjem	None
pribavljeno	Past
zovi	None
pomisle	Present
izgrađeno	Past
ugađa	Present
sastojali	Past
zlicama	None
kaznilo	Past
onesposobile	Past
pretili	Past
planinarima	None
sjećali	Past
sakupljali	Past
ispušteno	Past
operatora	None
zahtevalo	Past
topilo	Past
uticalo	Past
sniženo	Past
zauzeti	Past
zanemariše	Past
zračilo	Past
umeće	Present
stvarani	Past
kvarcu	None
inozemna	None
zbrinimo	None
proučavao	Past
ubrzava	Present
izdržljivosti	None
smestilo	Past
agitiralo	Past
ljuljaju	Present
najkompleksniju	None
zakopamo	Present
naglaske	None
sudjelovali	Past
laticama	None
oterasmo	Past
jadranskomu	None
istrijebljen	Past
najčudnijih	None
propisano	Past
ražestiste	Past
hapsio	Past
onemogućuje	Present
stijenjom	None
zahvale	Present
ceremonijalnu	None
neprijateljske	None
izvestili	Past
zamerke	None
prijegled	None
rešite	Present
pitalo	Past
pritiskali	Past
ađutantima	None
primećuje	Present
prikazivaste	Past
uzletio	Past
pričuvate	Present
razumnih	None
dopirao	Past
satire	Present
pomirio	Past
povređuje	Present
prisegne	Present
srnetinom	None
muzu	Present
indirektan	None
bližio	Past
funkcioniraš	Present
kompletom	None
vrećama	None
корпулентан	None
noćašnjom	None
preradili	Past
razilaze	Present
brujim	Present
gospodarskoj	None
pripremljen	Past
kazan	Past
sipe	Present
smenio	Past
razvijao	Past
rigorozni	None
ugode	Present
podnosi	Present
odbacivali	Past
izračunati	Past
raspušteno	Past
samoubojstvo	None
svirača	None
sličilo	Past
barbari	None
razoružali	Past
zakasnio	Past
nadzire	Present
sagrešenje	None
artiljerijski	None
povezane	Past
dopadao	Past
izruče	Present
ideograma	None
pošao	Past
žalosna	None
prestravljivali	Past
gospe	None
smestili	Past
raspolovili	Past
javljaju	Present
teniskomu	None
skupljani	Past
počeli	Past
dere	Present
prožiman	Past
promatran	Past
stanovnici	None
špèlūnka	None
pravoslavnom	None
uzvici	None
autorizirao	Past
odijelio	Past
prepušten	Past
zavezan	Past
pobije	Present
menstruacijama	None
zaboravu	None
tramvaju	None
sakupljamo	Present
sklopa	None
urešen	Past
sjevernokorejskih	None
zrnate	None
ozleđen	Past
zauzeo	Past
osvajan	Past
naoružani	Past
uljepšao	Past
iznjedrilo	Past
gasi	Present
okružene	Past
nadamo	Present
tamnoputo	None
dvojili	Past
navožene	Past
pravile	Past
poslužilo	Past
provjeravaju	Present
luterani	None
kralješcima	None
dekreti	None
raspodeljuje	Present
čitalo	Past
zabavišta	None
ohrabrivao	Past
ušle	Past
primenjuju	Present
kamiona	None
zarađivao	Past
poprimali	Past
pruće	None
sagrađeni	Past
билатералан	None
izbavili	Past
sankcijom	None
napadan	Past
omogućivano	Past
zarazom	None
uspjeli	Past
prijavim	Present
spiralnoj	None
poprave	Present
oženjeni	Past
latio	Past
izlagani	Past
raznosio	Past
naoružane	Past
isplivaju	Present
formulirao	Past
eksplodiraju	Present
profesionalno	None
nužnih	None
izazivao	Past
dosežu	Present
razumijevao	Past
nasrnuo	Past
pobacali	Past
mnogu	None
pregovara	Present
nametnute	Past
nabavljalo	Past
obrnuti	Past
razdijeljeno	Past
kreditori	None
čitamo	Present
posjedovale	Past
oslabljen	Past
razmene	Present
odgovaralo	Past
nameravasmo	Past
rasterao	Past
otpustili	Past
džipovima	None
brecaste	Past
pripalo	Past
čitali	Past
prcahu	Past
gunđate	Present
upućivani	Past
prekriju	Present
napredovale	Past
usidrili	Past
češano	Past
gucnem	Present
prosvjedovao	Past
karipsko	None
zlostavljali	Past
pretučemo	Present
sprovode	Present
transportirao	Past
strašan	None
potkopavaju	Present
bizantskih	None
zamenjene	Past
gricnuo	Past
izdisaste	Past
izlagale	Past
odstupaju	Present
nezavisni	None
bratskoga	None
obišli	Past
osvježavan	Past
financiralo	Past
napili	Past
gnječen	Past
uočilo	Past
pušta	Present
pripreme	Present
oticalo	Past
dosegne	Present
dopušteno	Past
ekrane	None
hagiografske	None
zlostavljate	Present
usudili	Past
gazio	Past
dekretu	None
spekuliraste	Past
napisao	Past
hren	None
obešeni	Past
smeštaju	Present
ponašali	Past
dodavano	Past
fascinirale	Past
prilagođen	Past
najčudotvornijih	None
lončarski	None
nalikuje	Present
uhapsili	Past
učeničko	None
udrugom	None
pješače	Present
pripisivane	Past
počinjeno	Past
podrazumevale	Past
doseljeni	Past
povjerava	Present
krije	Present
katodnoj	None
preskakahu	Past
turkmenskim	None
predviđa	Present
šaptalo	Past
razagnate	Present
nedjelji	None
mlak	None
proglašeno	Past
odbačene	Past
osuđivan	Past
epigram	None
dodeljivano	Past
uvere	Present
sličah	Past
ograničavao	Past
ljubimci	None
orah	Past
zrcali	Present
torpediramo	Present
rudama	None
raspoloženo	Past
prokleo	Past
nepriznata	None
nasmejavaju	Present
rode	Present
tesara	None
ugradio	Past
pohotljivci	None
probijeni	Past
transakcija	None
izuzetnoj	None
umetnut	Past
određivani	Past
zahtevale	Past
odgovarali	Past
zaspali	Past
dočekane	Past
uviđavne	None
obuzdasmo	Past
pripravlja	Present
udale	Past
invazijama	None
izložilo	Past
transkripcije	None
studiju	None
sugestijama	None
zalamah	Past
zapadao	Past
gvožđu	None
venjah	Past
poboljšale	Past
fatalizam	None
festivale	None
takve	None
izmjerene	Past
zaspale	Past
bodovano	Past
ocjenjuješ	Present
spekle	Past
kinuli	Past
uvodi	Present
cirkulacije	None
fiziološkoj	None
ugašene	Past
ljute	Present
presađuje	Present
klobuka	None
smešno	None
autekologijom	None
okretao	Past
razgovore	Present
cedi	Present
propušta	Present
oplemenio	Past
maran	None
hlor	None
podrazumevani	Past
opažen	Past
održe	Present
iskoristivi	None
zahvaćene	Past
pokrivače	None
spustio	Past
obrubljuju	Present
okončale	Past
ovalnim	None
prikazane	Past
magnetično	None
izvlačile	Past
lažeš	Present
urotio	Past
sklopili	Past
hrabrost	None
operu	Present
pripravljao	Past
formuliraju	Present
uzimalo	Past
namenjen	Past
medvedica	None
obavestili	Past
primijetilo	Past
useljavaju	Present
glupače	None
sastavlja	Present
protiču	Present
čvrstine	None
rasečen	Past
preziremo	Present
upotrebile	Past
upadljiva	None
cvalo	Past
tvrd	None
koristicama	None
najsloženijih	None
najhranjivijom	None
suzdržavale	Past
uverljivosti	None
čajeva	None
dočekani	Past
određivanje	None
pošle	Past
gubi	Present
razmnožio	Past
rasipavasmo	Past
snabdeven	Past
svojevoljno	None
prevagnuo	Past
razdelio	Past
vazalu	None
brijali	Past
sintetičkim	None
prisiljeno	Past
dojmovima	None
domislimo	Present
vikne	Present
relevantno	None
izvršite	Present
latinizaciju	None
norvešku	None
raspadnu	Present
iskvario	Past
osvojiše	Past
dodirne	Present
želeo	Past
obuzmimo	None
pridodate	Present
omogućilo	Past
savremenije	None
најподобнији	None
sabotirali	Past
zasađen	Past
sređeno	Past
porobljavaju	Present
sviraste	Past
oslobađani	Past
tuguju	Present
plavokosi	None
sušu	None
zaveden	Past
izjasnile	Past
podržan	Past
izganjaju	Present
naglašavali	Past
oblikovalo	Past
zakletvama	None
oplovili	Past
crta	Present
procenjuju	Present
upoznamo	Present
testamenta	None
sluškinjom	None
obratile	Past
pratilo	Past
pokršteni	Past
tigrovima	None
ostavio	Past
bojene	Past
popustilo	Past
dignut	Past
iznijele	Past
rabio	Past
mlazovima	None
zaostaju	Present
dostigli	Past
načelo	Past
teritorijalnom	None
nahranili	Past
uzletale	Past
nadahnjivao	Past
oslone	Present
držalo	Past
obavještavao	Past
povijaju	Present
ubadasmo	Past
zapušteni	Past
pamtio	Past
rascepljivah	Past
granicu	None
krili	Past
tekstualnih	None
blistahu	Past
posađen	Past
poprimao	Past
ukazivao	Past
kapitalističkom	None
ispunjavali	Past
odvije	Present
obrazovanu	None
zacijelile	Past
obrazlagani	Past
mačevasmo	Past
najkovrdžavije	None
žaluju	Present
kožari	None
povoda	None
sujeverje	None
zadrugu	None
došli	Past
zagrade	Present
proletera	None
smetnjama	None
posetite	Present
mulja	None
načuje	Present
motrili	Past
obuhvatiš	Present
skromnost	None
skijaško	None
rešene	Past
zauzdao	Past
isteran	Past
poduzete	Past
konsekutivnih	None
sačuvalo	Past
funkcionirali	Past
pojačao	Past
nazvan	Past
izjednačuju	Present
zbrisano	Past
zaljubljuju	Present
izvadilo	Past
gubite	Present
kosaču	None
uzete	Past
zatočenicama	None
pričvrstio	Past
ponašate	Present
zanoćaše	Past
teorije	None
podržava	Present
naglašeno	Past
prsnem	Present
zaduživaste	Past
dodao	Past
izbjegnut	Past
svećnjak	None
zastale	Past
kovrčahu	Past
razbiti	Past
gonjaste	Past
odlučilo	Past
rezom	None
kraterska	None
prikladnijim	None
velikome	None
skreću	Present
smiluje	Present
mota	Present
sramote	Present
jutrite	Present
izmamljivano	Past
dešnjaka	None
organizmima	None
tobožnji	None
pojačamo	Present
inozemne	None
kozmetičku	None
onesposobe	Present
unakažen	Past
uložio	Past
vjenčaju	Present
razlomljen	Past
osvanjuju	Present
plohe	None
susreću	Present
obrađuju	Present
mirne	None
zatočene	Past
dubeno	Past
ražešćeno	Past
proplancima	None
ocenjuje	Present
obujmljuješ	Present
onemogućavali	Past
nalazile	Past
sȅkta	None
satiru	Present
svađaju	Present
pošteđuje	Present
baštinici	None
pokidali	Past
nagrađuju	Present
titanija	None
teritorijalnu	None
traženo	Past
poželjnoga	None
viđali	Past
snabdeo	Past
stradava	Present
lonče	None
zaključak	None
dočaravaste	Past
sja	Present
popravljeno	Past
poštanska	None
nominirali	Past
individualističke	None
ulizivalo	Past
rušili	Past
prekinuli	Past
ojačava	Present
dvoboja	None
zadatka	None
glasale	Past
nasljeđivahu	Past
kožnih	None
doživljavaju	Present
zatalasani	Past
zapisano	Past
kazali	Past
nastoji	Present
oženjen	Past
sređivano	Past
rasprodali	Past
ušao	Past
naručilo	Past
zavezane	Past
kockarnicu	None
jedinstveno	None
prespavaju	Present
Čeh	None
tresu	Present
spaljivasmo	Past
pogođeno	Past
turpijah	Past
tužnu	None
zapovedani	Past
idejni	None
izađeš	Present
obnovljeno	Past
opčinih	Past
priušćivane	Past
nestajali	Past
zabilježene	Past
priznali	Past
njemačko	None
približavali	Past
regulirao	Past
graničnih	None
parlamente	None
šuti	Present
useljeno	Past
senzualnijoj	None
izvađeni	Past
dizahu	Past
zadrži	Present
folklor	None
progutao	Past
udaljio	Past
centralnoga	None
tečajem	None
bojimo	Present
žestini	None
klanjamo	Present
nagrđivale	Past
podsetio	Past
ispisano	Past
razapinjan	Past
eparhiji	None
besposličari	Present
napadani	Past
prikazani	Past
svira	Present
shvatilo	Past
draž	None
izbrisali	Past
koraca	Present
šekspirijanska	None
љигав	None
vjere	Present
sniva	Present
prigovore	Present
dvostrukim	None
prikazima	None
obišao	Past
šišti	Present
uhapšeno	Past
podržale	Past
karizmatična	None
korio	Past
izgovarano	Past
žalosnih	None
okretima	None
propao	Past
kaligrafijom	None
gradivu	None
najgorljivijih	None
kolajne	None
džinizama	None
ujedinjeno	Past
pridružile	Past
bunkerirate	Present
napravljeno	Past
pritvorio	Past
selektivnome	None
grdangrdna	None
liječene	Past
lijevane	Past
kikoće	Present
ljubio	Past
sušeni	Past
prevladavale	Past
slozi	None
sprijatelje	Present
potiču	Present
libijske	None
prodan	Past
највиши	None
uklanjani	Past
putovalo	Past
nemaju	Present
kažete	Present
školuje	Present
uspinjača	None
paradirali	Past
najsnalažljivijega	None
posedujemo	Present
ukopao	Past
poštansko	None
katanac	None
federativna	None
zbora	None
smestile	Past
ostao	Past
opada	Present
udaljeno	Past
iseljavaju	Present
prisiljava	Present
afričku	None
nacista	None
primijenilo	Past
zakrvarimo	Present
isecan	Past
impliciralo	Past
zloupotrijebljeni	Past
odricali	Past
opasali	Past
kvasio	Past
ispunjavao	Past
bedu	None
potpunih	None
punjeno	Past
divi	Present
transformiraju	Present
delegacije	None
istopio	Past
ruskim	None
nakupljaju	Present
opisano	Past
kȍpljanīče	None
poslužujem	Present
savjetovao	Past
pokopali	Past
raznijeli	Past
uljepšali	Past
iskorištavali	Past
motre	Present
pevaju	Present
spektar	None
odbio	Past
želuca	None
aperitiv	None
predstavljeni	Past
odgovorite	Present
povrijeđen	Past
razvalimo	Present
skalpirahu	None
povezivani	Past
antipatičnije	None
zemljoradnicima	None
osnovali	Past
oživljavao	Past
sviđalo	Past
arheološka	None
dvogledu	None
specijalizaciju	None
financirao	Past
vršilo	Past
osporavao	Past
osunčano	Past
pjesnici	None
damom	None
iskalio	Past
ugušio	Past
pošumljeni	Past
darovao	Past
povezani	Past
upotrebljavaju	Present
raširene	Past
našlo	Past
dodijelio	Past
uspijevao	Past
reprezentativnija	None
dijelimo	Present
gađani	Past
unosilo	Past
nastupile	Past
potezom	None
nedostajali	Past
udvostručen	Past
okrivljeni	Past
islamskom	None
bjesni	Present
cjelokupan	None
pobijeđeno	Past
zabranom	None
naslanja	Present
nabavih	Past
cirkusanticama	None
oholim	Present
predvodile	Past
bùšāč	None
velikomu	None
uticao	Past
predavale	Past
umetni	None
crnokose	None
užitku	None
izlascima	None
umetničko	None
takvih	None
cijeloj	None
dopune	Present
stapali	Past
uvoznu	None
okrivljene	Past
obožavao	Past
ispričaju	Present
dočekivani	Past
tretirali	Past
usmjereno	Past
raširen	Past
odmamljene	Past
udomiste	Past
prokopaju	Present
kreirale	Past
sastavljao	Past
naseljene	Past
monetarno	None
travanjskom	None
vršeno	Past
potkrepljivale	Past
propovedao	Past
otkazuju	Present
zakazan	Past
cesarom	None
blagostanjem	None
zamenjuju	Present
dodijelili	Past
slikao	Past
grejete	Present
gibanica	None
monolitnijima	None
cijela	None
ilustrator	None
predavalo	Past
šećernom	None
bezvremenske	None
poleteo	Past
odsijecaš	Present
lopove	None
moralo	Past
potrči	Present
oazi	None
iskorijenjen	Past
oduzima	Present
učile	Past
kongrese	None
jutri	Present
ùstupākā	None
uzelo	Past
knjiži	Present
graničio	Past
upotrijebe	Present
nabrbljao	Past
elastične	None
sviće	Present
najtoplokrvnijom	None
dvoličnjačkima	None
doseljavaju	Present
preporučuju	Present
komunicirale	Past
kontaminacijo	None
objavljivali	Past
kližu	Present
adrenalína	None
zadrugara	None
trener	None
zaostane	Present
logička	None
doživjeli	Past
zubni	None
žvaču	Present
potvrđivao	Past
dokumentarnom	None
kupovini	None
trpeo	Past
diktirale	Past
osnivao	Past
obrano	None
najciviliziranijega	None
otkida	Present
trudi	Present
prenosi	Present
naterane	Past
postavim	Present
sjedinio	Past
obuhvaćene	Past
pričalo	Past
svestrana	None
izuzme	Present
podržavao	Past
ganski	None
vreba	Present
nanišanilo	Past
zabadahu	Past
posebnoga	None
zabije	Present
zrače	Present
vraćate	Present
odsekle	Past
lijeva	Present
otputujem	Present
kidalo	Past
ministrica	None
glumilo	Past
tatarska	None
strašilo	Past
plašim	Present
цели	None
ulici	None
emocionalnom	None
uznemiren	Past
zelenaši	None
minutom	None
želelo	Past
рајски	None
iskazivani	Past
mašta	Present
zapušten	Past
najeo	Past
osuđen	Past
korporacija	None
iseljavali	Past
gledao	Past
skrenulo	Past
hinjaste	Past
prikupljalo	Past
jurišali	Past
zapovedao	Past
izdržane	Past
zapreminama	None
biljni	None
iskoriste	Present
kajkavština	None
usmerio	Past
poplašen	Past
oduzelo	Past
dogovorite	Present
abrazivna	None
primetili	Past
pritiskaju	Present
uništava	Present
ulazile	Past
pozdravljali	Past
tuđinu	None
stenje	Present
hipotezama	None
sunča	Present
pljačkao	Past
pripao	Past
zatvorene	Past
uspjeh	Past
razbjegnete	Present
proračunao	Past
smenjivali	Past
kotrljah	Past
hranili	Past
otrovane	Past
razmijenjeno	Past
kuri	Present
alkoholnih	None
sačinjava	Present
mrtavmrtva	None
sabiru	Present
svrstaju	Present
blažim	Present
nadgledalo	Past
genocidu	None
garantuje	Present
sazvao	Past
istaknut	Past
pretvorene	Past
smeštaj	None
realizirao	Past
svrstavane	Past
svjetluca	Present
ludnicu	None
podsetimo	Present
jetricom	None
imitiraste	Past
utvrđeni	Past
poslodavci	None
pretilo	Past
poručnik	None
probavni	None
slabili	Past
pratite	Present
rasporedimo	Present
potpisane	Past
zakidale	Past
osvanem	Present
privlače	Present
zadržano	Past
istrijebili	Past
težim	Present
aktivirale	Past
vijci	None
skidao	Past
elektronima	None
sabiraste	Past
sviram	Present
ubrizgava	Present
otapa	Present
šljemam	Present
šiva	Present
publicirao	Past
obore	Present
transgresija	None
prijavile	Past
zanimljiva	None
iznenađeni	Past
govoriš	Present
pretio	Past
prevladava	Present
brijah	Past
slavohlepnomu	None
kauboji	None
štitilo	Past
izbjegava	Present
raspuštane	Past
priušte	Present
prijateljevasmo	Past
okruže	Present
iskopane	Past
pozdravljeno	Past
onesposobljeno	Past
lovite	Present
razotkrili	Past
zvani	Past
jezi	None
stabilnijim	None
raspoznavali	Past
držano	Past
povraćen	Past
vučica	None
sađen	Past
bombardiralo	Past
izgovorene	Past
vjenčavaju	Present
popustio	Past
primenjeno	Past
zaliju	Present
mudrom	None
osjećajna	None
prodavačica	None
uguše	Present
određeno	Past
zbunjivaste	Past
izloženo	Past
ukrašen	Past
državljaninom	None
povučemo	Present
prijevarama	None
rastjeran	Past
neprekinuti	None
đavljemu	None
futuru	None
raspodijeljeni	Past
isprave	Present
podčinjene	Past
poznatih	None
izrađivalo	Past
ukrcavahu	Past
istrijebile	Past
grbavca	None
kapne	Present
odoše	Past
krše	Present
genealogijama	None
svežu	Present
pozvan	Past
očistili	Past
oslabeh	Past
ozljeđuje	Present
kalifati	None
osetio	Past
prolazim	Present
zbrinjavam	Present
slučajnih	None
zenom	None
isporučuje	Present
najmirnije	None
pokazivani	Past
jednosmjerna	None
sprovedene	Past
zaposlene	Past
prebačene	Past
predstavljan	Past
buši	Present
menjaste	Past
naterani	Past
uvriježeni	Past
sivkast	None
vencima	None
kongruencije	None
polagano	Past
potaknuto	Past
kružili	Past
lihvarim	Present
prigušuješ	Present
odavali	Past
gone	Present
najvetrovitijim	None
nadmašio	Past
ostavljamo	Present
navikava	Present
rastavile	Past
zbivali	Past
prekaljeni	Past
izgrađene	Past
provaljuješ	Present
mlinari	None
zaklone	Present
suprotstavljaju	Present
pljunuo	Past
vesla	Present
paklenoj	None
pedofiliju	None
zakočio	Past
izmigoljite	Present
razvrstavahu	Past
otkriven	Past
taktičke	None
beskorisniji	None
најнужнији	None
grupe	None
pravim	Present
povjeravalo	Past
optuživalo	Past
ponavljano	Past
skraćene	Past
anglističkomu	None
popravljali	Past
popunjavane	Past
uvređen	Past
gat	None
nastaje	Present
carstvom	None
pretvarani	Past
isteraju	Present
kupina	None
isključivali	Past
posvećivale	Past
ispušen	Past
podobnih	None
podržavali	Past
prognoziraš	Present
tvrdoća	None
identičnu	None
zatvoren	Past
svršeno	Past
zaposleno	Past
sviralo	Past
sramežljivci	None
navodim	Present
obavljale	Past
europskoga	None
pojedinačnim	None
primetio	Past
natjerate	Present
pobratimi	None
sinovima	None
naslikaše	Past
energičnom	None
mahne	Present
uznemirilo	Past
obrisan	Past
zaradile	Past
baštinjeni	Past
podmićivani	Past
tjerao	Past
skladalo	Past
potkivao	Past
prikupljani	Past
brišu	Present
poludjeli	Past
bježe	Present
питкији	None
teoretiziralo	Past
kliže	Present
klanjao	Past
geografska	None
bazgama	None
svrabom	None
vršio	Past
čitljiva	None
veterinarstvom	None
otklonjeni	Past
proračunali	Past
garantovalo	Past
hrabrio	Past
survaš	Present
njihalo	Past
lokot	None
uništavaju	Present
naišao	Past
poravnao	Past
lili	Past
rukovoditelja	None
antičkoga	None
avijacije	None
tvrde	Present
smjelo	Past
prikaz	None
naumiste	Past
improvizirao	Past
odazovu	Present
paronimi	None
financirali	Past
uvažen	Past
snašle	Past
marihuanom	None
spekulirao	Past
nasukan	Past
uočih	Past
vjenčao	Past
milosrđu	None
bretonskim	None
odbacili	Past
poduzme	Present
odgođeni	Past
poštujem	Present
krklja	Present
nedeljo	None
nesumnjivim	None
odjenuo	Past
zeta	None
zaštitilo	Past
očekivan	Past
čeka	Present
pogađali	Past
izrađivane	Past
impliciraju	Present
telegrafa	None
približavaste	Past
odzivaste	Past
usadio	Past
dodam	Present
svećenicima	None
uđoše	Past
zapažamo	Present
pripojeno	Past
platio	Past
izbijale	Past
osporeni	Past
obogatilo	Past
hlađen	Past
nezavisnoj	None
nakosivalo	Past
principijelnoga	None
smenjeni	Past
ustrojili	Past
primirje	None
ujediniš	Present
obećava	Present
burmanskih	None
ujedinjen	Past
slušaju	Present
pribraja	Present
nadoknadili	Past
blagoslivljali	Past
općenita	None
izgnali	Past
vjetrenjače	None
razbijaju	Present
realiziraju	Present
besmislenijih	None
odmarao	Past
nesene	Past
raznobojnih	None
uništavani	Past
ubijen	Past
grive	None
zakopani	Past
vreteno	None
uvažim	Present
sumnjičeni	Past
извршни	None
oličavaju	Present
zaborave	Present
utonuli	Past
otišle	Past
odleđen	Past
snabdijeva	Present
apsorpcija	None
nezamislivu	None
proljetnih	None
stotinku	None
nemoćnim	None
nesumnjivome	None
izostavljalo	Past
sunet	None
fondacija	None
procijenjen	Past
prepustili	Past
primijetimo	Present
ispadoše	Past
prelistavano	Past
sagrađivani	Past
probude	Present
atentatima	None
otpisan	Past
hrastovima	None
prerađeni	Past
nabasalo	Past
dodiruje	Present
sarađivah	Past
sašije	Present
usporavalo	Past
neurologiju	None
sapere	Present
korača	Present
prate	Present
bušotinama	None
sabijen	Past
glumcima	None
tribaš	Present
porađa	Present
vrednuju	Present
pobegoše	Past
crnačke	None
primenjivali	Past
neminovni	None
energije	None
posetile	Past
brižnosti	None
zagorčasmo	Past
naručene	Past
osudili	Past
povjerio	Past
sklopljeni	Past
svidelo	Past
obarali	Past
negovao	Past
napominjao	Past
sudimo	Present
laboratorijsku	None
gordijskomu	None
kuđene	Past
tonuo	Past
špijamo	Present
opisi	None
uplivaju	Present
pevačem	None
pamtili	Past
štrajkovi	None
oplođuje	Present
meša	Present
zamijeniste	Past
izviđao	Past
aplauza	None
opozovimo	None
očuvano	Past
ukrašavamo	Present
rezonàntnosti	None
divio	Past
uvjeravam	Present
odobrovoljismo	Past
povrijedili	Past
odzdraviste	Past
okružuju	Present
probušene	Past
uručene	Past
kovano	Past
potomke	None
jemenska	None
ljušturom	None
vratili	Past
narednoga	None
židovskih	None
duvnuti	Past
dvostruk	None
iznudio	Past
uključivale	Past
potvrdilo	Past
oružanima	None
pokrene	Present
označavale	Past
važi	Present
sporazumevaste	Past
zbunjivao	Past
ratnici	None
inovativne	None
hljeba	None
rubrika	None
ironični	None
istraživalo	Past
označio	Past
ljućahu	Past
prekršio	Past
најзвучнији	None
odricao	Past
akademiju	None
prigušeni	Past
leopardom	None
progone	Present
spadale	Past
zatvarali	Past
konduktera	None
iskorene	Present
zakleli	Past
zamišljaju	Present
sačinjene	Past
suzbijale	Past
posvećeni	Past
akustička	None
ustanovljeni	Past
mišićnim	None
zahtijevali	Past
dnevnike	None
prepuštaju	Present
odijela	None
nȁr	None
žarulja	None
izmjena	None
ironičnomu	None
spadaju	Present
gomilale	Past
tražiš	Present
aranžman	None
propadali	Past
nadmašeni	Past
drobljaste	Past
iznenađene	Past
opsjedaju	Present
obuhvatio	Past
preštampano	Past
simulirane	Past
spuštale	Past
navodile	Past
vrtložne	None
predali	Past
čara	Present
našli	Past
formulacija	None
pričamo	Present
doznao	Past
najavilo	Past
period	None
ovisio	Past
upišu	Present
brdskoj	None
antibiotike	None
neobjašnjiv	None
odnele	Past
napuštale	Past
obmanut	Past
svrbljasmo	Past
nasamarim	Present
povezali	Past
osiromašili	Past
cijeli	Present
prepisivali	Past
tepate	Present
ocenjivah	Past
opsedaju	Present
obrazovanja	None
trapez	None
slap	None
soli	Present
trpjeli	Past
utovarite	Present
državničkom	None
anemičnijoj	None
skinuto	Past
nabacio	Past
podešene	Past
živ	None
prozivali	Past
svrstano	Past
prekine	Present
izmišljali	Past
ostaviše	Past
alarmi	None
gubile	Past
bodren	Past
upotrijebljeno	Past
obilježavan	Past
uzburkao	Past
dodelimo	Present
obujete	Present
najcivilizovaniju	None
oblikovao	Past
odobren	Past
stavljao	Past
opsedne	Present
izabrali	Past
nezgodne	None
crvenilo	Past
aktualnome	None
egzosferama	None
zapitali	Past
doštampavamo	Present
sposobnijih	None
proždereš	Present
komšijom	None
blagoslovljene	Past
rasjekoše	Past
pakuju	Present
telesnom	None
odvojimo	Present
krvnički	None
ugledalo	Past
prisiljavaju	Present
napomenuto	Past
pupa	Present
isključujete	Present
gigantu	None
špekulacije	None
ispostavimo	Present
obustaviše	Past
имућни	None
potvrdio	Past
razdjeljivale	Past
ikavskom	None
apsorbirali	Past
saznaju	Present
centi	None
spomenuli	Past
fante	None
vječitim	None
prodavano	Past
vranim	None
lijevasmo	Past
pridonijeti	Past
uložene	Past
zlikovcima	None
združuje	Present
spremni	None
uzgaja	Present
susretane	Past
slućah	Past
nacrtao	Past
historijskom	None
ženevskoj	None
klicali	Past
samozadovoljnija	None
nadničari	None
koriste	Present
avangardi	None
framasone	None
opsedale	Past
vito	Past
uskim	None
federalista	None
samljevene	Past
promotrimo	Present
obradivo	None
dostavljao	Past
podsećao	Past
crtane	Past
čakavskoga	None
totemskome	None
trezor	None
brodskih	None
tronošcu	None
ukotvim	Present
snimaju	Present
podčinjeno	Past
harmonijskoga	None
pekmez	None
bizantijsko	None
skratio	Past
čvrsti	None
sklanjali	Past
verovao	Past
lobija	None
pogađaju	Present
bruse	Present
odoleh	Past
izvodio	Past
ucenjen	Past
sastajalo	Past
razlikovale	Past
poslušate	Present
zaplašen	Past
hranjeni	Past
iznudilo	Past
nadmašivali	Past
cvetali	Past
ubili	Past
izrezani	Past
neobjašnjivi	None
probodoše	Past
primorate	Present
obrađivalo	Past
nemaš	Present
isporučile	Past
zadale	Past
burad	None
hude	None
prerušio	Past
prevozio	Past
izgledalo	Past
jablan	None
ublaže	Present
najoštrije	None
odgovoreno	Past
odzvanja	Present
stabálā	None
namijenjeni	Past
propovijedao	Past
izlečene	Past
kupovane	Past
dođeš	Present
osuđene	Past
kaljeni	Past
otputovali	Past
pravi	Present
najuzbudljivije	None
putniku	None
smještalo	Past
horoskope	None
propadao	Past
gatano	Past
pomiješane	Past
usmjerimo	Present
astrologiji	None
muve	None
gromobrana	None
sanduka	None
risan	Past
mučno	None
sazvano	Past
pobijedili	Past
kružile	Past
vadi	Present
variš	Present
prevagnem	Present
zasebnoj	None
popržiste	Past
okrenulo	Past
posustaje	Present
artičoke	None
uradio	Past
raspustio	Past
derahu	Past
rabi	Present
propuste	Present
duhovni	None
poverovao	Past
spojnica	None
raseljene	Past
zavarali	Past
probave	Present
kopan	Past
istrošen	Past
predvodio	Past
neizvjesnom	None
poništen	Past
užom	None
raspisivahu	Past
koaguliraj	Past
slijepa	None
maloletne	None
pomiješale	Past
proglašene	Past
republičku	None
ubace	Present
ciljao	Past
klonovima	None
primjenjivale	Past
razbacuje	Present
usredotočeni	Past
povratnike	None
pregibate	Present
slatkiša	None
sire	Present
naizmeničnih	None
ispuštali	Past
tražen	Past
zatajujem	Present
ubrzavaju	Present
pjevao	Past
uvećale	Past
pevačice	None
mahunama	None
titrasmo	Past
zapošljava	Present
kulturni	None
partizanki	None
sastali	Past
kofein	None
zaštitimo	Present
brinuli	Past
učlanjeno	Past
protekle	Past
goriva	None
posađene	Past
pojeden	Past
zmajevih	None
cenzurirah	Past
kukaste	Past
navožen	Past
ždralovi	None
osjećalo	Past
ukrašene	Past
izuzeto	Past
isporučeno	Past
iskusili	Past
seni	None
kleknute	Past
sasječene	Past
putovanju	None
odleđivali	Past
eksplozivnim	None
rupture	None
odgovorili	Past
polugama	None
mitskih	None
tražimo	Present
polazite	Present
oktobarski	None
ratujem	Present
prelamam	Present
zastupalo	Past
skorbutom	None
pomognuti	Past
nadzirane	Past
proricali	Past
smenjuju	Present
pleonastičnim	None
pneumatologijom	None
usvajaju	Present
nastaju	Present
preraspodele	Present
ćoravoj	None
uvjeriste	Past
isceđujemo	Present
usporeno	Past
vilo	Past
uvodili	Past
pripazim	Present
bildersku	None
zabrinuto	Past
tajnice	None
izračunavane	Past
tikasmo	Past
probavnim	None
iznerviran	Past
najopravdanija	None
raspe	Present
prisiliš	Present
plitku	None
dokazivalo	Past
bodem	Present
raspoznavasmo	Past
paneliraš	Present
pridružuju	Present
usamljene	None
skupljalo	Past
općenitije	None
pešaštvima	None
napona	None
obojen	Past
odstupali	Past
opovrgli	Past
građevìnār	None
diftong	None
marte	None
izračunavamo	Present
ježeve	None
kanibal	None
osnovano	Past
prikupljane	Past
varijacijama	None
deklinaciji	None
ugušilo	Past
gravitacijskim	None
kooperativno	None
trofej	None
pobili	Past
šatiramo	Present
razmaknulo	Past
podao	None
odbija	Present
sakupljalo	Past
blatna	None
ljubljeni	Past
zasjenilo	Past
zaslužile	Past
teizma	None
mjerio	Past
sastanu	Present
pripadalo	Past
shvaćeno	Past
prepelica	None
dizalo	Past
najave	Present
razmisliš	Present
nemačke	None
trijezni	Present
izrekli	Past
priča	Present
graditeljske	None
kupuje	Present
kila	None
pljačkaju	Present
gljive	None
složene	Past
uzdržavali	Past
intenzivnom	None
osude	Present
gazilo	Past
složile	Past
povredili	Past
magnetnih	None
atletiko	None
čezne	Present
inferiornim	None
groša	None
objašnjavale	Past
obučavaš	Present
stvaraju	Present
обијесни	None
objedinjeni	Past
nagrnuli	Past
čekale	Past
rukovodi	Present
dostave	Present
ljestvama	None
karpatskom	None
opsele	Past
love	Present
figurativnu	None
izdaji	None
tetovirali	Past
pregovaralo	Past
standardi	None
kraniometriju	None
izmiče	Present
prikrivali	Past
dopunjene	Past
gura	Present
kažnjeni	Past
apatetični	None
ranica	None
novcu	None
rješavalo	Past
ovjeravasmo	Past
otiče	Present
Advente	None
prikazujemo	Present
preletao	Past
podneo	Past
objašnjen	Past
bilježi	Present
glagoljice	None
plebejcima	None
iskusio	Past
namenjeno	Past
karpatski	None
zapišu	Present
blažene	Past
psihijatrijske	None
križasmo	Past
ispravljen	Past
svetogrdno	None
zalede	Present
pregrijane	Past
prokleli	Past
opisivali	Past
grebene	Past
otapaju	Present
iskopale	Past
dubokoumnije	None
pokrštava	Present
hrđa	Present
kamenovali	Past
misirskoga	None
asociralo	Past
najhladnijih	None
vješaju	Present
stizali	Past
šume	Present
darežljivi	None
vragolastijega	None
sačinjavalo	Past
stanara	None
pratili	Past
bijele	Present
sramnima	None
empirijskoj	None
slabašan	None
krvavio	Past
promatrao	Past
vretenom	None
štofovi	None
zabeležene	Past
priušćivali	Past
uvodio	Past
izjednačimo	Present
meteorolog	None
nesporazumu	None
uplašene	Past
prane	Past
komotnih	None
unošene	Past
alkoholizmu	None
ovladava	Present
svinjetini	None
najkraćega	None
čepovima	None
ukradene	Past
nahranjeni	Past
stignu	Present
jenjavaste	Past
izdajstva	None
euforije	None
informirao	Past
pomognu	Present
пробитачнији	None
statistika	None
popije	Present
nadmašivale	Past
stišavane	Past
prelazio	Past
pretopljene	Past
trijumvirom	None
iskorištava	Present
dospijevamo	Present
izveštavaju	Present
provjerili	Past
uvidio	Past
potakao	Past
španskoj	None
ostane	Present
oponašam	Present
uključuje	Present
uplašile	Past
brojani	Past
istaknuti	Past
gazi	Present
povećamo	Present
zahtevali	Past
prenosim	Present
uljepšavan	Past
cvokoćete	Present
dogovorimo	Present
zavodio	Past
ratovale	Past
proteruju	Present
zadovoljeni	Past
zavlačah	Past
promašajem	None
optužuju	Present
dokučen	Past
verujem	Present
proverite	Present
košarku	None
zgrizeš	Present
većina	None
promotrite	Present
piljeno	Past
usporilo	Past
galantnoj	None
slezinu	None
kriterije	None
zauzdavam	Present
nameniste	Past
koška	Present
skrbili	Past
istorija	None
činili	Past
rascjepljivao	Past
ograđivao	Past
objavljujmo	None
koturah	Past
glasovale	Past
prekršile	Past
aluvijalnima	None
nadjačao	Past
nastupalo	Past
etimološka	None
nikotinom	None
otima	Present
preštampam	Present
čarobnjaku	None
krvavljen	Past
korišteni	Past
spojilo	Past
nesvesne	None
preplovio	Past
kušao	Past
fizičare	None
izdvajao	Past
најпорознији	None
patricijskomu	None
izlučio	Past
mišolovke	None
ukazalo	Past
slađoj	None
izvođen	Past
prijete	Present
zidna	None
februarskih	None
udružili	Past
mirio	Past
uvrštene	Past
emigraciji	None
plivališta	None
opsjedale	Past
odrezane	Past
ljuštura	None
aviona	None
tukao	Past
ojačavao	Past
ljubavnicu	None
primorale	Past
drevne	None
detliće	None
zajmova	None
slalo	Past
moći	None
odjeveno	Past
ispisuju	Present
tadašnji	None
ratu	None
kuje	Present
smatramo	Present
dobili	Past
promijenjeni	Past
oblizivahu	Past
rasjekao	Past
usvojeno	Past
poslovan	None
tajgi	None
smenjujem	Present
predložite	Present
pokrenulo	Past
trebaju	Present
prestajalo	Past
zidni	None
sprovele	Past
špijuniramo	Present
intelektualnoj	None
ružnom	None
dobivale	Past
rastane	Present
tove	Present
fusnote	None
promašili	Past
upućen	Past
podizalo	Past
izmere	Present
podsjećaju	Present
odvijao	Past
iskoristile	Past
izrezali	Past
dočekali	Past
otarasio	Past
preuzimali	Past
protivim	Present
potrošeni	Past
ispije	Present
farbaste	Past
svrstane	Past
finski	None
ustrojen	Past
investicijskim	None
najbrutalniji	None
mineralu	None
blagoslovljeni	Past
tetovirano	Past
opiru	Present
spustile	Past
istraga	None
upitan	Past
razmislite	Present
proriče	Present
ponestalo	Past
puščano	None
održavan	Past
osjetite	Present
mučeno	Past
odjeknulo	Past
korozija	None
najstrmijemu	None
dodeljivahu	Past
pobedio	Past
dokazuju	Present
odgrižu	Present
kršio	Past
predate	Present
uručivalo	Past
investicijski	None
plaće	None
upitam	Present
parne	None
urađeni	Past
razuzdano	None
odvežu	Present
uzmiču	Present
fijakeri	None
uložili	Past
pojednostavljene	Past
predajem	Present
uvidjeli	Past
isječeno	Past
ohlađen	Past
odeljenjem	None
naslonite	Present
ruralan	None
uništavate	Present
najranije	None
nedavna	None
kinin	None
dijagonalom	None
zasjenio	Past
mni	Present
izrazili	Past
ispravljene	Past
uturale	Past
klizače	None
cvetao	Past
povijao	Past
dikobrazi	None
složenije	None
prenoćivao	Past
prevožene	Past
egzistencijalna	None
šukaš	Present
samoglasnik	None
kožarskoga	None
obnovljeni	Past
uhvaćen	Past
priviknuti	Past
odazvali	Past
vratiše	Past
rub	None
ljućeno	Past
naučeni	Past
kolebali	Past
tkane	Past
raspodijeljeno	Past
hrani	Present
transakcijsku	None
propisivao	Past
osjeća	Present
pronikne	Present
odrastale	Past
prisustvuju	Present
izlomljeni	Past
zadavljen	Past
cenzorima	None
početka	None
sprud	None
uda	Present
sproveli	Past
zgusnuto	Past
vozilo	Past
snabdeli	Past
jadikuje	Present
platou	None
dogovaralo	Past
kopnene	None
trijeznio	Past
malicioznom	None
veren	Past
janje	Present
nailazile	Past
pregrađivan	Past
naglasile	Past
najneuspješniji	None
gerilcu	None
pomogne	Present
ostvarivale	Past
primenjivale	Past
kapetanu	None
sređuju	Present
rasiste	None
prevashodne	None
izvršeni	Past
sleđivan	Past
usredotočen	Past
isečemo	Present
opomenemo	Present
partnerstvima	None
mlečna	None
dopire	Present
medijske	None
temelje	Present
preferirao	Past
plašili	Past
bombardirali	Past
rasteretile	Past
isceliš	Present
iskvareno	Past
zborite	Present
didaktičke	None
ispituju	Present
rezbaren	Past
potrošnje	None
naljute	Present
sirotištima	None
rođen	Past
frivolnije	None
najtanju	None
svezan	Past
pokvarenomu	None
strvinar	None
zbrisali	Past
odavale	Past
invencijom	None
vunom	None
državna	None
zjenice	None
katedrali	None
zavodom	None
proteku	Present
uzjaše	Present
pretvoren	Past
bezgrešnom	None
bolujem	Present
bakreni	None
biografu	None
uvodimo	Present
naoružavale	Past
meo	Past
ostaviš	Present
skrpavalo	Past
prođi	None
šašavih	None
rezonantno	None
osporene	Past
inča	None
nazivao	Past
postoljem	None
dokazivo	None
smiješi	Present
kanalskomu	None
uklanjaju	Present
održava	Present
unište	Present
nosimo	Present
uskom	None
curile	Past
pripitomljen	Past
crepe	None
opali	Past
istražile	Past
čitano	Past
vezle	Past
kajmakom	None
oboo	Past
naručeno	Past
mladićem	None
čovečji	None
juni	None
raspiše	Present
zaštićuju	Present
prijeđene	Past
proglašavane	Past
usvojeni	Past
гвоздени	None
onemogućen	Past
natapaju	Present
gnjilele	Past
umorismo	Past
obraća	Present
oštećivalo	Past
birali	Past
ubrzavah	Past
miješani	Past
mucahu	Past
umorno	None
doprinosite	Present
svečano	None
bezimenoj	None
crpio	Past
ujedinilo	Past
unosile	Past
skromniju	None
starinu	None
vjeruju	Present
popucali	Past
vježbao	Past
brojio	Past
ničem	Present
diobom	None
saugaš	Present
zasjenjen	Past
suspenzijom	None
proglašeni	Past
amfibija	None
prilogu	None
trezne	Present
diskvalificiralo	Past
proveravasmo	Past
ljuljasmo	Past
kazanom	None
dodeljivali	Past
smirili	Past
biglisaste	Past
zgusnemo	Present
viče	Present
stearin	None
kovali	Past
strogih	None
levan	Past
ostvare	Present
opravdane	Past
oslonio	Past
dive	Present
napunjeno	Past
potpisale	Past
položili	Past
okupljao	Past
sniženi	Past
enciklopedista	None
prenijele	Past
predsjednike	None
plaćali	Past
procjenjivali	Past
obavija	Present
obustave	Present
suočava	Present
oficire	None
sirupa	None
trud	None
razredi	None
zaraćeni	Past
nastavljam	Present
poništene	Past
ohrabrivale	Past
arheološkim	None
obrađeno	Past
bježale	Past
nadovezao	Past
stižeš	Present
nagovarao	Past
natjeran	Past
pouzdanosti	None
prenete	Present
većinu	None
azot	None
uživa	Present
podnio	Past
izračunavaju	Present
povlačeni	Past
kraul	None
razrađuje	Present
kuha	Present
običnu	None
geografija	None
vrtoglavicom	None
obješeno	Past
osećajne	None
urote	Present
razočarali	Past
odabrali	Past
stopile	Past
skladali	Past
statičnom	None
novembarskomu	None
zabetoniraste	Past
suočile	Past
apologetiku	None
pokrenuti	Past
zaručnici	None
registracija	None
zemljoposjednici	None
šepavija	None
britanske	None
најлукавији	None
melo	Past
volovskome	None
šema	None
umjetnikom	None
maše	Present
pretvaralo	Past
projektil	None
nazivaju	Present
najahaše	Past
jahači	None
razmenjene	Past
rastaje	Present
progutane	Past
rušen	Past
upriličeni	Past
pretražio	Past
ukrašavah	Past
haran	Past
hvatao	Past
upozoravao	Past
ocijenjen	Past
ispitali	Past
fizičko	None
sklonim	Present
oklevaju	Present
naglašen	Past
čahure	None
izgubio	Past
istraživačkom	None
doživjele	Past
kuhali	Past
posjekli	Past
izgovaralo	Past
predočavalo	Past
penjao	Past
sticali	Past
pravovaljanoga	None
sabirali	Past
seda	Present
dostignute	Past
nadvisimo	Present
pobudile	Past
voćem	None
prevladali	Past
ćoravice	None
gutanju	None
utvaraste	Past
jabučicu	None
ušicama	None
saborničke	None
misliš	Present
nastojah	Past
hirovit	None
nastavljeno	Past
robovlasnike	None
predvideo	Past
slavonskim	None
antimaterijo	None
sukobljavali	Past
plesačicom	None
apolitičnoj	None
vršeni	Past
svedočio	Past
sjedi	Present
riješe	Present
umeju	Present
cilindričnomu	None
kladio	Past
pokrenut	Past
odbijan	Past
promatra	Present
ocenjeni	Past
mnogostrukim	None
predlagali	Past
saopćuju	Present
obavještavaju	Present
polimorfizmima	None
pilo	Past
provaljuje	Present
ušiljim	Present
anektirao	Past
zaključilo	Past
udruženjem	None
odobreno	Past
postidesmo	Past
krivim	Present
liniji	None
šestoricu	None
pojačale	Past
proizvodom	None
ubrzalo	Past
dostizao	Past
paradiraju	Present
kostriješasmo	Past
negoduje	Present
smoče	Present
progutani	Past
prihvaćale	Past
zamrzio	Past
bilježeno	Past
zdjeli	None
navodio	Past
verifikaciju	None
prevladan	Past
sjaju	Present
iskopavano	Past
izgledaš	Present
jemenskim	None
viknuo	Past
svjedočah	Past
iscrpile	Past
lomljivu	None
sekundi	None
poboljšavao	Past
ometani	Past
smijenili	Past
vodilo	Past
ukinute	Past
nameravao	Past
dvojile	Past
prestrašen	Past
iziskivalo	Past
oštre	Present
kasnili	Past
projekt	None
smeš	Present
znojne	None
mazan	Past
posrednici	None
uvredili	Past
organskim	None
rekurzivnih	None
ucjenjuje	Present
nosa	Present
ćȍsavōst	None
prorađujete	Present
pizdele	Past
izbrisale	Past
prevoja	None
donose	Present
sećam	Present
usadili	Past
pripravljahu	Past
apeli	None
iskrcali	Past
vratolomiju	None
početno	None
kurzivni	None
odale	Past
očarasmo	Past
dramatičniji	None
dojile	Past
monstruoznih	None
razaran	Past
jezičkim	None
zamijenjeno	Past
uspevao	Past
ždrijepci	None
zakazao	Past
nabavio	Past
posuđeno	Past
okretano	Past
obaveštavali	Past
opasano	Past
sjedalima	None
apsolviramo	Present
prerasti	None
propisan	Past
odabrane	Past
naslijedilo	Past
starali	Past
približio	Past
blagosiljao	Past
kadiš	Present
sužava	Present
trebale	Past
spuštamo	Present
kotiraju	Present
razoriše	Past
pošlo	Past
raseljavano	Past
djelujemo	Present
rasporede	Present
otvara	Present
svrstani	Past
odredio	Past
utjeha	None
nacrtano	Past
krao	Past
materijalističkom	None
kiti	Present
uvjerili	Past
zavisnije	None
smotrio	Past
nejednákosti	None
uvežbane	Past
oskudnije	None
zadubao	Past
govorimo	Present
ponovim	Present
snabdevene	Past
Adventom	None
opsednuti	Past
vari	Present
zmijolikoga	None
obilježile	Past
privlačilo	Past
uključite	Present
inačice	None
bengalsko	None
slabilo	Past
potopljen	Past
propatili	Past
semenu	None
žbuka	Present
očišćeni	Past
opredeljeno	Past
infracrvenoj	None
darovali	Past
odrastali	Past
zbrinuo	Past
razdvojile	Past
mlače	None
izbrisan	Past
obrazuje	Present
pretrpjelo	Past
popratili	Past
uplovio	Past
udaljenu	None
postižemo	Present
oživelo	Past
belgijsko	None
pisan	Past
vio	Past
spasile	Past
obaveštava	Present
vjeruješ	Present
atentatori	None
zvonikom	None
proizvodi	Present
riješeno	Past
rešavamo	Present
najnježnijega	None
mučne	None
veseli	Present
turkijski	None
prepisali	Past
dezinficirao	Past
opisivale	Past
rastvorene	Past
rasformirali	Past
uključili	Past
davnine	None
nepažnju	None
snižavani	Past
licence	None
dočarali	Past
valjku	None
besjedio	Past
privukle	Past
gorski	None
istraže	Present
krijesnica	None
ljetovanje	None
pristižu	Present
gangstersku	None
zagrijane	Past
potvrdili	Past
sukobili	Past
siluju	Present
crepom	None
ujedinile	Past
zbunio	Past
baščaršiji	None
gađao	Past
traktati	None
objasnili	Past
isperu	Present
lèvica	None
statički	None
odrađivao	Past
redovitom	None
provereno	Past
osiguravate	Present
pričvršćeno	Past
prizemlje	None
prosečnom	None
skrenuli	Past
meće	Present
zaklonjen	Past
razdvajao	Past
raskošni	None
razvozim	Present
ilirsku	None
svȋrka	None
nošeni	Past
štemovale	Past
okusili	Past
orgiju	None
uvjerljive	None
čitljivo	None
pređemo	Present
rascepio	Past
zavisilo	Past
ispitah	Past
transformaciji	None
boli	Past
namjeravam	Present
nabili	Past
javite	Present
utajilo	Past
kišilo	Past
zastupa	Present
gorče	None
sonar	None
pristupao	Past
optuživani	Past
heraldiku	None
salonu	None
obnavljao	Past
levaš	Present
jamči	Present
prisilnoga	None
imućne	None
prisustvovali	Past
bučni	None
darovitih	None
istaknuto	Past
selektori	None
napuštaju	Present
dostignut	Past
poređenju	None
odbijaju	Present
naglašene	Past
patrijarhalna	None
katu	None
objavljivani	Past
shodna	None
trošio	Past
tračnicama	None
podudara	Present
smeši	Present
svrstavao	Past
približavao	Past
mjȅsēce	None
neprijateljstva	None
poplavljene	Past
isijecah	Past
gađenjem	None
srušeni	Past
razumjeste	Past
dodeljen	Past
diskretni	None
meza	None
napreduju	Present
okultni	None
razdijeljen	Past
blijedim	Present
izgradnjom	None
pristizale	Past
griže	None
germaniziraj	Past
prljavom	None
sude	Present
ispraznim	Present
uradilo	Past
snimio	Past
razumiješ	Present
sazrelo	Past
priznale	Past
dokučujem	Present
ručica	None
španjolskom	None
potajno	None
akceleratora	None
shvatale	Past
nòzi	None
pridonosili	Past
nasljeđuju	Present
zauzimaju	Present
nagao	None
zbrojih	Past
razrušio	Past
utrošeni	Past
zmijski	None
zaostadosmo	Past
postizane	Past
jastukom	None
svideo	Past
lančano	None
učene	Past
amplifikacija	None
tonskih	None
podsjetili	Past
oslobađate	Present
ostanku	None
uklinjasmo	Past
vene	Present
дремљив	None
očistile	Past
izliječio	Past
podržali	Past
gledaju	Present
izdržali	Past
nakotima	None
dolazim	Present
posekao	Past
nepunu	None
maloljetničke	None
haba	Present
ovjereni	Past
pravda	Present
demokratskim	None
dosade	Present
ciljaju	Present
šaran	Past
upijali	Past
najoholiju	None
superiorni	None
kacige	None
opredijelio	Past
ekspanzija	None
jenjavao	Past
iselili	Past
komentirali	Past
jajetu	None
identitetu	None
beskućnicima	None
zaljubljivane	Past
olakšane	Past
proslavilo	Past
skidam	Present
najluksuzniji	None
izgovara	Present
peva	Present
upada	Present
lijepom	None
oživljava	Present
pridruženi	Past
razmaženi	Past
rata	None
smještajnim	None
klečaste	Past
nepovjerljivije	None
dospeju	Present
išarano	Past
plovučce	None
skupljeno	Past
uočimo	Present
spajamo	Present
oboli	Past
presudiš	Present
klanjaju	Present
smirio	Past
odsečen	Past
izjednačen	Past
najbezosjećajnijoj	None
istovarivačima	None
imun	None
crvenokosa	None
odobravale	Past
puštao	Past
utapao	Past
ozlijeđene	Past
smrtonosan	None
crtan	Past
usvajao	Past
takmičarke	None
ukrašavaju	Present
zahvalim	Present
naseljenu	None
rasklopilo	Past
uvaljuje	Present
prihvaćalo	Past
sadržavale	Past
konstruirao	Past
srlja	Present
usidrio	Past
opsovale	Past
presjekao	Past
izdali	Past
civilnoga	None
stječe	Present
odvojismo	Past
razmatrali	Past
polomljen	Past
uklonih	Past
ugrađivali	Past
lepome	None
doživljavale	Past
djetinjasto	None
obući	None
antropološkomu	None
okrenuti	Past
uređaje	None
mračnoj	None
smeste	Present
antropološkom	None
opsjednute	Past
bezvrijednih	None
rasprodaju	Present
tužitelju	None
rođeni	Past
alpinizmom	None
odmjeriše	Past
upoznaje	Present
privuklo	Past
hanovima	None
okupljen	Past
graničar	None
štampao	Past
umislio	Past
zagreboh	Past
sretne	Present
predao	Past
krčmario	Past
komfore	None
smatrah	Past
dodeljivalo	Past
pešaci	None
predviđaju	Present
obalnim	None
klanja	Present
preseku	Present
istrenirao	Past
ukrštene	Past
zapaljen	Past
latiš	Present
voćnjaci	None
istovaren	Past
impresionirali	Past
zavise	Present
varan	Past
filoloških	None
demonskih	None
prolazi	Present
uvrstilo	Past
izrađivali	Past
kamiondžijama	None
nastavci	None
obojene	Past
carski	None
nastalo	Past
preostao	Past
ulepšavaj	None
potreban	None
otkazom	None
postanete	Present
tjeralo	Past
privukao	Past
kontemplaciji	None
uhvatili	Past
stepama	None
položilo	Past
razneo	Past
razrađivali	Past
antilopama	None
dobacuje	Present
čizmu	None
meteorite	None
zupčaniče	None
aktivnijim	None
dvojasmo	Past
cijenjen	Past
nesagorivim	None
pokvasiste	Past
ugrožava	Present
poludio	Past
opažamo	Present
abecediraš	Present
pridjevom	None
kritizirano	Past
sklapao	Past
cjevovodu	None
spaljivani	Past
omogućen	Past
odmjeriš	Present
takmičilo	Past
otkrića	None
nadograde	Present
presuđivali	Past
iskopano	Past
opravdale	Past
late	Present
neugledno	None
toplom	None
slaganje	None
prerađivah	Past
dozvoljen	Past
razbegle	Past
izazove	Present
zahvaćeni	Past
zabilježili	Past
proizvodile	Past
slatino	None
dostizale	Past
plahti	None
stvoritelj	None
svinjom	None
tatarske	None
brojkama	None
izbacili	Past
impresivnim	None
kapa	Present
kažnjavalo	Past
dimovi	None
suočilo	Past
bjelila	None
začuđujem	Present
bivao	Past
krvavile	Past
presude	Present
šokirali	Past
ispijasmo	Past
štafetu	None
dadoh	Past
isticani	Past
napadalo	Past
pčelinja	None
prišle	Past
povorku	None
risale	Past
katastrofe	None
koštale	Past
svučem	Present
kaznu	None
prenošeni	Past
zamerile	Past
uneli	Past
doplovili	Past
nakupio	Past
prikažu	Present
tonem	Present
najavljivalo	Past
trk	None
promašuje	Present
razmenjuje	Present
sestrinstva	None
urešeni	Past
puste	Present
zimovali	Past
pohvalio	Past
naklanjasmo	Past
nazivale	Past
suzivale	Past
nasrne	Present
uništen	Past
ljubavnu	None
podilazio	Past
težili	Past
preradiše	Past
raznježivale	Past
abdomenima	None
mjeri	Present
presječene	Past
harao	Past
žitom	None
porobljujmo	None
nagrađivane	Past
sole	Present
napuštene	Past
brdovitijih	None
postojani	None
znamenke	None
osvajale	Past
prali	Past
probudite	Present
nacrtali	Past
kozliću	None
plahi	None
kažnjava	Present
zakopane	Past
odvodile	Past
osramoćivalo	Past
šapne	Present
klekne	Present
cio	None
osiromašuje	Present
koleno	None
tali	Present
potvrda	None
jula	None
gubio	Past
onemogućeno	Past
arbitrarna	None
zlostavlja	Present
nosan	Past
naseliste	Past
otimali	Past
crnogoričnom	None
ispražnjen	Past
kneževinama	None
nepokolebljiv	None
kranjskim	None
posluživali	Past
emocionalnome	None
održavano	Past
obećavalo	Past
isplativosti	None
pređeno	Past
rigah	Past
bubuljičavost	None
izabrasmo	Past
očuvao	Past
poveden	Past
uzvikuje	Present
činio	Past
predstavljalo	Past
радијалан	None
prošao	Past
franački	None
kroje	Present
mitološkim	None
oteto	Past
miješano	Past
jedinjen	Past
tajkunu	None
kajali	Past
procenjivahu	Past
poznatija	None
prikazivale	Past
cirkusa	None
opisivane	Past
oponiraste	Past
inatio	Past
krilo	Past
palestinsku	None
pokrenute	Past
potpisivao	Past
poprimljeni	Past
prepire	Present
uzveraše	Past
probdeveno	Past
sabirahu	Past
zapamte	Present
piljene	Past
zavidelo	Past
udomili	Past
uposlen	Past
radim	Present
skaču	Present
osporavan	Past
školovani	Past
vonjamo	Present
iseku	Present
sjajne	None
germansku	None
obešene	Past
nazdravljale	Past
sprdaste	Past
primitivniji	None
obrazovnoj	None
pendžerima	None
školovane	Past
zahteve	None
načinile	Past
vrtloge	None
ispravljam	Present
potražio	Past
stvarale	Past
zahtijevane	Past
cene	Present
dopunite	Present
udruženi	Past
harale	Past
kritiziraju	Present
непропустан	None
poslužen	Past
ispušten	Past
sličio	Past
resite	Present
odnio	Past
oličene	Past
sažete	Past
divane	Present
okovi	None
izjednačene	Past
zbunjeni	Past
stočarske	None
ljubavnice	None
vjerovao	Past
elektromagnetske	None
promislim	Present
poboljšano	Past
ulovili	Past
pripojen	Past
skrio	Past
najgrubljoj	None
nezdravom	None
iskorenili	Past
čami	Present
arapskim	None
točilo	Past
vezene	Past
aludirahu	None
zapovedim	Present
najnepovjerljivijoj	None
pretapaju	Present
vezivane	Past
obodi	None
šibica	None
graniči	Present
krepale	Past
sitnim	Present
prethodi	Present
globljasmo	Past
adaptiraju	Present
izdvajali	Past
drhti	Present
stvaranjem	None
odmerili	Past
formuliramo	Present
odelili	Past
nepredvidljivi	None
osnovaše	Past
prevareni	Past
imenuju	Present
utoke	None
pravovjerni	None
diktatorkom	None
prijestolju	None
odlazile	Past
raspušta	Present
bubrege	None
bezvlađe	None
dopunjava	Present
razdvojene	Past
prži	Present
uručio	Past
rastaviše	Past
povije	Present
simplificiraše	Past
igrokazi	None
srebrna	None
izoštravahu	Past
proterano	Past
odijevali	Past
razumeli	Past
odrađivan	Past
smaragd	None
prepirke	None
odvučen	Past
rigidna	None
prcasmo	Past
potkopali	Past
sipa	Present
zgužvao	Past
raspršili	Past
predstavljaju	Present
psalama	None
primete	Present
porobljeno	Past
dozvoljava	Present
окомит	None
carinskim	None
impresioniraju	Present
neuspješne	None
bombardiraju	Present
grebeni	Past
uvjeren	Past
smatrao	Past
poginuo	Past
levoj	None
spreče	Present
rezalo	Past
tinejdžer	None
ekvivalentnih	None
masturbacije	None
smognite	None
spekoh	Past
tucano	Past
nudisti	None
katapultirali	Past
ambigvìtēt	None
dubi	Present
alarmantnije	None
biljnim	None
prose	Present
slao	Past
nobelovca	None
pogasite	Present
napuštani	Past
naglašeni	Past
otpustio	Past
smireni	Past
harfu	None
umnim	None
андалуски	None
štampali	Past
doprinelo	Past
udruživali	Past
pribrajasmo	Past
krstarite	Present
rasformirane	Past
potvrdile	Past
izbriše	Present
odradio	Past
slepcem	None
sjah	Past
zavlači	Present
naljutio	Past
stihove	None
taoci	None
ispravna	None
naslijedili	Past
utvrđivasmo	Past
најдалекосежнији	None
zatraženo	Past
prilazile	Past
kastom	None
primate	Present
pokazan	Past
hemiji	None
obelodanjivao	Past
razmatramo	Present
nabrbljaš	Present
primenio	Past
vrteo	Past
pogrešio	Past
bjelance	None
otputuju	Present
dopremaju	Present
ojačao	Past
propijali	Past
zahvatilo	Past
zmijicama	None
zrakastim	None
realno	None
komentiramo	Present
pokušava	Present
sačuvan	Past
posramljivali	Past
odzvonimo	Present
promene	Present
roditeljskih	None
sviramo	Present
transliterirasmo	Past
obučavani	Past
zamjeriše	Past
bleskali	Past
najgnjusnijemu	None
nuđen	Past
razrađen	Past
zidajmo	None
pokreta	None
posjedujemo	Present
zaboravljasmo	Past
popisivao	Past
varaju	Present
prerijski	None
prdnuše	Past
obaviješteni	Past
gata	Present
ukrcava	Present
prihvaćate	Present
potplatio	Past
sabrani	Past
neiscrpne	None
zaokružili	Past
podstaviš	Present
shvaćali	Past
cvjeta	Present
ovjenčao	Past
najžgoljavijima	None
razmotre	Present
popratnoga	None
sitne	Present
božanstvom	None
vreban	Past
šancem	None
raščlanjene	Past
krtolom	None
afarski	None
svanemo	Present
raspletu	Present
imputirale	Past
ilovači	None
odlazio	Past
napale	Past
apsolutom	None
stavili	Past
zbližavaju	Present
efendije	None
gospodarilo	Past
nepoznatih	None
vraćeni	Past
maglinu	None
nominativa	None
ozlijedio	Past
jačini	None
istaknutije	None
negirali	Past
presvučeno	Past
mȁloūmnīče	None
prihvatite	Present
pomislio	Past
ozljedom	None
naselili	Past
utvrdilo	Past
ohrabruju	Present
uključio	Past
pričinih	Past
nadoknade	Present
pismohrane	None
ganut	Past
poravnavaju	Present
naučene	Past
počinio	Past
reprezentaciju	None
naglasilo	Past
redovitijim	None
kočiš	Present
opreme	Present
htelo	Past
iscurismo	Past
smetali	Past
oživeli	Past
delfini	None
salome	Present
susretao	Past
zastrašen	Past
uresite	Present
koherentnim	None
sazru	Present
slijeda	None
raskućismo	Past
pokriju	Present
liveni	Past
izgovaran	Past
uselilo	Past
nezadovoljstvu	None
osvrtima	None
dovođene	Past
košarke	None
stratigrafiji	None
najretardiranijemu	None
nestao	Past
opraštan	Past
suzdržani	Past
osnovna	None
navale	Present
crepa	None
staraju	Present
zahteva	Present
nabujaš	Present
kancelaru	None
resim	Present
ponovljeni	Past
poslan	Past
formirali	Past
razbacane	Past
rđali	Past
poraslo	Past
aktualiziraste	Past
imenovali	Past
izričite	None
podučavan	Past
rasipan	Past
trguje	Present
kritizira	Present
zahtijevano	Past
nepripremljeno	None
napustim	Present
zlorabim	Present
ovjenčan	Past
spremio	Past
bubne	Present
zadržani	Past
obavještava	Present
plodio	Past
nijansama	None
napišete	Present
pljuvali	Past
dopunjavaju	Present
zauzele	Past
najurimo	Present
postavljeno	Past
shvatili	Past
nožem	None
uspavljuješ	Present
odaje	Present
pripisivan	Past
astronomskim	None
tajnicom	None
zaštićeno	Past
poriče	Present
uživale	Past
boriš	Present
predomislili	Past
prihvaćam	Present
zavoljesmo	Past
vije	Present
izvidio	Past
lampama	None
otkinuti	Past
nasitimo	Present
panju	None
dopremismo	Past
tražim	Present
osvećuju	Present
seju	Present
teniska	None
trenutačnoj	None
propisani	Past
upisao	Past
poklonile	Past
afroazijsku	None
predela	None
suknjama	None
tipkah	Past
posjetile	Past
napušta	Present
oporavljali	Past
razoružani	Past
skinule	Past
kažnjavani	Past
podudarao	Past
raspršeni	Past
građanki	None
odvođen	Past
izvade	Present
prozvale	Past
inicijatoru	None
nagovara	Present
ponaša	Present
krojene	Past
potkovano	Past
pretopismo	Past
povraćaju	Present
omogućeni	Past
cikličan	None
sleđivani	Past
putovali	Past
odjevnim	None
tepeš	Present
zašiljeni	Past
naručili	Past
reagirali	Past
barbara	None
pregnuše	Past
uvažavali	Past
zamenite	Present
draženi	Past
sklope	Present
povređeni	Past
spremile	Past
obrate	Present
skelom	None
zamišljene	Past
održavani	Past
intonacijom	None
govorljivijom	None
cement	None
neboder	None
menjale	Past
bran	Past
vrhovnoga	None
vadim	Present
kuvan	Past
svezane	Past
ispostavljalo	Past
prokopavali	Past
bibliotekari	None
pokrenuto	Past
belaj	None
pretvoreni	Past
objavljeno	Past
snabdevale	Past
proširivan	Past
zatvarasmo	Past
dijagrami	None
nema	Present
kolje	Present
pravdahu	Past
дељив	None
razbjegne	Present
milovan	Past
nacionálnosti	None
kraljicom	None
uputama	None
presudilo	Past
ispunio	Past
nepromenjenih	None
ispali	Past
preostale	Past
lovilo	Past
pružili	Past
odgrizene	Past
nepušači	None
govoreno	Past
obaveštajnom	None
uvezivah	Past
podstrigu	Present
naoružan	Past
biva	Present
upotrebljavali	Past
glagoljičke	None
pročitano	Past
štucne	Present
zemaljsko	None
izostaju	Present
dvoje	Present
holandskoj	None
bistri	Present
transportiraju	Present
ubodem	Present
predložio	Past
umiru	Present
obišlo	Past
naslijeđene	Past
zviždale	Past
opirale	Past
nepoštenih	None
ponedjeljka	None
pozdravljam	Present
upućeno	Past
neprimjereni	None
brisani	Past
sačekali	Past
prepoznali	Past
prekrivalo	Past
cjeloviti	None
finalno	None
odriču	Present
prisutnost	None
gulimo	Present
uspevali	Past
autarhijom	None
izgarao	Past
dvor	None
labavi	Present
najavljivale	Past
razlučilo	Past
učlanio	Past
obuzdaju	Present
išarasmo	Past
trošili	Past
proglašavam	Present
opstoji	Present
oponašali	Past
zablistaš	Present
nebeskoj	None
projicirao	Past
prepadane	Past
svojina	None
osuđivane	Past
jedinim	Present
krstokljun	None
slobodna	None
stupilo	Past
reportaža	None
zaboravljeno	Past
istraživao	Past
svežem	Present
šarani	Past
ometao	Past
mjerene	Past
talasa	Present
shvaća	Present
poznati	Past
uzrokovao	Past
apostrofirale	Past
preselili	Past
protječu	Present
trojaki	None
hvaljah	Past
kobne	None
rekni	None
spomenom	None
izdvojili	Past
vlaži	Present
izbatinao	Past
testirao	Past
prebacivali	Past
frkan	Past
šiljatim	None
suočavali	Past
odugovlačio	Past
određuje	Present
janjimo	Present
kolhoza	None
bešnjele	Past
mrski	None
brusio	Past
prezirali	Past
destruktivnija	None
porastao	Past
raspuštale	Past
smakne	Present
tečne	None
otvorio	Past
počet	Past
arhitektica	None
iznenađuje	Present
napomene	Present
haubu	None
podržavaju	Present
braniš	Present
obučio	Past
najbolje	None
estonskoj	None
najneuobičajenijega	None
avanture	None
razmnožavali	Past
opuštamo	Present
proćaskaju	Present
tražilo	Past
lakoće	None
uzdisasmo	Past
ogovara	Present
naglašavao	Past
апатичан	None
nečasno	None
sarkastičnih	None
razbili	Past
zagrijavaju	Present
carinarnice	None
označeno	Past
odjeci	None
blagosilja	Present
mijenjao	Past
čapa	Present
određenih	None
afirmaciji	None
spljošten	Past
odali	Past
spaljivale	Past
krijumčario	Past
odlučih	Past
anektirale	Past
policija	None
počinjale	Past
pjenom	None
sintetična	None
razglašuju	Present
izbavile	Past
provjereno	Past
grebu	Present
čopor	None
raskidao	Past
označavali	Past
cijenim	Present
istupali	Past
seksualnosti	None
izrađivano	Past
pobuđuje	Present
prekršen	Past
špangu	None
slavohlepniji	None
razbudismo	Past
završavalo	Past
razjarene	Past
gazdi	None
upotrebljavamo	Present
svidjele	Past
radile	Past
analizirale	Past
razborito	None
kružilo	Past
uzrokuje	Present
iluzioniste	None
javljale	Past
pripitomljeni	Past
vikala	Past
izlučivane	Past
činjahu	Past
namenjeni	Past
измерљив	None
ubačeni	Past
opušta	Present
povratih	Past
zapisivao	Past
konvencionalnih	None
otklonilo	Past
šutio	Past
vreli	Past
nabrajaju	Present
rafinirali	Past
obilježeno	Past
odstreliš	Present
dionica	None
ràzdvōjenōst	None
bure	None
razdvojen	Past
partijskoga	None
financira	Present
povezalo	Past
akademik	None
odnosi	Present
sere	Present
načeli	Past
putujemo	Present
dresirao	Past
zapovijedao	Past
stvorene	Past
lokale	Past
eshatologiju	None
predamo	Present
obranio	Past
provodi	Present
mještani	None
zalama	Present
navođene	Past
cijenilo	Past
istopljeni	Past
otklanja	Present
raščlanjuje	Present
amateru	None
zalijete	Present
mjerimo	Present
pripečene	Past
sunčan	Past
tricikl	None
doslednosti	None
ilustratore	None
prostorno	None
mestimični	None
tiskano	Past
hrastovina	None
poduzetnikom	None
zakine	Present
najdostojnijom	None
neutroni	None
zakazuje	Present
uvlačio	Past
razvođahu	Past
preskače	Present
zaglavljeni	Past
izvodi	Present
pukovnijama	None
svodi	Present
naponu	None
zaratiše	Past
semantičku	None
zadesili	Past
podržavam	Present
glavnica	None
zanimaju	Present
goje	Present
raselili	Past
izmerimo	Present
paranoja	None
privukli	Past
saopćio	Past
znatiželjan	None
prethodili	Past
razumio	Past
regrutacijom	None
izbegavaju	Present
kritizirani	Past
uvjere	Present
ufa	Present
tresetu	None
objasne	Present
pripovijeda	Present
dospio	Past
pohlepe	None
krvava	None
tradicionalni	None
škrtario	Past
preventivnom	None
vitalne	None
gomilate	Present
ukorenjen	Past
davane	Past
bivstvovahu	Past
pažljiviji	None
utopljen	Past
ukazano	Past
duguje	Present
odolevaste	Past
povežemo	Present
osnovani	Past
izdvojene	Past
vojvodi	None
ručaju	Present
naiđete	Present
smrzavajmo	None
dođem	Present
pretragama	None
verižni	None
versificirah	Past
prigode	None
sedam	Present
obratilo	Past
bori	Present
realnijom	None
konkurenta	None
ogrebotina	None
obećavaste	Past
procjenjuju	Present
cvjetao	Past
testovima	None
nadovezaste	Past
potaknuti	Past
utopilo	Past
carevića	None
ustašu	None
krnice	None
položene	Past
progovaraste	Past
zapazili	Past
zgrćeš	Present
inicijatori	None
hiponimiju	None
dlanova	None
iskorišteni	Past
dinamiku	None
mrljom	None
napišem	Present
nadopunjavano	Past
ubija	Present
zadovoljen	Past
svakakve	None
neuspjelo	None
bugarino	Past
zateklo	Past
uzgojili	Past
akadski	None
počinjali	Past
puščana	None
iskaču	Present
prede	Present
drevno	None
vođeni	Past
čira	None
natječaju	None
presretne	Present
dvojite	Present
umirem	Present
labave	Present
automobili	None
nastradale	Past
obavijajmo	None
srh	None
jenjaste	Past
ispunite	Present
progovorilo	Past
pokvarile	Past
neurednom	None
suvremene	None
nagibe	None
zavolen	Past
skladam	Present
sprečio	Past
potapaju	Present
namijenite	Present
pročitani	Past
spomenuše	Past
sredim	Present
tuca	Present
prikrivaju	Present
potkrijepimo	Present
reagiraste	Past
stiču	Present
priopćavaju	Present
pržaste	Past
ocjene	None
predlažu	Present
dopuštan	Past
bosonogomu	None
najkonstruktivniju	None
bijelim	Present
glina	None
razbacah	Past
podmićen	Past
vođen	Past
kvarove	None
utvrđene	Past
ispisujemo	Present
pobedilo	Past
glavicom	None
paklenih	None
okupljalo	Past
pregovaraju	Present
odem	Present
obesile	Past
nazorom	None
oprostio	Past
cvale	Past
osporava	Present
trupama	None
sitnjahu	Past
obilježavalo	Past
zastrašili	Past
proterali	Past
zubar	None
povećalo	Past
etànōl	None
uticali	Past
improvizirasmo	Past
prorekao	Past
premotaju	Present
raspodeljen	Past
buknuo	Past
podvale	Present
šipci	None
gledani	Past
raspravimo	Present
razoružamo	Present
spriječeni	Past
vratimo	Present
neopravdan	None
rasječen	Past
telegrafist	None
prestižu	Present
odbijali	Past
upućivane	Past
takmiče	Present
kladivima	None
adverbijalnoj	None
morah	Past
neplodnim	None
razvijalo	Past
magarac	None
nakuplja	Present
feudalnu	None
bòjōvnīče	None
uvriježio	Past
odabran	Past
otplovili	Past
krčme	Present
osjetio	Past
uvrstio	Past
migova	None
lomio	Past
vješa	Present
neslužbenih	None
trlja	Present
uočavamo	Present
telekomunikacijskim	None
zlovoljni	None
objavljen	Past
mučna	None
pripremani	Past
inferiornija	None
pregrađene	Past
modi	None
skromna	None
iritiraju	Present
posijedio	Past
pogledavalo	Past
gonjeni	Past
nadahnjivani	Past
opica	None
oštećuju	Present
skandinavskih	None
pravdane	Past
maglovit	None
zadovoljimo	Present
povjerili	Past
izdržale	Past
miješamo	Present
odsecaju	Present
raspoloživom	None
najkrnji	None
najбуђавијima	None
pritiskale	Past
kropilo	None
kliče	Present
penetrira	Present
prošireni	Past
bestjelesnom	None
dignu	Present
slikaju	Present
pređu	Present
stupića	None
naglašavalo	Past
postigle	Past
poslovali	Past
paneliralo	Past
uklonjene	Past
pomiluješ	Present
prebiju	Present
sapunarskom	None
poludjesmo	Past
preslikane	Past
propovijedali	Past
evanđeoske	None
popisuju	Present
listiću	None
reklo	Past
prosjačile	Past
поузданији	None
neosjetljivomu	None
izdrži	Present
sijeku	Present
osiguran	Past
austrijanskih	None
incestom	None
ljutilo	Past
pratimo	Present
jastuci	None
zaslužio	Past
razorene	Past
uključimo	Present
obustavili	Past
niknuti	Past
prelaze	Present
kompromitirali	Past
nahranio	Past
svarivani	Past
oštetili	Past
zuri	Present
obrubljene	Past
kisiku	None
odmorih	Past
opremljeni	Past
predočeno	Past
sinete	Present
monstruoznim	None
pročitali	Past
ponavljalo	Past
belilom	None
dočekalo	Past
diči	Present
razasuli	Past
pripišu	Present
vrijeđalo	Past
bučice	None
hipicima	None
setio	Past
kvarah	Past
glumile	Past
negiraju	Present
oživljavaj	None
ljubimo	Present
prigovora	None
