geçmen	Nominative
akrobat	Nominative
sözleşmesini	Accusative
dikkat	Nominative
aynasını	Accusative
kilisesi	Nominative
salamlarınızı	Accusative
kumalar	Nominative
blogcu	Nominative
polise	Dative
reaktörlerde	Locative
ışınım	Nominative
canlandırma	Nominative
şamarlamayacağım	None
iskeletlerden	Ablative
yöresine	Dative
kahvelerde	Locative
yerlerdi	None
makyajda	Locative
tenisçilerinize	Dative
kimliğimin	Genitive
alanımızın	Genitive
alındırtıyoruz	None
indiler	None
sürter	None
sürülmem	None
şoklara	Dative
iskeletlerin	Genitive
cümleye	Dative
kesti	None
yarasalarmışsınız	None
aznavurunuzun	Genitive
eğri	Nominative
doyduk	None
çılgınlığı	Accusative
stantlar	Nominative
aygıtlarınızın	Genitive
kozmonot	Nominative
koyumuzu	Accusative
uyandık	None
delirir	None
takımın	Genitive
değiştirmez	None
girersiniz	None
göstereceksiniz	None
halkımızın	Genitive
arındık	None
günlerden	Ablative
unutmam	None
maske	Nominative
meydandan	Ablative
dakikalara	Dative
sorularınızın	Genitive
acenteliği	Accusative
geçtin	None
öyküm	Nominative
filmden	Ablative
madama	Dative
fakültesi	Nominative
umuyordu	None
kırıntılar	Nominative
öksürük	Nominative
sözlüğe	Dative
modan	Nominative
oturuyordu	None
popomuzu	Accusative
heyecan	Nominative
ergenliğim	Nominative
gösterilerimize	Dative
yasaklar	Nominative
yaptırıyorlar	None
odalarda	Locative
bay	Nominative
ayırdım	None
dünyalara	Dative
dağa	Dative
onguncumu	Accusative
takat	Nominative
araçsın	None
kısrak	Nominative
monarşileri	Accusative
sikmezsiniz	None
öperim	None
yaklaştım	None
Vikipedilere	Dative
parçalanmasından	Ablative
cinsin	None
yağlayıcısında	Locative
basımı	Accusative
koyarım	None
sevmedik	None
minareden	Ablative
derecelerden	Ablative
vade	Nominative
takside	Locative
arzularımızda	Locative
fizikçilerden	Ablative
roketlere	Dative
böğürtlenler	Nominative
kelepçemizde	Locative
fikirlerimize	Dative
çelik	Nominative
efe	Nominative
trenlere	Dative
kullanmıyor	None
kocaya	Dative
bölümümüz	Nominative
sıvı	Nominative
dolaplarda	Locative
kastınız	None
kazandınız	None
ayrılırlar	None
insanımsıyız	None
tabutlarınızın	Genitive
susmaz	None
yasalara	Dative
fişeklerden	Ablative
paylaştırması	Nominative
annelere	Dative
basıma	Dative
dileklerimi	Accusative
palikaryalarımızın	Genitive
pasifti	None
odacığı	Accusative
kayık	Nominative
yorumlarımı	Accusative
okulumuzda	Locative
çevirimimden	Ablative
pancara	Dative
ofislerden	Ablative
kansızlık	Nominative
kanalların	Genitive
içkilerin	Genitive
görmüyor	None
biçim	Nominative
süpürgenin	Genitive
çekirdeğe	Dative
kazayı	Accusative
alnımın	Genitive
girecekler	None
sporcular	Nominative
kategoriden	Ablative
yufkası	Nominative
otostobumuzda	Locative
öldürmediler	None
erkecellerden	Ablative
bombalardan	Ablative
inlerde	Locative
temsilcilik	Nominative
futbolculardır	None
anlatıyorlar	None
protestomda	Locative
değirmenlerde	Locative
cücelerinizde	Locative
açlığın	Genitive
kayboldum	None
ojelerimizi	Accusative
kalbimde	Locative
makarnalarım	Nominative
yörüngenize	Dative
grubunuz	Nominative
bekletti	None
uda	Dative
balinalardır	None
yarasını	Accusative
oltan	Nominative
kabuklarda	Locative
kakar	None
önyargılardan	Ablative
koymuyorum	None
farelerden	Ablative
bacakta	Locative
termometremizi	Accusative
şüpheleriniz	Nominative
kediden	Ablative
tasarruflarınızın	Genitive
çekirdeklerde	Locative
sürücüsünü	Accusative
savaşçılardır	None
yaprağa	Dative
büyüleyicisiniz	None
vampirden	Ablative
kemanlar	Nominative
oylarınızı	Accusative
meşaleler	Nominative
arayüzlerden	Ablative
doktrin	Nominative
yolculuğunuzda	Locative
trende	Locative
yenilirler	None
koymam	None
sevmiyor	None
sıkar	None
boyacılar	Nominative
üreticilerim	Nominative
kasımda	Locative
dilerim	None
yapmaz	None
politikadan	Ablative
derisine	Dative
öldürdüler	None
ölü	Nominative
kattılar	None
sunulur	None
rehinemi	Accusative
anlattılar	None
göğsüm	Nominative
gübresi	Nominative
şaşırttıracaksınız	None
balıklarda	Locative
fiziği	Accusative
batmadı	None
pisletmez	None
gününüzü	Accusative
başvuruyu	Accusative
alana	Dative
olacaksın	None
avokadolar	Nominative
çirkin	None
temsilciliklerde	Locative
guakamole	Nominative
ittirildi	None
kategoride	Locative
akreplerdir	None
abece	Nominative
kozduk	None
katılaşır	None
verdi	None
teknolojilerin	Genitive
gözyaşlarını	Accusative
ortaklığımızdan	Ablative
gösteriler	Nominative
konserlere	Dative
gölgesinden	Ablative
enişte	Nominative
vekildiler	None
siliyor	None
keselerimizde	Locative
yaprağımızı	Accusative
yavrulardan	Ablative
gökdeleni	Accusative
öğretmene	Dative
birleşirler	None
bankayı	Accusative
giyiyordu	None
ek	Nominative
demler	None
geçmemizde	Locative
varmıyor	None
tavana	Dative
Mogadişulularınızın	Genitive
kesecek	None
ropdöşambırlarımızı	Accusative
satrançlarınızdan	Ablative
bakımsız	None
oğlancıydık	None
ofis	Nominative
bahçesini	Accusative
lokantalar	Nominative
mükemmellikte	Locative
pehlivana	Dative
teklifinizi	Accusative
ömürden	Ablative
kurulum	Nominative
sabandan	Ablative
solumadın	None
karıştırıyordu	None
kaçağımın	Genitive
çavuştuk	None
tekil	Nominative
rakımdan	Ablative
müzikaller	Nominative
yazıtta	Locative
vermeyeceğim	None
kullanılmıyor	None
radyoda	Locative
asana	Dative
sildiniz	None
ulusta	Locative
telaffuzdan	Ablative
duyacak	None
paylaştılar	None
arayüzlerin	Genitive
kovada	Locative
kromozoma	Dative
lehçesini	Accusative
istiyorlar	None
bilgimi	Accusative
mandalmışız	None
iletirler	None
kebabımı	Accusative
daldırdınız	None
yelkene	Dative
çarmıhtan	Ablative
ilklendirmemize	Dative
ağıtlar	Nominative
klavyemiz	Nominative
boşalma	Nominative
liselere	Dative
kıskanırım	None
bacaya	Dative
kaçaklara	Dative
kıble	Nominative
durdular	None
yalanlarımız	Nominative
işlevlerde	Locative
göçmez	None
solunumda	Locative
azınlıkta	Locative
kirin	Genitive
hanımdan	Ablative
idealden	Ablative
ürünümüz	Nominative
kullanmayı	Accusative
omuzlarda	Locative
tornavidasına	Dative
çığırtkanlığımızda	Locative
asıl	Nominative
yazılarda	Locative
hareketlilik	Nominative
çizgisinde	Locative
haritasından	Ablative
ceylanlarsınız	None
arzın	Genitive
bakmıyor	None
gösteririz	None
geçerler	None
dönmüyor	None
dışkısında	Locative
şuruplar	Nominative
eşyasına	Dative
kararlara	Dative
ketçaplara	Dative
şampiyonlara	Dative
yollarım	Nominative
gruplarımızda	Locative
korkuyorlar	None
homurtularımızdan	Ablative
boşalmasına	Dative
üreme	Dative
yorar	None
oğullarınız	Nominative
yumdu	None
nişanlısı	Nominative
mumluklarımız	Nominative
bilmez	None
sendromlarımızı	Accusative
kesyapınızdan	Ablative
bakmam	Nominative
efemizde	Locative
elçilere	Dative
mühendise	Dative
mevsimden	Ablative
uzaylıyı	Accusative
çalgılardır	None
özneyi	Accusative
yetinin	Genitive
musonda	Locative
küme	Nominative
telefondan	Ablative
uyarımın	Genitive
hareketsizlik	Nominative
gelinim	Nominative
soydu	None
zigguratlarımızı	Accusative
kullanılmazlar	None
romandı	None
mermiye	Dative
selamı	Accusative
kenardan	Ablative
topluyorlar	None
düğmelerin	Genitive
tanımazsın	None
tepkimesinden	Ablative
maskesi	Nominative
yöreler	Nominative
jaguarın	Genitive
parçası	Nominative
bilginiz	Nominative
alkışımıza	Dative
yayımcılıklarımızın	Genitive
yaptım	None
yapmıyor	None
arzuhalcilerde	Locative
açmayacağım	None
üremi	Accusative
okuyordu	None
tabak	Nominative
göstermem	None
kervansaraylar	Nominative
öğretilere	Dative
kesiyordun	None
öğretmenden	Ablative
bileklerimiz	Nominative
kitaplık	Nominative
ambulansa	Dative
coşarız	None
tükenmez	None
merkezden	Ablative
kara	Dative
ısıya	Dative
üzülüyorum	None
akı	Nominative
bademler	Nominative
cephelerinizi	Accusative
özneler	Nominative
satıldın	None
psikologları	Accusative
oltaydık	None
giriyorlardı	None
salammışız	None
açmayacak	None
kalıp	Nominative
tuvaletin	Genitive
avokadolarınızda	Locative
civarları	Accusative
abadisini	Accusative
deneyimlere	Dative
bitkiye	Dative
müge	Nominative
çevirdiniz	None
izliyoruz	None
hıza	Dative
sinersin	None
büyüklüklerin	Genitive
şarkıcı	Nominative
bildirir	None
dindardı	None
isimsiz	None
döver	None
tayfaymışım	None
ünlünün	Genitive
örneğiniz	Nominative
embriyo	Nominative
rüyalara	Dative
teknolojiye	Dative
merkeze	Dative
hacımızdan	Ablative
kapaklarımız	Nominative
ülkelerde	Locative
rüyasını	Accusative
tutkun	Nominative
ortaya	Dative
sancaklardan	Ablative
sihirbazlar	Nominative
fotoğrafçı	Nominative
dükünüzün	Genitive
derleyici	Nominative
yolcular	Nominative
sıvılar	Nominative
sanmıyorum	None
eziyetçimizde	Locative
ülkesine	Dative
türün	Nominative
reçelden	Ablative
anlara	Dative
ortamlardan	Ablative
atom	Nominative
kodlar	Nominative
dağımızı	Accusative
meyhanesine	Dative
göçlerdir	None
şelaleleriniz	Nominative
eğrilere	Dative
kerevizlerimizi	Accusative
enstrümana	Dative
üremeyiz	None
yabancılardın	None
perisinin	Genitive
dedikoducumdan	Ablative
canlanıyor	None
kolyelerimizi	Accusative
kulakçık	Nominative
fırtınaya	Dative
çağırdı	None
tanımam	None
geçecekler	None
yağmasında	Locative
yerlermişim	None
atılıyor	None
sınırlarda	Locative
bakma	Nominative
fizikçi	Nominative
sonumuz	Nominative
modelsin	None
korktum	None
ayarlatmayacağım	None
benziyorlardı	None
dedeyi	Accusative
samurayın	Genitive
kumandaya	Dative
dudağımızı	Accusative
koyuyordunuz	None
şeyim	Nominative
dişli	Nominative
dalgasına	Dative
kitaplıkta	Locative
düşündüler	None
şikâyete	Dative
piskoposlar	Nominative
tütüyordum	None
amcasını	Accusative
sayfalarınız	Nominative
derecesinde	Locative
unda	Locative
kameradan	Ablative
kırılırlar	None
öküzlere	Dative
oyumda	Locative
gelinliğin	Genitive
özlemimizden	Ablative
veride	Locative
katılmadı	None
bilgilerimi	Accusative
büktürtmüyorduk	None
çizerim	None
boşanıyoruz	None
fahişelik	Nominative
bataryalarda	Locative
sultanmışsınız	None
Tiranlılarımdan	Ablative
sıralamada	Locative
akvaryumda	Locative
kuruşları	Accusative
hacılardan	Ablative
başvurunda	Locative
tekrarlarımıza	Dative
efesi	Nominative
şarkıcısına	Dative
verisine	Dative
dövüşçülerimden	Ablative
pozisyona	Dative
mezralara	Dative
paşalar	Nominative
vahayı	Accusative
strüktürümüz	Nominative
yayacaksın	None
ülkemin	Genitive
gelmemiz	Nominative
yazarsın	None
akciğerde	Locative
iblis	Nominative
öldüreceksin	None
flaş	Nominative
homonim	Nominative
savaştılar	None
öğretiye	Dative
kılık	Nominative
dolarlar	None
silmem	None
asmaz	None
akciğerlerde	Locative
mucizesine	Dative
göçlerimi	Accusative
yendirtmeyecekler	None
noktada	Locative
parmağa	Dative
ambulanslar	Nominative
roketleri	Accusative
yapıyorum	None
koyuyoruz	None
başkentten	Ablative
sürüyorlar	None
elçiye	Dative
şokta	Locative
ayırıyorum	None
psikiyatrı	Accusative
çizer	None
ortalarda	Locative
garajlarıma	Dative
cenazelere	Dative
davranışlarınız	Nominative
radyo	Nominative
yörüngeden	Ablative
sonbahara	Dative
krizden	Ablative
tabiyetlerim	Nominative
düşünmüyor	None
çorbasının	Genitive
yazıtlardan	Ablative
tecrit	Nominative
yıldırıma	Dative
karaciğerde	Locative
topa	Dative
sağlarım	Nominative
mimlerinizde	Locative
izlemedik	None
kesersiniz	None
takmayacaksın	None
verilmez	None
isinizi	Accusative
yeşimlerden	Ablative
tercümeden	Ablative
ilimlerde	Locative
tütüncüler	Nominative
topu	Accusative
ejderhanızın	Genitive
tepkimesini	Accusative
mendilin	Genitive
itildiler	None
startım	Nominative
bisikletinizi	Accusative
yeterlik	Nominative
ettiriyordu	None
bağırsak	Nominative
bilgilerimizin	Genitive
beceriksizler	None
katkılardan	Ablative
hükûmetten	Ablative
değişti	None
çavuşlar	Nominative
vitrinimizin	Genitive
mümessilleriniz	Nominative
puanımızda	Locative
sülüğü	Accusative
dalgıçlar	Nominative
butonlara	Dative
dergisine	Dative
göllerde	Locative
vardınız	None
bilemedi	None
mesafeler	Nominative
kaçmıyor	None
unlardan	Ablative
sınıflarımız	Nominative
yorumunuza	Dative
beldesinde	Locative
yazmadı	None
kuman	Nominative
kutlamalara	Dative
parlatmayız	None
darılıyoruz	None
çubuk	Nominative
duvarlardan	Ablative
oyuncuyu	Accusative
şairlerden	Ablative
çalacak	None
klişelerimi	Accusative
savunmuyorum	None
giysi	Nominative
güz	Nominative
sayıyorlardı	None
günümüzde	Locative
alırlar	None
canlandırdılar	None
kaynaştırtmıyordum	None
olacaksınız	None
ağlaşıyoruz	None
psikiyatristin	Genitive
bitmesine	Dative
ısırdı	None
ilişkiden	Ablative
cihaza	Dative
kamçılarımın	Genitive
ayinler	Nominative
gol	Nominative
kuvvetlerdi	None
anjiyolarım	Nominative
yalanlar	Nominative
izliyor	None
katkılarda	Locative
dadılar	Nominative
nihayet	Nominative
teoremde	Locative
mandalinalar	Nominative
akşamınız	Nominative
fırtınada	Locative
uzayımı	Accusative
müzelerin	Genitive
geçersin	None
içtiler	None
alışırım	None
iskeleti	Accusative
takı	Nominative
eşantiyonlar	Nominative
şuurum	Nominative
cephesinde	Locative
satılırlar	None
rehberleriniz	Nominative
ölçeriz	None
tabaklara	Dative
keçilerimize	Dative
bozar	None
cihan	Nominative
ağlarsın	None
kıyafetler	Nominative
istemiyoruz	None
yarımadamda	Locative
uygulamasından	Ablative
dokurlar	None
ikaz	Nominative
bilemez	None
satılıyor	None
vaktiniz	Nominative
amacımıza	Dative
elçisinin	Genitive
ilköğretime	Dative
fakülteden	Ablative
kapaklarsınız	None
aldın	None
çarşılarınız	Nominative
raporda	Locative
lunaparkta	Locative
akışkandan	Ablative
şaşılacak	None
unutmuyor	None
kalelerde	Locative
baslarda	Locative
dizeceğiz	None
giyecekler	None
oğul	Nominative
sümüğünüzden	Ablative
temsilcilerden	Ablative
yalıtımlarınızın	Genitive
aşçılar	Nominative
çalışmalarımda	Locative
ısısına	Dative
süpürdü	None
şampanyandan	Ablative
çıkarıyor	None
olacağım	None
veterinerimize	Dative
çarşıdan	Ablative
içiyoruz	None
işlemedin	None
fetişimizde	Locative
mühendislikleri	Accusative
Müslümanların	Genitive
muhalefetten	Ablative
kravatlarımda	Locative
yetişir	None
alanınızda	Locative
tutulmadan	Ablative
kılacak	None
duyar	None
sistemlerimizden	Ablative
karılarımız	Nominative
gecelerim	Nominative
dergiden	Ablative
kılarlar	None
giyiyorlar	None
kullanıcısın	None
öğreniyorlardı	None
ayıracaksınız	None
güvendi	None
duayı	Accusative
kullandılar	None
kardeştiler	None
öğrencilerimiz	Nominative
değişmem	None
gemiler	Nominative
büyükelçi	Nominative
coşkusunu	Accusative
akında	Locative
topların	Genitive
deposunda	Locative
cümlelere	Dative
kesmezler	None
izlencesi	Nominative
salona	Dative
hastalıklardan	Ablative
sağar	None
müşteriydiler	None
fakirlere	Dative
salahiyetimizde	Locative
vermezler	None
öne	Dative
defterlere	Dative
inim	Nominative
mezarlıklara	Dative
değiştirdin	None
yalan	Nominative
umutsuzlar	None
paylaşacağım	None
yetkilerimi	Accusative
marulumuz	Nominative
medreselerden	Ablative
falcısı	Nominative
kahramanımızın	Genitive
simidimizin	Genitive
izledik	None
siyasetçinin	Genitive
kimliklere	Dative
buluyorum	None
bilmedik	None
börekler	Nominative
dizede	Locative
kullanılmaz	None
hidratları	Accusative
mevsimler	Nominative
bakirelikler	Nominative
haberleşmedik	None
katıldım	None
çamurlar	Nominative
önerisinde	Locative
ölüyü	Accusative
kefallara	Dative
tutuyorlardı	None
dişçinin	Genitive
nohutlar	Nominative
istemcilerde	Locative
ilkelere	Dative
zombilere	Dative
bileğe	Dative
tanımazlar	None
soğurmuyordunuz	None
gözyaşlarının	Genitive
üyenden	Ablative
başarıyor	None
modasına	Dative
filozofumuzdan	Ablative
patronlarınızı	Accusative
asansöre	Dative
tan	Nominative
manalar	Nominative
ateşlere	Dative
arzusunun	Genitive
hurilerde	Locative
kaçırır	None
vikipedistten	Ablative
jokey	Nominative
bulunduk	None
doymadım	None
örer	None
oyumuzu	Accusative
tanesini	Accusative
fakülteyi	Accusative
sığmıyorsun	None
civarı	Accusative
belediyesinde	Locative
değerli	None
rüzgardan	Ablative
kodların	Genitive
fındığa	Dative
izliyorduk	None
votkalarınıza	Dative
yetkisinden	Ablative
kalbimizde	Locative
papyonlarımız	Nominative
sonuçtan	Ablative
aygıttan	Ablative
doktor	Nominative
kestiler	None
ananasımın	Genitive
mistiklere	Dative
diskoteğe	Dative
abacılarımın	Genitive
sıcaklıklara	Dative
mıhlara	Dative
tükürüyoruz	None
alışacağım	None
bastırmasını	Accusative
şairden	Ablative
gelmeyi	Accusative
şahıslara	Dative
bölgede	Locative
terziye	Dative
mıknatısa	Dative
önerime	Dative
sarhoşlar	Nominative
kulüplerde	Locative
çalışmadı	None
korunmasında	Locative
tutuyorum	None
eğlence	Nominative
göreceksiniz	None
tanımıyor	None
değirmeninizin	Genitive
görmeyiz	None
dedeler	Nominative
topolojiler	Nominative
bohçayı	Accusative
karantinanıza	Dative
bütünlerinizden	Ablative
elemente	Dative
uyarısı	Nominative
kalmazsınız	None
adalesinde	Locative
omuzdan	Ablative
gizemlerimizde	Locative
sosyoloğu	Accusative
tabutta	Locative
yürekleri	Accusative
develeri	Accusative
şiveyi	Accusative
çatlağın	Genitive
cadı	Nominative
kapatmam	None
zamanım	Nominative
kolejlerde	Locative
gitar	Nominative
iffetlerimin	Genitive
cadılar	Nominative
dizim	Nominative
süründürtürüm	None
finişe	Dative
derinden	Ablative
mumluğumuzda	Locative
sümük	Nominative
lehçesinden	Ablative
fikrimi	Accusative
memleketimizden	Ablative
yönelmeye	Dative
daldırtıyor	None
televizyonda	Locative
aldırmıyor	None
bütünden	Ablative
uyanır	None
kuralım	Nominative
tabanlarımın	Genitive
cumhurda	Locative
votkasın	None
akbabadan	Ablative
yapıyorlar	None
çakıllardan	Ablative
yongada	Locative
hikayelerin	Genitive
sünmezsiniz	None
ortasından	Ablative
dişlerimizin	Genitive
arayüzlere	Dative
kuruşların	Genitive
akışlara	Dative
tutacağız	None
ziyaretçi	Nominative
sorumsuzluk	Nominative
kuşlara	Dative
ödevde	Locative
duyularımız	Nominative
işgücüne	Dative
şapkada	Locative
kurtarıyor	None
çalıyorlardı	None
sargılarınıza	Dative
sebepte	Locative
seçmiyoruz	None
örneğimiz	Nominative
nargilelerinizde	Locative
vurgunu	Accusative
mesafenin	Genitive
yarışta	Locative
tutkularınızı	Accusative
nişanlıya	Dative
seçtiler	None
döverler	None
korselerinizi	Accusative
anjiyonu	Accusative
standım	Nominative
çıkacaksınız	None
çalgıcısı	Nominative
dirsekten	Ablative
avukata	Dative
menüsünün	Genitive
öğretilerden	Ablative
tahdit	Nominative
açmadım	None
cihazlar	Nominative
ofise	Dative
kurur	None
gülüşlerimizi	Accusative
büyürler	None
dışkısının	Genitive
örtün	Nominative
kuvvetsiniz	None
aileleri	Accusative
hapsimizin	Genitive
söyleşilere	Dative
yetmeyecek	None
katil	Nominative
kâsesi	Nominative
önden	Ablative
hemşireyi	Accusative
sevgilim	Nominative
kararımın	Genitive
batıyor	None
harita	Nominative
uzanıyordu	None
övgüsüne	Dative
ülkemizi	Accusative
mime	Dative
sayfalarmışsın	None
zammımın	Genitive
ispatlar	None
aktörlerime	Dative
âşıklar	Nominative
durmadılar	None
prostatımdan	Ablative
bildirmedi	None
buzuki	Nominative
karakterimizin	Genitive
iğnelerden	Ablative
intikamdan	Ablative
kaşıdı	None
heteroseksüellerimizin	Genitive
paralelkenarlar	Nominative
dansçıların	Genitive
enginar	Nominative
basıyor	None
ibneliğimize	Dative
gelmedik	None
astronotlardan	Ablative
savunuyor	None
rakamımı	Accusative
verin	Nominative
yakınımda	Locative
imamdan	Ablative
huzurlu	None
bulmaz	None
karakolda	Locative
girdiniz	None
kolajlar	Nominative
veriyorlar	None
basketbolcunuzda	Locative
kanmaz	None
dildo	Nominative
zeytinlerden	Ablative
gizlemedik	None
kalacağım	None
köpeği	Accusative
ulusumuzun	Genitive
kızlık	Nominative
tipografilerden	Ablative
şampiyon	Nominative
omuz	Nominative
göçtüler	None
müzikallerde	Locative
akçaağaçlar	Nominative
arıstağa	Dative
çekirgeler	Nominative
sekreterin	Genitive
değiştiriyordu	None
müşterisini	Accusative
sanırlar	None
bulunmadılar	None
saklandılar	None
değişkende	Locative
tohumlardan	Ablative
tavuklar	Nominative
bekleyeceğim	None
gazetesini	Accusative
mermilerdir	None
gelinliklerde	Locative
iletiyoruz	None
sahnesinden	Ablative
rakamdan	Ablative
sevdalinkan	Nominative
çarpımı	Accusative
marangozlar	Nominative
aydınlıkta	Locative
birleştirdi	None
cepheye	Dative
payda	Locative
teşhiste	Locative
içtim	None
koymuyoruz	None
ütü	Nominative
sondan	Ablative
güvenliliklerimizde	Locative
çalışıyorsun	None
yedeklerde	Locative
ömrüme	Dative
doğar	None
köprülere	Dative
çekirdek	Nominative
bahçesi	Nominative
alemlere	Dative
sac	Nominative
kaldıraçlarda	Locative
kocalarım	Nominative
yumurtalıklara	Dative
çokgen	Nominative
itiyordu	None
kirpinizde	Locative
tabutunuzdan	Ablative
pelinlerim	Nominative
küllerimizde	Locative
imambayıldı	Nominative
baygnlığımızda	Locative
keşkek	Nominative
diyecekler	None
hatamız	Nominative
ummanmışız	None
saçmalıktan	Ablative
kovuldu	None
korkuyorlardı	None
bülbüle	Dative
hazineleri	Accusative
izliyorlar	None
çorbalara	Dative
mutluluklarınıza	Dative
geleceksiniz	None
mıhlarımızda	Locative
uyarısını	Accusative
istemeyecek	None
tavanıma	Dative
oynamadılar	None
sağduyusuna	Dative
volkanizmalarda	Locative
sekmesi	Nominative
havlusu	Nominative
bekliyoruz	None
ateş	Nominative
deposunu	Accusative
okyanusları	Accusative
kırılır	None
içgüdülere	Dative
sarılıyor	None
öbekler	Nominative
bilgiler	Nominative
mitokondriler	Nominative
artar	None
köpüğümün	Genitive
yaratıkların	Genitive
aletten	Ablative
hücresinde	Locative
programlatmadınız	None
dinlenmeden	Ablative
ayrıldık	None
zulme	Dative
aşiretimden	Ablative
biçimimiz	Nominative
bitimmişsiniz	None
eğlenirler	None
solucan	Nominative
yeti	Nominative
değişmezler	None
fahişeler	Nominative
kaşınızdan	Ablative
kilisede	Locative
örtüde	Locative
üyeydi	None
kravatlar	Nominative
aşirete	Dative
nedimesi	Nominative
haritasına	Dative
filmlerde	Locative
bulundu	None
palyaçolar	Nominative
papasında	Locative
unutuyorsunuz	None
şarka	Dative
zamanınızı	Accusative
fabrikada	Locative
pasta	Nominative
önemden	Ablative
yöresinden	Ablative
saklarlar	None
ağadan	Ablative
astronotlar	Nominative
dilimler	Nominative
olmayacağız	None
dururuz	None
ayinleri	Accusative
sözleşmesinin	Genitive
sunulacak	None
kalacaksınız	None
yabancıydı	None
kertenkele	Nominative
tükeniyor	None
kılıç	Nominative
yalana	Dative
geçmenizi	Accusative
karıştırıyorum	None
bileziğimden	Ablative
olurlar	None
ağaçların	Genitive
yardımseverliklerimizi	Accusative
demliyor	None
boğazlarda	Locative
seçmedi	None
tecrübelerime	Dative
karakterlerdi	None
kaldırımımızı	Accusative
kemerlere	Dative
şairlerin	Genitive
beldeyi	Accusative
bastın	None
Yahudisinin	Genitive
dövüşçüyü	Accusative
yetiştiriyordu	None
ekinizde	Locative
bülbüllerimde	Locative
hudutlar	Nominative
başvuruya	Dative
piknikler	Nominative
kervansarayda	Locative
kıldı	None
tacizin	Genitive
çilek	Nominative
perdelere	Dative
gerdin	None
daldılar	None
savunur	None
şok	Nominative
ziyaretlerden	Ablative
patatesimize	Dative
sagası	Nominative
çiğdemden	Ablative
âmâsında	Locative
garsonlardan	Ablative
Monakoluyuz	None
eksenlere	Dative
çimkemizden	Ablative
gelire	Dative
marangozdu	None
madalyaları	Accusative
örnek	Nominative
açar	None
uçuyor	None
bozdu	None
dolmuşunuzu	Accusative
seslendi	None
boşalmaya	Dative
kazanacaksınız	None
vermeyiz	None
sezonda	Locative
kullanıyoruz	None
alanlarda	Locative
karıncalardan	Ablative
eğlencede	Locative
papası	Nominative
platformumuzu	Accusative
çılgınlık	Nominative
vahalarım	Nominative
ağlarlar	None
kulaklara	Dative
dezenfektanlar	Nominative
yıktılar	None
vurdum	None
yağar	None
kameralara	Dative
sıfatlara	Dative
işlemcilerde	Locative
udunuzda	Locative
cümlesini	Accusative
alacak	None
getirdim	None
mektuplardan	Ablative
dinçliklerimi	Accusative
dernektik	None
sarhoşları	Accusative
ölümsüzlüğün	Genitive
noktanı	Accusative
yardımcılar	Nominative
düzineden	Ablative
şizofreniyi	Accusative
çadırlarımıza	Dative
elipsler	Nominative
gübreler	Nominative
dakikası	Nominative
bellekler	Nominative
deştiniz	None
mezralardan	Ablative
kalbimin	Genitive
evrenler	Nominative
kördüm	None
yarayacaklar	None
cisimlerden	Ablative
boğaz	Nominative
çaldı	None
çılgınlığa	Dative
vermiyordu	None
değiştiler	None
kahramanlara	Dative
doğuyor	None
vuruyordu	None
topluluktu	None
yeterlikte	Locative
hamburger	Nominative
hazcı	Nominative
köylülerimiz	Nominative
öğrencisine	Dative
örtüsünün	Genitive
telefonda	Locative
çöker	None
temsillere	Dative
dalgalandırıyorsun	None
kuzumuz	Nominative
kaçaklardan	Ablative
katıldınız	None
tensörüme	Dative
işlemcilerden	Ablative
kayıkların	Genitive
homurtularınızdan	Ablative
ömür	Nominative
bulursun	None
bilmeyiz	None
yapmadım	None
avukatlardan	Ablative
sanıyorlardı	None
çıkıyordu	None
yedeğe	Dative
fırtınasını	Accusative
hatası	Nominative
kayakdan	Ablative
dizesi	Nominative
lenslerden	Ablative
büyüklüğe	Dative
jaluzi	Nominative
veririm	None
kurabiye	Nominative
üründen	Ablative
kulakçığa	Dative
ayaklarımızdan	Ablative
katılmıyorum	None
cinlerden	Ablative
kastın	None
unutmayacağım	None
birleşmeye	Dative
yoğurtçular	Nominative
yoğurda	Dative
anlatacaksınız	None
yatağım	Nominative
kesene	Dative
mağaralarımıza	Dative
çizmecimden	Ablative
sürekliliklerde	Locative
şarkıcıydık	None
doğuyorum	None
bulundular	None
dağılmalarımdan	Ablative
bohçama	Dative
yaralanmaya	Dative
çalgıçlarımı	Accusative
endüstrilere	Dative
moleküllere	Dative
cümlesinden	Ablative
satılıyorlardı	None
bağlıyor	None
kurbağalama	Nominative
vermiyorlar	None
öldürecekler	None
masan	Nominative
şarkımın	Genitive
yaptınız	None
ağdacınızın	Genitive
çanlarımın	Genitive
soldu	None
iskenderlerden	Ablative
aktifler	None
patlamayı	Accusative
politikacıya	Dative
yermiş	None
düzine	Nominative
şiirlerde	Locative
yanlışlar	None
vekillere	Dative
peruğumuzu	Accusative
araca	Dative
mumyasının	Genitive
şikayetten	Ablative
türüne	Dative
roketi	Accusative
taşıyor	None
batıydım	None
yasasında	Locative
sesleniyorum	None
tarayacak	None
aktörlerden	Ablative
görüşlerde	Locative
konseylerde	Locative
geyler	Nominative
ayinlerde	Locative
cevabımın	Genitive
eziyetçilere	Dative
haritasında	Locative
gelecekler	None
gönlüm	Nominative
birada	Locative
gösterisinin	Genitive
yazıyordu	None
volkanizman	Nominative
lisede	Locative
eceyi	Accusative
ayırırız	None
şarkıcıyı	Accusative
akşam	Nominative
oyunculuğun	Genitive
elmaslar	Nominative
seçmesini	Accusative
yarasalarda	Locative
okullarda	Locative
dumanlardan	Ablative
tepiyor	None
yağışlardan	Ablative
öğrencisini	Accusative
çelikte	Locative
meşrubatlarınızda	Locative
alevlerimiz	Nominative
gözlemden	Ablative
götüreceğim	None
içeceklerde	Locative
paylaşıyordu	None
pencerenin	Genitive
canlandırmalar	Nominative
aynasızdık	None
edebiyattan	Ablative
belediyelere	Dative
travmanızı	Accusative
kartpostallarınızda	Locative
çetelerden	Ablative
cehennemden	Ablative
yakadan	Ablative
görüşünüzü	Accusative
yedigen	Nominative
dağılmaz	None
küstün	None
yağmurlar	Nominative
kadınlık	Nominative
hocasını	Accusative
mumyaya	Dative
oyuncakmışsın	None
böler	None
askerlerde	Locative
ayakkabılar	Nominative
mermiler	Nominative
yardımseverliklerimiz	Nominative
götürmedim	None
röportajlar	Nominative
pisletiyorduk	None
saydılar	None
giysiymişler	None
idareler	Nominative
şeydi	None
güzelliğin	Genitive
üreticisini	Accusative
geyiğimize	Dative
dinlenmesi	Nominative
kalbe	Dative
geçmişlere	Dative
ışınımı	Accusative
mala	Dative
dirilir	None
vampirlerden	Ablative
soğuyacak	None
aşmayacağım	None
sıktı	None
cadılığın	Genitive
makara	Nominative
der	None
şovlarda	Locative
gerekti	None
mitokondri	Nominative
astım	None
kunduzlarıma	Dative
travmandan	Ablative
bireyleri	Accusative
birleştiriyordu	None
okudun	None
odasını	Accusative
finiş	Nominative
alfabeler	Nominative
kedilerdir	None
avcıdan	Ablative
saldılar	None
yolculuktan	Ablative
fotoğrafımızda	Locative
çift	Nominative
karıştırırlar	None
barışta	Locative
tercümanlar	Nominative
sokaklarda	Locative
izleyicilermişim	None
enstrümanlara	Dative
maaşları	Accusative
sonbaharlarınızın	Genitive
soğururlar	None
kasetlere	Dative
lezzet	Nominative
eklemesizmiş	None
altdilimin	Genitive
yaklaşıyorum	None
tıkacaklar	None
oğluma	Dative
ilçeden	Ablative
sezdim	None
denizatı	Nominative
paskalya	Nominative
varacak	None
platformumdan	Ablative
tacizlere	Dative
örümceğe	Dative
koltuklara	Dative
sahifemizde	Locative
enflasyona	Dative
salamımızı	Accusative
seçmenlere	Dative
aygıtçıklarımdan	Ablative
ilişki	Nominative
dakikalardan	Ablative
ışından	Ablative
başkentlere	Dative
öküze	Dative
beldelere	Dative
başparmakta	Locative
sunuculara	Dative
yıldızlar	Nominative
yapıncaklarımdan	Ablative
sonraya	Dative
dövmelerimin	Genitive
yönelme	Nominative
tarakları	Accusative
sigaralardan	Ablative
bekletir	None
gökdelenlere	Dative
istediler	None
sosluğunuzun	Genitive
oyuncudan	Ablative
makinemizden	Ablative
askerimizin	Genitive
kıç	Nominative
dinersiniz	None
ummanımızın	Genitive
okullara	Dative
mektuplarda	Locative
tümörlerde	Locative
puding	Nominative
gelmiyorsunuz	None
numaralamasını	Accusative
böbreklere	Dative
topçular	Nominative
yazdılar	None
bitmeye	Dative
teoremlerden	Ablative
sevmiyorsun	None
beyit	Nominative
ağırdı	None
terziler	Nominative
bombacıları	Accusative
ettiriyorlardı	None
taksimi	Accusative
hesapta	Locative
boşanır	None
şeyimiz	Nominative
değişmiyor	None
onarmadım	None
kapağımda	Locative
kazıya	Dative
kıskanıyordu	None
başarıyordu	None
gelmeden	Ablative
ağalarınızı	Accusative
vaziyetler	Nominative
sahnesinin	Genitive
taksiler	Nominative
düşerler	None
vajinaya	Dative
sığar	None
polis	Nominative
koordinat	Nominative
tatlılardır	None
travma	Nominative
ürettim	None
etiketlere	Dative
büyülüler	None
şirkette	Locative
evlatlıkları	Accusative
belleğimizde	Locative
varırsınız	None
sansarlar	Nominative
mızrap	Nominative
bürokrasiyi	Accusative
tabelada	Locative
karmış	None
övdüler	None
gençliklerimizin	Genitive
pipetlerinizden	Ablative
kıyafet	Nominative
iskeletler	Nominative
bozunuma	Dative
kılıçtan	Ablative
hipotalamus	Nominative
eksenler	Nominative
derlemesi	Nominative
odadan	Ablative
objeler	Nominative
çapan	Nominative
piramitte	Locative
kaygının	Genitive
denizyıldızları	Nominative
yerimde	Locative
bankasından	Ablative
sapar	None
lehçelerde	Locative
torunmuşlar	None
dalgınlık	Nominative
konserler	Nominative
sülüs	Nominative
flaşlar	Nominative
meyhaneler	Nominative
yuvada	Locative
bilgide	Locative
rakama	Dative
cüceleriniz	Nominative
ölecekler	None
makarayı	Accusative
koydun	None
geçmeler	Nominative
muşmulalara	Dative
dalgasından	Ablative
kıskanıyorum	None
sanatçıdan	Ablative
asar	None
ısım	Nominative
şiirlerin	Genitive
bükülmeyi	Accusative
cezeriyenizi	Accusative
reçelleri	Accusative
kullanılırlar	None
oyunculukta	Locative
vardı	None
hemşireye	Dative
batısı	Nominative
gelmesi	Nominative
yaratmasını	Accusative
kazmadı	None
çöpü	Accusative
bozdum	None
kapaklar	Nominative
işletmelere	Dative
rüyada	Locative
soymadılar	None
makineler	Nominative
ölecek	None
sorusu	Nominative
kazı	Nominative
karakterler	Nominative
yaratılarmışım	None
lokmasının	Genitive
dağılır	None
günahlarınızdan	Ablative
siliyorum	None
enerjiden	Ablative
sattı	None
tuzlu	None
ablalarsın	None
teper	None
metrese	Dative
arzusundan	Ablative
sınar	None
dürüm	Nominative
düşünmüyorum	None
camiye	Dative
ekonomist	Nominative
alkol	Nominative
merdivenlerinizden	Ablative
kanallara	Dative
gönderdik	None
çattın	None
övüyordu	None
güneşlerin	Genitive
katıldılar	None
seviyorsunuz	None
sistemimizde	Locative
yediriyordun	None
derdi	None
aldırtmamazsınız	None
eklerdim	None
tutacağım	None
diriymişim	None
kıça	Dative
fenere	Dative
heykelcik	Nominative
çevirim	Nominative
duyuyor	None
yetersizliktiniz	None
sekmeler	Nominative
çalışmalarınızı	Accusative
kürküm	Nominative
gösterecekler	None
listeyi	Accusative
tabanlardık	None
başçığımızda	Locative
bin	Nominative
görüşlerimden	Ablative
tümce	Nominative
heyecanlandırdım	None
geliştiririz	None
erkeneklersiniz	None
çıkmadım	None
karıştırdım	None
ofiste	Locative
yoracak	None
sanırım	None
çağıracak	None
öğütücümüzde	Locative
kazanırlar	None
satıştan	Ablative
ağayı	Accusative
uydusunun	Genitive
övgüsü	Nominative
şoktan	Ablative
sayıyoruz	None
gece	Nominative
ölçülürler	None
cenazesinin	Genitive
şeftalisi	Nominative
ölüyor	None
takısı	Nominative
topluluklarda	Locative
içeriyorum	None
kurbağalar	Nominative
yuvadan	Ablative
lokman	Nominative
cemaatlerden	Ablative
sözlüğümden	Ablative
betik	Nominative
gelmezsin	None
müzelerden	Ablative
dirildi	None
öfkelendirecek	None
bulmuyoruz	None
tepkimelere	Dative
ombudsmanınızdan	Ablative
eğitimlere	Dative
minarede	Locative
kullanıcılarımız	Nominative
gruplarım	Nominative
hedeflerin	Genitive
bileğimizde	Locative
çevirimlerimi	Accusative
düşüyorlar	None
uyumuyordum	None
irkeyelimiz	Nominative
ehemmiyetimize	Dative
eksikliğimiz	Nominative
türeve	Dative
göttün	None
sinirlendirdi	None
işitir	None
özneye	Dative
kabuklarımdan	Ablative
geçinir	None
haçtan	Ablative
tecrübesine	Dative
tarar	None
denizanalarının	Genitive
yeniliklere	Dative
çoğul	Nominative
doğurmuyor	None
çiçekçilere	Dative
hindiye	Dative
tarihçiye	Dative
uyruk	Nominative
gayzerlerimizde	Locative
kalplere	Dative
öğrencide	Locative
sekmede	Locative
pusulaya	Dative
bulunuyor	None
coşkuya	Dative
protestosunu	Accusative
gelirlerde	Locative
sayfalarda	Locative
birliklere	Dative
ürür	None
yorumlarınıza	Dative
musonları	Accusative
kozumuzda	Locative
ektim	None
çapımda	Locative
kızmaz	None
diyorlardı	None
önceler	Nominative
manalarıma	Dative
bakıcısının	Genitive
sınavlarda	Locative
dışkısından	Ablative
paylaşıyorlardı	None
horluyor	None
evrimden	Ablative
içerecek	None
bıktım	None
eğittiler	None
öğretmenlerimiz	Nominative
banliyölerimizden	Ablative
kaşen	Nominative
buluşuruz	None
değişmedi	None
kılıçlar	Nominative
arkadaşlık	Nominative
kraliçeye	Dative
etek	Nominative
gözlemeye	Dative
sanıyorlar	None
saymadım	None
çökerirsin	None
sezon	Nominative
hislere	Dative
oyuncaklardan	Ablative
eğitir	None
sonuçlardan	Ablative
kurtardım	None
şarklarınızdan	Ablative
çekirdeklerden	Ablative
babasız	Nominative
okumuyorum	None
surenin	Genitive
buldum	None
ergenlikte	Locative
çıt	Nominative
yongasından	Ablative
ağamızın	Genitive
azınlığı	Accusative
kırar	None
kuzusundan	Ablative
Yahudiler	Nominative
ilkesini	Accusative
yapmıyoruz	None
bitimlerim	Nominative
vibratör	Nominative
psikiyatristte	Locative
çıkarırlar	None
sürülür	None
uyarıyı	Accusative
veriliyor	None
kazanırsınız	None
kalemin	Genitive
nöronlardan	Ablative
basımın	Genitive
yiter	None
mindere	Dative
maltı	Accusative
bezer	None
tiyatrodan	Ablative
kuram	Nominative
virgüle	Dative
şatoyu	Accusative
doktrinden	Ablative
bozmuyor	None
muşmula	Nominative
filozof	Nominative
almıyoruz	None
geliştirecek	None
vaktimi	Accusative
kraliçeden	Ablative
kullanmadım	None
kurbandan	Ablative
arkadaşlığa	Dative
yerleştik	None
etkiye	Dative
medreselere	Dative
fikirden	Ablative
çevre	Nominative
savaşıma	Dative
şahıslarımızı	Accusative
kolon	Nominative
gazelde	Locative
sitenizden	Ablative
boğalar	Nominative
marula	Dative
bilmiyor	None
şaşırtıyorlar	None
doğramıyorduk	None
kazanacaklar	None
bakıcılar	Nominative
içermiyor	None
gölgeden	Ablative
vuruyor	None
ulusumu	Accusative
ehemmiyetlerinizde	Locative
kaplanlar	Nominative
makarası	Nominative
ziyaretçinizi	Accusative
elementten	Ablative
nöronunuzda	Locative
boyuyordu	None
yazıların	Genitive
ışıklarımızdan	Ablative
çarpar	None
cenazesini	Accusative
çıktık	None
asitler	Nominative
daldırır	None
paradan	Ablative
siğillerinizde	Locative
sayfayız	None
vaktimizi	Accusative
orta	Nominative
futbolcusundan	Ablative
süsmeyeceksiniz	None
yazmayacağım	None
derecede	Locative
verniklememiz	Nominative
yardımcılardır	None
sargılarınızdan	Ablative
birliktelikler	Nominative
kalıplara	Dative
leşe	Dative
savaşlar	Nominative
evlenir	None
tecrübesinden	Ablative
satıldılar	None
teşhis	Nominative
çetede	Locative
hazırlıklarda	Locative
görüyoruz	None
bilirsin	None
keçi	Nominative
gülüşlerimden	Ablative
eldiven	Nominative
acıdı	None
duymadık	None
otlarda	Locative
kuramlar	Nominative
buluta	Dative
topluluklarımı	Accusative
patron	Nominative
futbolcusuna	Dative
sütyen	Nominative
boşandılar	None
minare	Nominative
tanışır	None
paylaşır	None
maskarada	Locative
uyardım	None
beklerler	None
verildiler	None
gelirim	Nominative
zurnası	Nominative
oyalar	None
kurumlar	Nominative
bekliyorum	None
parıltımızın	Genitive
canlandı	None
öç	Nominative
polislerde	Locative
şaşırdık	None
sürgünlere	Dative
kıyılar	Nominative
sakladım	None
yoldaşlarınız	Nominative
sanacaksınız	None
yazdı	None
bakmalarımızın	Genitive
örümceklerimiz	Nominative
angut	Nominative
serverler	Nominative
deneyler	Nominative
bireyler	Nominative
kuramı	Accusative
açılacak	None
sundum	None
batacağım	None
devirimizin	Genitive
koruganlara	Dative
lisanlarımdan	Ablative
düşüyoruz	None
etkilerler	None
becerikli	None
çalışmanızda	Locative
belirtme	Nominative
kaldırımda	Locative
bademden	Ablative
doktorlara	Dative
birleşiyoruz	None
istatistikte	Locative
etkiden	Ablative
albümde	Locative
seks	Nominative
işkencecisine	Dative
eben	Nominative
çetelermiş	None
romanlardır	None
dileriz	None
girerim	None
omletlerinize	Dative
kesernız	Nominative
savunuyorlar	None
getiriyorlar	None
etkilemezler	None
leylekler	Nominative
esenlikler	Nominative
sıradandılar	None
senkretizm	Nominative
kahvesine	Dative
gizlenir	None
soydular	None
yangında	Locative
dergisinde	Locative
yerleşecek	None
kerpiç	Nominative
pena	Nominative
anlatırız	None
masa	Nominative
bastırma	Nominative
kemana	Dative
değişmeyecekler	None
uçaklarda	Locative
umdular	None
kalesinde	Locative
kötüleşti	None
teorilerde	Locative
işkenceyi	Accusative
mihrabım	Nominative
egoizm	Nominative
teşhir	Nominative
kemençe	Nominative
düşmez	None
oynuyor	None
Tiranlılarım	Nominative
dağılmasında	Locative
katilimin	Genitive
katıyordu	None
aseton	Nominative
Tiranlılarınız	Nominative
uygulamama	Dative
izlemem	None
müzeler	Nominative
lepistesimizden	Ablative
yağmura	Dative
duruyordu	None
koyuyorum	None
fetvanın	Genitive
yürekler	Nominative
parçalar	Nominative
acımıyordu	None
minberden	Ablative
akrobatlar	Nominative
temsilcilere	Dative
sosyologları	Accusative
sahnelerden	Ablative
gişeler	Nominative
öykü	Nominative
huniden	Ablative
ritimlere	Dative
yasaya	Dative
çalışmanı	Accusative
hastalar	Nominative
dalgası	Nominative
uyduya	Dative
çipe	Dative
angudumdan	Ablative
rebetikolar	Nominative
çıkmayı	Accusative
masamın	Genitive
fıstıklar	Nominative
geçmişimiz	Nominative
evlilikten	Ablative
valiz	Nominative
eşyada	Locative
ürettiler	None
ayrılıyordu	None
yapıncak	Nominative
bastırmadan	Ablative
kapasitesine	Dative
bağırsaklara	Dative
şampiyonluğumuzun	Genitive
unutmadılar	None
iğnesi	Nominative
çamurda	Locative
beyitlerden	Ablative
sunacağım	None
galaksilerde	Locative
eziyetler	Nominative
paleoantropolojiye	Dative
süngü	Nominative
üreticisinin	Genitive
papatyaydınız	None
öğretecek	None
patlamalar	Nominative
erimesine	Dative
lezzetlerimize	Dative
kenarda	Locative
samuraylardan	Ablative
yer	Nominative
ankette	Locative
çöplerin	Genitive
çoğullarımızda	Locative
gölgesini	Accusative
bencil	None
dumanmış	None
küstü	None
kitapçıklardan	Ablative
yapılmadı	None
midyeler	Nominative
maymundan	Ablative
yazıta	Dative
vekillerimi	Accusative
balinayız	None
bohçalarınızın	Genitive
oligarşiler	Nominative
menüler	Nominative
kelliğimizin	Genitive
kutsallığı	Accusative
doğuracak	None
gazetelerde	Locative
ısısının	Genitive
Müslümanlara	Dative
kaynamadınız	None
vadesinin	Genitive
kuvvetlerimiz	Nominative
bilecekler	None
kışkırtır	None
vadelerimi	Accusative
nergisimize	Dative
verirler	None
görüşlerimiz	Nominative
basacak	None
sunucularımdan	Ablative
dükkânlara	Dative
temsilcisine	Dative
aktifim	None
alıyorlardı	None
simyacıları	Accusative
mevkilerde	Locative
şampiyona	Dative
pederimiz	Nominative
kadınlığın	Genitive
hapisten	Ablative
sürülüyordu	None
düşüneceğiz	None
manana	Dative
yasan	Nominative
lahmacun	Nominative
saçmalığın	Genitive
mezradan	Ablative
baylarımdan	Ablative
yamyamlara	Dative
fındık	Nominative
giysilerden	Ablative
şahısdan	Ablative
deniliyordu	None
kehribardan	Ablative
çıkarmıyor	None
hatalarımız	Nominative
giyiyor	None
durur	None
cımbızlarım	Nominative
kanunlarımız	Nominative
sonralara	Dative
alfabeyi	Accusative
prototipe	Dative
yazmaz	None
övgüde	Locative
almanaklar	Nominative
genelev	Nominative
ayçiçeği	Nominative
laçoda	Locative
yalancılarım	Nominative
uçacaksın	None
tahtlar	Nominative
zorlukta	Locative
akvaryuma	Dative
kedicikti	None
kolikalarınıza	Dative
getirdiniz	None
izleyicilerde	Locative
Nusayrî	Nominative
gülüş	Nominative
homoseksüelimin	Genitive
önbilgimde	Locative
optimizasyon	Nominative
zarflar	Nominative
söner	None
aşar	None
mesafelerin	Genitive
kirmen	Nominative
buluyorlar	None
istersin	None
ceylanlar	Nominative
bacak	Nominative
teorisinde	Locative
yemeniden	Ablative
içerim	None
topçusunu	Accusative
doktorlar	Nominative
görmez	None
çiftler	Nominative
masörleriniz	Nominative
dersimiz	Nominative
altıgenler	Nominative
katalogda	Locative
avantajları	Accusative
parlatıcılardım	None
dikdörtgenlerinizin	Genitive
musluğa	Dative
kitabesinden	Ablative
sıfatlarımıza	Dative
notiluslarım	Nominative
patlıyordu	None
kümede	Locative
istemcimi	Accusative
kemerde	Locative
arayüze	Dative
bitkilerde	Locative
severiz	None
uyuyordu	None
kardeşlerimizi	Accusative
kocayı	Accusative
tarafa	Dative
kıblesi	Nominative
eğleniyor	None
bağımsızlığı	Accusative
fırınlarınıza	Dative
uluslar	Nominative
nöronlarımı	Accusative
ritimler	Nominative
tornavidalarıma	Dative
böğürtlenlerden	Ablative
heyecanlanmıyorum	None
termometre	Nominative
çiçenden	Ablative
kasım	Nominative
serer	None
silersiniz	None
noktalarda	Locative
kapın	Nominative
gergedan	Nominative
sandın	None
yalamadık	None
sıfata	Dative
yaratmamız	Nominative
devirlerinize	Dative
hırsız	Nominative
hindi	Nominative
vaha	Nominative
erneklerdir	None
gözlemcileri	Accusative
seçmelere	Dative
duymamın	Genitive
basdılar	None
aştık	None
masallar	Nominative
papalarımı	Accusative
ettiriyor	None
katılırız	None
oburluk	Nominative
vasiyetin	Genitive
kazımı	Accusative
sıralamalar	Nominative
anjiyografisinden	Ablative
batıyı	Accusative
kutular	Nominative
gelişiyordunuz	None
memleketimin	Genitive
bitirecek	None
güzellikten	Ablative
simyacıyı	Accusative
kelebeklerimde	Locative
oyunuza	Dative
makyajınıza	Dative
okyanustan	Ablative
kraliçelik	Nominative
görüşümün	Genitive
canlanmaz	None
maskeyi	Accusative
sığmayacak	None
aramıyoruz	None
karsın	None
devingenliklerim	Nominative
röntgen	Nominative
vajinanın	Genitive
belediyeden	Ablative
ipe	Dative
embriyolar	Nominative
pompalardan	Ablative
düşersin	None
çoğulunuz	Nominative
yazılara	Dative
harfler	Nominative
yaparsınız	None
fonksiyonumuz	Nominative
nüfusa	Dative
bakar	None
kullanım	Nominative
kitapçığı	Accusative
sempozyum	Nominative
wikisi	Nominative
kanıtlayacak	None
bombasına	Dative
kuğu	Nominative
şemsiyeden	Ablative
yaptırmıyor	None
bitmelerimin	Genitive
baht	Nominative
kovar	None
kumandadan	Ablative
duymamız	Nominative
savunuyorum	None
hazırlığın	Genitive
sakalar	Nominative
savaşır	None
klavyelermişsin	None
sayfamı	Accusative
göl	Nominative
övgüler	Nominative
mermiden	Ablative
hızlara	Dative
çölden	Ablative
yarış	Nominative
damla	Nominative
kaçırıyorsunuz	None
yetiştiler	None
notiluslarımıza	Dative
işkencelerinizden	Ablative
filizler	Nominative
yönelime	Dative
sepetlerimizin	Genitive
paylaşırım	None
eziyetçilik	Nominative
yazmadık	None
değirmenden	Ablative
gözbebekleri	Nominative
eriyik	Nominative
paylaşımdan	Ablative
yalancılarınız	Nominative
şurupları	Accusative
başkentte	Locative
belirteçler	Nominative
çölde	Locative
kahramana	Dative
gerilere	Dative
dişlere	Dative
istemiyordu	None
laçolarımın	Genitive
ambulanslarda	Locative
zürafanın	Genitive
ünlerimi	Accusative
kullanıyorlar	None
bastırmayı	Accusative
kustu	None
tuluma	Dative
çekice	Dative
hadisi	Accusative
davranıyorsunuz	None
romanlarda	Locative
bulur	None
bitirirler	None
deyiminizi	Accusative
durumunuzda	Locative
savunacağım	None
savunurlar	None
koptu	None
oylarınıza	Dative
bloga	Dative
işlemesinde	Locative
seviyordum	None
makineyi	Accusative
ketçapta	Locative
onurlarımda	Locative
değişecek	None
donatım	Nominative
oğullar	Nominative
bulunmam	None
sevdiler	None
işlemciler	Nominative
heteroseksüel	Nominative
pastası	Nominative
biraya	Dative
kardeşliğe	Dative
çamı	Accusative
kervansarayların	Genitive
duruyorsunuz	None
tanımlık	Nominative
yayıncılıklar	Nominative
sandalyeler	Nominative
sandı	None
maşa	Nominative
parasızlık	Nominative
iribaşınıza	Dative
oynamadı	None
tip	Nominative
işçiyi	Accusative
sayfalarımın	Genitive
marangozlarınıza	Dative
giriyorum	None
çöktü	None
ekranlardan	Ablative
kapıdan	Ablative
örümcek	Nominative
ikazımın	Genitive
lehçede	Locative
dondurmam	Nominative
yalancılığınızdan	Ablative
lezbiyen	Nominative
modeldi	None
demezler	None
uçacak	None
açmam	None
basarlar	None
gülmedi	None
indirim	Nominative
üçüz	Nominative
bulmazlar	None
futbolcumuz	Nominative
makinasında	Locative
salçalık	Nominative
çökerticilerimizin	Genitive
kromozom	Nominative
mayo	Nominative
anketlere	Dative
cücen	Nominative
günümü	Accusative
parlatıcımda	Locative
öldürdün	None
biralardan	Ablative
kalpten	Ablative
kodlarda	Locative
aktrislerden	Ablative
isyana	Dative
gemin	Nominative
üzdü	None
birleşecek	None
depresyonlarda	Locative
taşıdım	None
süngerler	Nominative
söyleşimde	Locative
tütecek	None
cesedin	Genitive
aldırtmaıyorum	None
manalarda	Locative
mustatilleriniz	Nominative
sindirdi	None
saksafonlarımdan	Ablative
müzenin	Genitive
kesmeyeceksin	None
içgüdüler	Nominative
sonuçtu	None
ekmiş	None
iniyoruz	None
götürüyor	None
indim	None
kullanışlarınızın	Genitive
ağaçkakan	Nominative
benek	Nominative
dönersin	None
enflasyonu	Accusative
duruyorum	None
dışkı	Nominative
nükleotitte	Locative
kolondan	Ablative
dizdiler	None
ilerisini	Accusative
karttan	Ablative
dülger	Nominative
fikrimden	Ablative
merdivenler	Nominative
incir	Nominative
kovaları	Accusative
uçurtmayı	Accusative
lokmam	Nominative
sahiplerinizden	Ablative
yardımlara	Dative
öpücük	Nominative
seviyor	None
kıyametlerimizden	Ablative
yazmasını	Accusative
cümlelerde	Locative
saldırırlar	None
satışlardan	Ablative
moleküllerde	Locative
saldırdılar	None
isimsizler	None
pancardan	Ablative
karna	Dative
oynamıyor	None
nosyon	Nominative
yağlayıcılar	Nominative
sahifenize	Dative
şatosu	Nominative
böbrek	Nominative
acılardan	Ablative
maratonunuzda	Locative
galaksinin	Genitive
sıvılarda	Locative
kolaylıklardan	Ablative
kul	Nominative
gösteriyorsunuz	None
çarşıya	Dative
ayısının	Genitive
değişikliklere	Dative
borçtan	Ablative
çocukluk	Nominative
telesiyej	Nominative
kırolarda	Locative
bakacağız	None
öğreneceğim	None
eşcinseller	Nominative
yarası	Nominative
melodide	Locative
çarptı	None
söyleşiden	Ablative
köprüyü	Accusative
çifte	Dative
düşünmediler	None
yoldururum	None
canlandırtacağız	None
omurgalarımızda	Locative
acıttık	None
koleksiyon	Nominative
karıncalarımıza	Dative
önerileriniz	Nominative
depresyona	Dative
tatlımız	Nominative
mısralar	Nominative
durumuma	Dative
mevkini	Accusative
şelalesi	Nominative
genelevlere	Dative
irkeyelmişler	None
çorbalarda	Locative
gözyaşının	Genitive
antioksidan	Nominative
piknik	Nominative
portlar	Nominative
kardan	Ablative
kist	Nominative
paylaşacak	None
zulüm	Nominative
köpürtmeyiz	None
hatırlar	Nominative
seveceğim	None
ortamlarda	Locative
gösteriyorsun	None
cümlemin	Genitive
çokgeni	Accusative
görürler	None
okumam	None
kilise	Nominative
tıkladım	None
atışırlar	None
örnekleriniz	Nominative
vahan	Nominative
fotoğrafçınız	Nominative
finale	Dative
kazana	Dative
motorinimizden	Ablative
sevmem	None
akrabanız	Nominative
gösterilerde	Locative
çağırıyoruz	None
avokado	Nominative
fakire	Dative
abacıma	Dative
yersiniz	None
açacak	None
romanlardın	None
surelerin	Genitive
unuttum	None
kilimlerimiz	Nominative
tüylerde	Locative
arayüzden	Ablative
sitemde	Locative
yardımcılığınızı	Accusative
biterler	None
öğütür	None
vitrinde	Locative
karaduluma	Dative
ebede	Locative
anneliklerde	Locative
kapısının	Genitive
kurumumu	Accusative
işlemesi	Nominative
almıyorlar	None
tümcelere	Dative
kopmadı	None
lokumlarınızdan	Ablative
aşiretten	Ablative
kuşta	Locative
ilâçlar	Nominative
malta	Dative
acemi	Nominative
müzeden	Ablative
soğudum	None
ispatladı	None
hazinelerin	Genitive
dindarlıklarımıza	Dative
sunmuyorum	None
yazman	Nominative
üreticilerde	Locative
konferanslarımı	Accusative
şeylere	Dative
mühimliklerimizi	Accusative
bardaklar	Nominative
savaşçılarımız	Nominative
yağlıyordun	None
maskelere	Dative
akrabalarımızın	Genitive
parçacıklara	Dative
mancınıkta	Locative
diyeceksiniz	None
kıyıyı	Accusative
sayfamıza	Dative
ayrılmalara	Dative
yaratacak	None
ekimin	Genitive
soma	Dative
totemcimize	Dative
Kopenhaglılarımızda	Locative
içerirler	None
oynayacağım	None
külotlarınıza	Dative
emlaklarınızı	Accusative
prototipleri	Accusative
kıyafetlerdiniz	None
körlük	Nominative
ilköğretimde	Locative
askerlerden	Ablative
kuyusuna	Dative
iletkende	Locative
kulüplerden	Ablative
düşmanda	Locative
cezeryenden	Ablative
oyunculardı	None
olmayız	None
dövmen	Nominative
bozdular	None
pastırma	Nominative
kurama	Dative
maskeden	Ablative
puro	Nominative
çalgıçlarınızdan	Ablative
bürürsünüz	None
bağda	Locative
muğlalığa	Dative
ayrılmayacağız	None
yaratırlar	None
mekikten	Ablative
çöp	Nominative
öküzlerden	Ablative
bütünleşir	None
uzaklar	Nominative
eksikliğe	Dative
avokadolarda	Locative
fal	Nominative
aydınlığın	Genitive
dağılmasının	Genitive
işletmeden	Ablative
telesiyejlere	Dative
dizen	Nominative
durmazlar	None
şarkıcıydı	None
kurtaracak	None
beyitte	Locative
barbar	None
kaçırıyor	None
ortasına	Dative
frizbiler	Nominative
dışımızda	Locative
saydırdı	None
düşecek	None
kullanıcısından	Ablative
rahiplerdir	None
koşulur	None
güzellikler	Nominative
getireceksiniz	None
yıkıyor	None
cenneti	Accusative
bağdan	Ablative
katilden	Ablative
ışığa	Dative
omurgası	Nominative
istisna	Nominative
birleşmesine	Dative
kozlarımızdan	Ablative
görüşlerden	Ablative
sosistik	None
sinecek	None
yolculuklar	Nominative
salatayı	Accusative
süzgeçlerimi	Accusative
korunması	Nominative
örnekler	Nominative
ereceğiz	None
dalaklarımızdan	Ablative
kullanmanızı	Accusative
vermiyorum	None
ayaklara	Dative
öğretir	None
narkotiklerimizin	Genitive
katlardan	Ablative
bağlardı	None
edebiyatlar	Nominative
isterler	None
küçüklükte	Locative
şoklar	Nominative
yusufçuklar	Nominative
günahkârımı	Accusative
sandalyenin	Genitive
aldırtmamaz	None
eğlenceler	Nominative
kanıyor	None
sıyırdı	None
kahramandı	None
iletirim	None
mikroptan	Ablative
göçünüzün	Genitive
bağımlılığa	Dative
dersimden	Ablative
hemşiremiz	Nominative
titreşimlere	Dative
yarışmadan	Ablative
imamlardım	None
oturuyorsun	None
ayırırlar	None
özne	Nominative
masalda	Locative
tıkarlar	None
gündöndümüzde	Locative
glasnosttan	Ablative
cibiliyetinizde	Locative
alevlerimizin	Genitive
figüranlar	Nominative
şiveye	Dative
çeyrekte	Locative
çıkmıyorduk	None
teklifimi	Accusative
sunulmaz	None
saldırıyordu	None
sarılır	None
dondurmana	Dative
yakında	Locative
bayılmalarımızı	Accusative
süspansuvarınız	Nominative
jaguarların	Genitive
makinasından	Ablative
çözeltiden	Ablative
fakirleştirmedik	None
klavye	Nominative
damatlık	Nominative
omurga	Nominative
saklıyor	None
yumurtalıklarda	Locative
telaffuzunuz	Nominative
klitorislerimin	Genitive
erkekliklerimin	Genitive
takmaz	None
neşemizi	Accusative
sayar	None
bacağa	Dative
ejderhalar	Nominative
ayrımcılığa	Dative
kenar	Nominative
hatasının	Genitive
zigguratlara	Dative
elçi	Nominative
acayipmişsin	None
çeviriyoruz	None
müelliflerimde	Locative
futbolcuda	Locative
evlenmedi	None
albümümün	Genitive
cevapta	Locative
birleştireceğim	None
bölgeyi	Accusative
karıncalar	Nominative
tulumumuzda	Locative
vekillerinizden	Ablative
kümeye	Dative
yangınlarda	Locative
dükkânda	Locative
kasetler	Nominative
mağarada	Locative
şarkımızda	Locative
asansörde	Locative
tanrıydı	None
çevirir	None
eldivenler	Nominative
hikâyelere	Dative
başvurunuz	Nominative
kaydedicisini	Accusative
voleybolculara	Dative
eniştelere	Dative
baza	Dative
ilke	Nominative
kemerlerde	Locative
içerir	None
parlatıcımın	Genitive
eylemlere	Dative
kurbağayı	Accusative
ninnisinden	Ablative
kozana	Dative
sürümlere	Dative
bulunmaları	Accusative
tekfur	Nominative
ceviziniz	Nominative
zaferler	Nominative
savaşmıyordu	None
yanlışım	None
ısırmaz	None
konuklardan	Ablative
kelimelere	Dative
patlamalarda	Locative
bağlıyorlar	None
kolayı	Accusative
korkarım	None
piramitleri	Accusative
oyunculuk	Nominative
uykunun	Genitive
geziyor	None
katarlar	Nominative
işlemedim	None
nurdan	Ablative
amatöre	Dative
çeyreği	Accusative
dağdan	Ablative
kapamamızda	Locative
kırıldı	None
gecikirsiniz	None
çelikten	Ablative
pompanın	Genitive
taslaklarda	Locative
uzaylılara	Dative
sözleşmesine	Dative
vezirimde	Locative
cümlelerden	Ablative
şairlerde	Locative
oyunculuğu	Accusative
kalıyorsun	None
kapakçıkların	Genitive
gemilerde	Locative
vasiyette	Locative
sözleşmelerde	Locative
astı	None
çürüdü	None
kolonunuzdan	Ablative
helvayı	Accusative
telefonlar	Nominative
adsız	None
derlemesinde	Locative
dirseklerde	Locative
rüyalarsınız	None
küstüm	None
tercümelerde	Locative
gelişirler	None
alevler	Nominative
salıncak	Nominative
gelinir	None
mumuma	Dative
anlatıyorlardı	None
solmaz	None
susuzluğa	Dative
tekilamızın	Genitive
ikazlardı	None
maden	Nominative
mendilden	Ablative
tabiyet	Nominative
gereksinime	Dative
kopmadık	None
evrenimiz	Nominative
tutarız	None
dövmeye	Dative
yarağımın	Genitive
karides	Nominative
geyşandan	Ablative
erke	Nominative
boyun	Nominative
hocam	Nominative
yeriz	None
ayrılmayacak	None
cinsiyet	Nominative
gruplardan	Ablative
asacağım	None
karşıdan	Ablative
etkilemeyecekler	None
tasarımım	Nominative
soslar	Nominative
yolar	None
bitmelerimizi	Accusative
hatasına	Dative
bayılıyordunuz	None
iğnesinin	Genitive
uyuyorum	None
götürdüm	None
duyma	Nominative
çalışmalarımızın	Genitive
silgiydiniz	None
alçaklar	None
sinüste	Locative
çökertilere	Dative
ulamlarda	Locative
bahtsızdım	None
parçasının	Genitive
gerekmiyor	None
geçmişinizde	Locative
torunlardan	Ablative
elçiden	Ablative
davranıyorlardı	None
yazmana	Dative
tanelere	Dative
motorin	Nominative
saklanmıyordular	None
alımlı	None
düşmanlardır	None
yörekentlerimde	Locative
basketbolculardan	Ablative
saksıda	Locative
zamanlardan	Ablative
Duşanbelinizde	Locative
makine	Nominative
aynasız	Nominative
sümüklerinizden	Ablative
tabanlarda	Locative
dedikoduya	Dative
otosu	Nominative
tercihiniz	Nominative
kazımayacaksınız	None
çıbanlar	Nominative
karıncayız	None
psikologlardan	Ablative
bildiriyordu	None
tuş	Nominative
bıçakladı	None
dükkânlardan	Ablative
bakması	Nominative
kalabalığa	Dative
eğilmez	None
yapmayacağız	None
sınıflarda	Locative
yeterliliğe	Dative
kullanılacak	None
yöremiz	Nominative
muhalefet	Nominative
erkelerde	Locative
dalgasını	Accusative
dedikodulardan	Ablative
iletir	None
bükülmesi	Nominative
ezdik	None
yolculuklarınızı	Accusative
değiştim	None
dizeceksin	None
derleyicisi	Nominative
alanınız	Nominative
eğitimlerimizde	Locative
kaçarız	None
seyahatten	Ablative
taraflara	Dative
onarırım	None
balıkçılara	Dative
inandılar	None
tamlayan	Nominative
sözlüklerden	Ablative
azınlıklar	Nominative
eğrilerden	Ablative
kılıklarda	Locative
şaşıracaksınız	None
kuramlardan	Ablative
yanarlar	None
yordam	Nominative
yazmıyoruz	None
lensler	Nominative
teoride	Locative
şelalesinde	Locative
uçurtması	Nominative
şatosuna	Dative
arıyorsun	None
sapmaz	None
etekler	Nominative
sokak	Nominative
böreğimizden	Ablative
süzgeçler	Nominative
futbolcuyu	Accusative
ettirmez	None
görüşe	Dative
küçüldü	None
duvarlara	Dative
şifonyerden	Ablative
ettireceğiz	None
gübrelerinizi	Accusative
taradım	None
çıkma	Nominative
yontmuyoruz	None
planete	Dative
saat	Nominative
kahveye	Dative
donmadan	Ablative
bereketimiz	Nominative
tuştan	Ablative
ikilemden	Ablative
duruyorsun	None
krallığın	Genitive
cücelerde	Locative
videolarıma	Dative
merdiven	Nominative
şişliğe	Dative
ördekler	Nominative
model-view-presenterinize	Dative
kot	Nominative
bloglarda	Locative
çubukta	Locative
veriliyordu	None
yatağa	Dative
belirtmeye	Dative
silahlarınızı	Accusative
küllüklerimizde	Locative
kolejden	Ablative
sepetten	Ablative
vakte	Dative
kodu	Accusative
odunda	Locative
işletmesine	Dative
eteğimizden	Ablative
camilerde	Locative
banliyöler	Nominative
yutağımızın	Genitive
kandillerde	Locative
pezevenk	Nominative
tundrası	Nominative
anıyor	None
dayamıyoruz	None
acayip	None
kazanır	None
kulüpler	Nominative
koyum	Nominative
yitmeyeceğim	None
anıyordu	None
dublörünüzde	Locative
medreseler	Nominative
yaratacaksın	None
şimşeklerde	Locative
heykelciğe	Dative
şaşırtdılar	None
sanmam	None
hamsterlerde	Locative
şampiyonlukta	Locative
gözlüyorum	None
seçicisinden	Ablative
yemiş	Nominative
övgüden	Ablative
armağan	Nominative
teklifimizin	Genitive
asacağız	None
fizikten	Ablative
eklersiniz	None
dikişten	Ablative
taşıdı	None
ot	Nominative
pelikan	Nominative
duymuyorlar	None
saklamaz	None
yaratıktan	Ablative
kesmez	None
jaguar	Nominative
amacımız	Nominative
amaçta	Locative
öpüyorum	None
bitmiyor	None
hülyalarımızda	Locative
teşhirimde	Locative
makinelerinizde	Locative
hatalarımdan	Ablative
bölümüm	Nominative
paskalyada	Locative
topluluğumuzun	Genitive
dağıtıyordu	None
sevaplarınızda	Locative
diyorsunuz	None
geyim	Nominative
şemsiyeler	Nominative
şehirlerimizde	Locative
olumsuzlukları	Accusative
batın	Nominative
cevherleri	Accusative
çöpçatanlıklarımızdan	Ablative
bölecek	None
günlüğe	Dative
kılıklara	Dative
iyonosferin	Genitive
ölüsünün	Genitive
oligarşiye	Dative
sunuyorum	None
cami	Nominative
azınlığın	Genitive
mevzularda	Locative
düğünler	Nominative
ikileme	Dative
isler	Nominative
bellek	Nominative
heyetimiz	Nominative
sumağımızdan	Ablative
fotoğrafçıya	Dative
akın	Nominative
kitabelerde	Locative
yarımadasının	Genitive
taşaklarım	Nominative
okumadı	None
kozmonotlarımda	Locative
sansarımızda	Locative
kıyısını	Accusative
endüstride	Locative
kokusundan	Ablative
ettirtmeyeceksin	None
meyhanesi	Nominative
mahzen	Nominative
ekranda	Locative
dergisinden	Ablative
bütününüz	Nominative
gösterecek	None
ayırmam	None
öküzmüşsün	None
katkıya	Dative
saklanıyordu	None
oluyordum	None
domatese	Dative
damlaların	Genitive
prostatlarımızın	Genitive
gülerler	None
karartı	None
ışında	Locative
keseceğim	None
gecelerden	Ablative
kullanıcılardan	Ablative
seslendim	None
balıkçılardan	Ablative
dersiniz	Nominative
manasının	Genitive
dörtgene	Dative
psikoterapilerimi	Accusative
merdivende	Locative
iyileştirir	None
binerler	None
dizesini	Accusative
akşamlarda	Locative
pusulada	Locative
ağaya	Dative
temizliyor	None
almıyordu	None
bakarsın	None
gönderdiler	None
haritayı	Accusative
pamukta	Locative
akrabalarımız	Nominative
boyadı	None
çıkıyoruz	None
uçlardan	Ablative
öğretmenlerden	Ablative
tarımdan	Ablative
üyesinde	Locative
dağılmayı	Accusative
yardımlardan	Ablative
yarışmalarda	Locative
geliştiririm	None
sorular	Nominative
sigaradan	Ablative
mancınıklar	Nominative
ilerletir	None
kopacak	None
bitme	Nominative
şuurlarımıza	Dative
davranmaz	None
kıldım	None
embriyoya	Dative
nişanlılar	Nominative
durmuyor	None
kumaşlar	Nominative
mümessil	Nominative
çarşısının	Genitive
gözlemcilerin	Genitive
tesadüfleri	Accusative
sıfatlardan	Ablative
aşçısı	Nominative
garsonlar	Nominative
öğretti	None
meşalelerimizden	Ablative
çıkardılar	None
kavmim	Nominative
canlanılacaklar	None
krizlerde	Locative
buluşacağız	None
madalyanın	Genitive
rüyasında	Locative
girmeyecek	None
katılmazsınız	None
futbolcular	Nominative
fotoğrafçısı	Nominative
emniyete	Dative
bozayıda	Locative
hocasından	Ablative
hazırlıkları	Accusative
kanserde	Locative
köprülerden	Ablative
dinozorlarımın	Genitive
dinlenmesini	Accusative
kakıyorsunuz	None
alkollerin	Genitive
saksafon	Nominative
golümüzü	Accusative
ısıyı	Accusative
kuzusu	Nominative
yarımadası	Nominative
allık	Nominative
seçiliyordu	None
makyajımız	Nominative
şahıslar	Nominative
isyanlarınızın	Genitive
şehvetiniz	Nominative
şiir	Nominative
tiyatroma	Dative
olmadı	None
işittik	None
bekleyecek	None
aşacak	None
çıkmalar	Nominative
rahatsızlandı	None
güvenmiyoruz	None
kervansarayı	Accusative
parasızlıklarınızdan	Ablative
bileklerden	Ablative
yuvan	Nominative
bahçeden	Ablative
dişlerimi	Accusative
saymıyorum	None
iletkenden	Ablative
olaylardan	Ablative
sınırlarımız	Nominative
cümlelerimi	Accusative
dehşete	Dative
pırasanda	Locative
kâbusunuzun	Genitive
istemedim	None
süzme	Nominative
tuttu	None
kazmaz	None
beklemenin	Genitive
dualarda	Locative
dürümü	Accusative
şikayetler	Nominative
sorulardan	Ablative
bakmaz	None
gözlemciden	Ablative
yetiyordu	None
pedimiz	Nominative
devede	Locative
emlak	Nominative
ışınlardır	None
anketlerimiz	Nominative
olduk	None
asker	Nominative
dağıldık	None
atılmayacak	None
susuzluğun	Genitive
şafakta	Locative
uçağımızın	Genitive
doğuma	Dative
şahmerdanımı	Accusative
seviyorlardı	None
kilimler	Nominative
derecesinin	Genitive
sayımda	Locative
gerekmiyordu	None
diyorsun	None
akım	Nominative
kuyulara	Dative
lazerlerde	Locative
tepmem	None
kaplanlara	Dative
keseceğiz	None
mikroişlemcilerde	Locative
sıçanlar	Nominative
hindilerdim	None
yerlermişsiniz	None
kuramın	Genitive
minaresinin	Genitive
doktorlardı	None
neşe	Nominative
otomobilciliğinizin	Genitive
uçmuş	None
cümle	Nominative
geçmesi	Nominative
kullanırız	None
paralelkenarlarda	Locative
cesette	Locative
verim	Nominative
mezralar	Nominative
tanışıyordu	None
deliymişler	None
bozayılardım	None
hastaymış	None
şikâyetlerinizi	Accusative
pusmaz	None
kılmadı	None
onardınız	None
filinizden	Ablative
hipotalamustan	Ablative
karakterlerdir	None
gösterilerden	Ablative
krallıkların	Genitive
babasızdılar	None
ibneyim	None
yorumunuzu	Accusative
parlatır	None
sitemizde	Locative
tabancalardan	Ablative
tamlayandan	Ablative
tasarımlarda	Locative
dualardan	Ablative
aracınızın	Genitive
güven	Nominative
dönmeyeceğim	None
krizantem	Nominative
fitiller	Nominative
aznavurmuşsun	None
tümörden	Ablative
bayılmana	Dative
ayvaz	Nominative
etkilerden	Ablative
başvurulara	Dative
kılar	None
gökdelenler	Nominative
müzisyen	Nominative
camisi	Nominative
harçlığımdan	Ablative
bireyde	Locative
tacımıza	Dative
birleşmesi	Nominative
kovboylarda	Locative
vurmadım	None
lehçesi	Nominative
deneyimim	Nominative
küçüklüklerin	Genitive
daldı	None
büyükelçiye	Dative
direğimize	Dative
kavaklar	Nominative
kasta	Locative
çalgılarınızın	Genitive
küvetten	Ablative
biraların	Genitive
memeler	Nominative
ararlar	None
genelevlerinizden	Ablative
kırık	Nominative
evrene	Dative
rüyalarım	Nominative
kategorisinde	Locative
kahveden	Ablative
balıklara	Dative
geçmediler	None
tipografyamıza	Dative
çalışmaz	None
maşalar	Nominative
yumurtasına	Dative
çatlakların	Genitive
idaresinde	Locative
portakal	Nominative
direkten	Ablative
kutsallığın	Genitive
silerim	None
asteroitler	Nominative
kurumlardan	Ablative
çarparlar	None
silecek	None
füzelere	Dative
katılıyordum	None
kusma	Nominative
futbolcuymuşum	None
şapkacınızda	Locative
mikrofonda	Locative
bekliyordum	None
topoloji	Nominative
sorumluluktan	Ablative
kemerleri	Accusative
şeyde	Locative
bilgisini	Accusative
katılmam	None
idarelerde	Locative
hüzünlerimin	Genitive
kovuldular	None
maymunlardan	Ablative
okunaksızlıklar	Nominative
efelerinizde	Locative
hikayelerden	Ablative
körfeze	Dative
vahaymışsın	None
gerekecek	None
çağanozumuzdan	Ablative
bulunmadı	None
pencerelerin	Genitive
eşikte	Locative
soslara	Dative
oyuncuydu	None
öldürtüldü	None
arzulara	Dative
eksenlerimizden	Ablative
bel	Nominative
senkretizminizi	Accusative
eklerdir	None
kazanacak	None
bağlamaz	None
maskesinin	Genitive
ayakkabısının	Genitive
mutluluğuma	Dative
seçenek	Nominative
yakasında	Locative
bülbülünüzden	Ablative
ölçülmez	None
parıltıya	Dative
avukatlardır	None
giriyorsunuz	None
yağmurumda	Locative
cüceyi	Accusative
kahramandan	Ablative
İngilizceleştirmiyor	None
deynler	Nominative
alanımız	Nominative
şatoda	Locative
mayadan	Ablative
yalanlara	Dative
türünden	Ablative
pompalara	Dative
gizledim	None
kapatıyorum	None
götürmez	None
parlatıyordum	None
düşünmüyoruz	None
taşımayacak	None
makinesini	Accusative
sürücüsüne	Dative
kardeşime	Dative
temsillerim	Nominative
aynamızı	Accusative
vitrinimde	Locative
politikalarda	Locative
kıyamet	Nominative
yusufçuk	Nominative
yağlarda	Locative
hududumuzda	Locative
kapatmaz	None
ayaktan	Ablative
düzer	None
rakamlarım	Nominative
kaşe	Nominative
bacım	Nominative
pişirmedin	None
ortan	Nominative
izleyiciye	Dative
cinsiyeti	Accusative
doğurur	None
çarpı	Nominative
gözbebeğinin	Genitive
cevabımız	Nominative
cevaplardan	Ablative
anjiyografi	Nominative
gökadalarda	Locative
kıydılar	None
vilayet	Nominative
peruklarımızı	Accusative
sonlarımızın	Genitive
uydusunda	Locative
savundum	None
erecek	None
bamya	Nominative
korkuyoruz	None
dışkıdan	Ablative
kavram	Nominative
lazeri	Accusative
üçüzlerinize	Dative
uyanıyor	None
yöremize	Dative
oynamam	None
bildiririm	None
sığıyor	None
karşıda	Locative
cevherin	Genitive
yumuyor	None
sapıklık	Nominative
numaralamamızın	Genitive
dizelerde	Locative
duyuyorlardı	None
eziyordum	None
karısının	Genitive
karanfillerinizden	Ablative
tanen	Nominative
bağımsızlığa	Dative
gönderiyor	None
kutulara	Dative
yapıyor	None
bacayı	Accusative
tütsü	Nominative
yeniliyor	None
seçersiniz	None
strüktürde	Locative
bölgemiz	Nominative
yazarların	Genitive
beklemiyordum	None
blogumuzu	Accusative
gecikir	None
cenup	Nominative
kullanacak	None
dizilere	Dative
onguncusunuz	None
delikte	Locative
fundalarda	Locative
akrabasının	Genitive
yaparlar	None
pencerede	Locative
kristalde	Locative
peynirler	Nominative
planetler	Nominative
cinsellikte	Locative
yaklaştık	None
tercihten	Ablative
dedikodulara	Dative
beldesi	Nominative
senaryoya	Dative
belediyede	Locative
istemiyorsunuz	None
istiridye	Nominative
bekleyeceğiz	None
füzeler	Nominative
kullandınız	None
sincaplarıma	Dative
varmaz	None
devirlerdim	None
ölüyorum	None
karnesinde	Locative
pastalar	Nominative
yolcudan	Ablative
totemcinizi	Accusative
ziyaretçilere	Dative
bulamadı	None
konumuz	Nominative
silmiyor	None
teknoloji	Nominative
bükülmesini	Accusative
samuraylara	Dative
objelerdir	None
sümüklerimi	Accusative
çıpa	Nominative
olmadılar	None
koleksiyonlarda	Locative
finaller	Nominative
jokeyler	Nominative
bekleriz	None
sevgilimi	Accusative
dansçının	Genitive
misket	Nominative
izledi	None
görüşlerinizi	Accusative
bulacaklar	None
otobüs	Nominative
verilere	Dative
fareler	Nominative
oyuncusu	Nominative
sagalarda	Locative
telefonlara	Dative
girdabımı	Accusative
giyecek	None
paylaşım	Nominative
tanırsınız	None
titreşimler	Nominative
boşalmayı	Accusative
ayrılmaya	Dative
cevaplarda	Locative
sayfanda	Locative
kıblelerim	Nominative
ışıkta	Locative
teknolojiyi	Accusative
fabrikanın	Genitive
numaralamasına	Dative
hücrelerimizden	Ablative
ışınlarımızda	Locative
saçıyordu	None
tutuyorlar	None
kümeden	Ablative
mermilerde	Locative
inanmadı	None
atılmıyor	None
yangından	Ablative
üreticisiniz	None
odam	Nominative
aygıtçığımız	Nominative
paşa	Nominative
ayçiçekleri	Nominative
kelimelerde	Locative
fragmanımın	Genitive
yasağınız	Nominative
klarnetler	Nominative
bunar	None
psikoloğu	Accusative
bağım	Nominative
şaşırtacaklar	None
kokuyordu	None
sunucudan	Ablative
ölçüşecek	None
ışıklar	Nominative
silaha	Dative
uduma	Dative
derecesi	Nominative
mısırımda	Locative
otostoplarımız	Nominative
paşam	Nominative
bulunmuyorum	None
gazetede	Locative
korktuk	None
engizisyon	Nominative
duyarım	None
ekşirsiniz	None
paylaşmazlar	None
öpüşür	None
desen	Nominative
şakalar	Nominative
kondu	None
katılacaklar	None
kitabesine	Dative
primitif	None
ehemmiyetsizliğimiz	Nominative
cephesinden	Ablative
kurbanlardan	Ablative
uzayda	Locative
papağanımın	Genitive
bilekler	Nominative
silecekler	None
tuğla	Nominative
hamburgerinizin	Genitive
işlemcisine	Dative
aramıyorum	None
annelikler	Nominative
âlimdin	None
harçlığımızda	Locative
canlandırmada	Locative
lenslerin	Genitive
ortadan	Ablative
sihirli	None
kaygıdan	Ablative
gemisinin	Genitive
davranırlar	None
süzgeçten	Ablative
hatalardan	Ablative
grubum	Nominative
sekmesinin	Genitive
tanrım	Nominative
yaratmasından	Ablative
motele	Dative
cevize	Dative
fagotlara	Dative
örmezler	None
hastalara	Dative
bataryasını	Accusative
hemşire	Nominative
içeriyorlar	None
kopar	None
dürüme	Dative
listede	Locative
yüzeylerimizin	Genitive
enflasyonun	Genitive
hıçkırıklara	Dative
arayacak	None
örtüye	Dative
hızlıdı	None
sorumsuzluğunuzun	Genitive
rapordan	Ablative
türevde	Locative
kızarlar	None
buluyordu	None
müşterisine	Dative
buharlaşır	None
sayacaklar	None
devinime	Dative
giysilere	Dative
susmayacaklar	None
kuyusunun	Genitive
sayfalardır	None
filozoflarda	Locative
müzede	Locative
doğuruyordu	None
dükler	Nominative
sabanlarımın	Genitive
istisnalarız	None
gökadalara	Dative
denizanaları	Nominative
biliyor	None
cevhere	Dative
takın	Nominative
okuruz	None
erdiniz	None
listemden	Ablative
bileceksin	None
yazmamız	Nominative
güvercin	Nominative
yolundurursun	None
camisini	Accusative
çoğullar	Nominative
jeolojinin	Genitive
tohumlara	Dative
çiçelerinizi	Accusative
hatalarım	Nominative
kolonya	Nominative
mefhumlarınızda	Locative
entegrasyonu	Accusative
bulacağım	None
âlimlere	Dative
hanıma	Dative
öfkelendirir	None
doğuyoruz	None
aletlerdir	None
çiğdem	Nominative
bulutlardan	Ablative
canlandırmıyor	None
ilkeye	Dative
yapıda	Locative
videomuza	Dative
tecrübem	Nominative
algoloji	Nominative
altdillerinizden	Ablative
şairler	Nominative
heyecanlandırmıyordum	None
domates	Nominative
karıncalara	Dative
yönde	Locative
voleybol	Nominative
pehlivanlarımda	Locative
iftitah	Nominative
tanımıyoruz	None
haberlerinizden	Ablative
beklerim	None
onguncularımdan	Ablative
moronu	Accusative
coşkulu	None
balalaykalar	Nominative
duydu	None
teşkilattan	Ablative
eşiklere	Dative
yardımcılığınızdan	Ablative
hücreler	Nominative
çıkarıyorlardı	None
bükmemelerinizde	Locative
yazmıyorlar	None
uyruklarınıza	Dative
davranıyorlar	None
gözlükçümden	Ablative
bağımsızlığın	Genitive
itiyorlar	None
çiftlere	Dative
güneşler	Nominative
kapılardan	Ablative
şivene	Dative
etkilerin	Genitive
kılavuzdum	None
sürülerde	Locative
ortayı	Accusative
çözeltiyi	Accusative
bıktık	None
kanaldan	Ablative
fırınlarda	Locative
jenerasyonlar	Nominative
inanacak	None
güttü	None
hinterlantlarımızın	Genitive
kristallere	Dative
kataloglar	Nominative
pompalar	Nominative
ısırıkların	Genitive
verimsizleştirmezler	None
beklemeyi	Accusative
müsellesimizin	Genitive
doğruculuklarımın	Genitive
yazmalarınıza	Dative
çukurdan	Ablative
kervansarayları	Accusative
şampiyonluklara	Dative
uymuyordu	None
anlatacağız	None
amatörünüzü	Accusative
harfte	Locative
kuruldan	Ablative
inanıyordu	None
saçıma	Dative
akciğerlerimizden	Ablative
gayzerlerimizi	Accusative
bilgilerinizin	Genitive
hatadan	Ablative
ustasına	Dative
kolikanızdan	Ablative
kistlerimizin	Genitive
kurtaracağız	None
deniliyor	None
tutar	None
kapısından	Ablative
kullanacaksın	None
gayda	Nominative
zorluğa	Dative
düşünüyorsun	None
kenarlardan	Ablative
kromozomuma	Dative
dalgadan	Ablative
oto	Nominative
uzanır	None
bütün	Nominative
umar	None
makinesinin	Genitive
ananasımdan	Ablative
mendil	Nominative
kaldı	None
pancar	Nominative
şikâyetten	Ablative
ölçmüyor	None
yıldırımlara	Dative
vücutların	Genitive
bağımsızlıkları	Accusative
sınırda	Locative
kurallara	Dative
bölgeydi	None
yanıtlarda	Locative
tanıttı	None
işletmesinin	Genitive
dişlisi	Nominative
mikroişlemcisini	Accusative
tanjant	Nominative
masadan	Ablative
akrabasına	Dative
kocamın	Genitive
parçalardan	Ablative
şampiyonluğumuzda	Locative
gidiliyor	None
taşıyacak	None
vajinada	Locative
odaya	Dative
ekonomistlerden	Ablative
çeviriyorum	None
oturuyordum	None
düğme	Nominative
mühendislere	Dative
küvetlerimden	Ablative
öper	None
papağanlar	Nominative
dinsizliğimize	Dative
üzüyorsun	None
sistem	Nominative
plektrumlarım	Nominative
şekerparelerde	Locative
krakerlere	Dative
kasa	Dative
paylaşmıyor	None
köylümüze	Dative
silgi	Nominative
türünde	Locative
geçmesini	Accusative
kürüyorsun	None
uygulama	Nominative
cenazesi	Nominative
önerisinin	Genitive
avizenden	Ablative
şey	Nominative
ilklendirmenden	Ablative
kırıyordu	None
seveceksin	None
kuyumcular	Nominative
düzeliyor	None
düşmanlarımın	Genitive
görüşünüze	Dative
kanmam	None
katkıların	Genitive
sarıldılar	None
tercihimizden	Ablative
kalkar	None
alevmişiz	None
baharlar	Nominative
şiveler	Nominative
oynatıcında	Locative
hikâyede	Locative
tanrıya	Dative
rehberlere	Dative
kolonunuz	Nominative
kalıyorlardı	None
düşüyorsunuz	None
sunucusunda	Locative
acemiydim	None
ölçüşüyordum	None
kokarsınız	None
fotoğraftan	Ablative
bölüm	Nominative
mevkisini	Accusative
duymazsınız	None
bulunmuyor	None
sınayacak	None
zibillerimizden	Ablative
kapasitesinin	Genitive
sıcaklığın	Genitive
modellermişsiniz	None
sererler	None
fahişelerden	Ablative
eşofman	Nominative
sürekliliğe	Dative
kanala	Dative
minareler	Nominative
tanıma	Dative
öğrencisinin	Genitive
şafaklarımıza	Dative
bazalt	Nominative
yüzmeden	Ablative
gölge	Nominative
dövüşlerde	Locative
dondurur	None
mektuplar	Nominative
beldemizde	Locative
indekse	Dative
cihazlarda	Locative
kulağım	Nominative
kimliğiniz	Nominative
uyarlar	None
kimliğim	Nominative
sunduk	None
asitlerde	Locative
öldürecek	None
izolasyona	Dative
kuyumcumuzdan	Ablative
sultanlara	Dative
boks	Nominative
silerler	None
sandalyeye	Dative
keman	Nominative
battaniyelere	Dative
değişirler	None
koymadı	None
sabahtan	Ablative
temizliyorum	None
katmaz	None
vücutlara	Dative
tırtılları	Accusative
geçecek	None
söyleşilerde	Locative
kategorisi	Nominative
gülünçleşeceğiz	None
deneyimlerimiz	Nominative
savaşıyorlardı	None
güveniyor	None
Museviler	Nominative
cephenizi	Accusative
dağıldı	None
çetesine	Dative
donmayı	Accusative
eriyiklerimden	Ablative
fotoğraf	Nominative
yetiştirdim	None
kulak	Nominative
gişesinde	Locative
sinmedi	None
bağımlılık	Nominative
romanım	Nominative
yataktan	Ablative
çama	Dative
tıkar	None
kaygılardan	Ablative
hatalar	Nominative
pastayı	Accusative
tartar	None
gençliğim	Nominative
duman	Nominative
karaciğere	Dative
baklavası	Nominative
topluluğumuz	Nominative
hücreden	Ablative
volkanlarınız	Nominative
doğruculuklarınızdan	Ablative
sindirimde	Locative
kimliğimizi	Accusative
beceriksiz	None
uzaylı	Nominative
ahtapot	Nominative
albümlerden	Ablative
vitrinlerde	Locative
göllerden	Ablative
doktordu	None
verdirdiler	None
küçülür	None
okulum	Nominative
işleme	Nominative
piramide	Dative
kirişler	Nominative
yanıt	Nominative
öleceğiz	None
duymadan	Ablative
canlandırılıyor	None
çiftlikten	Ablative
geometriden	Ablative
içeceklerim	Nominative
robotu	Accusative
kapamayım	None
fikirlerimizden	Ablative
tarabası	Nominative
öğrencilerinize	Dative
söğütler	Nominative
ayarlattırmıyordun	None
tararlar	None
ışınımdan	Ablative
bilgiyi	Accusative
nüfuzları	Accusative
yufka	Nominative
keşkeklerinizin	Genitive
virgüllerimde	Locative
eksenlerde	Locative
ongun	Nominative
sindirim	Nominative
kat	Nominative
banklarımızda	Locative
bakıyordu	None
öldürmedim	None
parçalanır	None
kabalık	Nominative
lazerler	Nominative
varır	None
karadulunuzun	Genitive
kansere	Dative
açıyorlar	None
kazısının	Genitive
çapası	Nominative
dalar	None
küle	Dative
gökadaya	Dative
cumhurlarsın	None
kullanıcımız	Nominative
döner	None
hiperbolüm	Nominative
bohçalarınızı	Accusative
buluşur	None
modelden	Ablative
fikirlerden	Ablative
lira	Nominative
kozlardan	Ablative
vurgusuna	Dative
klişenizden	Ablative
sürüyorum	None
keçisinde	Locative
geçmiyor	None
yavrusunun	Genitive
ürerler	None
öğreniriz	None
unutmadı	None
fikriniz	Nominative
enjektörümüz	Nominative
vaftize	Dative
marangozlarsınız	None
bakıyorsun	None
seçmeden	Ablative
karınca	Nominative
yapmamı	Accusative
tuttun	None
cevaplarınızda	Locative
uzaylarda	Locative
parçalanmalara	Dative
haritamızı	Accusative
cemaatlerde	Locative
spamlarımızın	Genitive
fotoğrafınızda	Locative
tümcesini	Accusative
kazaklardan	Ablative
çiftlerdir	None
anlattım	None
balalaykana	Dative
sonraları	Accusative
oğlum	Nominative
ortamlar	Nominative
pedlerimden	Ablative
ömrümün	Genitive
ilerlettiler	None
seyahate	Dative
merkezi	Accusative
istemedik	None
bayılıyorum	None
yapmazsın	None
sayıyordu	None
erkeneğimiz	Nominative
köpekleri	Accusative
bikinimi	Accusative
mumlarınızın	Genitive
kategorilerden	Ablative
karakollara	Dative
bilardonun	Genitive
sarhoşluğun	Genitive
argoya	Dative
yabancısının	Genitive
tıktık	None
tenisçilermişsiniz	None
maskesine	Dative
istemiyorlar	None
doğuyordu	None
hidrat	Nominative
sunucusundan	Ablative
sayfanızı	Accusative
amatörümün	Genitive
amacınızı	Accusative
acı	Nominative
kedim	Nominative
verisinden	Ablative
göbek	Nominative
migren	Nominative
acıtmazlar	None
demeyeceğim	None
yayarlar	None
futbolculara	Dative
kuvvetti	None
babalılarmışım	None
titreşimleri	Accusative
ısırırlar	None
marangoz	Nominative
sekmeye	Dative
olmuyordu	None
savaştım	None
birey	Nominative
yardımcısının	Genitive
itti	None
öce	Dative
ecem	Nominative
matlasın	None
yakınlardan	Ablative
velet	Nominative
âşıklardan	Ablative
gecesi	Nominative
taşıyordu	None
şokun	Genitive
fikolojilerin	Genitive
gereksinim	Nominative
taşımıyordum	None
akbabalara	Dative
söver	None
kurbanlara	Dative
yerler	Nominative
mantığa	Dative
kararınıza	Dative
meşaleleriniz	Nominative
kasidelerinizin	Genitive
geziyordu	None
birleşir	None
yoğurtçularınızdan	Ablative
ceylan	Nominative
düşmandım	None
kullanıcıdan	Ablative
frambuazıma	Dative
sporcularınız	Nominative
balığımdan	Ablative
yedeğim	Nominative
kaplumbağama	Dative
yapacağım	None
öğrencilerimizin	Genitive
frekansa	Dative
fikrinizin	Genitive
sunarım	None
bulunmaya	Dative
ilklendirmesini	Accusative
ağacı	Accusative
ebeyi	Accusative
uğratmaz	None
döneriz	None
meni	Nominative
maskesinden	Ablative
canlandırmayı	Accusative
asetonunuz	Nominative
eridi	None
gösteriye	Dative
yazmamıza	Dative
zavarlarıma	Dative
seçtiniz	None
Kürtleri	Accusative
dolabınızdan	Ablative
kürer	None
cümlesinde	Locative
üyelerimiz	Nominative
odalarımızda	Locative
gelişiriz	None
üzmez	None
kaçmayacak	None
fikirler	Nominative
pedofobiye	Dative
puromuzdan	Ablative
öldürüyordu	None
programlanır	None
kapısı	Nominative
çalışmalarımı	Accusative
yarattık	None
kuğuya	Dative
ine	Dative
mümessilmiş	None
hayvanlar	Nominative
mevkine	Dative
boksa	Dative
finallerde	Locative
otellere	Dative
verdik	None
gondol	Nominative
çekirdeklerinizi	Accusative
sattırtırdı	None
yardımım	Nominative
kelimesinde	Locative
bazlara	Dative
muhalefette	Locative
yapılacak	None
sezona	Dative
muzlar	Nominative
direkte	Locative
fareydi	None
istemiyor	None
uyur	None
bataryalar	Nominative
boyacıyı	Accusative
duyuyorsun	None
korunmanı	Accusative
fiilden	Ablative
belirtmeyi	Accusative
iyileşmez	None
göğse	Dative
kardeşim	Nominative
sivrisineğe	Dative
sorumluluğa	Dative
ayırır	None
böğürtlenlerdin	None
kaldınız	None
sirke	Dative
tıklamıyordum	None
küpe	Nominative
yerleştiler	None
kuştan	Ablative
silahlara	Dative
çukurlardan	Ablative
maskesini	Accusative
kullanırsınız	None
katarlardan	Ablative
eğitirsin	None
sözlüğünüz	Nominative
yarışmasında	Locative
çizgide	Locative
yakuta	Dative
geleceğim	None
hareketsizliklerinizden	Ablative
menünüzde	Locative
tozdan	Ablative
örtünüze	Dative
sarhoşun	Genitive
tozlardınız	None
evrimimizden	Ablative
anketlerde	Locative
seçeneklerin	Genitive
frekanslar	Nominative
alevlerimizi	Accusative
tiyatro	Nominative
dövüştü	None
vernikler	Nominative
dövdü	None
açılmaz	None
bencillikten	Ablative
hazineye	Dative
tüylerden	Ablative
tayfalarımda	Locative
lahanası	Nominative
prototipin	Genitive
izlerim	None
böbrekte	Locative
müzisyenden	Ablative
öneri	Nominative
cevher	Nominative
buluşuyoruz	None
anahtarlık	Nominative
biliyorsunuz	None
zorluklara	Dative
anıyoruz	None
veriyor	None
satıyorlardı	None
balkanınızı	Accusative
birlikteliklerimizin	Genitive
tasarımlara	Dative
sinmiyor	None
gösterdik	None
kuyudan	Ablative
örümceklerde	Locative
lezbiyenimin	Genitive
cinselliklerin	Genitive
çıplaklığın	Genitive
doluyor	None
olaylarımızdan	Ablative
kullanılmadı	None
şişliğimiz	Nominative
kurtarmaz	None
ısınacak	None
kaldıraçlarımızın	Genitive
aktrisimin	Genitive
odası	Nominative
kaleme	Dative
sonuçlarımda	Locative
üzümden	Ablative
feribotlarım	Nominative
kunduz	Nominative
mayası	Nominative
sonsuza	Dative
okumadın	None
eksiklikler	Nominative
memleketlerden	Ablative
delmiyorum	None
fil	Nominative
korkuluk	Nominative
enflasyonları	Accusative
palyaçolarımızda	Locative
menekşeymişim	None
serçeler	Nominative
taksim	Nominative
köfteden	Ablative
bekliyorsunuz	None
iblise	Dative
ailelerde	Locative
gözyaşlarından	Ablative
buluyoruz	None
nene	Nominative
bitiyordu	None
baylar	Nominative
birleşmede	Locative
kümemiz	Nominative
çiftliklerinizin	Genitive
başardık	None
izliyorum	None
haçlar	Nominative
yedirirler	None
öncelere	Dative
şelalede	Locative
katlarımıza	Dative
kâğıtlardan	Ablative
depresifmiş	None
tatlım	Nominative
videoya	Dative
parçalandım	None
makarasının	Genitive
uyanmaz	None
toplar	Nominative
oldum	None
yağışlardır	None
dıştan	Ablative
tohumda	Locative
yasasının	Genitive
heyetlere	Dative
bölgelerdi	None
minareyi	Accusative
kullanıcıydı	None
çalışırım	None
fonksiyon	Nominative
yalvarırım	None
yolculardan	Ablative
bedevilere	Dative
kaçtık	None
silahlar	Nominative
korsandan	Ablative
yenildiler	None
müzikale	Dative
memesi	Nominative
çırağa	Dative
zombiler	Nominative
sapmayacaklar	None
burunlarınız	Nominative
karanlığın	Genitive
deline	Dative
yolculuklarda	Locative
bilgilere	Dative
toza	Dative
tavanda	Locative
öbeklerimiz	Nominative
yollardır	None
çarşılar	Nominative
topluyordu	None
okudum	None
tarihçisi	Nominative
makinalara	Dative
katalog	Nominative
garsonlarımız	Nominative
ayılarınızın	Genitive
teknolojiler	Nominative
arzudan	Ablative
türevlerde	Locative
gönülde	Locative
geliştiriyoruz	None
bazaltınız	Nominative
kategoriye	Dative
çığırtkanlardır	None
gidilecek	None
geçiyorlar	None
asansörlerde	Locative
yanlıştı	None
diskoda	Locative
kalıyoruz	None
düşeriz	None
ayrılacaklar	None
kurumlarda	Locative
devinmeyecekler	None
embriyoymuşlar	None
yaratmaya	Dative
seçilirsin	None
bakacağım	None
altınlar	Nominative
izlek	Nominative
ölümler	Nominative
mermiyi	Accusative
ispatladılar	None
sakallar	Nominative
hastalıktan	Ablative
derler	None
silindirlere	Dative
günümüze	Dative
yorganı	Accusative
geldiler	None
oyunculuklar	Nominative
kanıtladılar	None
bütünleşti	None
kıydı	None
seçilmem	None
yığdı	None
sözcüğümüz	Nominative
anlatacak	None
gemilerimiz	Nominative
bitirttirmezler	None
moda	Nominative
değirmende	Locative
Aşkabatlısından	Ablative
demiyor	None
güzellikleri	Accusative
kameran	Nominative
dindarlığınızdan	Ablative
modeller	Nominative
akışkanları	Accusative
kategorimiz	Nominative
getirmeyecek	None
giydiler	None
zeytin	Nominative
baytarınızdan	Ablative
yazarı	Accusative
eşiğimi	Accusative
hızımız	Nominative
faresine	Dative
çöktük	None
savunmuyor	None
konserlerime	Dative
umarız	None
lügat	Nominative
balinalara	Dative
yaratıyorlardı	None
sevdin	None
paradoksun	Genitive
perdelerden	Ablative
giysisini	Accusative
portlarınızın	Genitive
akrabalarda	Locative
balinaya	Dative
bozan	Nominative
girdaplar	Nominative
perisini	Accusative
bazaltlar	Nominative
ilerimden	Ablative
binlere	Dative
dağıtımdan	Ablative
uymuyorlar	None
göçlerden	Ablative
mutsuzdun	None
gözlemenden	Ablative
büker	None
öğrencilerdir	None
gaf	Nominative
kullanıcıda	Locative
savaşıyorlar	None
ustayı	Accusative
çağırır	None
kümbet	Nominative
kolada	Locative
ikazlar	Nominative
gemisinden	Ablative
malda	Locative
ısınmaz	None
örttü	None
kavimler	Nominative
algoritmasına	Dative
fırtınasına	Dative
görmem	None
vururum	None
uydulara	Dative
yerinize	Dative
makarnayı	Accusative
homoseksüelimize	Dative
bisikletlerde	Locative
matruşka	Nominative
acılarmışız	None
klişeler	Nominative
aşıklara	Dative
ehemmiyetliliğinizi	Accusative
masalarda	Locative
çarmıhta	Locative
senaryosundan	Ablative
kaçırdım	None
gidildi	None
kullanmıyoruz	None
sosyologların	Genitive
amcayı	Accusative
ısısı	Nominative
evrende	Locative
koordinatlarımın	Genitive
böğürtlenlerimizde	Locative
aptallık	Nominative
başvurumun	Genitive
protestoya	Dative
uzağız	None
yapıyoruz	None
balamozlarda	Locative
alırsınız	None
imamlardan	Ablative
eriklerimin	Genitive
lalaları	Accusative
parmaklarınıza	Dative
iletilerin	Genitive
bileşiğe	Dative
koltuklarda	Locative
kaçacak	None
belirtmeler	Nominative
duyması	Nominative
penisilinlerimi	Accusative
tecrübelerden	Ablative
masalım	Nominative
fiilde	Locative
işgücünü	Accusative
anlattı	None
şişiyor	None
lezyona	Dative
merkezlerden	Ablative
müzisyeninize	Dative
yetersizliğe	Dative
yoğuracağım	None
susar	None
havralarınızdan	Ablative
tuşları	Accusative
kazanırız	None
konularım	Nominative
yoldaşlardı	None
bele	Dative
iskelete	Dative
mermisinden	Ablative
şüpheler	Nominative
enjektör	Nominative
kırtasiyelerime	Dative
perdeye	Dative
heteroseksüellermişsiniz	None
vakitlere	Dative
karşılık	Nominative
aznavurlarımı	Accusative
şuura	Dative
izolasyonumun	Genitive
yorum	Nominative
çekirdeklere	Dative
söyleşisinde	Locative
süpürgeleri	Accusative
lolipoplarınızın	Genitive
meydanların	Genitive
ayazı	Accusative
abadilerinizde	Locative
kullanıcıya	Dative
tarafımdan	Ablative
mihrap	Nominative
mamalarımızın	Genitive
götürür	None
tabelalar	Nominative
ayakkabı	Nominative
sayfaya	Dative
içiyorum	None
korkmuyorum	None
oynuyorsunuz	None
etiketlerden	Ablative
yapıldı	None
uykular	Nominative
kazılar	Nominative
hazcılık	Nominative
ilginçmiş	None
andım	None
günümüz	Nominative
şalımızda	Locative
koruyucuydu	None
patlama	Nominative
kasideydin	None
bozunumdan	Ablative
basım	Nominative
oynarız	None
rahiplerden	Ablative
zamanımızın	Genitive
ofislere	Dative
çukurları	Accusative
bilgilerden	Ablative
aynalar	Nominative
gelin	Nominative
tekila	Nominative
oyuncaklarmışız	None
bölgesin	None
köygöçürenlerdin	None
ananas	Nominative
müşteri	Nominative
odacık	Nominative
yeterliliğinizde	Locative
keserim	None
mahzenimin	Genitive
kaldırıma	Dative
fragman	Nominative
yuvası	Nominative
odunlar	Nominative
bileşik	Nominative
üyesine	Dative
sinüsün	Genitive
havuç	Nominative
sisteme	Dative
tasanız	Nominative
gerdi	None
sürümlerde	Locative
ettiriyorlar	None
şirketten	Ablative
gecelik	Nominative
temsilde	Locative
türedi	None
olca	Nominative
anüs	Nominative
çizgiler	Nominative
başardın	None
gemilerden	Ablative
şeylerimizi	Accusative
sitelerden	Ablative
yankıya	Dative
ıspanak	Nominative
işletmeye	Dative
gezerler	None
levye	Nominative
basar	None
şemsiyesinin	Genitive
siteniz	Nominative
banliyölerde	Locative
odasının	Genitive
filozoflarınız	Nominative
ölüydüm	None
hahamdı	None
saksolar	Nominative
glasnostunuzun	Genitive
yazıdan	Ablative
asan	Nominative
öğretisine	Dative
yalanlardır	None
düldüllerinizden	Ablative
ayısına	Dative
bölümde	Locative
cadıyı	Accusative
donma	Nominative
kayıtlar	Nominative
yaydılar	None
dizisi	Nominative
objede	Locative
vermez	None
asmıyorsunuz	None
yorumumu	Accusative
beneklersin	None
sokağımız	Nominative
göçlerime	Dative
rüzgârlara	Dative
ahtapotta	Locative
saçlara	Dative
kuruşu	Accusative
satıyorlar	None
kaparım	None
eklemelisiniz	None
şaşırttırmadınız	None
dövmemiz	Nominative
bürüdü	None
sınıf	Nominative
otellerimin	Genitive
bahçeler	Nominative
işlemedi	None
yerleşir	None
büyükelçinin	Genitive
öneriniz	Nominative
ilklendirme	Nominative
bileşiklere	Dative
paylaşımlarımız	Nominative
aktif	None
ortaklar	Nominative
dergin	Nominative
sultanlar	Nominative
sürücüye	Dative
sancağın	Genitive
tanesi	Nominative
işlemci	Nominative
kurumlarımı	Accusative
kıblelerime	Dative
kalabalıkların	Genitive
pilav	Nominative
memeye	Dative
korkacak	None
filozofumun	Genitive
halkımızı	Accusative
sivrisinek	Nominative
tacizden	Ablative
hırsızlara	Dative
güvensizliğimi	Accusative
konudan	Ablative
futbolculardın	None
dirseğe	Dative
krizlere	Dative
samuray	Nominative
pozisyonda	Locative
kurbağasının	Genitive
uçtan	Ablative
sorularınız	Nominative
parmak	Nominative
büyükelçileri	Accusative
geleceksin	None
cibinlerimiz	Nominative
seçilmedi	None
yalar	None
mekikte	Locative
övgüsünün	Genitive
kaçtılar	None
börülcelerdin	None
dalgayı	Accusative
bitkilere	Dative
geyşalarımı	Accusative
sayfalandırmamda	Locative
sunuyorlar	None
çobanlardan	Ablative
radara	Dative
tümör	Nominative
kanserin	Genitive
şövalyelere	Dative
katılmayacak	None
otlara	Dative
kapaktan	Ablative
sevgililer	Nominative
yaratmazlar	None
şeyime	Dative
yardı	None
kağıtlarımdan	Ablative
tıklar	None
öldürttüler	None
kuklaya	Dative
vazosu	Nominative
defterimden	Ablative
tavuğumda	Locative
acıyorum	None
andılar	None
seçilmez	None
güldüm	None
astronotlara	Dative
fetişinizden	Ablative
çıkmadılar	None
bitiririz	None
camilere	Dative
yeriniz	Nominative
hatalarınızdan	Ablative
lezyonlara	Dative
vururlar	None
karalamaları	Accusative
dürümde	Locative
memenizden	Ablative
ağlıyordu	None
şamandıra	Nominative
isyanlar	Nominative
pederlerinizi	Accusative
seviyorlar	None
güvenim	Nominative
yağlayıcıda	Locative
asılda	Locative
kazandan	Ablative
minareye	Dative
dumantan	Ablative
gölgeler	Nominative
perdeler	Nominative
durumumda	Locative
kenara	Dative
rüzgarı	Accusative
seçmemizin	Genitive
haşefelerime	Dative
onurlar	Nominative
cisimde	Locative
çiftlik	Nominative
ölümümden	Ablative
sorumluluk	Nominative
balinayı	Accusative
izleyicisinin	Genitive
semerler	Nominative
şehir	Nominative
yaralanmasından	Ablative
düştüm	None
odaktan	Ablative
voleybolun	Genitive
maşanızda	Locative
kalkmadı	None
dönüyorum	None
diyapazonlarımı	Accusative
yakına	Dative
kılıflar	Nominative
tuşu	Accusative
banklarınız	Nominative
sunaklar	Nominative
ilçelerden	Ablative
kristallerde	Locative
benzer	Nominative
yardımcısına	Dative
katılıyordu	None
menüsünden	Ablative
hudut	Nominative
striptizinizde	Locative
sapanlarıma	Dative
kedisini	Accusative
sayfanı	Accusative
umuyorum	None
denizyıldızlarına	Dative
odamız	Nominative
çukurun	Genitive
günebakan	Nominative
yayımcılık	Nominative
cüceye	Dative
gönlünüze	Dative
aygıtlar	Nominative
eskir	None
heceden	Ablative
sağdan	Ablative
değişikliğin	Genitive
kanatın	Genitive
kirpisi	Nominative
yasağa	Dative
mevkiyi	Accusative
eziyetimizin	Genitive
neşesi	Nominative
duyuyordu	None
öptü	None
baltasını	Accusative
kullanıyordun	None
kaplumbağasının	Genitive
çekirdekler	Nominative
gözlemcinin	Genitive
olmazsın	None
depolardan	Ablative
düşünmedim	None
uzunlukta	Locative
kirpi	Nominative
kalpte	Locative
dişlerden	Ablative
bürokratlarda	Locative
kertenkeleler	Nominative
soğana	Dative
verisi	Nominative
kargayı	Accusative
girdiler	None
yavruymuşum	None
okuyor	None
gayzerim	Nominative
travmayı	Accusative
davranmazlar	None
temsilcilerimize	Dative
hülya	Nominative
gömlek	Nominative
mühendisliği	Accusative
avmış	None
ayıyı	Accusative
entrikası	Nominative
açlık	Nominative
mucizeyi	Accusative
dolabımızdan	Ablative
sakaların	Genitive
kurtçuk	Nominative
tanıtmadınız	None
seçildiler	None
akrabalar	Nominative
ongunculuklarımızı	Accusative
klatrat	Nominative
dinmem	None
giymedi	None
yağmalar	Nominative
horlamazsınız	None
işçiler	Nominative
korkuyorum	None
verilerimiz	Nominative
yarışları	Accusative
atomlara	Dative
nedeninize	Dative
çalıyor	None
mitokondriye	Dative
kıskanç	None
paradoksları	Accusative
övdü	None
tabana	Dative
objesi	Nominative
köprülerde	Locative
işlev	Nominative
yaymaz	None
sepetlere	Dative
yetiştiriyor	None
zaferinize	Dative
okyanusa	Dative
trigonometrinin	Genitive
koltuklar	Nominative
olmayacaksınız	None
tavanlarınız	Nominative
akısına	Dative
zamanımızı	Accusative
abacılarda	Locative
gübre	Nominative
kütükler	Nominative
getirecekler	None
oynatıcı	Nominative
yaratması	Nominative
sanatta	Locative
spam	Nominative
sezonlardan	Ablative
yalancımız	Nominative
savunuyorsun	None
içecekten	Ablative
kırmadı	None
hareketsizliğimde	Locative
ileriyi	Accusative
kırılıyordu	None
çaydanlığın	Genitive
televizyonlar	Nominative
kiplerden	Ablative
demliyecekler	None
DVDleri	Accusative
pirinçler	Nominative
hedeflere	Dative
sahifeye	Dative
olmam	None
alyan	Nominative
haritanızı	Accusative
göçtü	None
takıma	Dative
elma	Nominative
pandaların	Genitive
yoğurtçuluğumuza	Dative
kolejlerimin	Genitive
tuttum	None
ergenlik	Nominative
gökdelenlerin	Genitive
taradık	None
büzlerimizden	Ablative
toplumlardan	Ablative
fikre	Dative
kirler	Nominative
mezrada	Locative
izleyicimizi	Accusative
intikamlarımızdan	Ablative
ölümsüzleştirdi	None
otostop	Nominative
Kürtlere	Dative
dövüşüyorduk	None
dünyanın	Genitive
saksı	Nominative
süngülerin	Genitive
kimyacılar	Nominative
bildirmem	None
yandık	None
tundralar	Nominative
devingenliğinizde	Locative
kâsemizin	Genitive
teşhisler	Nominative
kapıya	Dative
korkmuyor	None
çimkelerimden	Ablative
politikacıları	Accusative
saçmalığa	Dative
şikâyetimden	Ablative
ülkelermişsin	None
öğretmenimiz	Nominative
hocamıza	Dative
saydım	None
ritüellerde	Locative
alışır	None
özete	Dative
çerçin	Nominative
politikalar	Nominative
birlikteliğe	Dative
güzellik	Nominative
yağmurdan	Ablative
görüntüye	Dative
gereksinimimiz	Nominative
algoritmalarda	Locative
bulunuyordu	None
örtecek	None
birliklerimiz	Nominative
onamazlar	None
kazmaya	Dative
Vikipedilerin	Genitive
tilde	Nominative
sakin	Nominative
kaynadı	None
mistiklerimizin	Genitive
hastaydı	None
ehemmiyetliliklerinizi	Accusative
sitemin	Genitive
doğdum	None
patlamadı	None
katılmadılar	None
etkilemiyor	None
bulunacağım	None
dünyalar	Nominative
bağımsızlıktan	Ablative
tacizler	Nominative
geçmişim	Nominative
satrançtan	Ablative
itimin	Genitive
piyanosuna	Dative
tercümeyi	Accusative
kibritleriniz	Nominative
yanıyor	None
bayılırlar	None
çiziyordu	None
benziyorlar	None
cehennemler	Nominative
sökeceksiniz	None
yapılmaz	None
kahramanlar	Nominative
pozitronu	Accusative
benzemez	None
almayacağım	None
devlerimizden	Ablative
akınızı	Accusative
devinirler	None
değiştiririm	None
derilerimi	Accusative
anasızlığınızın	Genitive
buluşurlar	None
akış	Nominative
karıştırıyorsunuz	None
şikayeti	Accusative
gözlemleri	Accusative
inanmıyor	None
modasının	Genitive
gecikeceksiniz	None
verilmedi	None
yapmıyorum	None
tarihçimizde	Locative
kalırım	None
istemedin	None
sahnesi	Nominative
geyikten	Ablative
öğretmeninize	Dative
elmalar	Nominative
kirlerden	Ablative
aygıtçıklar	Nominative
yıprattı	None
firavunlar	Nominative
sağdık	None
hüzünümüzde	Locative
ısırıklara	Dative
geliştiriyor	None
gişe	Nominative
akımdan	Ablative
ayılır	None
çökmez	None
müzikallere	Dative
taca	Dative
korselerinize	Dative
parçacıklar	Nominative
kistlerden	Ablative
kalabalıkta	Locative
camilerimize	Dative
diner	None
lehçe	Nominative
araçlardır	None
akreplerdik	None
dayadı	None
erimez	None
kardeşlerdi	None
sıradan	None
yazmadan	Ablative
canlanmayacağım	None
yolculukta	Locative
musluk	Nominative
taneler	Nominative
kervansaray	Nominative
sınıflardan	Ablative
kor	Nominative
kaçıyorduk	None
kromozomlar	Nominative
kaynaşacak	None
kalede	Locative
gübrelerde	Locative
çeyrek	Nominative
vurgusu	Nominative
savaştı	None
kıldık	None
yalvarıyorum	None
yorumlarınız	Nominative
Yahudilerdir	None
dilberler	Nominative
uyarılarınızda	Locative
kategorisinden	Ablative
dublörler	Nominative
kirazlarınızı	Accusative
sülüslerimizden	Ablative
şatolara	Dative
etlerde	Locative
diyorduk	None
tipler	Nominative
çökeleklerinizin	Genitive
pırasayı	Accusative
noktadan	Ablative
malumat	Nominative
ıspanaklarımızda	Locative
sütlacı	Accusative
Kürtlerden	Ablative
tuşa	Dative
papatyalarınızın	Genitive
yangındınız	None
bulutların	Genitive
kırıldım	None
sporcularımız	Nominative
reaktörde	Locative
aynada	Locative
işçiden	Ablative
perisi	Nominative
öğretmediler	None
gelirler	Nominative
protestolara	Dative
taşmadılar	None
birleşmedi	None
işkenceler	Nominative
yastığa	Dative
mutluluklarımızın	Genitive
uçlar	Nominative
sargı	Nominative
sivrisineklerden	Ablative
boyar	None
buladı	None
kardeşlerdir	None
kabalıklarda	Locative
şehirlere	Dative
yorgunum	None
grup	Nominative
kraliçelerin	Genitive
çalışmamda	Locative
girmem	None
minbere	Dative
boşalmasını	Accusative
korugana	Dative
kistlermişiz	None
dinliliklerimize	Dative
denizyıldızının	Genitive
ilçelerde	Locative
simyayı	Accusative
mügeymiş	None
derdik	None
baykuşlarımı	Accusative
ramazanlarda	Locative
kategorilerde	Locative
kamerasından	Ablative
oğullara	Dative
sıkıntıdan	Ablative
imamdım	None
tepeceksin	None
göğüs	Nominative
önerilerinize	Dative
iskendermişiz	None
hayvanlara	Dative
acılara	Dative
istemcisi	Nominative
urun	Genitive
sıcaklıktan	Ablative
kemanda	Locative
denizatları	Nominative
dizisinde	Locative
evleniyorlar	None
ortada	Locative
gölgesinin	Genitive
eskemiyorduk	None
fabrikaya	Dative
cepheyi	Accusative
gizlerler	None
girmediler	None
akılarım	Nominative
sunu	Nominative
masallardan	Ablative
yavşağımızdan	Ablative
başvurusundan	Ablative
hiyeroglifler	Nominative
karnabahar	Nominative
üyenize	Dative
kamusumdan	Ablative
balinasının	Genitive
çıkmadı	None
sporcudan	Ablative
bitmedi	None
sarılırlar	None
harfleri	Accusative
göçtüm	None
hesapların	Genitive
ritimlerde	Locative
yetkimizi	Accusative
ilerinizden	Ablative
salmaz	None
belleğe	Dative
maçlara	Dative
uyduk	None
takıyorlardı	None
wiki	Nominative
cinsiyetin	Genitive
patates	Nominative
kirden	Ablative
anlatmadım	None
ayaklarımızın	Genitive
uzaylıları	Accusative
aradılar	None
paradokslar	Nominative
ölmez	None
günüme	Dative
palyaçomu	Accusative
çağırıyor	None
işlerler	None
keşfettim	None
yapılıyor	None
elmas	Nominative
tanıyorum	None
çizdiler	None
yeterlikler	Nominative
kiler	Nominative
butona	Dative
yerim	Nominative
giderimde	Locative
uydusunu	Accusative
savaşçınızda	Locative
elçisi	Nominative
sayfalarımız	Nominative
mamalar	Nominative
tanıdık	None
şahım	Nominative
erdin	None
yetenekliydi	None
amcası	Nominative
gelmedin	None
yavruyu	Accusative
yarışmam	Nominative
değişir	None
gagaya	Dative
yaprakta	Locative
ördeklerinize	Dative
makinasının	Genitive
alkışa	Dative
almaz	None
dağınık	None
çağırırız	None
sitemden	Ablative
seçiliyorlardı	None
basketbolcusu	Nominative
gözyaşları	Nominative
dışa	Dative
nefrete	Dative
dize	Nominative
paylaşmam	None
mezrasından	Ablative
yolculuklarımız	Nominative
vaktinizi	Accusative
tütülerimize	Dative
uzunluklar	Nominative
batmadılar	None
başlangıçta	Locative
sağlayıcıymışsın	None
siliyoruz	None
öğrencilerimize	Dative
yamyam	Nominative
şamdan	Nominative
gergedanı	Accusative
derlemede	Locative
kızlıklarımdan	Ablative
imamınıza	Dative
devinimler	Nominative
öğütücüsünde	Locative
siğil	Nominative
sıçanda	Locative
davranışlara	Dative
damat	Nominative
kayıklara	Dative
kukladan	Ablative
tanımayacak	None
aksisedaya	Dative
aktördü	None
savaşacağım	None
mandallar	Nominative
tenisçilerimin	Genitive
defterlerimde	Locative
yanlışlığın	Genitive
sise	Dative
ütüymüşüz	None
hümanizmin	Genitive
gecikmedi	None
gondola	Dative
bitiriyordu	None
yanlışlıklar	Nominative
fırınlarsınız	None
cücenizin	Genitive
oteller	Nominative
damlayacaksınız	None
kimliğimi	Accusative
örneklere	Dative
konsey	Nominative
unutuyoruz	None
frizbiyi	Accusative
hadisten	Ablative
geliştiriyorum	None
şişersiniz	None
sanıyorsun	None
dövüş	Nominative
kategorisinin	Genitive
ezdiler	None
yarışması	Nominative
aktrislere	Dative
karda	Locative
vikipedistlere	Dative
yönelimde	Locative
durumumuz	Nominative
göçmüşler	None
mikrofonu	Accusative
avlardı	None
imam	Nominative
sunarlar	None
örmezsiniz	None
çubuğa	Dative
vaftizi	Accusative
lavaş	Nominative
avdan	Ablative
erikten	Ablative
bulundunuz	None
istemciler	Nominative
otomobilimizin	Genitive
seçeneğe	Dative
kurumumuz	Nominative
duracak	None
ejderhalardan	Ablative
kozayı	Accusative
kibutzlarınıza	Dative
melodilerin	Genitive
bürokrasi	Nominative
sepete	Dative
entrikalara	Dative
böğürtlenlerimizi	Accusative
derilere	Dative
sahnede	Locative
arkadaşlıklarınızın	Genitive
ritm	Nominative
böceklerimizi	Accusative
büyükmüş	None
ombudsmanlarınızda	Locative
otobüslerde	Locative
yapışırlar	None
kaçıyorlar	None
ayırmadı	None
yaparız	None
kullanıcıydım	None
çalışmada	Locative
dudaklara	Dative
rüzgarın	Genitive
idareyi	Accusative
vilayetlere	Dative
şovdan	Ablative
bitişe	Dative
kolamıza	Dative
batacak	None
alkoller	Nominative
ayrılmadı	None
kullanıcılarımıza	Dative
altımın	Genitive
alışıyordu	None
sirk	Nominative
konseyde	Locative
yaptılar	None
bakmadım	None
yapımcıların	Genitive
okulumuz	Nominative
kaynaçlarınızın	Genitive
uğratılır	None
gazetesi	Nominative
alanlarınız	Nominative
yarışa	Dative
kullanıcısını	Accusative
yüzmenizin	Genitive
işkenceniz	Nominative
ilişkisinden	Ablative
pastırması	Nominative
devlere	Dative
dürer	None
yaklaştılar	None
yetkisi	Nominative
göçtünüz	None
yufkasına	Dative
iniyordu	None
yıldıza	Dative
bülbülümün	Genitive
perilerden	Ablative
vadeden	Ablative
mağarasında	Locative
denildi	None
geçindiler	None
çarmıha	Dative
esenliğe	Dative
masumum	None
bacaklardan	Ablative
gelme	Nominative
güzler	Nominative
finişlerinize	Dative
hastanelerden	Ablative
klavyeden	Ablative
halılara	Dative
mucizeler	Nominative
bitkilerdir	None
bacanağımızda	Locative
akiferler	Nominative
radyoyu	Accusative
gösteriyordum	None
uyardılar	None
bazlarda	Locative
bölgelerimiz	Nominative
ısırıkları	Accusative
kuzuymuşum	None
vurdun	None
fizikçiydi	None
derisinden	Ablative
sınırımız	Nominative
takım	Nominative
palyaço	Nominative
pipi	Nominative
mağarayı	Accusative
helvan	Nominative
koylara	Dative
koca	Nominative
bayım	Nominative
düşünmem	None
aceleciliği	Accusative
yenilecek	None
ilkem	Nominative
ağlaşırım	None
zamandan	Ablative
saklayacak	None
akvaryum	Nominative
yetiştirecek	None
tavandan	Ablative
yaralanmalarımı	Accusative
ninnilersin	None
üreticileriz	None
göstermiyorsunuz	None
yaramaz	None
seyrettim	None
gelirsin	None
sanattan	Ablative
yanmaz	None
elementlerde	Locative
kızdı	None
anarşiden	Ablative
tayfasının	Genitive
dizemlerinizde	Locative
karamel	Nominative
araçmışım	None
dışlarımız	Nominative
örtü	Nominative
fırınlardan	Ablative
eşcinseldi	None
cümlelerdir	None
kullanıyordu	None
grubumuzun	Genitive
unutmazlar	None
vidalardık	None
akciğerlerden	Ablative
kovulurlar	None
görüyorsun	None
cenazeye	Dative
yenilmezler	None
buluşuyorlardı	None
vahada	Locative
fırtınalardan	Ablative
kaşımadın	None
açtılar	None
ilkeler	Nominative
deneyimler	Nominative
ağaçkakandan	Ablative
çalışmalarımdan	Ablative
yağışta	Locative
dılağımda	Locative
darıldın	None
köpürüyorsun	None
girmiyorum	None
geldik	None
cisimler	Nominative
bakıyorsunuz	None
ilkeyi	Accusative
kazısında	Locative
şivesinden	Ablative
başvurumuz	Nominative
evleneceğim	None
tacizi	Accusative
birleştirtmeyiz	None
oluyorsun	None
durursun	None
fikirlere	Dative
çubuktan	Ablative
fagot	Nominative
tariflerden	Ablative
bitirdiler	None
Aşkabatlısının	Genitive
öğütücüleriniz	Nominative
cinselliğin	Genitive
adam	Nominative
tutmaz	None
kardeşliği	Accusative
mezraya	Dative
kuruyorum	None
dulda	Locative
defterden	Ablative
uluslarda	Locative
kıyafetten	Ablative
bakarım	None
tavernamızdan	Ablative
soğuyorum	None
eğlencelerden	Ablative
vurgun	Nominative
imrenmiyorum	None
karantinalardan	Ablative
koyuyorsun	None
konulardır	None
sessizliğe	Dative
içermezler	None
yapmazlar	None
malumatlarımıza	Dative
battaniyelerde	Locative
vilayete	Dative
gazeteden	Ablative
demeyeceğiz	None
değiştirecek	None
mekiklerde	Locative
belediyelerde	Locative
yetki	Nominative
değirmenler	Nominative
lezzete	Dative
çökeleklerimizden	Ablative
wikide	Locative
sesleniyor	None
durumda	Locative
bulgur	Nominative
aldırmadı	None
vuracağım	None
kaşesi	Nominative
tatta	Locative
lezyonlarımız	Nominative
davranır	None
kistlerimizi	Accusative
fareden	Ablative
örnekti	None
zaferlerinizde	Locative
bülbülüm	Nominative
asasına	Dative
arzda	Locative
ormanımızdan	Ablative
öksürürsünüz	None
kaybolur	None
belirtmede	Locative
oynatıcıya	Dative
kelimeden	Ablative
kartpostalda	Locative
ülkemi	Accusative
heyecanlanmazlar	None
sözdizimine	Dative
dönüyordu	None
amaçlara	Dative
külahlarımızda	Locative
rakım	Nominative
duyuyordum	None
kullanımdan	Ablative
oynuyorlardı	None
kalıyorsunuz	None
kullanmam	Nominative
avcıyı	Accusative
tanıdılar	None
yeniliklerimden	Ablative
gençliğimin	Genitive
nişanlısının	Genitive
müselleste	Locative
gürz	Nominative
seçecek	None
ablama	Dative
grubunuzda	Locative
yumurtadan	Ablative
çiçekçi	Nominative
kamerasını	Accusative
ürer	None
üçüzünüze	Dative
yazmasından	Ablative
fabrikadan	Ablative
prostatımıza	Dative
bulamıyorum	None
cemaatten	Ablative
köpürtmüyordunuz	None
kuyularda	Locative
uru	Accusative
kuyanlarımda	Locative
Türkçeleştirdim	None
fikrimiz	Nominative
akşamımız	Nominative
üzecek	None
yedekte	Locative
basketbolcular	Nominative
sporculardan	Ablative
çözeltisi	Nominative
dalgalanmayız	None
bankalar	Nominative
tasarımda	Locative
kurallarımızı	Accusative
kırıtacağız	None
okudunuz	None
saldırmayacak	None
delikten	Ablative
ayinlere	Dative
devirmiş	None
erimedi	None
çalgılarımızdan	Ablative
köylülerden	Ablative
araçlar	Nominative
zurnalar	Nominative
bacılardır	None
ilkesinden	Ablative
kuşa	Dative
kokuya	Dative
uyudu	None
vermiyoruz	None
üyelik	Nominative
seçeceğiz	None
Monakolularıma	Dative
enjektörler	Nominative
bacalara	Dative
kullandık	None
dalacaklar	None
kasidesi	Nominative
mevsime	Dative
kaş	Nominative
karakterlerden	Ablative
sorulara	Dative
utanıyorum	None
mikroişlemcinize	Dative
duymayı	Accusative
oylardan	Ablative
birleştiler	None
kasetlerinizden	Ablative
yasaktı	None
hemşirelere	Dative
sayacak	None
taksinizde	Locative
yardım	Nominative
dedi	None
bankası	Nominative
günlük	Nominative
veriyoruz	None
ongundan	Ablative
okiyalarıma	Dative
yaratıklardan	Ablative
nüfustan	Ablative
izleyiciyi	Accusative
oyuncusuna	Dative
ağalar	Nominative
falda	Locative
dilimden	Ablative
düğünlere	Dative
dışımda	Locative
seçmezler	None
oyuncun	Nominative
sekmeyi	Accusative
odacımıza	Dative
ipinizden	Ablative
devirdi	None
süngerinizde	Locative
gemini	Accusative
sosyolojinin	Genitive
namazımızı	Accusative
karısını	Accusative
nedenim	Nominative
yönetim	Nominative
perde	Nominative
vasiyeti	Accusative
müellifinizi	Accusative
kullanıcın	Nominative
üşürüm	None
tarihçilerden	Ablative
ziyaretçilerdiniz	None
gözlemlerde	Locative
işçiye	Dative
klavyesini	Accusative
ömrümde	Locative
duymaya	Dative
sıralamaya	Dative
kurtardı	None
viskisinin	Genitive
etkilediler	None
cevabınız	Nominative
perini	Accusative
bulamadım	None
fareyi	Accusative
çıkacak	None
getirirler	None
hastanelerinizden	Ablative
birleştirmiyordum	None
bacasının	Genitive
koklamayız	None
arzusuna	Dative
konserden	Ablative
dönüşümün	Genitive
tecrübeme	Dative
etkilemez	None
temsilciliklermişsin	None
cümlesi	Nominative
sileriz	None
nilüfer	Nominative
önemliliğimizden	Ablative
iblislere	Dative
maaşın	Genitive
yavrusunu	Accusative
bilmezler	None
piskopos	Nominative
değiştirmedim	None
doğruyum	None
maması	Nominative
palikaryaymışsınız	None
yalanlarınız	Nominative
süpürür	None
tekilimizde	Locative
siteme	Dative
çıkarıyorum	None
gübresinin	Genitive
mihraba	Dative
malt	Nominative
papatyam	Nominative
makinaya	Dative
hemşirelerinizde	Locative
yorumuma	Dative
bükmesinde	Locative
kovaya	Dative
enerjinin	Genitive
jaguara	Dative
yengeçler	Nominative
modele	Dative
yapının	Genitive
bekletiyor	None
kuramların	Genitive
benziyordu	None
sunumu	Accusative
dudaktan	Ablative
sıralaması	Nominative
bulunmuyorlar	None
şiirde	Locative
yumarsınız	None
sinirlendirir	None
ritim	Nominative
atılıyordu	None
geçmesinin	Genitive
sevmiyoruz	None
adım	Nominative
bülbül	Nominative
inanırım	None
gelmiyorsun	None
kaplumbağası	Nominative
kullanacaklar	None
çalışmadan	Ablative
açıyorsunuz	None
koltuğu	Accusative
isteyeceğiz	None
gitmesi	Nominative
çalışmayı	Accusative
çağanozlarınızdan	Ablative
günlerimi	Accusative
denilmeyeceğiz	None
annelik	Nominative
savaşımızda	Locative
istisnalara	Dative
tatlıya	Dative
kılıf	Nominative
futbolcusu	Nominative
emecek	None
fahişeydik	None
sildi	None
lahanaya	Dative
hayvanın	Genitive
kıllığımızda	Locative
çıkaracağız	None
maçtan	Ablative
şairi	Accusative
camimizin	Genitive
dakikasını	Accusative
seviyordu	None
tükendim	None
koltukların	Genitive
ayinlerden	Ablative
maydanozlarımı	Accusative
heykelciğimizden	Ablative
makaranızı	Accusative
tahtlarımız	Nominative
soğanlar	Nominative
otlardan	Ablative
geçeriz	None
koyacağız	None
bilemiyorum	None
kaçaklarımızın	Genitive
odasından	Ablative
gemisi	Nominative
aydınlık	Nominative
tutulmalarımıza	Dative
kusar	None
ikilem	Nominative
üretmez	None
öğrenciler	Nominative
parçalanmasını	Accusative
değerliydiler	None
iletmeyecekler	None
köylüsünü	Accusative
görmezler	None
albümlere	Dative
yağdan	Ablative
nedene	Dative
ikilemlerimde	Locative
saçarlar	None
anarşiye	Dative
aşa	Dative
kılmaz	None
uzaktılar	None
şikâyetler	Nominative
ısılarda	Locative
yanıtınız	Nominative
yetkilerim	Nominative
numaralamalarımızdan	Ablative
hazineden	Ablative
akvaryumlardan	Ablative
havuzda	Locative
taraf	Nominative
çıkaracağım	None
çizgiden	Ablative
madende	Locative
listesinden	Ablative
kanlılıklar	Nominative
sandım	None
mevkiler	Nominative
temsillerimizden	Ablative
tanışıyoruz	None
sorunu	Accusative
saçlarınızın	Genitive
ibneler	Nominative
dervişler	Nominative
karakteriniz	Nominative
değişikliğe	Dative
zürafalar	Nominative
bilirler	None
dağlarımızda	Locative
önceliklerimi	Accusative
yağma	Nominative
istatistiklere	Dative
kaderinizde	Locative
ölçtü	None
göç	Nominative
kasacaksınız	None
ucubelerimi	Accusative
ulam	Nominative
şarkımız	Nominative
pehlivanlardınız	None
aşka	Dative
insanlığı	Accusative
gitmeler	Nominative
geçmişe	Dative
bekliyorduk	None
mikroorganizmalardır	None
yabancıyı	Accusative
uyarıyordu	None
vampirlere	Dative
değiştirdim	None
üyeler	Nominative
kulaklar	Nominative
kazak	Nominative
sikilmiyorduk	None
helva	Nominative
acelecilikten	Ablative
seversin	None
tanıdım	None
sarılacak	None
yapıyorlardı	None
sağlayıcılar	Nominative
makinelerden	Ablative
verdirtir	None
balinalarda	Locative
biçiminizden	Ablative
imamlarız	None
oyunculardan	Ablative
ilçenin	Genitive
kırdırmayacaklar	None
çıkmıyor	None
yönelimin	Genitive
kalfa	Nominative
çevirdik	None
kurbanda	Locative
minder	Nominative
geçmişimin	Genitive
gönül	Nominative
götürmedi	None
derisini	Accusative
güveniyorum	None
vurgunuz	Nominative
videosunu	Accusative
binler	Nominative
eğiliyor	None
arzdan	Ablative
şikayet	Nominative
dirsekte	Locative
mikroplardan	Ablative
içmez	None
fotoğrafçıydı	None
helikopter	Nominative
akışkan	Nominative
kaderde	Locative
papazdı	None
simyaların	Genitive
numaralamamalar	Nominative
şikayetlere	Dative
kenarlara	Dative
saklandı	None
dönemlerde	Locative
kipler	Nominative
zulümler	Nominative
avcısının	Genitive
efem	Nominative
vereceğim	None
para	Nominative
başvurumda	Locative
koleksiyonumuza	Dative
kovmazsın	None
doğmadı	None
devrimde	Locative
gecemi	Accusative
hızınız	Nominative
yumurtalıklarımızı	Accusative
sandviçlere	Dative
hikayede	Locative
kullanılıyor	None
sıvılaşacaksınız	None
amatörden	Ablative
ziyaretler	Nominative
tasarruflar	Nominative
raket	Nominative
patlamanın	Genitive
bildirdim	None
saçlarımıza	Dative
baharat	Nominative
inci	Nominative
imambayıldımdan	Ablative
sağduyusunu	Accusative
kolyelerime	Dative
vardılar	None
tasarıma	Dative
tükenmeyecekler	None
lahmacunlardan	Ablative
alkışlar	Nominative
kazama	Dative
patatese	Dative
sorumluluklara	Dative
duracağız	None
mikrofiber	Nominative
alemden	Ablative
diyordunuz	None
unutmayacağız	None
eğride	Locative
virgülden	Ablative
kımızlarım	Nominative
argo	Nominative
uğrattılar	None
şüphenizde	Locative
fırında	Locative
istediniz	None
dövmesine	Dative
cezalandırdık	None
bitmelerimizde	Locative
köygöçürenlerimin	Genitive
odacılar	Nominative
kolonlara	Dative
kardeşlerime	Dative
demirciler	Nominative
çalışırız	None
deltoid	Nominative
yığar	None
jenerasyona	Dative
misafirinizin	Genitive
dolaplarımdan	Ablative
bilemiyor	None
amcaya	Dative
kızgın	None
taslaklarımızı	Accusative
manitalarınızın	Genitive
yalıtım	Nominative
kurulumu	Accusative
galaksiler	Nominative
ağaçtan	Ablative
duyarsınız	None
zulümlere	Dative
sıkıntıları	Accusative
müşteriden	Ablative
kokuyor	None
geliştiler	None
makyaja	Dative
durumdan	Ablative
yaklaşıyorlardı	None
tümörü	Accusative
limona	Dative
sürünüyordunuz	None
unutur	None
sacın	Genitive
değiştirmedi	None
maratoncularımıza	Dative
peruk	Nominative
kırıklar	Nominative
lensten	Ablative
sismoloji	Nominative
dükmüş	None
adımın	Genitive
bombalara	Dative
kuku	Nominative
dizilerden	Ablative
ojeler	Nominative
çıraklara	Dative
kabukta	Locative
istisnalardır	None
açlığa	Dative
güderler	None
havuçlarımızdan	Ablative
çevirimlerimizin	Genitive
uykularda	Locative
çıban	Nominative
uydu	Nominative
kurbanları	Accusative
kaçıyordu	None
meşenden	Ablative
duttan	Ablative
homoseksüeller	Nominative
hastalıklarda	Locative
duvardan	Ablative
adama	Dative
animasyona	Dative
merdivene	Dative
tarihçilere	Dative
papirüs	Nominative
eziyete	Dative
krize	Dative
yapıya	Dative
haberlerden	Ablative
aşiretlerimiz	Nominative
maratoncu	Nominative
uygulamalarımızdan	Ablative
tümöre	Dative
pezevenklerime	Dative
odacıklarda	Locative
frambuazlarımdan	Ablative
psikoterapide	Locative
geçmezler	None
istatistikleri	Accusative
cücelerdir	None
boşalmaz	None
ulamlar	Nominative
kokusunu	Accusative
kapadılar	None
vasiyetlerin	Genitive
doğrar	None
bipimden	Ablative
öküzlerinizi	Accusative
çana	Dative
baltasından	Ablative
tatlısı	Nominative
oturmadı	None
senaryolar	Nominative
yağın	Genitive
soylulara	Dative
ayakkabısına	Dative
kolona	Dative
bayılmıyordu	None
yarasından	Ablative
tenisçiye	Dative
kefirlerim	Nominative
göstermezler	None
kıllar	Nominative
karıncası	Nominative
yıkar	None
ışınımın	Genitive
çıkarırız	None
getirir	None
ankete	Dative
şikayetlerde	Locative
harçlığımıza	Dative
sevişirler	None
beneklerimin	Genitive
prensibe	Dative
mitokondrinin	Genitive
totemcimizden	Ablative
mumyası	Nominative
arzuhalcilermiş	None
peynirlerden	Ablative
çadırlarda	Locative
isteyecekler	None
forumdaş	Nominative
ararsın	None
çıkardım	None
alanım	Nominative
unutacak	None
çalışmayacak	None
otobüsten	Ablative
çıkarsın	None
nenelerde	Locative
neşriyattan	Ablative
övgüsünü	Accusative
fikrimizi	Accusative
istemediniz	None
ilerletti	None
boyacıma	Dative
bitmesinden	Ablative
geçtiniz	None
panendeistlerdi	None
hadis	Nominative
incire	Dative
göğüsler	Nominative
fahişeliğe	Dative
şaşırdınız	None
yapışmasına	Dative
bitkin	Nominative
kasaplar	Nominative
dayanıklılık	Nominative
sayfalarımızı	Accusative
götüme	Dative
kıymetlerimi	Accusative
temsilcilerimizin	Genitive
jonglörler	Nominative
çarşaflarımın	Genitive
karantina	Nominative
susuzluğu	Accusative
siliyorlar	None
bulgura	Dative
psikoloğa	Dative
mikrop	Nominative
çıkarmayacak	None
şampiyonluğa	Dative
rakamda	Locative
televizyonlardan	Ablative
kuruyordu	None
soyluların	Genitive
diyoruz	None
saçarım	None
irdelemeyeceksiniz	None
taşacak	None
utlara	Dative
bulutlar	Nominative
adamlara	Dative
ilçe	Nominative
sürtüklerimde	Locative
heyecanlanır	None
oynayacak	None
aşımı	Accusative
algoritmalardan	Ablative
zorlukların	Genitive
aldırırım	None
doğduk	None
periye	Dative
kıskançlık	Nominative
yayacak	None
kusmalarımızın	Genitive
günlerim	Nominative
kalesine	Dative
hamamda	Locative
saganızda	Locative
aşkımızda	Locative
solucanlar	Nominative
aktristi	None
uydularda	Locative
nörona	Dative
barbarlar	None
fırınlara	Dative
çöllerde	Locative
klavyede	Locative
puanlara	Dative
elçin	Nominative
serdim	None
ağaca	Dative
işkenceciler	Nominative
durumlardan	Ablative
yıldırımlar	Nominative
bastırmada	Locative
saparlar	None
tahditler	Nominative
yarışın	Genitive
istemcimizin	Genitive
kâğıt	Nominative
saç	Nominative
katkıdan	Ablative
fikirlerim	Nominative
gelecek	None
demedim	None
programlanmayacağım	None
veriyordu	None
bankasına	Dative
geceler	Nominative
çöküyordu	None
düşünüyoruz	None
papalar	Nominative
aşlarınızı	Accusative
sporcuyu	Accusative
paylaştı	None
algoritması	Nominative
memleketimden	Ablative
iletkenlere	Dative
savaşmaz	None
çağırdım	None
tasayı	Accusative
güldük	None
sürülmez	None
tabancadan	Ablative
ilaçlara	Dative
ürker	None
şiirden	Ablative
isim	Nominative
baytarımıza	Dative
sekmelerde	Locative
sokakta	Locative
amaçtan	Ablative
mevkinden	Ablative
beklemiyordu	None
körler	Nominative
dalgada	Locative
cisimlerde	Locative
bataryalardan	Ablative
ağam	Nominative
düşünmez	None
konuk	Nominative
arayüzleri	Accusative
yerlerdir	None
tanışmadı	None
alacakaranlık	Nominative
bluzsuzumuzda	Locative
aşklar	Nominative
yarışmada	Locative
yağ	Nominative
sözlüklere	Dative
kartallara	Dative
burktu	None
kardeşlere	Dative
frekanslarınızı	Accusative
böltü	None
âlemden	Ablative
vaziyete	Dative
çalgılara	Dative
bildiler	None
içiyordu	None
nal	Nominative
kayıkları	Accusative
kandiller	Nominative
dirilmemeyeceğiz	None
radyosuna	Dative
eşekler	Nominative
minarelerimizde	Locative
sağlarız	None
katılırsınız	None
mısranızın	Genitive
boza	Nominative
tanıyor	None
bilmiyoruz	None
büyüyordu	None
eğilir	None
kaldık	None
objelerde	Locative
yorumlarıma	Dative
buzulda	Locative
kristale	Dative
çağırmadı	None
uyarıyor	None
üretti	None
sunuyor	None
bükülmenize	Dative
kıracak	None
dadıya	Dative
sargıdan	Ablative
üzer	None
halılar	Nominative
fonksiyonlardan	Ablative
kazanıyorlar	None
dakikasının	Genitive
iletiyordu	None
dürmedi	None
sinirlendireceksin	None
sonuç	Nominative
almanak	Nominative
unuturlar	None
zamanınız	Nominative
bürokratlar	Nominative
bütünlerime	Dative
serçenin	Genitive
panteist	Nominative
ayrılmaların	Genitive
sitede	Locative
bulmuyordu	None
çağırıyorlar	None
cevaplarınızı	Accusative
inciydim	None
skrotum	Nominative
dakikayı	Accusative
canlandırtıyorsun	None
emlakçılarımı	Accusative
limonda	Locative
karanlıkların	Genitive
kırışıklıklarınızın	Genitive
tanımıyordum	None
erdemli	None
mevkilere	Dative
sıpalarım	Nominative
şivesinin	Genitive
ustam	Nominative
kurabiyeleri	Accusative
geziyorum	None
yeterliklerinizi	Accusative
çıplaklık	Nominative
müzisyenimizin	Genitive
ayakkabıcı	Nominative
çökeltide	Locative
konferanslara	Dative
cemaatte	Locative
rokette	Locative
bölümlerden	Ablative
pehlivandı	None
Tiranlıyım	None
yerden	Ablative
oyunuzun	Genitive
ambulans	Nominative
sürgünde	Locative
avantaja	Dative
duydun	None
siklerinizi	Accusative
konarlar	None
bakıyordum	None
mistiğinizi	Accusative
kestirmelerinizden	Ablative
kırıklara	Dative
teşkilatta	Locative
açlıktan	Ablative
kullanacağız	None
virgülünüzde	Locative
dövdüler	None
yumurtanızı	Accusative
geçmeyecek	None
havuz	Nominative
düğünlerimizde	Locative
çalışmıyorum	None
eşofmanlarınızı	Accusative
döktüler	None
lunaparklarmışsın	None
dağlı	Nominative
işkence	Nominative
zurnana	Dative
silahıma	Dative
yapmadan	Ablative
sunulurlar	None
şikâyetlere	Dative
kapamayacaksınız	None
duymasından	Ablative
satmadı	None
bağlar	Nominative
bilirsiniz	None
duyacağız	None
koyuyorlar	None
tuvaletten	Ablative
dirseklere	Dative
fok	Nominative
gırtlağa	Dative
alfabeleri	Accusative
iskeletin	Genitive
taneye	Dative
bugünlerim	Nominative
okiyamızdan	Ablative
hazırlıktan	Ablative
kötüleşir	None
tepkime	Nominative
dolmuşlarımda	Locative
yardımcıdan	Ablative
tabancası	Nominative
eriyecek	None
tercihinize	Dative
süse	Dative
süngünün	Genitive
parçacıklarda	Locative
uzaklara	Dative
ölüyordu	None
ilişkilerimizi	Accusative
buzdolabına	Dative
diziye	Dative
belediyesi	Nominative
bitkisine	Dative
soğurlar	None
erkeceysiniz	None
sustum	None
toplumlarda	Locative
havuçlarınızdan	Ablative
kimliğimizden	Ablative
örnekmişler	None
çoraplarımızı	Accusative
kıstı	None
kıl	Nominative
teorilere	Dative
alkolleri	Accusative
huzurum	Nominative
soğanımız	Nominative
takvimlerdim	None
raketler	Nominative
yaya	Nominative
cisimlerdir	None
bisküvilerde	Locative
yarasına	Dative
kıyılardan	Ablative
şalvarlar	Nominative
çizgisi	Nominative
baygınlıklarınızda	Locative
korkuyordu	None
yaraya	Dative
deneyiniz	Nominative
mağarasından	Ablative
öpüşürler	None
kinematiği	Accusative
ortalarımdan	Ablative
geçiniyordu	None
neşeden	Ablative
korse	Nominative
satmaz	None
vermem	None
müzikalde	Locative
nefretlerinizden	Ablative
yoldaşım	Nominative
zamanımız	Nominative
gizlenmediniz	None
dolacak	None
taşıyorlardı	None
orman	Nominative
tiyatrolarda	Locative
karantinaya	Dative
aygıta	Dative
tekliften	Ablative
kovalar	Nominative
dondurmada	Locative
çıkmıyoruz	None
araçlarımıza	Dative
bulunuyorsun	None
kantolar	Nominative
kâbus	Nominative
yazıları	Accusative
savaşçılardı	None
klostrofobi	Nominative
vurguyu	Accusative
müstahdemmişsiniz	None
düdükte	Locative
takıyor	None
aleminize	Dative
kaşır	None
büyüdük	None
fiilin	Genitive
uzaklardan	Ablative
çarşılarınızın	Genitive
hedeflerde	Locative
kanıtladı	None
direk	Nominative
oynamıyoruz	None
şapkacılarız	None
yapması	Nominative
parçacığa	Dative
çözeltisinden	Ablative
biter	None
basarım	None
kumaşa	Dative
kolye	Nominative
şişer	None
boşandı	None
geçmez	None
ördü	None
ülkeye	Dative
ikazsınız	None
bilgisine	Dative
zavar	Nominative
ölçtürteceğim	None
sürdürülebilirliği	Accusative
üren	Nominative
görüntüyü	Accusative
doğruyuz	None
kullanımda	Locative
inanırsın	None
yorumlarınızı	Accusative
hikâyeler	Nominative
fren	Nominative
bakirelerimizi	Accusative
gezmezler	None
güvercinim	Nominative
yörüngesi	Nominative
ön	Nominative
uğratılacak	None
dalgalanır	None
tarife	Dative
satrançta	Locative
günahtan	Ablative
akraba	Nominative
iğneyi	Accusative
noktalardır	None
arıyorlar	None
sürülecek	None
çıkacaklar	None
şuurlarımızın	Genitive
eceler	Nominative
yaratmıyor	None
öldürmez	None
hikayelere	Dative
atıldı	None
sancağa	Dative
dedelerden	Ablative
pandanın	Genitive
demircisi	Nominative
sağduyuyu	Accusative
son	Nominative
seçiyorum	None
heyecanlar	Nominative
kazan	Nominative
dağılırlar	None
politikacılar	Nominative
halılarda	Locative
alevde	Locative
kapaktık	None
ovar	None
vaktimiz	Nominative
dedikoduyu	Accusative
ailede	Locative
oldunuz	None
getiriyoruz	None
piramitlerden	Ablative
yayıyor	None
günümüzden	Ablative
çökerler	None
denilmez	None
hastalanmıyoruz	None
avcımızdan	Ablative
arayüzde	Locative
tarakların	Genitive
soğanınızdan	Ablative
fondöten	Nominative
kavunmuşum	None
oturduk	None
sürüyordu	None
travmalardan	Ablative
dilmediniz	None
haç	Nominative
olmadım	None
binlerden	Ablative
gökadaların	Genitive
bakmıyorlar	None
kapılarda	Locative
uyarınız	Nominative
mikroorganizma	Nominative
savaşçılarımızda	Locative
taslaklara	Dative
avizesi	Nominative
boşalıyor	None
yağarım	None
pişiyorum	None
model	Nominative
doymaz	None
şehirde	Locative
finalden	Ablative
cezve	Nominative
dönüşümde	Locative
cezeryemi	Accusative
verildi	None
kanıtlar	None
girdi	None
bükmene	Dative
yazması	Nominative
giysiye	Dative
akımı	Accusative
kolonlardan	Ablative
dakikamıza	Dative
yetkilerde	Locative
istemcisinin	Genitive
ünsüzlere	Dative
pelikanlardım	None
eğlenirim	None
milimetreye	Dative
solucanlarmış	None
işçisinin	Genitive
hamburgerimin	Genitive
jölesi	Nominative
izolasyonumuzu	Accusative
silmedim	None
minber	Nominative
hançer	Nominative
yonga	Nominative
asansörün	Genitive
sancaktan	Ablative
ortaklıkta	Locative
satılmaz	None
algoritmasından	Ablative
ünlüyü	Accusative
uzağa	Dative
topluluklardınız	None
tavernası	Nominative
korunmaya	Dative
zürriyetinizin	Genitive
oyuncularımız	Nominative
sahneyi	Accusative
lügatte	Locative
yakan	Nominative
piramitlerin	Genitive
nekrofili	Accusative
durumunuz	Nominative
somu	Accusative
içeriyor	None
gitmesine	Dative
bitkilerimizden	Ablative
parçalanması	Nominative
evlendik	None
vasat	None
köygöçürenimi	Accusative
ünlülerden	Ablative
çağırıyordu	None
tutmuyordu	None
savunuyorlardı	None
sigaraların	Genitive
tundraymışsınız	None
çalgıcılar	Nominative
basımda	Locative
parlatıcım	Nominative
botaniklerin	Genitive
yarışlarda	Locative
baya	Dative
kâse	Nominative
çılgınlığın	Genitive
prensipler	Nominative
ipekten	Ablative
kazakları	Accusative
yapacaksınız	None
oydan	Ablative
bekliyor	None
ıspanaktan	Ablative
sürüngenler	Nominative
artıklarınızın	Genitive
bulgurumuzdan	Ablative
varırlar	None
sitemize	Dative
trigonometri	Nominative
dinlenmeye	Dative
daldırmazsınız	None
yapmayı	Accusative
narkotik	Nominative
kazın	Nominative
işgücünde	Locative
dilek	Nominative
taşıyorsun	None
otostoplarımdan	Ablative
boğanın	Genitive
yıpranır	None
tipografyamızın	Genitive
oluyorum	None
şehvet	Nominative
filimin	Genitive
tasalarınızın	Genitive
öğreneceğiz	None
algoritmadan	Ablative
garsona	Dative
noktürnümüzden	Ablative
bölgesinin	Genitive
geçiyordum	None
eşyamdan	Ablative
bok	Nominative
enerjilerin	Genitive
integral	Nominative
toplarda	Locative
öküzsünüz	None
sunmaz	None
helikopterler	Nominative
sonlara	Dative
yetişiyordu	None
seviyoruz	None
mısırda	Locative
kaset	Nominative
dediler	None
çoraplar	Nominative
verimsizleştiriyorlardı	None
liseleri	Accusative
minaresinde	Locative
koleje	Dative
şovlara	Dative
sevgilisi	Nominative
şovda	Locative
konusun	None
topluluklardan	Ablative
anlatmıyor	None
bağlardır	None
votkalarımı	Accusative
yasasından	Ablative
bilmezsin	None
yetiştirdiler	None
denilecek	None
kıyımın	Genitive
temizlerim	None
çiller	Nominative
iskelet	Nominative
yayıyorum	None
ağaçlar	Nominative
tundralardınız	None
teklifim	Nominative
çizgisinin	Genitive
ipek	Nominative
sezer	None
çarşıyı	Accusative
çalıştık	None
politikada	Locative
abartır	None
aygıtta	Locative
çevirdi	None
iyileşmezsiniz	None
koşuluyorum	None
yazıyordum	None
gösterir	None
yüzeyden	Ablative
güvercinlersiniz	None
çözeltimize	Dative
kedisine	Dative
inanıyorlar	None
cumhur	Nominative
işletme	Nominative
telaffuzda	Locative
kataloğunuzun	Genitive
yoldan	Ablative
simya	Nominative
sürücülerimin	Genitive
kovulduk	None
dilberinizi	Accusative
protestosu	Nominative
aydınlıktan	Ablative
sökerler	None
aşirette	Locative
boğazda	Locative
saptı	None
inlerim	Nominative
oğlunuz	Nominative
kullanmama	Dative
bildiriyorlar	None
kurulda	Locative
kızar	None
ibneleriz	None
sığacak	None
kavramlarımda	Locative
değiştirmeyecek	None
günde	Locative
ura	Dative
kayak	Nominative
gözyaşı	Nominative
tekrarlar	Nominative
karşılar	Nominative
helikopterlerde	Locative
sürüler	Nominative
dağıtımda	Locative
istemem	None
çevrelerde	Locative
çalışmanızı	Accusative
cihazlardan	Ablative
civcivin	Genitive
göçten	Ablative
sihirbazınızdan	Ablative
yapraklara	Dative
lokantalarda	Locative
yasaklara	Dative
geyşalarımızın	Genitive
şortlar	Nominative
söktüler	None
biliyorlar	None
batısını	Accusative
izleyicilere	Dative
şekerpare	Nominative
pencereyi	Accusative
hızlarınızdan	Ablative
doğusu	Nominative
kıyamette	Locative
çıktım	Nominative
kunduzlarımda	Locative
alet	Nominative
kuvvetlilik	Nominative
nazende	Locative
bağcıklarınıza	Dative
ulamımıza	Dative
gebermedik	None
ömre	Dative
sonlarımın	Genitive
yapmıyorsun	None
eşyayı	Accusative
kütük	Nominative
kelimelerdir	None
öğrencim	Nominative
odakta	Locative
yaklaşır	None
parabollerinizi	Accusative
bitirdim	None
yapmamız	Nominative
çalışmıyordu	None
kalmayız	None
yongalar	Nominative
kitabesinde	Locative
vermeyecek	None
uzaya	Dative
yalvardı	None
cenazesine	Dative
turşular	Nominative
yoldaşız	None
pasif	None
Musevilerimin	Genitive
savaşçıdan	Ablative
alacakaranlıktan	Ablative
doğurmaz	None
temsilci	Nominative
gülünçleşti	None
düşünürsün	None
yumurtalara	Dative
sonbaharlarım	Nominative
öğretilerde	Locative
koyacağım	None
kitabelere	Dative
mısrada	Locative
dersim	Nominative
pırasalarımdan	Ablative
söyleşiler	Nominative
âmâsınız	None
oligarşinin	Genitive
devirdiler	None
cesetlerin	Genitive
sunuyorsunuz	None
yörüngesinde	Locative
bürokratları	Accusative
sirkte	Locative
fakültemizde	Locative
vurdular	None
yönelimler	Nominative
geciktirir	None
tıklıyorum	None
kalın	Nominative
evlenecek	None
çiziyorlardı	None
çamdan	Ablative
dizinde	Locative
yapmayacak	None
külahlarımdan	Ablative
bağladım	None
keçiden	Ablative
sevmez	None
seçmeye	Dative
kızanda	Locative
otoculuklarmışsınız	None
bilmezsiniz	None
yapışmasını	Accusative
manitadan	Ablative
dedikoducu	Nominative
derleyiciler	Nominative
ilişkim	Nominative
yumuşakçalardan	Ablative
kullanıcılardır	None
üyeliğim	Nominative
fortlıyorlar	None
sesleniyoruz	None
asmadın	None
final	Nominative
vibratörlerden	Ablative
borç	Nominative
sisten	Ablative
şehirlerimizin	Genitive
örs	Nominative
dergi	Nominative
strüktürümden	Ablative
cevaplarımı	Accusative
kışkırttılar	None
istemciyi	Accusative
uzaylıya	Dative
tutarım	None
ahizen	Nominative
terapistlerimin	Genitive
evrime	Dative
kapılar	Nominative
dağıtıma	Dative
koydum	None
fundalar	Nominative
sakinleriniz	Nominative
yörüngelerimizde	Locative
görüşünüz	Nominative
direrler	None
geçmeniz	Nominative
şelalelerimi	Accusative
binecek	None
yazmada	Locative
konserlerde	Locative
nargilelerinizden	Ablative
akına	Dative
müzisyeninizden	Ablative
eğrinin	Genitive
içiyorlardı	None
romandan	Ablative
avınızda	Locative
ablalarmışsınız	None
bütünlerinizde	Locative
uymadılar	None
gökadada	Locative
silindirlerde	Locative
yaramazlar	None
hatalara	Dative
arıyordum	None
sermiyorduk	None
piknikte	Locative
keçilere	Dative
seyahatlerde	Locative
oyumun	Genitive
düzelmez	None
yerimiz	Nominative
düşüneceğim	None
durdu	None
takarlar	None
coşmayacaklar	None
şarkıcılarda	Locative
davranıyorum	None
desenime	Dative
çeteye	Dative
peçetelerdi	None
gazetesinden	Ablative
yolunduruyorum	None
koleksiyonlar	Nominative
sıkıntıda	Locative
rüyası	Nominative
düşmanlarınızı	Accusative
aşlarımdan	Ablative
dışkısını	Accusative
çalıyordum	None
lazer	Nominative
dadanır	None
gösterdiler	None
konuyordu	None
yetkisine	Dative
üretiyordu	None
ibne	Nominative
büyüklükten	Ablative
dişçi	Nominative
sürpriz	Nominative
şikayete	Dative
derneğimizin	Genitive
mümessillerinizi	Accusative
pijamadan	Ablative
sıvılardan	Ablative
gelmiyordum	None
donatımlarınızdan	Ablative
odunların	Genitive
yarıştan	Ablative
karısı	Nominative
dükkânlardık	None
dergisinin	Genitive
alıcımızı	Accusative
düğünlerde	Locative
sararır	None
verilirler	None
özel	None
kırıntıda	Locative
getirmez	None
eşekten	Ablative
bacada	Locative
uçurtmalar	Nominative
hudutta	Locative
alıyorum	None
susmadınız	None
inandık	None
yarattılar	None
kıyıdan	Ablative
rehberler	Nominative
korkuttu	None
orfoza	Dative
mevkinde	Locative
gösterirler	None
beklemiyorum	None
hastamı	Accusative
yolunduruyor	None
yarışlar	Nominative
edat	Nominative
patlar	None
maman	Nominative
yedirir	None
bataryayı	Accusative
soyludan	Ablative
sorumluluğumuz	Nominative
sürtüğünüzü	Accusative
getiriyor	None
eğriye	Dative
askıda	Locative
dullar	Nominative
dövüşürler	None
katılıyor	None
belediyesini	Accusative
helvalar	Nominative
üzülecek	None
çıkardın	None
zorluklardan	Ablative
ünsüzleri	Accusative
dönemlerden	Ablative
mağaralardan	Ablative
dalgalara	Dative
işlerim	None
seriyor	None
kesmedi	None
sonbaharımızda	Locative
geliniyor	None
dövüyordu	None
otoculuktunuz	None
anlatacağım	None
ünlülerin	Genitive
ayırmaz	None
istiyordu	None
kullanıcım	Nominative
demircisine	Dative
köprünün	Genitive
kullanıyorsunuz	None
gizem	Nominative
eğlencesi	Nominative
arşivi	Accusative
teoreme	Dative
açıldılar	None
