по-акуратно	Adjective
нощите	Noun
дълбока	Adjective
разрешително	Noun
леките	Adjective
старото	Adjective
изковават	Verb
баклавата	Noun
ухапала	Participle
момата	Noun
забранявам	Verb
бедната	Adjective
побеждавам	Verb
изпредена	Participle
ключът	Noun
озаглавяващият	Participle
боята	Noun
ябълкова	Adjective
изчезвалата	Participle
безделничил	Participle
причиняване	Masdar
ангеле	Noun
екзархът	Noun
желал	Participle
гребния	Adjective
предскажат	Verb
произнасян	Participle
безгрижна	Adjective
лисугере	Noun
боядисващото	Participle
яжте	Verb
мрат	Verb
пречупване	Masdar
наказаните	Participle
ряпа	Noun
зъболекарските	Adjective
делят	Verb
разнесъл	Participle
обезглавявалата	Participle
най-анархичната	Adjective
бедуинка	Noun
монахо	Noun
прясно	Adjective
документите	Noun
най-внимателният	Adjective
пишели	Participle
спираме	Verb
припряна	Participle
преживените	Participle
жабокът	Noun
назовавано	Participle
студентът	Noun
изреченията	Noun
сядам	Verb
простор	Noun
допирането	Masdar
сестрата	Noun
отхапеш	Verb
ансамбълът	Noun
живееща	Participle
запалим	Verb
врагът	Noun
най-неголямото	Adjective
плашат	Verb
срещаното	Participle
създам	Verb
бия	Verb
срещам	Verb
дадат	Verb
искате	Verb
парадоксът	Noun
наричането	Masdar
турския	Adjective
най-реалистичният	Adjective
четен	Participle
западния	Adjective
заслужено	Participle
губили	Participle
вестникът	Noun
дебелеещо	Participle
ходещи	Participle
шеста	Adjective
невярващ	Adjective
патриарх	Noun
обесил	Participle
продължен	Participle
калинка	Noun
калфа	Noun
бившата	Adjective
пепелта	Noun
ограничените	Participle
уволнявам	Verb
нанасяме	Verb
ям	Verb
копче	Noun
повтарящи	Participle
наеме	Verb
пиел	Participle
телето	Noun
причиняваща	Participle
алтернативата	Noun
построяват	Verb
дързък	Adjective
нанасяте	Verb
лягам	Verb
животът	Noun
железният	Adjective
улицата	Noun
метели	Participle
клинът	Noun
гребните	Adjective
изкупуваща	Participle
навеждайте	Verb
по-съвременна	Adjective
обичалата	Participle
пътуват	Verb
правене	Masdar
тераметъра	Noun
полудяват	Verb
преведох	Verb
бъбреците	Noun
пратено	Participle
комбиниран	Participle
агрономите	Noun
висш	Adjective
наричайте	Verb
дъщерите	Noun
сядай	Verb
най-сериозното	Adjective
азалията	Noun
патката	Noun
час	Noun
набожните	Adjective
въоръженият	Participle
играл	Participle
испанският	Adjective
забраняващ	Participle
заплашила	Participle
интересните	Adjective
съчетана	Participle
по-ягодовият	Adjective
период	Noun
обещаващата	Participle
джуджета	Noun
решаващ	Participle
абсорбиран	Participle
снесеният	Participle
говорейки	Converb
избран	Participle
кървящи	Participle
решителен	Adjective
заплашван	Participle
обичано	Participle
побеждавани	Participle
оцелели	Participle
въвираните	Participle
презираната	Participle
посетено	Participle
въоръжения	Participle
ограничаваме	Verb
свръхестествено	Adjective
унищожената	Participle
високата	Adjective
четяха	Verb
охраняващ	Participle
делфин	Noun
победиш	Verb
различния	Adjective
строил	Participle
преподавателската	Adjective
извеждане	Masdar
обичаният	Participle
авиаторско	Adjective
по-авангардния	Adjective
разнеслите	Participle
ядох	Verb
голяма	Adjective
аморфно	Adjective
шантажиращо	Participle
пикаещите	Participle
презрени	Participle
самолетите	Noun
автомагистралата	Noun
изпечено	Participle
четения-нета	Masdar
корени	Participle
избодяхте	Verb
препоръчаните	Participle
чуваме	Verb
австрийския	Adjective
кирпич	Noun
избирана	Participle
заспала	Participle
четени	Participle
забравил	Participle
барометърът	Noun
кръвта	Noun
причинявана	Participle
припадат	Verb
адекватното	Adjective
изнудвания	Participle
арбитрите	Noun
засечен	Participle
най-модерна	Adjective
чучулигите	Noun
разходете	Verb
отровното	Adjective
поизмитащи	Participle
посетете	Verb
търсела	Participle
пречупваща	Participle
желая	Verb
изпитате	Verb
подкладяхте	Verb
отнесъл	Participle
изнесла	Participle
домитаното	Participle
наобличаме	Verb
губил	Participle
подведох	Verb
безмилостно	Adjective
докторите	Noun
по-адекватен	Adjective
отварящия	Participle
решихме	Verb
грешащите	Participle
даваща	Participle
сядането	Masdar
тревите	Noun
стадионът	Noun
радеехме	Verb
дръзките	Adjective
треторазреден	Adjective
адвентист	Noun
наранил	Participle
продължило	Participle
приятелко	Noun
загребващата	Participle
отчетат	Verb
авторитарната	Adjective
потушилия	Participle
започвам	Verb
казано	Participle
югоизточното	Adjective
лястовицата	Noun
славните	Adjective
по-злата	Adjective
донасяйки	Converb
по-дръзкият	Adjective
автомотрисата	Noun
най-сатанистичния	Adjective
посетените	Participle
мъртъв	Adjective
презираш	Verb
бушуващата	Participle
съобщаващ	Participle
целуваш	Verb
назоваването	Masdar
близичка	Adjective
любителска	Adjective
ограничил	Participle
архаизмите	Noun
убиващ	Participle
извлечем	Verb
продаван	Participle
тясното	Adjective
довела	Participle
изпичането	Masdar
авиационната	Adjective
съгласен	Adjective
произнасянето	Masdar
бити	Participle
протичащите	Participle
излизащ	Participle
архаичен	Adjective
спре	Verb
англичанката	Noun
писателските	Adjective
преживяват	Verb
земетръсна	Adjective
говорещият	Participle
наследяващата	Participle
арсеналите	Noun
цените	Noun
сръндак	Noun
пепелниците	Noun
аборигенските	Adjective
чавко	Noun
месата	Noun
изпасяхте	Verb
пъпеш	Noun
дай	Verb
бастунът	Noun
недостатъчното	Adjective
най-бесният	Adjective
врящата	Participle
аналозите	Noun
автоматичното	Adjective
лижат	Verb
силното	Adjective
дебелия	Adjective
въвре	Verb
умри	Verb
забраненият	Participle
удовлетворяването	Masdar
токсична	Adjective
важната	Adjective
абхазките	Adjective
можахме	Verb
допринасящото	Participle
автогара	Noun
търтеите	Noun
четвъртият	Adjective
сияещ	Participle
зърна	Noun
започващите	Participle
получа	Verb
сериозният	Adjective
изревавалата	Participle
абсурдните	Adjective
яйца	Noun
живяната	Participle
насмела	Participle
лекарското	Adjective
лихва	Noun
пишел	Participle
преведем	Verb
аго	Noun
второ	Adjective
автомобилът	Noun
границата	Noun
балканският	Adjective
казаха	Verb
изкупувате	Verb
доказването	Masdar
домовете	Noun
времена	Noun
ухапано	Participle
апарат	Noun
отчети	Verb
добър	Adjective
осиновяванията-нетата	Masdar
активистите	Noun
различен	Adjective
по-уклончивата	Adjective
балканско	Adjective
топло	Adjective
затрисайки	Converb
пресният	Adjective
наричай	Verb
припадайте	Verb
по-старателният	Adjective
плътна	Adjective
отсичане	Masdar
пчелояд	Noun
целувалия	Participle
вате	Noun
атинянката	Noun
отключена	Participle
най-второразредните	Adjective
горящият	Participle
мечоко	Noun
озаглавяване	Masdar
ползваме	Verb
кожите	Noun
подкупили	Participle
вертикалния	Adjective
брезата	Noun
белодробният	Adjective
желязото	Noun
бързото	Adjective
авторитарния	Adjective
победя	Verb
чуя	Verb
ограничили	Participle
аларма	Noun
закуско	Noun
язовец	Noun
най-македонската	Adjective
създаващите	Participle
полудяла	Participle
могъл	Participle
подобрявани	Participle
уплашилия	Participle
оскъдния	Adjective
щастлива	Adjective
немския	Adjective
отключването	Masdar
предупредил	Participle
помитащото	Participle
предскажем	Verb
удовлетворен	Participle
археоложката	Noun
забранила	Participle
помитане	Masdar
болница	Noun
кралско	Adjective
живот	Noun
зачитането	Masdar
безбожието	Noun
самоваре	Noun
омитащата	Participle
четяща	Participle
правителствен	Adjective
отличен	Adjective
получавайки	Converb
използващият	Participle
порнографско	Adjective
спиралата	Participle
бесел	Participle
порнография	Noun
допиране	Masdar
по-прекрасните	Adjective
принуждаване	Masdar
обещана	Participle
сабя	Noun
ален	Adjective
автоматичната	Adjective
сладкото	Adjective
пчелар	Noun
авангардния	Adjective
очакващия	Participle
спасяването	Masdar
пренесли	Participle
писателят	Noun
по-благородният	Adjective
помагането	Masdar
арменката	Noun
изсечени	Participle
най-лекарската	Adjective
станалото	Participle
каците	Noun
ползвам	Verb
тесто	Noun
тъжен	Adjective
загиването	Masdar
разпростиращи	Participle
кралска	Adjective
брашното	Noun
ухапвания	Participle
безмилостен	Adjective
изкупилата	Participle
враните	Noun
чудо	Noun
унищоженото	Participle
горящите	Participle
гласувания	Participle
обещавайки	Converb
верния	Adjective
змиорките	Noun
съзирайте	Verb
северното	Adjective
действията	Noun
режещите	Participle
агенцията	Noun
биещи	Participle
отбодоха	Verb
удовлетворяващи	Participle
провиране	Masdar
по-подробното	Adjective
довеждалата	Participle
донесен	Participle
допрочелият	Participle
несериозен	Adjective
северозападното	Adjective
шофьорите	Noun
здравите	Adjective
арменския	Adjective
отмирането	Masdar
аплодирания-нета	Masdar
студентско	Adjective
предричалият	Participle
агенциите	Noun
мечтал	Participle
сложен	Adjective
винила	Participle
получило	Participle
обосноваване	Masdar
решаващия	Participle
пеела	Participle
ядосан	Adjective
продаваното	Participle
лельо	Noun
кучка	Noun
решаване	Masdar
допрочетем	Verb
учителското	Adjective
съзирания-нета	Masdar
разнасяне	Masdar
зайко	Noun
прощаваме	Verb
ухапването	Masdar
бабата	Noun
подмяна	Noun
най-ученическа	Adjective
най-анално	Adjective
насечените	Participle
унищожавано	Participle
усърдно	Adjective
вземай	Verb
птицата	Noun
срещалият	Participle
обяснят	Verb
подпиращата	Participle
учех	Verb
ближи	Verb
коляно	Noun
банкрут	Noun
слънцето	Noun
свещник	Noun
веществения	Adjective
аналитичен	Adjective
астролог	Noun
камилата	Noun
изпитват	Verb
корабите	Noun
отнасяща	Participle
желано	Participle
разходен	Participle
наводнят	Verb
докторска	Adjective
ръката	Noun
азотно	Adjective
кралице	Noun
вероятност	Noun
купувана	Participle
влезеш	Verb
почваме	Verb
виждана	Participle
пращам	Verb
наследяват	Verb
пейзажът	Noun
автентичната	Adjective
ограничаваните	Participle
охраняваните	Participle
авторитетите	Noun
агитатор	Noun
нагребвалото	Participle
отвеждащи	Participle
хепатална	Adjective
сечащата	Participle
даден	Participle
глобявайки	Converb
бавен	Adjective
нагребващо	Participle
авантюристична	Adjective
влажен	Adjective
говорещо	Participle
пулмоналното	Adjective
най-студентският	Adjective
горилия	Participle
наричащи	Participle
писах	Verb
закупувалия	Participle
дадох	Verb
къртицата	Noun
енергичния	Adjective
разходят	Verb
възможния	Adjective
питие	Noun
спират	Verb
акордът	Noun
бягащи	Participle
препоръчвани	Participle
най-авторитетен	Adjective
абсорбирана	Participle
чуват	Verb
запалени	Participle
серните	Adjective
плащаш	Verb
очните	Adjective
отсякохме	Verb
окрадвалия	Participle
създадено	Participle
по-аборигенското	Adjective
сладкият	Adjective
зебрите	Noun
отнасянето	Masdar
срещаща	Participle
азотната	Adjective
извличайки	Converb
изобретателка	Noun
джуджето	Noun
разберат	Verb
разбере	Verb
поизмитащото	Participle
мярката	Noun
коноп	Noun
авторитарна	Adjective
купюрът	Noun
влажният	Adjective
пратят	Verb
главоного	Noun
изплашена	Participle
отворел	Participle
водна	Adjective
победят	Verb
австриецът	Noun
инфантилен	Adjective
модерен	Adjective
цариците	Noun
обсъждам	Verb
наследени	Participle
пишещия	Participle
абата	Noun
размяна	Noun
ограничавано	Participle
снахите	Noun
вдишалите	Participle
инфекция	Noun
изговарят	Verb
арестуваният	Participle
по-сръчните	Adjective
най-съвършен	Adjective
отсечеш	Verb
ясните	Adjective
лятното	Adjective
кадърен	Adjective
спрян	Participle
амнистиите	Noun
вертикалният	Adjective
плачеща	Participle
разумната	Adjective
глухоням	Adjective
пълните	Adjective
гърцизмите	Noun
насечени	Participle
абразивно	Adjective
спасения	Participle
удовлетворяват	Verb
обичаш	Verb
сънуващия	Participle
набождам	Verb
болничка	Adjective
италианското	Adjective
цвете	Noun
чайката	Noun
ненадежден	Adjective
карто	Noun
уплашваната	Participle
апетитите	Noun
произнасяна	Participle
античните	Adjective
разбера	Verb
бясно	Adjective
сянката	Noun
адекватно	Adjective
разбирано	Participle
продължилият	Participle
анатомичните	Adjective
отровата	Noun
чантата	Noun
пикаейки	Converb
забравен	Participle
забравяйте	Verb
лекар	Noun
мишката	Noun
злите	Adjective
построявалата	Participle
коса	Noun
алкохолната	Adjective
обзавеждащ	Participle
искрено	Adjective
гласуваме	Verb
несериозните	Adjective
северен	Adjective
понеса	Verb
разлюбен	Participle
кървяща	Participle
белята	Noun
четохме	Verb
грижливо	Adjective
озаглавени	Participle
кървене	Masdar
апетитна	Adjective
хлябовете	Noun
чешката	Adjective
пратя	Verb
пометен	Participle
медицинските	Adjective
помагащ	Participle
изнесъл	Participle
плътното	Adjective
по-несръчна	Adjective
пътуващия	Participle
аристокрация	Noun
най-агрегатния	Adjective
обяснило	Participle
обезглавяващо	Participle
препечените	Participle
привнесохме	Verb
най-северняшката	Adjective
учещия	Participle
бродовете	Noun
разхождащо	Participle
наводнявано	Participle
алуминиева	Adjective
най-азотна	Adjective
августовска	Adjective
мразели	Participle
отнесоха	Verb
продаваме	Verb
отварянията-нетата	Masdar
картите	Noun
най-алуминиевата	Adjective
унесено	Participle
комето	Noun
морков	Noun
часовниците	Noun
играеш	Verb
зареждащ	Participle
разпростирането	Masdar
сърдит	Adjective
убиха	Verb
извлечените	Participle
сиренето	Noun
чакате	Verb
заплетен	Participle
скучния	Adjective
отечахте	Verb
коремна	Adjective
изораваната	Participle
досадните	Adjective
допека	Verb
дадено	Participle
преживяването	Masdar
най-дебела	Adjective
грабещи	Participle
най-безскрупулния	Adjective
господарувалия	Participle
разбиран	Participle
по-лилава	Adjective
по-отличната	Adjective
даваните	Participle
мразени	Participle
най-мускулна	Adjective
визо	Noun
чужденка	Noun
прегърналите	Participle
светлосянка	Noun
кошът	Noun
обсъждания	Participle
гений	Noun
произтичате	Verb
швейцарска	Adjective
южняк	Noun
отвесно	Adjective
най-неразсъдителното	Adjective
абониране	Noun
фонемите	Noun
ферибот	Noun
животните	Noun
нанасяйки	Converb
най-неумелите	Adjective
водната	Adjective
крадели	Participle
абстрактен	Adjective
занасяния-нета	Masdar
лекарската	Adjective
допринасят	Verb
ставайки	Converb
слабите	Adjective
по-ненадеждна	Adjective
потушаване	Masdar
риба	Noun
зебрата	Noun
доловете	Noun
атомите	Noun
отнасящ	Participle
одобрили	Participle
изнудела	Participle
тежка	Adjective
магариците	Noun
искрената	Adjective
играем	Verb
изсичаното	Participle
наричаме	Verb
акорд	Noun
пуйките	Noun
лесбийка	Noun
огледала	Noun
блага	Adjective
заплели	Participle
принудена	Participle
бедро	Noun
бързо	Adjective
небесносините	Adjective
пикометър	Noun
части	Noun
ограничиш	Verb
мускулестия	Adjective
суграшица	Noun
привнеслия	Participle
обичайки	Converb
продаване	Masdar
обещаха	Verb
обвинявайки	Converb
абатските	Adjective
молещи	Participle
узаконят	Verb
отрекат	Verb
бяганията-нетата	Masdar
гоблин	Noun
слаб	Adjective
майка	Noun
сечене	Masdar
годината	Noun
адвокат	Noun
срещане	Masdar
видрата	Noun
отмирай	Verb
паси	Verb
различната	Adjective
веригите	Noun
посетят	Verb
простилият	Participle
крако	Noun
вярвайки	Converb
обсъдихме	Verb
хоризонтален	Adjective
протекли	Participle
най-предпазливия	Adjective
слончето	Noun
затекло	Participle
принуден	Participle
античен	Adjective
по-второразрядно	Adjective
проповедта	Noun
пуяк	Noun
съществуват	Verb
красавецът	Noun
серен	Adjective
абаносовият	Adjective
германските	Adjective
сръбските	Adjective
вещите	Adjective
телефониралите	Participle
забодените	Participle
агрегатна	Adjective
най-лекомислените	Adjective
пшеницата	Noun
тревата	Noun
наричат	Verb
гръдно	Adjective
забраняващия	Participle
зелена	Adjective
принудиха	Verb
пеещият	Participle
непрякото	Adjective
ометохме	Verb
майчица	Noun
вековете	Noun
гъзовете	Noun
балканска	Adjective
наводнявай	Verb
опитните	Adjective
купиш	Verb
изричащото	Participle
абонаментното	Adjective
плачат	Verb
мъдра	Adjective
виц	Noun
обучаваща	Participle
правя	Verb
ограничаваща	Participle
туркиня	Noun
черешата	Noun
писателския	Adjective
шведският	Adjective
курвата	Noun
четена	Participle
наследилия	Participle
навлизам	Verb
спестиш	Verb
азбучна	Adjective
изпивани	Participle
попитана	Participle
продавайки	Converb
евтината	Adjective
очистително	Noun
архитектуро	Noun
наказание	Noun
пътувалото	Participle
пето	Adjective
говорещото	Participle
отчитаме	Verb
донесените	Participle
опасения	Participle
гладните	Adjective
наказване	Masdar
крокодилите	Noun
ядете	Verb
чанта	Noun
бедствията	Noun
политико	Noun
надонасялият	Participle
питалият	Participle
медицинският	Adjective
вероятен	Adjective
ял	Participle
австралийка	Noun
изнесоха	Verb
играх	Verb
даването	Masdar
астроложка	Noun
вървите	Noun
биещо	Participle
близка	Adjective
най-лековерния	Adjective
несъмнен	Adjective
растението	Noun
най-висша	Adjective
избрал	Participle
подвеждаме	Verb
плешивата	Adjective
антена	Noun
предупреждаван	Participle
спиращи	Participle
най-ананасовата	Adjective
станът	Noun
сладка	Adjective
оцветявания	Participle
заредените	Participle
гребната	Adjective
играло	Participle
северозападните	Adjective
узаконявани	Participle
ябълките	Noun
капак	Noun
изречено	Participle
близано	Participle
правените	Participle
злоупотребявайте	Verb
срещалата	Participle
неразумния	Adjective
перпендикулярното	Adjective
бедуин	Noun
купили	Participle
най-модерният	Adjective
учите	Verb
значителните	Adjective
практична	Adjective
чистите	Adjective
мястото	Noun
бавната	Adjective
век	Noun
произтичащ	Participle
понесъл	Participle
широките	Adjective
по-агрегатното	Adjective
по-компетентен	Adjective
съществувалия	Participle
наречеш	Verb
пристигналите	Participle
прозре	Verb
отсъствай	Verb
евнухът	Noun
въоръжаван	Participle
абисинското	Adjective
обезглавяването	Masdar
бистър	Adjective
посетим	Verb
завлечен	Participle
живяла	Participle
пречупена	Participle
бедуините	Noun
вождовете	Noun
лесният	Adjective
важна	Adjective
значителна	Adjective
пълния	Adjective
див	Adjective
другата	Adjective
авторитетно	Adjective
строене	Masdar
корен	Participle
осиновяла	Participle
глас	Noun
говорят	Verb
обичаща	Participle
загребвайте	Verb
вторият	Adjective
отнесли	Participle
прехапваният	Participle
докажело	Participle
съществувалото	Participle
авторството	Noun
господине	Noun
четях	Verb
храбреците	Noun
знамето	Noun
действия	Noun
повтарящото	Participle
книгата	Noun
извеждащ	Participle
острилка	Noun
цитатите	Noun
отричат	Verb
заричам	Verb
дометях	Verb
ранен	Participle
кълбото	Noun
година	Noun
доказваш	Verb
забравиха	Verb
арменската	Adjective
якото	Adjective
отрекоха	Verb
заоравалото	Participle
дете	Noun
бой	Noun
амперметър	Noun
сериозно	Adjective
словенско	Adjective
превеждаш	Verb
изкусно	Adjective
по-дясно	Adjective
четвъртата	Adjective
съгласието	Noun
най-продажбено	Adjective
племенник	Noun
архипелаг	Noun
антипартийна	Adjective
князът	Noun
палците	Noun
кокал	Noun
по-доблестно	Adjective
млякото	Noun
противникът	Noun
започналият	Participle
навлизаща	Participle
плътният	Adjective
турският	Adjective
борбата	Noun
копчето	Noun
вярващият	Participle
хоризонталният	Adjective
нагризваният	Participle
североизточна	Adjective
горящата	Participle
най-северозападното	Adjective
станало	Participle
питате	Verb
анулирано	Participle
косо	Noun
повтаряне	Masdar
по-безскрупулна	Adjective
вещото	Adjective
шепот	Noun
отлична	Adjective
суеверие	Noun
гърлото	Noun
седмицата	Noun
убиването	Masdar
старите	Adjective
словосъчетания	Noun
наказван	Participle
изпитващия	Participle
комунист	Noun
излизане	Masdar
мъдър	Adjective
прехапаните	Participle
унгарското	Adjective
киноцентър	Noun
слова	Noun
безбрачието	Noun
използвайте	Verb
обезсмъртеният	Participle
четох	Verb
одобрен	Participle
рамо	Noun
повярват	Verb
опреди	Verb
облекат	Verb
препоръчат	Verb
змиорката	Noun
вълчица	Noun
обзавеждане	Masdar
чакането	Masdar
авторитарен	Adjective
желаната	Participle
казана	Participle
излизащият	Participle
аборигените	Noun
потекла	Participle
пчелите	Noun
паяк	Noun
купела	Participle
ортогонална	Adjective
агнета	Noun
наблюдения	Noun
алхимикът	Noun
ябълковите	Adjective
вероятните	Adjective
нокът	Noun
доктор	Noun
нарекло	Participle
червеите	Noun
абстракциите	Noun
бухалите	Noun
предената	Participle
заболи	Participle
убити	Participle
алкохолиците	Noun
любопитната	Adjective
счупването	Masdar
озадачели	Participle
желаех	Verb
кризата	Noun
снесяло	Participle
подобрено	Participle
побеждават	Verb
йоктометър	Noun
отричам	Verb
бактериалните	Adjective
глобили	Participle
бистрата	Adjective
тънкия	Adjective
произнасяне	Masdar
можеш	Verb
изплетяхте	Verb
загубилите	Participle
най-алуминиево	Adjective
създаденият	Participle
попитани	Participle
търсиш	Verb
отворим	Verb
казване	Masdar
нанасян	Participle
адвокатите	Noun
грабят	Verb
изпий	Verb
най-свраче	Adjective
прелъстен	Participle
зъболекарския	Adjective
наобличана	Participle
горящо	Participle
номер	Noun
ухапана	Participle
красавица	Noun
учените	Participle
басе	Noun
студентстваме	Verb
писахме	Verb
виждаш	Verb
дребното	Adjective
бесило	Participle
препоръчват	Verb
обилната	Adjective
светлосянката	Noun
сонетът	Noun
живеейки	Converb
връв	Noun
мразена	Participle
кафета	Noun
съществителните	Noun
огледало	Noun
кастите	Noun
по-умелите	Adjective
насичане	Masdar
охранявайки	Converb
можете	Verb
лимоните	Noun
угоди	Noun
обещалата	Participle
търсещ	Participle
набодяла	Participle
глобявайте	Verb
по-трето	Adjective
бактериално	Adjective
животното	Noun
използващо	Participle
пиете	Verb
вра	Verb
акулата	Noun
отхапани	Participle
поднеси	Verb
най-недостатъчно	Adjective
красавицата	Noun
дъвкал	Participle
обвиняване	Masdar
изпасвате	Verb
анулираните	Participle
подобрихте	Verb
мускулната	Adjective
лисиците	Noun
узаконяване	Masdar
посъветвана	Participle
изтеклото	Participle
абисинките	Noun
наизлизате	Verb
кошмарите	Noun
изслушам	Verb
аварийния	Adjective
реалистична	Adjective
спра	Verb
легализират	Verb
най-кривото	Adjective
аксиомата	Noun
срещането	Masdar
унесох	Verb
изложбите	Noun
подпираният	Participle
детинско	Adjective
абсорбирани	Participle
излизащо	Participle
полученият	Participle
мишата	Adjective
висшето	Adjective
въвираният	Participle
писал	Participle
по-батареен	Adjective
носовете	Noun
осиновихте	Verb
набожданото	Participle
живеели	Participle
счупените	Participle
работата	Noun
бедното	Adjective
скуо	Noun
коле	Noun
изпяващия	Participle
средите	Noun
воля	Noun
режещ	Participle
рибите	Noun
изчезнаха	Verb
нанасяне	Masdar
комбинираната	Participle
валидните	Adjective
закон	Noun
обещаната	Participle
абстрактно	Adjective
вратите	Noun
боговете	Noun
патриарсите	Noun
влакна	Noun
автентична	Adjective
изслушан	Participle
благословил	Participle
компетентните	Adjective
хомяк	Noun
пуяко	Noun
ангел	Noun
изпасем	Verb
размяната	Noun
ползвана	Participle
вечерта	Noun
напишем	Verb
решителните	Adjective
изчезналият	Participle
легализираният	Participle
изтърваван	Participle
висше	Adjective
наркоман	Noun
изнесените	Participle
белгийката	Noun
отичащото	Participle
банкрутът	Noun
сякохте	Verb
преведен	Participle
умираща	Participle
обучаващ	Participle
запалили	Participle
щуката	Noun
потъне	Verb
утайките	Noun
мустак	Noun
авангардното	Adjective
наболите	Participle
грабени	Participle
бабите	Noun
най-отличният	Adjective
нахапаният	Participle
слушаме	Verb
гадже	Noun
вковаван	Participle
лекарството	Noun
бацилоносителят	Noun
петел	Noun
монахиня	Noun
искрите	Noun
по-храбро	Adjective
навличат	Verb
чупят	Verb
родино	Noun
влаковете	Noun
дотечало	Participle
обсъдени	Participle
щука	Noun
уплашени	Participle
некомпетентна	Adjective
най-абатските	Adjective
пращането	Masdar
крива	Adjective
обезсмъртих	Verb
отсичалите	Participle
топола	Noun
облечели	Participle
врабците	Noun
страдания	Noun
подчертано	Participle
разнасяните	Participle
извличан	Participle
набожен	Adjective
обречеш	Verb
изпечените	Participle
четящи	Participle
изпитваш	Verb
одобреният	Participle
краткото	Adjective
отсечени	Participle
потушено	Participle
счупили	Participle
по-дясното	Adjective
тополата	Noun
ученичка	Noun
състезател	Noun
играейки	Converb
сребърна	Adjective
обучила	Participle
засичаният	Participle
пиели	Participle
преподавател	Noun
скуа	Noun
изпитите	Participle
отмират	Verb
започнало	Participle
по-светла	Adjective
спеченото	Participle
азиатко	Noun
изплетен	Participle
пелена	Noun
приятелят	Noun
най-апетитна	Adjective
добрата	Adjective
губила	Participle
лекцията	Noun
обезсмъртяваната	Participle
подслушване	Masdar
пеещи	Participle
предплатилият	Participle
изоравалите	Participle
отнеса	Verb
изминалия	Participle
портата	Noun
пшеница	Noun
учещите	Participle
делял	Participle
небесносиньо	Adjective
плетен	Participle
прочетена	Participle
аморфното	Adjective
набождано	Participle
десетото	Adjective
говорило	Participle
преподавателско	Adjective
езерото	Noun
ненадеждно	Adjective
нагребвания-нета	Masdar
ягодова	Adjective
амвон	Noun
дирижабле	Noun
жено	Noun
обещаване	Masdar
анализите	Noun
поведенията	Noun
непряк	Adjective
по-бързичкото	Adjective
по-проницателният	Adjective
продажбата	Noun
близката	Adjective
ползвания	Participle
препоръчаната	Participle
автодрезините	Noun
съперница	Noun
жените	Noun
доверчива	Adjective
чудесните	Adjective
взводът	Noun
благодарящият	Participle
срещащ	Participle
свръхестествен	Adjective
продаващите	Participle
коронясват	Verb
по-азбестова	Adjective
гласувай	Verb
бактериален	Adjective
аргументът	Noun
кат	Noun
обучавайте	Verb
вулканът	Noun
песните	Noun
спестявайки	Converb
унищожа	Verb
станахме	Verb
прелата	Participle
грозните	Adjective
подслушам	Verb
студентските	Adjective
опредения	Participle
даващия	Participle
решиш	Verb
тръгваш	Verb
аварийна	Adjective
подписващ	Participle
змеица	Noun
изнасящи	Participle
излезем	Verb
копчетата	Noun
по-жестокия	Adjective
съобщение	Noun
значително	Adjective
кладеният	Participle
цветята	Noun
изкупуват	Verb
раченето	Masdar
отличното	Adjective
актуална	Adjective
аварката	Noun
жълтото	Adjective
противник	Noun
тъпо	Adjective
загиващото	Participle
лукава	Adjective
по-зверско	Adjective
швейцарското	Adjective
подписал	Participle
парашутът	Noun
хапехте	Verb
най-изпълнимо	Adjective
ударник	Noun
написания	Participle
кървяло	Participle
некомпетентната	Adjective
обсъжданото	Participle
безстрашният	Adjective
гласуват	Verb
лица	Noun
плътната	Adjective
пасене	Masdar
милиметра	Noun
забранителният	Adjective
арогантният	Adjective
почитайки	Converb
подобреното	Participle
свещите	Noun
истинното	Adjective
лед	Noun
авенютата	Noun
неузрелите	Adjective
строящия	Participle
нагребват	Verb
виждано	Participle
поведен	Participle
питаме	Verb
докаже	Verb
прилагателни	Noun
реших	Verb
най-грижливия	Adjective
преден	Participle
запален	Participle
допринесъл	Participle
биноклите	Noun
решетка	Noun
получавания	Participle
по-авиационно	Adjective
реален	Adjective
царевица	Noun
уставът	Noun
унищожаване	Masdar
търсещия	Participle
свраката	Noun
словенците	Noun
принудените	Participle
поднесла	Participle
гласувате	Verb
надебелеем	Verb
запалване	Masdar
подчертана	Participle
помагаш	Verb
момчета	Noun
играещ	Participle
лихвата	Noun
изпяващи	Participle
източна	Adjective
краткият	Adjective
живее	Verb
господарствувалия	Participle
жълтият	Adjective
обезглавявана	Participle
най-източно	Adjective
подчертавалите	Participle
евтин	Adjective
вковаваната	Participle
окрадвалият	Participle
обясним	Verb
скубещи	Participle
лятно	Adjective
бивол	Noun
заплашена	Participle
започващия	Participle
поопичана	Participle
сигурният	Adjective
забравили	Participle
избождащия	Participle
кукувиче	Adjective
отвесния	Adjective
надежден	Adjective
чучулига	Noun
изтекъл	Participle
югоизточните	Adjective
говорещите	Participle
клали	Participle
пиле	Noun
разходя	Verb
фургон	Noun
ботушите	Noun
безгрижните	Adjective
купените	Participle
воден	Adjective
по-саркастичният	Adjective
вторите	Adjective
предплащалите	Participle
убило	Participle
цунами	Noun
граница	Noun
смелата	Adjective
удовлетворена	Participle
агресивен	Adjective
тигрицата	Noun
произлизат	Verb
умна	Adjective
преживяващият	Participle
свещта	Noun
допринеса	Verb
алигаторите	Noun
адмиралът	Noun
спестяване	Masdar
сградата	Noun
орел	Noun
учител	Noun
плътните	Adjective
краве	Adjective
ограниченият	Participle
съзират	Verb
жабо	Noun
спиралото	Participle
агитацията	Noun
напредвайки	Converb
излизащия	Participle
свиран	Participle
желаещият	Participle
гълъб	Noun
навлязъл	Participle
изнасяни	Participle
предупредени	Participle
родина	Noun
бледосин	Adjective
наела	Participle
съобщят	Verb
най-ябълковия	Adjective
ортогоналната	Adjective
загубилия	Participle
изслушват	Verb
по-първоразреден	Adjective
безбрачие	Noun
напичайте	Verb
злодеите	Noun
залив	Noun
произнесен	Participle
племенникът	Noun
сечени	Participle
пренесено	Participle
парадоксална	Adjective
сградите	Noun
говорихме	Verb
дарът	Noun
изплитащия	Participle
горял	Participle
обещай	Verb
по-осъществимо	Adjective
спряна	Participle
отсечена	Participle
комбиниращ	Participle
създават	Verb
започваме	Verb
овчарят	Noun
котвата	Noun
станах	Verb
удовлетворяващ	Participle
запалвани	Participle
довеждащ	Participle
предплащане	Masdar
брала	Participle
писала	Participle
заплашен	Participle
татко	Noun
проповедите	Noun
свирай	Verb
назовавам	Verb
играех	Verb
агентът	Noun
закупуващият	Participle
яркост	Noun
любов	Noun
учителският	Adjective
заподозрелия	Participle
сокол	Noun
потресени	Participle
замитащият	Participle
жена	Noun
водорасли	Noun
платения	Participle
барометър	Noun
батарейна	Adjective
дометели	Participle
вършеехте	Verb
навлезела	Participle
счупвайки	Converb
използващата	Participle
край	Noun
носорозите	Noun
възпирания	Participle
доблестните	Adjective
питат	Verb
червеното	Adjective
свраките	Noun
доблестен	Adjective
отричащи	Participle
продължиха	Verb
можехме	Verb
визите	Noun
съветване	Masdar
анонимно	Adjective
обричат	Verb
изпечени	Participle
счупванията-нетата	Masdar
полудеете	Verb
нараняване	Masdar
обучен	Participle
бозайник	Noun
предплатяла	Participle
гълъбът	Noun
доверчиво	Adjective
живелите	Participle
врана	Noun
балканската	Adjective
наказана	Participle
шипката	Noun
завляклата	Participle
решавам	Verb
най-неважното	Adjective
извежданите	Participle
модификациите	Noun
подобното	Adjective
реалната	Adjective
нишко	Noun
бомбардиране	Masdar
превозът	Noun
полувисш	Adjective
чиста	Adjective
разумното	Adjective
препоръчано	Participle
казаните	Participle
майсторско	Adjective
разум	Noun
граничели	Participle
повторена	Participle
изкупуване	Masdar
по-азбестовата	Adjective
препоръчван	Participle
подписвам	Verb
одобрените	Participle
авариен	Adjective
топлата	Adjective
обилния	Adjective
най-предпазливо	Adjective
очния	Adjective
паслия	Participle
сирене	Noun
високия	Adjective
разплаканото	Participle
запечен	Participle
руско	Adjective
опитна	Adjective
подкупени	Participle
изсекли	Participle
дните	Noun
чичото	Noun
загубените	Participle
единадесетият	Adjective
наплитанията-нетата	Masdar
учило	Participle
бомбардиран	Participle
вземаме	Verb
обезглавена	Participle
абаносовата	Adjective
кухня	Noun
пъргава	Adjective
комар	Noun
учена	Participle
пренасящ	Participle
обяснявайте	Verb
високото	Adjective
разболяват	Verb
бихме	Verb
удовлетворяваме	Verb
изнасяно	Participle
гаджето	Noun
по-далечното	Adjective
учела	Participle
счупим	Verb
билото	Participle
зачитайте	Verb
обясняват	Verb
врени	Participle
капела	Participle
вишна	Noun
излизам	Verb
използвана	Participle
убиел	Participle
вярваш	Verb
изпитането	Masdar
планина	Noun
наследил	Participle
състезателно	Adjective
по-мускулно	Adjective
напекох	Verb
падащи	Participle
порта	Noun
аборигенът	Noun
бактериална	Adjective
австралийския	Adjective
победена	Participle
повторен	Participle
по-бързо	Adjective
рязан	Participle
носът	Noun
златото	Noun
умрелия	Participle
коремно	Adjective
челата	Participle
акушерката	Noun
държавите	Noun
забраняване	Masdar
обяснете	Verb
скорците	Noun
дълбокия	Adjective
кълвач	Noun
арнаутко	Noun
австриец	Noun
мъдрости	Noun
лопата	Noun
покривите	Noun
клюн	Noun
ограничената	Participle
птиците	Noun
красавиците	Noun
азиатското	Adjective
обещаващо	Participle
танцуваме	Verb
абсолютна	Adjective
помагалия	Participle
минаретата	Noun
по-действителният	Adjective
червените	Adjective
близко	Adjective
заслужилият	Participle
източния	Adjective
несериозно	Adjective
работещият	Participle
обсъдело	Participle
създадем	Verb
разберем	Verb
заспивалата	Participle
азиатските	Adjective
опираме	Verb
отсякъл	Participle
ансамблите	Noun
чупейки	Converb
предупредено	Participle
убиецът	Noun
решите	Verb
часовете	Noun
победихме	Verb
подобряхте	Verb
младия	Adjective
главата	Noun
овца	Noun
дребно	Adjective
дълбоките	Adjective
гъркиня	Noun
лековерен	Adjective
построил	Participle
назовавате	Verb
понавлезеш	Verb
тесния	Adjective
ум	Noun
построени	Participle
дръзката	Adjective
другите	Adjective
попечената	Participle
правехме	Verb
наковавай	Verb
третите	Adjective
подобния	Adjective
тясно	Adjective
кадифето	Noun
армия	Noun
подкладеното	Participle
допринасяне	Masdar
драгинко	Noun
предсказването	Masdar
причиняващия	Participle
отворила	Participle
актрисата	Noun
запека	Verb
нагребваш	Verb
мравките	Noun
прел	Participle
неразсъдлив	Adjective
биещ	Participle
съобщенията	Noun
интересуващ	Participle
неверният	Adjective
влюбване	Masdar
хомосексуалистите	Noun
ядосания	Adjective
беглец	Noun
лесния	Adjective
спестено	Participle
оръжие	Noun
повтарят	Verb
огледалото	Noun
пиейки	Converb
голямото	Adjective
протест	Noun
закупиха	Verb
заповядано	Participle
токсичните	Adjective
заплитат	Verb
усилието	Noun
символът	Noun
агнетата	Noun
лековерния	Adjective
халвата	Noun
лесните	Adjective
повлечена	Participle
продължаващият	Participle
извлякох	Verb
можеха	Verb
учителско	Adjective
гущерът	Noun
девица	Noun
мечтана	Participle
най-сатанистично	Adjective
безстрашния	Adjective
работлива	Adjective
спасяван	Participle
подведен	Participle
абхазко	Adjective
по-недоврелият	Adjective
произлязла	Participle
руска	Adjective
навлизащи	Participle
обвиняването	Masdar
дъвче	Verb
най-топъл	Adjective
съчетавайки	Converb
кладене	Masdar
зеленият	Adjective
отварянето	Masdar
авиаторка	Noun
пътуването	Masdar
авторско	Adjective
мечталата	Participle
победихте	Verb
прелъстявалата	Participle
загубили	Participle
разбрано	Participle
светъл	Adjective
алманах	Noun
бактерийната	Adjective
ранила	Participle
седмият	Adjective
кладенците	Noun
изберем	Verb
изсечените	Participle
абстрактният	Adjective
швейцарските	Adjective
арменският	Adjective
продължаващ	Participle
подчертах	Verb
обсъждани	Participle
получаващото	Participle
думата	Noun
стройте	Verb
почитан	Participle
спасиха	Verb
изпичат	Verb
автостоп	Noun
магазин	Noun
реалистичното	Adjective
анатемосвания-нета	Masdar
доплитащото	Participle
обезглавяване	Masdar
сърце	Noun
въоръженото	Participle
отвеждаща	Participle
непоколебимата	Adjective
слабо	Adjective
ранявайки	Converb
играя	Verb
търсени	Participle
изслушваните	Participle
зашивания	Participle
бихте	Verb
чернодробна	Adjective
строена	Participle
сънувай	Verb
забранено	Participle
австрийската	Adjective
земетресение	Noun
хамбарът	Noun
чухме	Verb
заври	Verb
повлечахте	Verb
кокоша	Adjective
ангелските	Adjective
китовете	Noun
изплашени	Participle
якия	Adjective
започналите	Participle
ушивайки	Converb
изложба	Noun
боядисаният	Participle
абсорбция	Noun
можела	Participle
течности	Noun
борба	Noun
ножицата	Noun
прясното	Adjective
полумярката	Noun
блясъкът	Noun
нарекъл	Participle
отвлякъл	Participle
арабското	Adjective
обвинените	Participle
смазалия	Participle
обречено	Participle
момъкът	Noun
дадохте	Verb
лесбийките	Noun
адресите	Noun
понесяха	Verb
отвеждай	Verb
вазата	Noun
по-възможните	Adjective
афоризмите	Noun
университетът	Noun
слушания	Participle
швейцарския	Adjective
подчертаният	Participle
бащи	Noun
адекватните	Adjective
смелият	Adjective
безбройните	Adjective
плачели	Participle
разбрало	Participle
най-преподавателското	Adjective
акробатка	Noun
забраних	Verb
мазането	Masdar
победа	Noun
бремето	Noun
събудиш	Verb
отсичаш	Verb
препрочитане	Masdar
истинската	Adjective
компетенция	Noun
използваните	Participle
привнасяните	Participle
пчелоядът	Noun
пейзажите	Noun
европеецът	Noun
неврял	Adjective
пресен	Adjective
глобена	Participle
затресях	Verb
навирате	Verb
арката	Noun
по-неблагоразумната	Adjective
несериозна	Adjective
князете	Noun
вършеене	Masdar
бегло	Adjective
отсъстващите	Participle
наследеното	Participle
надонасяния	Participle
измрат	Verb
докажа	Verb
най-кореместа	Adjective
цената	Noun
парадоксите	Noun
заплитане	Masdar
студът	Noun
облечено	Participle
бдение	Noun
прегърнатите	Participle
гимназия	Noun
обучаваните	Participle
чичо	Noun
арменка	Noun
гладна	Adjective
цена	Noun
играла	Participle
пъргав	Adjective
одобряваните	Participle
унищожаван	Participle
подписват	Verb
царю	Noun
заплашващо	Participle
сладолед	Noun
работещото	Participle
съвременната	Adjective
вършея	Verb
наковаващи	Participle
пушил	Participle
пъпешът	Noun
актьорите	Noun
лявата	Adjective
пингвин	Noun
опичат	Verb
пушили	Participle
прочитането	Masdar
охраняват	Verb
крадат	Verb
вицовете	Noun
слънчевия	Adjective
влажното	Adjective
аплодират	Verb
припадне	Verb
наобличаното	Participle
беден	Adjective
чакаме	Verb
побеждавайки	Converb
пристигнала	Participle
другарят	Noun
зетьовете	Noun
велосипед	Noun
сестро	Noun
падащият	Participle
захапваното	Participle
легализирането	Masdar
молейки	Converb
усърдните	Adjective
кате	Noun
най-автоматичен	Adjective
любови	Noun
лепилото	Noun
засякоха	Verb
усърдната	Adjective
решена	Participle
възможният	Adjective
бастун	Noun
съобщена	Participle
пиши	Verb
белогвардеец	Noun
най-сръбско	Adjective
изговарящ	Participle
продаващи	Participle
изведен	Participle
чернодробен	Adjective
връвта	Noun
сприятелим	Verb
изпитаме	Verb
протичаща	Participle
убедените	Participle
дръзкото	Adjective
чакай	Verb
подкупвано	Participle
ставащ	Participle
срядата	Noun
надонеслите	Participle
предсказваните	Participle
злото	Adjective
легализиране	Masdar
абсурдното	Adjective
изтичащи	Participle
изпитвана	Participle
най-хоризонтален	Adjective
зачетяла	Participle
сигурен	Adjective
повлечал	Participle
назоваване	Masdar
полудели	Participle
най-прекрасната	Adjective
гущер	Noun
поопечели	Participle
отнесло	Participle
аплодиралата	Participle
отвлечената	Participle
жълтата	Adjective
соба	Noun
алтова	Adjective
погребване	Masdar
полувисшите	Adjective
насекоми	Noun
розата	Noun
ортогонален	Adjective
надвнесат	Verb
преведи	Verb
взимащ	Participle
повтаряте	Verb
най-важен	Adjective
загубваната	Participle
белгиецо	Noun
сечен	Participle
по-съвременен	Adjective
плети	Verb
чобанка	Noun
речи	Noun
най-искрените	Adjective
срещат	Verb
саркастичната	Adjective
лектор	Noun
стомашната	Adjective
изгубено	Participle
потушена	Participle
арогантна	Adjective
наводнявана	Participle
разболяване	Masdar
полукълбото	Noun
лелята	Noun
алкохолния	Adjective
амониева	Adjective
ранените	Participle
неумела	Adjective
дадохме	Verb
другарко	Noun
бузата	Noun
търсещият	Participle
наетото	Participle
започналия	Participle
подвеждащ	Participle
магазинът	Noun
отведена	Participle
грешат	Verb
донасяното	Participle
неумелото	Adjective
по-анилиновия	Adjective
спрежения	Noun
пила	Participle
танцуваните	Participle
писана	Participle
очаквания	Participle
доене	Masdar
осата	Noun
анулирането	Masdar
захапал	Participle
полусянка	Noun
повторих	Verb
ученият	Participle
зрялата	Participle
ходилото	Participle
рязали	Participle
превеждат	Verb
пръчка	Noun
говорено	Participle
бадем	Noun
главоноги	Noun
изнудването	Masdar
най-невярна	Adjective
поспра	Verb
арменските	Adjective
адът	Noun
красиво	Adjective
варварска	Adjective
албанското	Adjective
четената	Participle
слязъл	Participle
лек	Adjective
подвели	Participle
вземайте	Verb
скумрията	Noun
архипелазите	Noun
разумният	Adjective
разхождащи	Participle
зъбец	Noun
кутия	Noun
подпишат	Verb
протичащия	Participle
изпетия	Participle
бивше	Adjective
варварският	Adjective
преведената	Participle
изпрелото	Participle
анцуже	Noun
изпасената	Participle
по-недостатъчната	Adjective
вземания	Participle
засекат	Verb
хубавата	Adjective
най-южните	Adjective
спасената	Participle
широко	Adjective
анекдот	Noun
интересното	Adjective
нещата	Noun
наследилият	Participle
схватка	Noun
даваме	Verb
зебра	Noun
получите	Verb
продажбите	Noun
космите	Noun
магарето	Noun
вечерят	Verb
любопитно	Adjective
сравняване	Masdar
изгубихме	Verb
тичайки	Converb
врене	Masdar
дядо	Noun
лесна	Adjective
тухлата	Noun
майсторското	Adjective
превела	Participle
длетото	Noun
сладко	Adjective
ароматите	Noun
преведена	Participle
интелигентният	Adjective
извличана	Participle
подкупения	Participle
свещници	Noun
подпряно	Participle
отворило	Participle
прощавам	Verb
по-умелата	Adjective
допрочели	Participle
мъж	Noun
принудилият	Participle
отварящ	Participle
отхапвайки	Converb
обезглавяват	Verb
наследяване	Masdar
пикометрите	Noun
простират	Verb
гласуването	Masdar
гласувам	Verb
злато	Noun
вярващите	Participle
изковаването	Masdar
радостта	Noun
немкиня	Noun
табу	Noun
нанесения	Participle
заплетена	Participle
водопой	Noun
изнесат	Verb
четените	Participle
столица	Noun
некадърния	Adjective
тялото	Noun
дланта	Noun
здрава	Adjective
убивам	Verb
стария	Adjective
молеща	Participle
измине	Verb
по-продажбеното	Adjective
запридане	Masdar
баща	Noun
изплашеният	Participle
чудеса	Noun
изгубиш	Verb
студеният	Adjective
орлета	Noun
сиво	Adjective
изковаване	Masdar
запалката	Noun
мечовете	Noun
возило	Noun
извел	Participle
преживяна	Participle
вестник	Noun
дяволска	Adjective
четящ	Participle
плашили	Participle
сок	Noun
самоубийства	Noun
опиращи	Participle
обясняващ	Participle
по-червената	Adjective
мустаците	Noun
произлизащия	Participle
продавачката	Noun
гениите	Noun
по-пуйчия	Adjective
авторският	Adjective
обвинявани	Participle
плачещи	Participle
прасета	Noun
конците	Noun
желаела	Participle
най-сярната	Adjective
американския	Adjective
обучена	Participle
адаптацията	Noun
оцелял	Participle
избодения	Participle
сръбско	Adjective
камък	Noun
отсъствам	Verb
авторитетния	Adjective
хектолитра	Noun
ухапваща	Participle
опасващата	Participle
южните	Adjective
замират	Verb
гърмът	Noun
поглежданите	Participle
произлязло	Participle
полудял	Participle
присъстваща	Participle
живееш	Verb
блясък	Noun
счупено	Participle
нареченото	Participle
обесването	Masdar
сонет	Noun
руският	Adjective
занесохме	Verb
пушихме	Verb
авторите	Noun
зачитания-нета	Masdar
правителствената	Adjective
даровете	Noun
по-ароматична	Adjective
произтичаща	Participle
телетата	Noun
седма	Adjective
подчертаване	Masdar
апартаментът	Noun
смазващ	Participle
наказвам	Verb
шибам	Verb
алчния	Adjective
анестезиоложките	Noun
броненосците	Noun
спестявам	Verb
най-лилавата	Adjective
действителен	Adjective
дъще	Noun
нарекла	Participle
ерата	Noun
произтичащото	Participle
повторела	Participle
шунката	Noun
жълт	Adjective
вечерям	Verb
обречен	Participle
слон	Noun
завеждащи	Participle
почетат	Verb
получения	Participle
водното	Adjective
продължаващото	Participle
озаглавяван	Participle
гневно	Adjective
горена	Participle
по-прекрасна	Adjective
адрес	Noun
водоравно	Adjective
протичащ	Participle
спестяваш	Verb
довело	Participle
зачитат	Verb
продължа	Verb
одобриха	Verb
словенските	Adjective
алуминиевото	Adjective
чакайте	Verb
антилопата	Noun
хапе	Verb
амбициозна	Adjective
северният	Adjective
предсказали	Participle
червения	Adjective
акордеонът	Noun
доказваща	Participle
подобният	Adjective
очакваното	Participle
коритото	Noun
висша	Adjective
тръгват	Verb
хапещи	Participle
написвайки	Converb
царство	Noun
предсказаното	Participle
наричаш	Verb
пеело	Participle
каса	Noun
сравним	Verb
закупите	Verb
най-безкрайно	Adjective
по-треторазрядната	Adjective
понесения	Participle
автоматичен	Adjective
доведения	Participle
зачетох	Verb
работещ	Participle
почвам	Verb
южняшко	Adjective
подкупванията-нетата	Masdar
обясняване	Masdar
агитационната	Adjective
езико	Noun
бодрия	Adjective
медицинското	Adjective
закусвания-нета	Masdar
краят	Noun
лека	Adjective
чавките	Noun
изнудилият	Participle
непокътнато	Adjective
таткото	Noun
комбинирания	Participle
въвлечена	Participle
най-добрия	Adjective
докторът	Noun
зарекла	Participle
казвай	Verb
обвиниха	Verb
работете	Verb
напичат	Verb
наведена	Participle
купен	Participle
по-немските	Adjective
завеждащият	Participle
реалистичен	Adjective
влахинята	Noun
извличането	Masdar
одобрило	Participle
занесена	Participle
осиновяване	Masdar
закупен	Participle
изсякох	Verb
досадната	Adjective
щурецът	Noun
широкото	Adjective
чудесно	Adjective
авиатор	Noun
чух	Verb
власите	Noun
ерите	Noun
хубавец	Noun
различното	Adjective
нощи	Noun
обречени	Participle
най-хомосексуалното	Adjective
раняван	Participle
болен	Adjective
сеченията	Noun
побеждаването	Masdar
живеещо	Participle
завеждат	Verb
набодения	Participle
учат	Verb
комерсиално	Adjective
навлязло	Participle
амвоне	Noun
майчице	Noun
сравнявайки	Converb
светлосинята	Adjective
метох	Verb
разбиращ	Participle
опакото	Adjective
по-отличния	Adjective
сравняването	Masdar
започналото	Participle
работят	Verb
продължаваното	Participle
символ	Noun
виелица	Noun
пречупват	Verb
адмиралите	Noun
надебеляващи	Participle
бедняшките	Adjective
омитаме	Verb
по-лековерното	Adjective
аварската	Adjective
спрем	Verb
мазане	Masdar
порнографска	Adjective
некадърна	Adjective
осите	Noun
сприятеля	Verb
потекохме	Verb
разнасяни	Participle
американско	Adjective
грижите	Noun
обвиненият	Participle
предели	Participle
продавани	Participle
потушил	Participle
пренасяне	Masdar
произнасят	Verb
замиране	Masdar
злодеят	Noun
костенурка	Noun
написах	Verb
свръхестествена	Adjective
платено	Participle
авантюристка	Noun
заслужилите	Participle
излезеш	Verb
работа	Noun
ядяхме	Verb
потичащото	Participle
сравнил	Participle
налозите	Noun
насекомо	Noun
ближе	Verb
обсъждащи	Participle
устите	Noun
модерният	Adjective
доказваният	Participle
горени	Participle
десетия	Adjective
най-батерийния	Adjective
по-предпазливата	Adjective
героините	Noun
нанасяна	Participle
неприятел	Noun
отключват	Verb
оцелея	Verb
надебелявалите	Participle
правил	Participle
езикът	Noun
дясната	Adjective
розмарине	Noun
непряка	Adjective
младият	Adjective
пратени	Participle
донесена	Participle
пристигнех	Verb
племената	Noun
загиналите	Participle
абсорбираме	Verb
миша	Adjective
най-аварско	Adjective
бактериалната	Adjective
арабския	Adjective
подчертаем	Verb
донесла	Participle
ухо	Noun
деветите	Adjective
забременяване	Masdar
нишките	Noun
легализирани	Participle
изпитано	Participle
победените	Participle
сонетите	Noun
ходиш	Verb
чирак	Noun
чупене	Masdar
строения	Participle
игото	Noun
североизточния	Adjective
обучаващи	Participle
спасих	Verb
вещо	Adjective
излязоха	Verb
акумулатор	Noun
старателно	Adjective
създайте	Verb
дюлята	Noun
чаша	Noun
калфите	Noun
кривите	Adjective
по-бедняшкия	Adjective
можеща	Participle
шкафовете	Noun
набождания-нета	Masdar
насечена	Participle
замъците	Noun
молещият	Participle
измиране	Masdar
пренесох	Verb
госпожо	Noun
лекомислен	Adjective
използваната	Participle
спасяваме	Verb
написани	Participle
администрациите	Noun
говорене	Masdar
събудих	Verb
най-състезателната	Adjective
веригата	Noun
почитането	Masdar
абдукцията	Noun
прегърни	Verb
изчезнехме	Verb
разбрахте	Verb
измирайки	Converb
изтеклите	Participle
обичат	Verb
студентският	Adjective
доенето	Masdar
ядосаната	Adjective
километра	Noun
водо	Noun
паток	Noun
болестта	Noun
предрекъл	Participle
разумът	Noun
убитата	Participle
протестите	Noun
ученическото	Adjective
наобличащо	Participle
моливе	Noun
разболяла	Participle
островът	Noun
смазващи	Participle
избождат	Verb
учтива	Adjective
бойлер	Noun
могла	Participle
кокошка	Noun
молещ	Participle
засечена	Participle
ранял	Participle
деля	Verb
обяснил	Participle
сиромасите	Noun
коремното	Adjective
антико	Noun
естетичен	Adjective
продаваш	Verb
причинени	Participle
дребния	Adjective
измамите	Noun
забравения	Participle
модерната	Adjective
белия	Adjective
училище	Noun
безаварийните	Adjective
запалената	Participle
най-злият	Adjective
обещан	Participle
рязането	Masdar
еластично	Adjective
писмо	Noun
опека	Verb
спася	Verb
скъпият	Adjective
черна	Adjective
въоръжат	Verb
сигурно	Adjective
способния	Adjective
изведената	Participle
преди	Verb
земетресението	Noun
предупреден	Participle
колеги	Noun
агностико	Noun
битият	Participle
принуждаването	Masdar
доказваните	Participle
токсичен	Adjective
ограниченията	Noun
занасяй	Verb
допринасянето	Masdar
подобря	Verb
врабчетата	Noun
по-бледосинята	Adjective
преживяваните	Participle
създала	Participle
аксиома	Noun
прехапаното	Participle
унищожавалите	Participle
авторските	Adjective
ползвайки	Converb
продължат	Verb
денят	Noun
закупеният	Participle
най-осъществимо	Adjective
простиращо	Participle
питащият	Participle
яребица	Noun
наричаните	Participle
обезсмъртяването	Masdar
изнеслото	Participle
перпендикулярна	Adjective
ставаният	Participle
реалното	Adjective
сярна	Adjective
безкрайния	Adjective
най-различната	Adjective
пълен	Adjective
тръгващи	Participle
вярващи	Participle
благославящ	Participle
допринасяте	Verb
грабете	Verb
използвам	Verb
царица	Noun
заслужен	Participle
избрано	Participle
злоупотребил	Participle
изведени	Participle
биха	Verb
засякъл	Participle
възможната	Adjective
австрийските	Adjective
работих	Verb
съществуващ	Participle
изчитането	Masdar
обучихме	Verb
дотичат	Verb
подвеждаща	Participle
интересувам	Verb
портокал	Noun
неразсъдителното	Adjective
драконите	Noun
будехме	Verb
внимателен	Adjective
автономен	Adjective
избираните	Participle
тресяло	Participle
автентичен	Adjective
обсъжданите	Participle
доведената	Participle
авторитарното	Adjective
черната	Adjective
абатската	Adjective
цялото	Adjective
преподавателското	Adjective
писало	Participle
отвеждани	Participle
правеха	Verb
автоколоните	Noun
обвиняваща	Participle
пеещата	Participle
най-апетитно	Adjective
попитат	Verb
несръчна	Adjective
дългите	Adjective
управителят	Noun
ухапване	Masdar
будала	Noun
изпаслата	Participle
най-способната	Adjective
коронясването	Masdar
погледнато	Participle
донеси	Verb
изчезнала	Participle
опасяхте	Verb
югоизточен	Adjective
най-другия	Adjective
създаваните	Participle
може	Verb
учен	Participle
казващия	Participle
обещаващото	Participle
обричайки	Converb
легализиралия	Participle
делили	Participle
алчен	Adjective
граничело	Participle
забравянето	Masdar
лисицата	Noun
предупреждаваме	Verb
охранявани	Participle
запечала	Participle
строящият	Participle
най-кравята	Adjective
уволнят	Verb
метоха	Verb
навестяваната	Participle
обсъдя	Verb
гласуваш	Verb
славно	Adjective
изчезнеш	Verb
тънък	Adjective
умиралия	Participle
вакъф	Noun
допринасящите	Participle
убийца	Noun
изпитани	Participle
кестен	Noun
абсолвентът	Noun
ставаме	Verb
легализиран	Participle
политика	Noun
храбрия	Adjective
пристигнах	Verb
чешките	Adjective
плетенето	Masdar
лета	Noun
отвлечено	Participle
алените	Adjective
леко	Adjective
съобщаването	Masdar
аварийните	Adjective
простирайки	Converb
чистото	Adjective
затъмнението	Noun
озаглавено	Participle
визитка	Noun
победим	Verb
лукавата	Adjective
търсеща	Participle
девицата	Noun
възлязла	Participle
вярващия	Participle
пишех	Verb
близкият	Adjective
строила	Participle
пушенето	Masdar
измама	Noun
отрека	Verb
изплитам	Verb
живеела	Participle
изпасена	Participle
повеждащият	Participle
подвелият	Participle
амониевият	Adjective
пеещо	Participle
мозъкът	Noun
причиненото	Participle
прасковите	Noun
бебе	Noun
стомашните	Adjective
мечът	Noun
обсъждаме	Verb
доказващия	Participle
афоризмът	Noun
ураганите	Noun
предупреждаваща	Participle
завеждания	Participle
подписващите	Participle
отвели	Participle
майсторските	Adjective
дръзкия	Adjective
снесените	Participle
кухните	Noun
интелигентното	Adjective
вероятната	Adjective
истинно	Adjective
лопатата	Noun
пристигат	Verb
по-архаичните	Adjective
агрегатния	Adjective
очаквам	Verb
обезглавявай	Verb
боядисаш	Verb
спиращ	Participle
абсциса	Noun
браха	Verb
произнесена	Participle
излизайки	Converb
ароматна	Adjective
по-водно	Adjective
вземащи	Participle
смазване	Masdar
заплашилите	Participle
измират	Verb
вярването	Masdar
желани	Participle
грешен	Participle
анулиралият	Participle
най-невяращия	Adjective
изгубвана	Participle
хубавите	Adjective
компетентности	Noun
изведения	Participle
акордите	Noun
осиновения	Participle
опитите	Noun
мечтаел	Participle
ходела	Participle
алкохол	Noun
подчертавам	Verb
разбиращи	Participle
американското	Adjective
новия	Adjective
погребван	Participle
звънецът	Noun
байко	Noun
мета	Verb
плашел	Participle
мъртвият	Adjective
адекватна	Adjective
повторило	Participle
баба	Noun
запалка	Noun
ставам	Verb
спасиш	Verb
четено	Participle
катериците	Noun
обесили	Participle
лягай	Verb
рачел	Participle
всезнайките	Noun
принудилите	Participle
архаичният	Adjective
ходенето	Masdar
арменска	Adjective
атомната	Adjective
наобличат	Verb
северозападен	Adjective
остров	Noun
магнитът	Noun
ударите	Noun
прозорецо	Noun
помагайте	Verb
разходели	Participle
левия	Adjective
заредяхте	Verb
свираният	Participle
целуване	Masdar
шефката	Noun
бомбардират	Verb
създаванията-нетата	Masdar
започвайки	Converb
езан	Noun
дивото	Adjective
сръчните	Adjective
решавате	Verb
опеклият	Participle
обвинявалото	Participle
по-бременното	Adjective
заплашвана	Participle
произлизащ	Participle
любезното	Adjective
състезателната	Adjective
спреженията	Noun
обръщение	Noun
провиращият	Participle
учителката	Noun
най-перпендикулярно	Adjective
играна	Participle
шипка	Noun
непоколебима	Adjective
чествания	Participle
къщата	Noun
важно	Adjective
лекомислена	Adjective
получаващите	Participle
мрежата	Noun
счупения	Participle
номерът	Noun
скръбта	Noun
вертолетите	Noun
най-любознателен	Adjective
бивш	Adjective
красавец	Noun
обесени	Participle
изтичане	Masdar
изпитвания	Participle
пиха	Verb
влезли	Participle
краю	Noun
авангарден	Adjective
артилерия	Noun
далечна	Adjective
безпокойства	Noun
халва	Noun
североизточните	Adjective
вождът	Noun
руския	Adjective
стоманата	Noun
изнасяне	Masdar
най-естетичен	Adjective
отвел	Participle
работилия	Participle
автономната	Adjective
произнесените	Participle
горят	Verb
обсъждат	Verb
влезлият	Participle
аварийно	Adjective
платила	Participle
учело	Participle
комерсиална	Adjective
безскрупулен	Adjective
смазана	Participle
мечтаеш	Verb
зарекъл	Participle
чуе	Verb
лекарства	Noun
търгът	Noun
медицинска	Adjective
сръбския	Adjective
дояща	Participle
прочитайки	Converb
октоподите	Noun
опират	Verb
продължавайки	Converb
автобус	Noun
платен	Participle
допринесло	Participle
възпиране	Masdar
коронясващата	Participle
мажат	Verb
хапят	Verb
варварската	Adjective
вечеряните	Participle
часовник	Noun
абисинската	Adjective
започнем	Verb
осиновях	Verb
изпитан	Participle
тополите	Noun
унищожаващи	Participle
изчитане	Masdar
написана	Participle
агресията	Noun
усилие	Noun
зидарят	Noun
дадена	Participle
седмиците	Noun
реша	Verb
отличния	Adjective
почвай	Verb
изнудило	Participle
арменците	Noun
охлюв	Noun
глупаво	Adjective
най-чисто	Adjective
азиатец	Noun
подобрен	Participle
коритата	Noun
отречен	Participle
модерните	Adjective
правела	Participle
изчезването	Masdar
доен	Participle
изгубените	Participle
валидно	Adjective
заспали	Participle
понавлезте	Verb
хората	Noun
напитка	Noun
говорещия	Participle
получаващи	Participle
красавците	Noun
работейки	Converb
наблюдението	Noun
заковавания	Participle
умният	Adjective
мухите	Noun
по-щателният	Adjective
коремният	Adjective
плачещата	Participle
свастиката	Noun
доблестна	Adjective
кожухът	Noun
изричано	Participle
подписало	Participle
глобо	Noun
забравената	Participle
балкан	Noun
залез	Verb
човече	Noun
мъдростите	Noun
змия	Noun
адамов	Adjective
мразел	Participle
апостроф	Noun
чествана	Participle
мазнините	Noun
плетат	Verb
улица	Noun
пренесем	Verb
асансьорите	Noun
пристигащ	Participle
гимназията	Noun
овчар	Noun
по-жесток	Adjective
опасващи	Participle
по-значително	Adjective
пристигащи	Participle
нисша	Adjective
делели	Participle
ходещата	Participle
навлизащата	Participle
майката	Noun
авторките	Noun
трамваят	Noun
най-лекият	Adjective
състезателен	Adjective
работеха	Verb
поднесъл	Participle
бактериолозите	Noun
сомът	Noun
овошките	Noun
инфантилна	Adjective
аналната	Adjective
изсеченият	Participle
можах	Verb
козлите	Noun
подкупването	Masdar
навлезли	Participle
попитването	Masdar
по-лекомислената	Adjective
сравняващо	Participle
ставайте	Verb
войвода	Noun
обвиниш	Verb
мела	Participle
станел	Participle
будещ	Participle
зачитани	Participle
бягащия	Participle
замитаният	Participle
пишещият	Participle
най-веществена	Adjective
най-аналния	Adjective
пренасяща	Participle
антиките	Noun
апетитът	Noun
австралийката	Noun
сладката	Adjective
обезглавените	Participle
изнудим	Verb
извличане	Masdar
занесени	Participle
продължилите	Participle
наказвано	Participle
съзираме	Verb
пиела	Participle
опридат	Verb
делящ	Participle
десният	Adjective
подписвай	Verb
най-адамово	Adjective
смаже	Verb
най-неумелия	Adjective
казват	Verb
замък	Noun
чаплата	Noun
жената	Noun
допринесоха	Verb
аварията	Noun
булите	Noun
истините	Noun
корита	Noun
обвинено	Participle
обяснила	Participle
абако	Noun
боецът	Noun
завели	Participle
най-студения	Adjective
бълхата	Noun
охлювът	Noun
катерица	Noun
делото	Noun
наивна	Adjective
изтичащото	Participle
припевите	Noun
бистро	Adjective
отнасяно	Participle
ариец	Noun
тичат	Verb
грешащо	Participle
опри	Verb
гъската	Noun
деветият	Adjective
сечението	Noun
храбра	Adjective
млъкват	Verb
хипопотам	Noun
грижлива	Adjective
посъветвам	Verb
интересният	Adjective
казахте	Verb
наричам	Verb
състезателното	Adjective
сравняваш	Verb
плуг	Noun
пиеш	Verb
стадионите	Noun
изсичаща	Participle
благородният	Adjective
приятелствата	Noun
биела	Participle
печатът	Noun
вероятността	Noun
комерсиалната	Adjective
пило	Participle
оргазмът	Noun
абсолвентите	Noun
тръгваме	Verb
избрана	Participle
невнимателно	Adjective
допринасящи	Participle
вдишат	Verb
питиетата	Noun
одобряваният	Participle
подписаният	Participle
победено	Participle
по-черната	Adjective
човка	Noun
антроположката	Noun
мечтах	Verb
точния	Adjective
момчетата	Noun
загивай	Verb
километрите	Noun
катът	Noun
съобщаващият	Participle
австрийското	Adjective
автономия	Noun
изчезват	Verb
бомбардиращи	Participle
загребвания-нета	Masdar
канела	Noun
провирането	Masdar
комбинирате	Verb
абсорбираш	Verb
интелигентна	Adjective
корейки	Converb
наивен	Adjective
виждащи	Participle
строящ	Participle
княз	Noun
демокрациите	Noun
убеждавайки	Converb
ароматът	Noun
правят	Verb
подписаната	Participle
създали	Participle
компетентното	Adjective
поднесени	Participle
изслушат	Verb
зверските	Adjective
изнесло	Participle
индивидуалността	Noun
отваряш	Verb
завра	Verb
убеден	Participle
испанска	Adjective
изплитайки	Converb
славния	Adjective
превеждайки	Converb
комбинират	Verb
археоложка	Noun
велосипедите	Noun
секирата	Noun
по-второразредния	Adjective
подобрим	Verb
италианците	Noun
съвършените	Adjective
предплатя	Verb
спасяване	Masdar
забравяш	Verb
осиновеното	Participle
изпиташ	Verb
ароматичния	Adjective
делене	Masdar
подслушвани	Participle
унгарска	Adjective
анатомичната	Adjective
поглеждай	Verb
снасянето	Masdar
феникс	Noun
рамото	Noun
бомбардирането	Masdar
секли	Participle
адресирана	Participle
сказуемото	Noun
намекнехме	Verb
авантюра	Noun
коронясана	Participle
чистата	Adjective
важния	Adjective
пристигащите	Participle
събудена	Participle
загубило	Participle
засечени	Participle
антропологът	Noun
най-саркастично	Adjective
безформено	Adjective
подчертаната	Participle
плътно	Adjective
десен	Adjective
лекциите	Noun
донесения	Participle
ядеш	Verb
комбинираното	Participle
питайки	Converb
комбинирана	Participle
най-креативно	Adjective
подписвате	Verb
изчезналия	Participle
продължения	Participle
хляб	Noun
разходена	Participle
четвъртото	Adjective
протекат	Verb
ходят	Verb
превежданите	Participle
порнографът	Noun
пръстите	Noun
извлекли	Participle
небесносин	Adjective
раненото	Participle
загиват	Verb
по-работливите	Adjective
пратите	Verb
кутията	Noun
синигерите	Noun
ранили	Participle
по-зверска	Adjective
изпята	Participle
балнеолечението	Noun
опичащо	Participle
върхът	Noun
германският	Adjective
швейцарско	Adjective
прелъстяването	Masdar
любителско	Adjective
сеизмично	Adjective
скъп	Adjective
тежкия	Adjective
правителствена	Adjective
привнесен	Participle
исканото	Participle
сметана	Noun
превеждам	Verb
накитите	Noun
по-южен	Adjective
модерно	Adjective
влизайки	Converb
безделничилите	Participle
сврака	Noun
по-словенската	Adjective
ябълков	Adjective
разходилото	Participle
акробатиката	Noun
соколът	Noun
шефовете	Noun
отхапал	Participle
коронясан	Participle
сери	Verb
влизащите	Participle
убития	Participle
дайте	Verb
забрана	Noun
работещия	Participle
арменското	Adjective
вярното	Adjective
въвлекат	Verb
подчерталите	Participle
напреднал	Participle
заплашват	Verb
немският	Adjective
ясна	Adjective
арнаутин	Noun
розо	Noun
мускулното	Adjective
стремена	Noun
делящи	Participle
заповядайте	Verb
решени	Participle
бледничък	Adjective
несръчният	Adjective
разбирайки	Converb
шибалото	Participle
отключените	Participle
долът	Noun
влажните	Adjective
арабските	Adjective
плешива	Adjective
чуто	Participle
неуспех	Noun
плачеха	Verb
куклата	Noun
пушено	Participle
най-сърдитите	Adjective
италианския	Adjective
губели	Participle
лъв	Noun
наказват	Verb
изчезващ	Participle
започналата	Participle
кладохме	Verb
гората	Noun
най-активната	Adjective
загубиш	Verb
даденото	Participle
изплетях	Verb
погледнеш	Verb
господарство	Noun
почетена	Participle
пасяла	Participle
разпростираща	Participle
интересуваме	Verb
диво	Adjective
започвайте	Verb
победилия	Participle
изгубил	Participle
спирания	Participle
хайдук	Noun
момите	Noun
компетентна	Adjective
предричано	Participle
господарствуваш	Verb
стомах	Noun
деветото	Adjective
магнитите	Noun
неголяма	Adjective
кукувицата	Noun
съобщилото	Participle
забраняването	Masdar
табуто	Noun
венците	Noun
креативния	Adjective
мишите	Adjective
въоръжената	Participle
нещастните	Adjective
алчната	Adjective
добра	Adjective
счупиш	Verb
мозъците	Noun
небрежен	Adjective
разбирана	Participle
агроном	Noun
отворих	Verb
арабко	Noun
снасят	Verb
бесена	Participle
възбелия	Adjective
аскерино	Noun
вечеряния	Participle
разхожданото	Participle
възпиращ	Participle
създадат	Verb
дебела	Adjective
потушаващите	Participle
сравнят	Verb
плашели	Participle
посъветваното	Participle
оцетът	Noun
предпазлива	Adjective
по-лекомисленият	Adjective
загинал	Participle
дъвкания-нета	Masdar
погледне	Verb
сражение	Noun
белодробните	Adjective
накажем	Verb
правел	Participle
предричалата	Participle
протестът	Noun
учих	Verb
ограничават	Verb
омраза	Noun
унищожавания-нета	Masdar
кратко	Adjective
преживяваме	Verb
ушила	Participle
четеният	Participle
обичана	Participle
заведен	Participle
портите	Noun
шефка	Noun
лешниците	Noun
писмото	Noun
господарският	Adjective
избере	Verb
оцелеем	Verb
бозайникът	Noun
отрекла	Participle
брадата	Noun
въоръжили	Participle
жабите	Noun
загубена	Participle
зри	Verb
нисшите	Adjective
авантюрите	Noun
понавлизалият	Participle
аргатко	Noun
убеждаваш	Verb
портокалов	Adjective
отсичат	Verb
пишат	Verb
забравяй	Verb
мъртвото	Adjective
истинското	Adjective
лекарят	Noun
чадърите	Noun
грижливото	Adjective
забравим	Verb
желаният	Participle
излезете	Verb
преподавателката	Noun
измре	Verb
мускул	Noun
отбождащият	Participle
заливът	Noun
абитуриенте	Noun
чужденците	Noun
авансирам	Verb
допичани	Participle
енергичен	Adjective
автоматично	Adjective
младата	Adjective
произлизащият	Participle
водите	Noun
презирайки	Converb
оцелее	Verb
име	Noun
решал	Participle
помагай	Verb
забременееш	Verb
премяна	Noun
обвинила	Participle
засичалата	Participle
ограничаването	Masdar
по-безстрашното	Adjective
използваме	Verb
поопека	Verb
ледът	Noun
въоръжилите	Participle
отчетена	Participle
разумните	Adjective
атомно	Adjective
по-непоколебимото	Adjective
агора	Noun
пристигане	Masdar
питаш	Verb
потушат	Verb
скумрия	Noun
времената	Noun
зимите	Noun
ловка	Adjective
очаквана	Participle
забожданията-нетата	Masdar
реалност	Noun
сражението	Noun
заслужех	Verb
по-овчия	Adjective
бежанец	Noun
смело	Adjective
подведат	Verb
облечената	Participle
играещите	Participle
лъвът	Noun
купуването	Masdar
говорещ	Participle
създадоха	Verb
обесеха	Verb
изтичащата	Participle
по-къртиче	Adjective
старицата	Noun
излизащото	Participle
падежите	Noun
северняк	Noun
прозирам	Verb
намекнал	Participle
счупил	Participle
наемане	Masdar
най-възтясна	Adjective
осиновените	Participle
наводнените	Participle
очаквате	Verb
лява	Adjective
оса	Noun
яж	Verb
решим	Verb
по-съвременната	Adjective
плащано	Participle
адресирано	Participle
благодарения	Participle
агресорите	Noun
давана	Participle
ползващия	Participle
умът	Noun
цитатът	Noun
хипербола	Noun
пенис	Noun
уволнявайки	Converb
заслужат	Verb
немецът	Noun
слушането	Masdar
избраха	Verb
амбицията	Noun
пилата	Participle
молили	Participle
топлия	Adjective
лукавия	Adjective
евтините	Adjective
най-мъдрото	Adjective
аварска	Adjective
силният	Adjective
изгубиха	Verb
речникът	Noun
преживяване	Masdar
състезания	Noun
бродяга	Noun
предричане	Masdar
господарствай	Verb
посещаваме	Verb
ден	Noun
законите	Noun
овчия	Adjective
предсказваща	Participle
по-дяволския	Adjective
любопитният	Adjective
създадете	Verb
по-чешките	Adjective
вест	Noun
неловко	Adjective
ножовете	Noun
сприятеляват	Verb
скъпо	Adjective
нараненото	Participle
изпят	Participle
топлите	Adjective
ограничено	Participle
учителските	Adjective
длета	Noun
победени	Participle
авиационните	Adjective
почитано	Participle
най-лилавият	Adjective
осиновявалото	Participle
абдикиранията	Noun
бягащ	Participle
препрочета	Verb
наранявани	Participle
любезна	Adjective
привнесените	Participle
произнесени	Participle
славният	Adjective
архаичната	Adjective
балюстрада	Noun
причиняващо	Participle
по-азиатските	Adjective
десетата	Adjective
разбирай	Verb
мисли	Noun
принудих	Verb
възпрени	Participle
посъветвани	Participle
източната	Adjective
сенките	Noun
винят	Verb
повярвай	Verb
вечерите	Noun
най-глупавия	Adjective
решетката	Noun
повтарянето	Masdar
календар	Noun
швейцарка	Noun
автомагистрала	Noun
по-чудесно	Adjective
кажели	Participle
писма	Noun
влизанията-нетата	Masdar
строените	Participle
поведат	Verb
опиращ	Participle
изнесения	Participle
обсъждането	Masdar
североизточната	Adjective
неголемия	Adjective
литъра	Noun
изпитвайки	Converb
нанеса	Verb
превеждани	Participle
светлите	Adjective
анонимния	Adjective
ползвате	Verb
кош	Noun
кол	Noun
абатския	Adjective
кукувичето	Adjective
раните	Verb
мишко	Noun
любопитния	Adjective
опряна	Participle
наркоманка	Noun
въоръжените	Participle
прочела	Participle
спасим	Verb
картофът	Noun
най-балканско	Adjective
отмиращото	Participle
сечение	Noun
изрекъл	Participle
наеман	Participle
германския	Adjective
винена	Participle
уволнил	Participle
смазан	Participle
търсело	Participle
измяната	Noun
двубой	Noun
написал	Participle
абакът	Noun
касите	Noun
заподозиралите	Participle
изричаща	Participle
търсещи	Participle
креативно	Adjective
англичанка	Noun
проповеди	Noun
аналитичното	Adjective
започнатите	Participle
венецът	Noun
мразиш	Verb
батерийно	Adjective
виното	Noun
гимназиите	Noun
нарекли	Participle
доплитане	Masdar
богиня	Noun
повеждайки	Converb
строели	Participle
питата	Participle
сечахме	Verb
практичните	Adjective
хамбургерите	Noun
пасящ	Participle
изпълнимото	Adjective
обещаваща	Participle
добрият	Adjective
по-австрийския	Adjective
авансирания	Participle
лекарство	Noun
храстите	Noun
словенският	Adjective
убиете	Verb
доказващи	Participle
повторил	Participle
вляза	Verb
сярната	Adjective
прелъстявания	Participle
рибо	Noun
целувайки	Converb
влакът	Noun
унищожават	Verb
пренесената	Participle
колегите	Noun
по-десета	Adjective
завел	Participle
нахапало	Participle
решителният	Adjective
горелката	Noun
опрени	Participle
болна	Adjective
авантюрата	Noun
шестия	Adjective
избождащ	Participle
подчертал	Participle
крадял	Participle
колежка	Noun
съобщавана	Participle
пренасяна	Participle
албанец	Noun
мишките	Noun
подобряват	Verb
ограничавана	Participle
наетата	Participle
платиш	Verb
охраняваната	Participle
срещан	Participle
пренасяйки	Converb
ковчегът	Noun
корито	Noun
извеждани	Participle
обвиняват	Verb
осиновят	Verb
провираният	Participle
микрометър	Noun
убитият	Participle
котвите	Noun
девета	Adjective
чернодробната	Adjective
по-гръдния	Adjective
подпряна	Participle
засякохме	Verb
чернодробния	Adjective
непокътната	Adjective
практично	Adjective
унесена	Participle
заплашихме	Verb
одобряващите	Participle
пушилата	Participle
бързият	Adjective
чисто	Adjective
старият	Adjective
най-непокътнатата	Adjective
буквите	Noun
изкупели	Participle
въшките	Noun
построеният	Participle
облеченият	Participle
навеждалия	Participle
молите	Verb
криза	Noun
кварк	Noun
посъветват	Verb
почвалия	Participle
наричано	Participle
насекомото	Noun
счупила	Participle
пренесла	Participle
нишката	Noun
будят	Verb
североизточно	Adjective
авантюристите	Noun
биели	Participle
причинявано	Participle
излизаме	Verb
разстрел	Noun
асирийка	Noun
тис	Noun
течността	Noun
наказанието	Noun
тръгвай	Verb
ядял	Participle
уволнените	Participle
корабът	Noun
убивайте	Verb
обличам	Verb
шведския	Adjective
ограничението	Noun
мразил	Participle
разбраха	Verb
премираща	Participle
агент	Noun
осиновели	Participle
влизате	Verb
агите	Noun
реч	Noun
вишната	Noun
неприятелите	Noun
пеещ	Participle
търся	Verb
елипсата	Noun
агнец	Noun
паразитите	Noun
търговете	Noun
отците	Noun
небе	Noun
хоризонталната	Adjective
разнасяйки	Converb
хубав	Adjective
докторското	Adjective
плащащото	Participle
студентския	Adjective
най-любителската	Adjective
обсъдиш	Verb
смяна	Noun
изкупувани	Participle
разбрани	Participle
знамена	Noun
убила	Participle
очното	Adjective
баклава	Noun
подчертавания	Participle
създавам	Verb
амнистията	Noun
вероятното	Adjective
арестуваните	Participle
млеката	Noun
магазините	Noun
най-беглото	Adjective
врящият	Participle
занасяна	Participle
можещите	Participle
охраняван	Participle
пращани	Participle
отвличани	Participle
по-ангелският	Adjective
съобщилите	Participle
подметях	Verb
местата	Noun
тресейки	Converb
бушуванията-нетата	Masdar
агностик	Noun
змеиците	Noun
земята	Noun
мразещият	Participle
разстрелът	Noun
злоупотребилата	Participle
сигурното	Adjective
топла	Adjective
правителствено	Adjective
ангелския	Adjective
унеслата	Participle
отведат	Verb
обвинят	Verb
разходихте	Verb
построеното	Participle
отварям	Verb
вулгаризъм	Noun
щуките	Noun
излязъл	Participle
балканските	Adjective
живеех	Verb
омелият	Participle
близане	Masdar
най-безвярна	Adjective
доказана	Participle
одобряват	Verb
агитко	Noun
ядейки	Converb
ного	Noun
архаична	Adjective
ветропоказател	Noun
надонасялия	Participle
бягащата	Participle
видра	Noun
заплашвам	Verb
креативна	Adjective
отчитани	Participle
гневните	Adjective
катерицата	Noun
озаглавяваш	Verb
подписаните	Participle
отнасят	Verb
станалият	Participle
граничещата	Participle
фасул	Noun
динята	Noun
единадесето	Adjective
избери	Verb
арабската	Adjective
обезглавени	Participle
по-бездейния	Adjective
обзаведох	Verb
германка	Noun
захапване	Masdar
момичетата	Noun
възлизащият	Participle
комбинирани	Participle
мома	Noun
патицата	Noun
герой	Noun
интелигентен	Adjective
изнасяна	Participle
кралата	Participle
мислите	Noun
плащат	Verb
сивата	Adjective
анулирания	Participle
пренасяния	Participle
агресивният	Adjective
използвате	Verb
отнасящо	Participle
щраус	Noun
изтекат	Verb
по-тънък	Adjective
парашут	Noun
провирате	Verb
говорещата	Participle
спрения	Participle
подписвайки	Converb
построяваме	Verb
висшите	Adjective
обилно	Adjective
избирате	Verb
дребният	Adjective
влязат	Verb
рязко	Noun
обесило	Participle
авария	Noun
изчезналите	Participle
желан	Participle
наранени	Participle
играещия	Participle
дръзко	Adjective
спирани	Participle
отсъстващ	Participle
оръжия	Noun
искам	Verb
надеждно	Adjective
ушите	Noun
боядисват	Verb
създавана	Participle
анархичен	Adjective
зачевано	Participle
назоваващ	Participle
здравото	Adjective
наврелите	Participle
навлизането	Masdar
апострофът	Noun
апартамент	Noun
нога	Noun
по-любознателния	Adjective
изпеклите	Participle
одобряващи	Participle
бягащият	Participle
казвано	Participle
въоръжен	Participle
получаваната	Participle
верният	Adjective
удар	Noun
щуко	Noun
алкохоличка	Noun
изгубилият	Participle
лягат	Verb
по-аналитическият	Adjective
създаден	Participle
избодохте	Verb
немската	Adjective
северняшка	Adjective
режещия	Participle
арестуващата	Participle
коремната	Adjective
най-сребърната	Adjective
понапекат	Verb
далечното	Adjective
абхазка	Adjective
простиране	Masdar
горелка	Noun
болната	Adjective
анцуг	Noun
истината	Noun
оцветена	Participle
абисинка	Noun
обясняващо	Participle
присъстват	Verb
анатема	Noun
работлив	Adjective
удовлетворявалата	Participle
горели	Participle
ученическата	Adjective
автогарата	Noun
трето	Adjective
подмяната	Noun
унгарската	Adjective
сера	Verb
отричано	Participle
принудят	Verb
дават	Verb
четеното	Participle
южняците	Noun
разстояния	Noun
допряна	Participle
ръбът	Noun
привнесена	Participle
замиталата	Participle
подобрило	Participle
посетили	Participle
авторитетният	Adjective
създаването	Masdar
драките	Noun
състезателката	Noun
наричате	Verb
заведа	Verb
винената	Participle
автомобилите	Noun
най-неизкусният	Adjective
рязала	Participle
сериозния	Adjective
бързичка	Adjective
монарсите	Noun
врящия	Participle
обещаващ	Participle
губя	Verb
казала	Participle
разхождаща	Participle
забравящи	Participle
млечнобял	Adjective
протекла	Participle
пишеха	Verb
питащия	Participle
по-порнографското	Adjective
изречени	Participle
най-анилинова	Adjective
най-акуратно	Adjective
парашутите	Noun
винен	Participle
валидна	Adjective
създалият	Participle
бремената	Noun
зрящи	Participle
обясняваме	Verb
минаре	Noun
приятелите	Noun
безстрашна	Adjective
източното	Adjective
студентстване	Masdar
вакъфът	Noun
педераст	Noun
пасем	Verb
оцветявано	Participle
дива	Adjective
чираците	Noun
очите	Noun
несъмненото	Adjective
далечно	Adjective
довеждани	Participle
мрежа	Noun
пренесен	Participle
подобряващи	Participle
по-северняшкият	Adjective
загубите	Verb
наивните	Adjective
изнасянето	Masdar
учели	Participle
сънуванията-нетата	Masdar
нарекох	Verb
руската	Adjective
започване	Masdar
клада	Verb
ъгъл	Noun
бягащото	Participle
удовлетворил	Participle
създаваш	Verb
принуждавано	Participle
компетентен	Adjective
вършаните	Participle
плачейки	Converb
адвокатко	Noun
летния	Adjective
еластичен	Adjective
дъвкане	Masdar
зидарка	Noun
черешо	Noun
простите	Verb
наводнен	Participle
приятелка	Noun
шунка	Noun
отмиране	Masdar
по-верния	Adjective
обвинени	Participle
копраля	Noun
спасило	Participle
абразия	Noun
лъвицата	Noun
съпруг	Noun
легла	Noun
любопитна	Adjective
библиотека	Noun
белодробно	Adjective
най-неизкусните	Adjective
плачеш	Verb
въжета	Noun
подкупеното	Participle
арабска	Adjective
донасящите	Participle
говорех	Verb
резките	Noun
кукувица	Noun
гръдният	Adjective
отровна	Adjective
абсолютния	Adjective
здравата	Adjective
авторитетните	Adjective
влизането	Masdar
телевизорът	Noun
меса	Noun
скърби	Noun
пушиш	Verb
вертикалното	Adjective
котката	Noun
аналитичният	Adjective
съществуването	Masdar
простя	Verb
най-дяволското	Adjective
пренеса	Verb
югозападния	Adjective
занесен	Participle
турската	Adjective
изсечена	Participle
ограничих	Verb
създавай	Verb
получаващ	Participle
най-бившия	Adjective
битката	Noun
промените	Noun
занесено	Participle
накладяла	Participle
пристигайки	Converb
измрелите	Participle
акне	Noun
по-азиатският	Adjective
накладели	Participle
наводнената	Participle
станаха	Verb
молела	Participle
тежките	Adjective
препоръчани	Participle
оцеляването	Masdar
съгласните	Adjective
писателско	Adjective
словенска	Adjective
пръчките	Noun
въвиращите	Participle
припев	Noun
кървящата	Participle
пращалата	Participle
енергично	Adjective
затичалата	Participle
радеенията-нетата	Masdar
получиш	Verb
яли	Participle
по-аналния	Adjective
безформеното	Adjective
побеждаване	Masdar
комерсиалния	Adjective
хубавия	Adjective
соковете	Noun
косъм	Noun
бактериалният	Adjective
набожният	Adjective
автономния	Adjective
лятна	Adjective
погледнах	Verb
сило	Noun
създаваният	Participle
искай	Verb
обличаният	Participle
победих	Verb
отворения	Participle
най-мускулестият	Adjective
наобличащите	Participle
стадион	Noun
изгубя	Verb
нанометра	Noun
благославям	Verb
сетаметърът	Noun
лекарския	Adjective
ползвано	Participle
уме	Noun
надвнасящо	Participle
безпокойствата	Noun
навестилото	Participle
вероятности	Noun
лепило	Noun
монарх	Noun
колене	Noun
домат	Noun
срещащите	Participle
губещите	Participle
спасил	Participle
обрекъл	Participle
излизащи	Participle
путките	Noun
доказахте	Verb
срани	Participle
заплелите	Participle
уплашените	Participle
бившият	Adjective
кладенец	Noun
напитките	Noun
изляза	Verb
обосноваващи	Participle
заспалия	Participle
запалят	Verb
изпичане	Masdar
спасилите	Participle
аеротаксита	Noun
сребърния	Adjective
отвесната	Adjective
агрегатен	Adjective
отричани	Participle
четящия	Participle
англицизма	Noun
по-млад	Adjective
длето	Noun
нанолитърът	Noun
най-недостатъчен	Adjective
земите	Noun
обмяна	Noun
азиатската	Adjective
изсечен	Participle
отвлечени	Participle
уволнявани	Participle
загребват	Verb
нарекохте	Verb
южняшка	Adjective
единадесетата	Adjective
арбитърът	Noun
оцветяването	Masdar
ходейки	Converb
заслужили	Participle
донесоха	Verb
студентките	Noun
протеклите	Participle
решавалата	Participle
чутото	Participle
орле	Noun
свръхестествения	Adjective
плашещи	Participle
тичаща	Participle
мляко	Noun
втечнена	Participle
падайки	Converb
адресирането	Masdar
граничил	Participle
ограничена	Participle
протекохте	Verb
създаващата	Participle
зачетен	Participle
сабите	Noun
агрегатите	Noun
протичащият	Participle
отчетен	Participle
кочо	Noun
сохо	Noun
умната	Adjective
прозирани	Participle
решаващите	Participle
съществувалият	Participle
изгубеното	Participle
заподозреният	Participle
загубих	Verb
зверовете	Noun
перпендикулярните	Adjective
прегръщащият	Participle
поле	Noun
княгинята	Noun
обвиняващото	Participle
дадете	Verb
тежко	Adjective
подчертаваща	Participle
очен	Adjective
сребърен	Adjective
замах	Noun
получаващият	Participle
космато	Adjective
най-батарейният	Adjective
умиране	Masdar
предсказаните	Participle
безмилостния	Adjective
злоупотребите	Verb
пратили	Participle
надвнасяме	Verb
езерата	Noun
присъствайте	Verb
обезглавете	Verb
чудесното	Adjective
захапвалата	Participle
живей	Verb
използващи	Participle
лесното	Adjective
целуванията-нетата	Masdar
опитният	Adjective
администратор	Noun
устна	Noun
болногледачка	Noun
бременност	Noun
преденето	Masdar
голямо	Adjective
амфитеатър	Noun
будела	Participle
некомпетентен	Adjective
зареваване	Masdar
дебеляло	Participle
алгоритъмът	Noun
арменецът	Noun
нещастния	Adjective
подвеждан	Participle
адвентистката	Noun
най-кадърният	Adjective
момците	Noun
превеждан	Participle
подчертан	Participle
привнесено	Participle
кучката	Noun
обичайте	Verb
яйцевиден	Adjective
одобрената	Participle
пей	Verb
най-неразумно	Adjective
предупредят	Verb
светлосин	Adjective
клиновете	Noun
най-кравия	Adjective
безмилостното	Adjective
кралската	Adjective
запалено	Participle
бащата	Noun
опиращо	Participle
продължаващите	Participle
убедена	Participle
безкрайните	Adjective
спасите	Verb
абдоминална	Adjective
козя	Adjective
създаван	Participle
заковаван	Participle
благодарящите	Participle
руното	Noun
изпичаните	Participle
чупещия	Participle
поспирайки	Converb
германското	Adjective
гъвкаво	Adjective
варварите	Noun
нарекоха	Verb
компетенциите	Noun
диньо	Noun
заковавалото	Participle
восъкът	Noun
отключат	Verb
инвестиране	Masdar
донесло	Participle
следобедите	Noun
амбициозен	Adjective
най-модерната	Adjective
търсели	Participle
строим	Verb
изсичани	Participle
използват	Verb
потънат	Verb
подобряваните	Participle
съчетал	Participle
липата	Noun
най-кукувичите	Adjective
гъркиньо	Noun
лижещ	Participle
слабото	Adjective
виждаме	Verb
посетен	Participle
по-мишия	Adjective
дълбоко	Adjective
подробните	Adjective
отнасящото	Participle
излез	Verb
обвинена	Participle
разлюбващо	Participle
зашиван	Participle
най-сръбска	Adjective
учителките	Noun
устно	Noun
стомахът	Noun
изнудените	Participle
очакваната	Participle
плащане	Masdar
адресирани	Participle
оцеляващи	Participle
намеквайте	Verb
австралийко	Noun
абстрактния	Adjective
кошмарът	Noun
анатомичен	Adjective
изгребвате	Verb
бистра	Adjective
бясна	Adjective
произляза	Verb
уставите	Noun
изнесен	Participle
запалело	Participle
забодял	Participle
потънали	Participle
купувай	Verb
отчитащи	Participle
македонският	Adjective
несръчен	Adjective
йерарх	Noun
бирите	Noun
агностичката	Noun
плашещ	Participle
сандалите	Noun
неуспехът	Noun
дворецът	Noun
магарица	Noun
врящо	Participle
азбучното	Adjective
умрялата	Participle
разнесла	Participle
обучаващият	Participle
обезглавяващият	Participle
счупвания	Participle
заподозират	Verb
неразсъдливата	Adjective
речта	Noun
мишка	Noun
сложена	Adjective
пристигането	Masdar
четели	Participle
слонче	Noun
изкупуването	Masdar
заключения	Noun
изминала	Participle
бръмбарите	Noun
соколица	Noun
изминалата	Participle
ядения	Participle
хапането	Masdar
смазваща	Participle
алуминиевият	Adjective
картофите	Noun
таралежите	Noun
най-австрийска	Adjective
мъртъвците	Noun
отведено	Participle
анатемосани	Participle
пчела	Noun
търсещата	Participle
ерекцийо	Noun
активния	Adjective
пушена	Participle
хомосексуалната	Adjective
доя	Verb
плачещо	Participle
анестезиолог	Noun
гласувана	Participle
напишеш	Verb
испанските	Adjective
по-авансов	Adjective
обяснения	Participle
пепелник	Noun
насекомите	Noun
вестите	Noun
източно	Adjective
коремните	Adjective
по-преподавателско	Adjective
обилното	Adjective
изпитване	Masdar
простено	Participle
премирате	Verb
прочитане	Masdar
самолете	Noun
опрян	Participle
бистрите	Adjective
стремената	Noun
милиметъра	Noun
неспособен	Adjective
авантюристично	Adjective
феите	Noun
броненосецът	Noun
очакването	Masdar
загубвам	Verb
най-авторската	Adjective
напредваща	Participle
запаля	Verb
яребиците	Noun
батарейната	Adjective
потекло	Participle
правителственото	Adjective
обвинявана	Participle
наказаният	Participle
пещерите	Noun
звезда	Noun
микролитър	Noun
работливите	Adjective
гъз	Noun
албанка	Noun
изгризват	Verb
пелените	Noun
високите	Adjective
вдишване	Masdar
заслужил	Participle
крушата	Noun
най-любопитна	Adjective
калкан	Noun
чествания-нета	Masdar
по-способна	Adjective
съществуващите	Participle
хлябът	Noun
напредналия	Participle
изпивайки	Converb
дъска	Noun
унищожавайки	Converb
звяр	Noun
най-възтесните	Adjective
четеш	Verb
принасящ	Participle
монархът	Noun
аварийо	Noun
спасят	Verb
по-четвърто	Adjective
самоубийството	Noun
югозападният	Adjective
западният	Adjective
дадем	Verb
прозорците	Noun
бирата	Noun
низшите	Adjective
скъпа	Adjective
бягането	Masdar
енергичното	Adjective
анакондо	Noun
съобщавания	Participle
правих	Verb
разхождано	Participle
апаратите	Noun
взводовете	Noun
червено	Adjective
изричане	Masdar
часът	Noun
тръгването	Masdar
втечнявана	Participle
адвокатката	Noun
скъпото	Adjective
главоногите	Noun
заплаша	Verb
италианската	Adjective
скорец	Noun
дълбокото	Adjective
нощта	Noun
момичета	Noun
бебешката	Adjective
изчетен	Participle
сравнявано	Participle
абдикиращото	Participle
зверското	Adjective
кучетата	Noun
търсещо	Participle
отворената	Participle
пий	Verb
съществувалите	Participle
висшата	Adjective
по-отличните	Adjective
разпрострелите	Participle
живелият	Participle
причинявайки	Converb
лукав	Adjective
анална	Adjective
благодарила	Participle
обречения	Participle
варварин	Noun
анулиран	Participle
тръгване	Masdar
косатката	Noun
опитното	Adjective
произнасяно	Participle
модерното	Adjective
господарстваш	Verb
йерарсите	Noun
напреднали	Participle
биейки	Converb
мети	Verb
получават	Verb
тънка	Adjective
произлизащите	Participle
спирай	Verb
отворено	Participle
овошко	Noun
кометата	Noun
предсказано	Participle
бито	Participle
семена	Noun
кочите	Adjective
наричащо	Participle
ялово	Adjective
кралският	Adjective
гладен	Adjective
немските	Adjective
учителския	Adjective
бият	Verb
лелите	Noun
агнето	Noun
писателската	Adjective
наизляза	Verb
гребна	Adjective
анонимната	Adjective
неразумните	Adjective
невярна	Adjective
поборник	Noun
косъмът	Noun
аварско	Adjective
политиките	Noun
хладилнико	Noun
заченехте	Verb
най-благото	Adjective
говорените	Participle
подобрил	Participle
ушиването	Masdar
чернодробните	Adjective
университете	Noun
мразят	Verb
германците	Noun
осиновил	Participle
убитите	Participle
ерекцията	Noun
северняшката	Adjective
продължаващи	Participle
отмяна	Noun
решителния	Adjective
храбрите	Adjective
пречупите	Verb
наемаме	Verb
песни	Noun
астероидите	Noun
удовлетворя	Verb
наследило	Participle
убедете	Verb
отвеждат	Verb
майсторска	Adjective
чаканото	Participle
решителната	Adjective
студентското	Adjective
силната	Adjective
семето	Noun
отварящата	Participle
горен	Participle
бебета	Noun
зареждането	Masdar
чешкия	Adjective
обесените	Participle
учебниците	Noun
понавляза	Verb
играните	Participle
обясняваща	Participle
гъвкавата	Adjective
опрем	Verb
автономно	Adjective
единадесета	Adjective
злоупотребиха	Verb
състезателна	Adjective
авансираме	Verb
най-злата	Adjective
подписвайте	Verb
агрегатно	Adjective
фериботите	Noun
изчезнех	Verb
най-проницателният	Adjective
обясните	Verb
подслушвания	Participle
боят	Noun
писателката	Noun
извлечен	Participle
съобщавайки	Converb
повторено	Participle
целият	Adjective
заподозряната	Participle
по-бодро	Adjective
създадената	Participle
гигалитре	Noun
паун	Noun
кей	Noun
мечок	Noun
пратиха	Verb
крадене	Masdar
разбираш	Verb
убиец	Noun
врабчета	Noun
изсечено	Participle
обучаване	Masdar
завеждащия	Participle
говорена	Participle
мели	Participle
писани	Participle
драката	Noun
безалкохолните	Adjective
дъвчем	Verb
светлосиня	Adjective
залязване	Masdar
ват	Noun
биография	Noun
срещано	Participle
понапечахте	Verb
потъващи	Participle
най-портокаловите	Adjective
брадите	Noun
свръхестествената	Adjective
красива	Adjective
неблагоразумен	Adjective
чудесата	Noun
ставате	Verb
словосъчетанието	Noun
тестото	Noun
живяло	Participle
изнудилите	Participle
опасат	Verb
припирам	Verb
автономният	Adjective
касапин	Noun
учителят	Noun
бившия	Adjective
стомашния	Adjective
унесоха	Verb
дворците	Noun
беглите	Adjective
азиатците	Noun
обезглавявайте	Verb
обещаното	Participle
сериозен	Adjective
гоблините	Noun
полувисша	Adjective
виждат	Verb
студентката	Noun
правели	Participle
авиационна	Adjective
адекватната	Adjective
островите	Noun
атаката	Noun
балюстрадите	Noun
търсите	Verb
будите	Verb
видеоускорителят	Noun
загубят	Verb
лекторите	Noun
щастливите	Adjective
глупчо	Noun
тесният	Adjective
анекдотите	Noun
гъвкавия	Adjective
купената	Participle
пеели	Participle
клинците	Noun
отвлякох	Verb
отключваща	Participle
авантюристът	Noun
нещото	Noun
създалата	Participle
получен	Participle
запалели	Participle
срещаме	Verb
храбрец	Noun
прочетох	Verb
потъналия	Participle
предсказания	Participle
гласуване	Masdar
дой	Verb
стани	Verb
получаващия	Participle
подобен	Adjective
калканът	Noun
ходел	Participle
оцветено	Participle
повлякъл	Participle
интересуващите	Participle
планината	Noun
азбучнико	Noun
селото	Noun
допринесеш	Verb
ненадеждна	Adjective
пеещите	Participle
исканията-нетата	Masdar
попитам	Verb
авлигите	Noun
препоръчан	Participle
искреното	Adjective
изговаряне	Masdar
будилия	Participle
умирам	Verb
препоръчаш	Verb
написала	Participle
аерогара	Noun
ароматно	Adjective
австрийката	Noun
пес	Noun
арапин	Noun
работили	Participle
врабец	Noun
алтернативите	Noun
щраусът	Noun
администраторката	Noun
перпендикулярната	Adjective
причиняваш	Verb
вишните	Noun
подметоха	Verb
виждащ	Participle
подкупят	Verb
възможен	Adjective
мразените	Participle
автомобил	Noun
кошмар	Noun
внимателният	Adjective
плътен	Adjective
силите	Noun
доказвам	Verb
опра	Verb
университетите	Noun
изслушването	Masdar
бавния	Adjective
хладилник	Noun
пепел	Noun
вратовръзка	Noun
точното	Adjective
кула	Noun
очаквай	Verb
донасят	Verb
адамово	Adjective
пеейки	Converb
плешивият	Adjective
отсъстващият	Participle
щурец	Noun
дебелеел	Participle
стоманите	Noun
дирижабъл	Noun
влезем	Verb
бърза	Adjective
капакът	Noun
мажеща	Participle
стандарт	Noun
анулирана	Participle
периодите	Noun
длани	Noun
по-белодробния	Adjective
антична	Adjective
бабанката	Noun
посещаващи	Participle
сметаната	Noun
по-абонаментното	Adjective
причинен	Participle
биеща	Participle
господарката	Noun
агитация	Noun
дяволско	Adjective
биеха	Verb
присъстващи	Participle
полуделия	Participle
започнахме	Verb
предскаже	Verb
по-състезателния	Adjective
красивото	Adjective
боядисваните	Participle
паяците	Noun
заслужаваш	Verb
чаят	Noun
пращаш	Verb
другарите	Noun
излезлия	Participle
продаваните	Participle
южен	Adjective
вестовой	Noun
зима	Noun
осиновявани	Participle
облогът	Noun
доказване	Masdar
бикът	Noun
казал	Participle
безкрайното	Adjective
капел	Participle
пили	Participle
изтичалият	Participle
свръхестественото	Adjective
чуйте	Verb
унищожаваме	Verb
вълкът	Noun
хапел	Participle
заспиване	Masdar
несъмнените	Adjective
бозайниците	Noun
надеждите	Noun
антрополозите	Noun
любезният	Adjective
балнеолечение	Noun
бременността	Noun
посетени	Participle
рушветите	Noun
закусваш	Verb
търсенето	Masdar
разнасяна	Participle
тичане	Masdar
произлезли	Participle
аморфна	Adjective
крило	Noun
оцеляване	Masdar
азиатският	Adjective
бие	Verb
ходил	Participle
джамия	Noun
доказаната	Participle
използвания	Participle
най-турския	Adjective
помитащо	Participle
продължавате	Verb
немското	Adjective
прочитат	Verb
нанометрите	Noun
ставаш	Verb
използвай	Verb
реалистичната	Adjective
осъществимо	Adjective
преведените	Participle
обещала	Participle
абдукция	Noun
азотния	Adjective
красивият	Adjective
пасъл	Participle
снесено	Participle
възпрат	Verb
саркастичен	Adjective
излезехме	Verb
любителското	Adjective
довели	Participle
мечтали	Participle
тревогата	Noun
полувисшия	Adjective
жабоците	Noun
упреквайте	Verb
вършеейки	Converb
запичане	Masdar
ароматното	Adjective
винени	Participle
превъзнесял	Participle
ядосаният	Adjective
зидар	Noun
авиационния	Adjective
пълното	Adjective
правила	Participle
акварелист	Noun
избол	Participle
по-азбестовото	Adjective
алено	Adjective
автоматичният	Adjective
чучулиго	Noun
обвиняхме	Verb
почитащ	Participle
загинали	Participle
оцветени	Participle
правителства	Noun
пещерата	Noun
изгубен	Participle
мечтаният	Participle
обучавайки	Converb
продължавалия	Participle
слоницата	Noun
пометена	Participle
гаджета	Noun
по-наивният	Adjective
бегълката	Noun
дебелите	Adjective
по-цялото	Adjective
отваряйки	Converb
възпиращи	Participle
невярното	Adjective
вуйчото	Noun
документът	Noun
ягодата	Noun
пратената	Participle
актьор	Noun
наречени	Participle
нанасянето	Masdar
влизаме	Verb
причинил	Participle
примрелите	Participle
сравняван	Participle
създаващи	Participle
създалите	Participle
преживявалата	Participle
по-низше	Adjective
мускулестият	Adjective
студовете	Noun
сандалът	Noun
варварския	Adjective
кралю	Noun
съгласие	Noun
овче	Adjective
изчезвалите	Participle
царевицата	Noun
плугът	Noun
обезглавен	Participle
любопитните	Adjective
ябълково	Adjective
телевизоре	Noun
повтарящ	Participle
получих	Verb
часовникът	Noun
продаваща	Participle
фериботът	Noun
изпечен	Participle
забранена	Participle
по-решителен	Adjective
побеждавай	Verb
овцете	Noun
подвеждани	Participle
измяна	Noun
светлина	Noun
заповядат	Verb
канелата	Noun
чакаш	Verb
платите	Verb
предрекла	Participle
по-влажната	Adjective
най-кривите	Adjective
казващо	Participle
славна	Adjective
биеш	Verb
изпасваните	Participle
мразим	Verb
съперницата	Noun
заплашено	Participle
убих	Verb
навело	Participle
кралица	Noun
изковавалите	Participle
ушия	Verb
обсъждаш	Verb
граничеща	Participle
алкохолна	Adjective
скуби	Verb
будиш	Verb
аналният	Adjective
по-плешивите	Adjective
касапите	Noun
мечтаейки	Converb
розите	Noun
водораслите	Noun
слънчевите	Adjective
аварийното	Adjective
най-инфантилното	Adjective
отрицателното	Adjective
овчата	Adjective
пуйка	Noun
бушуващите	Participle
алкохолните	Adjective
несериозното	Adjective
най-източния	Adjective
убиван	Participle
отваряте	Verb
очи	Noun
произнасяйки	Converb
вечността	Noun
обилните	Adjective
албанските	Adjective
абстрактната	Adjective
спасените	Participle
автентичният	Adjective
азотният	Adjective
псета	Noun
обучено	Participle
адресиране	Masdar
чути	Participle
анатемосаните	Participle
дела	Noun
аплодирани	Participle
анакондата	Noun
стайо	Noun
благодаря	Verb
закуска	Noun
по-обилен	Adjective
въшка	Noun
отворили	Participle
спестяваме	Verb
жестокото	Adjective
ъглите	Noun
слизащата	Participle
деляща	Participle
озадачават	Verb
доле	Noun
кит	Noun
купюр	Noun
момичето	Noun
забавите	Noun
пестил	Participle
суеверията	Noun
повторени	Participle
казахме	Verb
желязната	Adjective
изведена	Participle
мъжа	Noun
най-пуйче	Adjective
принуждавани	Participle
граничите	Verb
антилопите	Noun
строено	Participle
упреквате	Verb
сирената	Noun
правиш	Verb
вятърът	Noun
черният	Adjective
допират	Verb
подобрили	Participle
гласуващ	Participle
полудееш	Verb
хапи	Verb
завлечени	Participle
посещаването	Masdar
левът	Noun
по-хубавата	Adjective
чешкият	Adjective
отхапваният	Participle
благославяне	Masdar
снесената	Participle
небесата	Noun
изговарялото	Participle
ранени	Participle
мечтаеща	Participle
пратен	Participle
сражения	Noun
преживяла	Participle
знаме	Noun
изковаващият	Participle
съвременния	Adjective
център	Noun
злоупотребилото	Participle
червената	Adjective
шизофрениците	Noun
подклал	Participle
арменките	Noun
щастливата	Adjective
пътуване	Masdar
маймуните	Noun
вселена	Noun
убеждавам	Verb
орлиците	Noun
потичалия	Participle
уплашват	Verb
избирани	Participle
отвличайте	Verb
по-бледосиният	Adjective
бузо	Noun
препоръчам	Verb
фасулът	Noun
зачитайки	Converb
заслужилия	Participle
човекът	Noun
доведа	Verb
лицето	Noun
болестите	Noun
пренесените	Participle
говорим	Verb
леглата	Noun
учещ	Participle
пеене	Masdar
невнимателните	Adjective
опечен	Participle
по-ябълков	Adjective
клюнът	Noun
предсказващият	Participle
пиявицата	Noun
подпиран	Participle
казани	Participle
тегоба	Noun
разболяло	Participle
абхазката	Adjective
разболяващо	Participle
сприятелят	Verb
даващите	Participle
спестявания	Participle
допирана	Participle
можаха	Verb
сила	Noun
лимоне	Noun
безкрайният	Adjective
кризите	Noun
актуалният	Adjective
недостатъчен	Adjective
болногледаческото	Adjective
превозите	Noun
хубаво	Adjective
пожарите	Noun
рачиха	Verb
ползващите	Participle
надебеляващо	Participle
широка	Adjective
по-алтовите	Adjective
атака	Noun
плащаме	Verb
ухапал	Participle
обещавам	Verb
влечуго	Noun
чула	Participle
победената	Participle
швейцарската	Adjective
гладния	Adjective
обличат	Verb
забравихте	Verb
зрящ	Participle
питайте	Verb
работещи	Participle
победилите	Participle
спираща	Participle
прочитащата	Participle
съобщаване	Masdar
палките	Noun
дециметър	Noun
унгарските	Adjective
далите	Participle
македонската	Adjective
ага	Noun
кожа	Noun
забранили	Participle
извеждаща	Participle
обесвалия	Participle
получаването	Masdar
гвоздей	Noun
граничейки	Converb
глухонемите	Adjective
очно	Adjective
авиаторът	Noun
обсъдим	Verb
лекомисленото	Adjective
най-перпендикулярната	Adjective
потресохте	Verb
нареченият	Participle
навлезлите	Participle
благословена	Participle
получаващо	Participle
принуждават	Verb
използването	Masdar
големите	Adjective
анонимният	Adjective
срещащата	Participle
говорело	Participle
зъболекарят	Noun
мълнията	Noun
комерсиалният	Adjective
сирена	Noun
ограничавайки	Converb
аванпост	Noun
пия	Verb
дена	Noun
потъване	Masdar
боядисан	Participle
водата	Noun
хоризонтално	Adjective
изчезналото	Participle
турчинът	Noun
сравнено	Participle
спестяването	Masdar
мразите	Verb
пращано	Participle
убит	Participle
желаейки	Converb
вселената	Noun
цено	Noun
повярвам	Verb
асирийката	Noun
принесена	Participle
ангелите	Noun
запичаното	Participle
бяла	Adjective
зъбците	Noun
изпичания	Participle
южната	Adjective
давате	Verb
убедиш	Verb
причиняващ	Participle
глупавото	Adjective
удовлетворяване	Masdar
повторения	Participle
намерения	Noun
одобрено	Participle
мъдрост	Noun
славеите	Noun
песента	Noun
съседите	Noun
пясъците	Noun
метеорът	Noun
залязвам	Verb
създаваната	Participle
навлечал	Participle
съчетаващият	Participle
произнесено	Participle
високо	Adjective
плашиш	Verb
спрени	Participle
алената	Adjective
свещ	Noun
сияеща	Participle
компетентност	Noun
пасли	Participle
бивша	Adjective
седмия	Adjective
използвано	Participle
препечени	Participle
накълвавалия	Participle
навлякъл	Participle
убиват	Verb
съобщението	Noun
австралиец	Noun
мекотелите	Noun
напредващи	Participle
разрешителните	Noun
гласуваната	Participle
абревиатурата	Noun
приятелството	Noun
проповед	Noun
изнудват	Verb
целувай	Verb
четат	Verb
виниха	Verb
бягащо	Participle
евнух	Noun
обсъждаща	Participle
северозападният	Adjective
индивидуалности	Noun
двубоят	Noun
разсъдителното	Adjective
прочетеното	Participle
американският	Adjective
простил	Participle
създавания	Participle
съчетае	Verb
господарския	Adjective
елипса	Noun
избрани	Participle
щастлив	Adjective
меде	Noun
извличания-нета	Masdar
студена	Adjective
градушката	Noun
абонат	Noun
лятото	Noun
голям	Adjective
избиране	Masdar
аборигенско	Adjective
покривът	Noun
непоколебим	Adjective
неголямата	Adjective
отворя	Verb
гласът	Noun
небеса	Noun
по-яловия	Adjective
отварян	Participle
най-северняшкият	Adjective
сядане	Masdar
китът	Noun
яйцевидна	Adjective
охраняването	Masdar
зъбът	Noun
посетиха	Verb
заливите	Noun
соколите	Noun
посещавам	Verb
бактериен	Adjective
челото	Participle
разбраната	Participle
умират	Verb
простиращия	Participle
бърно	Noun
горяща	Participle
тъжната	Adjective
снежинките	Noun
клине	Noun
радялата	Participle
обсъждана	Participle
наследила	Participle
изминато	Participle
посещават	Verb
решах	Verb
интересуващия	Participle
забранят	Verb
алхимиците	Noun
прочетени	Participle
вуйчовците	Noun
лекарствата	Noun
по-азбестовите	Adjective
съвършения	Adjective
далият	Participle
магаре	Noun
сънуваш	Verb
привнасяне	Masdar
понесла	Participle
заслужаващ	Participle
абревиатура	Noun
чудото	Noun
гуляй	Noun
безскрупулна	Adjective
токо	Noun
летата	Noun
съвършено	Adjective
масата	Noun
загине	Verb
отнасяйте	Verb
обичаната	Participle
палец	Noun
подчертаващият	Participle
алуминиево	Adjective
клетвата	Noun
подпиралата	Participle
съперник	Noun
заплашваща	Participle
деня	Noun
живеещия	Participle
прегръщащото	Participle
треса	Verb
атинянин	Noun
бесите	Verb
стандартът	Noun
коронясани	Participle
прочетен	Participle
възлизащ	Participle
търтей	Noun
бушуват	Verb
взимани	Participle
сокът	Noun
гърда	Noun
правена	Participle
зареден	Participle
предупреждавана	Participle
третото	Adjective
молещите	Participle
браво	Noun
осмият	Adjective
кварките	Noun
сравнявана	Participle
гейовете	Noun
падежът	Noun
ползващо	Participle
нагризваме	Verb
озаглавяват	Verb
тясна	Adjective
най-гребно	Adjective
отрицателния	Adjective
лукавото	Adjective
зрелите	Participle
бяло	Adjective
запиращия	Participle
получаваща	Participle
въжето	Noun
абитуриентко	Noun
изчезващо	Participle
обзаведени	Participle
вина	Noun
костенурката	Noun
най-космест	Adjective
обсъден	Participle
падай	Verb
декалитрите	Noun
здрав	Adjective
отвесните	Adjective
удовлетворих	Verb
оргазма	Noun
изпълнимите	Adjective
забременяват	Verb
повелите	Participle
тънките	Adjective
забравените	Participle
говорих	Verb
повторим	Verb
съществуваща	Participle
поглеждам	Verb
купуваната	Participle
изчел	Participle
поднесат	Verb
изнасян	Participle
котките	Noun
наказвани	Participle
прелъстил	Participle
германките	Noun
умрелият	Participle
августовската	Adjective
злоупотребяващ	Participle
посетеният	Participle
възможното	Adjective
ставащи	Participle
яка	Adjective
шкаф	Noun
въоръжаване	Masdar
тъпа	Adjective
отнасяш	Verb
запиран	Participle
продължавай	Verb
по-правителственият	Adjective
битка	Noun
мечките	Noun
отец	Noun
нивото	Noun
изтичащ	Participle
поведял	Participle
пожарът	Noun
прощавалата	Participle
създалото	Participle
плащате	Verb
мишият	Adjective
хомосексуалните	Adjective
палко	Noun
корена	Participle
носорог	Noun
златните	Adjective
ученичките	Noun
краищата	Noun
бит	Participle
дом	Noun
въвлечени	Participle
тежкият	Adjective
сложените	Adjective
препрочели	Participle
наведа	Verb
доведем	Verb
по-компетентния	Adjective
безкрайната	Adjective
приятелката	Noun
обзавеждат	Verb
узаконяването	Masdar
по-ненадеждно	Adjective
бременна	Adjective
косата	Noun
по-цяло	Adjective
чествано	Participle
по-бедният	Adjective
изкусна	Adjective
по-очните	Adjective
влязох	Verb
бързеите	Noun
провиралото	Participle
зрелият	Participle
цитат	Noun
очакващи	Participle
изнудвай	Verb
брашно	Noun
най-гръдният	Adjective
алжирка	Noun
храст	Noun
каната	Noun
коремите	Noun
изпитвате	Verb
сливата	Noun
сека	Verb
свещениците	Noun
виждащото	Participle
племенницата	Noun
майко	Noun
касто	Noun
малините	Noun
царството	Noun
причинена	Participle
чешкото	Adjective
навираща	Participle
по-тъпото	Adjective
мечтая	Verb
съобщено	Participle
уплашеният	Participle
джуджетата	Noun
пясък	Noun
арка	Noun
превеждано	Participle
съчетаване	Masdar
естетична	Adjective
монахът	Noun
виждалата	Participle
половината	Noun
ухапаха	Verb
благото	Adjective
изметения	Participle
повела	Participle
важен	Adjective
прелъстяване	Masdar
подкупихме	Verb
донасялото	Participle
хладилниците	Noun
говорели	Participle
желязна	Adjective
създалия	Participle
произлизаща	Participle
решаваща	Participle
ботуш	Noun
повлеченото	Participle
отвореният	Participle
използване	Masdar
некадърен	Adjective
нивите	Noun
съперничката	Noun
по-учтиво	Adjective
низшият	Adjective
болест	Noun
скъпия	Adjective
счупвам	Verb
кана	Noun
поизметели	Participle
изневерите	Noun
платил	Participle
вярваме	Verb
хубавица	Noun
умиращото	Participle
мускулно	Adjective
амбициозният	Adjective
подчертахте	Verb
красивата	Adjective
авторитетен	Adjective
цялата	Adjective
безстрашен	Adjective
събудят	Verb
гласувано	Participle
бакалавър	Noun
обезглавяваният	Participle
спряно	Participle
по-шведската	Adjective
яйце	Noun
прекрасният	Adjective
довеждането	Masdar
спряното	Participle
прекрасно	Adjective
белият	Adjective
забравеният	Participle
изнасящ	Participle
изминем	Verb
разстоянията	Noun
коловете	Noun
бобрите	Noun
бягай	Verb
абдикация	Noun
авторското	Adjective
тъмносиня	Adjective
извлечено	Participle
влезлия	Participle
мъжът	Noun
тъмносин	Adjective
довел	Participle
дебелият	Adjective
по-правителствена	Adjective
анален	Adjective
истина	Noun
феята	Noun
ветре	Noun
по-сложен	Adjective
гласуващите	Participle
ушие	Verb
желана	Participle
спирано	Participle
накажат	Verb
назовавалият	Participle
бактерийно	Adjective
отнесени	Participle
анулират	Verb
чиракът	Noun
пращат	Verb
актуален	Adjective
избрах	Verb
използваща	Participle
антилопа	Noun
пълна	Adjective
начетяла	Participle
изплашените	Participle
жестоките	Adjective
благоразумните	Adjective
спрат	Verb
упрекнал	Participle
най-южняшка	Adjective
табута	Noun
насмитаните	Participle
съперникът	Noun
кораб	Noun
построения	Participle
левите	Adjective
граничещ	Participle
обзаведено	Participle
гончетата	Noun
авиационно	Adjective
въпрос	Noun
режещият	Participle
саркастична	Adjective
спрею	Noun
кошуля	Noun
дворец	Noun
инвестирането	Masdar
пято	Participle
отсека	Verb
завлекли	Participle
фемтолитре	Noun
режели	Participle
обучаването	Masdar
противобясна	Adjective
абсолютните	Adjective
поведението	Noun
опака	Adjective
надвнасялата	Participle
танцувам	Verb
губел	Participle
продължили	Participle
нанесеното	Participle
най-доверчивите	Adjective
преведеното	Participle
търсеният	Participle
говорен	Participle
присъстващите	Participle
водораслото	Noun
припевът	Noun
дало	Participle
доказваме	Verb
компетентния	Adjective
крокодилът	Noun
цветя	Noun
по-топлото	Adjective
анално	Adjective
аксиомите	Noun
пушене	Masdar
създавайки	Converb
глезло	Noun
чукундур	Noun
сраното	Participle
автомат	Noun
безразсъдно	Adjective
изгубили	Participle
жълто	Adjective
изсичане	Masdar
абсолютното	Adjective
най-деветата	Adjective
закусел	Participle
допринасям	Verb
чашата	Noun
плетени	Participle
писахте	Verb
изнудел	Participle
тежкото	Adjective
най-новият	Adjective
англичанинът	Noun
кошница	Noun
схватките	Noun
ходилия	Participle
алгоритмите	Noun
построиха	Verb
нанесъл	Participle
астрологът	Noun
мачовете	Noun
сандал	Noun
погребват	Verb
опичалия	Participle
дребните	Adjective
кокошките	Noun
танцувалата	Participle
доказаха	Verb
търг	Noun
полудея	Verb
въоръжавани	Participle
сприятеляваш	Verb
забравяйки	Converb
звънец	Noun
земьо	Noun
атиняните	Noun
най-истинска	Adjective
друго	Adjective
изнудиха	Verb
наследили	Participle
извлекат	Verb
отречеш	Verb
играят	Verb
пътуващата	Participle
лешът	Noun
трева	Noun
надвнесло	Participle
зачитан	Participle
нанесената	Participle
сърцата	Noun
бесилото	Participle
хамбар	Noun
грозното	Adjective
интелигентно	Adjective
чели	Participle
черното	Adjective
учителите	Noun
загубеното	Participle
препоръчвания	Participle
касапинът	Noun
умреш	Verb
заметяла	Participle
произлязат	Verb
завеждане	Masdar
истинска	Adjective
получехте	Verb
платим	Verb
доведен	Participle
слънцата	Noun
сякъл	Participle
слончета	Noun
зеленото	Adjective
поднесената	Participle
азотното	Adjective
антителата	Noun
търсеното	Participle
тъжно	Adjective
молел	Participle
отсичането	Masdar
по-деветото	Adjective
можем	Verb
организма	Noun
алжирците	Noun
забранените	Participle
прощавайте	Verb
съгласията	Noun
отче	Noun
протичането	Masdar
обсъдили	Participle
интересуваш	Verb
най-жълтата	Adjective
турските	Adjective
предсказана	Participle
чакащи	Participle
наплели	Participle
седмата	Adjective
слоновете	Noun
по-опакото	Adjective
бедрото	Noun
генералисимус	Noun
вероятния	Adjective
заораващо	Participle
мускулния	Adjective
одобряване	Masdar
злоупотребяващи	Participle
причинявалата	Participle
оцет	Noun
изпечала	Participle
градина	Noun
циците	Noun
желаното	Participle
пренасяш	Verb
античната	Adjective
глупавия	Adjective
або	Noun
танцуване	Masdar
започвалите	Participle
опечения	Participle
умелото	Adjective
веществено	Adjective
наковавате	Verb
абитуриент	Noun
архаизъм	Noun
убедени	Participle
търсената	Participle
космест	Adjective
по-кратко	Adjective
азбуката	Noun
понавлизащ	Participle
разпростирайки	Converb
безбожния	Adjective
изплашат	Verb
рачещото	Participle
медицинско	Adjective
правещо	Participle
ваза	Noun
зашиват	Verb
уклончив	Adjective
опираща	Participle
мъртвец	Noun
аналитичния	Adjective
написване	Masdar
донесъл	Participle
училището	Noun
княже	Noun
забременелите	Participle
забраната	Noun
авангардните	Adjective
арнаут	Noun
прегърнати	Participle
губейки	Converb
закупили	Participle
амониевия	Adjective
бодра	Adjective
умните	Adjective
отричан	Participle
студентстванията-нетата	Masdar
уплашена	Participle
красивия	Adjective
изобретателят	Noun
обвинили	Participle
даващ	Participle
отчитане	Masdar
потушаващият	Participle
атомното	Adjective
водният	Adjective
по-очен	Adjective
изплашили	Participle
срещащи	Participle
отключите	Verb
разплачеш	Verb
голямата	Adjective
пръчката	Noun
естетично	Adjective
мело	Participle
драка	Noun
снимка	Noun
чупилото	Participle
наведен	Participle
най-креативният	Adjective
тухла	Noun
пил	Participle
казващ	Participle
ставаща	Participle
по-досадната	Adjective
автоматична	Adjective
по-западното	Adjective
храната	Noun
отчетената	Participle
източен	Adjective
будената	Participle
аскерът	Noun
изпяваме	Verb
разбирането	Masdar
зеления	Adjective
гърцизъм	Noun
длан	Noun
топлият	Adjective
овчите	Adjective
отчитана	Participle
коронясване	Masdar
царства	Noun
дълга	Adjective
изминаващите	Participle
най-авангардна	Adjective
пиша	Verb
изговорена	Participle
азотна	Adjective
горим	Verb
пречупения	Participle
ходене	Masdar
кулата	Noun
отличната	Adjective
досадния	Adjective
другарка	Noun
отворите	Verb
опит	Noun
ягода	Noun
племена	Noun
целувам	Verb
извела	Participle
продаваният	Participle
присъствате	Verb
векът	Noun
вдишваните	Participle
астероид	Noun
изобретател	Noun
комбинираният	Participle
железния	Adjective
работиха	Verb
въврените	Participle
гърцизма	Noun
разбирания	Participle
верига	Noun
донесли	Participle
безкрайно	Adjective
гневен	Adjective
гласуващи	Participle
изминаването	Masdar
победило	Participle
саркастичния	Adjective
съществуващи	Participle
принуждавам	Verb
потънал	Participle
чакащ	Participle
уплашено	Participle
подобрявайки	Converb
езикознанието	Noun
бралото	Participle
частта	Noun
ябълковото	Adjective
произлезлите	Participle
препоръчвано	Participle
изречена	Participle
по-алкохолната	Adjective
най-реалният	Adjective
елените	Noun
ягодово	Adjective
вземат	Verb
затъмнения	Noun
упрекват	Verb
козел	Noun
забравени	Participle
подобрявайте	Verb
дояло	Participle
убивайки	Converb
припиралия	Participle
бъбрекът	Noun
виня	Verb
веществен	Adjective
завличат	Verb
щастливият	Adjective
използващия	Participle
прочетените	Participle
пренасянето	Masdar
важните	Adjective
леката	Adjective
косатка	Noun
танцуващо	Participle
препоръчвам	Verb
антените	Noun
разлюбвалият	Participle
заекът	Noun
интересуваното	Participle
плешивия	Adjective
досаден	Adjective
автентично	Adjective
винил	Participle
обесвана	Participle
акцентът	Noun
сестричка	Noun
пътувате	Verb
убедя	Verb
съвършен	Adjective
подписаха	Verb
боядисване	Masdar
по-аварийна	Adjective
прегръщаното	Participle
по-германската	Adjective
решаващо	Participle
бедно	Adjective
изсичат	Verb
най-низшия	Adjective
ходили	Participle
дело	Noun
победата	Noun
побеждаваме	Verb
опасен	Participle
ялова	Adjective
нахапващата	Participle
снесохме	Verb
даващи	Participle
вковаващото	Participle
неутрино	Noun
евнусите	Noun
купувайте	Verb
по-лекия	Adjective
дългият	Adjective
саркастично	Adjective
пилетата	Noun
аварските	Adjective
слънчева	Adjective
ометеното	Participle
чайка	Noun
чужденката	Noun
разнасящи	Participle
берат	Verb
предскажехте	Verb
екзарх	Noun
бързите	Adjective
говорехме	Verb
съвременните	Adjective
заведял	Participle
платя	Verb
спестяват	Verb
храсте	Noun
интересуват	Verb
строената	Participle
авторитет	Noun
най-австрийската	Adjective
подписах	Verb
ковчезите	Noun
подчертания	Participle
разпростиран	Participle
отричаните	Participle
най-лястовичите	Adjective
изпия	Verb
най-августейшият	Adjective
астероидът	Noun
опасохте	Verb
убедиха	Verb
хубавицата	Noun
храброто	Adjective
изчезване	Masdar
плакало	Participle
живея	Verb
изсечения	Participle
подобрят	Verb
превеждаме	Verb
отмре	Verb
загубвайки	Converb
ограничите	Verb
компетентността	Noun
зелените	Adjective
гъвкавите	Adjective
компетентно	Adjective
главите	Noun
значителната	Adjective
потресяхме	Verb
енергична	Adjective
започвате	Verb
дюля	Noun
продължаваната	Participle
произнесохме	Verb
разбереш	Verb
яребицата	Noun
наивно	Adjective
кривата	Adjective
самолет	Noun
най-предпазливите	Adjective
най-лесният	Adjective
спестя	Verb
прощаване	Masdar
обучавано	Participle
донасянето	Masdar
елен	Noun
навестяващия	Participle
подобните	Adjective
избрало	Participle
предскажехме	Verb
пасейки	Converb
плашения-нета	Masdar
импровизатор	Noun
принуждавай	Verb
по-треторазреден	Adjective
мечтай	Verb
богинята	Noun
най-авиаторско	Adjective
шофьорът	Noun
окото	Noun
анилиновият	Adjective
бира	Noun
мускулна	Adjective
старата	Adjective
по-несъмненият	Adjective
удовлетворяващо	Participle
азбучен	Adjective
опридам	Verb
правилата	Participle
кладейки	Converb
живеещият	Participle
наранено	Participle
балканът	Noun
лекарката	Noun
гъбите	Noun
автогол	Noun
най-австралийско	Adjective
сребърният	Adjective
котка	Noun
героиня	Noun
оцветеното	Participle
пета	Adjective
наследявате	Verb
връх	Noun
по-различна	Adjective
заслужавате	Verb
учениците	Noun
по-гръдната	Adjective
припичам	Verb
запичани	Participle
намерението	Noun
най-албанските	Adjective
насичания-нета	Masdar
кукла	Noun
бий	Verb
правителство	Noun
реалистично	Adjective
ухото	Noun
десета	Adjective
съветвайки	Converb
абсолютният	Adjective
най-чернодробно	Adjective
крилете	Noun
корем	Noun
изслушване	Masdar
навлизане	Masdar
арийците	Noun
жерав	Noun
запечени	Participle
вино	Noun
капели	Participle
сляза	Verb
наоблякохме	Verb
говореха	Verb
безформен	Adjective
македонското	Adjective
агрономство	Noun
тъпите	Adjective
влизаща	Participle
припирани	Participle
отсъстват	Verb
госпожата	Noun
прозираните	Participle
некомпетентно	Adjective
грозно	Adjective
изгубеха	Verb
можели	Participle
желаещи	Participle
порнографските	Adjective
доказал	Participle
уплашен	Participle
ядящо	Participle
надонасялите	Participle
одеяние	Noun
орач	Noun
аморфната	Adjective
изгубят	Verb
езера	Noun
бежанецът	Noun
стаята	Noun
заведат	Verb
чуванията-нетата	Masdar
словенец	Noun
документ	Noun
желаещото	Participle
стрехите	Noun
пасеното	Participle
погребвайте	Verb
наречените	Participle
агрономството	Noun
по-ароматично	Adjective
опаката	Adjective
получилият	Participle
посетяла	Participle
различните	Adjective
потушеното	Participle
аналните	Adjective
десетите	Adjective
кошниците	Noun
тичай	Verb
по-възтясно	Adjective
иконата	Noun
неща	Noun
портокалите	Noun
най-висок	Adjective
наводнявани	Participle
бушуваща	Participle
търсих	Verb
опако	Adjective
ледовете	Noun
белгийка	Noun
пъргавия	Adjective
белодробния	Adjective
творенията	Noun
давай	Verb
счупят	Verb
създаване	Masdar
раняват	Verb
пята	Participle
прелъстяван	Participle
по-благоразумната	Adjective
по-бавния	Adjective
започнахте	Verb
атомните	Adjective
еленът	Noun
причинената	Participle
простим	Verb
анатомичния	Adjective
изчетохме	Verb
бедният	Adjective
писаната	Participle
пилето	Noun
ограничени	Participle
белодробното	Adjective
зачеват	Verb
закупил	Participle
компютрите	Noun
оскъдна	Adjective
неутрината	Noun
падалия	Participle
господарствуващият	Participle
еластичните	Adjective
обесила	Participle
съществителното	Noun
аристокрацията	Noun
ранения	Participle
авиаторската	Adjective
вертикалните	Adjective
нанасящи	Participle
прочетеш	Verb
отболите	Participle
съчетано	Participle
изричайки	Converb
купени	Participle
преведат	Verb
скубело	Participle
лопатите	Noun
произлезел	Participle
втечняват	Verb
пренасяме	Verb
по-лукавата	Adjective
пристигащия	Participle
повели	Participle
търсила	Participle
припекло	Participle
активната	Adjective
поспрян	Participle
стъклото	Noun
животни	Noun
допринасящия	Participle
изпитваща	Participle
нанесени	Participle
бактериалния	Adjective
убедим	Verb
опасеното	Participle
реалният	Adjective
възлизат	Verb
наоблечения	Participle
раним	Verb
засечели	Participle
капаците	Noun
съзряната	Participle
предсказан	Participle
държавата	Noun
бедния	Adjective
горящ	Participle
доведена	Participle
напиша	Verb
сечена	Participle
четяло	Participle
наетия	Participle
замъкът	Noun
арабите	Noun
сериозната	Adjective
микрометра	Noun
месецът	Noun
захапват	Verb
маймуната	Noun
нает	Participle
допринесла	Participle
жълъдите	Noun
аналогът	Noun
зачитанията-нетата	Masdar
продължени	Participle
кравата	Noun
хрян	Noun
изпитам	Verb
по-хубав	Adjective
инвестираме	Verb
лекия	Adjective
повярвайте	Verb
повторят	Verb
сечените	Participle
дяволският	Adjective
майките	Noun
любопитен	Adjective
забременеехме	Verb
алармата	Noun
превели	Participle
зетят	Noun
убедила	Participle
съобщаван	Participle
паланка	Noun
умовете	Noun
полковникът	Noun
орлетата	Noun
ябълка	Noun
краденето	Masdar
предсказани	Participle
дебелата	Adjective
нагризват	Verb
легализирана	Participle
бедните	Adjective
дебело	Adjective
събудя	Verb
кутийо	Noun
мечка	Noun
поспирания-нета	Masdar
влязъл	Participle
бензинът	Noun
австралийците	Noun
косме	Noun
намеквай	Verb
построих	Verb
огън	Noun
къртица	Noun
зачевайте	Verb
започнах	Verb
потъвайки	Converb
по-активно	Adjective
падалото	Participle
дядовците	Noun
коч	Noun
руското	Adjective
предупредили	Participle
пренасящо	Participle
кожусите	Noun
далия	Participle
обучаващите	Participle
отвориш	Verb
опитен	Adjective
немците	Noun
подробния	Adjective
спирайте	Verb
агитката	Noun
скучно	Adjective
произнасяни	Participle
правителството	Noun
калфата	Noun
нанесло	Participle
създадохме	Verb
учел	Participle
наклаждам	Verb
страданието	Noun
бадемът	Noun
мога	Verb
убеждаваме	Verb
разплакана	Participle
съществуващия	Participle
кажеш	Verb
отхапаният	Participle
обилен	Adjective
будихме	Verb
станалата	Participle
потушавани	Participle
самолетът	Noun
пиявица	Noun
танцуваща	Participle
стомашно	Adjective
изминали	Participle
правителствения	Adjective
доказала	Participle
унищожения	Participle
валидния	Adjective
арестуван	Participle
погребвалият	Participle
разбран	Participle
съществително	Noun
изневярата	Noun
построили	Participle
изпила	Participle
чужденец	Noun
одобряваме	Verb
изтекла	Participle
подклаждане	Masdar
фениксът	Noun
ограничаван	Participle
отчитащ	Participle
благородния	Adjective
затъмненията	Noun
вълците	Noun
инфантилната	Adjective
простят	Verb
неважната	Adjective
кочовете	Noun
подписан	Participle
реалистичните	Adjective
напредналата	Participle
обвиняваш	Verb
разплаквани	Participle
аналитичните	Adjective
заслужаваме	Verb
купуване	Masdar
смел	Adjective
пристигнехме	Verb
кради	Verb
гърлата	Noun
значителният	Adjective
таралеж	Noun
агата	Noun
узаконени	Participle
буден	Participle
принесен	Participle
повлякла	Participle
австрийка	Noun
акцент	Noun
спестени	Participle
по-досадните	Adjective
строен	Participle
изговаряната	Participle
влязла	Participle
събудилото	Participle
спираното	Participle
заспал	Participle
азбука	Noun
ходели	Participle
грозната	Adjective
прегърнала	Participle
вдишвания	Participle
австралийската	Adjective
практичният	Adjective
прочетеният	Participle
мускулестото	Adjective
изчезващи	Participle
отичане	Masdar
разхождат	Verb
спечели	Participle
неутриното	Noun
допрени	Participle
шесто	Adjective
произлизания-нета	Masdar
искащи	Participle
второто	Adjective
малино	Noun
начетен	Participle
отвлечения	Participle
космат	Adjective
кантар	Noun
разбиране	Masdar
наказал	Participle
раненият	Participle
козелът	Noun
преживяло	Participle
живеете	Verb
месото	Noun
заредена	Participle
играни	Participle
битпазаре	Noun
закупуваните	Participle
започната	Participle
капане	Masdar
стремето	Noun
отворят	Verb
почитаме	Verb
чупенето	Masdar
мускулен	Adjective
ходещите	Participle
небрежното	Adjective
изминавай	Verb
влажната	Adjective
докторка	Noun
могли	Participle
енергичната	Adjective
смазали	Participle
литърът	Noun
спасяват	Verb
презиращо	Participle
спрежение	Noun
построят	Verb
смените	Noun
търсен	Participle
владика	Noun
доведох	Verb
ароматично	Adjective
тъжните	Adjective
отречено	Participle
целуват	Verb
аероснимка	Noun
зайка	Noun
югоизточната	Adjective
писаното	Participle
пронасяните	Participle
портокалът	Noun
заченалия	Participle
слизащ	Participle
съблазни	Noun
слънчевият	Adjective
кълвачите	Noun
изговорим	Verb
по-анархичен	Adjective
влъхва	Noun
невярно	Adjective
отбодения	Participle
сладките	Adjective
членестоногите	Noun
архаичните	Adjective
запечено	Participle
винилите	Participle
актриса	Noun
минарето	Noun
озадачавани	Participle
състезателните	Adjective
създадена	Participle
зъб	Noun
почитаният	Participle
горяло	Participle
умно	Adjective
извели	Participle
учтив	Adjective
наследения	Participle
четящите	Participle
администрация	Noun
лукаво	Adjective
евтина	Adjective
учения	Participle
алвеола	Noun
модификацията	Noun
оскъдното	Adjective
коронясвани	Participle
живеело	Participle
решат	Verb
лястовиците	Noun
пасели	Participle
внимателния	Adjective
съвършеният	Adjective
превъзнесената	Participle
заслужаващо	Participle
будим	Verb
уволнилите	Participle
новото	Adjective
навирания	Participle
писател	Noun
навлязат	Verb
лекото	Adjective
залязвалите	Participle
ключовете	Noun
уклончиво	Adjective
част	Noun
измамата	Noun
изпечена	Participle
заслужават	Verb
ясния	Adjective
вълко	Noun
станалите	Participle
сънувам	Verb
горяла	Participle
авансово	Adjective
анекдотът	Noun
заплашвани	Participle
най-гладна	Adjective
решавайки	Converb
златната	Adjective
четвъртия	Adjective
унищожена	Participle
работели	Participle
промяна	Noun
решения	Participle
атом	Noun
виждания	Participle
най-босичката	Adjective
бушуващото	Participle
втора	Adjective
шефе	Noun
начетена	Participle
по-южняшко	Adjective
светлосиньо	Adjective
изпитана	Participle
възможностите	Noun
течност	Noun
навиращия	Participle
мрем	Verb
влахините	Noun
тъмносиният	Adjective
спасяващи	Participle
саркастичното	Adjective
отрицателният	Adjective
слезли	Participle
оцветила	Participle
изпитвани	Participle
най-умният	Adjective
благодарих	Verb
по-кратките	Adjective
частите	Noun
усърдното	Adjective
зашивате	Verb
унищожените	Participle
южнякът	Noun
почваш	Verb
говоря	Verb
анатемата	Noun
ловкият	Adjective
потъналият	Participle
по-морскосиньо	Adjective
продължаващия	Participle
прочитаща	Participle
заплашване	Masdar
наказанията	Noun
буза	Noun
генерал	Noun
пътуващият	Participle
напредналите	Participle
лихвите	Noun
отчетяха	Verb
взвод	Noun
плакал	Participle
изслушвайки	Converb
болницата	Noun
зачитаното	Participle
биографията	Noun
козия	Adjective
яденето	Masdar
ушита	Participle
змеят	Noun
авеню	Noun
използвани	Participle
лизана	Participle
докторските	Adjective
написването	Masdar
най-абсурдното	Adjective
отчитаната	Participle
търсейки	Converb
километър	Noun
продължаващата	Participle
карта	Noun
по-любителското	Adjective
инфекциите	Noun
упреквам	Verb
автоматичните	Adjective
най-антипартиен	Adjective
подмитано	Participle
унищожили	Participle
патриархът	Noun
дълбок	Adjective
мекотели	Noun
пренесъл	Participle
ножът	Noun
по-безразсъдна	Adjective
обковаваща	Participle
мечтаното	Participle
овньо	Noun
плакала	Participle
югозападната	Adjective
всезнайковци	Noun
счупеното	Participle
вертикален	Adjective
играли	Participle
построите	Verb
тесните	Adjective
стръв	Noun
донасяна	Participle
имането	Masdar
отчело	Participle
наранявам	Verb
абдикираме	Verb
облякъл	Participle
рязка	Noun
администраторите	Noun
пасат	Verb
спестите	Verb
наречена	Participle
алчна	Adjective
унгарския	Adjective
закупените	Participle
гъските	Noun
донесено	Participle
плетене	Masdar
унгарският	Adjective
прочел	Participle
подчертаните	Participle
ядене	Masdar
улиците	Noun
подобрявате	Verb
състезателния	Adjective
помагаме	Verb
автономна	Adjective
заораванията-нетата	Masdar
подобрила	Participle
противничката	Noun
животно	Noun
пелената	Noun
словото	Noun
стъпалата	Noun
активистът	Noun
ангелско	Adjective
загубихте	Verb
хоризонталното	Adjective
мисълта	Noun
студентка	Noun
видрите	Noun
човките	Noun
череша	Noun
слонът	Noun
ушити	Participle
липите	Noun
пития	Participle
греших	Verb
запридащо	Participle
разхождам	Verb
армиите	Noun
победен	Participle
изчезналата	Participle
седмо	Adjective
най-бледничкият	Adjective
сиромах	Noun
съчетаят	Verb
бягане	Masdar
допринесяха	Verb
пренесена	Participle
козето	Adjective
сръчно	Adjective
подобрени	Participle
отбодели	Participle
гъсоците	Noun
безстрашните	Adjective
изчезнало	Participle
касо	Noun
решаващи	Participle
чуло	Participle
петелът	Noun
обучаващия	Participle
легализирано	Participle
платени	Participle
играела	Participle
парадокс	Noun
умиращ	Participle
най-ягодовите	Adjective
потеклото	Participle
ненадеждната	Adjective
чела	Participle
влажния	Adjective
кеят	Noun
отбоденият	Participle
отбол	Participle
напредвайте	Verb
започни	Verb
езикознание	Noun
благородното	Adjective
отнесен	Participle
довеждащо	Participle
агитка	Noun
охраняваща	Participle
обичане	Masdar
подобреният	Participle
бинокъл	Noun
по-вещественото	Adjective
изпяване	Masdar
авторска	Adjective
по-плешив	Adjective
съчетани	Participle
автентичните	Adjective
следобед	Noun
обясних	Verb
изпитващ	Participle
лъвица	Noun
вярна	Adjective
изсичана	Participle
златният	Adjective
най-свръхестествената	Adjective
ноктите	Noun
отнасяния	Participle
деляло	Participle
дясна	Adjective
очакваните	Participle
състезателка	Noun
коронясващо	Participle
говорени	Participle
унасян	Participle
получело	Participle
губещо	Participle
прехапел	Participle
отсъствалият	Participle
сърна	Noun
ухапалият	Participle
спестят	Verb
изкусните	Adjective
джамията	Noun
съобщил	Participle
амбицийо	Noun
възел	Noun
любезно	Adjective
наранят	Verb
тъпото	Adjective
анонимните	Adjective
нанасяни	Participle
белгиецът	Noun
отваряни	Participle
желанията	Noun
потушен	Participle
сестра	Noun
принудил	Participle
приятелства	Noun
червена	Adjective
режещата	Participle
зимата	Noun
комерсиален	Adjective
влахо	Noun
прозират	Verb
отнесем	Verb
усилия	Noun
ключ	Noun
влечуги	Noun
авторитарният	Adjective
арабин	Noun
възможните	Adjective
по-авиационната	Adjective
дивата	Adjective
наблюдение	Noun
обичаме	Verb
по-старателно	Adjective
арест	Noun
точно	Adjective
произнесената	Participle
отвела	Participle
по-акуратното	Adjective
танцуващите	Participle
прилагателните	Noun
сравняваме	Verb
амфитеатрите	Noun
агитационна	Adjective
архипелагът	Noun
кралските	Adjective
тясната	Adjective
плащан	Participle
простираща	Participle
играйте	Verb
най-словенският	Adjective
пращан	Participle
избрали	Participle
спасявания	Participle
отвеждането	Masdar
абаносово	Adjective
отвлечен	Participle
наводняваме	Verb
написаха	Verb
отецът	Noun
пеещото	Participle
съзре	Verb
строя	Verb
шантажирате	Verb
аберация	Noun
растенията	Noun
зареждащата	Participle
помагайки	Converb
ароматните	Adjective
честваме	Verb
индивидуалностите	Noun
презиралото	Participle
шибаният	Participle
отвличане	Masdar
допрочитаните	Participle
болното	Adjective
начела	Participle
разбиращо	Participle
изреченият	Participle
принудило	Participle
гъска	Noun
навлизащите	Participle
по-практичните	Adjective
продължаваш	Verb
господарска	Adjective
обсъждайте	Verb
анахронизма	Noun
коминът	Noun
живееха	Verb
убедих	Verb
потресена	Participle
ръка	Noun
снесеното	Participle
теле	Noun
съветваните	Participle
гладната	Adjective
естетичната	Adjective
колегата	Noun
козе	Adjective
активистка	Noun
изговорени	Participle
счупваният	Participle
счупената	Participle
боже	Noun
сравнявате	Verb
обсъдят	Verb
изгубената	Participle
обучават	Verb
източният	Adjective
живеещите	Participle
сеизмична	Adjective
осиновявания	Participle
интересна	Adjective
най-дивите	Adjective
октопод	Noun
вършеещият	Participle
бацилоносителко	Noun
по-отровният	Adjective
дирижабълът	Noun
по-авгиева	Adjective
