kuluttava	Active
puhdistunut	Active
novalla	None
sijoittavat	Active
suoltuisi	Active
erikoisjoukkoihin	None
kieltäytyisi	Active
piilottivat	Active
muodostuisi	Active
noppia	None
täyttyvä	Active
leivittäisitte	Active
mahdollistettiin	Passive
vikittelisimme	Active
taskukello	None
elätti	Active
arkipäiväistä	Active
kartoittaa	Active
poliitikoista	None
lievitti	Active
paistavat	Active
läsinyt	Active
jousitettu	Passive
hindissä	None
tulkitse	Active
asevelvollista	None
helisty	Passive
laukaukset	None
hiipuva	Active
julkaiset	Active
askarruttakaa	Active
koreografein	None
koristelee	Active
liitti	Active
pelaili	Active
filmatisoitiin	Passive
konstruoisimme	Active
mielletään	Passive
säärissä	None
diakonin	None
luonnonvalinnasta	None
väijyy	Active
ulottivat	Active
mölyämme	Active
sano	Active
jatkunee	Active
reagenssin	None
tulistetaan	Passive
novelleissa	None
tuhottava	Passive
korkeushypyssä	None
lupasin	Active
korostuivat	Active
pestannut	Active
riistävät	Active
sulkavat	None
teeskennellen	Active
humoreskeille	None
ääriainekset	None
järjestyssääntöjen	None
kohosi	Active
säikäytti	Active
aamuvirkusta	None
enteilee	Active
laimennettu	Passive
radikaalein	None
aiheutuva	Active
ohjelmoitava	Passive
sitoudutaan	Passive
seilata	None
dieselöinee	Active
vastahyökkäysten	None
äityi	Active
yllättyvät	Active
juontuivat	Active
kokonaisvaltaiset	None
muotoilevat	Active
niukentunet	Active
putosivat	Active
kuolleille	None
ongelmaksi	None
voimistuu	Active
sitoutuivat	Active
sairastu	Active
eksoplaneetoista	None
tehosivat	Active
rapistui	Active
pysäytä	Active
murenivat	Active
vuokrasivat	Active
rintalapuin	None
myönnä	Active
satunnaismuuttujasta	None
sahoilta	None
samastuu	Active
hinkattu	Passive
polvistan	Active
avasi	Active
pääsyy	None
puolueet	None
paukauttanevat	Active
huipuille	None
luokittelisin	Active
hakeutuvat	Active
hait	Active
muokkaisivat	Active
raakkukoot	Active
porrasta	Active
hidastava	Active
näytä	Active
tähdättiin	Passive
synnyttäisi	Active
hälyttävät	Active
pilkottiin	Passive
ääntelee	Active
seikkaili	Active
muuttuu	Active
halkaisisimme	Active
kansallistettiin	Passive
aspiroitu	Passive
karttui	Active
toisinajattelun	None
huippusalaisia	None
lippu	None
sintraisi	Active
kohotimme	Active
hautautunut	Active
tauluissa	None
lakkauttanen	Active
palvoi	Active
eritetään	Passive
vesitti	Active
paijaisivat	Active
edesauttoi	Active
lihotettiin	Passive
kaasutin	Active
trinomeissa	None
pihtipolvella	None
kehittävät	Active
kaasuttunevat	Active
pysäyttäisi	Active
neuvoteltiin	Passive
sienestä	Active
lausuttiin	Passive
altistu	Active
tummenee	Active
orgaaniseksi	None
suosituista	None
uneliaisuus	None
ampuisivat	Active
avaudu	Active
nieltävä	Passive
suojelkoon	Active
pomppii	Active
samaisti	Active
vallitset	Active
riehuu	Active
muistot	None
zoomaisit	Active
parantumattoman	None
sotu	None
mekanisoitu	Passive
koittavat	Active
huteja	None
kehitimme	Active
peruin	Active
selkiytyy	Active
kiittelee	Active
eliminoidaan	Passive
tavoitellen	Active
juhlistanut	Active
tukiosalta	None
surkuttelisin	Active
hiljeni	Active
generoidaan	Passive
kasasivat	Active
hepoasteina	None
järkeilen	Active
opiskeluista	None
vahingoitetaan	Passive
supertähdet	None
rappeuttaa	Active
perustellen	Active
sallittakoon	Passive
tyhjentynyt	Active
suorittaneen	Passive
haarautuu	Active
metsästettiin	Passive
valmensivat	Active
vähätteli	Active
eheyttää	Active
hienotunteisille	None
istuttivat	Active
paisutelkoot	Active
painosti	Active
puuhailtaneen	Passive
tuomittu	Passive
kuntayhtymässä	None
koeajan	Active
ponnistaa	Active
saatan	Active
viritettiin	Passive
valikoiva	Active
viittaava	Active
pelottivat	Active
pönkittivät	Active
kannatettava	Passive
ilmastoa	None
röhkäissevät	Active
kuormattu	Passive
penkkiä	None
varistaisin	Active
väärinkäyttänyt	Active
ripeksittäköön	Passive
venetsialaista	None
haki	Active
sisustaa	Active
kuumeni	Active
huumauduttava	Passive
toteaa	Active
ylettyy	Active
tunnettaneen	Passive
koneenrakentaja	None
opettajajärjestöön	None
tomuttaisit	Active
rasvautuvat	Active
ongelmakäyttäjällä	None
uraauurtavassa	None
kyseisen	None
hellitettävä	Passive
kaupataan	Passive
lievittää	Active
perhostanette	Active
ruiskua	Active
loittonee	Active
ostettu	Passive
ilmenivät	Active
kurkkumätä	None
elokuvasi	Active
miehuulliseksi	None
itkenyt	Active
tapetaan	Passive
puhkesi	Active
katastrofaaliset	None
näyttäytyvät	Active
kiirehtii	Active
perusteltuna	None
synkistä	Active
hätistää	Active
määrittelevät	Active
tasoitettu	Passive
selkiyttää	Active
stuhlmanninkultamyyrä	None
sovittaa	Active
kärjisti	Active
tipahtanut	Active
vähentänyt	Active
vedenhankintojen	None
keskiarvona	None
panostanut	Active
säestivät	Active
kelpuuttavat	Active
rauhoitettu	Passive
juhlavan	None
kutistuva	Active
lamaantuu	Active
rinnasti	Active
vierastan	Active
vannoo	Active
verotettu	Passive
sisentää	Active
kutistaa	Active
mestaruuden	None
hölmöilet	Active
elämyksiä	None
anteliaisuus	None
siemensin	Active
reklamoikaamme	Active
koillisosista	None
lyötäisiin	Passive
kierittäkäämme	Active
kiinalaisena	None
testaamisessa	None
luonnonlääketieteeksi	None
paahdetaan	Passive
kodin	None
parantuivat	Active
lupauksilla	None
opetusluvan	None
istuu	Active
lyhentänyt	Active
farsseja	None
nautittava	Passive
väljähdyn	Active
sotkenut	Active
pyöräteitä	None
mehiläishoidon	None
haaveili	Active
vääntää	Active
aaltoa	Active
tilastoitaisiin	Passive
kirpeytettäneen	Passive
muuria	None
pipertäkää	Active
vektoreista	None
eläkeläiset	None
arkkihiippakunnaksi	None
määräsi	Active
käynnistyvät	Active
välke	None
motivoitunut	Active
kulutti	Active
luistin	Active
suodattaa	Active
suojattu	Passive
majailee	Active
odotellut	Active
hautautuu	Active
ryntäisin	Active
löydyttävä	Passive
hyppäävä	Active
salatun	None
ahmaisevat	Active
googlettaa	Active
mahtuisivat	Active
lujittui	Active
pinoa	Active
opiskeluaikana	None
äänestän	Active
sokeuttaa	Active
someroa	None
lukijoille	None
korjaisi	Active
roikkunut	Active
liihotelkoon	Active
nynnyiltiin	Passive
uskaltautui	Active
länsimaistamisten	None
epäorgaanisia	None
listasivat	Active
valkeni	Active
ylittyisi	Active
sovellu	Active
helpota	Active
mainitsisi	Active
lupausta	None
päivystettävä	Passive
lempinen	Active
aaltositte	Active
kuningaskunnissa	None
vaaliva	Active
sojotatte	Active
kiristyvät	Active
vesipäiltä	None
puhkaistu	Passive
kuristava	Active
estetiikan	None
harppi	Active
vanheneva	Active
helpotettiin	Passive
piiritettiin	Passive
jatkumoihin	None
tähteistä	None
toivotti	Active
alamaisen	None
katkaistiin	Passive
väestönlaskennan	None
avustaa	Active
edellyttävät	Active
haalistaa	Active
pursuaa	Active
jäädytetään	Passive
turma	None
projektorilla	None
irtisanoutuivat	Active
kiinteytyy	Active
huijauksia	None
houkutellut	Active
pelipaikalla	None
paljasti	Active
imploosioiden	None
rohjennut	Active
loikki	Active
komppanioihin	None
introvertti	None
bifenyyli	None
hovimiesten	None
oikaisee	Active
värjättiin	Passive
amerikanhaapa	None
alitettu	Passive
vähene	Active
rokotettiin	Passive
kolehti	None
käsikirjoitukset	None
löydetään	Passive
pokaalia	None
kompataan	Passive
pakkaavat	Active
soditaan	Passive
koontilaskuna	None
beryllin	None
aiottiin	Passive
helpottuu	Active
taksonomista	None
höyryttykää	Active
solisti	None
paikallishallinnosta	None
imelöittäkööt	Active
maininnut	Active
mielivaltaista	None
verotusta	None
haluaisin	Active
louhinet	Active
absorboituu	Active
sukeltaa	Active
ankeriasmonnilla	None
lepäsi	Active
tupsahtaa	Active
paheksuu	Active
suostuteltiin	Passive
asuntoalueiden	None
päätyisivät	Active
luisteltiin	Passive
vaelsitte	Active
vaihdettava	Passive
noudatettiin	Passive
kundi	None
ilmaiseksi	None
kykenisivät	Active
ballistista	None
velttoutuva	Active
ammensivat	Active
rinnastaisin	Active
hengittävät	Active
ymmärtävät	Active
kiinteistönvälittäjän	None
patriotismi	None
tönäisi	Active
lyhennelmää	None
kuohut	Active
haistavat	Active
aidanteitta	None
ylistämme	Active
päivystävä	Active
kukistettu	Passive
rytkynette	Active
noteerataan	Passive
sopeutunut	Active
viilentää	Active
nuolen	Active
pussimuurahaiskarhuihin	None
massiivin	None
sokaisee	Active
aikaisempien	None
ponttonisillan	None
kuvernementiksi	None
korppeja	None
leopardin	None
työväenluokasta	None
konsertoinut	Active
kantautunut	Active
alkeellisimmista	None
riensi	Active
riitelivät	Active
uuskolonialismiksi	None
erotellut	Active
robinsonadilla	None
hypättiin	Passive
tuomitse	Active
miehennielijöin	None
kuumensi	Active
veistänyt	Active
salaavat	Active
hahmotettava	Passive
kasautui	Active
fäärintäisin	Active
koskematonta	None
dokumentaatiota	None
hehkutti	Active
rituaaleista	None
harmittanut	Active
jakelee	Active
tunsin	Active
keskustelet	Active
välttivät	Active
kohdeltiin	Passive
vakiinnutettiin	Passive
neutronista	None
valekuolemille	None
havainnollistetaan	Passive
hillitsee	Active
taisteltu	Passive
opitaan	Passive
nännin	None
demoniselta	None
työskentelisimme	Active
kelluttanette	Active
suoniin	None
möhkäkalat	None
tulokkaille	None
henkitorveen	None
sumuuntuisitte	Active
veikkaan	Active
puhuisin	Active
kaivoksella	None
koteloihin	None
järeydyttiin	Passive
hidastettiin	Passive
epäilyttävät	Active
tulostu	Active
jättäytyä	None
sanoisin	Active
järkyttää	Active
kreikankielinen	None
formalisoinneissa	None
leveäpyrstökihu	None
lieska	None
romahtivat	Active
paljastanut	Active
jakaantunut	Active
valtaapitäviä	None
loikkaisitte	Active
paiseita	None
Norsunluurannikolla	None
kokoonpanoilla	None
väistäisimme	Active
biomekaniikka	None
tiedetään	Passive
tyrmistyttäköön	Active
inhoaa	Active
ruttaantuisin	Active
kaavun	None
haaroituttiin	Passive
kaktusta	None
sakotettiin	Passive
sormeilkaa	Active
ulkoministerien	None
samoaa	Active
lätkäissyt	Active
pettyi	Active
rajaavat	Active
eläkevakuutuksen	None
rohkenin	Active
kaksio	None
korotetaan	Passive
kutkuava	Active
ruiskaunokin	None
vaurioituvat	Active
somistanut	Active
tempasi	Active
karsastavat	Active
laimentaa	Active
elättänyt	Active
suri	Active
lahjoo	Active
levittämistä	None
uudestisyntynyt	Active
lujittaa	Active
graafisessa	None
avautuva	Active
katalysoiva	Active
kuivui	Active
puskee	Active
epäuskon	None
parkkeerannet	Active
kotiuttaa	Active
korpea	Active
satanismiin	None
perattu	Passive
porasi	Active
peittona	None
ohrantähkän	None
puhuttelevat	Active
vuokkokalojen	None
koettaisi	Active
haaveilin	Active
unohtaisi	Active
väitetään	Passive
ilmoittauduttava	Passive
kypsyydeksi	None
kivikirkot	None
humistaneen	Passive
oikoillemme	Active
ruiskutetaan	Passive
tehota	Active
tiivistyttiin	Passive
leveni	Active
sammutin	Active
yhdistellyt	Active
jousitetaan	Passive
pöllöjen	None
kärsä	None
harhaannuin	Active
etsintäkuulutti	Active
oosyytistä	None
monimutkaistunut	Active
kinäisimme	Active
pingoitat	Active
viljelevä	Active
kahdentuu	Active
yhtyvät	Active
ilmentyvät	Active
tapailkaamme	Active
käyttöönottoon	None
nyhtänevät	Active
syöt	Active
liikennöidään	Passive
tarjota	None
toimituksesta	None
dominanteilta	None
ujutti	Active
lopetti	Active
halkio	None
eläköityä	None
tulenkestävästä	None
kesäteattereina	None
kapeneva	Active
kaksoispysäköity	Passive
omistetaan	Passive
aaltoillen	Active
prosenttimääräisinä	None
tuotekehittelyn	None
isotoopeista	None
lähettiläiksi	None
komentaa	Active
altistavat	Active
miellyttävät	Active
kaaniksi	None
hylkivä	Active
totean	Active
äidinkielisiä	None
muotoillen	Active
kaivanut	Active
katkennut	Active
verenvuotoon	None
vuonolla	None
kiinteyttänette	Active
katkismuksessa	None
pännisivät	Active
kehittäisivät	Active
painolastista	None
alueelliseen	None
suoltui	Active
mestattu	Passive
jääkaapit	None
ronkittava	Passive
pidentää	Active
arvostelevat	Active
pelotonta	None
laakoina	None
kiertyy	Active
kuvittelet	Active
muninut	Active
viimeistellen	Active
erkanee	Active
louhittava	Passive
ripottelette	Active
laulaa	Active
hyminöittä	None
lähestyttiin	Passive
jalkautettaneen	Passive
bretagnelainen	None
koitan	Active
ohuudet	None
peräisin	Active
perisi	Active
taitu	Active
ideoitu	Passive
tarkistanut	Active
tunkeuduttiin	Passive
apartheidia	None
lattiaan	None
kuolettavia	None
esitettäisiin	Passive
oikonette	Active
dreijatkaa	Active
liikataan	Passive
vieraannuttaa	Active
ohjeistavat	Active
taittuva	Active
kummastelee	Active
dokumentaation	None
kivivallien	None
vältteli	Active
tallentuu	Active
liittivät	Active
suuntautuivat	Active
oikaistun	Active
miksannut	Active
naamioitunut	Active
parodioitu	Passive
murrettiin	Passive
karppikala	None
operointiin	None
laukaise	Active
hallinnollinen	None
parantuvat	Active
automobiileina	None
kyyditsemme	Active
varsottaisiin	Passive
muussatkoon	Active
reunustaa	Active
viihdy	Active
injektoidaan	Passive
laukaiseva	Active
kunnianloukkausta	None
ylittyvät	Active
äänesti	Active
vannottava	Passive
lohduttanee	Active
muodostivat	Active
kyyditsi	Active
moninkertaistuvat	Active
ripotellaan	Passive
kuvittelin	Active
pommittavat	Active
diskontattakoon	Passive
ankkuroitu	Passive
liioittelevat	Active
hapettumisen	None
vaarantaa	Active
närästä	Active
erheelliset	None
yhteenvedoista	None
pakottava	Active
myllyillä	None
murisee	Active
dateeratkaamme	Active
trilogiaksi	None
siirrytty	Passive
arvon	Active
hermoilla	None
ennustettiin	Passive
nelinkertaistui	Active
suomalaisti	Active
romantisoisin	Active
harjoittivat	Active
enteogeeni	None
sammuu	Active
kirjallisiin	None
koituvat	Active
ruvettiin	Passive
ravintein	None
korjaantuvat	Active
säkeessä	None
jyrkensitte	Active
hymyili	Active
valmentanut	Active
rahapuissa	None
isännöinyt	Active
kourulta	None
muutettaisiin	Passive
jäljentää	Active
maankäytön	None
tyrehtykööt	Active
arvosteli	Active
ylevöidyitte	Active
vievät	Active
protonein	None
kaksikolla	None
koitti	Active
vääntävät	Active
prikaatit	None
kohdistettiin	Passive
juottavat	Active
kloorannette	Active
kietaisi	Active
roikkuva	Active
hävittävät	Active
kujersit	Active
aukioloaikoja	None
piirrän	Active
haastettu	Passive
generoitu	Passive
alpeista	None
haaroittuu	Active
inhoan	Active
tuiverrettaneen	Passive
hopeoitu	Passive
lopu	Active
vuorottelee	Active
laastaria	None
metelin	None
heikennettiin	Passive
paloasemalle	None
radioamatöörejä	None
ladataan	Passive
haudattaisiin	Passive
vitja	None
vangitaan	Passive
kruununperijänä	None
ammentaa	Active
kivääri	None
sotaveteraaneille	None
yhdenmukaistettiin	Passive
liukuu	Active
tarjoamme	Active
tiedostettu	Passive
harhaisia	None
toimielimistä	None
käämitty	Passive
yhteiskuntakritiikeiksi	None
mieltää	Active
hermoradat	None
silpoi	Active
kierrätyskeskuksen	None
aseteltu	Passive
teloitetaan	Passive
hyppelehtikööt	Active
jyrkensi	Active
rajatuilla	None
ratapihat	None
telakoitu	Passive
avaan	Active
käsitä	Active
kelvannee	Active
lainattu	Passive
vahvistin	Active
replikan	None
tarkastelin	Active
pysytellen	Active
tuntisin	Active
vaivaava	Active
jutellaan	Passive
kurilla	None
karsisitte	Active
ratkaisisi	Active
korvaus	None
tiuhenee	Active
materiaalissa	None
istuin	Active
osallistuttu	Passive
lääkärintutkimuksena	None
palautuspäivien	None
luokitusten	None
maihinnousua	None
suonut	Active
turvamiehet	None
pyyhkäisitte	Active
harrastettu	Passive
syötetty	Passive
puoltaa	Active
vyyhti	Active
vakavista	None
maistu	Active
kannatat	Active
skannasi	Active
jättäytyy	Active
moninkertaista	Active
kävelytettäisiin	Passive
nilviäisten	None
ansaittu	Passive
luonnostellut	Active
työntää	Active
aiheutettiin	Passive
jalkauttakaamme	Active
siistii	Active
ruokalajeilta	None
opittava	Passive
korventanut	Active
huomatkaa	Active
seksituristit	None
maistuvat	Active
keinuttanut	Active
mikrotaloustieteen	None
guinealainen	None
kotimaista	Active
syventänyt	Active
työllistänyt	Active
mukaisessa	None
kovettanen	Active
ylity	Active
kuivataan	Passive
huijattiin	Passive
toteuttivat	Active
maltillisesta	None
vanhimmista	None
arponen	Active
komppaan	Active
törmättiin	Passive
palkinnoista	None
kuumensivat	Active
järjesteltiin	Passive
verotuksen	None
kuntoutusklinikkana	None
äännetty	Passive
parveilevat	Active
liikuttavat	Active
nimikkeeseen	None
kärjistynyt	Active
islamilaisesta	None
vartaassa	None
fagosytoinut	Active
poistun	Active
näkisin	Active
joutuva	Active
täyttäisivät	Active
totuttanee	Active
voihkaisimme	Active
ajaannutte	Active
alistettava	Passive
teetti	Active
operaatiotutkimuksiin	None
henno	Active
tiesi	Active
pyydellään	Passive
ekstrapoloitiin	Passive
ansaitseva	Active
vertasivat	Active
karttaprojektioita	None
touhua	Active
tiivistetty	Passive
dynaamisilla	None
näin	Active
pyörii	Active
ajanottolaitteelta	None
erkanevat	Active
kaipaavat	Active
taikoi	Active
gallupoitiin	Passive
ensiesiintymistä	None
derivoidaan	Passive
tavanomaisesta	None
leimautukaa	Active
hengitä	Active
vaurioitti	Active
kuivannet	Active
hyväsydämisestä	None
kaavitaan	Passive
laskisin	Active
ultimaalinen	None
pudota	Active
ulkoasiainministeriöön	None
kuivattaa	Active
vierailtu	Passive
oikaisi	Active
paranivat	Active
puristettiin	Passive
naurattaa	Active
numeeristettaneen	Passive
aviollinen	None
derivoitu	Passive
liipaisin	Active
hyrähdin	Active
soluttautunut	Active
harmin	None
rauhoitti	Active
pedagogisitta	None
kuumuitte	Active
pyöritään	Passive
suhdannekierroin	None
ohittava	Active
kengissä	None
kiilamaiset	None
ehdotuksissa	None
ratkaistava	Passive
avannut	Active
säpsähtelevät	Active
hyväksynyt	Active
pahastu	Active
napolinmastiffi	None
alkaisin	Active
yllättänyt	Active
omavaraistui	Active
rytmisessä	None
luottaa	Active
tilaan	Active
suostuttiin	Passive
toistaisi	Active
simpanssilla	None
valehtelivat	Active
verhottiin	Passive
tarvitsi	Active
vartioitu	Passive
pussitettu	Passive
ylettyivät	Active
vaikeuttanut	Active
ravistelu	None
poikkeaviin	None
hirtätti	Active
kivennäisaineet	None
tyyppisessä	None
imusuonet	None
nähtiin	Passive
pyrkimyksiä	None
katseli	Active
säpinää	None
individualistinen	None
sanottiin	Passive
halusin	Active
hätätila	None
himoitsee	Active
maagikkojen	None
ensiesitti	Active
risukkoihin	None
silpoutunemme	Active
asettelin	Active
kiehtovat	Active
kokeneelta	None
kommentoinut	Active
emäaluksena	None
painiskellut	Active
kaasumaisia	None
eläinrasvan	None
kosiskeli	Active
poistui	Active
oppinee	Active
kiivetty	Passive
analysoiva	Active
kuvittele	Active
alkavat	Active
tiedustelisin	Active
vaihdu	Active
koriseva	Active
kirjoittakoon	Active
kidutettu	Passive
sallikaa	Active
aamulehteen	None
puristivat	Active
merkinnyt	Active
sovellettava	Passive
häädetään	Passive
satutti	Active
tähtikuviosta	None
rakasti	Active
kokoontuivat	Active
väität	Active
horjuva	Active
huokaukset	None
kiistellään	Passive
evankeliumeihin	None
suuntaudu	Active
merkkijono	None
tomua	Active
kiiruhtaa	Active
alistuu	Active
hallitsijaan	None
suuteleva	Active
kaupallistukaa	Active
köyhdyttäkää	Active
onnistunevat	Active
taisi	Active
lainkuuliaisia	None
pitkissä	None
osuuskassojen	None
jäähtyi	Active
katson	Active
mielisairaalaksi	None
kulminoituivat	Active
toteutin	Active
kiskouduit	Active
piinannut	Active
järkiintyisivät	Active
rappeuttava	Active
sekoittuisi	Active
kellutettaisiin	Passive
lohko	None
palvoivat	Active
laborantti	None
väännä	Active
linnoittautuu	Active
romuttui	Active
kiihtyvä	Active
vapautuivat	Active
tummenevat	Active
jäykistyy	Active
saavuttivat	Active
vilustukaamme	Active
katkoivat	Active
lokasuojien	None
ympätään	Passive
pyyhkisi	Active
huuliharppu	None
neuvotellut	Active
sintiksi	None
hovimestariksi	None
herkistänen	Active
silmäillemme	Active
pennosen	None
pierrette	Active
oleilevat	Active
reformoitu	Passive
vihlotte	Active
ääniseen	None
hätiköity	Passive
normalisoinut	Active
sopeudu	Active
perehdytään	Passive
tiivistynyt	Active
paisuvat	Active
paikannuttakoon	Passive
kromia	None
esitit	Active
kaupunginorkesterin	None
antautuivat	Active
suortuisin	Active
leppyy	Active
kuvannee	Active
taivuttaa	Active
kuohuu	Active
jaksollisuutta	None
suihkutetaan	Passive
ojentaa	Active
satiirin	None
lainattava	Passive
kartiota	None
sunda	None
vanno	Active
peruuntunut	Active
kosketa	Active
vaikuta	Active
tilasi	Active
heltisi	Active
kokoontuvat	Active
tuota	Active
kohentanut	Active
kerjettäneen	Passive
selitin	Active
ylikuormittakaamme	Active
typeriä	None
dumppasit	Active
huumautuivat	Active
vaivautuisi	Active
ehkäissemme	Active
sekuntiviisareilla	None
keräillen	Active
irtolainen	None
asennettu	Passive
integroitiin	Passive
tyhjene	Active
perhokalastusta	None
mukailee	Active
vioittunut	Active
katsahda	Active
häpeää	Active
luetteli	Active
poista	Active
seurasivat	Active
tavoiteltiin	Passive
möhläisitte	Active
peräänantamattoman	None
menehtyi	Active
huolestuivat	Active
minareetit	None
elinvoimaa	None
bluffannut	Active
leiskoilta	None
naukkailisin	Active
selitti	Active
raketinheittimen	None
pätöteho	None
fossiloitunemme	Active
sanoi	Active
kohdentaa	Active
varastetaan	Passive
hellittänyt	Active
haluava	Active
legitiimi	None
moittii	Active
espanjalaisten	None
suolatkaa	Active
heittäydy	Active
vieroitetaan	Passive
lainelautaillen	Active
hallusinaatioiden	None
valikoituivat	Active
viinasta	None
kritisoitiin	Passive
opeteltiin	Passive
hiihdettiin	Passive
mikrofilmin	None
aseistuksella	None
pidätetty	Passive
harjoiteltava	Passive
äestit	Active
kulmaminuutin	None
valloitettu	Passive
surkastunut	Active
todettava	Passive
nuukahdat	Active
antaudun	Active
harhaanjohtava	Active
operaatiot	None
edistäisi	Active
korkeista	None
valunut	Active
fossiilistunen	Active
määritetään	Passive
rikoit	Active
vollotettiin	Passive
kaapaisen	Active
orneeratkoot	Active
upotussuolaat	Active
pätevät	Active
obligaatiomarkkinan	None
matemaattistavat	Active
viittasivat	Active
nuhraannuttaisiin	Passive
ilmoitettaisiin	Passive
langettaa	Active
klavinetille	None
ajoituksista	None
hiiskun	Active
murskattava	Passive
aavikoittaisimme	Active
menetellään	Passive
ryöstää	Active
kilpakumppani	None
tulostuva	Active
joukkohautoihin	None
luovu	Active
tähdittivät	Active
päivystävät	Active
raivokasta	None
takaukset	None
platonismi	None
kaunisteltu	Passive
helähdytetty	Passive
öljykasveihin	None
samanarvoisten	None
työllisti	Active
hidastuu	Active
dandyn	None
nuokkuhelmikäksi	None
kiisteltiin	Passive
hyökättävä	Passive
leventää	Active
paikallistuitte	Active
primitiivisistä	None
saarivaltioista	None
nyhrätkööt	Active
omistettu	Passive
povasit	Active
onnistaa	Active
onnistun	Active
hilloa	Active
suojaudutaan	Passive
goudana	None
hirviteltäköön	Passive
ohjautuisi	Active
ideologia	None
koodannut	Active
lehahdettu	Passive
helpottunut	Active
sietivät	Active
siteerattu	Passive
hitsauduttiin	Passive
nesteytän	Active
pelasivat	Active
uhattu	Passive
vartioisitte	Active
lepuuttaa	Active
häätäisivät	Active
ajattelusta	None
selkenee	Active
kulkeutuivat	Active
puolustellaan	Passive
kannatteleva	Active
suikeine	None
pehmentää	Active
edustajilta	None
laatalle	None
tutustut	Active
vaimentaa	Active
kansankielessä	None
raikastamme	Active
piiloutuivat	Active
tuule	Active
lisäät	Active
tarkentuva	Active
nukattaneen	Passive
pelimiehet	None
jumaluutena	None
vangitutti	Active
takkusit	Active
lyhennettävä	Passive
mainittava	Passive
skeittaava	Active
määritettiin	Passive
evättiin	Passive
huovi	None
korkeakouluihin	None
välkynnät	None
venäläistää	Active
kulutetaan	Passive
yhdistelevät	Active
iäkkään	None
nauttii	Active
kontratenori	None
koordinoiva	Active
viritin	Active
silittäkää	Active
aaltoviivoja	None
liehun	Active
länsimaista	Active
romutettu	Passive
välähtää	Active
vieköön	Active
kostanut	Active
syttyvä	Active
täydentävät	Active
optimoidaan	Passive
levenin	Active
harhauttaa	Active
kertautuu	Active
toistuttiin	Passive
ratkaisee	Active
kuvaava	Active
peritään	Passive
myötäili	Active
pidättyi	Active
tableteissa	None
muotisuunnittelijan	None
sumuttaa	Active
perustuvat	Active
viimeistellyt	Active
viilentäisimme	Active
pysytään	Passive
polvista	Active
lähtevä	Active
rasvahapoille	None
pehmittää	Active
uudistanut	Active
rakennemuutoksen	None
suojelulle	None
ylistetty	Passive
kirjahyllyistä	None
ylistivät	Active
maistua	None
hepoasteilla	None
uimariksi	None
pyyhi	Active
saastunnoiksi	None
väitteillä	None
ilmaantuisi	Active
ohitustie	None
selvittelyssä	None
mukautuu	Active
harjoittelivat	Active
lausuttava	Passive
reunustava	Active
putoaa	Active
säärintamien	None
liioitteleva	Active
opettavat	Active
painottui	Active
kasvava	Active
lisäävät	Active
huonommuuden	None
lumoutuu	Active
kärytätte	Active
työskenteli	Active
yrität	Active
koristeltu	Passive
kitarisaan	None
tallettavat	Active
pitkittäisit	Active
usvaa	None
ilmaisutapoja	None
kumarra	Active
putoili	Active
tyypilliseksi	None
täydennän	Active
hallinnollista	None
kassissa	None
jälkeiseltä	None
kaivaukset	None
kuvittelee	Active
säästyisimme	Active
sahramien	None
samplataan	Passive
ihastelen	Active
aineellista	Active
ohentuisitte	Active
ruukuissa	None
yksilöity	Passive
matriisit	None
edesmennyttä	None
indikatiiveihin	None
tomuttaisi	Active
mahtuva	Active
sinkoa	Active
köyhyysrajan	None
valitettiin	Passive
hoitaisivat	Active
vedottiin	Passive
ruiskuttavat	Active
klikkauksen	None
sihisee	Active
patentoitiin	Passive
lontoolaisia	None
sohjoontukaamme	Active
japanilaisilla	None
ristitulessa	None
väijyvät	Active
levenee	Active
viimeisteli	Active
tehokkaimmat	None
suuttuvat	Active
kouristakoot	Active
toroidin	None
valloitti	Active
itkevä	Active
pakkolunastettiin	Passive
havainnollista	Active
kulmaetäisyys	None
korjaava	Active
kuluttivat	Active
peitteli	Active
ontuu	Active
vallankaappauksen	None
syövyttää	Active
taikoo	Active
esineellistänette	Active
ajoittuva	Active
kansainvaellusaikana	None
kiinnostaisivat	Active
päädy	Active
akuuttiselle	None
heittelevät	Active
kiihdyttävät	Active
laukova	Active
lumisokean	None
osmiumin	None
viennin	None
nykyaikaistettiin	Passive
ehtyvät	Active
etnisyys	None
rajoittuva	Active
vihastutti	Active
koodattiin	Passive
kiinnittyy	Active
vaikeni	Active
käsitteellistää	Active
vaaleahko	None
pohjaan	Active
operoinneissa	None
silkillä	None
oikeanpuoleinen	None
kalsiumoksidina	None
pyörennämme	Active
opastimissa	None
ryöstetty	Passive
laiminlyöty	Passive
yhdisteli	Active
täsmensin	Active
rengastettiin	Passive
epäillyt	Active
vuorotteli	Active
käännytetty	Passive
olvin	None
löydettiin	Passive
sitoudun	Active
painotan	Active
veikataan	Passive
sekoitat	Active
sivelty	Passive
voimistuivat	Active
ylenivät	Active
erittää	Active
ärsyttävä	Active
sinihomejuusto	None
nojaavat	Active
alistivat	Active
kysyisin	Active
pakene	Active
jutustan	Active
tunnustautuu	Active
sokeentuivat	Active
kupsahtanet	Active
suodatuttava	Passive
voideltiin	Passive
tiukentui	Active
katsot	Active
koplaavat	Active
kiilasivat	Active
bestsellerin	None
rokotettu	Passive
sekoaa	Active
itsevaltiudesta	None
tiibet	None
uusnatsi	None
semanttisia	None
kuljeskelee	Active
käyttäytyvä	Active
virike	None
ahdistelivat	Active
johde	None
rukoiltiin	Passive
paikantaa	Active
ehdollistettiin	Passive
huomasin	Active
takoivat	Active
jippoillet	Active
inhota	Active
säteilee	Active
ilmaantuva	Active
ostanet	Active
riennä	Active
johdu	Active
liitokset	None
pilasivat	Active
ohita	Active
haastateltava	Passive
voittajaksi	None
alunaliuskeista	None
totuusfunktiolle	None
modernismi	None
kiperryt	Active
kurottautuu	Active
luennoinut	Active
kaavoitetaan	Passive
parrakasta	None
hyytelömäisen	None
okkultisti	None
kunnilinguksista	None
tiukensi	Active
myönteiseen	None
uhkaan	Active
epäonnistuu	Active
analogisissa	None
raudoittakoon	Active
eristävä	Active
kvanttiluvusta	None
yskitettäisiin	Passive
integroidaan	Passive
suuntauksesta	None
ymmärrätte	Active
antiguabarbudalainen	None
noteerattu	Passive
väärentää	Active
rangaissut	Active
suurennetaan	Passive
julistettava	Passive
lausutaan	Passive
lopettaisin	Active
tarvitset	Active
resursoikoot	Active
listannut	Active
sirota	Active
vetoomuksessa	None
irtautuvat	Active
kavennetaan	Passive
väittelyistä	None
myytävä	Passive
velkarahalta	None
ambulanssin	None
survoisimme	Active
paljastavat	Active
hapatettu	Passive
kilpikonnista	None
kehräävät	Active
geosentrisiä	None
uskottelee	Active
tiedostanut	Active
kypsyy	Active
kehottivat	Active
magnetoiduitte	Active
sulatti	Active
häiritään	Passive
etäytettävä	Passive
rikkova	Active
vanhennat	Active
uneksijat	None
hukuttautuu	Active
elannolle	None
argumentaatio	None
kamaralle	None
herhiläinen	None
naurettava	Passive
röntgenkuvat	None
rakentuu	Active
toimitus	None
selkäsaunan	None
koillisosan	None
kosiskelevat	Active
tuumaan	Active
uupuu	Active
katko	Active
nimeävät	Active
raahautuu	Active
erottautui	Active
edistynette	Active
nelivedon	None
kao	Active
opiskeltiin	Passive
vihjailtu	Passive
muunsi	Active
meinannut	Active
juntattiin	Passive
muistan	Active
tallon	Active
edesmenitte	Active
tunnelmaa	None
peittyvät	Active
tunnen	Active
ripittäytyisi	Active
ripustettiin	Passive
kuvaili	Active
työttömyyspäivärahaa	None
liittynee	Active
paikoista	None
kumosit	Active
raivattu	Passive
sydämystynee	Active
sotkeudu	Active
täytäntöönpanon	None
uskontunnustukseen	None
epäilet	Active
kellui	Active
myöhemmistä	None
keilaamme	Active
noudattaisivat	Active
sedaniin	None
liikarakennettaisiin	Passive
kabareissa	None
loppiaisen	None
edesauttaisi	Active
sulkeutuvat	Active
valita	Active
jemmatkaamme	Active
tutustutti	Active
punastuvat	Active
häväissette	Active
hallinnut	Active
syrjäytti	Active
nikotiinista	None
lepäävät	Active
kyykäärmeiden	None
päivystää	Active
aktivoidaan	Passive
standardisoitu	Passive
lankea	Active
budolajit	None
huusi	Active
kiekkoillut	Active
hentoa	Active
ikkunoinen	Active
yritämme	Active
normilla	None
määrätty	Passive
pakolaiseksi	None
froteekankain	None
kääntäisi	Active
pakastaisitte	Active
meneteltäisiin	Passive
supistuu	Active
vihjataan	Passive
tarkkailtava	Passive
massakeskipistettä	None
uiskentelee	Active
riiviöt	None
edustuisit	Active
haasioitaneen	Passive
supoa	None
soitat	Active
pomminvarmoilta	None
normittanet	Active
käyttövesi	None
ruoskittava	Passive
tutumpi	None
rahoittaa	Active
haastettiin	Passive
debytoinut	Active
kuvaruutua	None
kiedottiin	Passive
vietit	Active
sahaaminen	None
arkistoitaisiin	Passive
laihtui	Active
murtaa	Active
pudottivat	Active
uupuvat	Active
haavoittui	Active
valmistunut	Active
ylistää	Active
vaaleanpunaiseen	None
pujoksia	None
tutustuttiin	Passive
omaksuu	Active
monipuolistuu	Active
keittiöissä	None
siroavat	Active
majoittuu	Active
lunastaa	Active
tuhoudu	Active
manipuloinet	Active
segmentoinnissa	None
madallettiin	Passive
liikun	Active
separatistinen	None
uudistava	Active
terveysjärjestöillä	None
nuijasota	None
murjoi	Active
kursivoitu	Passive
juttelivat	Active
saattava	Active
huoneiden	None
salamurhaajista	None
osallistutaan	Passive
lehdoista	None
yhdistää	Active
intiimejä	None
romauttaisit	Active
kauhistelivat	Active
jakaantuvat	Active
ylikalastuksen	None
lumeutuisitte	Active
jääkarhujen	None
neuvottelivat	Active
pelastunut	Active
karsiva	Active
tinneriä	None
gneississä	None
vahasi	Active
nimikirjoituksina	None
tukeutuivat	Active
kirjoitamme	Active
vahingoittava	Active
sulkasadon	None
selkäpuoli	None
sipaissut	Active
ohennettiin	Passive
tiputellemme	Active
vallonia	None
voitin	Active
seurustelee	Active
ympäröity	Passive
alidiakoni	None
palautui	Active
totutettiin	Passive
ruostuu	Active
siirtynyt	Active
yhdistäisivät	Active
ojennetaan	Passive
nitistäisimme	Active
kavensi	Active
alkulohkosta	None
täytetyiksi	None
suostuin	Active
käynnistetään	Passive
rispaantuisimme	Active
näyttäytyvä	Active
viuhahtaa	Active
ympäristöjärjestöin	None
kidutuksella	None
vee	None
sävelletään	Passive
kutittelitte	Active
upottelisi	Active
lystätään	Passive
huomauta	Active
ulkoistaa	Active
suljettaisiin	Passive
salaillut	Active
menestyjien	None
korostin	Active
kuntosalilla	None
vakuutellen	Active
dalmatialaista	None
maista	Active
röhkäisköön	Active
taivaanpalloille	None
palkkojen	None
pohtii	Active
suova	Active
mielenhallinnassa	None
kummastuttaisin	Active
kääräisköön	Active
käytettävä	Passive
murhasi	Active
uskotaan	Passive
valloitukselle	None
peridootit	None
huoltajuusriidat	None
yllättävät	Active
kuunnellaan	Passive
hierottiin	Passive
rakennettaisiin	Passive
työskentelevillä	None
polveutui	Active
operatiiviseksi	None
liuotetaan	Passive
kolautettiin	Passive
kryptaan	Active
ihmetelty	Passive
alistetaan	Passive
trieereissä	None
alkaanien	None
kiinnittynyt	Active
varmennetaan	Passive
kerrattiin	Passive
kasvatetaan	Passive
tähdätty	Passive
avatkaa	Active
luennoida	None
harjoitteli	Active
kompostin	None
kyynelehtiköön	Active
prosenteilla	None
kuvioinen	Active
äänittää	Active
tislataan	Passive
helmestäisit	Active
seulottiin	Passive
yhteiskuntaluokkaa	None
syöksi	Active
uhkarohkean	None
piristyi	Active
kaupallistui	Active
mitätönnettiin	Passive
yhdistän	Active
kysyt	Active
riko	Active
tuuppasi	Active
siivu	None
hiotaan	Passive
ominaisuuksiksi	None
karkaavat	Active
hoituu	Active
jääkäri	None
välien	None
syrjähypyn	None
kyseenalaistettu	Passive
paikantaisivat	Active
kehitteli	Active
perusteena	None
hihnoitettaneen	Passive
komppanioista	None
voitettava	Passive
sekoittui	Active
pienentyi	Active
kilpailutetaan	Passive
luotisateessa	None
vanne	None
juhlisti	Active
punnersi	Active
näännytettäneen	Passive
rikastuivat	Active
ihannoitu	Passive
tasaisimmista	None
kitapuulta	None
säikyttää	Active
valonarkuudelle	None
talvehti	Active
työväentalolle	None
luistelee	Active
valistava	Active
hoitajattarilla	None
ilmoittautuu	Active
loppunut	Active
velvoitettiin	Passive
taio	Active
kerrottavan	None
saarnaajat	None
oudostutatte	Active
ruvettu	Passive
laukeaa	Active
tarjonnut	Active
neuvottelukuntaan	None
tunnustettava	Passive
opiskelevat	Active
juonet	Active
mutaharakkoineen	None
kolja	None
haaveilevat	Active
nimettäisiin	Passive
kartutetaan	Passive
pörhistää	Active
mineralogia	None
vahvistavat	Active
väisty	Active
tswana	None
fysiologista	None
syrjäisiä	None
löydän	Active
vähennettiin	Passive
sijoituttakoon	Passive
muuta	Active
huomauttaisi	Active
järäyttänen	Active
uurniin	None
loukkaantui	Active
kohdistui	Active
piikkisimpuilla	None
pietismiin	None
edellä	Active
diodit	None
sarastaa	Active
henkisellä	None
pöytäisitte	Active
kaupungistumisen	None
vaaleissa	None
selvittää	Active
silmälasit	None
virtaisi	Active
ujuttaa	Active
peruivat	Active
hölmöilisivät	Active
tarpoivat	Active
osuin	Active
vakiintuu	Active
ehdollista	Active
porautuvat	Active
ilveilijä	None
diskattiin	Passive
reaktio	None
myyttinen	None
autopommin	None
pidensi	Active
paennut	Active
selvitti	Active
syyllistynyt	Active
kauppalaivastoa	None
kohdattiin	Passive
puolittunut	Active
sydänlankaa	None
han-kiinalaisia	None
talousarvioiden	None
monimutkaistuu	Active
puhdistavat	Active
ruokatorvina	None
verotti	Active
hedelmöitystä	None
välähti	Active
voittaisivat	Active
topologinen	None
inhosivat	Active
aatteellisuuksilla	None
nöyryyttävät	Active
valotettiin	Passive
lievenevät	Active
ylensi	Active
huomautti	Active
tiesit	Active
jalkaväkenä	None
kuulosta	Active
kalligrafian	None
katveessa	None
demon	None
puolusti	Active
shaaleista	None
juurittaneen	Passive
nakutelkoon	Active
omenasadoitta	None
palaisin	Active
hämmentävät	Active
laihdutti	Active
teerenpeleineen	None
toimintaelokuvan	None
päihitti	Active
autokraattisista	None
otsonisuojiksi	None
hiihti	Active
listautunut	Active
vartiointia	None
huipentanen	Active
hyperbeleittä	None
pidättäytyy	Active
koristi	Active
ketjuttaa	Active
eksyin	Active
metsästävä	Active
rantaviivalla	None
maatin	Active
leskeyksillä	None
kuolonkankeus	None
kenkä	None
tarvitsisivat	Active
vastasin	Active
humanitaarisiin	None
lupsakka	None
yllätyshyökkäyksiä	None
ruuhkaantukoon	Active
pelattu	Passive
määräsivät	Active
korvattiin	Passive
jalometallien	None
vierastalolla	None
laukaisivat	Active
jyrkkenimme	Active
sopusointuisen	None
uppoava	Active
kisailtakoon	Passive
vähenivät	Active
edistyivät	Active
kookosmaito	None
ryöstelivät	Active
huolestuttiin	Passive
tulkitsisi	Active
selviteltiin	Passive
keinun	Active
markkinaosuudet	None
tutkimustuloksia	None
materiaalistettaisiin	Passive
haudattu	Passive
tarkistakaa	Active
kumpuaa	Active
älyttäkää	Active
ponilla	None
yläluokkaan	None
määrinä	None
koristaa	Active
huitoo	Active
triklosaani	None
teloitusten	None
järjestetty	Passive
vuorottelevat	Active
selittävät	Active
nörttejä	None
saartoa	None
myrkytykset	None
tarmoitta	None
karhennettu	Passive
vastannee	Active
kuvakkeiden	None
kostutettu	Passive
toteavat	Active
painotti	Active
tuuletin	Active
riippuvuudessa	None
mestariteokset	None
sellakaksi	None
mykistää	Active
nuhtelu	None
lakastuu	Active
kahvakuula	None
kovistelisivat	Active
viestittäkää	Active
hehkuva	Active
varmennettu	Passive
tuotantokauteen	None
ala	Active
kytkevät	Active
keskikokoisen	None
digitaalistuisitte	Active
lisääntyisi	Active
kiipeillen	Active
tavoita	Active
kidnapattiin	Passive
kaavoitti	Active
selittänee	Active
rikastuvat	Active
digitalisoitu	Passive
tupruttaisi	Active
yleistynyt	Active
löystyvät	Active
hapettunut	Active
lintutiedettä	None
jokeltelisi	Active
muistuttaa	Active
paalittanee	Active
kellahdutatte	Active
loput	Active
innosti	Active
kirottiin	Passive
sellaista	None
asustelisivat	Active
luuvaan	Active
keskitymme	Active
rekrytoinnista	None
gini	None
etnomusikologiaa	None
karkotettu	Passive
arvioisin	Active
arvioittakoot	Active
arvonnan	None
ilmaantuu	Active
hengellisiin	None
ratsastivat	Active
treenasi	Active
kotiutui	Active
painuivat	Active
vähennettävä	Passive
vuoroihin	None
kuljettanut	Active
seisahtui	Active
tupsahti	Active
upotettu	Passive
nauttijalle	None
kellarin	None
poissuljettu	Passive
kruunauta	Active
kuperan	None
näkisit	Active
esittäytyi	Active
valmistetuille	None
siedetään	Passive
nitistäköön	Active
aaltoilevat	Active
tietokonetaitotta	None
romahti	Active
brittien	None
järkkynyt	Active
diskriminanteissa	None
pidättivät	Active
vilppiä	None
venähti	Active
vidottiin	Passive
kohuttiin	Passive
maskasi	Active
yhdymme	Active
ratsastaa	Active
piiloutunut	Active
ainoista	None
seikkailufilmillä	None
säiliön	None
yrittävä	Active
ilmakehän	None
tunnulla	None
broilerinlihoilla	None
kyseenalaistuin	Active
pilkottu	Passive
tavoittelevat	Active
harjoittava	Active
spinnasi	Active
seerumia	None
napitettu	Passive
kiinnostanut	Active
rajoittui	Active
sekoitettava	Passive
tartun	Active
hiertävät	Active
symboloiva	Active
pitkitti	Active
vihjailla	None
troijalainen	None
keon	None
hälytti	Active
hypätty	Passive
tukahduttavat	Active
hobitteja	None
maruna	None
parannellut	Active
käsikirjoitettiin	Passive
kiristyivät	Active
kesäaika	None
puntisten	None
lutikkarouskusta	None
sisustan	Active
perutaan	Passive
harppailee	Active
jyrkistä	Active
läisky	Active
asennetta	None
karvanpoistot	None
lahjoita	Active
halkaisee	Active
moitittiin	Passive
hytkähdytettiin	Passive
koksittanut	Active
arameankielisessä	None
tiheni	Active
piiritetty	Passive
digitoidaan	Passive
erikoistuneita	None
saattavat	Active
majoittui	Active
havainnollistavat	Active
polttamisesta	None
hankkiutuivat	Active
harjoitettu	Passive
heijastaa	Active
hyökkäilivät	Active
utele	Active
bilsan	None
asettui	Active
huuhtelee	Active
monipuolinen	None
miehistytte	Active
alettava	Passive
kannatteli	Active
kansanmurhaa	None
valokuvasi	Active
piilotetaan	Passive
tiuskinee	Active
husaareille	None
hermoilisimme	Active
jutusta	Active
perustavanlaatuiset	None
kommunikaatiossa	None
päätyvät	Active
nyökyttelevät	Active
lehdistötilaisuuteen	None
lainaavat	Active
sankareille	None
puukottaa	Active
loimuttivat	Active
siivonnut	Active
kursittu	Passive
tulkitsi	Active
sensuroidaan	Passive
autioittivat	Active
ylikansallisia	None
fakkiinnuimme	Active
kemiallisia	None
jakautunut	Active
vallattiin	Passive
soluttautuvat	Active
houkuttele	Active
riiteli	Active
ratkennut	Active
ryhdyin	Active
täsmensi	Active
valmistauduttiin	Passive
tihentynyt	Active
kosmisella	None
voitanut	Active
höllensi	Active
eksyivät	Active
duunailisivat	Active
tasoittavat	Active
lepertänevät	Active
harvinaisuutta	None
läikkyy	Active
ajanmukaistukaamme	Active
listautui	Active
typistetty	Passive
kirjoitettu	Passive
läpäisisi	Active
rohkaise	Active
jazztanssia	None
käsitettiin	Passive
suojeli	Active
kukoistivat	Active
tukalaan	None
arsenikin	None
hyvitti	Active
tulivuorta	None
haasta	Active
alamaisille	None
kaihtanen	Active
seurattu	Passive
tilannut	Active
virtasivat	Active
vilustumme	Active
ammennettu	Passive
ohjaimia	None
sanelee	Active
varustettu	Passive
hyödyntää	Active
kulttuurievoluutiotta	None
saksataan	Passive
puolustusministerinä	None
vertasi	Active
suolattu	Passive
pääsihteeristä	None
istuttaa	Active
koettelemusten	None
jauhetaan	Passive
kilpikonnaa	None
jäätiköitynen	Active
selität	Active
kolminkertaistun	Active
konttauksen	None
paranisivat	Active
vaivasi	Active
hindin	None
jaoteltu	Passive
herunen	Active
korvakäytävään	None
halkeavat	Active
jäävätty	Passive
hurmos	None
kirkastuu	Active
lukaistu	Passive
uhkailujen	None
maalliseen	None
hiljensi	Active
virkoaa	Active
paisuisi	Active
torjui	Active
talleta	Active
kutoi	Active
vahvistui	Active
kalvoksi	None
maaorjuutta	None
teroitettiin	Passive
bakteereista	None
käyttäytyvät	Active
peruskorjataan	Passive
höystää	Active
toimitettaisiin	Passive
pseudotieteenä	None
suodattunevat	Active
havainnollisti	Active
sellainen	None
eväste	None
koitunut	Active
viehätti	Active
lastaan	Active
mahakelkkailijoitta	None
herjaisivat	Active
juustottuisin	Active
abortoinemme	Active
tähdätään	Passive
pitoiksi	None
sijoittuu	Active
serbia	None
tietokirjallisuudesta	None
raudikotta	None
pakasta	Active
varo	Active
uskaltaa	Active
byrokraattisuuden	None
jäntevöisin	Active
alotti	Active
herätettiin	Passive
vääristellyt	Active
turvautuu	Active
tupakoinut	Active
kiinnosti	Active
parantelee	Active
julmuudet	None
taipunut	Active
kukoisti	Active
solakoita	None
naureskelisitte	Active
sotaoikeus	None
passata	None
kysellään	Passive
täydennetään	Passive
tulevaan	None
peukaloinen	Active
vastenmielisyydestä	None
lukkouduttu	Passive
puolestapuhuja	None
kätteli	Active
tiputtavat	Active
kostoiskun	None
visva	None
tiputettu	Passive
hakattu	Passive
välisistä	None
osunet	Active
alalajille	None
voisi	Active
soittelevat	Active
harmentanut	Active
laajentava	Active
rasistiseksi	None
imetty	Passive
ärsytä	Active
lievenee	Active
tahraannu	Active
tervehdittiin	Passive
soija	None
päivätty	Passive
rajatonta	None
järkytti	Active
riippunut	Active
lentävät	Active
karkotettava	Passive
pomppi	Active
kiilasi	Active
säilyköön	Active
innostuivat	Active
asennuksena	None
aikaansai	Active
lannoittaa	Active
kierrättävät	Active
lahjoittanut	Active
puristettava	Passive
volyymi	None
peliohjaimella	None
kohdistaa	Active
hindulaisuudesta	None
klassisisteissa	None
alennusmyyntien	None
liikuttui	Active
kaivaa	Active
räppäsi	Active
cameoroolia	None
pilkki	Active
kannattelee	Active
suolaan	Active
täydennettävä	Passive
tornadoa	None
niitti	Active
myyn	Active
kuivuisi	Active
mikroprosessoritta	None
huuruatte	Active
kettujahti	None
tuohinen	None
ulkoisti	Active
pelota	Active
poistin	Active
oikaissut	Active
häly	None
eläviä	None
ruoho	None
hukkunut	Active
äärilajin	None
päättyvää	None
korostaa	Active
välittyvä	Active
työntäisi	Active
yksinkertaistuvat	Active
kopsattu	Passive
lupautuu	Active
arvostellut	Active
aidoittanemme	Active
rakentaisi	Active
pommituksilta	None
pasuuna	None
raiskannut	Active
ilmoittautui	Active
luennoitsija	None
huutelitte	Active
säilytyksen	None
korjaantuu	Active
laitakukkien	None
alittivat	Active
huomautettiin	Passive
tarkoittaa	Active
lähetetty	Passive
laitteella	None
saostuu	Active
vaarantunut	Active
avustettava	Passive
rajoitettu	Passive
yököttäisitte	Active
kivunnut	Active
ydinarsenaaleitta	None
sirkushuveja	None
komposiittia	None
etsitään	Passive
lauhdutin	Active
vaurioita	Active
kullattiin	Passive
generaattorille	None
kuplii	Active
haluttaisi	Active
puuroutunen	Active
valkealle	None
univelalle	None
ärsyttää	Active
leijuu	Active
hyökkäsivät	Active
lainaisin	Active
entisenlaisessa	None
nollasi	Active
nipsahtaisin	Active
ohentumineen	None
esipuheesta	None
vangitsi	Active
karvonen	Active
rautakaivokset	None
voinevat	Active
epäkohtelias	None
kuunnelkaa	Active
viilettäisin	Active
harkitsi	Active
keinutan	Active
haastattelivat	Active
tunnustettiin	Passive
höystänevät	Active
vanhennu	Active
timpureihin	None
tietoturvaa	None
samurai	None
sisältänyt	Active
purkitettu	Passive
närästykselle	None
psykedeeliseen	None
hölskytät	Active
varttunut	Active
nurmikat	None
juotava	Passive
säilytetään	Passive
vilkaisin	Active
luetellaan	Passive
ruskokiiviltä	None
pienenivät	Active
kolmasosassa	None
ullakkohuoneina	None
viehättänet	Active
rotaviruksen	None
yläosattomissa	None
ballististen	None
asetu	Active
kulki	Active
kuljettaisi	Active
kohtaisi	Active
alapuoli	None
vahingoittuvat	Active
ornamentoisivat	Active
aktuaalista	Active
hohtavat	Active
yleisimpään	None
maksuvalmius	None
yhtyi	Active
tasoittuvat	Active
botaanikolta	None
rehentelevät	Active
läpäisivät	Active
järeää	None
mahdu	Active
kellotti	Active
näivettynyt	Active
hirvitti	Active
otatti	Active
metalliselta	None
tanssinut	Active
ryöstelet	Active
tyydyttää	Active
tutkiva	Active
poppia	None
kehittyy	Active
viitsisi	Active
sekaannu	Active
loven	None
kertautuvat	Active
muistelevat	Active
itsevarman	None
mielipidevanki	None
antautui	Active
nutistanet	Active
nurkunut	Active
lohkaistu	Passive
ylitys	None
villivarsa	None
kuivata	Active
temmoin	Active
suututtaa	Active
tarjoutuvat	Active
ostat	Active
päätyisi	Active
tiivistin	Active
mukautuivat	Active
poikkeaisi	Active
paikkaan	Active
uskontunnustukselta	None
tunnustusta	None
suunnittelukilpailussa	None
siirrymme	Active
mukautunut	Active
etunimillä	None
syvin	None
tietulli	None
rauhansopimusta	None
sovelletaan	Passive
kätkeytyvät	Active
syvensi	Active
käyttöaika	None
liityin	Active
hapettaa	Active
hahmoteltu	Passive
konetykkejä	None
esittelevät	Active
hyvästelivät	Active
puidaan	Passive
kultakaivoksessa	None
loukkaannu	Active
muinaistieteilijästä	None
hoitava	Active
mielletty	Passive
hämmensivät	Active
ratko	Active
ruoppaan	Active
podin	Active
puhdistetaan	Passive
faunan	None
tottuivat	Active
kalliomaalaus	None
lähtisivät	Active
samastui	Active
nurkkaan	Active
thomsoningaselleihin	None
käyttäydy	Active
toista	Active
syytää	Active
ylitsepääsemätön	None
verkottunut	Active
varoi	Active
rikkonen	Active
osavaltioilla	None
ilmatilasta	None
pelästyvät	Active
pelaan	Active
hallinnoitiin	Passive
jäsenmaa	None
ydinalan	None
militarisoitukoot	Active
alkyynit	None
seurasin	Active
hukkuvat	Active
lykkääntynyt	Active
yritettäisiin	Passive
tunnustettaisiin	Passive
puolittui	Active
ulotettu	Passive
numerologiaa	None
arkipäivää	None
aaltoalueen	None
keskustellut	Active
peruskorjattu	Passive
otaksuttiin	Passive
asiattomia	None
edelsi	Active
auttaa	Active
alkeelliset	None
haalistuvat	Active
kansoittaa	Active
estyi	Active
alkuperäiskieleen	None
uskokaa	Active
hyödyttävät	Active
teettänyt	Active
trivialisoitava	Passive
keskeytetään	Passive
tulkinnemme	Active
sijoittui	Active
piirittää	Active
varmistettiin	Passive
röökattiin	Passive
synnytyslaitoksen	None
asutettiin	Passive
mitoitettu	Passive
ylistetään	Passive
ennusmerkki	None
monopoloituva	Active
rehulla	None
lipsahdus	None
altistaisi	Active
arastettu	Passive
tarttuisi	Active
näytellyt	Active
hylkeenpyytäjät	None
symboloinut	Active
motorisoitakoon	Passive
upottaisin	Active
aasiannorsut	None
toimeentulosta	None
alamme	Active
avaruuslentäjä	None
aikuistuttava	Passive
listautuu	Active
tarjottiin	Passive
satama-altaasta	None
viettelevä	Active
koitin	Active
eteläisillä	None
tasauttava	Active
karhenivat	Active
englannintorvi	None
tyranni	None
pyyhitään	Passive
konstruoitiin	Passive
vertaileva	Active
vastustamme	Active
taikatemppujen	None
kiivetään	Passive
astuttaa	Active
kaasuttava	Active
budjetoitu	Passive
komeilee	Active
löyhennytään	Passive
tottuvat	Active
visko	Active
tuhosivat	Active
yksiväriseksi	None
palta	Active
nimennyt	Active
välittivät	Active
juonittelee	Active
muutettu	Passive
ilonpitäjä	None
vähättelevät	Active
taitajaa	None
seurattaisiin	Passive
luhisti	Active
härmetymme	Active
biedermeierinä	None
havaijilainen	None
luetteloinut	Active
havainnoiva	Active
koettelee	Active
neuvostotasavalloista	None
oudommilta	None
hinasi	Active
työtehtävän	None
demonauhasta	None
siirtolaisille	None
trivialisoinette	Active
kalatiiran	None
seinätulpalla	None
optisen	None
toistettava	Passive
päättyy	Active
raiskattu	Passive
laskelmoiva	Active
vältetään	Passive
varjostivat	Active
rohkaisisi	Active
kultauduttu	Passive
sekoituttiin	Passive
typpinarkooseineen	None
kaivoivat	Active
debattiin	Passive
leiriytyivät	Active
paluuksi	None
pyöristyy	Active
venyi	Active
ryhdyn	Active
sielua	None
kielitiedettä	None
kompromettoiva	Active
solunjakautumisessa	None
törmäystä	None
uudistuksesta	None
kohdistuisi	Active
kohonnevat	Active
itsepäinen	None
muistuttanut	Active
siirtyivät	Active
laskeutuva	Active
suostuttu	Passive
albumeissa	None
narisuttanemme	Active
säästävä	Active
tilasivat	Active
vikittelee	Active
triathlonissa	None
muuttajien	None
teeskenteli	Active
harrastuksista	None
virkistää	Active
laivasta	None
moniavioisuus	None
lukeutuu	Active
luodannet	Active
syyllistytään	Passive
harkittiin	Passive
vaalentuivat	Active
ylistän	Active
vuotava	Active
tilasit	Active
poistuva	Active
leveys	None
taottiin	Passive
laittaa	Active
rahtilaivan	None
ehdottaisi	Active
skeittauksen	None
lastattu	Passive
tekeytyy	Active
elävöittävä	Active
iskostanet	Active
valmennetaan	Passive
ekvivalenssirelaatio	None
ränsistyköön	Active
puhkaisee	Active
jatkettava	Passive
paradigmassa	None
viihtyvät	Active
turmelluttava	Passive
alkuperäiskappaleen	None
paukkunen	Active
tallennettava	Passive
alaiseksi	None
vietetään	Passive
edistetty	Passive
kriisiin	None
käärmekaula	None
asusteli	Active
tunnustettu	Passive
uudenaikaista	Active
hyvämuistisetta	None
dynamiittia	None
liberaalien	None
toimipiste	None
kaavittaneen	Passive
hidastuvat	Active
serafeita	None
käännetään	Passive
vääpeleistä	None
raivokohtauksena	None
prässäytyisin	Active
loistavalta	None
lihoa	Active
läntisellä	None
syrjäytynyt	Active
vesijohdon	None
herkistymistä	None
epäilivät	Active
potkaisee	Active
maltillistutaan	Passive
ikebanalla	None
mahdollistivat	Active
floriinin	None
sojottava	Active
akuutteihin	None
lisännee	Active
kaunopuheinen	None
räjähdä	Active
ajantasaista	Active
muutostyössä	None
eletty	Passive
partenogeneesi	None
livahdatte	Active
kirjon	Active
huovutettava	Passive
heikentyvä	Active
jälkeen	None
laantunut	Active
mestaruuskilpailun	None
joutunee	Active
spagettiwesterneistä	None
sulje	Active
rikkain	None
rakennustyömaita	None
oksennutettaneen	Passive
ahavoittanee	Active
juonut	Active
irvailee	Active
esittäkää	Active
majoittuvat	Active
odotellen	Active
noituu	Active
yöpynyt	Active
kehut	Active
monismia	None
substantiivina	None
kiitämme	Active
hangaariin	None
syötettävä	Passive
valmennettiin	Passive
riisui	Active
kohdistu	Active
ohikulkutien	None
liioiteltu	Passive
myöstävä	Active
tajusivat	Active
pääkonttoriin	None
uhkailua	None
šokki	None
liittyivät	Active
missiot	None
naura	Active
haukut	Active
oikeutti	Active
merkkasin	Active
newyorkilainen	None
antauduttava	Passive
lyhennettiin	Passive
ilmeeseen	None
lyhimpiä	None
ressuilla	None
loogisuuden	None
uuvuttaa	Active
suolaudut	Active
katsotte	Active
anonyymeistä	None
sanoivat	Active
pahennuttaisiin	Passive
futuurit	None
kiinnostukseen	None
voitettu	Passive
vihjasi	Active
hallinnolliseen	None
tungin	Active
rakasta	Active
miellettävä	Passive
suihkuaa	Active
inahtaisitte	Active
havittelivat	Active
nousivat	Active
pankkiiri	None
suhtautuisin	Active
kaapattiin	Passive
hengitystie	None
ratkottu	Passive
lietsoo	Active
mittelevät	Active
verrataan	Passive
epäpuhtaita	None
hakusanaa	None
pidettiin	Passive
kansainvälistyi	Active
yksityistetty	Passive
individualisoitava	Passive
kummastuttaa	Active
ratkaissut	Active
dippaatte	Active
uumoiltiin	Passive
öljyvärityö	None
tarkistaisi	Active
yritin	Active
lohtunaisitta	None
rakennettava	Passive
harppokaa	Active
japanilaiselta	None
iivanoina	None
kerskukoon	Active
keskeytä	Active
vainoaa	Active
puhuttaisiin	Passive
turkulaiselle	None
väkevöikööt	Active
samaista	Active
hukuttautui	Active
tyydyttivät	Active
seilaavat	Active
varoittanut	Active
huollettiin	Passive
kirjain	None
sisaruuden	None
liberalisoisitte	Active
johdattaa	Active
aitomaksasammaliin	None
levyinen	None
kiinalaisilta	None
kromioikaa	Active
vihaisten	None
jatkopaikkaan	None
äimistäisi	Active
välilehteen	None
vaakunakilpeä	None
korkittavat	Active
voidellaan	Passive
välittyi	Active
syrjäytyi	Active
epäuskottava	None
kuittasi	Active
rakennukseen	None
pidentyy	Active
passannevat	Active
hermostu	Active
pyhittää	Active
leuanveto	None
ansarin	None
edennyt	Active
pahensivat	Active
hiilsi	Active
naarmutumme	Active
syövät	Active
istuskelemme	Active
konvergenssista	None
vuokraava	Active
päristetään	Passive
nakersi	Active
uhkaillaan	Passive
koristellut	Active
etsiskeli	Active
äitykööt	Active
punottu	Passive
lipaissut	Active
vasteita	None
sotilaallista	Active
radikalisoitunut	Active
soinen	Active
sammuttanut	Active
kaivaudu	Active
ryöstetään	Passive
jyrrännevät	Active
heiluttaa	Active
hämmästyi	Active
kehnillä	None
riitin	Active
säveltävät	Active
sieraimiin	None
melua	Active
kolikkoja	None
vipattakoot	Active
jalkaudut	Active
prosentuaalinen	None
lopetettaisiin	Passive
kotkaan	Active
kuormattiin	Passive
muodostuu	Active
arkistoidaan	Passive
nousisi	Active
ryöstävät	Active
julistettu	Passive
taittui	Active
pilaavat	Active
perustelin	Active
majaili	Active
esittänee	Active
varustautunut	Active
irtaannuimme	Active
kaarnoittukaamme	Active
muistutettiin	Passive
hyökkäilevät	Active
hyytykää	Active
aiheuttava	Active
käräytettäköön	Passive
veistetään	Passive
plombitettiin	Passive
veritulppien	None
salasi	Active
perustuttava	Passive
kuokkinette	Active
jäsennelty	Passive
palovakuutuksiin	None
löysit	Active
ajanmukaistettiin	Passive
kyyristäkööt	Active
taipuva	Active
aktiivisten	None
hoiditte	Active
laittanut	Active
vahvuisia	None
rannikkoalueilta	None
opastaisin	Active
tulitan	Active
jännittää	Active
vertaisin	Active
kierrättivät	Active
hupenee	Active
tirkisteltäneen	Passive
keskittykää	Active
automatisoitiin	Passive
koputti	Active
rikastetaan	Passive
toistan	Active
kiipeilevä	Active
nestekidenäyttö	None
lähetetään	Passive
pälpättäisi	Active
sublimoitunette	Active
valmistautunut	Active
hörpätkööt	Active
pääomistajana	None
laatinut	Active
puhuisi	Active
väestönsuoja	None
loputtava	Passive
mittaavat	Active
subarktisen	None
alittaa	Active
urheiluautoa	None
supistuivat	Active
yksilöidään	Passive
vastaavina	None
moodeissa	None
suoristetaan	Passive
imeytyvät	Active
hyväksytti	Active
hakivat	Active
sivuutetaan	Passive
värttinällä	None
tarjoilevat	Active
etelärannikosta	None
nälkiintyivät	Active
firmasta	None
kaipaisivat	Active
tulehtui	Active
lomautettava	Passive
kuro	Active
jäsennetään	Passive
huoannevat	Active
napsautat	Active
liuottaa	Active
kivipaino	None
vertaillen	Active
nähdään	Passive
tiedostava	Active
suunnistavat	Active
avustava	Active
surivat	Active
homon	None
välisin	None
kannustamme	Active
japanilaiset	None
pyörittelee	Active
sudenpennuissa	None
lisäisi	Active
juridisia	None
purutupakkaa	None
fyysisille	None
menevään	None
kolibrien	None
parantaisivat	Active
järjestyä	None
elätteli	Active
esiinnyttävä	Passive
säilyttämistä	None
siunasivat	Active
stressaantunut	Active
poikettu	Passive
naamioidun	Active
kultarouskusta	None
varjostin	Active
veisattiin	Passive
kokeelliselle	None
peittää	Active
personifioitakoon	Passive
vyöryi	Active
altistuksessa	None
sopeudutaan	Passive
limaat	Active
hyväksyivät	Active
avautuu	Active
pienikokoisiksi	None
piilotettu	Passive
kammottavat	Active
irlantilaisen	None
keskeytyvät	Active
jäädy	Active
hämärryttänyt	Active
matara	None
savanneille	None
orjatar	None
käynnistävä	Active
ammuskeli	Active
jätkien	None
kehitellyt	Active
pelästyy	Active
pidellen	Active
aliarvioitu	Passive
yrittää	Active
harmaannutettiin	Passive
pallokalojen	None
ylipukeutunee	Active
evännyt	Active
silmäilty	Passive
lempi	Active
altistaa	Active
tietää	Active
tainnuta	Active
huolehti	Active
trypsiinin	None
heinäsirkka	None
jemmatkoon	Active
testaavat	Active
haisulin	None
ilmoittanut	Active
juhlinut	Active
syntymämerkkiä	None
havaitsee	Active
sotamiehenä	None
kronikoitsija	None
soitellaan	Passive
kiipeili	Active
uudisraivaaja	None
kiihtyvät	Active
vaalinut	Active
heijastunut	Active
haastettava	Passive
tipahtaa	Active
hammastuit	Active
katkeaisivat	Active
muuttivat	Active
kunnossapitoa	None
suonet	Active
päätepisteenä	None
jännitetty	Passive
turhauttava	Active
päädyt	Active
ryysinemme	Active
toteutuva	Active
silueteille	None
kielilläpuhuminen	None
avosuota	None
vääristelee	Active
fosforesoikoot	Active
epävakautta	None
kiduttaneen	Passive
aikaistaa	Active
käsitellään	Passive
vinkeistä	None
latinoikoot	Active
korjailen	Active
mäkärässä	None
pilkkovat	Active
puolsivat	Active
vähäteltiin	Passive
nousunopeusmittareihin	None
puututaan	Passive
rakkausrunoja	None
sävellystä	None
muokattaisiin	Passive
taustaa	None
peitä	Active
konsultoiva	Active
toteuttavat	Active
luostarille	None
taittunut	Active
urheilulajin	None
täydessä	None
laukaistaneen	Passive
haaveillut	Active
rehellisinä	None
innostunut	Active
talvehtii	Active
laiduntava	Active
romaneille	None
päätietä	None
keskusteltava	Passive
pysähtyivät	Active
elämänkatsomustiedon	None
paistettu	Passive
rynnisti	Active
sulfaattimenetelmässä	None
vaiettu	Passive
liikennemerkin	None
törmään	Active
uhkaavat	Active
monitieteistä	None
perustaa	Active
polarisoituisitte	Active
neljännesvuosisadan	None
fidžiksi	None
varastoina	None
keskustelen	Active
rangaistaisiin	Passive
maitorauhasten	None
fakkiintunevat	Active
ampuivat	Active
kunnosta	Active
kiipesitte	Active
lakkoon	None
aloitellut	Active
nappailivat	Active
elävöitti	Active
neutraalisti	Active
istutetaan	Passive
kuvittelevat	Active
potkaisi	Active
laulavat	Active
tarkemmassa	None
lohduttaa	Active
köyhtynyt	Active
lämpene	Active
mukailtu	Passive
rakastavat	Active
kanavoitu	Passive
peruuta	Active
välttelee	Active
äkkäämme	Active
siirtäisin	Active
sanonnasta	None
puolustanut	Active
montenegrolainen	None
tahmealla	None
lepäisit	Active
arvostellen	Active
huononsi	Active
singonnut	Active
katsastutti	Active
käsitti	Active
sauhuat	Active
edistä	Active
kaakaosta	None
tunnelmoisi	Active
pudottanut	Active
aikonut	Active
epätarkkuudesta	None
pilarissa	None
rupean	Active
puurtanette	Active
aikataulutettu	Passive
käryttänet	Active
mahtuivat	Active
selitytään	Passive
kudotaan	Passive
suositetaan	Passive
oi'isti	Active
katkeroitatte	Active
rehabilitoinemme	Active
alueellisissa	None
epäonnistuisi	Active
laihdutettiin	Passive
vihannut	Active
sulata	Active
ajautumista	None
asuinpaikka	None
palautuva	Active
italialaiselle	None
rokottaa	Active
estyvät	Active
siirryttiin	Passive
kuleksinevat	Active
ehditty	Passive
kengillä	None
vaisuja	None
kehittivät	Active
andante	None
jäsentelevä	Active
näyttelevät	Active
eriarvoista	Active
sekaan	Active
kannella	Active
tuoreeseen	None
katsotaan	Passive
kelmien	None
agitaatioitta	None
kaukasialaiset	None
tunnustan	Active
keskeytyy	Active
nopeuttaa	Active
neutraalistutte	Active
galleriasta	None
arvioidaan	Passive
rataosille	None
kekomuurahaisiin	None
muodostan	Active
noudattelivat	Active
tallennettu	Passive
raiskaavat	Active
vaikeutuivat	Active
kiihotti	Active
lupaisi	Active
lähetit	Active
tunnustamisesta	None
levittäytyi	Active
oksentavat	Active
rukoile	Active
sijainnut	Active
ylläpidettäisiin	Passive
säästöpankeille	None
keinuu	Active
perustettaisiin	Passive
palvelimien	None
sitoi	Active
syötti	Active
valmistellaan	Passive
liity	Active
grillannee	Active
hiihtokilpailuja	None
mallintava	Active
vertailtiin	Passive
ymmärsin	Active
planetaarion	None
mutkittelevat	Active
luokkataistelussa	None
säännöstellään	Passive
mahtuisi	Active
kehystävät	Active
savetut	Active
inversion	None
kiitä	Active
luonnehti	Active
kuvatekstistä	None
flaijereita	None
karheutunut	Active
hankkinut	Active
kanonisoinut	Active
vaaranna	Active
purjehduksiin	None
haluttakaa	Active
ivasi	Active
matkasivat	Active
lukaisin	Active
mittauksista	None
kuroudun	Active
löysin	Active
aikamoisen	None
yrityskaupoista	None
sekoittava	Active
vahingoituttu	Passive
meikattu	Passive
valtiollisten	None
miksasivat	Active
irrotettiin	Passive
skeittirampein	None
vihkaisen	Active
artistiin	None
eskaloidutaan	Passive
tavoitettu	Passive
vääristyy	Active
vaurioille	None
nimittänyt	Active
perhosuintiin	None
luhistunut	Active
aukaistiin	Passive
puoliryhmää	None
tympeydyin	Active
pakastekuivattanette	Active
muovataan	Passive
kapuaa	Active
lehtipuita	None
sotamiehille	None
riistäytynyt	Active
visuaalistettakoon	Passive
ruskeutuva	Active
höyrystyvät	Active
kiiruhti	Active
kytkeytyivät	Active
hirvittää	Active
uiskenteli	Active
aidattiin	Passive
takkuili	Active
nauran	Active
lisätkää	Active
nollakokoihin	None
tunkeilijan	None
järkiperäistyttäneen	Passive
paahdutaan	Passive
yleistä	Active
kehkeytynyt	Active
korostettava	Passive
valotti	Active
paikallistettiin	Passive
nyppylässä	None
häivytti	Active
videopelissä	None
turhautuisit	Active
turvauduttava	Passive
välikohtaus	None
pussitetaan	Passive
huovasta	None
aikaansaavat	Active
häiriinny	Active
painottuu	Active
sepelpoukamissa	None
hukkaavat	Active
houkuttavat	Active
platonilaista	None
nyhtäisty	Passive
kohdennetaan	Passive
törmäät	Active
vauhditti	Active
palaan	Active
siirryin	Active
akseptattava	Passive
kilpaillut	Active
opeteltava	Passive
täysiä	None
riku	Active
soveltavat	Active
aateloinniksi	None
kaatuva	Active
hyväksyttäisi	Active
puristavat	Active
noutaa	Active
laukaisualustatta	None
kudottu	Passive
pidät	Active
sensationaalisen	None
odotutettaneen	Passive
opittiin	Passive
glyserolista	None
tasoristeykseen	None
onnistuisi	Active
roihahdettava	Passive
golfkentälle	None
opusnumero	None
seuraajan	None
ansaitset	Active
verisuonikasvaimen	None
kuultavat	Active
vaihtoehtoisiksi	None
tahmeni	Active
hedelmäpuuna	None
omenakirvan	None
järisen	Active
palkataan	Passive
utelisimme	Active
sanoutuu	Active
asiakirjoissa	None
taltioinut	Active
naamioitui	Active
hyökättäisiin	Passive
vakioitu	Passive
yhdistänyt	Active
vesikidutus	None
kuntoutui	Active
öljypisaroilta	None
riidellään	Passive
antropologisen	None
tunne	Active
ilmestyisi	Active
ohittukaa	Active
päädyissä	None
varttuivat	Active
naama	None
hyödynnä	Active
sotilaslentokoneita	None
kuvitetaan	Passive
hyväksyttävät	Active
tuhoavat	Active
kuorimo	None
selkeyttävä	Active
pestään	Passive
kyettiin	Passive
perinteikkään	None
kirvoittanut	Active
tehostettu	Passive
vastustava	Active
haihtuisi	Active
kostuttaa	Active
koetetaan	Passive
sirkukseksi	None
kummeksutettaisiin	Passive
tarjoutuu	Active
haukattaneen	Passive
lieveni	Active
hytkäyttänet	Active
porautuu	Active
hidastanut	Active
päättelyyn	None
verkkokauppaa	None
kaareutuvat	Active
käännytettäköön	Passive
huutomerkkiä	None
huudelkoon	Active
monipuolistuvat	Active
tehonnut	Active
bensiinimoottoria	None
malli	None
jääväisitte	Active
kysyttäisiin	Passive
kulkenut	Active
salakuljetti	Active
kolttasaamelaisia	None
rekonstruoitiin	Passive
pommitettiin	Passive
saalistaisi	Active
hyppelehdittävä	Passive
aritmetiikkaan	None
perhostettu	Passive
salaileva	Active
loikkasi	Active
lukeutuvat	Active
valikoitu	Passive
väitti	Active
muistoesineitä	None
uskoin	Active
kuolaan	Active
rankaissen	Active
kuorsattakoon	Passive
kartongin	None
alistaa	Active
teljettiin	Passive
vaihdettu	Passive
kavennettu	Passive
arvostavat	Active
uhkasivat	Active
shopit	None
julkilausuman	None
prässätty	Passive
eksoterminen	None
syyllistää	Active
paukun	Active
toipuisi	Active
kumoava	Active
aatelismiehen	None
riisihäröllä	None
latinalaista	Active
kimmellettiin	Passive
isännöivä	Active
priorisoisi	Active
vapaudu	Active
iestitte	Active
joukkion	None
suojeleva	Active
uuttaa	Active
kantajien	None
moninkertaistunut	Active
palaava	Active
keinokastelua	None
koostuisivat	Active
sieti	Active
yleni	Active
laukesi	Active
lähestyivät	Active
nopeuttivat	Active
talutti	Active
hyväksyttävyyksiltä	None
lisättävä	Passive
kannatin	Active
viittomakielessä	None
kirjautui	Active
jakoivat	Active
päihitettävä	Passive
ommeltiin	Passive
tiedostanemme	Active
kasva	Active
väitellen	Active
päärynää	None
kipsaamme	Active
havainnollistaa	Active
kommentoitu	Passive
halveksuttiin	Passive
standardoitiin	Passive
kierrätettiin	Passive
likaantuu	Active
kurotettaneen	Passive
joustavat	Active
moninaista	Active
livahtaisin	Active
pihkaantuu	Active
adjektiivit	None
hoiteli	Active
säästellyt	Active
harmahtavat	Active
satuttaisi	Active
sijoittua	None
etääntyivät	Active
valöörein	None
pyörsit	Active
enkelimäisine	None
käyristitte	Active
rusettia	None
esiteltävä	Passive
siirtää	Active
sulautettu	Passive
surmasivat	Active
ostaa	Active
etabloiduttaneen	Passive
kansallista	Active
höyrystää	Active
loivennamme	Active
peruuntuivat	Active
entistä	Active
villiydyt	Active
koostumuksen	None
höyrytetty	Passive
saostetaan	Passive
mikrogrammana	None
korjautuu	Active
tunnuslauseina	None
rummuttaa	Active
sovinistisitta	None
lihoo	Active
vapaaherra	None
nisäkkäiden	None
kiistatta	None
typistät	Active
tiedotukset	None
vainosi	Active
aukaistaan	Passive
niksu	Active
tallensin	Active
kertaavat	Active
valehyökkäykseen	None
tennispelaajia	None
laittakoon	Active
kauhistuttaa	Active
palsamoitiin	Passive
edeltävät	Active
tuottavat	Active
puuduttakaamme	Active
kääpiöplaneetaksi	None
purkautuisi	Active
suppene	Active
suitsuttaa	Active
laillistutettaisiin	Passive
metabolisen	None
alokasta	None
rajattaisiin	Passive
ulkoministeriön	None
lisensoitu	Passive
loveaisimme	Active
nojautunut	Active
observoisitte	Active
oro	None
kaupunkivaltio	None
tulkitsin	Active
pelätään	Passive
kara	None
tiistaiaamuna	None
kristallinen	None
erinomaisia	None
onnettomuuteen	None
asuntokaupan	None
rauhoitetaan	Passive
edistyi	Active
puhuttaisi	Active
vapaamielinen	None
ylennettiin	Passive
ilmaisin	Active
tietokoneista	Active
julkaissut	Active
dolomiittikalkeista	None
vakoojan	None
oletetaan	Passive
rakeista	Active
aikailin	Active
edellytetään	Passive
kysyvät	Active
lotottaneen	Passive
jakaannu	Active
kehitettävä	Passive
porasivat	Active
analysoidaan	Passive
lannistui	Active
automaattista	Active
pätee	Active
piirroselokuvan	None
jodioinemme	Active
aiheutui	Active
kotiutti	Active
lisätty	Passive
plagioitu	Passive
ideoille	None
paneloitu	Passive
ylläpitävä	Active
epäonnistunut	Active
kysynyt	Active
pettävä	Active
löytäjäksi	None
kesyttäjät	None
kaupitaan	Passive
peitellyt	Active
pohjoispuolelta	None
keväistä	Active
rakastuivat	Active
onnettomuustapauksiksi	None
loikoilisin	Active
murskataan	Passive
kirkastaa	Active
runnoi	Active
taitettava	Passive
karsisi	Active
pohjukaissuolihaavassa	None
estivät	Active
oletetusta	None
keskustelimme	Active
pariskuntaa	None
bysanttilaisissa	None
kirjoittautunut	Active
suutelivat	Active
jyrsijänä	None
ylireagoinemme	Active
turvonnut	Active
kuroi	Active
kanavoidun	Active
modernistanette	Active
laantuu	Active
suisti	Active
tallensivat	Active
havitellut	Active
käytti	Active
nyrjäytellen	Active
lukeutui	Active
muokkaajalla	None
lähettää	Active
teeri	None
innostuvat	Active
käyttötarkoitus	None
kanoottikaksikkojen	None
jatkaisi	Active
uupunut	Active
azerintakoot	Active
paikataan	Passive
rasvaantunen	Active
heristynette	Active
laitettaisiin	Passive
puhuivat	Active
tiukentaa	Active
likasi	Active
ampui	Active
huoltajaa	None
kydetään	Passive
varustettiin	Passive
uudistuva	Active
pillastunut	Active
eteläpohjalaisia	None
kulminoitui	Active
harkitseva	Active
kustantavat	Active
karstoittukaamme	Active
huomattava	Passive
lähtisin	Active
normaalisti	Active
haistaa	Active
myyteissä	None
kaksinkertaistuvat	Active
artikulaation	None
haudo	Active
piikiville	None
sodittu	Passive
tarkkailen	Active
poraava	Active
lapsuudenystävä	None
tottelevaisuus	None
varaavat	Active
tehokkaammalla	None
harhauttakaamme	Active
arkussineiksi	None
vastusta	Active
kiistelivät	Active
urheilukenttään	None
väärentämisestä	None
saapuisivat	Active
pedofilia	None
asensin	Active
seuloi	Active
julkipankaamme	Active
paranneltu	Passive
marinoidun	Active
perijä	None
rumentaa	Active
alentaa	Active
aasianpyhäiibikseksi	None
kamppaili	Active
miksauksia	None
huollettava	Passive
sähköistetty	Passive
yhdenmukaistaa	Active
sijoitettu	Passive
hätkähdytti	Active
ryhtyisi	Active
öljyväritöillä	None
hammaspeikko	None
huokuu	Active
taitaa	Active
juristi	None
uskallan	Active
toipunut	Active
huijasivat	Active
vanhenee	Active
keikkaillen	Active
muovattiin	Passive
naurunalaistava	Active
devalvoitiin	Passive
heikkolaatuiset	None
keräisi	Active
vuokraan	Active
yhteiskuntakritiikin	None
jonotettiin	Passive
turhautui	Active
katsoisi	Active
siirtymämetalleja	None
neorealismi	None
bisneksen	None
kiitetty	Passive
kouruuntukaa	Active
hydrauliset	None
periytyvät	Active
syrjäytyivät	Active
kuivumista	None
lauttaan	Active
ihailee	Active
edustajainhuoneessa	None
riimihärkää	None
puhuvat	Active
kultahammasta	None
paluita	None
ylvästellevät	Active
rakastuu	Active
latinalaistanut	Active
äänestäjiin	None
asetutaan	Passive
värisinä	None
yhtenäistä	Active
muistutan	Active
onnistuivat	Active
kiertynyt	Active
päättelivät	Active
arvioitaisiin	Passive
pakenin	Active
heittelivät	Active
suippenee	Active
punertuu	Active
kärjistyimme	Active
mökineen	None
makeine	None
tarinalle	None
miellytti	Active
takakannesta	None
jumitti	Active
luovutti	Active
vääristä	Active
tao	Active
saalistaa	Active
seurakuntalaista	None
parantavat	Active
sovi	Active
vierivä	Active
tietokonepelejä	None
tarkoitan	Active
arvostava	Active
radioliikenteeseen	None
raahustaisivat	Active
lantakasoissa	None
väittäisin	Active
tapparalle	None
perustavat	Active
harhailee	Active
levyttivät	Active
petkutti	Active
natsien	None
ampuisi	Active
valmistaisi	Active
pakkomiellettä	None
oikaistaan	Passive
jumalattareksi	None
halkeiluja	None
huononee	Active
geopoliittisen	None
oranssiin	None
nielevät	Active
alistettu	Passive
ihmetytti	Active
jupiset	Active
rastaan	None
tarkennettiin	Passive
naisistuin	Active
supermarket	None
pyöräilee	Active
räätälöity	Passive
riehakan	None
mielialojen	None
vitsaillaan	Passive
miellä	Active
ahtauman	None
ilmoitettu	Passive
komentava	Active
tulkittaisiin	Passive
pelkistetään	Passive
vuoda	Active
puskevat	Active
laskuvarjojääkärit	None
etikoitunemme	Active
uneksii	Active
rauhoittelee	Active
suunnista	Active
fondueista	None
huolinut	Active
ponttoonisilta	None
yököttäisit	Active
joudun	Active
taksonomiaan	None
harrastaisi	Active
räkytimme	Active
turvaudutaan	Passive
kuvailtiin	Passive
modernisti	Active
riistaa	None
maatuu	Active
aikaavieville	None
oivallettu	Passive
huovuttanevat	Active
listattiin	Passive
harkkoja	None
vastustajat	None
taukosi	Active
liitolle	None
falsifioitaneen	Passive
kirjanorjassa	None
mainostoimistoon	None
ilmoitit	Active
hävetimme	Active
vanhentui	Active
voitamme	Active
hetkuit	Active
kykenemättömyydestä	None
käännä	Active
tuhopolttajaan	None
yhteyttää	Active
juniorit	None
pommitti	Active
kyselee	Active
lahjoitti	Active
turvataan	Passive
muistuttivat	Active
kieroutunut	Active
alustaa	Active
ilmalaivalla	None
suoriutunette	Active
rekisteröitävä	Passive
riistänyt	Active
karsastaa	Active
kyseenalaistivat	Active
vertikaalinen	None
vakuutetaan	Passive
opetteli	Active
näimme	Active
käristyimme	Active
kotoutat	Active
ajoitettu	Passive
soitan	Active
tahmennevat	Active
laadukkailla	None
avaruuslennoilla	None
liityn	Active
perannee	Active
tislatuitta	None
syaani	None
vaalitulokset	None
kesyttämistä	None
livon	Active
saksansi	Active
tarkastettiin	Passive
pahentavat	Active
toteutti	Active
tapoin	Active
aikataulutettiin	Passive
venevaja	None
repesivät	Active
kietoontui	Active
kaksikylkisinä	None
voivodikunnan	None
iloitse	Active
vaijerilla	None
tuhoutunut	Active
tutustuttaa	Active
sortuisi	Active
kiihottava	Active
verhoaa	Active
rangaistava	Passive
merkkaan	Active
bibliografian	None
pyöräili	Active
mormoni	None
suvaitsevuuksineen	None
siivitti	Active
parantanut	Active
oransseja	None
äänsivät	Active
kuuromykkien	None
vahingoittanut	Active
valikoidaan	Passive
suunnattiin	Passive
lumilautaillemme	Active
heijastuksen	None
myöntävät	Active
hinkatkaa	Active
uppoaisi	Active
kirjoiteltiin	Passive
sääntöineen	None
surkeita	None
näyttävä	Active
puhkesivat	Active
tunnettiin	Passive
kalkutin	Active
hovioikeutta	None
kiinnittyvä	Active
elävöittää	Active
eristyi	Active
motivoiva	Active
ilmaantukoon	Active
ultralyhyin	None
rikkaina	None
melo	Active
pikkuvarpusitta	None
vaikeneva	Active
saostuvat	Active
poistan	Active
vaikuttavat	Active
huhtoisin	Active
sinertävät	Active
senttimetri	None
murrosiän	None
lainanottajan	None
naukunemme	Active
kiinnostuin	Active
hillittiin	Passive
turhautuu	Active
mahduttava	Passive
kätkenyt	Active
blondaat	Active
lombardialainen	None
katkeileva	Active
paukutti	Active
nopeutettu	Passive
kukistuu	Active
menehtyvät	Active
sakotetaan	Passive
vääristää	Active
myrkyttäkööt	Active
mäntymetsä	None
suhtautuu	Active
asentavat	Active
saapuu	Active
äänestäisin	Active
täytyttävä	Passive
tingitty	Passive
rahdattu	Passive
koostukaamme	Active
kieltäisi	Active
lussuttanevat	Active
muistettaisiin	Passive
testosteroni	None
katkesi	Active
tuloiksi	None
dynamot	None
standardoidut	Active
vieraillut	Active
keittänen	Active
näytteli	Active
siselöinemme	Active
virittänyt	Active
puki	Active
innovatiivisella	None
venyivät	Active
hankoa	Active
metafyysisessä	None
tihkuva	Active
arvaamattomia	None
obinugrilaisten	None
investoikaamme	Active
ilmastointiteippiä	None
raaputuksilta	None
pyörittäisi	Active
kunnianarvoisella	None
koostetaan	Passive
varmistunut	Active
välkkyvät	Active
häpäisyä	None
puuhaan	Active
pyöristää	Active
termodynamiikkaan	None
puutuin	Active
hakeutunut	Active
parittaa	Active
osanottajia	None
kanarialintu	None
luotettava	Passive
koiravahtina	None
rukoilevat	Active
oppinut	Active
jauhettu	Passive
rasiat	None
ojitettu	Passive
halveksui	Active
opiskelivat	Active
vedät	Active
aurinkosähkö	None
palkkaavat	Active
kypsyi	Active
tyhjentää	Active
arkkidiakoni	None
vaurastuivat	Active
puukirkosta	None
tunnelmista	None
modernisoitui	Active
tunnistavat	Active
päiväsi	Active
vedä	Active
ennusta	Active
valkaistu	Passive
huilunsoittaja	None
bunkkereihin	None
sovittaneen	Passive
hoikistat	Active
kyseenalaistat	Active
koordinoidaan	Passive
yhdistivät	Active
sopeuduttiin	Passive
avarrat	Active
omavaraistakoot	Active
toistavat	Active
kusipää	None
kuvakirjoja	None
joutuu	Active
stemma	None
suostuttelee	Active
muotouduimme	Active
kumota	Active
perun	Active
paljastaa	Active
rokotetaan	Passive
hypyt	None
kaivertanut	Active
assosioitaneen	Passive
verifioinevat	Active
kangasta	Active
kartoittivat	Active
haavoitti	Active
kasvonpiirteitä	None
sipaskaamme	Active
maittakoot	Active
järähtivät	Active
elektronisilla	None
jesuiitaksi	None
kapeassa	None
ruoansulatusjärjestelmä	None
sutinen	Active
heiluttiin	Passive
piilottaisi	Active
ensiesitetty	Passive
näyttänyt	Active
parantelen	Active
modifioidun	Active
saksikaamme	Active
satsannemme	Active
ukottuisitte	Active
musertaa	Active
havahtui	Active
katkeaisi	Active
taidekokoelmasta	None
auttakoon	Active
lähetin	Active
asvaltoitu	Passive
ahtoilman	None
kieltäytyi	Active
uusiutuvat	Active
resuaisi	Active
sunnalaiset	None
taannut	Active
vastavakoiluun	None
kylmentää	Active
sääntelevä	Active
kuuluisaksi	None
järjestyssäännöille	None
koulutuskeskukset	None
harhaopiksi	None
malttanut	Active
ehdottavat	Active
työllistävät	Active
manipuloiva	Active
kauttaviivan	None
ystävystyvät	Active
kuntoutti	Active
polje	Active
kanonisoitiin	Passive
puhkeamisen	None
liittyisivät	Active
vajoamme	Active
tarkistin	Active
liityttävä	Passive
digitoitu	Passive
pesiköön	Active
suistokrokotiilin	None
tuoksut	Active
kotiutetaan	Passive
hypotensio	None
klimppiydymme	Active
orkestroitu	Passive
romutti	Active
tilataan	Passive
virkamiehelle	None
sulautti	Active
sahtia	None
huijannut	Active
huomautettu	Passive
pidätte	Active
soikea	None
nyhälaitainen	None
hallitse	Active
puristin	Active
ajoittuivat	Active
haaveillen	Active
nivusissa	None
jyrisyttäisit	Active
ulostavat	Active
täsmentävät	Active
pidätteli	Active
edesauttavat	Active
vandaalia	None
venyisi	Active
toistin	Active
ratkeavat	Active
moduloitu	Passive
neuroosiksi	None
teljetään	Passive
unohtunut	Active
korvautuvat	Active
kasvoi	Active
vähentyisi	Active
lovettu	Passive
myönnät	Active
toimita	Active
kolminkertaistuu	Active
rahastaa	Active
alotin	Active
ennättäköön	Active
hehkuttaa	Active
haihtuvat	Active
nirhaisemme	Active
ruvettava	Passive
kopiokoneissa	None
pesukarhut	None
ilmaantuvat	Active
nykyaikaistuttava	Passive
tepsutamme	Active
anastanut	Active
yhtenäistyisi	Active
varoittaa	Active
puolueettomiksi	None
potkukelkoissa	None
jaanattaneen	Passive
sadekausi	None
heikkonen	Active
henkiolennon	None
koteloitu	Passive
toipui	Active
hakkasi	Active
seurustelusta	None
etsintäkuuluttaa	Active
oliivi	None
erakkona	None
aktivoiva	Active
hurissevat	Active
dementoitunut	Active
paheksun	Active
haritettiin	Passive
kysyi	Active
saavutettu	Passive
ehdotat	Active
sekaisin	Active
ehkäisyvaahdotta	None
suomennoksia	None
kapteeni	None
tuulettava	Active
kelvannut	Active
oikaistiin	Passive
läähättäisitte	Active
nimisenä	None
tapettu	Passive
nujerrettiin	Passive
kulkua	None
vahdi	Active
omavaraista	Active
helisevä	Active
siivoaa	Active
ajanmukaistettu	Passive
virulenssein	None
drumliini	None
jalostanut	Active
pilvenpiirtäjistä	None
nahuatl	None
kiilana	None
painostavat	Active
kysellen	Active
kolmivuotinen	None
siteerataan	Passive
nostattava	Active
kirkkaudesta	None
triumfiin	None
soikoon	Active
kuivatettiin	Passive
silppuaisi	Active
yksilöivä	Active
astui	Active
teurastettu	Passive
sahalta	None
pakottivat	Active
työkalusta	None
tahmaudut	Active
syvennytään	Passive
supan	None
lepäsivät	Active
holhoojana	None
tuijottava	Active
jäkälistä	None
kuumimmista	None
risteytysten	None
orjakaupoilta	None
kookospähkinää	None
aarteenetsinnän	None
keskittyisi	Active
osannut	Active
kaavioisit	Active
naureskellen	Active
valokuva	None
hohti	Active
hiukaisisimme	Active
suomennetaan	Passive
heijastuvat	Active
juonesta	None
muodostaisi	Active
kansallistaa	Active
katastrofissa	None
funktioina	None
pitäisin	Active
enstatiitti	None
arkkipiispoista	None
puoliintuu	Active
lomaillevat	Active
sitoivat	Active
sulkeudu	Active
hennot	Active
paettava	Passive
vaikuttajista	None
raataa	Active
himoitsivat	Active
ohjeisti	Active
valvoisi	Active
paisuteltu	Passive
kukistivat	Active
metsänhoitoyhdistykset	None
puhdistava	Active
myöntää	Active
nukleiinihappo	None
ilmaantuivat	Active
siroteltu	Passive
tuotteistettu	Passive
miekkailua	None
tarhattu	Passive
vakiintuneilla	None
liittyisi	Active
ojentelisin	Active
piittasit	Active
uutettu	Passive
käpyilet	Active
spiraalit	None
alimpaan	None
tähdensi	Active
salamoisivat	Active
kokoontuisivat	Active
syvennetty	Passive
varottava	Passive
lähisukulaisina	None
sepittänyt	Active
möyhentäisin	Active
tapellaan	Passive
chilensalpietareista	None
henkilöityisit	Active
varta	Active
arvataan	Passive
teleskoopista	None
metaboliaan	None
kierrätetään	Passive
pakassa	None
irrottivat	Active
valitan	Active
huku	Active
myönnettävä	Passive
huonontanut	Active
repeytyy	Active
polkeuduttaisiin	Passive
altistuu	Active
vahvistuvat	Active
koristanut	Active
junarataa	None
syvyyksiin	None
lampsinette	Active
napannut	Active
käppäilevät	Active
murtautuvat	Active
luonnista	Active
kerrostu	Active
viivästyy	Active
kuivaisi	Active
karkotettaisiin	Passive
jäätävän	None
suurentunut	Active
valitin	Active
kaihtavat	Active
kiellät	Active
julkistetaan	Passive
keula	None
estynyt	Active
kohdistanut	Active
valehtelee	Active
langeta	Active
sotilasajoneuvo	None
yhdistyisit	Active
laiminlyötiin	Passive
sotisi	Active
been	None
kuljetaan	Passive
nukuttava	Active
kisannut	Active
riisuvat	Active
käräjäoikeudessa	None
edesmenimme	Active
aateliskalenterissa	None
prikaatitta	None
henkivartijan	None
laantuivat	Active
hajuaisteilla	None
syvenevät	Active
käpristynee	Active
väärennöksenä	None
puhkaisi	Active
helpottuisi	Active
keihäsmiehet	None
prokaryoottien	None
absiditta	None
yritetään	Passive
ropisee	Active
jäätyisi	Active
torilla	None
murskasi	Active
väitteille	None
kamppailee	Active
kauhistava	Active
kuuluvalla	None
orkesterissa	None
nekrofiili	None
suorakulmaisen	None
itsetunto	None
yritystoimintaan	None
puvusta	Active
punoittavat	Active
opastetaan	Passive
kuumenivat	Active
itsenäistynyt	Active
rakennuttivat	Active
ojitusta	None
pudottautuu	Active
vaimentava	Active
kohdistetaan	Passive
joutunut	Active
bodasivat	Active
saksinen	Active
lohduttaisi	Active
kiipeilevät	Active
palkkaisi	Active
lasketaan	Passive
verhoillette	Active
pienentyy	Active
teoreettisella	None
ammattikoulut	None
rabbin	None
ampua	None
puhui	Active
vaihtelevat	Active
lastiluettelo	None
yksityiseen	None
salakuljetettiin	Passive
typistyi	Active
normitettu	Passive
noudata	Active
rosvota	None
kavahti	Active
yllättänette	Active
komennettiin	Passive
liputetaan	Passive
patinoisi	Active
puuteria	None
muodistaisin	Active
kiehtonut	Active
rennompi	None
laudaturin	None
meriraja	None
puoltava	Active
drive-in-elokuvateatterit	None
pahenee	Active
omakotitaloista	None
startannut	Active
puolittuu	Active
valmistetulla	None
koulutetaan	Passive
estradilla	None
kulttuurivallankumouksen	None
viisastuu	Active
laillistutaan	Passive
uhkailkoon	Active
postuloitiin	Passive
svetareina	None
koulututtaneen	Passive
ääliömäiseksi	None
analytiikkaan	None
äänsi	Active
pistävä	Active
lankesi	Active
etsisin	Active
galatialaiset	None
jakaantuivat	Active
valjasti	Active
köntystänet	Active
kännätköön	Active
luovutettaisiin	Passive
muistelisin	Active
onnesta	Active
saaveista	None
fanittaa	Active
synkensi	Active
proletaaristan	Active
pitäville	None
tasoitettava	Passive
tiivistänyt	Active
torjutaan	Passive
valokuvannut	Active
taidat	Active
polyfoniset	None
kampannut	Active
esitettiin	Passive
koetellaan	Passive
läikähdeltävä	Passive
rauhallisessa	None
buddhalaisuudet	None
eliminoitu	Passive
aloittelin	Active
piipahti	Active
siirryttävä	Passive
kivetettäneen	Passive
ihastuu	Active
kaasukammiota	None
vokaalisointua	None
putsaisimme	Active
herjaava	Active
amulettina	None
patsaiden	None
vaikutat	Active
kokoomus	None
hakeutui	Active
kivestää	Active
aion	Active
hukkaannuttava	Passive
kuultava	Active
evakuoitiin	Passive
muumioitiin	Passive
muurattu	Passive
säilyivät	Active
heikkovirrat	None
ahonoidanlukko	None
poistunut	Active
viihdytämme	Active
huoneenlämmössä	None
lahdattu	Passive
haukkuivat	Active
materiaaleilla	None
piileksikää	Active
tirkistelen	Active
painukaa	Active
uskon	Active
panostava	Active
matkittu	Passive
sävelletty	Passive
töhritty	Passive
jalkavaimojen	None
haastan	Active
mokoman	None
tiikerihailla	None
keinautetaan	Passive
rajattiin	Passive
järkyttyivät	Active
konsortiossa	None
peräänkuuluttanut	Active
kaasuuntuu	Active
koneiston	None
lukumäärälle	None
pubista	None
linjattu	Passive
osaisi	Active
jyrännen	Active
tynnyreihin	None
vainosivat	Active
valottaa	Active
replikoiduin	Active
levittäytyvä	Active
suomuurain	None
närkästynyt	Active
lintsattava	Passive
muutellut	Active
selvensin	Active
kuunneltu	Passive
ammattikielessä	None
kertaistui	Active
marttyyriksi	None
oppimisterapian	None
ripoteltu	Passive
lyyhistyitte	Active
miekkaillen	Active
eläisivät	Active
serbiaksi	None
paljastu	Active
toistuvasta	None
ulotetaan	Passive
edellyttänyt	Active
käyttäytyy	Active
kidutusta	None
julkista	Active
toisintaa	Active
toisti	Active
vaiheesta	None
syrjäyttänyt	Active
hyaluronihapoilla	None
miekoilta	None
repeytynyt	Active
tarkoitat	Active
kiinnitettävä	Passive
sallisivat	Active
lyöt	Active
viisaudesta	None
tutusta	Active
kampanjoinut	Active
telova	Active
närkästyttäisi	Active
helissevät	Active
vietävä	Passive
osallistuin	Active
laukaistu	Passive
sorsalintujen	None
lisääntynyt	Active
auttajat	None
osakunnasta	None
vikisimme	Active
johdattivat	Active
lähde	Active
samaistui	Active
jäädä	Active
kohtaisivat	Active
voittamista	None
suunnistettiin	Passive
rappeutui	Active
löysi	Active
näytäntökaudella	None
leventynyt	Active
lanseerattiin	Passive
syvennettiin	Passive
kastaudutte	Active
geishakuuliksi	None
miehittämätöntä	None
materiaaliksi	None
voimaantullut	Active
poiminut	Active
hibernoitaneen	Passive
aikakauslehdet	None
nukkauduit	Active
suojelevat	Active
julkaisi	Active
saavuttanut	Active
joriskaamme	Active
tippuu	Active
kuluta	Active
räyhäsi	Active
mätänitte	Active
seurustellut	Active
kartastoon	None
permikautisia	None
kirvoitti	Active
pimittänyt	Active
inhottavaa	None
granaattiomena	None
lauletaan	Passive
poistamme	Active
virstaa	None
tutustumme	Active
pakota	Active
hiljenee	Active
käsinukesta	None
keskustellaan	Passive
hirtettiin	Passive
silpoivat	Active
johdatellut	Active
muuteltu	Passive
arpajaisten	None
ajeltu	Passive
ruuhkaannuit	Active
lähtisit	Active
ilmoittaja	None
betonitiilessä	None
valmistanut	Active
peity	Active
pelkistyvät	Active
kaivoi	Active
jaat	Active
himmennevät	Active
vaatimattomalla	None
epäilevä	Active
nimittäisi	Active
sukelluksissa	None
kietoutuvat	Active
luotettu	Passive
oksensi	Active
lyönyt	Active
pingotettu	Passive
kukistettava	Passive
luottamusmiehen	None
meedialaiset	None
yhdentänet	Active
deittailkoot	Active
tulostin	Active
oletamme	Active
vaikeuttivat	Active
osuu	Active
mangaanin	None
hanuristi	None
kiinnitetty	Passive
haaveilen	Active
kariutunut	Active
vertailivat	Active
autoritaarisen	None
prototyypit	None
avuttomia	None
koostuva	Active
tupeerattaisiin	Passive
anasti	Active
valmisteltiin	Passive
hahmottelee	Active
hävitetään	Passive
hätyyttävät	Active
rituaaleilla	None
puistelet	Active
demoralisoiduttu	Passive
siirrä	Active
kortteleista	None
lujennettaneen	Passive
lojaaliudesta	None
hyveellisyyden	None
mahtailijoiden	None
yhteisölliseen	None
hitsataan	Passive
kiristi	Active
pidättäytyivät	Active
dekkarikirjailija	None
jututtaa	Active
vaalittu	Passive
voimista	Active
kohua	Active
hommaisi	Active
parittelevat	Active
twistiä	None
korkit	None
teeskentelevät	Active
onnistuu	Active
vouhottavat	Active
hämäävät	Active
perusteina	None
kastroitu	Passive
helpottava	Active
kestitsi	Active
kolminkertaisti	Active
maanosiin	None
hiokoon	Active
suotautunemme	Active
kiihdyttivät	Active
sekundääristä	None
nuolimaisia	None
ristetty	Passive
höyryää	Active
taita	Active
levykeasemien	None
kääpiöbullterrieri	None
puolusta	Active
suomennettiin	Passive
käyttäytymisellä	None
läpäisee	Active
eioona	None
nakuttelemme	Active
lääkitsitte	Active
täyttävä	Active
varastanut	Active
kipusivat	Active
salakuljettivat	Active
puolustusasianajajaa	None
häiriköidään	Passive
vietteli	Active
vasemmistolaistuttu	Passive
sukelsi	Active
liimattu	Passive
rutistaa	Active
luokittelevat	Active
kirkastettu	Passive
turvaneuvostoa	None
suunnitelmilta	None
tappelua	None
lämmennyt	Active
laantui	Active
leimautunut	Active
pylvääseen	None
väiteltiin	Passive
panttaisivat	Active
parittomina	None
maanalaisena	None
mädäntynette	Active
tulittaa	Active
räätälöidään	Passive
spektaakkelissa	None
vältettiin	Passive
rakastuvat	Active
miehistönkuljetusvaunu	None
toipuu	Active
laukaistiin	Passive
tulevilta	None
pärjätään	Passive
suhdelukua	None
tietämyksen	None
väittelee	Active
levyttäisi	Active
salattu	Passive
etsisi	Active
patosivat	Active
sponsoroitu	Passive
sinkosi	Active
kuivaisin	Active
mesimarja	None
korvikkeeksi	None
horjuttaisitte	Active
laitettiin	Passive
looseiksi	None
päihteinä	None
seisoi	Active
välähdellevät	Active
kiekkoilisin	Active
kielsi	Active
vaaliliittona	None
puolsi	Active
printattu	Passive
sanotaan	Passive
tarjosi	Active
vauhkoutuisi	Active
pulju	None
sinetöidä	None
reagoisivat	Active
nuolevat	Active
esittävät	Active
tapettiin	Passive
ihaillut	Active
rikkoi	Active
luotsasi	Active
alko	None
tallasin	Active
kerääntynyt	Active
koettanut	Active
suomennoksina	None
vakaan	Active
jouduttaisi	Active
norjensivat	Active
puettu	Passive
viestitti	Active
rivimiesten	None
vaurioidu	Active
tyhjennettävä	Passive
jäljitettiin	Passive
lahjoituksilla	None
joutavat	Active
sortuvat	Active
tarkoittanet	Active
kehutaan	Passive
sammut	Active
säädettiin	Passive
ohittanut	Active
naulittiin	Passive
äänittivät	Active
kammitsoissa	None
risteytti	Active
originaalisetta	None
estettäisiin	Passive
lanseerannut	Active
täsmentää	Active
murhataan	Passive
lyhennä	Active
kannatamme	Active
ristikoinee	Active
säteile	Active
itsenäistyisi	Active
arvaisin	Active
kirroosi	None
asianomistajalla	None
vilkaissemme	Active
täydellisempi	None
uskaltautuvat	Active
juovatanrekiksi	None
sulattavat	Active
joivat	Active
mielipuolten	None
vakionopeudensäätimen	None
horjutti	Active
huljuva	Active
jyliskäämme	Active
viru	Active
sortui	Active
merenelävät	None
akkusatiivi	None
merkitsisi	Active
rannikolle	None
laajene	Active
friikannette	Active
ahdistavat	Active
haittana	None
safkatta	None
kasuavat	Active
verenmyrkytykseen	None
koteloisivat	Active
katsottu	Passive
hyötyisivät	Active
kansalaisten	None
tuhoamisesta	None
asettuisivat	Active
paheksuvat	Active
luettele	Active
tyyppinä	None
yhdistettiin	Passive
kompastunut	Active
kivetty	Passive
logoista	None
eläkeläisistä	None
varoittivat	Active
kelpasivat	Active
sävyttää	Active
rohkaisevat	Active
valtaisivat	Active
aloittaisivat	Active
varjosta	Active
hissuttaisimme	Active
velkautettava	Passive
muunsivat	Active
muokattu	Passive
ravistellaan	Passive
ylennys	None
puleerattaneen	Passive
siemenissä	None
jalkautunut	Active
viikuna	None
monimutkaistakoot	Active
ärtynyt	Active
kareja	None
ryntäsi	Active
haluat	Active
pidämme	Active
tiedostettiin	Passive
valtuuttanut	Active
kerättiin	Passive
söi	Active
tunnossa	None
edistyvät	Active
kyyhkystä	None
eristäytynyt	Active
kimpaantuva	Active
romahdutti	Active
hymyjen	None
ehdotan	Active
sönkätköön	Active
piilusit	Active
jäähtynyt	Active
ajattelemattomaksi	None
iltatähdessä	None
lyyhistykööt	Active
tiedottaa	Active
halvaantui	Active
laimennettaisiin	Passive
rulettia	None
yhdisty	Active
nyhjäillään	Passive
tyrmäsivät	Active
keikkaili	Active
ahdattiin	Passive
pakottautunut	Active
norjansi	Active
videopelien	None
onnelaan	None
kaavailivat	Active
vannoivat	Active
päätynyt	Active
nopeuttanut	Active
hyttynen	None
hupeni	Active
versoi	Active
lounaista	None
ilmoitti	Active
väännettiin	Passive
myrkyttää	Active
niitattakoon	Passive
koitettu	Passive
kimppuunnu	Active
heijastin	Active
menetellen	Active
tervaannut	Active
kirjastoautot	None
neuvotellaan	Passive
tasapainoili	Active
turhaumassa	None
himmenee	Active
murtuisi	Active
annossa	None
hiilivoimaa	None
ejakuloitaisiin	Passive
ekshibitionismi	None
kyntänevät	Active
chippasimme	Active
lanseerasi	Active
mission	None
viedä	None
kiittänyt	Active
kehikon	None
lipsahti	Active
odottakaa	Active
edellyttää	Active
päihitetään	Passive
tuotannontekijä	None
odottivat	Active
selviytyvät	Active
henkilömäärän	None
tyrmättiin	Passive
kehuivat	Active
tanssiaisissa	None
typpioksiduulin	None
siippojen	None
tarkkailtiin	Passive
sallinut	Active
tiedotettu	Passive
kaareutuva	Active
suolannevat	Active
uskalsivat	Active
viidakkoa	None
valmistava	Active
eurytmia	None
korttelin	None
sisäistä	Active
lähestyt	Active
standardisoitiin	Passive
liudentunut	Active
tutkimuskenttä	None
oteltiin	Passive
savutti	Active
aliryhmien	None
riimitellyt	Active
polarisoitunut	Active
uutuuksista	None
viriteltiin	Passive
tyrannin	None
mursi	Active
liehu	Active
esilämmitetään	Passive
suukappale	None
sokeutena	None
viihtynyt	Active
historioinut	Active
myssy	None
louhittu	Passive
kutuaikana	None
mukaileva	Active
arvautettu	Passive
vanhentunut	Active
diplomaattiposteitta	None
luovuttaisi	Active
tasoittivat	Active
vyörynyt	Active
kähene	Active
herätti	Active
räätälin	None
tiesimme	Active
märkivä	Active
tunnustaa	Active
kannustin	Active
ahdistelee	Active
seuraamuksia	None
suodattavat	Active
orjailutta	None
zoomattava	Passive
hillitty	Passive
laillistuttaneen	Passive
yhdensuuntaista	Active
voimankäytön	None
ekstranetissä	None
kiirehdittiin	Passive
katolisille	None
huumaavat	Active
hiitannen	Active
pakotettava	Passive
haudattiin	Passive
latinisoitu	Passive
vapautuu	Active
arvosti	Active
haastatit	Active
ruokasienenä	None
molskinoille	None
rintamamiestaloista	None
korkeasta	None
sijoittanut	Active
kvanttifysiikassa	None
taitettu	Passive
janotaan	Passive
halveksittiin	Passive
pyyhällettiin	Passive
naureskeli	Active
määräydy	Active
varmistutaan	Passive
myllerretty	Passive
kahlitsee	Active
pomottanevat	Active
kannattavan	None
revontuliksi	None
nostovoimaa	None
räjäyttää	Active
yhtenäistää	Active
puuttunut	Active
luvallistettakoon	Passive
unohdettu	Passive
käyttäisivät	Active
tulkattu	Passive
tarjottava	Passive
foolihappoa	None
paimennettiin	Passive
uumoiltu	Passive
kajota	Active
pellettiä	None
mikrofoneihin	None
tietämättömyyteen	None
heittivät	Active
siimoilla	None
ratifioitiin	Passive
pilaisi	Active
odottavat	Active
amerikkalaistutaan	Passive
samoan	Active
tehostetaan	Passive
taiteenfilosofioin	None
tiukkeni	Active
tähditti	Active
väittäisi	Active
läheisempiä	None
äännelkäämme	Active
peruutettu	Passive
spekuloidaan	Passive
ohjeistanut	Active
voitan	Active
tiliöitiin	Passive
kirjailen	Active
muikun	None
edustajainhuoneen	None
löytäisin	Active
päti	Active
metalloikoon	Active
tapahtuisivat	Active
lento-onnettomuuksia	None
siintää	Active
laulakaa	Active
voittajalta	None
tyrkyttäisitte	Active
seison	Active
hohtaa	Active
kieltää	Active
torun	Active
opettele	Active
eläisi	Active
tapahduttava	Passive
levennettäneen	Passive
estäkää	Active
käynnistyi	Active
kärjistivät	Active
lähikauppaa	None
keulahahmo	None
kastuu	Active
keijustotta	None
siirrät	Active
ylennetään	Passive
välittyisi	Active
jäätyivät	Active
reunamuodostuma	None
nojaava	Active
kehottavat	Active
seurauslause	None
protoineen	None
alkulimalla	None
alistui	Active
farsin	None
peittyi	Active
saapuisi	Active
vaapun	Active
halot	Active
paistetaan	Passive
perustuivat	Active
hoitelee	Active
taksikuskia	None
epäilee	Active
kuningaskalastajien	None
härkähai	None
viitattiin	Passive
käsittää	Active
hornin	None
vammautukoon	Active
saimaannorpat	None
kirpaisee	Active
pienentää	Active
yläfemmoitta	None
kirkasti	Active
kauhistuvat	Active
haluaa	Active
muodostuvat	Active
suhtautuisi	Active
helpontunet	Active
askarruttaa	Active
pulin	None
vertaisarviointi	None
kumartaa	Active
autoilussa	None
ehdotit	Active
pohdiskeleva	Active
kiteytyi	Active
polveutuisivat	Active
majaillut	Active
imeytynyt	Active
havahtuu	Active
akustiikassa	None
taisteltava	Passive
kylmän	None
käsketty	Passive
hiffannette	Active
viivytteli	Active
aidannemme	Active
ravustavat	Active
rauhaarakastavalla	None
valvokaa	Active
basilikat	None
sotikoon	Active
lähiympäristö	None
tiedät	Active
säästämistä	None
killun	Active
kuljeskeli	Active
edesmenneeseen	None
väkevöity	Passive
peittyy	Active
imenyt	Active
autonalustoihin	None
kosmologia	None
rintamaa	None
vihataan	Passive
alkeissilmussa	None
silppuri	None
lennä	Active
harpotaan	Passive
haarautuva	Active
mukaillen	Active
tähystää	Active
ykkössija	None
investoinut	Active
muukalaisystävällisiksi	None
yllyttänyt	Active
sivulliset	None
ilmatorjuntaohjus	None
kaahaan	Active
saapuivat	Active
osallistu	Active
suostun	Active
bumerangi	None
byrokraattistanette	Active
metsästänyt	Active
jäsentyy	Active
pysähdytään	Passive
käsitteistä	Active
kaappaavat	Active
linkoa	Active
avusti	Active
eväillä	None
öykkäröitävä	Passive
sokeutuu	Active
äkämä	None
lamaantui	Active
siveä	None
miehitettiin	Passive
maannetaan	Passive
hoiperrelkaa	Active
lopettamisen	None
vitsailivat	Active
kuullottava	Active
ohjeissa	None
koivunlehtohapero	None
kuvaan	Active
huomautin	Active
mäkitupalaisen	None
soitettu	Passive
kaiverruksilta	None
vähentynyt	Active
salakuljettaa	Active
marjo	Active
afaattisessa	None
vallankumoukseksi	None
imujuurelta	None
pysyttäisiin	Passive
maalaisjärki	None
liiskatkaa	Active
ohjautuva	Active
afrikansatulahaikarasta	None
liuottavat	Active
premissi	None
hävitetty	Passive
kovenee	Active
promovoinevat	Active
testattu	Passive
kehdattu	Passive
hahmotettu	Passive
poikkeaa	Active
lupautunut	Active
bileitä	None
vastustat	Active
pohdittiin	Passive
älyllistä	Active
palaavat	Active
yhdistyisivät	Active
palokuntien	None
lyhennetään	Passive
kersantilta	None
sinipunaiset	None
kaalikääryleet	None
puuttuu	Active
ryhtynet	Active
supistuvat	Active
lastasivat	Active
suostutaan	Passive
olosuhteista	None
kierähtää	Active
painoindeksin	None
ahtautunut	Active
uitiin	Passive
doupattaneen	Passive
härmistyy	Active
herkistynyt	Active
yllättäjä	None
riiviö	None
karkeista	Active
henkilöidyttäisiin	Passive
saamelaisilta	None
juohtunut	Active
leikittiin	Passive
juhlii	Active
sairastuttaa	Active
hirmuliskoina	None
erity	Active
jalostunut	Active
lähentyivät	Active
parane	Active
tyrehdytti	Active
lyödään	Passive
turvauduttiin	Passive
ilmoitin	Active
supistui	Active
aitoamerikkalaisista	None
suominen	Active
himoitsi	Active
parlamentaarisessa	None
polveutunee	Active
sopimattomista	None
miksattiin	Passive
norahti	Active
huumaudun	Active
liikutti	Active
kovettuva	Active
kaihonnut	Active
tarkastellaan	Passive
vuodatti	Active
grafiikasta	None
nikotuttavat	Active
ulommassa	None
sovittivat	Active
humma	None
täyttyivät	Active
mekasta	Active
liuennut	Active
mahdollistanut	Active
assosioidaan	Passive
lahjoittavat	Active
parannellaan	Passive
hajaudu	Active
vähyytenä	None
pysäyttäkää	Active
näkivät	Active
painottuivat	Active
valmennettava	Passive
sallitulla	None
sorville	None
beetahajoamisineen	None
kata	Active
kardemumma	None
vaikutusmahdollisuuksia	None
lykkäsi	Active
jääristä	None
tömistelkää	Active
latinalaistettaisiin	Passive
sävyttivät	Active
keskittänyt	Active
vaiennut	Active
laukkonen	Active
linnoittautunut	Active
loveavat	Active
praktikoikoon	Active
käsittelemme	Active
mausta	Active
rankannut	Active
tarkoittivat	Active
nukahtaa	Active
typistyisin	Active
aurinkoisissa	None
kerroksella	None
kevyen	None
pidentäkööt	Active
pyörittävät	Active
sisäistäkää	Active
kokeelliset	None
syötäisiin	Passive
heikentynyt	Active
suojasi	Active
uudenaikaisen	None
passitettiin	Passive
pesivä	Active
käynnistää	Active
suosisit	Active
luvattomien	None
tytäryhtiölle	None
korvannut	Active
häädetty	Passive
kuuntelivat	Active
kontrolloiva	Active
jouduttiin	Passive
hakoja	None
sisäiseltä	None
herätteli	Active
muodostunee	Active
ilmiönä	None
rantautui	Active
lauhtui	Active
lorotellemme	Active
jäädytettävä	Passive
kantoaallolla	None
kuuroutuva	Active
aurataan	Passive
valehtelisin	Active
sitaatissa	None
sivuttiin	Passive
kroaatin	None
laattojen	None
jalostettu	Passive
raunioittivat	Active
loukkauksesta	None
tunkeutuva	Active
moduloidaan	Passive
vaarantanut	Active
ratkaisuehdotuksia	None
sairastui	Active
väsähtänyt	Active
työttömyyspäivärahan	None
verottavat	Active
peilata	None
käytätte	Active
askarruttanut	Active
bramiinia	None
huomautuksissa	None
nojasi	Active
tunnisti	Active
preussiin	None
suurennettu	Passive
älähtää	Active
kostan	Active
osattu	Passive
tehostettiin	Passive
luovuin	Active
herjaavat	Active
mielsivät	Active
pitänee	Active
ilmastonmuutos	None
hidastetaan	Passive
englannissa	None
havaitsevat	Active
kainostuttivat	Active
hukkuu	Active
kiikastaa	Active
spesifisiin	None
täydentävä	Active
yksinkertaistaa	Active
vahvistumiseen	None
odottavia	None
alkuainetta	None
lojuu	Active
pätevä	Active
aravalainoitteinen	None
saatat	Active
aavisti	Active
maakumpuja	None
liitteeksi	None
maanvaivoitta	None
saaristot	None
päivämäärineen	None
pilkkoutuu	Active
seisahtunet	Active
sotalaivojen	None
monimutkaistaa	Active
härskiytyi	Active
problematiikkaan	None
turmelee	Active
hoidettava	Passive
vapaamielisenä	None
räimisitte	Active
juoksutetaan	Passive
kolmiviikkoisen	None
yhtälönä	None
lasertulostin	None
ylistävä	Active
interreilatkaamme	Active
putiikin	None
humppasit	Active
pissapojissa	None
ujoutta	None
nitoja	None
birgittalaisluostarin	None
dominikaanisessa	None
navakoidumme	Active
päde	Active
nukkujatta	None
soittavat	Active
lokalisoitu	Passive
selostanut	Active
välimatkan	None
muuttuneisiin	None
seinävalaisimilta	None
perunut	Active
muisteltiin	Passive
unohtaisivat	Active
liimasi	Active
sisustettu	Passive
hohottavat	Active
vihellettiin	Passive
mainitsin	Active
huuhtoutui	Active
jaettu	Passive
projektoreita	None
sijatkoon	Active
voitti	Active
pakkosyötettävä	Passive
hallitsevat	Active
sijoittuva	Active
järkevöidyin	Active
vähennä	Active
paalutettu	Passive
oikeistolaistumme	Active
omistan	Active
opastivat	Active
liukulaakereiksi	None
avaruusasemalla	None
aamunkoitossa	None
viimeistellään	Passive
metsämurmeli	None
hahmottanut	Active
mutkattomat	None
maltoineen	None
kondorien	None
majoittanut	Active
spesiaalistaisimme	Active
levitä	Active
anastettu	Passive
erittyy	Active
tarkasteltu	Passive
pierisi	Active
heitätin	Active
turbaanien	None
vierailee	Active
poikennut	Active
huojahtanet	Active
ruvennut	Active
väljenemme	Active
normittaisi	Active
myöntynyt	Active
valikon	None
mongertava	Active
vaatekappale	None
talousvaikeuksien	None
kuvansi	Active
käytettäisiin	Passive
altistettiin	Passive
myötäilivät	Active
myönnyttävä	Passive
arvostettiin	Passive
huomaisivat	Active
roomalaista	Active
muovikassiin	None
puurratte	Active
hyödynnettiin	Passive
kangilla	None
lämpöiset	None
kytki	Active
haittaan	Active
loukkaantuvat	Active
itsenäistyy	Active
tarpeesta	None
jarruuntukoot	Active
lujittavat	Active
taltioitiin	Passive
tanssissa	None
tarkastele	Active
jäähdyttäjän	None
tahdistin	Active
postinkantaja	None
ajorataa	None
järjestävä	Active
miellettiin	Passive
vastustatte	Active
luodattu	Passive
hidastavat	Active
kärkevä	None
tainnuttaa	Active
puremalihaksitta	None
apteekkarein	None
ajanmukaistanette	Active
hirveä	Active
sortuu	Active
kiristävät	Active
lootusasentoon	None
määräisi	Active
harjoittanut	Active
piilottanut	Active
prepositionaalille	None
ruhosta	None
kiivastelijoihin	None
kiusattu	Passive
fundamentalismista	None
rasittunut	Active
suotu	Passive
numeroitu	Passive
puleerannut	Active
wokkiruoitta	None
ryhtyi	Active
levittyy	Active
haikaili	Active
lennettävä	Passive
maoreja	None
hukkuivat	Active
rohkaissut	Active
aiheuttivat	Active
sijaita	None
ratkaisemista	None
siivuttanette	Active
kulkijoilta	None
jaellut	Active
kaikkitietävä	None
raivataan	Passive
hoitui	Active
kirjoittava	Active
saarsi	Active
kohoa	Active
hävinneitä	None
sopupelittä	None
lykkäsivät	Active
esteettömyys	None
suoltaa	Active
kalasti	Active
puolustavat	Active
helskykööt	Active
differentioituva	Active
juuttunut	Active
noteerattaneen	Passive
algebrallisen	None
muovausleikkauksetta	None
kaipasin	Active
sijoitettiin	Passive
molo	None
pitäkää	Active
jälkikäsittely	None
dominoinut	Active
arabikumi	None
tupakanpolton	None
syövyttänyt	Active
ravistelee	Active
empisivät	Active
kirpaissut	Active
selvitettiin	Passive
venähtäisivät	Active
levykeaseman	None
porkkana	None
merkitty	Passive
pyörähdät	Active
opeta	Active
kuorot	None
selitettävä	Passive
patentoinut	Active
oikeuta	Active
tiedotti	Active
haurastuu	Active
luotsannut	Active
yttriumin	None
kyborgien	None
turvattaisiin	Passive
talvehtinen	Active
suodatin	Active
kilvoittelivat	Active
levittävä	Active
myisi	Active
fluorihoidot	None
laulettiin	Passive
tunnustautunut	Active
oletan	Active
toivotettiin	Passive
amebamaisten	None
sivuuttanut	Active
huvittunut	Active
vaskasitte	Active
öljyputkelle	None
leimaavat	Active
kaksoiskierre	None
liuskatta	None
talletettiin	Passive
feodaaliherroineen	None
vääristynyt	Active
melankoliset	None
aamulehdessä	None
vangituttaa	Active
antistaattisemmalla	None
dieseliä	None
systemoikaa	Active
jäävännee	Active
marskimaat	None
livahti	Active
sulamisesta	None
olentoja	None
ekonometriselta	None
kaivata	Active
murrostaisin	Active
vingahdan	Active
uskaltaisin	Active
edistää	Active
vertaisarvioinnit	None
kintaita	None
lukihäiriöillä	None
täydennä	Active
marinoitu	Passive
ennustanut	Active
maailmankartalle	None
tarpeelliselta	None
lujitti	Active
departementteihin	None
puutunut	Active
täytetyllä	None
nietosta	Active
siirtolaisia	None
hankittaisiin	Passive
protoneista	None
lopettakaa	Active
vastaanotettu	Passive
konversioilla	None
pensasta	Active
putsaavat	Active
sanoittaa	Active
tärvelty	Passive
petoeläimistä	None
istunnot	None
tentti	Active
vakinaistaisi	Active
rikottaisiin	Passive
kiteytyvät	Active
paljastuivat	Active
voidan	Active
puhutellaan	Passive
tiedota	Active
väsäsin	Active
yhdistyisi	Active
järkeili	Active
lentotukikohtiin	None
maustettu	Passive
tutkinut	Active
suhina	None
lajittelee	Active
pesaisisi	Active
käyttivät	Active
paikattiin	Passive
ilmoittava	Active
murtoviivasta	None
markkinoidaan	Passive
markkinahinnat	None
korkeuskäyrien	None
vähemmistöstä	None
tapattakaa	Active
veneettömiin	None
hyperventiloitaneen	Passive
käsittelivät	Active
väsätty	Passive
digitaalisille	None
johtopäätöksiä	None
rasittunet	Active
noutava	Active
keventävä	Active
asettuisi	Active
uskontunnustus	None
lataat	Active
vallattava	Passive
sademittari	None
lyheni	Active
luisui	Active
narskahdus	None
trilogiaan	None
kehotin	Active
tarjoutui	Active
häivytte	Active
jahkasin	Active
sortuivat	Active
ilmasti	Active
vakuutusaikoina	None
komentavat	Active
kuopattiin	Passive
ehdytän	Active
varjoa	Active
huomioikaa	Active
avustuksella	None
paineistaa	Active
komennettu	Passive
tipahdellette	Active
työstetään	Passive
huoistakoot	Active
linnoitettiin	Passive
vesittää	Active
saostuisivat	Active
idealisoitu	Passive
vieroittaa	Active
pienensivät	Active
räjäyttelee	Active
bikineitä	None
toimitetaan	Passive
voimisteli	Active
korpipäästäiseltä	None
juontaisi	Active
keitti	Active
petkutan	Active
glysiinistä	None
kammennen	Active
konsultoitu	Passive
torjumisessa	None
mullistivat	Active
syökää	Active
lihavoitu	Passive
poistanut	Active
haastattelee	Active
valmistellut	Active
heittäisin	Active
riisunen	Active
kihlautunut	Active
laukea	Active
suositellen	Active
kellahtavat	Active
kotihiireen	None
ratkesi	Active
kessuille	None
kastelee	Active
hähättänyt	Active
kehitystyöhön	None
koalitiossa	None
negridin	None
tuotiin	Passive
kalkkeuduimme	Active
korvattaisiin	Passive
vaurioittava	Active
elvytetty	Passive
karsinoomiksi	None
laimetkoon	Active
valtarakenteet	None
eukalyptukset	None
punnitsisi	Active
huolehdinnoiksi	None
polvistunut	Active
lisääntyy	Active
valmistautuu	Active
tiukentaisimme	Active
arpeudut	Active
liikevaihtoon	None
todellisista	None
kodat	None
vety	Active
tarkensi	Active
jumaluuteen	None
hypi	Active
cesiumin	None
hieskoivu	None
oikeussaliin	None
aikaista	Active
tarkkailtu	Passive
öljyterminaalin	None
hierotaan	Passive
paksujen	None
menettelee	Active
ravistaisimme	Active
tyylilajeiksi	None
huuhtoivat	Active
keräsi	Active
lietsoivat	Active
parannettava	Passive
edelläkävijäksi	None
rangaistaan	Passive
slovakialle	None
ilmaantuisin	Active
säädelty	Passive
heikennä	Active
slummiutunemme	Active
virkistäisimme	Active
kohdunkaulansyövässä	None
yltäkylläisyyden	None
talloisivat	Active
laajentumisessa	None
viestitelkööt	Active
varauduttiin	Passive
suojelivat	Active
kansiolla	None
ilmestynee	Active
syöttää	Active
erittele	Active
ajeli	Active
rakastakaa	Active
kaltevoinut	Active
alikehittynyt	None
popmusiikki	None
viivytettiin	Passive
uistin	Active
tarvo	Active
keikkaillut	Active
etsikää	Active
hirveää	Active
lähentelevä	Active
raahasivat	Active
kuusamaperhosissa	None
matkustajamäärillä	None
instrumentaaleja	None
viivästynyt	Active
vahingoittunut	Active
halkoo	Active
räjäyttele	Active
temppuilkoon	Active
porkkanaraasteina	None
viisivuotiaina	None
tiherrettäisiin	Passive
ilmaisi	Active
ruusunpunainen	None
kiusasi	Active
edistämisessä	None
kannattajineen	None
pienennä	Active
sooloissa	None
harmeja	None
lumoava	Active
kunniakas	None
murhaan	Active
matkustettava	Passive
juonnettiin	Passive
julistivat	Active
mirrin	None
ohjelmoidaan	Passive
hankaloittivat	Active
kulkeutui	Active
kiehutuksia	None
tallentunut	Active
amputoinemme	Active
kahlannut	Active
kököttää	Active
pohjoisnavalta	None
velvoitti	Active
luokittelin	Active
hyllytetty	Passive
aurinkovuorokausi	None
sotkeutuu	Active
imelletty	Passive
teroitettu	Passive
osaamiskeskuksen	None
syntetisaattorien	None
ansaitsemme	Active
voidellut	Active
innostui	Active
esittäytynyt	Active
kuvussa	None
tutkijoissa	None
sivuavalla	None
pistävät	Active
kiehtoo	Active
kahleilla	None
aikaansaadaan	Passive
teloituksen	None
epäusko	None
hyräilee	Active
kiintyvät	Active
taidettu	Passive
vahingoittaa	Active
loit	Active
lakkautetaan	Passive
pudottautuvat	Active
salamurhaan	Active
unohdat	Active
ammusvarastoja	None
tappakaa	Active
korvautui	Active
käytät	Active
värväsivät	Active
ulottaa	Active
viulistit	None
upota	Active
dunkerinajokoiran	None
nouseva	Active
tartuttiin	Passive
edustuston	None
yritysten	None
testattava	Passive
oikolukua	None
tutkitutti	Active
maisemantutkimuksin	None
vahvistettu	Passive
painostaa	Active
kidusraoiksi	None
kirjovat	Active
heiluivat	Active
kipenöisimme	Active
liität	Active
tulittavat	Active
yletä	Active
velottu	Passive
rahoita	Active
sähköpostilla	None
nelinkertaistu	Active
napsahtaa	Active
vakuuttivat	Active
lankeaisi	Active
tilattiin	Passive
selviytyy	Active
tajuttu	Passive
kuulustelevat	Active
sauvon	Active
kaupunginvaltuutettua	None
rypistyvät	Active
poliittistunemme	Active
suorittivat	Active
heikkojännitteisiin	None
anaerobisissa	None
nastaa	None
shakkimatti	None
aiheellista	Active
haavoittivat	Active
lietsoi	Active
varjostaa	Active
munittu	Passive
moraalittomuutta	None
syyllistyi	Active
hauskuutetaan	Passive
biopolttoaineita	None
kopiolla	None
turvautunut	Active
kalibroitu	Passive
pohjaudu	Active
palkattava	Passive
siviilivihkimisiksi	None
istuuduttaneen	Passive
verhoavat	Active
injektoikaa	Active
heilahtaisitte	Active
ponnahtanut	Active
vaivaan	Active
lukitun	Active
järähdettäköön	Passive
kellahtava	Active
välttelevät	Active
eristykäämme	Active
individuaalistaisit	Active
selvitellyt	Active
siirtyi	Active
maaottelut	None
tappanut	Active
rajoittivat	Active
luetteloitiin	Passive
huoltoasemissa	None
sterilisoitava	Passive
nyrkinkokoisena	None
jäädyttävät	Active
gloksiniaksi	None
reserviupseerikoulusta	None
käsitellyt	Active
latinisoidaan	Passive
dubletit	None
liikututtiin	Passive
kouluttajana	None
vaurioituivat	Active
tajusi	Active
uinuu	Active
addiktoitaneen	Passive
koulutettiin	Passive
tilavuuksien	None
kriminologiselta	None
menestyisit	Active
valloittanut	Active
kotoistettu	Passive
vesiteinä	None
juurehtiva	Active
sotkeutuisivat	Active
selviydy	Active
erottunut	Active
valehteli	Active
sellossa	None
sisälly	Active
mahtoi	Active
jättäydyitte	Active
puhallettiin	Passive
kannatettiin	Passive
juoksuttaa	Active
karitsoittaisit	Active
liikkuu	Active
baaritiskillä	None
puolisotilaallista	None
polveutuva	Active
jatkunut	Active
välittää	Active
kaatuivat	Active
väittivät	Active
orjuutettiin	Passive
arvostellaan	Passive
vahingollisena	None
tuhkattiin	Passive
rooleista	None
paritellen	Active
liikuteltava	None
kielenalaisin	None
seitsenotteluun	None
kartuttaa	Active
aasien	None
kultakaudeksi	None
yllätetty	Passive
sykkii	Active
sopiva	Active
siirrettäväksi	None
latasivat	Active
työstettiin	Passive
piteli	Active
ohjautui	Active
muistanut	Active
suositeltava	Passive
matemaattistuttaneen	Passive
liikutettava	Passive
juontunut	Active
vituttaisi	Active
konsertit	None
heitellyt	Active
yksilöllisyys	None
haparoinee	Active
mangustit	None
modernisoitu	Passive
hiuduin	Active
aloittaisi	Active
mainitse	Active
motivoiduimme	Active
selittänyt	Active
kapeammaksi	None
kiinaksi	None
suojautuu	Active
pilakuvien	None
omistautuu	Active
luonnehtiva	Active
vaurioittavat	Active
korvautunut	Active
säänteli	Active
väkevöidään	Passive
järkyttyvät	Active
noutivat	Active
äyskynyt	Active
kajahdat	Active
metropoli	None
arvioitiin	Passive
viilataan	Passive
klimppiytyisi	Active
karkottanut	Active
kvartsia	None
kuikuili	Active
pestasi	Active
kaksineuvoinen	None
markkinoitiin	Passive
kymmenille	None
muistelet	Active
salvon	Active
työyhteisöjen	None
pamautti	Active
virtsaan	Active
venäläistynyt	Active
kouluttanemme	Active
sovellettu	Passive
mietiskelevä	Active
räjäytetään	Passive
väitän	Active
tarvitseva	Active
koristellaan	Passive
luonnistu	Active
sulttaanille	None
kaksinkertaistuu	Active
piiritti	Active
indoktrinaatio	None
neuvoja	None
toteaisin	Active
kyllästyvä	Active
sisältäisi	Active
pirstoutuisit	Active
kaunistaa	Active
uudistavat	Active
hämärä	None
sukulaisena	None
tyydytti	Active
napattu	Passive
katkaistaan	Passive
laajentanevat	Active
ihmisparkoina	None
katsekontaktia	None
puhalletaan	Passive
törröttävät	Active
sotaorpoihin	None
kitkeröitynen	Active
kohtauskulmaa	None
lumipeitettä	None
elävä	Active
mehevöidyn	Active
notkelmassa	None
perustan	Active
heikkenivät	Active
vaitelias	None
madaltunette	Active
selitettäisiin	Passive
havainnot	None
vantaaksi	None
laiminlyöntien	None
kenkiä	None
nöyrtyi	Active
sopeutuvat	Active
vuodan	Active
kuumenee	Active
ilmenisi	Active
halvaannuttaa	Active
poteva	Active
kasematteja	None
rannikko	None
kietoutuivat	Active
matkustanut	Active
tehoaisi	Active
syveni	Active
puitiin	Passive
kinkkaan	Active
tunnistaisivat	Active
ruskistaisi	Active
huusivat	Active
uhrataan	Passive
haukkuva	Active
vinoutunut	Active
kiinalaisen	None
antisankariksi	None
ilmaan	Active
uusiutui	Active
perustelisivat	Active
kisasivat	Active
muutan	Active
valitteli	Active
lisensioitu	Passive
ripustaa	Active
välttyi	Active
itäsuomalaisina	None
mikropiireissä	None
hyväksyisivät	Active
tasavaltalaisen	None
mittaamisesta	None
loukattiin	Passive
sosiaalistuttakoon	Passive
kytkenet	Active
paloiteltiin	Passive
oopperaan	None
steinerkoulut	None
vivahteikas	None
panssaroitiin	Passive
asfaltoitu	Passive
hilloutunevat	Active
metsästä	Active
tekeytykää	Active
huhuttiin	Passive
täydentäisi	Active
tuomaroinut	Active
madotimme	Active
rivistön	None
kasaantuu	Active
ilmastoitu	Passive
aksenttimerkissä	None
tarinassa	None
darwinismi	None
nelinkertaistaa	Active
näyttelisi	Active
kuulostivat	Active
kroaatti	None
dopingskandaalista	None
pillittänen	Active
kiihottunet	Active
niveleen	None
tuulastaisin	Active
toivioretkettä	None
horjahtanette	Active
kaasuuntunut	Active
sokeerattakoon	Passive
kipsaisi	Active
jomottanemme	Active
järjestettiin	Passive
karsittiin	Passive
tilavatta	None
nuhteli	Active
myanmarin	None
välittyivät	Active
peräsi	Active
petetty	Passive
poistaisi	Active
karmaiseva	Active
saavu	Active
vainotaan	Passive
nuijittiin	Passive
pelastavat	Active
savuttanee	Active
herpauduttu	Passive
urbanisoitunette	Active
haukutaan	Passive
lennätetty	Passive
kiipeilee	Active
kulttuurisissa	None
lattialaatan	None
piilotin	Active
oleskeli	Active
hytisyttäisivät	Active
jäystänyt	Active
vapautti	Active
neoliittisesta	None
seiso	Active
alalajia	None
edistivät	Active
selitetty	Passive
raivattava	Passive
esittäytyy	Active
pohjautui	Active
arvostetaan	Passive
veny	Active
nukahtavat	Active
hämärtänyt	Active
rikastuu	Active
uhrattava	Passive
lokeja	None
lausuttu	Passive
evakuoidaan	Passive
käännyttävät	Active
inventoitu	Passive
tappele	Active
katkeilee	Active
liioittelee	Active
äänestätte	Active
heikentää	Active
esikuntineen	None
johtaminen	None
homogeenista	Active
taikinoitaneen	Passive
telkeää	Active
räpäytti	Active
esittelijänä	None
välkyn	Active
ehtii	Active
lakkoillet	Active
saasteita	None
erkaantuivat	Active
voitetaan	Passive
avustanut	Active
moduloitaisiin	Passive
teurasti	Active
unohti	Active
koplaan	Active
surmaan	Active
raivokkaita	None
hipsinen	Active
haavoittuneita	None
äärimmäisissä	None
asustaa	Active
eskaloituu	Active
varjostettu	Passive
lintsaisin	Active
nuhjaantuisimme	Active
äkämystytettiin	Passive
masentunut	Active
sallittaisiin	Passive
havaitsen	Active
lisätköön	Active
jästien	None
vaaleille	None
muistutettu	Passive
hommaan	Active
ehdotettiin	Passive
pinnistä	Active
katkaise	Active
lisätään	Passive
takkuiset	None
käräjien	None
raakapurje	None
sosiaalistakaamme	Active
kiistänyt	Active
aikaistettiin	Passive
juurikarvat	None
sekasikiö	None
alakouluista	None
porattiin	Passive
vältyttiin	Passive
elättää	Active
äidinperinnöissä	None
kutistuivat	Active
lomittuvat	Active
saavun	Active
nanna	None
kauppakeskuksissa	None
heilutellen	Active
suotimia	None
salvo	Active
ratkeaa	Active
sokaistukaamme	Active
pihistettäköön	Passive
veganismia	None
puolueelliseksi	None
armahtanette	Active
johteessa	None
taistelisi	Active
kiverryt	Active
poistukaa	Active
suutelevat	Active
soistuva	Active
puuvillaisin	None
langattomat	None
autetaan	Passive
tarjottu	Passive
tekniikkaan	None
lievittävä	Active
selvitetään	Passive
mätästävä	Active
työnnettiin	Passive
retoromaani	None
ennustan	Active
räiskisin	Active
käsinojat	None
tuotos	None
pärjäävä	Active
hämäsi	Active
saada	None
telineessä	None
karisti	Active
korostettiin	Passive
nousukauden	None
loppuunmyyty	Passive
turvannut	Active
etäytti	Active
kalastettu	Passive
vähämerkitykselliselle	None
huomataan	Passive
halkeaa	Active
moskaa	None
omenaviinietikoihin	None
syyskausineen	None
äärimmäisistä	None
kaikui	Active
suvereniteetin	None
pyrinnön	None
identifioitu	Passive
viedään	Passive
kelpaisivat	Active
uita	Active
ohjausjärjestelmä	None
yksiviivainen	None
voittivat	Active
mainostettiin	Passive
ostavat	Active
vaalilauseet	None
puhallutettava	Passive
unohtuivat	Active
ylevöitettiin	Passive
valitellut	Active
vankeuteen	None
häiriintyvät	Active
muotoutui	Active
jälkeinen	None
pystyttivät	Active
syössee	Active
ponnisti	Active
periferiat	None
maustettiin	Passive
metsästyksen	None
fanalokeissa	None
maailmanlistalla	None
edettävä	Passive
iänmääritysten	None
niksautti	Active
aseklofenaakille	None
ansaitaan	Passive
järjestäytyy	Active
riisutaan	Passive
muokkain	None
säilytimme	Active
hiilettäköön	Active
mantraa	None
biotekniikkaa	None
sentrifugoidaan	Passive
ryöstänyt	Active
hävittää	Active
levittäytyivät	Active
kihlattiin	Passive
poikkaiskaa	Active
filmattu	Passive
edesmennyt	Active
oikoili	Active
paisutettaneen	Passive
tukehduttaa	Active
tarkkaileva	Active
uhkailivat	Active
huudettu	Passive
silmäsairaudet	None
holtittomasta	None
madaltaa	Active
äänititte	Active
lannistanut	Active
varmistaa	Active
seuraajalla	None
germaanisilla	None
viritetty	Passive
siirtyvä	Active
kiemurteli	Active
luikerteleva	Active
italiannin	Active
käännyttänyt	Active
kunnioittava	Active
ammatillista	Active
kärjistävät	Active
paluusta	None
haihdutat	Active
rakennuttu	Passive
murjaissette	Active
jakeeseen	None
tulkitseva	Active
tartutaan	Passive
kostautui	Active
oksetitte	Active
moraalille	None
imutetaan	Passive
alenna	Active
karsinut	Active
palvova	Active
selvittävät	Active
näyttäisin	Active
löydätte	Active
menestynyt	Active
kiljahtakaamme	Active
liittynyt	Active
ruokakaupassa	None
lihavoidaan	Passive
siisteydestä	None
heijastuu	Active
hymyilyttänet	Active
turmeltunut	Active
ominaislämpökapasiteetti	None
pohdittava	Passive
huomauttanut	Active
runnellut	Active
harmittava	Active
sureva	Active
taivu	Active
nesteyttää	Active
sivisty	Active
kumosi	Active
kannatan	Active
karmittakoon	Passive
spartalaista	None
komea	None
jyväskyläläiselle	None
vetelehdittäisiin	Passive
myöhästyvät	Active
tupasvilla	None
kuvaukset	None
keitot	None
seurataan	Passive
kuhisee	Active
juontava	Active
presidenttikaudet	None
toteutettu	Passive
tulehtuivat	Active
parhaalla	None
vallitsivat	Active
tekstille	None
romuttuivat	Active
fuditaan	Passive
rustiikan	None
nestemäisenä	None
seisoivat	Active
muistuttaisivat	Active
pelaavat	Active
ydinvastaisilta	None
nastin	None
laiskistunut	Active
vähemmistöhallitukseen	None
liikenneväylät	None
stressaudun	Active
pyhäköt	None
kaavailtiin	Passive
mitallinen	None
kärsäkäsmäisiä	None
engelmanninkuuseksi	None
peitetty	Passive
vanhentuvat	Active
irrottavat	Active
tarvinnee	Active
kysele	Active
painautuu	Active
puhelinkeskukset	None
yhdistettäköön	Passive
liikenneonnettomuuteen	None
vääntöön	None
piinasivat	Active
velo	Active
hyökätty	Passive
suositti	Active
mellakoisit	Active
suorittaisi	Active
anastaa	Active
sisennetty	Passive
juohdutte	Active
harkittava	Passive
entisöity	Passive
maailmanmestaruuskilpailut	None
homotsygoottina	None
vuosikertomuksessa	None
varasi	Active
rungoissa	None
tšekkoslovakialaisten	None
hypähtelen	Active
piilolinssien	None
ravinnon	None
hömppää	None
rusetit	None
kasvatettava	Passive
monimuotoistunee	Active
pumpattu	Passive
rinteet	None
yhtenäistyi	Active
luokiteltava	Passive
vartioitiin	Passive
vastakkainasettelussa	None
ohittavat	Active
välitettävä	Passive
koherentin	None
vastusti	Active
eli	Active
levittää	Active
tyhjensivät	Active
kaadutaan	Passive
todettiin	Passive
kokeva	Active
kivestit	Active
kärsien	None
hitsattakoon	Passive
murskattu	Passive
urkurin	None
moittinut	Active
puskuttaisimme	Active
mutkistakoon	Active
harjoitettiin	Passive
tiukennettiin	Passive
pelastettiin	Passive
kaivelee	Active
tyydytä	Active
luotti	Active
irvailisimme	Active
yhteisölliset	None
vasempaan	None
mutkistaa	Active
vaurioitunut	Active
retuutettu	Passive
alettiin	Passive
stipendin	None
syön	Active
soitetaan	Passive
urheilijaa	None
tarkastellut	Active
atomiytimissä	None
sairastuu	Active
huokaista	None
panimoissa	None
makeutettu	Passive
lapa	Active
huoltanut	Active
eksyy	Active
kiristetään	Passive
sotkuun	None
joudutti	Active
tukista	Active
binomijakauman	None
maalintekijä	None
salpaava	Active
aavikoitunut	Active
johtuva	Active
torjuva	Active
haukuttiin	Passive
etsivä	Active
liruimme	Active
ajatelmia	None
hirvennen	Active
kiteydy	Active
viittaisi	Active
idättävät	Active
hankaloittanut	Active
hävitettäisiin	Passive
veroton	None
kärhämöikäämme	Active
aaltoili	Active
kuppikakuksi	None
konekivääristä	None
kirjokansi	None
palvelinta	None
osseetteja	None
kurki	Active
katkeroitui	Active
differentoikaa	Active
muuttuivat	Active
virtuaalista	None
istutusten	None
syntymättömän	None
keksintöjen	None
valikoidut	Active
pysäyttele	Active
jäänteenä	None
käräjäoikeudella	None
putkimainen	None
säätyvaltiopäivillä	None
potentiaaliseksi	None
kuljin	Active
meikistä	None
jauhoivat	Active
hymyilevät	Active
kammo	Active
kohotettu	Passive
innoitatte	Active
ratkeaisi	Active
kirjailtu	Passive
alttarille	None
voimistava	Active
torkuttiin	Passive
omistautuivat	Active
kipertyvät	Active
palatkaa	Active
arkonteista	None
pulahtanevat	Active
tutkittaisiin	Passive
kykeni	Active
vahvennettava	Passive
johdattelee	Active
eräänlaiseksi	None
osallistuisi	Active
verovapaalla	None
kohdistivat	Active
emiirinä	None
ritarikunnalta	None
rotuhygienian	None
kiskaisee	Active
puraissee	Active
mahakelkkailijalta	None
sukellettakoon	Passive
koodaava	Active
toivotan	Active
puristaa	Active
lieventynyt	Active
teloitettu	Passive
vierastaa	Active
uskalsi	Active
työntyvä	Active
kiteytetty	Passive
virun	Active
saalisti	Active
tykkään	Active
lehmät	None
huomioiva	Active
kuurnitkoot	Active
säästetään	Passive
organisoidaan	Passive
eskaloitui	Active
lääkärintarkastuksessa	None
pohdiskelevat	Active
lipaisevat	Active
mustaan	Active
observoitu	Passive
valkokaulusrikollisuuksista	None
pidätti	Active
nielaisee	Active
konferenssista	None
pentagrammi	None
muotoutuu	Active
kerrytti	Active
kilpailutettiin	Passive
absoluuttisella	None
seosti	Active
alumiiniklorideiksi	None
johdantoja	None
suuntaan	Active
jääkäreiksi	None
maitokaupoin	None
haaroittuva	Active
kaukaloina	None
kiinteinä	None
gingiviiteille	None
kolmivaihejännitteistä	None
syyttömässä	None
pilannut	Active
tukahdutettu	Passive
kutevaksi	None
naurahtelisin	Active
siunaisit	Active
hallinnolle	None
aura-autolta	None
ostosten	None
vetänyt	Active
hahmottanen	Active
haavanlehdillä	None
mekanismin	None
adoptiolasta	None
ammottava	Active
ristennen	Active
suudellut	Active
leijailee	Active
purkaantui	Active
jäsentykää	Active
androidilla	None
miehitetty	Passive
kalastivat	Active
ällistynyt	Active
vaikeita	None
raottaa	Active
hurmaan	Active
roikottaa	Active
vakinaista	Active
pohjautuu	Active
suonen	Active
ratsasi	Active
seestit	Active
sijoita	Active
kulkevat	Active
haavoitettu	Passive
lentäisivät	Active
seuraava	Active
kerennyt	Active
kelasta	Active
häiriintynyt	Active
vakiintunut	Active
teurastaa	Active
ilmiantoi	Active
yhdistäkää	Active
tuomitsivat	Active
testannut	Active
ehkäistytty	Passive
styreeni	None
vääpeli	None
noudatin	Active
kiinnittivät	Active
löivät	Active
jylhistyi	Active
päämiehestä	None
kokonaiskustannuksilla	None
äyskäisevä	Active
suuseksin	None
oudoksuttaa	Active
kylmäveriseltä	None
tasaava	Active
keräillyt	Active
trendien	None
liikahdelkoon	Active
arvaisi	Active
värväytyivät	Active
edetään	Passive
syöttänyt	Active
täyttyisivät	Active
herkkeni	Active
suojaisi	Active
rakensivat	Active
räjäytysten	None
lekoteltaisiin	Passive
virkavaltaistaisitte	Active
soitellen	Active
sekaantuivat	Active
söisi	Active
langetettiin	Passive
joutaa	Active
lukittu	Passive
filosofiasta	None
tuhoaisi	Active
proletarisoikaa	Active
turpiini	None
syrjäyttäisi	Active
sumutetaan	Passive
lyövä	Active
huonontuivat	Active
rusikoisi	Active
häiritsevät	Active
rockilta	None
kumpuja	None
edo	Active
suhteelliseen	None
säikeitä	None
lukemasta	None
pystytettävä	Passive
tarkastelevat	Active
mullisti	Active
rikkoutuivat	Active
punoi	Active
kopahda	Active
loppuisivat	Active
koskettanut	Active
tukahdutettiin	Passive
käväistäköön	Passive
kiipeää	Active
lumottu	Passive
luokittelun	None
sinkoaa	Active
joglykaamihapossa	None
ammus	None
harrastava	Active
syyttänyt	Active
vesivessoiksi	None
vapautunut	Active
toimielimet	None
kestä	Active
juonipaljastusten	None
voitaneen	Passive
ihmisalkiosta	None
molekyylimassa	None
kumoutui	Active
muotoilut	None
oleskellut	Active
hyödy	Active
kohdistuit	Active
pukeutunut	Active
laihennut	Active
oikolukisivat	Active
suostuttelivat	Active
seurustelevat	Active
ennusti	Active
selittyvät	Active
torpedoinut	Active
pikeä	Active
kierrellen	Active
vuotaa	Active
koostuivat	Active
varastoitiin	Passive
selkiyttäisi	Active
venyttää	Active
virkavaltaistettaneen	Passive
induktiossa	None
pakattiin	Passive
jousiorkesteria	None
liikehti	Active
ihastuivat	Active
viilenivät	Active
tarkoitettiin	Passive
laskeutuisi	Active
