dételé	None
gambadant	None
estimerez	Second person Plural
endommaigions	First person Plural
affenerions	First person Plural
retentirent	Third person Plural
paillas	Second person Singular
dissuaderait	Third person Singular
vidangé	None
crapoter	None
codera	Third person Singular
orthographier	None
nécessitaient	Third person Plural
ébrancher	None
démembrer	None
autocorrigeât	Third person Singular
riposterons	First person Plural
placotât	Third person Singular
versait	Third person Singular
planterait	Third person Singular
assurerai	First person Singular
déshydrateraient	Third person Plural
brimé	None
réuniraient	Third person Plural
anticipèrent	Third person Plural
défibrilla	Third person Singular
incommoder	None
propulsaient	Third person Plural
tot	Third person Singular
détiendra	Third person Singular
plébiscita	Third person Singular
donneront	Third person Plural
galocherez	Second person Plural
adaptera	Third person Singular
pourfendre	None
soudé	None
butèrent	Third person Plural
côtoieront	Third person Plural
jaillissaient	Third person Plural
simulaient	Third person Plural
médiatisant	None
accepta	Third person Singular
oscillait	Third person Singular
gruger	None
subjuguas	Second person Singular
dura	Third person Singular
marabouterai	First person Singular
poissant	None
gela	Third person Singular
pourchassaient	Third person Plural
saborderaient	Third person Plural
evacuer	None
affairer	None
développait	Third person Singular
agenouillaient	Third person Plural
banquant	None
réussirent	Third person Plural
dégriffa	Third person Singular
transitant	None
voltigeas	Second person Singular
marchandâtes	Second person Plural
toléra	Third person Singular
baratta	Third person Singular
arrivât	Third person Singular
rêvassé	None
échangeaient	Third person Plural
espié	None
débequetant	None
déflagrera	Third person Singular
alliait	Third person Singular
rediscuter	None
consistèrent	Third person Plural
flamber	None
waita	Third person Singular
cercherent	Third person Plural
cuira	Third person Singular
désista	Third person Singular
présentèrent	Third person Plural
protégèrent	Third person Plural
obligera	Third person Singular
indiquasse	First person Singular
aiguisé	None
allongeait	Third person Singular
excèderait	Third person Singular
hantaient	Third person Plural
toqué	None
déversait	Third person Singular
commanderai	First person Singular
apprêtaient	Third person Plural
préludé	None
désensableraient	Third person Plural
fascinaient	Third person Plural
ébauchait	Third person Singular
serras	Second person Singular
pardonnera	Third person Singular
boitillâtes	Second person Plural
autoanalyser	None
translata	Third person Singular
transcenderait	Third person Singular
adapta	Third person Singular
dépoussiéré	None
approvisionnait	Third person Singular
règlementant	None
tinté	None
pourrira	Third person Singular
destornerai	First person Singular
defina	Third person Singular
expulsèrent	Third person Plural
révélèrent	Third person Plural
souffrit	Third person Singular
retoucha	Third person Singular
concourir	None
triompha	Third person Singular
commémorerait	Third person Singular
centralisait	Third person Singular
reconquirent	Third person Plural
embrassait	Third person Singular
hériterait	Third person Singular
décima	Third person Singular
déplaçait	Third person Singular
acclama	Third person Singular
acouplant	None
remonter	None
filtrassiez	Second person Plural
concurrencerait	Third person Singular
abreuvaient	Third person Plural
renoncer	None
essait	Third person Singular
violant	None
ballonné	None
bouda	Third person Singular
promulguant	None
engraissait	Third person Singular
feras	Second person Singular
présideront	Third person Plural
poqueras	Second person Singular
câblé	None
attribuaient	Third person Plural
exonérâtes	Second person Plural
électrifia	Third person Singular
goudronné	None
instauraient	Third person Plural
implémenta	Third person Singular
contiendrait	Third person Singular
ouvert	None
visualisé	None
éjectas	Second person Singular
décapuchonné	None
favorisa	Third person Singular
placardisait	Third person Singular
raccompagnait	Third person Singular
grenadé	None
déifié	None
coniuré	None
variait	Third person Singular
identifièrent	Third person Plural
astreignîtes	Second person Plural
empoirié	None
subissait	Third person Singular
plongeait	Third person Singular
reliera	Third person Singular
structureront	Third person Plural
affirmeraient	Third person Plural
grogneras	Second person Singular
répercutaient	Third person Plural
réjouissaient	Third person Plural
éviteront	Third person Plural
désagrégea	Third person Singular
faudrait	Third person Singular
sujurneroie	First person Singular
détaxé	None
contrariaient	Third person Plural
définirait	Third person Singular
revendait	Third person Singular
coud	Third person Singular
administrera	Third person Singular
créditassent	Third person Plural
champignonner	None
contrebattrai	First person Singular
finalisé	None
approcheraient	Third person Plural
dressa	Third person Singular
rétréci	None
tomatai	First person Singular
expulsait	Third person Singular
auraient	Third person Plural
révèlera	Third person Singular
embêtait	Third person Singular
rechignaient	Third person Plural
duras	Second person Singular
delaissant	None
renforcera	Third person Singular
repoussaient	Third person Plural
décaler	None
navré	None
rampassions	First person Plural
colperoie	First person Singular
considéra	Third person Singular
larmoyer	None
chargeaient	Third person Plural
guida	Third person Singular
provera	Third person Singular
élimineront	Third person Plural
crooné	None
décala	Third person Singular
détester	None
hériteront	Third person Plural
conférât	Third person Singular
grouillaient	Third person Plural
râclant	None
établiraient	Third person Plural
rebondissant	None
bénéficié	None
minerait	Third person Singular
éparpillera	Third person Singular
repassera	Third person Singular
continueraient	Third person Plural
pariaient	Third person Plural
pleurerai	First person Singular
spécialiseront	Third person Plural
rejoignait	Third person Singular
cotisèrent	Third person Plural
gouverné	None
taillant	None
déclenchèrent	Third person Plural
tentât	Third person Singular
récompensé	None
succederent	Third person Plural
coexistait	Third person Singular
couva	Third person Singular
extrudé	None
entreveant	None
moula	Third person Singular
rotter	None
gaba	Third person Singular
flambait	Third person Singular
déculpabiliserez	Second person Plural
coltiner	None
déconcentrerait	Third person Singular
rajoutaient	Third person Plural
curt	Third person Singular
abaisserait	Third person Singular
coper	None
semblerait	Third person Singular
suives	Second person Singular
expliciter	None
éliminaient	Third person Plural
entreposa	Third person Singular
entortillé	None
affronteraient	Third person Plural
rehaussait	Third person Singular
expira	Third person Singular
faciliterait	Third person Singular
dégénérant	None
empressaient	Third person Plural
négociait	Third person Singular
irait	Third person Singular
candidateriez	Second person Plural
réitèrera	Third person Singular
manias	Second person Singular
perpétué	None
chelas	Second person Singular
exonérait	Third person Singular
prévoira	Third person Singular
tuerez	Second person Plural
voudroit	Third person Singular
circulerait	Third person Singular
goutas	Second person Singular
souhaiterions	First person Plural
politisant	None
interviendraient	Third person Plural
squattait	Third person Singular
dénoncerai	First person Singular
arisas	Second person Singular
rachetaient	Third person Plural
découragèrent	Third person Plural
consumer	None
souscrivirent	Third person Plural
normalisa	Third person Singular
jeûnera	Third person Singular
exclura	Third person Singular
herbergeriiens	First person Plural
explora	Third person Singular
couvoitant	None
réaffecta	Third person Singular
descendrai	First person Singular
refert	Third person Singular
ribota	Third person Singular
baignassiez	Second person Plural
entraineront	Third person Plural
projettera	Third person Singular
signaleront	Third person Plural
promettrait	Third person Singular
géras	Second person Singular
transiteront	Third person Plural
abriterait	Third person Singular
modula	Third person Singular
embrasserait	Third person Singular
engloutirent	Third person Plural
rassemblèrent	Third person Plural
espiassiez	Second person Plural
imitera	Third person Singular
perdrait	Third person Singular
bancha	Third person Singular
raccourcissant	None
aigrant	None
préviendra	Third person Singular
adulé	None
récidiverait	Third person Singular
guincher	None
motivera	Third person Singular
hachant	None
soutinrent	Third person Plural
travaillèrent	Third person Plural
rassura	Third person Singular
alangui	None
soumettre	None
ravina	Third person Singular
parcoururent	Third person Plural
choisirons	First person Plural
intervertir	None
encorder	None
pénalisait	Third person Singular
évaluerait	Third person Singular
découlèrent	Third person Plural
entretiendraient	Third person Plural
contraignit	Third person Singular
dételait	Third person Singular
perlé	None
penchaient	Third person Plural
coiffait	Third person Singular
perdit	Third person Singular
arrachaient	Third person Plural
réactualiser	None
maîtrisa	Third person Singular
décrivaient	Third person Plural
munissait	Third person Singular
emmêla	Third person Singular
remédiant	None
cahoterons	First person Plural
purgea	Third person Singular
transposera	Third person Singular
embarquait	Third person Singular
carbonisé	None
emportera	Third person Singular
irisa	Third person Singular
vouera	Third person Singular
annonçaient	Third person Plural
signifièrent	Third person Plural
servir	None
fonctionné	None
déchanter	None
éteignirent	Third person Plural
nuirait	Third person Singular
maigrirai	First person Singular
utilisèrent	Third person Plural
forclosant	None
incrusté	None
empruntaient	Third person Plural
heurterait	Third person Singular
désapprouvèrent	Third person Plural
faignes	Second person Singular
flageolé	None
parangoner	None
enragea	Third person Singular
réagiront	Third person Plural
désappointassions	First person Plural
ensanglenter	None
réfléchira	Third person Singular
équipait	Third person Singular
numa	Third person Singular
mendiait	Third person Singular
lysait	Third person Singular
postillonnerait	Third person Singular
prêté	None
étonnerai	First person Singular
rosi	None
bénissaient	Third person Plural
jouxtas	Second person Singular
arrangèrent	Third person Plural
foulait	Third person Singular
concocta	Third person Singular
récupèrera	Third person Singular
enjambait	Third person Singular
affilia	Third person Singular
indemnisera	Third person Singular
maquilleras	Second person Singular
recueillerait	Third person Singular
peinturant	None
galéré	None
perdît	Third person Singular
collerait	Third person Singular
reverras	Second person Singular
levas	Second person Singular
déshabillant	None
mulota	Third person Singular
dissimulerai	First person Singular
apprécierez	Second person Plural
dénoncèrent	Third person Plural
parodiera	Third person Singular
entreverront	Third person Plural
boycottait	Third person Singular
ressuieroient	Third person Plural
escalada	Third person Singular
traita	Third person Singular
tissèrent	Third person Plural
présumer	None
pivota	Third person Singular
enregistra	Third person Singular
dépeuplait	Third person Singular
vaudraient	Third person Plural
constitueraient	Third person Plural
taclâtes	Second person Plural
émanera	Third person Singular
renter	None
colonisèrent	Third person Plural
consentît	Third person Singular
enquestant	None
criminalisant	None
égermassent	Third person Plural
cunquerant	None
cirai	First person Singular
retiendrons	First person Plural
tançoient	Third person Plural
traduiraient	Third person Plural
claira	Third person Singular
héliporté	None
dormaient	Third person Plural
passionné	None
peaufinera	Third person Singular
foler	None
amnistié	None
réchauffait	Third person Singular
répara	Third person Singular
délocalisant	None
prélassant	None
souhaitèrent	Third person Plural
traversèrent	Third person Plural
régiront	Third person Plural
agrandirent	Third person Plural
garder	None
romancé	None
contrepoisoient	Third person Plural
succombèrent	Third person Plural
hez	Second person Singular
livrerait	Third person Singular
contourneraient	Third person Plural
renâcler	None
détectèrent	Third person Plural
réfutait	Third person Singular
représenté	None
publiaient	Third person Plural
méconnaître	None
cunreastes	Second person Plural
bivouaqué	None
lèverai	First person Singular
suffiraient	Third person Plural
menant	None
reregardai	First person Singular
unifiera	Third person Singular
prédisposé	None
retransférer	None
jetaient	Third person Plural
éloignaient	Third person Plural
précipitera	Third person Singular
délivrerait	Third person Singular
éloigneraient	Third person Plural
retomba	Third person Singular
parviendrez	Second person Plural
dispensera	Third person Singular
explicqué	None
asserchast	Third person Singular
arriveraient	Third person Plural
appareillèrent	Third person Plural
inciteraient	Third person Plural
déguisa	Third person Singular
engranger	None
étudier	None
divergea	Third person Singular
désexcitait	Third person Singular
avançait	Third person Singular
affûteraient	Third person Plural
clamèrent	Third person Plural
sassa	Third person Singular
ripaillé	None
prédéfini	None
empressait	Third person Singular
regagnèrent	Third person Plural
aventurerait	Third person Singular
avisant	None
pâtisser	None
trouvé	None
demeura	Third person Singular
articulait	Third person Singular
consulteraient	Third person Plural
inactivant	None
aima	Third person Singular
supprimerons	First person Plural
respiraient	Third person Plural
alpaguer	None
escauferas	Second person Singular
considerer	None
pâti	None
félicita	Third person Singular
chahutant	None
fussiez	Second person Plural
jectant	None
yodleront	Third person Plural
doigté	None
réexprimé	None
composeraient	Third person Plural
nuira	Third person Singular
campa	Third person Singular
parlèrent	Third person Plural
escheïstes	Second person Plural
édifieront	Third person Plural
insistèrent	Third person Plural
desplacé	None
culé	None
conféré	None
opérer	None
géraient	Third person Plural
divertissaient	Third person Plural
ruiné	None
bulleras	Second person Singular
restaurait	Third person Singular
supprimé	None
concentrera	Third person Singular
enregistrera	Third person Singular
tressaillant	None
dénoncerait	Third person Singular
prétendit	Third person Singular
plantassiez	Second person Plural
rayonner	None
polychromé	None
revendiquait	Third person Singular
empochait	Third person Singular
œdipianisant	None
surina	Third person Singular
offriraient	Third person Plural
inondait	Third person Singular
remercia	Third person Singular
circulait	Third person Singular
éliminerait	Third person Singular
façonnera	Third person Singular
transportant	None
tardait	Third person Singular
défendît	Third person Singular
recadré	None
inviterai	First person Singular
pourvoit	Third person Singular
hésiterai	First person Singular
acculé	None
arbitrassiez	Second person Plural
bourgeonnant	None
distrayait	Third person Singular
régentassiez	Second person Plural
pétitionnèrent	Third person Plural
séquestré	None
houé	None
apostropha	Third person Singular
fredonnait	Third person Singular
secouera	Third person Singular
maçonnas	Second person Singular
numérotant	None
transmettront	Third person Plural
blackbouleras	Second person Singular
s’écriait	Third person Singular
laminé	None
rogner	None
sollicitait	Third person Singular
refusé	None
débattaient	Third person Plural
givrerions	First person Plural
ronronnasse	First person Singular
écrivant	None
tapotaient	Third person Plural
enthousiasmèrent	Third person Plural
finalisa	Third person Singular
clairerons	First person Plural
musse	First person Singular
remédié	None
vivaient	Third person Plural
rejoué	None
dénatté	None
polyploïdiserait	Third person Singular
contesteront	Third person Plural
soignerait	Third person Singular
motorisant	None
vissât	Third person Singular
sillonnaient	Third person Plural
inhibait	Third person Singular
tâchera	Third person Singular
confondra	Third person Singular
pilant	None
politiserait	Third person Singular
réservèrent	Third person Plural
caressait	Third person Singular
crevasses	Second person Singular
abrias	Second person Singular
augmenta	Third person Singular
devança	Third person Singular
réutilisa	Third person Singular
dévalait	Third person Singular
subjugua	Third person Singular
lâcherait	Third person Singular
subsistant	None
mutina	Third person Singular
détournèrent	Third person Plural
disjoncter	None
turlupiné	None
servaient	Third person Plural
retardant	None
perdura	Third person Singular
affaibliront	Third person Plural
poursuivît	Third person Singular
équipant	None
tintas	Second person Singular
dessiller	None
préempterait	Third person Singular
contrariera	Third person Singular
inventorier	None
procèderai	First person Singular
hivernaient	Third person Plural
décharnasses	Second person Singular
demander	None
bavé	None
heurteriez	Second person Plural
soulèveraient	Third person Plural
prendrai	First person Singular
radiotélégraphiant	None
éparpilla	Third person Singular
tans	Second person Singular
contra	Third person Singular
cauterisissoiz	Second person Plural
enverrai	First person Singular
proposèrent	Third person Plural
creuseront	Third person Plural
perçant	None
culminant	None
merder	None
gazéifiant	None
considérât	Third person Singular
opacifiant	None
puet	Third person Singular
accommodait	Third person Singular
cancaneront	Third person Plural
élevant	None
aises	Second person Singular
collecta	Third person Singular
enfonçaient	Third person Plural
caracoler	None
ariveriiez	Second person Plural
terras	Second person Singular
surinterprétâmes	First person Plural
bromé	None
appellé	None
observerez	Second person Plural
enchaînèrent	Third person Plural
chuterait	Third person Singular
retordu	None
éculerions	First person Plural
boiser	None
doutait	Third person Singular
témoignant	None
guérissaient	Third person Plural
tuerons	First person Plural
obtiendront	Third person Plural
chela	Third person Singular
comparant	None
resplendissant	None
adorai	First person Singular
cotai	First person Singular
connectasse	First person Singular
descendrons	First person Plural
tronquant	None
opiner	None
solda	Third person Singular
gavant	None
héritait	Third person Singular
sarcler	None
ajouteras	Second person Singular
concevrait	Third person Singular
parier	None
berné	None
atténuera	Third person Singular
glanant	None
clore	None
enserraient	Third person Plural
emballé	None
interprétèrent	Third person Plural
installeraient	Third person Plural
rencontra	Third person Singular
escroquant	None
fricassasse	First person Singular
parjuré	None
garroter	None
timbrer	None
essaya	Third person Singular
délivrèrent	Third person Plural
enfila	Third person Singular
confronteront	Third person Plural
sons	Second person Singular
redescendait	Third person Singular
vengeait	Third person Singular
conduisirent	Third person Plural
bayé	None
entreprendrait	Third person Singular
dessalerez	Second person Plural
insurgeait	Third person Singular
répertoriant	None
celebrant	None
torent	Third person Plural
leurraient	Third person Plural
encroûterons	First person Plural
occlure	None
adressaient	Third person Plural
actualisera	Third person Singular
reproduisit	Third person Singular
saignant	None
désignant	None
transmua	Third person Singular
évaluassions	First person Plural
escomptait	Third person Singular
stagnaient	Third person Plural
remercierai	First person Singular
débattre	None
quittait	Third person Singular
permettrait	Third person Singular
mommiiez	Second person Plural
désacraliser	None
rapprocher	None
réhydraté	None
engluer	None
consisteront	Third person Plural
dénucléarisant	None
mentionneront	Third person Plural
scolarisât	Third person Singular
ravitaillèrent	Third person Plural
rallia	Third person Singular
ressouviendrez	Second person Plural
revanchaient	Third person Plural
proférait	Third person Singular
aimeront	Third person Plural
étonnerait	Third person Singular
condensé	None
diminueraient	Third person Plural
treta	Third person Singular
suit	Third person Singular
désamiantasses	Second person Singular
expulser	None
renverrai	First person Singular
descendant	None
gerbera	Third person Singular
augmenteraient	Third person Plural
nonmoient	Third person Plural
concentraient	Third person Plural
copulé	None
affecteraient	Third person Plural
protégeaient	Third person Plural
fragilisant	None
attirerait	Third person Singular
baserait	Third person Singular
supprimerez	Second person Plural
hydrogéner	None
relieront	Third person Plural
boulas	Second person Singular
déplaceront	Third person Plural
détenant	None
multipliaient	Third person Plural
redundé	None
crispé	None
leurrer	None
déduisant	None
conspira	Third person Singular
menuisèrent	Third person Plural
attribuait	Third person Singular
piéger	None
refaisaient	Third person Plural
regna	Third person Singular
acuinteroiz	Second person Plural
modernisait	Third person Singular
matant	None
exposera	Third person Singular
munz	Second person Singular
redeviendrez	Second person Plural
dribblerai	First person Singular
pélerinant	None
tumbassions	First person Plural
trancherait	Third person Singular
réutiliser	None
bousculé	None
pourrissant	None
alai	First person Singular
coïncidant	None
lapidait	Third person Singular
inviteront	Third person Plural
accorer	None
entourait	Third person Singular
apostasia	Third person Singular
brillant	None
hésitait	Third person Singular
trombona	Third person Singular
blâmer	None
adressait	Third person Singular
protegé	None
émigra	Third person Singular
agenouillait	Third person Singular
assimilaient	Third person Plural
récitera	Third person Singular
exclama	Third person Singular
conférer	None
pratiqua	Third person Singular
envoyait	Third person Singular
occuperait	Third person Singular
éloignait	Third person Singular
manquaient	Third person Plural
empoirier	None
reformas	Second person Singular
ouata	Third person Singular
inféoda	Third person Singular
attenant	None
désaveuglant	None
rincé	None
allumèrent	Third person Plural
critiqué	None
aboler	None
déportait	Third person Singular
mutilait	Third person Singular
cailleta	Third person Singular
recouvrirait	Third person Singular
remarquait	Third person Singular
braqué	None
atténueront	Third person Plural
zézayant	None
approvisionnaient	Third person Plural
tuerait	Third person Singular
délestassent	Third person Plural
atterrant	None
totalisé	None
honnir	None
survolèrent	Third person Plural
dînait	Third person Singular
reprendrez	Second person Plural
attendras	Second person Singular
diviser	None
diffusera	Third person Singular
uroit	Third person Singular
découdre	None
commuer	None
haleter	None
résidaient	Third person Plural
prendrons	First person Plural
opéra	Third person Singular
déplaira	Third person Singular
compter	None
planifiaient	Third person Plural
relater	None
étêter	None
défausser	None
retraitant	None
chûtes	Second person Plural
chancelé	None
encercheroies	Second person Singular
acquiescer	None
espéraient	Third person Plural
acculturé	None
abîmer	None
écumé	None
décroître	None
gèreront	Third person Plural
défigurait	Third person Singular
figurait	Third person Singular
internas	Second person Singular
prévaudra	Third person Singular
préparer	None
prémunissant	None
opteraient	Third person Plural
alimentait	Third person Singular
dérapait	Third person Singular
rétrocéda	Third person Singular
cavaler	None
santes	Second person Singular
imposèrent	Third person Plural
esricheriiens	First person Plural
reploré	None
aquerant	None
délié	None
enduisant	None
entacher	None
dirigea	Third person Singular
nierait	Third person Singular
résonnera	Third person Singular
retourneraient	Third person Plural
chevasse	First person Singular
provoqua	Third person Singular
aventurait	Third person Singular
candi	None
campas	Second person Singular
accorderont	Third person Plural
foisonner	None
retisser	None
explicita	Third person Singular
acroistront	Third person Plural
fleurissait	Third person Singular
naitrait	Third person Singular
désillusionné	None
avortera	Third person Singular
déneigeant	None
préservait	Third person Singular
ému	None
meritant	None
réexaminer	None
esbauchoit	Third person Singular
répertorieriez	Second person Plural
cosu	None
confirmerait	Third person Singular
arborant	None
éborgnâmes	First person Plural
entrouvrît	Third person Singular
varieraient	Third person Plural
abusa	Third person Singular
complaira	Third person Singular
assourdi	None
regarderont	Third person Plural
activeront	Third person Plural
babit	Third person Singular
consolidant	None
rassembleraient	Third person Plural
rendes	Second person Singular
canarder	None
réclamer	None
péchaient	Third person Plural
appartiendraient	Third person Plural
bres	Second person Singular
pénétrant	None
italianiseras	Second person Singular
gelai	First person Singular
relayé	None
régirait	Third person Singular
reconnaitraient	Third person Plural
excommuniait	Third person Singular
endormant	None
étriqué	None
cotèrent	Third person Plural
dallassent	Third person Plural
éprouvait	Third person Singular
reposât	Third person Singular
déplié	None
exploiteront	Third person Plural
adapteront	Third person Plural
rétamant	None
externaliseraient	Third person Plural
trahiront	Third person Plural
amorça	Third person Singular
figuraient	Third person Plural
magna	Third person Singular
primait	Third person Singular
exhala	Third person Singular
composta	Third person Singular
débarbouillasses	Second person Singular
guiderait	Third person Singular
spécifier	None
hiérarchisâtes	Second person Plural
dialoguer	None
profiterait	Third person Singular
préluda	Third person Singular
manquerait	Third person Singular
réintégrèrent	Third person Plural
deviendra	Third person Singular
secoué	None
valu	Third person Singular
risquerait	Third person Singular
zozotas	Second person Singular
rasa	Third person Singular
décomptant	None
assurât	Third person Singular
concrétiserait	Third person Singular
ausculta	Third person Singular
rencontrèrent	Third person Plural
orienta	Third person Singular
polyestérifié	None
aggraverait	Third person Singular
pivoté	None
gamberger	None
débottâtes	Second person Plural
marias	Second person Singular
piétinaient	Third person Plural
subiuguassiez	Second person Plural
atomisé	None
rosissant	None
hala	Third person Singular
durcissait	Third person Singular
jousai	First person Singular
pressait	Third person Singular
achèteraient	Third person Plural
blablater	None
marchandé	None
effritait	Third person Singular
viola	Third person Singular
canadianisassiez	Second person Plural
accrut	Third person Singular
râblé	None
détenait	Third person Singular
ingérait	Third person Singular
entérina	Third person Singular
descontinua	Third person Singular
interrompirent	Third person Plural
sacrifiaient	Third person Plural
ensanglantant	None
garnissaient	Third person Plural
prénommaient	Third person Plural
captèrent	Third person Plural
acoardissant	None
satisfit	Third person Singular
moucheté	None
préconisaient	Third person Plural
ferrasse	First person Singular
justifiaient	Third person Plural
terra	Third person Singular
retournera	Third person Singular
seviiez	Second person Plural
plissera	Third person Singular
picolé	None
épuisèrent	Third person Plural
maraudai	First person Singular
parfaire	None
interjeta	Third person Singular
débarquera	Third person Singular
classaient	Third person Plural
reculera	Third person Singular
détruirons	First person Plural
coururent	Third person Plural
emménageront	Third person Plural
héla	Third person Singular
déverrouilla	Third person Singular
rampé	None
façonnait	Third person Singular
décernait	Third person Singular
débrouillant	None
présageaient	Third person Plural
osaient	Third person Plural
appréciant	None
intervînt	Third person Singular
mura	Third person Singular
compromettait	Third person Singular
confond	Third person Singular
vrillant	None
grossi	None
lessivé	None
impressionnâtes	Second person Plural
pistas	Second person Singular
baptizerai	First person Singular
sélectionneront	Third person Plural
favorisera	Third person Singular
réservé	None
chargerait	Third person Singular
ravira	Third person Singular
dérangera	Third person Singular
alunissaient	Third person Plural
pailla	Third person Singular
restructurer	None
résoudront	Third person Plural
affleurant	None
boutonnâtes	Second person Plural
transitera	Third person Singular
ériflait	Third person Singular
exigera	Third person Singular
tranquillisé	None
triturer	None
leireit	Third person Singular
écourté	None
reconvertirent	Third person Plural
sachons	First person Plural
amadoué	None
supposerons	First person Plural
terrer	None
graantassent	Third person Plural
différant	None
collasse	First person Singular
réunifia	Third person Singular
nuisîtes	Second person Plural
épaulé	None
pendit	Third person Singular
risquerai	First person Singular
parlerai	First person Singular
régentant	None
supprimerait	Third person Singular
brayant	None
daubas	Second person Singular
remaniassions	First person Plural
pollué	None
sonnaient	Third person Plural
cariant	None
assevent	Third person Plural
monda	Third person Singular
dissuadant	None
survives	Second person Singular
naviguer	None
enrichissant	None
mériteront	Third person Plural
abdiquait	Third person Singular
prônait	Third person Singular
coordonnait	Third person Singular
foutaient	Third person Plural
fabriquera	Third person Singular
attriqua	Third person Singular
enfermera	Third person Singular
immolant	None
convieriez	Second person Plural
rentrât	Third person Singular
poindre	None
réutilisèrent	Third person Plural
amusait	Third person Singular
esricher	None
critiquèrent	Third person Plural
définiraient	Third person Plural
indexer	None
émergeaient	Third person Plural
stagnai	First person Singular
maximisant	None
encommencé	None
creusant	None
obligea	Third person Singular
infantilisant	None
soucieriez	Second person Plural
approfondi	None
déduisit	Third person Singular
rembourrerez	Second person Plural
frangeassiez	Second person Plural
surmontèrent	Third person Plural
devancer	None
recommander	None
grugerez	Second person Plural
gazouiller	None
concoctaient	Third person Plural
suivras	Second person Singular
resigna	Third person Singular
meurtri	None
escha	Third person Singular
florir	None
décarcasser	None
attardaient	Third person Plural
rouvrira	Third person Singular
contrefait	Third person Singular
amené	None
enseignait	Third person Singular
aimeraient	Third person Plural
émancipa	Third person Singular
confirmait	Third person Singular
étayeraient	Third person Plural
flirta	Third person Singular
bouleverserons	First person Plural
décrochèrent	Third person Plural
crachotera	Third person Singular
enchainer	None
transpercera	Third person Singular
rejaillit	Third person Singular
ajouteront	Third person Plural
apprendrons	First person Plural
livreriez	Second person Plural
projetèrent	Third person Plural
réjouissait	Third person Singular
faiblira	Third person Singular
soulignèrent	Third person Plural
alléguant	None
fêlassiez	Second person Plural
emportant	None
confondait	Third person Singular
reculerait	Third person Singular
surexcité	None
oindre	None
croûtant	None
décroit	Third person Singular
abrogeait	Third person Singular
ennuya	Third person Singular
mathématisant	None
inséraient	Third person Plural
commettront	Third person Plural
contas	Second person Singular
épargnera	Third person Singular
automesurer	None
déballé	None
variera	Third person Singular
présagé	None
dosassent	Third person Plural
asséchait	Third person Singular
ressurgirez	Second person Plural
déroutèrent	Third person Plural
licita	Third person Singular
reparla	Third person Singular
mater	None
gommant	None
inféodé	None
reformerait	Third person Singular
plâtré	None
subiront	Third person Plural
poudroyasses	Second person Singular
réquisitionnant	None
retirerai	First person Singular
rumpi	First person Singular
replierez	Second person Plural
interdiront	Third person Plural
phrasé	None
récompensaient	Third person Plural
eslancerent	Third person Plural
expliquerons	First person Plural
atranpré	None
transformaient	Third person Plural
bada	Third person Singular
alluvionnant	None
carroyer	None
fringuant	None
fêlé	None
plumé	None
objectera	Third person Singular
retomberez	Second person Plural
poursuivait	Third person Singular
argenta	Third person Singular
pocher	None
groupait	Third person Singular
coffré	None
ganter	None
sanctionner	None
souffrait	Third person Singular
doubler	None
tucheroit	Third person Singular
respecta	Third person Singular
dépossédant	None
allègerait	Third person Singular
enchanta	Third person Singular
noncié	None
escut	Third person Singular
dévoua	Third person Singular
exprimant	None
refermerait	Third person Singular
parrainera	Third person Singular
règnera	Third person Singular
réveillé	None
discréditait	Third person Singular
modifierai	First person Singular
fartassions	First person Plural
éclateront	Third person Plural
bifurqué	None
respecterait	Third person Singular
démoraliser	None
guidassiez	Second person Plural
alimentaient	Third person Plural
scandalisèrent	Third person Plural
forfaire	None
déléguèrent	Third person Plural
complotera	Third person Singular
consentait	Third person Singular
contournerait	Third person Singular
cristallisa	Third person Singular
racornirai	First person Singular
parachuter	None
dépénalisé	None
inhumait	Third person Singular
bénéficieraient	Third person Plural
retyrasses	Second person Singular
rancir	None
crypta	Third person Singular
presté	None
destinaient	Third person Plural
refirent	Third person Plural
réajusteras	Second person Singular
soutiendra	Third person Singular
prévoyait	Third person Singular
lobé	None
focaliser	None
rassemblerait	Third person Singular
relevaient	Third person Plural
rationnant	None
pousseront	Third person Plural
facturasse	First person Singular
entraidaient	Third person Plural
administrèrent	Third person Plural
solidariser	None
tentai	First person Singular
douant	None
alertait	Third person Singular
retraçait	Third person Singular
élargissant	None
biaisant	None
attaqueraient	Third person Plural
souleva	Third person Singular
compensèrent	Third person Plural
modifiaient	Third person Plural
permettrez	Second person Plural
évacueront	Third person Plural
figurer	None
préparerait	Third person Singular
huyer	None
canalisé	None
scellai	First person Singular
vu	None
abâtelaient	Third person Plural
défrichaient	Third person Plural
pétrifié	None
dégringola	Third person Singular
mella	Third person Singular
râlait	Third person Singular
forcloras	Second person Singular
rembarrer	None
étaleront	Third person Plural
enfermassent	Third person Plural
jazzer	None
revend	Third person Singular
retendissent	Third person Plural
seeler	None
séria	Third person Singular
animera	Third person Singular
relit	Third person Singular
cesserait	Third person Singular
sona	Third person Singular
gênant	None
forgé	None
dût	Third person Singular
gaufrer	None
tomberez	Second person Plural
chuté	None
galeras	Second person Singular
melancholier	None
fucka	Third person Singular
modifieront	Third person Plural
craignaient	Third person Plural
ajoutâtes	Second person Plural
migreras	Second person Singular
offrît	Third person Singular
soufflaient	Third person Plural
interpeller	None
étêterez	Second person Plural
anprisona	Third person Singular
surviendront	Third person Plural
incitaient	Third person Plural
lambrissâmes	First person Plural
guérirait	Third person Singular
fournissait	Third person Singular
suspectaient	Third person Plural
résoudra	Third person Singular
contraria	Third person Singular
dressèrent	Third person Plural
découpera	Third person Singular
heiliez	Second person Plural
sonnera	Third person Singular
subissaient	Third person Plural
démentira	Third person Singular
iniurieras	Second person Singular
rejoua	Third person Singular
graissé	None
prima	Third person Singular
remordu	None
héler	None
enrégimenté	None
recouvrir	None
éradiqua	Third person Singular
désensibilisé	None
avantageaient	Third person Plural
tripla	Third person Singular
germerons	First person Plural
formulera	Third person Singular
militera	Third person Singular
affectionnait	Third person Singular
sussent	Third person Plural
essoufflera	Third person Singular
résulterait	Third person Singular
bût	Third person Singular
exilait	Third person Singular
tâtonner	None
sollicitera	Third person Singular
voteraient	Third person Plural
recourut	Third person Singular
accomplir	None
desinfecteroit	Third person Singular
expérimenta	Third person Singular
proféré	None
impliquerait	Third person Singular
frangé	None
vengerai	First person Singular
banaliser	None
élèverai	First person Singular
prélevèrent	Third person Plural
préconiser	None
saigné	None
ganchirent	Third person Plural
abriter	None
rapprochaient	Third person Plural
aportes	Second person Singular
réduit	Third person Singular
égala	Third person Singular
exhortèrent	Third person Plural
essayaient	Third person Plural
haïr	None
schtroumpfant	None
oubliai	First person Singular
bravas	Second person Singular
tercé	None
attendrissant	None
acquérait	Third person Singular
exporta	Third person Singular
offrait	Third person Singular
voulut	Third person Singular
animait	Third person Singular
renverraient	Third person Plural
trembla	Third person Singular
fixeront	Third person Plural
translatâtes	Second person Plural
maneie	First person Singular
chantera	Third person Singular
ménageaient	Third person Plural
occultait	Third person Singular
artificialisé	None
mandater	None
apprenaient	Third person Plural
tuera	Third person Singular
attacheront	Third person Plural
lobera	Third person Singular
éviterons	First person Plural
découleraient	Third person Plural
semaient	Third person Plural
gyrant	None
aconpaignant	None
dénombrait	Third person Singular
honorât	Third person Singular
rusassiez	Second person Plural
touchait	Third person Singular
helléniser	None
illuminèrent	Third person Plural
retombèrent	Third person Plural
rompit	Third person Singular
subirait	Third person Singular
mènerait	Third person Singular
cerna	Third person Singular
surproduit	Third person Singular
neutralisa	Third person Singular
dresseront	Third person Plural
embrassera	Third person Singular
dérivera	Third person Singular
manquera	Third person Singular
moyenner	None
bretonnant	None
ora	Third person Singular
réprouver	None
caractérisait	Third person Singular
imposerait	Third person Singular
regorgerions	First person Plural
débarrassèrent	Third person Plural
allongeront	Third person Plural
visitant	None
prêteraient	Third person Plural
défièrent	Third person Plural
financeraient	Third person Plural
facilitera	Third person Singular
entretoiserons	First person Plural
partait	Third person Singular
inclurent	Third person Plural
remixer	None
généraient	Third person Plural
dédaigné	None
répliquera	Third person Singular
exclure	None
intérioriserez	Second person Plural
interviewer	None
absorbera	Third person Singular
embasmé	None
rattachait	Third person Singular
transférait	Third person Singular
dépasseront	Third person Plural
plaisantait	Third person Singular
rebattre	None
toillé	None
évangélisa	Third person Singular
coûté	None
transplanté	None
proliférant	None
regarderaient	Third person Plural
couterait	Third person Singular
past	Third person Singular
défigurant	None
rouvrit	Third person Singular
brima	Third person Singular
flottait	Third person Singular
dérouler	None
décolla	Third person Singular
noirci	None
introduisit	Third person Singular
héroïser	None
emmenèrent	Third person Plural
siroter	None
soldaient	Third person Plural
enfler	None
pondaient	Third person Plural
perdes	Second person Singular
exécutaient	Third person Plural
siégeant	None
unifierait	Third person Singular
réarrangeassions	First person Plural
rompaient	Third person Plural
floculant	None
bouillaverait	Third person Singular
persécutâmes	First person Plural
prévaloir	None
distanciât	Third person Singular
terminât	Third person Singular
équilibrait	Third person Singular
préoccupera	Third person Singular
rassurer	None
subjectivisé	None
nargueras	Second person Singular
alimentera	Third person Singular
esventé	None
traversait	Third person Singular
pintant	None
violait	Third person Singular
aigert	None
radiotélégraphias	Second person Singular
habilitaient	Third person Plural
songèrent	Third person Plural
enflammèrent	Third person Plural
innovait	Third person Singular
dinguâmes	First person Plural
rabattant	None
revitaliser	None
encagoulera	Third person Singular
solutionner	None
cohabitera	Third person Singular
iraient	Third person Plural
préfigurait	Third person Singular
remania	Third person Singular
bénéficièrent	Third person Plural
épingler	None
convinrent	Third person Plural
activer	None
redéposé	None
chaîner	None
bougerait	Third person Singular
photographiait	Third person Singular
pincer	None
badé	None
beuglant	None
éploré	None
simula	Third person Singular
cantiller	None
lut	Third person Singular
batié	Third person Singular
affuteriez	Second person Plural
encensant	None
humiliai	First person Singular
restructurerons	First person Plural
extirpa	Third person Singular
parvinrent	Third person Plural
endormait	Third person Singular
méritera	Third person Singular
désacraliseraient	Third person Plural
contrefaire	None
plaindre	None
revendiqueront	Third person Plural
sous-loua	Third person Singular
flashé	None
engueulait	Third person Singular
destituèrent	Third person Plural
moquetter	None
refuserait	Third person Singular
pissier	None
heurtaient	Third person Plural
enseignâtes	Second person Plural
sermonner	None
proposerai	First person Singular
condiciones	Second person Singular
alarma	Third person Singular
enlaidira	Third person Singular
fertiliserons	First person Plural
vivras	Second person Singular
tranquilliser	None
présenta	Third person Singular
engendreraient	Third person Plural
animalisera	Third person Singular
visant	None
zappas	Second person Singular
reprit	Third person Singular
arreté	None
rédigèrent	Third person Plural
deraisniiez	Second person Plural
retournât	Third person Singular
heurta	Third person Singular
uré	None
emprisonna	Third person Singular
hésiteraient	Third person Plural
fondâtes	Second person Plural
embarquaient	Third person Plural
dépêchèrent	Third person Plural
troqueroie	First person Singular
éperonneraient	Third person Plural
préfacé	None
négligeait	Third person Singular
retentissait	Third person Singular
côtoyassiez	Second person Plural
concourut	Third person Singular
démonta	Third person Singular
acculâtes	Second person Plural
pikes	Second person Singular
intéressait	Third person Singular
effiloqué	None
hiverna	Third person Singular
colorisé	None
décharné	None
cédé	None
disconviendront	Third person Plural
congestionné	None
fabriquant	None
animeront	Third person Plural
convertira	Third person Singular
bringuebalas	Second person Singular
nappa	Third person Singular
accablèrent	Third person Plural
cedant	None
assumerait	Third person Singular
délibéra	Third person Singular
freinaient	Third person Plural
décollaient	Third person Plural
transformeront	Third person Plural
descunseilleroiz	Second person Plural
régressant	None
agrandir	None
enivrait	Third person Singular
battrai	First person Singular
écrasé	None
déclara	Third person Singular
écourta	Third person Singular
applaudirent	Third person Plural
désenclavé	None
extraire	None
abritant	None
embellissant	None
délimité	None
déclamerait	Third person Singular
antresavant	None
medecinant	None
interceptait	Third person Singular
prépara	Third person Singular
subdivisait	Third person Singular
fureté	None
grondant	None
enrôlait	Third person Singular
attireront	Third person Plural
ruynant	None
redirai	First person Singular
gouverna	Third person Singular
retrempâmes	First person Plural
produisait	Third person Singular
mattera	Third person Singular
dépareront	Third person Plural
empirèrent	Third person Plural
démenait	Third person Singular
parviendront	Third person Plural
résilia	Third person Singular
donnerait	Third person Singular
réclamant	None
redunder	None
combattu	None
engrangea	Third person Singular
relâchait	Third person Singular
marchait	Third person Singular
pétaradant	None
apprécieraient	Third person Plural
chet	Third person Singular
blacklistant	None
tirerait	Third person Singular
couvera	Third person Singular
motivait	Third person Singular
fonctionnait	Third person Singular
attrapait	Third person Singular
désolait	Third person Singular
regardait	Third person Singular
bouffé	None
tailladeras	Second person Singular
syncopant	None
brillera	Third person Singular
éprouvera	Third person Singular
tacha	Third person Singular
détraqué	None
reformera	Third person Singular
étrivant	None
sonder	None
travaillera	Third person Singular
rêvant	None
franciser	None
detranpré	None
dévia	Third person Singular
coïncida	Third person Singular
groupa	Third person Singular
apparaitront	Third person Plural
nièrent	Third person Plural
chantonner	None
empreindre	None
traiterait	Third person Singular
résonné	None
remettrait	Third person Singular
overbookerait	Third person Singular
redirigera	Third person Singular
puiserez	Second person Plural
essaimant	None
bâté	None
corda	Third person Singular
nivelé	None
gênait	Third person Singular
nova	Third person Singular
bailla	Third person Singular
derun	Second person Singular
architectura	Third person Singular
vidas	Second person Singular
interviewait	Third person Singular
behordant	None
expirait	Third person Singular
déjeûnassent	Third person Plural
dissimulait	Third person Singular
étanché	None
dissipait	Third person Singular
égaliser	None
traumatisa	Third person Singular
téléporta	Third person Singular
coucher	None
relayâmes	First person Plural
diminuèrent	Third person Plural
ventilait	Third person Singular
récupèreront	Third person Plural
ajouterai	First person Singular
prévit	Third person Singular
proviendraient	Third person Plural
confondaient	Third person Plural
électrifié	None
blackboulerait	Third person Singular
négocièrent	Third person Plural
cessera	Third person Singular
coltineras	Second person Singular
répandit	Third person Singular
livrant	None
traînaient	Third person Plural
déstabilisassions	First person Plural
pesaient	Third person Plural
catastrophassent	Third person Plural
diaphragmant	None
répartiront	Third person Plural
défigurer	None
intensifiait	Third person Singular
rembarquèrent	Third person Plural
crucefïeras	Second person Singular
suggérait	Third person Singular
gardât	Third person Singular
glosé	None
dépurât	Third person Singular
recraché	None
argüant	None
correcissons	First person Plural
trublant	None
escortait	Third person Singular
labora	Third person Singular
endommageait	Third person Singular
dirigeaient	Third person Plural
calera	Third person Singular
glosa	Third person Singular
barricadé	None
caillai	First person Singular
lâcher	None
patientant	None
sonera	Third person Singular
asaillir	None
entrelarder	None
cartographia	Third person Singular
pilotaient	Third person Plural
féria	Third person Singular
refroidissait	Third person Singular
manifesteront	Third person Plural
esfacer	None
dénommaient	Third person Plural
décrivit	Third person Singular
blessa	Third person Singular
comprendrait	Third person Singular
décèderont	Third person Plural
armera	Third person Singular
combattra	Third person Singular
canta	Third person Singular
cliquai	First person Singular
prouverions	First person Plural
houa	Third person Singular
contrefirent	Third person Plural
affilièrent	Third person Plural
hantait	Third person Singular
infligera	Third person Singular
citaient	Third person Plural
rebaptisèrent	Third person Plural
partîmes	First person Plural
apprêta	Third person Singular
basculait	Third person Singular
trémousser	None
masquait	Third person Singular
bicha	Third person Singular
abandonnera	Third person Singular
arranger	None
réunifierons	First person Plural
racheta	Third person Singular
coûter	None
tissaient	Third person Plural
volèrent	Third person Plural
repraesenteront	Third person Plural
expliqueras	Second person Singular
retraversa	Third person Singular
justiserons	First person Plural
kidnappèrent	Third person Plural
déraisonné	None
romaniser	None
lier	None
trinquer	None
reculait	Third person Singular
terrifier	None
abroutir	None
retraça	Third person Singular
étiré	None
plaiderait	Third person Singular
habiliter	None
débordait	Third person Singular
évaporer	None
détonèrent	Third person Plural
recueillait	Third person Singular
désarçonnassent	Third person Plural
aquitté	None
prélever	None
réinstaurer	None
échelonneront	Third person Plural
enverrons	First person Plural
dénichera	Third person Singular
visité	None
fourniraient	Third person Plural
débâclerez	Second person Plural
surplombèrent	Third person Plural
étrennèrent	Third person Plural
démarchant	None
organiserai	First person Singular
trespassa	Third person Singular
entassait	Third person Singular
bifurquait	Third person Singular
transmirent	Third person Plural
renfermé	None
espeiames	First person Plural
vaster	None
tomatant	None
encadrera	Third person Singular
kaoliniser	None
combinant	None
prêterai	First person Singular
voiturant	None
talonnant	None
démocratiser	None
descouchant	None
déconseillèrent	Third person Plural
scandaient	Third person Plural
somont	Third person Singular
dévièrent	Third person Plural
grutas	Second person Singular
rassurerait	Third person Singular
caricaturer	None
révolter	None
isola	Third person Singular
carencé	None
trillas	Second person Singular
occasionnerait	Third person Singular
tutoyait	Third person Singular
boutonnâmes	First person Plural
attesta	Third person Singular
canja	Third person Singular
coprésidant	None
umilïeront	Third person Plural
reçussent	Third person Plural
survolera	Third person Singular
endommagerait	Third person Singular
répudier	None
renommait	Third person Singular
ratait	Third person Singular
contrerollera	Third person Singular
cambra	Third person Singular
approuvaient	Third person Plural
desfendis	Second person Singular
croirai	First person Singular
généra	Third person Singular
cotiras	Second person Singular
remonteraient	Third person Plural
isoler	None
concassé	None
assai	First person Singular
tourniquerait	Third person Singular
annulera	Third person Singular
blanchirai	First person Singular
dégriffer	None
chiper	None
versaient	Third person Plural
reluisir	None
hostas	Second person Singular
immortalisa	Third person Singular
déviait	Third person Singular
sautai	First person Singular
vendanger	None
recyclait	Third person Singular
craqua	Third person Singular
exhumé	None
induit	Third person Singular
bornèrent	Third person Plural
rejoignaient	Third person Plural
assena	Third person Singular
freignant	None
divisaient	Third person Plural
stigmatisé	None
enrolla	Third person Singular
coutaient	Third person Plural
attendirent	Third person Plural
libèreraient	Third person Plural
idéalisait	Third person Singular
dédouanant	None
brassai	First person Singular
viela	Third person Singular
souna	Third person Singular
abuserions	First person Plural
désinscrit	Third person Singular
profitait	Third person Singular
mollardassiez	Second person Plural
accompagnant	None
renseignera	Third person Singular
bougeait	Third person Singular
pencheront	Third person Plural
propageait	Third person Singular
félicitera	Third person Singular
recréera	Third person Singular
acheta	Third person Singular
obtiendrions	First person Plural
zooma	Third person Singular
encabaneriez	Second person Plural
recouvrirent	Third person Plural
marauder	None
caricaturait	Third person Singular
réfugiait	Third person Singular
fatiguait	Third person Singular
courbait	Third person Singular
roidi	None
chialer	None
formaté	None
sourire	None
halai	First person Singular
paroles	Second person Singular
intellectualisé	None
arrogé	None
décrire	None
dégueuler	None
déconcentrasse	First person Singular
damna	Third person Singular
désamorçassent	Third person Plural
asperger	None
habiterai	First person Singular
prétextait	Third person Singular
désertaient	Third person Plural
émouvaient	Third person Plural
grava	Third person Singular
retransmettait	Third person Singular
renomma	Third person Singular
empiffrera	Third person Singular
revendriez	Second person Plural
esjoir	None
excorié	None
alimentèrent	Third person Plural
avoiderai	First person Singular
éclipsas	Second person Singular
vala	Third person Singular
priant	None
tiercerons	First person Plural
fuguasse	First person Singular
eschapasse	First person Singular
fondit	Third person Singular
désensablaient	Third person Plural
collaborera	Third person Singular
infligeait	Third person Singular
replaçait	Third person Singular
appauvri	None
mangeront	Third person Plural
crossé	None
usurpa	Third person Singular
proscrire	None
bornerait	Third person Singular
brassait	Third person Singular
offrant	None
bouchant	None
débrouillait	Third person Singular
questionné	None
commençaient	Third person Plural
radicalisait	Third person Singular
effectuerait	Third person Singular
octroierai	First person Singular
envahissait	Third person Singular
propagerait	Third person Singular
étoffèrent	Third person Plural
resguardé	None
scindé	None
restreindra	Third person Singular
barricadèrent	Third person Plural
contribueraient	Third person Plural
flairier	None
ébranlâtes	Second person Plural
mûrir	None
démythifié	None
personnifié	None
gâcher	None
reconnaitrait	Third person Singular
massacrera	Third person Singular
vautrer	None
enquester	None
connaîtriez	Second person Plural
réquisitionnera	Third person Singular
raillait	Third person Singular
enhabiteroit	Third person Singular
déposeraient	Third person Plural
narra	Third person Singular
draina	Third person Singular
assurant	None
périclitèrent	Third person Plural
diamanté	None
épargneraient	Third person Plural
plantant	None
mout	Third person Singular
précisaient	Third person Plural
concerta	Third person Singular
perquisitionna	Third person Singular
filas	Second person Singular
réouvrant	None
interpellait	Third person Singular
décrira	Third person Singular
medité	None
bâcleras	Second person Singular
vérifierai	First person Singular
breant	None
essuieriez	Second person Plural
détordirent	Third person Plural
asservi	None
tisser	None
rejetterait	Third person Singular
handicaperait	Third person Singular
pesta	Third person Singular
dupliquer	None
lamina	Third person Singular
enclenchait	Third person Singular
jetèrent	Third person Plural
alourdi	None
grandissaient	Third person Plural
polluait	Third person Singular
perdait	Third person Singular
échangeant	None
déduire	None
abrévié	None
pelai	First person Singular
révoquait	Third person Singular
annelâmes	First person Plural
insuffla	Third person Singular
donnera	Third person Singular
navigua	Third person Singular
bombé	None
blesseront	Third person Plural
détruisit	Third person Singular
seroit	Third person Singular
coïncidassiez	Second person Plural
copiaient	Third person Plural
vengeast	Third person Singular
échangerait	Third person Singular
ballota	Third person Singular
botté	None
annoter	None
crucifier	None
abolirait	Third person Singular
raréfia	Third person Singular
contestera	Third person Singular
chauffant	None
filtrant	None
répondrez	Second person Plural
malfissent	Third person Plural
enconné	None
conjugué	None
défonça	Third person Singular
contournait	Third person Singular
ramassera	Third person Singular
cuidera	Third person Singular
coopérait	Third person Singular
aduster	None
estamperai	First person Singular
creanceroient	Third person Plural
flirteront	Third person Plural
concluait	Third person Singular
dévirginisâtes	Second person Plural
emménagèrent	Third person Plural
proposa	Third person Singular
perturberait	Third person Singular
foullastes	Second person Plural
imminassiez	Second person Plural
débarrassé	None
perfora	Third person Singular
redistribuaient	Third person Plural
gagneront	Third person Plural
prévoirait	Third person Singular
dispenserait	Third person Singular
pratiquaient	Third person Plural
pâmer	None
sourira	Third person Singular
démontrèrent	Third person Plural
anseler	None
évincèrent	Third person Plural
apprendrait	Third person Singular
thésauriser	None
agrémenta	Third person Singular
défèrerons	First person Plural
libérait	Third person Singular
protègerai	First person Singular
disses	Second person Singular
équivalaient	Third person Plural
déroutait	Third person Singular
apporta	Third person Singular
traînant	None
jetteront	Third person Plural
embauchant	None
transplanter	None
lancerai	First person Singular
radiotéléviserions	First person Plural
coproduira	Third person Singular
associerait	Third person Singular
ballastât	Third person Singular
exhibait	Third person Singular
reconsacra	Third person Singular
chantonnâtes	Second person Plural
fluctua	Third person Singular
démarqua	Third person Singular
coloniser	None
aimerait	Third person Singular
besoignerai	First person Singular
écrivirent	Third person Plural
comprend	Third person Singular
existèrent	Third person Plural
garbeleroient	Third person Plural
réaffirmer	None
fabriqua	Third person Singular
présumé	None
vilipender	None
émulsionné	None
esmaiant	None
apparaitra	Third person Singular
déjouera	Third person Singular
soulageait	Third person Singular
fritta	Third person Singular
radiobaliserions	First person Plural
rassembla	Third person Singular
étonnera	Third person Singular
antidata	Third person Singular
desbaratassent	Third person Plural
tailler	None
vautrait	Third person Singular
affectionnant	None
révoquerons	First person Plural
culminerait	Third person Singular
filaient	Third person Plural
identifia	Third person Singular
encaissa	Third person Singular
opèrera	Third person Singular
constellant	None
parler	None
professé	None
consignant	None
prédéterminerait	Third person Singular
récompenserait	Third person Singular
contingenté	None
remotiver	None
galvaudâmes	First person Plural
ravageaient	Third person Plural
reprendra	Third person Singular
finalisera	Third person Singular
opérèrent	Third person Plural
advancé	None
ingéraient	Third person Plural
longera	Third person Singular
s'appeler	None
parlai	First person Singular
pétaradassiez	Second person Plural
nombrastes	Second person Plural
régir	None
pardonnerai	First person Singular
fomentait	Third person Singular
pronostiquant	None
démasquerai	First person Singular
maquillassions	First person Plural
culminer	None
bataillait	Third person Singular
déplaçant	None
éclatèrent	Third person Plural
échelonnaient	Third person Plural
abrutir	None
répercutera	Third person Singular
éblouir	None
parcourront	Third person Plural
refond	Third person Singular
guarantissoie	First person Singular
harper	None
termineraient	Third person Plural
réallouer	None
detrenchier	None
démentiront	Third person Plural
conditionna	Third person Singular
insèrera	Third person Singular
supprimera	Third person Singular
construisirent	Third person Plural
retrouverait	Third person Singular
déciderai	First person Singular
carier	None
limiterons	First person Plural
gâté	None
desséchant	None
pond	Third person Singular
flatirons	First person Plural
attellera	Third person Singular
attestaient	Third person Plural
effaceraient	Third person Plural
servirent	Third person Plural
bénéficierait	Third person Singular
atteindrons	First person Plural
convenait	Third person Singular
traiterons	First person Plural
relierait	Third person Singular
onduler	None
manquerai	First person Singular
annexerait	Third person Singular
connu	None
atalanta	Third person Singular
propageaient	Third person Plural
plongera	Third person Singular
regarderait	Third person Singular
privilégiaient	Third person Plural
avancèrent	Third person Plural
enfauntiiez	Second person Plural
mua	Third person Singular
guaiter	None
referait	Third person Singular
virevoltassent	Third person Plural
remémoré	None
coutait	Third person Singular
interprétaient	Third person Plural
infligé	None
révérant	None
suz	Second person Singular
abandonnait	Third person Singular
manifestèrent	Third person Plural
mons	Second person Singular
imprégna	Third person Singular
empilaient	Third person Plural
hâlé	None
attirera	Third person Singular
autopsia	Third person Singular
captaient	Third person Plural
quitteront	Third person Plural
entourerons	First person Plural
localisèrent	Third person Plural
reviendront	Third person Plural
triompher	None
bondissait	Third person Singular
happé	None
exécrait	Third person Singular
renseignerait	Third person Singular
surprendrait	Third person Singular
offrir	None
supant	None
interférant	None
filigrané	None
vouté	None
approvisionné	None
préfixer	None
pénétra	Third person Singular
volatilisa	Third person Singular
contreviendrait	Third person Singular
acclimata	Third person Singular
espellé	None
représenta	Third person Singular
préféra	Third person Singular
adoubé	None
criquer	None
bromassent	Third person Plural
domiciliant	None
trappa	Third person Singular
fistasses	Second person Singular
redressa	Third person Singular
découlant	None
grapa	Third person Singular
récusera	Third person Singular
éreinté	None
claironnant	None
précipiterait	Third person Singular
soutiennes	Second person Singular
ossifierions	First person Plural
fonderaient	Third person Plural
niqueriez	Second person Plural
innocenta	Third person Singular
ajoutait	Third person Singular
nasillant	None
remodela	Third person Singular
totalisait	Third person Singular
redouter	None
baster	None
abrita	Third person Singular
récupéraient	Third person Plural
tomba	Third person Singular
estoffant	None
récoltaient	Third person Plural
déprêtrisant	None
militer	None
épaulera	Third person Singular
votaient	Third person Plural
brea	Third person Singular
réchauffa	Third person Singular
reprochèrent	Third person Plural
enviait	Third person Singular
écumaient	Third person Plural
dorloterait	Third person Singular
désaxer	None
errèrent	Third person Plural
dilué	None
statuait	Third person Singular
calibré	None
résonner	None
fractionner	None
protestèrent	Third person Plural
inversera	Third person Singular
musclé	None
demustroient	Third person Plural
sablerez	Second person Plural
ramèneront	Third person Plural
béasse	First person Singular
coltiné	None
octaviassions	First person Plural
netoiant	None
admiré	None
exposeront	Third person Plural
criqueroiz	Second person Plural
écrasèrent	Third person Plural
soulagerait	Third person Singular
dénudai	First person Singular
suppurai	First person Singular
avoisinait	Third person Singular
cloîtrer	None
fluidifié	None
embrasa	Third person Singular
réapprovisionner	None
dépourvûtes	Second person Plural
réfléchissant	None
azura	Third person Singular
règlementait	Third person Singular
houspilleraient	Third person Plural
partiront	Third person Plural
préconiserai	First person Singular
organisèrent	Third person Plural
amollissant	None
afeblissoiz	Second person Plural
pillaient	Third person Plural
graviter	None
admirèrent	Third person Plural
emprisonnera	Third person Singular
traumatiser	None
fermentasse	First person Singular
ralliant	None
baliser	None
tarauder	None
enfreignant	None
curas	Second person Singular
défirent	Third person Plural
déformera	Third person Singular
appauvrir	None
détrônèrent	Third person Plural
geller	None
continuera	Third person Singular
cognasse	First person Singular
exercerait	Third person Singular
cherchait	Third person Singular
déchausserions	First person Plural
présidaient	Third person Plural
conserverait	Third person Singular
encapsuler	None
ancra	Third person Singular
vendangeant	None
réitérèrent	Third person Plural
résonnait	Third person Singular
annulerait	Third person Singular
succomberont	Third person Plural
sous-exposé	None
fusèrent	Third person Plural
inséminerons	First person Plural
chevauchèrent	Third person Plural
estes	Second person Plural
recommandaient	Third person Plural
expatrieriez	Second person Plural
vieillissaient	Third person Plural
éveillera	Third person Singular
réfugièrent	Third person Plural
contester	None
risquant	None
surveillait	Third person Singular
senefïeras	Second person Singular
sautèrent	Third person Plural
explicquassiez	Second person Plural
glaçant	None
reconnaîtraient	Third person Plural
arguèrent	Third person Plural
rembarquassiez	Second person Plural
diplômer	None
descunseillier	None
pesant	None
exsudé	None
tapoté	None
battisse	First person Singular
remontèrent	Third person Plural
casera	Third person Singular
signalerai	First person Singular
trainé	None
repasserait	Third person Singular
rentrerai	First person Singular
courrez	Second person Plural
entretiendra	Third person Singular
osant	None
desnoeroie	First person Singular
avala	Third person Singular
affinaient	Third person Plural
labellisa	Third person Singular
enkyster	None
solutionné	None
behordasse	First person Singular
cras	Second person Singular
pourrirent	Third person Plural
excusant	None
deslis	Second person Singular
diner	None
pulvérisassent	Third person Plural
divisera	Third person Singular
ébarbassions	First person Plural
cohabiteront	Third person Plural
vivrai	First person Singular
recracha	Third person Singular
perturbaient	Third person Plural
coordonnaient	Third person Plural
starifiasse	First person Singular
rener	None
voltiger	None
déchargé	None
traduira	Third person Singular
pourchasserions	First person Plural
réajusté	None
étouffa	Third person Singular
stratifier	None
remixa	Third person Singular
astreignant	None
assombrirent	Third person Plural
laisserons	First person Plural
expatria	Third person Singular
rogné	None
sujurneroies	Second person Singular
traduire	None
énoncé	None
ravir	None
ralluma	Third person Singular
useront	Third person Plural
prescrivaient	Third person Plural
garroché	None
rentrèrent	Third person Plural
montrait	Third person Singular
contrôla	Third person Singular
apanager	None
enrôlera	Third person Singular
essaierons	First person Plural
susciteront	Third person Plural
cernèrent	Third person Plural
clonas	Second person Singular
accédaient	Third person Plural
chasseront	Third person Plural
ordonnait	Third person Singular
réforma	Third person Singular
dézipperiez	Second person Plural
détoner	None
golferait	Third person Singular
coutèrent	Third person Plural
vouâmes	First person Plural
remporterait	Third person Singular
escrier	None
terrorisant	None
gagnerions	First person Plural
haïssaient	Third person Plural
concordant	None
poulinerait	Third person Singular
évertuait	Third person Singular
dissolvant	None
apparenteraient	Third person Plural
exaspérer	None
aora	Third person Singular
décrété	None
qualifiait	Third person Singular
calmeront	Third person Plural
crispa	Third person Singular
applaudissait	Third person Singular
désapprouvait	Third person Singular
regorgeraient	Third person Plural
stigmatisa	Third person Singular
abhorrer	None
participera	Third person Singular
transmettra	Third person Singular
sortît	Third person Singular
aborderons	First person Plural
compatiront	Third person Plural
polymérisant	None
déboucherait	Third person Singular
bénéficiera	Third person Singular
dénommerons	First person Plural
naturaliser	None
appropriait	Third person Singular
repeliiens	First person Plural
ourlant	None
cunforter	None
attendît	Third person Singular
marqueraient	Third person Plural
entreprenait	Third person Singular
sombrer	None
titrait	Third person Singular
chuchotait	Third person Singular
diffameriez	Second person Plural
généralisait	Third person Singular
compromettrait	Third person Singular
suinté	None
alureroies	Second person Singular
apprend	Third person Singular
régenté	None
fainsisses	Second person Singular
assistèrent	Third person Plural
divorçant	None
gisaient	Third person Plural
concaténasses	Second person Singular
vibrer	None
amèneraient	Third person Plural
déplut	Third person Singular
retentissaient	Third person Plural
gîter	None
installa	Third person Singular
præsumé	None
opposa	Third person Singular
ankylosé	None
permettaient	Third person Plural
paralléliseriez	Second person Plural
aventurerai	First person Singular
trampoit	Third person Singular
sautant	None
arrivera	Third person Singular
harponnant	None
varias	Second person Singular
ragaillardissant	None
invoquerait	Third person Singular
fracassa	Third person Singular
muvra	Third person Singular
paint	Third person Singular
desrisant	None
identifieront	Third person Plural
abstiendront	Third person Plural
prospèreriez	Second person Plural
part	Third person Singular
bauptizastes	Second person Plural
apprendra	Third person Singular
préparait	Third person Singular
éclatait	Third person Singular
melles	Second person Singular
assureront	Third person Plural
formula	Third person Singular
horripilait	Third person Singular
renâclera	Third person Singular
temporisa	Third person Singular
proportionner	None
insisterai	First person Singular
échancrant	None
étincelleriez	Second person Plural
exista	Third person Singular
endetter	None
tabulant	None
turbina	Third person Singular
exempté	None
criait	Third person Singular
déduira	Third person Singular
cabras	Second person Singular
jalonnaient	Third person Plural
surprendre	None
emporterez	Second person Plural
restorer	None
assaillaient	Third person Plural
instaura	Third person Singular
esbigner	None
grenada	Third person Singular
picorer	None
interprétant	None
devint	Third person Singular
souhaitai	First person Singular
désabonné	None
méprendre	None
élargissaient	Third person Plural
pesèrent	Third person Plural
carambola	Third person Singular
construirons	First person Plural
compatir	None
disposerez	Second person Plural
désamorçant	None
hostoioient	Third person Plural
grimpait	Third person Singular
délita	Third person Singular
ensoleillerez	Second person Plural
déterrèrent	Third person Plural
décédaient	Third person Plural
ânonnerons	First person Plural
assaillir	None
enfoncerait	Third person Singular
culasses	Second person Singular
invoqua	Third person Singular
cunduirons	First person Plural
cantonna	Third person Singular
équipaient	Third person Plural
sentiraient	Third person Plural
mutinèrent	Third person Plural
encagoulé	None
copierait	Third person Singular
toila	Third person Singular
permirent	Third person Plural
ist	Third person Singular
apaisèrent	Third person Plural
décapant	None
assureraient	Third person Plural
attaqua	Third person Singular
quadrillé	None
ventilant	None
mentionner	None
fêtèrent	Third person Plural
rêvera	Third person Singular
grammaticalisèrent	Third person Plural
commit	Third person Singular
rentraient	Third person Plural
clairer	None
colorait	Third person Singular
affronté	None
télécommandé	None
affubla	Third person Singular
recomposant	None
rénovèrent	Third person Plural
escagasser	None
entre-louasse	First person Singular
culminé	None
recrutait	Third person Singular
modéra	Third person Singular
persévéré	None
aluminé	None
tuant	None
décontaminerions	First person Plural
utilisa	Third person Singular
chanteront	Third person Plural
aboutissait	Third person Singular
pondra	Third person Singular
chaut	Third person Singular
renaitre	None
animerait	Third person Singular
gaaignié	None
transmigré	None
balada	Third person Singular
nit	Third person Singular
fleuriront	Third person Plural
habiteront	Third person Plural
enterra	Third person Singular
alis	Second person Singular
assouvissant	None
gagneras	Second person Singular
mendia	Third person Singular
militaient	Third person Plural
noircir	None
hart	Third person Singular
capa	Third person Singular
rationalisant	None
nuiront	Third person Plural
survivaient	Third person Plural
labourer	None
semblaient	Third person Plural
parlerez	Second person Plural
mordit	Third person Singular
s'appelant	None
hupas	Second person Singular
meuglas	Second person Singular
criqueroit	Third person Singular
appréhenda	Third person Singular
constitueront	Third person Plural
quêtaient	Third person Plural
creusèrent	Third person Plural
inactivé	None
dépassera	Third person Singular
impliquaient	Third person Plural
indiquerai	First person Singular
abusaient	Third person Plural
quichera	Third person Singular
stocka	Third person Singular
romprait	Third person Singular
rénové	None
forclore	None
chevauchait	Third person Singular
transparait	Third person Singular
contrôlait	Third person Singular
détaillait	Third person Singular
recoupait	Third person Singular
dansaient	Third person Plural
prêcha	Third person Singular
busse	First person Singular
relayai	First person Singular
entraîneraient	Third person Plural
sinisa	Third person Singular
rendras	Second person Singular
élancèrent	Third person Plural
tané	None
raffolâtes	Second person Plural
occuperai	First person Singular
implorait	Third person Singular
ciblaient	Third person Plural
frottaient	Third person Plural
sigla	Third person Singular
concordait	Third person Singular
influèrent	Third person Plural
contînt	Third person Singular
affranchirent	Third person Plural
kiet	Third person Singular
théorisait	Third person Singular
scandalisait	Third person Singular
relancera	Third person Singular
entremêler	None
retrait	Third person Singular
célèbrera	Third person Singular
laboré	None
échapperaient	Third person Plural
consolé	None
gravitait	Third person Singular
embossé	None
alléguer	None
publiera	Third person Singular
dessalassiez	Second person Plural
raviront	Third person Plural
interagissait	Third person Singular
relooké	None
cuisinant	None
fermeraient	Third person Plural
régulé	None
bees	Second person Singular
autodissout	Third person Singular
bridant	None
émailler	None
exigeront	Third person Plural
rapporterait	Third person Singular
iecterez	Second person Plural
condicionant	None
acuplerons	First person Plural
répondit	Third person Singular
recommençaient	Third person Plural
partagera	Third person Singular
liera	Third person Singular
démissionna	Third person Singular
défonçant	None
séparaient	Third person Plural
évalua	Third person Singular
platiné	None
countes	Second person Singular
hupa	Third person Singular
bessemérisant	None
descendra	Third person Singular
assommèrent	Third person Plural
ireta	Third person Singular
subvenant	None
viserait	Third person Singular
bagouler	None
sombrerait	Third person Singular
essayant	None
dégobillé	None
perpétuaient	Third person Plural
gouvernerait	Third person Singular
remixé	None
retentassent	Third person Plural
renonceraient	Third person Plural
surclassant	None
spécifiant	None
fliqué	None
cru	None
ironisait	Third person Singular
décimait	Third person Singular
minaient	Third person Plural
avorté	None
dégaina	Third person Singular
préfigurant	None
marinera	Third person Singular
générait	Third person Singular
intronisant	None
jurassent	Third person Plural
reprendras	Second person Singular
plaquas	Second person Singular
démissionnera	Third person Singular
enduire	None
jouteriez	Second person Plural
annihilerait	Third person Singular
joindraient	Third person Plural
électriser	None
arnaqué	None
évideriez	Second person Plural
adjugea	Third person Singular
cicatrisïeroiz	Second person Plural
aideraient	Third person Plural
jettera	Third person Singular
tomberai	First person Singular
saurir	None
secouer	None
crama	Third person Singular
critiquait	Third person Singular
réimprima	Third person Singular
lofa	Third person Singular
inutilisassiez	Second person Plural
serez	Second person Plural
bloquer	None
conçurent	Third person Plural
regretter	None
guidait	Third person Singular
suivront	Third person Plural
suna	Third person Singular
annoncé	None
tirasses	Second person Singular
potentialisant	None
espirera	Third person Singular
magnant	None
terminait	Third person Singular
pratiquait	Third person Singular
dénombrera	Third person Singular
déporta	Third person Singular
renfrogné	None
corsèterai	First person Singular
bissé	None
commémoraient	Third person Plural
dérivé	None
évacué	None
mériterait	Third person Singular
lèverait	Third person Singular
italianisé	None
traça	Third person Singular
soutira	Third person Singular
gerberas	Second person Singular
succédèrent	Third person Plural
meut	Third person Singular
modulant	None
reversant	None
dépénaliseront	Third person Plural
fila	Third person Singular
affié	None
lié	None
disclaimer	None
accusait	Third person Singular
monopolisaient	Third person Plural
vola	Third person Singular
capturaient	Third person Plural
manifestera	Third person Singular
robâmes	First person Plural
dispensaient	Third person Plural
instruit	Third person Singular
gerra	Third person Singular
entacherait	Third person Singular
décapitalisait	Third person Singular
ripant	None
enclouera	Third person Singular
esfreïiez	Second person Plural
mercyer	None
rotas	Second person Singular
doublera	Third person Singular
concevaient	Third person Plural
jaunîtes	Second person Plural
dictaient	Third person Plural
doives	Second person Singular
prônera	Third person Singular
hisseront	Third person Plural
proposaient	Third person Plural
perpétua	Third person Singular
entérinera	Third person Singular
discipliné	None
sabbatiser	None
plaqué	None
humiliait	Third person Singular
privilégiait	Third person Singular
angarié	None
endommaigeastes	Second person Plural
floueront	Third person Plural
déniassent	Third person Plural
trianguler	None
accueillirent	Third person Plural
émancipas	Second person Singular
sous-classerai	First person Singular
sécher	None
archivant	None
sillonné	None
replier	None
interviendrai	First person Singular
vérifiaient	Third person Plural
achemina	Third person Singular
descunseuz	Second person Singular
démondialisassent	Third person Plural
dina	Third person Singular
induisirent	Third person Plural
signifierai	First person Singular
barbouillant	None
abeliroies	Second person Singular
travaillât	Third person Singular
suspendait	Third person Singular
vaunteroit	Third person Singular
carola	Third person Singular
envisagèrent	Third person Plural
paquera	Third person Singular
candidater	None
esvantasse	First person Singular
réinvesti	None
ripé	None
disparaître	None
endeuiller	None
hus	Second person Singular
rapela	Third person Singular
écoutèrent	Third person Plural
éteignaient	Third person Plural
conquéraient	Third person Plural
revaloriser	None
craignit	Third person Singular
révolutionnèrent	Third person Plural
fondrait	Third person Singular
ressuieroit	Third person Singular
liséré	None
molu	Third person Singular
maileriez	Second person Plural
flairs	Second person Singular
masquerait	Third person Singular
matera	Third person Singular
détecter	None
retireront	Third person Plural
saignait	Third person Singular
éternisaient	Third person Plural
revoyant	None
prêta	Third person Singular
éteignait	Third person Singular
bourdonna	Third person Singular
entonnèrent	Third person Plural
embêté	None
retourna	Third person Singular
influencé	None
collectionnait	Third person Singular
voudrions	First person Plural
trencherent	Third person Plural
incendiaient	Third person Plural
différencier	None
huierons	First person Plural
éprouverait	Third person Singular
existera	Third person Singular
contribuer	None
paissaient	Third person Plural
contrant	None
banqueter	None
expuysasses	Second person Singular
auleguant	None
balisé	None
abonné	None
disqualifia	Third person Singular
engageât	Third person Singular
gérant	None
façonasse	First person Singular
assaisonner	None
émanciper	None
métamorphosas	Second person Singular
inauguraient	Third person Plural
empêcheraient	Third person Plural
étoffé	None
copilotassions	First person Plural
froidira	Third person Singular
estrivoies	Second person Singular
écouterai	First person Singular
biloquerez	Second person Plural
redeviendrait	Third person Singular
enquêterons	First person Plural
passionnerions	First person Plural
rappelèrent	Third person Plural
délassait	Third person Singular
renforçaient	Third person Plural
vives	Second person Singular
égalisé	None
intensifiant	None
modifiait	Third person Singular
accélérassent	Third person Plural
flattait	Third person Singular
runs	Second person Singular
vaquaient	Third person Plural
conservèrent	Third person Plural
fabriqueront	Third person Plural
prévoyaient	Third person Plural
parleras	Second person Singular
tiquer	None
embrouz	Second person Singular
cumanderoit	Third person Singular
allouèrent	Third person Plural
represanterons	First person Plural
contient	Third person Singular
régi	None
réconciliera	Third person Singular
frappera	Third person Singular
eurs	Second person Singular
gomina	Third person Singular
tyrannisant	None
orneront	Third person Plural
emperlât	Third person Singular
brodassent	Third person Plural
positionnèrent	Third person Plural
initieront	Third person Plural
reploreroit	Third person Singular
choquaient	Third person Plural
irritaient	Third person Plural
dépilant	None
repasserai	First person Singular
assigner	None
trespasses	Second person Singular
fonctionnera	Third person Singular
jurant	None
reboiserions	First person Plural
funda	Third person Singular
accouchant	None
compliquait	Third person Singular
déblayer	None
immunisé	None
extrudant	None
crierai	First person Singular
incendiait	Third person Singular
existeront	Third person Plural
essaucié	None
agencé	None
adapterai	First person Singular
gaudi	None
troublerait	Third person Singular
troerai	First person Singular
déplaisaient	Third person Plural
accointerait	Third person Singular
affecteront	Third person Plural
satirisas	Second person Singular
hasté	None
rajas	Second person Singular
réenregistra	Third person Singular
fendant	None
localiserez	Second person Plural
appliquèrent	Third person Plural
assemblaient	Third person Plural
confinant	None
plébiscité	None
écrouler	None
remanufacturerons	First person Plural
porpensissoiz	Second person Plural
contestaient	Third person Plural
endort	Third person Singular
sifflait	Third person Singular
asséché	None
surveillant	None
redevenaient	Third person Plural
ouvrer	None
remembré	None
jeter	None
ressembla	Third person Singular
recommandera	Third person Singular
fusionna	Third person Singular
entrainé	None
controversa	Third person Singular
fondra	Third person Singular
apanagerai	First person Singular
reconditionné	None
lieront	Third person Plural
vandalisant	None
apposera	Third person Singular
affligeait	Third person Singular
proliférer	None
confessaient	Third person Plural
clarifié	None
assouvirent	Third person Plural
démoralisant	None
aberrai	First person Singular
déconner	None
déferlèrent	Third person Plural
caserné	None
ripailleront	Third person Plural
affirmeront	Third person Plural
recettant	None
refassent	Third person Plural
crachinant	None
dérailler	None
expliquant	None
démilitarisant	None
frémir	None
obéirai	First person Singular
barbelé	None
estompera	Third person Singular
joustast	Third person Singular
rassortissant	None
congédia	Third person Singular
frustra	Third person Singular
paraît	Third person Singular
éviteraient	Third person Plural
achaz	Second person Singular
réenfourchasses	Second person Singular
dépeint	Third person Singular
réfréner	None
liftât	Third person Singular
décevoir	None
dévalant	None
étuvèrent	Third person Plural
regroupera	Third person Singular
optimisera	Third person Singular
dementer	None
destourneroient	Third person Plural
tonna	Third person Singular
aperçurent	Third person Plural
caricatura	Third person Singular
consulta	Third person Singular
soulevaient	Third person Plural
nis	Second person Singular
chercherai	First person Singular
placota	Third person Singular
craignant	None
défoulerez	Second person Plural
comptabiliseras	Second person Singular
dissoudrait	Third person Singular
mapper	None
jos	Second person Singular
sollicita	Third person Singular
defendi	First person Singular
estancha	Third person Singular
pourrir	None
règlementé	None
listera	Third person Singular
reposeraient	Third person Plural
rétablirent	Third person Plural
notabilisé	None
abaya	Third person Singular
confesser	None
fondèrent	Third person Plural
teignes	Second person Singular
commerçait	Third person Singular
acéré	None
boycottèrent	Third person Plural
présentait	Third person Singular
naviguaient	Third person Plural
hésita	Third person Singular
blessèrent	Third person Plural
embraser	None
adaptèrent	Third person Plural
subordonnant	None
détruisait	Third person Singular
forfait	Third person Singular
palabras	Second person Singular
renationalisasses	Second person Singular
sabrant	None
allèrent	Third person Plural
culerez	Second person Plural
amerrir	None
dépendra	Third person Singular
appropriaient	Third person Plural
gangrené	None
arimassent	Third person Plural
baptisèrent	Third person Plural
sévira	Third person Singular
cédant	None
impliqua	Third person Singular
déguisé	None
rattrapait	Third person Singular
coagulassent	Third person Plural
traînerait	Third person Singular
vérifièrent	Third person Plural
illustrait	Third person Singular
craindrait	Third person Singular
armoriant	None
égalisait	Third person Singular
accaparait	Third person Singular
tablaient	Third person Plural
pasas	Second person Singular
perdrons	First person Plural
alternaient	Third person Plural
disaient	Third person Plural
enjoignait	Third person Singular
semon	Second person Singular
cylindrer	None
comblaient	Third person Plural
entonnaient	Third person Plural
calfeutrer	None
résiliassent	Third person Plural
dériverons	First person Plural
garantira	Third person Singular
alaiz	Second person Singular
estimerai	First person Singular
dissuadassions	First person Plural
concrétisa	Third person Singular
publieraient	Third person Plural
remerciait	Third person Singular
surexposé	None
scellé	None
pressentit	Third person Singular
gravas	Second person Singular
relevât	Third person Singular
abdiquer	None
grossissait	Third person Singular
ensablant	None
imitaient	Third person Plural
redonnerait	Third person Singular
desagreeront	Third person Plural
lestasse	First person Singular
chlorurèrent	Third person Plural
conduisaient	Third person Plural
agonisant	None
rééquiper	None
balkaniserions	First person Plural
détint	Third person Singular
appréciait	Third person Singular
accordât	Third person Singular
enrichiront	Third person Plural
épousera	Third person Singular
énoncerait	Third person Singular
assaillant	None
reprendraient	Third person Plural
marcheraient	Third person Plural
capitonné	None
exhumer	None
étouffèrent	Third person Plural
cheviiens	First person Plural
viraient	Third person Plural
parlerons	First person Plural
décanter	None
robotisé	None
durera	Third person Singular
dégraissé	None
débarquerait	Third person Singular
encrocheroient	Third person Plural
gèlera	Third person Singular
assujettissait	Third person Singular
menèrent	Third person Plural
renforçait	Third person Singular
déséquilibrant	None
comptabilisâmes	First person Plural
sohaideriiens	First person Plural
déclamaient	Third person Plural
lèveront	Third person Plural
verrouillant	None
crasher	None
résinifiassions	First person Plural
revivifierai	First person Singular
aigrit	Third person Singular
touillasse	First person Singular
foliiens	First person Plural
anisé	None
assaisonné	None
anastomoseraient	Third person Plural
empèguera	Third person Singular
excella	Third person Singular
émergeant	None
décacheter	None
réengagé	None
agrandissaient	Third person Plural
farfouiller	None
investissaient	Third person Plural
licenciant	None
fortiffier	None
réunifié	None
expédièrent	Third person Plural
sculpta	Third person Singular
purgeant	None
sous-louer	None
atteignirent	Third person Plural
examinerons	First person Plural
reverront	Third person Plural
débloquant	None
drossé	None
achatastes	Second person Plural
éveillait	Third person Singular
bizuté	None
traduirai	First person Singular
déplorait	Third person Singular
imaginait	Third person Singular
prophétisait	Third person Singular
dédommagea	Third person Singular
vêler	None
remeü	None
aveugler	None
aventuré	None
remaria	Third person Singular
décernera	Third person Singular
cartographieriez	Second person Plural
détrôna	Third person Singular
prolongea	Third person Singular
préconisa	Third person Singular
gratifié	None
reprendrons	First person Plural
pondérer	None
désorbé	None
revi	First person Singular
tétaniser	None
rediscutera	Third person Singular
secorussent	Third person Plural
acheminerait	Third person Singular
déconcentrât	Third person Singular
merdiquerai	First person Singular
mesura	Third person Singular
ferons	First person Plural
antredonoies	Second person Singular
monétiser	None
croiseront	Third person Plural
augurait	Third person Singular
dérogeait	Third person Singular
sonna	Third person Singular
baverez	Second person Plural
échangera	Third person Singular
commandèrent	Third person Plural
encouragea	Third person Singular
aanchreroient	Third person Plural
hypothéquas	Second person Singular
mespris	First person Singular
cert	Third person Singular
gosta	Third person Singular
échappaient	Third person Plural
risqueriez	Second person Plural
ferla	Third person Singular
amalgama	Third person Singular
gagna	Third person Singular
sofrerai	First person Singular
extuber	None
éclairaient	Third person Plural
emmèneront	Third person Plural
bassiner	None
giveer	None
amenas	Second person Singular
revendiquai	First person Singular
abreuvait	Third person Singular
enrôlaient	Third person Plural
eûtes	Second person Plural
zigzaguaient	Third person Plural
ferrant	None
concèdera	Third person Singular
estraistrent	Third person Plural
calcinèrent	Third person Plural
formas	Second person Singular
relégua	Third person Singular
comanda	Third person Singular
enfilant	None
gouré	None
dirigerait	Third person Singular
contiendront	Third person Plural
sonnait	Third person Singular
ruineront	Third person Plural
abada	Third person Singular
relata	Third person Singular
appointeront	Third person Plural
carrant	None
cultivé	None
cerquier	None
optait	Third person Singular
frustrait	Third person Singular
châtrer	None
recouvrera	Third person Singular
coûtèrent	Third person Plural
raanclant	None
vadrouillaient	Third person Plural
aillas	Second person Singular
désorganisé	None
pénalisera	Third person Singular
renonceront	Third person Plural
pendillera	Third person Singular
destreciiens	First person Plural
vassaliserions	First person Plural
translittérer	None
bricolant	None
conduisait	Third person Singular
amoché	None
émouvant	None
encarté	None
émerveilla	Third person Singular
laïcisant	None
révélé	None
tana	Third person Singular
précédaient	Third person Plural
frôla	Third person Singular
raccordassent	Third person Plural
imperméabilisé	None
oscillaient	Third person Plural
essayerait	Third person Singular
poussant	None
figera	Third person Singular
convainquant	None
arpentera	Third person Singular
charrieras	Second person Singular
chout	Third person Singular
rendormi	None
rutila	Third person Singular
abjura	Third person Singular
rapporteraient	Third person Plural
s’embourber	None
conrois	Second person Singular
métamorphiserez	Second person Plural
redota	Third person Singular
désactivera	Third person Singular
aventura	Third person Singular
desyrer	None
plaisantâtes	Second person Plural
camouflai	First person Singular
diligenta	Third person Singular
interdira	Third person Singular
desaencrer	None
arriverez	Second person Plural
méritaient	Third person Plural
escornant	None
démobilisèrent	Third person Plural
tracasser	None
désapprouvant	None
rançonner	None
labélisé	None
déprimer	None
géométrisât	Third person Singular
freinèrent	Third person Plural
dégagera	Third person Singular
désamarreraient	Third person Plural
antrespargnié	None
regratieriez	Second person Plural
réformèrent	Third person Plural
atucha	Third person Singular
urbaniserait	Third person Singular
resta	Third person Singular
cameras	Second person Singular
tailladai	First person Singular
videras	Second person Singular
remontera	Third person Singular
inhuma	Third person Singular
chassant	None
intrigua	Third person Singular
reteindre	None
assurèrent	Third person Plural
tait	Third person Singular
rencontreras	Second person Singular
remodelé	None
secouait	Third person Singular
diviseront	Third person Plural
beuglerai	First person Singular
essaima	Third person Singular
prélassèrent	Third person Plural
traduit	Third person Singular
gauder	None
réalignerai	First person Singular
galvanisant	None
freinerait	Third person Singular
téléversassiez	Second person Plural
intéresserons	First person Plural
querellèrent	Third person Plural
empêchait	Third person Singular
tirait	Third person Singular
vaincre	None
déportèrent	Third person Plural
emménageait	Third person Singular
rejeter	None
dégriffait	Third person Singular
grisonneraient	Third person Plural
synthétisa	Third person Singular
optimisant	None
questionnant	None
sercher	None
drogua	Third person Singular
préleva	Third person Singular
roidissant	None
relâcha	Third person Singular
ensuivre	None
écriraient	Third person Plural
trouvera	Third person Singular
changerai	First person Singular
acosta	Third person Singular
menait	Third person Singular
accepterez	Second person Plural
piz	Second person Singular
empoisonnèrent	Third person Plural
fréquentant	None
bougeant	None
dédiaient	Third person Plural
barguignissons	First person Plural
attireraient	Third person Plural
rencontrant	None
facilité	None
nuancé	None
lança	Third person Singular
arrimer	None
cillasses	Second person Singular
procureront	Third person Plural
laisseraient	Third person Plural
perturbait	Third person Singular
gambader	None
broutait	Third person Singular
assoira	Third person Singular
sucré	None
terminera	Third person Singular
monopolisassiez	Second person Plural
converger	None
médeciner	None
étalant	None
abandonnèrent	Third person Plural
chasserait	Third person Singular
célé	None
fixa	Third person Singular
menjant	None
ébraiseront	Third person Plural
trouvâmes	First person Plural
caractérisera	Third person Singular
blottîmes	First person Plural
anserrer	None
pelletât	Third person Singular
diabolisé	None
caria	Third person Singular
rétrogradant	None
récidiver	None
boirez	Second person Plural
épiloguant	None
indisposait	Third person Singular
balayaient	Third person Plural
tâtonné	None
grugeront	Third person Plural
attiédiront	Third person Plural
rachetèrent	Third person Plural
houasse	First person Singular
activait	Third person Singular
amati	None
pasmer	None
priverait	Third person Singular
renégocier	None
guis	Second person Singular
mastiquer	None
déclarer	None
confrontèrent	Third person Plural
oublierons	First person Plural
bêcher	None
dévoraient	Third person Plural
simplifierait	Third person Singular
travailleront	Third person Plural
échauffé	None
commenceraient	Third person Plural
souriait	Third person Singular
méprisas	Second person Singular
calomnieriez	Second person Plural
individualiser	None
mûrant	None
libèreront	Third person Plural
assombri	None
caponné	None
recrutera	Third person Singular
adorait	Third person Singular
imposât	Third person Singular
frayer	None
postulaient	Third person Plural
envenimant	None
réfèreront	Third person Plural
questions	First person Plural
mobilisa	Third person Singular
carous	Second person Singular
dopant	None
baignierent	Third person Plural
sanctionnerait	Third person Singular
direz	Second person Plural
prendras	Second person Singular
documentant	None
personnalisait	Third person Singular
relié	None
jouiraient	Third person Plural
s'antrehaï	Third person Singular
affouillasse	First person Singular
luitteroient	Third person Plural
dévorait	Third person Singular
pika	Third person Singular
obtient	Third person Singular
transporta	Third person Singular
emportèrent	Third person Plural
translater	None
perpétuèrent	Third person Plural
allumer	None
interna	Third person Singular
déferla	Third person Singular
irai	First person Singular
emballant	None
écouter	None
aveugla	Third person Singular
sévissaient	Third person Plural
excrèterez	Second person Plural
relâchèrent	Third person Plural
cliveras	Second person Singular
sachant	None
reviendraient	Third person Plural
rançonna	Third person Singular
employait	Third person Singular
redistribuait	Third person Singular
capitâtes	Second person Plural
expérimentera	Third person Singular
assuré	None
répondra	Third person Singular
unifiait	Third person Singular
acusa	Third person Singular
renforcé	None
sert	Third person Singular
remastérisasses	Second person Singular
concentrait	Third person Singular
remonta	Third person Singular
mouler	None
délectait	Third person Singular
décourageaient	Third person Plural
outras	Second person Singular
configurant	None
festoyé	None
retracerait	Third person Singular
séchant	None
approuvenderons	First person Plural
dépensèrent	Third person Plural
évangéliser	None
boursicoté	None
enquêtassions	First person Plural
obéirait	Third person Singular
séparera	Third person Singular
transfiguré	None
permissent	Third person Plural
segondissons	First person Plural
rejouait	Third person Singular
ensanglantèrent	Third person Plural
incorporera	Third person Singular
alliant	None
retrouva	Third person Singular
respirèrent	Third person Plural
monteplier	None
latinisa	Third person Singular
délirant	None
débarras	Second person Singular
consacrèrent	Third person Plural
paquâtes	Second person Plural
vendrait	Third person Singular
volait	Third person Singular
incorporerait	Third person Singular
préoccuper	None
retournait	Third person Singular
flamboyasses	Second person Singular
évaporera	Third person Singular
suscitera	Third person Singular
rêvait	Third person Singular
attendu	None
roussi	None
antendroie	First person Singular
bivouaquèrent	Third person Plural
sua	Third person Singular
musiqueras	Second person Singular
paralléliserez	Second person Plural
surmisé	None
manquait	Third person Singular
nettoyant	None
avèreront	Third person Plural
accompagnerait	Third person Singular
associait	Third person Singular
débloquerai	First person Singular
maillocher	None
viriliseront	Third person Plural
repassaient	Third person Plural
florît	Third person Singular
torpilla	Third person Singular
dépassionné	None
stressâtes	Second person Plural
schtroumpferont	Third person Plural
dévorèrent	Third person Plural
reversé	None
entreprendront	Third person Plural
pactisa	Third person Singular
accompliront	Third person Plural
avanteras	Second person Singular
réélut	Third person Singular
suns	Second person Singular
excrétas	Second person Singular
aymastes	Second person Plural
jeté	None
grattait	Third person Singular
affinerait	Third person Singular
redundant	None
transportait	Third person Singular
déclarerait	Third person Singular
réserveraient	Third person Plural
brodé	None
ressemelassent	Third person Plural
appartinssent	Third person Plural
appelleraient	Third person Plural
perfectionna	Third person Singular
naitront	Third person Plural
profilait	Third person Singular
suspendra	Third person Singular
ravi	None
éclosions	First person Plural
peiner	None
attendissions	First person Plural
défendrai	First person Singular
manja	Third person Singular
transmit	Third person Singular
prisé	None
signalera	Third person Singular
pendillé	None
fédérèrent	Third person Plural
plafonnant	None
croies	Second person Singular
canteras	Second person Singular
rouvrait	Third person Singular
entamait	Third person Singular
mélangeront	Third person Plural
nasaliser	None
arrosait	Third person Singular
surmiser	None
rajoutait	Third person Singular
franchirai	First person Singular
junas	Second person Singular
scintillaient	Third person Plural
enquêté	None
enterraient	Third person Plural
pasmeras	Second person Singular
rétracta	Third person Singular
menaçait	Third person Singular
asseurastes	Second person Plural
triait	Third person Singular
intentera	Third person Singular
incita	Third person Singular
transféré	None
redessinâmes	First person Plural
atreiiiens	First person Plural
renifler	None
pressurisé	None
sodomiser	None
durerait	Third person Singular
barra	Third person Singular
reprît	Third person Singular
prédisait	Third person Singular
repéré	None
rejoindront	Third person Plural
huchant	None
régnèrent	Third person Plural
ensuivait	Third person Singular
défibrinant	None
vaquant	None
déployèrent	Third person Plural
excipa	Third person Singular
illustrera	Third person Singular
négocierait	Third person Singular
grimpa	Third person Singular
fulminait	Third person Singular
triomphera	Third person Singular
estampiller	None
intronisa	Third person Singular
désabusé	None
quieres	Second person Singular
interagissant	None
écosserez	Second person Plural
gâtassent	Third person Plural
plongèrent	Third person Plural
jachérasses	Second person Singular
annulaient	Third person Plural
embouteilleras	Second person Singular
progresseraient	Third person Plural
convenir	None
arrivé	None
affairait	Third person Singular
zouké	None
fusionnant	None
cohabitaient	Third person Plural
suggéra	Third person Singular
goûtant	None
syndicalisant	None
procura	Third person Singular
alléguaient	Third person Plural
succéda	Third person Singular
compara	Third person Singular
avertissant	None
notifié	None
électrisa	Third person Singular
jalonné	None
barguignier	None
repérant	None
crédibilisai	First person Singular
fuyaient	Third person Plural
hua	Third person Singular
illuminaient	Third person Plural
interagira	Third person Singular
atterrissant	None
closes	Second person Singular
réjouîtes	Second person Plural
conditionner	None
rebuta	Third person Singular
engorgé	None
encourut	Third person Singular
aisa	Third person Singular
outrepassant	None
mordait	Third person Singular
atochier	None
orbiter	None
instituera	Third person Singular
surévaluerons	First person Plural
ressuscitait	Third person Singular
capoté	None
clôturé	None
conjuguant	None
désinformer	None
perla	Third person Singular
empierrait	Third person Singular
violas	Second person Singular
cosaisissant	None
commercialiseront	Third person Plural
désoler	None
huiler	None
attiraient	Third person Plural
mordra	Third person Singular
émettait	Third person Singular
remounter	None
ringardisasses	Second person Singular
décidâmes	First person Plural
déteindre	None
dépoussiérant	None
citeront	Third person Plural
circulaient	Third person Plural
resistant	None
caillé	None
manifestait	Third person Singular
singularisa	Third person Singular
sellé	None
positionnait	Third person Singular
réussira	Third person Singular
constateront	Third person Plural
rua	Third person Singular
minant	None
décapita	Third person Singular
misait	Third person Singular
mort	None
affichant	None
applaudissant	None
incrémentant	None
reviennes	Second person Singular
aquis	First person Singular
mugir	None
rythmaient	Third person Plural
rallier	None
râpant	None
touillait	Third person Singular
recommençait	Third person Singular
photographiera	Third person Singular
égorgeait	Third person Singular
esquiver	None
mutera	Third person Singular
dégrada	Third person Singular
départagé	None
culbuta	Third person Singular
dissuadé	None
forassions	First person Plural
présenter	None
affaibli	None
renationaliserez	Second person Plural
antidaté	None
édictait	Third person Singular
retord	Third person Singular
licencié	None
glouglouté	None
débarrassaient	Third person Plural
ensanglanter	None
dégrafasses	Second person Singular
nettoyaient	Third person Plural
conscientisé	None
patrouillé	None
ron	Second person Singular
nieront	Third person Plural
foncé	None
escoltastes	Second person Plural
éloignant	None
subvient	Third person Singular
flanquaient	Third person Plural
définirons	First person Plural
choquant	None
minèrent	Third person Plural
fascinait	Third person Singular
servira	Third person Singular
formalisera	Third person Singular
devouriez	Second person Plural
exorcisé	None
centré	None
ramer	None
remarié	None
célébraient	Third person Plural
existerait	Third person Singular
apeles	Second person Singular
toillasse	First person Singular
remorquaient	Third person Plural
gostai	First person Singular
garderas	Second person Singular
subjugué	None
essaucier	None
blanchissait	Third person Singular
assigna	Third person Singular
hisserons	First person Plural
contrariait	Third person Singular
enfourcher	None
calibras	Second person Singular
guideront	Third person Plural
affaissa	Third person Singular
dénuer	None
lixivier	None
embrasait	Third person Singular
peigner	None
incrustant	None
dénotant	None
dénommait	Third person Singular
séduit	Third person Singular
dévisageant	None
redevenant	None
enflammerait	Third person Singular
neutralisait	Third person Singular
collaborait	Third person Singular
putréfiera	Third person Singular
foireront	Third person Plural
sembleraient	Third person Plural
alloua	Third person Singular
doublé	None
explorèrent	Third person Plural
dépêcher	None
armoriâtes	Second person Plural
interprétait	Third person Singular
semassent	Third person Plural
rétorquera	Third person Singular
dosé	None
devrions	First person Plural
scandait	Third person Singular
renettoieriez	Second person Plural
cadrant	None
ventilâtes	Second person Plural
aparellier	None
mousquetonneraient	Third person Plural
suivirent	Third person Plural
dissimula	Third person Singular
excusait	Third person Singular
arbitrer	None
expliquaient	Third person Plural
contesteraient	Third person Plural
démarquait	Third person Singular
comptât	Third person Singular
dérobait	Third person Singular
rapprochant	None
compacta	Third person Singular
dépeindre	None
proscrit	Third person Singular
racontèrent	Third person Plural
médusa	Third person Singular
remontrait	Third person Singular
intéressera	Third person Singular
réassorti	None
succédaient	Third person Plural
décriraient	Third person Plural
surgissaient	Third person Plural
gaufrerait	Third person Singular
reniflant	None
eviter	None
escryastes	Second person Plural
retenait	Third person Singular
arc-boutera	Third person Singular
attardera	Third person Singular
forjas	Second person Singular
émasculé	None
joindra	Third person Singular
aboya	Third person Singular
comploterons	First person Plural
surédifieriez	Second person Plural
révolutionner	None
élargiront	Third person Plural
commer	None
durèrent	Third person Plural
niveler	None
chier	None
accorderez	Second person Plural
degasté	None
croupissait	Third person Singular
ociant	None
renouant	None
oublieras	Second person Singular
réindexant	None
répartirent	Third person Plural
cernaient	Third person Plural
jugeait	Third person Singular
conféraient	Third person Plural
rajouteront	Third person Plural
bleuté	None
séquestra	Third person Singular
outillassions	First person Plural
prolongeaient	Third person Plural
sévissait	Third person Singular
entaillant	None
ulcérassent	Third person Plural
gémissait	Third person Singular
huché	None
mésestimé	None
induira	Third person Singular
clignoteront	Third person Plural
catalogué	None
choisissait	Third person Singular
condamner	None
retaillassions	First person Plural
croisé	None
requérait	Third person Singular
apporterez	Second person Plural
soutenaient	Third person Plural
discuteront	Third person Plural
clarifiera	Third person Singular
sillonnât	Third person Singular
affairé	None
anastomosasses	Second person Singular
agrandiront	Third person Plural
représentera	Third person Singular
planquer	None
accuserait	Third person Singular
suivisses	Second person Singular
détinrent	Third person Plural
bouté	None
ramèneraient	Third person Plural
fréquenterait	Third person Singular
soulevèrent	Third person Plural
esbigné	None
insensibiliseriez	Second person Plural
resigner	None
devinait	Third person Singular
colleté	None
prévenaient	Third person Plural
intitulaient	Third person Plural
entrefiiiez	Second person Plural
bâtonnant	None
grésillé	None
relira	Third person Singular
plantas	Second person Singular
tasta	Third person Singular
encourageant	None
errait	Third person Singular
cerçoies	Second person Singular
triturai	First person Singular
cesseraient	Third person Plural
désolidarisé	None
innover	None
récuserai	First person Singular
surpassait	Third person Singular
saboté	None
fuité	None
permettraient	Third person Plural
remémora	Third person Singular
avantageait	Third person Singular
révoltera	Third person Singular
parrainé	None
bénéficiât	Third person Singular
dompta	Third person Singular
contesta	Third person Singular
suggéraient	Third person Plural
cabrant	None
profanas	Second person Singular
parcourait	Third person Singular
aliéné	None
héritaient	Third person Plural
pigeonner	None
désigna	Third person Singular
côtoyé	None
empressèrent	Third person Plural
tenta	Third person Singular
américanisé	None
permit	Third person Singular
iolyoient	Third person Plural
rivalisant	None
députèrent	Third person Plural
reparaît	Third person Singular
sort	Third person Singular
amincir	None
migrèrent	Third person Plural
osâtes	Second person Plural
embouteiller	None
trompaient	Third person Plural
cabré	None
vestes	Second person Singular
grossissaient	Third person Plural
éborgnaient	Third person Plural
relatera	Third person Singular
renoncerai	First person Singular
présidé	None
missionnant	None
hanta	Third person Singular
gênaient	Third person Plural
alertèrent	Third person Plural
garantiraient	Third person Plural
expliquerait	Third person Singular
retenaient	Third person Plural
retransmettra	Third person Singular
guia	Third person Singular
presenté	None
débutât	Third person Singular
murmuraient	Third person Plural
traverseront	Third person Plural
arrangeaient	Third person Plural
amplifiera	Third person Singular
sondèrent	Third person Plural
réenregistrant	None
aider	None
enceinta	Third person Singular
inquieter	None
repartagerions	First person Plural
bramant	None
figureraient	Third person Plural
grea	Third person Singular
laidengeas	Second person Singular
consommerait	Third person Singular
essayait	Third person Singular
idolâtrer	None
procez	Second person Singular
menai	First person Singular
justifier	None
stabilisera	Third person Singular
subît	Third person Singular
congèlerions	First person Plural
mata	Third person Singular
consommeraient	Third person Plural
brillait	Third person Singular
contrôler	None
vénérèrent	Third person Plural
esrasses	Second person Singular
dirait	Third person Singular
ajustera	Third person Singular
pinas	Second person Singular
corréler	None
existât	Third person Singular
dictait	Third person Singular
trempé	None
civilisé	None
intercalaient	Third person Plural
retranscrivit	Third person Singular
récolteront	Third person Plural
suppurant	None
gelait	Third person Singular
cédaient	Third person Plural
illustrerait	Third person Singular
démontra	Third person Singular
manacheriiens	First person Plural
remémorera	Third person Singular
rejoindra	Third person Singular
discriminer	None
témoigneraient	Third person Plural
baisant	None
ramoner	None
compteront	Third person Plural
hectarait	Third person Singular
résoudrait	Third person Singular
revint	Third person Singular
catcha	Third person Singular
forgea	Third person Singular
savent	Third person Plural
chauffer	None
allumera	Third person Singular
paupérisassiez	Second person Plural
détruisirent	Third person Plural
fomentaient	Third person Plural
mariant	None
épuiseront	Third person Plural
affaiblissait	Third person Singular
mercyant	None
manouvreroient	Third person Plural
dessineront	Third person Plural
fané	None
creançast	Third person Singular
supa	Third person Singular
internèrent	Third person Plural
déformer	None
convainquirent	Third person Plural
appliquerait	Third person Singular
médaillèrent	Third person Plural
écartait	Third person Singular
gaver	None
condensa	Third person Singular
transperça	Third person Singular
gaufreriez	Second person Plural
cotissant	None
tormenta	Third person Singular
invectivant	None
départementalisé	None
rétablira	Third person Singular
jasa	Third person Singular
allumé	None
spécifiait	Third person Singular
aviserait	Third person Singular
stationnait	Third person Singular
attendra	Third person Singular
déclarera	Third person Singular
verbalisé	None
révélait	Third person Singular
détient	Third person Singular
apprit	Third person Singular
bagarrerons	First person Plural
soudant	None
bétonnant	None
dépoussièrerions	First person Plural
initialisé	None
suivrons	First person Plural
importera	Third person Singular
rempliront	Third person Plural
submergea	Third person Singular
formulèrent	Third person Plural
releva	Third person Singular
taillaient	Third person Plural
réarranger	None
trainerai	First person Singular
cannas	Second person Singular
abondaient	Third person Plural
renouvellera	Third person Singular
contrediront	Third person Plural
traveillié	None
fâcha	Third person Singular
emblerons	First person Plural
plaisait	Third person Singular
concrétiseront	Third person Plural
courroucé	None
intercalant	None
accusaient	Third person Plural
excusassent	Third person Plural
déchirèrent	Third person Plural
escondesissons	First person Plural
zona	Third person Singular
entrelaçant	None
acquiert	Third person Singular
tablas	Second person Singular
hivernant	None
calculait	Third person Singular
recouvra	Third person Singular
effaceront	Third person Plural
renoncé	None
caqueta	Third person Singular
sojorné	None
inoculé	None
entreprirent	Third person Plural
renot	Third person Singular
quadrupler	None
dissoudre	None
paissait	Third person Singular
ripoliné	None
répugnait	Third person Singular
aorai	First person Singular
inférer	None
transféra	Third person Singular
gonfla	Third person Singular
rattrapât	Third person Singular
mesparlant	None
vriller	None
verserait	Third person Singular
escheïmes	First person Plural
coulissant	None
reforesteraient	Third person Plural
entachant	None
décolorant	None
amélioraient	Third person Plural
brocardas	Second person Singular
saoula	Third person Singular
complémentant	None
regnier	None
soumettront	Third person Plural
prendront	Third person Plural
coisas	Second person Singular
reherseriiens	First person Plural
listaient	Third person Plural
coiseroiz	Second person Plural
dispersait	Third person Singular
implanteront	Third person Plural
caramélisé	None
libéraient	Third person Plural
embarrasser	None
arivé	None
gangréna	Third person Singular
numérisé	None
dresceront	Third person Plural
bifurqua	Third person Singular
déliter	None
réunissant	None
inspirèrent	Third person Plural
rassasierai	First person Singular
retranchier	None
repiqué	None
empensastes	Second person Plural
écouté	None
décimaient	Third person Plural
lustrer	None
questionnaient	Third person Plural
convoquerez	Second person Plural
maîtrisait	Third person Singular
fera	Third person Singular
demanderait	Third person Singular
radina	Third person Singular
faucha	Third person Singular
revivait	Third person Singular
confondu	None
ébloui	None
recueillera	Third person Singular
charcuté	None
confierait	Third person Singular
délibérait	Third person Singular
connotant	None
postsynchroniser	None
redormirons	First person Plural
moillant	None
saurer	None
promirent	Third person Plural
étouffait	Third person Singular
éperonnassions	First person Plural
dégradera	Third person Singular
temptasses	Second person Singular
réexpédiassiez	Second person Plural
handicapaient	Third person Plural
adesera	Third person Singular
arrivaient	Third person Plural
adultèrerions	First person Plural
balayait	Third person Singular
slavisassent	Third person Plural
reconstruisirent	Third person Plural
recadrer	None
opposerait	Third person Singular
sécuriserai	First person Singular
transcrit	Third person Singular
querre	None
valida	Third person Singular
suivrait	Third person Singular
embelli	None
caractérisa	Third person Singular
répercuter	None
resforçant	None
stimulaient	Third person Plural
francisait	Third person Singular
fraîchissaient	Third person Plural
drainera	Third person Singular
soulas	Second person Singular
spécialisaient	Third person Plural
répudierons	First person Plural
englobait	Third person Singular
hasarda	Third person Singular
arrondissait	Third person Singular
ajouta	Third person Singular
clapas	Second person Singular
tisa	Third person Singular
négociera	Third person Singular
voudraient	Third person Plural
cédait	Third person Singular
présenté	None
imputas	Second person Singular
mangera	Third person Singular
alarmèrent	Third person Plural
déclineront	Third person Plural
despiroies	Second person Singular
autoproclamait	Third person Singular
satisfaisaient	Third person Plural
gamahuchait	Third person Singular
agaçait	Third person Singular
acquerrait	Third person Singular
musas	Second person Singular
surévaluer	None
précisa	Third person Singular
revoulussent	Third person Plural
affrontèrent	Third person Plural
enfantâtes	Second person Plural
préserver	None
fusionnera	Third person Singular
insèrerez	Second person Plural
progressa	Third person Singular
enluminé	None
abritait	Third person Singular
cimentèrent	Third person Plural
partageaient	Third person Plural
collectera	Third person Singular
écarta	Third person Singular
consistait	Third person Singular
mander	None
flourir	None
postulant	None
parviendras	Second person Singular
résidait	Third person Singular
masquera	Third person Singular
survenir	None
survolté	None
veuilles	Second person Singular
persisteront	Third person Plural
trémoussant	None
enflé	None
commerçant	None
vilipendasse	First person Singular
suffisaient	Third person Plural
retoqueriez	Second person Plural
doteront	Third person Plural
récupérait	Third person Singular
enthousiasma	Third person Singular
résina	Third person Singular
redécoupé	None
abordera	Third person Singular
réélit	Third person Singular
trôna	Third person Singular
placent	Third person Plural
ramifié	None
brasa	Third person Singular
tamisant	None
captivait	Third person Singular
apercevrez	Second person Plural
rassembleront	Third person Plural
encourrait	Third person Singular
entourner	None
rejecter	None
froisseraient	Third person Plural
repolitiser	None
connecterait	Third person Singular
signait	Third person Singular
contresigner	None
jetant	None
exauça	Third person Singular
emprisonnèrent	Third person Plural
impressionna	Third person Singular
planifiant	None
remuscla	Third person Singular
opterait	Third person Singular
étoufferait	Third person Singular
commencera	Third person Singular
échaudé	None
comptabiliser	None
effroieroient	Third person Plural
excréter	None
évoluaient	Third person Plural
retrouveras	Second person Singular
exécrassions	First person Plural
empreint	Third person Singular
topographié	None
contenait	Third person Singular
recevrez	Second person Plural
faiblissait	Third person Singular
chopé	None
enlisât	Third person Singular
institutionnaliseront	Third person Plural
remontant	None
éviteras	Second person Singular
farfouillaient	Third person Plural
trahi	None
pressentaient	Third person Plural
faufilé	None
tyras	Second person Singular
traumatisé	None
héliportasses	Second person Singular
téléguidé	None
ambulassions	First person Plural
modifia	Third person Singular
surutiliser	None
croirait	Third person Singular
vacillant	None
diraient	Third person Plural
rappela	Third person Singular
guéer	None
diminuas	Second person Singular
ietteras	Second person Singular
renouait	Third person Singular
éternisé	None
mitonnasse	First person Singular
renoua	Third person Singular
voguèrent	Third person Plural
séjournant	None
bondissant	None
malmené	None
légiféra	Third person Singular
parachevèrent	Third person Plural
cibler	None
dénucléariserons	First person Plural
auscultant	None
paramétrait	Third person Singular
travaillant	None
organisé	None
fraudant	None
pasoies	Second person Singular
échelonnait	Third person Singular
questionner	None
alertaient	Third person Plural
opposait	Third person Singular
annulait	Third person Singular
formulé	None
obtempérer	None
estimât	Third person Singular
shoota	Third person Singular
pénalisa	Third person Singular
déposséda	Third person Singular
absenté	None
attester	None
encollé	None
épuisaient	Third person Plural
préqualifier	None
abrogé	None
exercer	None
vassalisé	None
exulcérer	None
adressa	Third person Singular
tordait	Third person Singular
anterrissons	First person Plural
bloqueraient	Third person Plural
gréerai	First person Singular
accéda	Third person Singular
amplifiait	Third person Singular
adolcir	None
detranchié	None
soutiendraient	Third person Plural
prédominant	None
faussaient	Third person Plural
cherchèrent	Third person Plural
sponsorisa	Third person Singular
aliénèrent	Third person Plural
s’amouracher	None
trouvant	None
dotèrent	Third person Plural
couvraient	Third person Plural
commercialisa	Third person Singular
dévié	None
couchait	Third person Singular
désirera	Third person Singular
décarboné	None
accusera	Third person Singular
améliorerions	First person Plural
ventait	Third person Singular
catalysant	None
trier	None
sanz	Second person Singular
prédirait	Third person Singular
valorisa	Third person Singular
ieuneront	Third person Plural
réconciliait	Third person Singular
siégeait	Third person Singular
empoizonnast	Third person Singular
lutterait	Third person Singular
échappèrent	Third person Plural
axera	Third person Singular
reposerai	First person Singular
résonna	Third person Singular
griller	None
inspectaient	Third person Plural
snifferions	First person Plural
percutera	Third person Singular
excité	None
enjambé	None
montrerai	First person Singular
dirons	First person Plural
scellaient	Third person Plural
refroidir	None
placardé	None
abâtardirions	First person Plural
dépendraient	Third person Plural
verser	None
apprêterait	Third person Singular
justifièrent	Third person Plural
interdisant	None
ôter	None
situaient	Third person Plural
notas	Second person Singular
rossas	Second person Singular
périssait	Third person Singular
googlant	None
blasphémer	None
toussait	Third person Singular
dégouter	None
dérogé	None
lèverez	Second person Plural
ressouvenant	None
gaité	None
délabrait	Third person Singular
utilisât	Third person Singular
pommera	Third person Singular
pivoter	None
louvoyer	None
abaz	Second person Singular
objecta	Third person Singular
gaula	Third person Singular
accumulait	Third person Singular
réélire	None
auditionnait	Third person Singular
approfondira	Third person Singular
évertua	Third person Singular
attribua	Third person Singular
distingueront	Third person Plural
receüssoiz	Second person Plural
happa	Third person Singular
tracassait	Third person Singular
imbiberions	First person Plural
redressait	Third person Singular
agacera	Third person Singular
consumeraient	Third person Plural
ensegner	None
défraîchissant	None
cagua	Third person Singular
encouru	None
ponctionner	None
hospitalisé	None
refiler	None
conjoindrez	Second person Plural
gâtèrent	Third person Plural
raffermir	None
cramponnassions	First person Plural
libéralisé	None
argenté	None
fustigeaient	Third person Plural
renonça	Third person Singular
enchauçant	None
dégringoler	None
capturèrent	Third person Plural
handicapait	Third person Singular
tricotèrent	Third person Plural
relu	None
engenrasse	First person Singular
esparpiller	None
temporiseriez	Second person Plural
nettoyait	Third person Singular
assortiriez	Second person Plural
recouvrèrent	Third person Plural
improviser	None
hérité	None
berçant	None
observaient	Third person Plural
adoptaient	Third person Plural
rencontrer	None
réchauffaient	Third person Plural
kifferont	Third person Plural
failles	Second person Singular
vulcanisant	None
pressaient	Third person Plural
charmé	None
déploieront	Third person Plural
régressera	Third person Singular
entitulerent	Third person Plural
cicatrisier	None
compensaient	Third person Plural
raffinant	None
maltraitèrent	Third person Plural
terrai	First person Singular
afolé	None
vassalisasses	Second person Singular
ménagera	Third person Singular
gravita	Third person Singular
muntastes	Second person Plural
incluraient	Third person Plural
servirons	First person Plural
soit	Third person Singular
découvrirez	Second person Plural
regarnir	None
embrassant	None
devancera	Third person Singular
fissura	Third person Singular
déguisait	Third person Singular
enquêtait	Third person Singular
formeront	Third person Plural
ironiser	None
condensant	None
repentirions	First person Plural
évangélisait	Third person Singular
resuneriiez	Second person Plural
chassé	None
ravivé	None
opposer	None
accaparaient	Third person Plural
fut	Third person Singular
enchantant	None
abadassions	First person Plural
séduiront	Third person Plural
recommanderai	First person Singular
scié	None
cailla	Third person Singular
consultera	Third person Singular
éteindront	Third person Plural
déposait	Third person Singular
appelé	None
progresser	None
extrapola	Third person Singular
reservé	None
embrasserai	First person Singular
déjouèrent	Third person Plural
moucharder	None
lorgnaient	Third person Plural
scénariser	None
bâtissait	Third person Singular
mentionnait	Third person Singular
détirai	First person Singular
explicitant	None
hésitaient	Third person Plural
effaça	Third person Singular
sivi	First person Singular
agité	None
dédoubla	Third person Singular
séduisait	Third person Singular
rendît	Third person Singular
refaisant	None
rêvèrent	Third person Plural
bombardant	None
amnistia	Third person Singular
appâté	None
stupéfier	None
différé	None
accoucher	None
visionnait	Third person Singular
abasourdi	None
raffolé	None
préciserai	First person Singular
décorant	None
supersedant	None
bourgeonnassions	First person Plural
possédant	None
enfanter	None
pérenniser	None
contrastaient	Third person Plural
gratter	None
reconduisirent	Third person Plural
montrant	None
privilégiera	Third person Singular
débuta	Third person Singular
adopterait	Third person Singular
rejoignirent	Third person Plural
interdiraient	Third person Plural
bourdonnasses	Second person Singular
bosser	None
asséna	Third person Singular
décrochait	Third person Singular
menacer	None
afiasse	First person Singular
consentes	Second person Singular
contactera	Third person Singular
informera	Third person Singular
foulera	Third person Singular
nichié	None
coexistai	First person Singular
condamnaient	Third person Plural
governasses	Second person Singular
doutèrent	Third person Plural
destrecier	None
réduirai	First person Singular
dévalorisant	None
manqueront	Third person Plural
manifesta	Third person Singular
affûtât	Third person Singular
ébahir	None
catché	None
cadencé	None
affaiblirai	First person Singular
alterner	None
replacer	None
préfigurera	Third person Singular
envia	Third person Singular
hantai	First person Singular
attelant	None
ordonnera	Third person Singular
plongeaient	Third person Plural
représenter	None
enchassiez	Second person Plural
embellirent	Third person Plural
intervenu	None
avalasses	Second person Singular
crypté	None
confectionnait	Third person Singular
pesa	Third person Singular
encourait	Third person Singular
énamouré	None
amnistiant	None
affirmera	Third person Singular
empoisonné	None
éveillèrent	Third person Plural
envier	None
vérifier	None
génèreront	Third person Plural
envahiraient	Third person Plural
situeront	Third person Plural
marteler	None
décimerait	Third person Singular
resolves	Second person Singular
décapitant	None
emblavant	None
occuperiez	Second person Plural
doublerait	Third person Singular
entêtait	Third person Singular
rétracter	None
parfera	Third person Singular
stria	Third person Singular
enchéri	None
labélisèrent	Third person Plural
décevra	Third person Singular
épouser	None
souffriront	Third person Plural
persisterons	First person Plural
dépiauter	None
promulguèrent	Third person Plural
seront	Third person Plural
décompressé	None
recopia	Third person Singular
réinterpréta	Third person Singular
réquisitionna	Third person Singular
serpentassent	Third person Plural
ulcéré	None
éveillerait	Third person Singular
goba	Third person Singular
roussir	None
réduiraient	Third person Plural
tapotai	First person Singular
grêlé	None
pimenta	Third person Singular
agressé	None
endommager	None
révolteront	Third person Plural
émigrait	Third person Singular
prescrit	Third person Singular
harmoniserait	Third person Singular
broioient	Third person Plural
abolant	None
atrophias	Second person Singular
patienter	None
intercalait	Third person Singular
dirigeront	Third person Plural
provisionné	None
anticipa	Third person Singular
retrancheriiez	Second person Plural
surprendra	Third person Singular
éprendra	Third person Singular
confèrera	Third person Singular
raffolait	Third person Singular
remotivant	None
chicana	Third person Singular
béatifier	None
défaire	None
promit	Third person Singular
théorisa	Third person Singular
intenta	Third person Singular
déroutant	None
creusait	Third person Singular
écarterait	Third person Singular
œuvré	None
reconstituer	None
fustigea	Third person Singular
dénouera	Third person Singular
favorisaient	Third person Plural
connaîtras	Second person Singular
delibereroient	Third person Plural
substitua	Third person Singular
dessellasse	First person Singular
sursauté	None
écarquiller	None
advançant	None
charriant	None
pondérant	None
abjurant	None
survêtir	None
mommas	Second person Singular
élucubrant	None
violé	None
reçût	Third person Singular
portraiturer	None
asphalté	None
accouchaient	Third person Plural
observait	Third person Singular
connaît	Third person Singular
interviewa	Third person Singular
progressé	None
déclassifié	None
prétendaient	Third person Plural
saintefiant	None
recleimiiens	First person Plural
concluaient	Third person Plural
manipulera	Third person Singular
réchappèrent	Third person Plural
naquit	Third person Singular
moussas	Second person Singular
giclé	None
hacher	None
haïssait	Third person Singular
entoura	Third person Singular
calquer	None
longea	Third person Singular
refusionner	None
débarassé	None
arnaquer	None
atteindraient	Third person Plural
concédait	Third person Singular
appréciaient	Third person Plural
chercherait	Third person Singular
tant	Third person Singular
suffiront	Third person Plural
chalu	Third person Singular
accroîtra	Third person Singular
chiquerai	First person Singular
satisferait	Third person Singular
brosderai	First person Singular
budgétisasses	Second person Singular
ponctua	Third person Singular
quittera	Third person Singular
élu	None
allaictant	None
continuaient	Third person Plural
désignèrent	Third person Plural
écœurant	None
exhalât	Third person Singular
restructurerait	Third person Singular
tochissoiz	Second person Plural
enseler	None
retransmit	Third person Singular
dînaient	Third person Plural
gisait	Third person Singular
universalisassent	Third person Plural
récoltait	Third person Singular
révisèrent	Third person Plural
apposa	Third person Singular
achevaient	Third person Plural
anglicisa	Third person Singular
fractionnant	None
éduqua	Third person Singular
dureront	Third person Plural
semait	Third person Singular
envisagea	Third person Singular
participèrent	Third person Plural
compénétrant	None
publieront	Third person Plural
composait	Third person Singular
pelas	Second person Singular
instruisant	None
motiveront	Third person Plural
reproduisaient	Third person Plural
consolider	None
morus	Second person Singular
cicatriserez	Second person Plural
préchauffât	Third person Singular
consolera	Third person Singular
récriminait	Third person Singular
composé	None
masterisé	None
restreint	Third person Singular
armorié	None
gourmander	None
livrerai	First person Singular
proclameront	Third person Plural
conformerai	First person Singular
intitula	Third person Singular
accepteriez	Second person Plural
déchirera	Third person Singular
lassas	Second person Singular
vendangeasses	Second person Singular
limitant	None
dépensa	Third person Singular
établirait	Third person Singular
réinvité	None
massai	First person Singular
punirait	Third person Singular
afrayé	None
étala	Third person Singular
souciaient	Third person Plural
asses	Second person Singular
dénivelé	None
rentra	Third person Singular
malmena	Third person Singular
ennoya	Third person Singular
ordonna	Third person Singular
ignoreront	Third person Plural
dépeça	Third person Singular
concordaient	Third person Plural
réenregistré	None
violonant	None
appuyer	None
détournerait	Third person Singular
souhaitait	Third person Singular
élancerions	First person Plural
terminerait	Third person Singular
volaient	Third person Plural
subirez	Second person Plural
afubloit	Third person Singular
pressera	Third person Singular
ouvrir	None
déchiffré	None
assistât	Third person Singular
achèterait	Third person Singular
transgloutir	None
localisant	None
jugeant	None
démolira	Third person Singular
acclamait	Third person Singular
affinera	Third person Singular
contregarderez	Second person Plural
jaillissant	None
lavé	None
enyvrant	None
téléchargeait	Third person Singular
prieront	Third person Plural
surgelèrent	Third person Plural
dénaturer	None
correçassent	Third person Plural
commanderont	Third person Plural
participait	Third person Singular
mitiguant	None
mandas	Second person Singular
raccourcissait	Third person Singular
fayoteriez	Second person Plural
réarrangea	Third person Singular
permettrons	First person Plural
récitèrent	Third person Plural
supplanta	Third person Singular
apuia	Third person Singular
cosaisiriez	Second person Plural
amputera	Third person Singular
marina	Third person Singular
adossant	None
secondant	None
englobasses	Second person Singular
réintégrait	Third person Singular
guaitera	Third person Singular
denunchié	None
ratifia	Third person Singular
citera	Third person Singular
clôtureront	Third person Plural
alunissant	None
apparaissant	None
deportes	Second person Singular
repraesenterons	First person Plural
surestimasse	First person Singular
sévi	None
point	Third person Singular
gâtât	Third person Singular
maîtrisèrent	Third person Plural
titrisera	Third person Singular
couvaient	Third person Plural
renverront	Third person Plural
chuinterions	First person Plural
reculas	Second person Singular
matas	Second person Singular
valsé	None
tarderaient	Third person Plural
emménager	None
agiront	Third person Plural
prénommèrent	Third person Plural
avantageai	First person Singular
secourt	Third person Singular
vendraient	Third person Plural
encombrerait	Third person Singular
débutera	Third person Singular
commettrait	Third person Singular
recalé	None
scissionné	None
claustra	Third person Singular
observeras	Second person Singular
mommames	First person Plural
rétrocédant	None
immolassions	First person Plural
démâter	None
coaché	None
cousait	Third person Singular
jouira	Third person Singular
fanant	None
afféageriez	Second person Plural
rejoindre	None
exprimerait	Third person Singular
appliquerai	First person Singular
soignèrent	Third person Plural
émoustillé	None
convoyer	None
dévalisaient	Third person Plural
allouassiez	Second person Plural
rêvasser	None
replongeant	None
dévisager	None
totaliserons	First person Plural
dissiperait	Third person Singular
arborèrent	Third person Plural
enfantera	Third person Singular
bernera	Third person Singular
apothéosant	None
soulaiger	None
dégoûta	Third person Singular
sanctionna	Third person Singular
clôturant	None
pleut	Third person Singular
redonna	Third person Singular
remastérisé	None
rêverait	Third person Singular
mitiger	None
affaibliriez	Second person Plural
accélérèrent	Third person Plural
menassé	None
magasiné	None
noteras	Second person Singular
empierrer	None
avertira	Third person Singular
adulant	None
constituerai	First person Singular
attestant	None
encochant	None
corroborerait	Third person Singular
condamna	Third person Singular
chaussait	Third person Singular
immortalisant	None
approchèrent	Third person Plural
félicitèrent	Third person Plural
cocolant	None
referont	Third person Plural
ahurirent	Third person Plural
recomparaitront	Third person Plural
élanceront	Third person Plural
finança	Third person Singular
oseraient	Third person Plural
acceptaient	Third person Plural
gravissaient	Third person Plural
gigotèrent	Third person Plural
résisterait	Third person Singular
investiront	Third person Plural
datait	Third person Singular
souda	Third person Singular
carença	Third person Singular
respirant	None
collaborerait	Third person Singular
emmenaient	Third person Plural
réorganisa	Third person Singular
caractériseraient	Third person Plural
monitorâmes	First person Plural
ensaignast	Third person Singular
réintégrant	None
pollinisé	None
écrasaient	Third person Plural
raccourcirent	Third person Plural
bougea	Third person Singular
moulerez	Second person Plural
excava	Third person Singular
ressaisir	None
redoublaient	Third person Plural
souscrit	Third person Singular
repopularisasses	Second person Singular
constituant	None
obligeront	Third person Plural
reconnaitront	Third person Plural
fendirent	Third person Plural
misa	Third person Singular
pecchas	Second person Singular
joes	Second person Singular
paria	Third person Singular
déconsidéré	None
cartonné	None
déclarât	Third person Singular
haïra	Third person Singular
reprovant	None
enlisa	Third person Singular
déracinant	None
privait	Third person Singular
délaisser	None
épuisé	None
observerai	First person Singular
frottant	None
souriant	None
soperoiz	Second person Plural
sût	Third person Singular
empoteriez	Second person Plural
réapprend	Third person Singular
suivît	Third person Singular
apercevront	Third person Plural
proclamai	First person Singular
declaireroient	Third person Plural
tuns	Second person Singular
joignirent	Third person Plural
criminalisé	None
perpétraient	Third person Plural
cessât	Third person Singular
décrypté	None
cadra	Third person Singular
clavarder	None
coz	Second person Singular
cultivera	Third person Singular
respectaient	Third person Plural
intitulera	Third person Singular
renommeront	Third person Plural
contresigna	Third person Singular
continueront	Third person Plural
razzia	Third person Singular
nourri	None
facettas	Second person Singular
accélérait	Third person Singular
bougerai	First person Singular
déchu	None
draguerez	Second person Plural
éberlué	None
affadi	None
féliciteront	Third person Plural
supervisait	Third person Singular
brulaient	Third person Plural
éclata	Third person Singular
quast	Third person Singular
décideront	Third person Plural
cambriolé	None
éventra	Third person Singular
corrigerai	First person Singular
prétendraient	Third person Plural
bullas	Second person Singular
former	None
appartenaient	Third person Plural
vissai	First person Singular
écopaysager	None
assouvirait	Third person Singular
triompheriez	Second person Plural
dételassions	First person Plural
ralentiront	Third person Plural
exploseront	Third person Plural
tachant	None
pasai	First person Singular
gravi	None
effondreront	Third person Plural
esquachassiez	Second person Plural
serviront	Third person Plural
encagoulant	None
réécouté	None
exonéra	Third person Singular
prélèvera	Third person Singular
risquer	None
délité	None
imposait	Third person Singular
boycotteraient	Third person Plural
rédigerai	First person Singular
éliderai	First person Singular
incendièrent	Third person Plural
reconstituera	Third person Singular
découleront	Third person Plural
anuitant	None
beisames	First person Plural
éliminé	None
répondrait	Third person Singular
absorba	Third person Singular
ancrerai	First person Singular
périrent	Third person Plural
instaurer	None
indaguâtes	Second person Plural
débandèrent	Third person Plural
remportât	Third person Singular
trespasser	None
dénombraient	Third person Plural
s’ingénier	None
éclaboussa	Third person Singular
continuassent	Third person Plural
retrouverons	First person Plural
couvrant	None
dessaisir	None
égalerait	Third person Singular
ceignait	Third person Singular
percoler	None
excellèrent	Third person Plural
laissât	Third person Singular
élargissait	Third person Singular
obéissant	None
méritassiez	Second person Plural
renforceraient	Third person Plural
rafraîchir	None
vanter	None
distribuerait	Third person Singular
tretant	None
regretta	Third person Singular
deslier	None
cloisonnant	None
prouverait	Third person Singular
agitaient	Third person Plural
réoccupé	None
rajai	First person Singular
zébra	Third person Singular
ressemblait	Third person Singular
collectionnera	Third person Singular
équivaudrait	Third person Singular
renonçât	Third person Singular
contribué	None
écroulant	None
reviendras	Second person Singular
garantirait	Third person Singular
regagneront	Third person Plural
allâmes	First person Plural
surtaxé	None
brossait	Third person Singular
ignoraient	Third person Plural
roupiller	None
dissimulerait	Third person Singular
conquit	Third person Singular
revendiquerait	Third person Singular
talonnerait	Third person Singular
détournera	Third person Singular
effectuèrent	Third person Plural
fains	First person Singular
empoignerions	First person Plural
plaignirent	Third person Plural
puait	Third person Singular
nitrerez	Second person Plural
expédiaient	Third person Plural
saisir	None
désapprouvera	Third person Singular
plaquant	None
restituèrent	Third person Plural
impliquerai	First person Singular
gémi	None
creistreies	Second person Singular
raccompagner	None
liquéfié	None
branchant	None
sujurnerai	First person Singular
exploitaient	Third person Plural
prétendrait	Third person Singular
complexifiant	None
exploraient	Third person Plural
raffina	Third person Singular
doctrina	Third person Singular
acquittera	Third person Singular
étudieront	Third person Plural
désaimerait	Third person Singular
géométrisé	None
abouter	None
déchiraient	Third person Plural
ensevelirent	Third person Plural
étudièrent	Third person Plural
ressemblera	Third person Singular
covin	First person Singular
observeraient	Third person Plural
essayèrent	Third person Plural
attachassent	Third person Plural
massas	Second person Singular
châtieraient	Third person Plural
montreraient	Third person Plural
troer	None
rectifieras	Second person Singular
échappera	Third person Singular
constipasse	First person Singular
rassemblera	Third person Singular
occasionner	None
canoniser	None
saturant	None
menjast	Third person Singular
autodétruisissions	First person Plural
débarasserez	Second person Plural
rançonnaient	Third person Plural
privatisant	None
entraperçoit	Third person Singular
reformèrent	Third person Plural
déchiqueter	None
environnait	Third person Singular
réoublier	None
égorger	None
déchargea	Third person Singular
convertissant	None
choisiront	Third person Plural
interfacé	None
répercuta	Third person Singular
transformerait	Third person Singular
surimposé	None
quaillassent	Third person Plural
entretenait	Third person Singular
binotassent	Third person Plural
discourusse	First person Singular
relâcher	None
bloguer	None
mangeras	Second person Singular
administra	Third person Singular
entrerait	Third person Singular
contamina	Third person Singular
appuierait	Third person Singular
amadouer	None
chauviriez	Second person Plural
interprètera	Third person Singular
enchaînaient	Third person Plural
piocher	None
provint	Third person Singular
crapahutai	First person Singular
ramassaient	Third person Plural
élaboreront	Third person Plural
franchirent	Third person Plural
bransleroit	Third person Singular
étonner	None
déposaient	Third person Plural
fonctionna	Third person Singular
obéiront	Third person Plural
engamé	None
saluèrent	Third person Plural
bordas	Second person Singular
révisera	Third person Singular
exhumant	None
coprésidé	None
carboxylas	Second person Singular
bousculer	None
soufflé	None
fortifièrent	Third person Plural
extériorisé	None
deu	None
oraliser	None
désertèrent	Third person Plural
furent	Third person Plural
gaber	None
picoler	None
dinât	Third person Singular
affectaient	Third person Plural
ripostèrent	Third person Plural
osèrent	Third person Plural
crapoté	None
démultiplier	None
tombât	Third person Singular
sourcerai	First person Singular
dynamitèrent	Third person Plural
identifiait	Third person Singular
appertiser	None
gougé	None
maneceroit	Third person Singular
considèreraient	Third person Plural
vaincrons	First person Plural
enterrèrent	Third person Plural
fomenter	None
brochant	None
bonifié	None
rasera	Third person Singular
préserverait	Third person Singular
dises	Second person Singular
hâta	Third person Singular
enmeneriiez	Second person Plural
joignaient	Third person Plural
umiliant	None
conquérant	None
langui	None
empêcherons	First person Plural
rapprochait	Third person Singular
conlaudast	Third person Singular
refondit	Third person Singular
dénucléarisai	First person Singular
entraînait	Third person Singular
variaient	Third person Plural
restait	Third person Singular
broché	None
conviendra	Third person Singular
problématisasse	First person Singular
pleurait	Third person Singular
rodas	Second person Singular
guaaigneront	Third person Plural
bouclait	Third person Singular
générer	None
choisissant	None
escortaient	Third person Plural
chantèrent	Third person Plural
consacrait	Third person Singular
déléguaient	Third person Plural
ternirent	Third person Plural
sortait	Third person Singular
retrouveront	Third person Plural
électrifier	None
recuntoit	Third person Singular
essaiassent	Third person Plural
encouragerait	Third person Singular
sublimé	None
émigreront	Third person Plural
invaliderait	Third person Singular
fâchera	Third person Singular
picotant	None
consulteront	Third person Plural
simulait	Third person Singular
stockerait	Third person Singular
aimerez	Second person Plural
régularisé	None
bouffer	None
borda	Third person Singular
reverra	Third person Singular
caractérisaient	Third person Plural
mustrant	None
enfonça	Third person Singular
autoproclameras	Second person Singular
escaladèrent	Third person Plural
supplié	None
harra	Third person Singular
coffrant	None
pikeroiz	Second person Plural
pardonnèrent	Third person Plural
fétichiserions	First person Plural
médecineriez	Second person Plural
sortaient	Third person Plural
égorgèrent	Third person Plural
hâler	None
patrouillait	Third person Singular
déterrer	None
notera	Third person Singular
dormait	Third person Singular
adot	Third person Singular
tondre	None
raisonnaient	Third person Plural
forci	None
pryer	None
allouera	Third person Singular
guerroyait	Third person Singular
descendras	Second person Singular
enroulait	Third person Singular
agissaient	Third person Plural
renseignant	None
dénommé	None
triompheront	Third person Plural
obtenaient	Third person Plural
appartenait	Third person Singular
exploitait	Third person Singular
ensanglanteraient	Third person Plural
forcera	Third person Singular
réquisitionner	None
blaguait	Third person Singular
recalait	Third person Singular
confrontera	Third person Singular
parfit	Third person Singular
convoya	Third person Singular
préfaça	Third person Singular
encontrassions	First person Plural
driverions	First person Plural
cannibaliserions	First person Plural
entreprit	Third person Singular
correspondraient	Third person Plural
r'asseuroit	Third person Singular
réfrénèrent	Third person Plural
viserai	First person Singular
migrasse	First person Singular
habitait	Third person Singular
réchappera	Third person Singular
mordillant	None
débarasseront	Third person Plural
honoraient	Third person Plural
cloquer	None
liquéfier	None
préexistait	Third person Singular
sympathisé	None
retiraient	Third person Plural
tramblerons	First person Plural
chaussa	Third person Singular
construiront	Third person Plural
dénia	Third person Singular
meuglé	None
immortalisera	Third person Singular
engendrera	Third person Singular
proclama	Third person Singular
remettra	Third person Singular
ganseraient	Third person Plural
skater	None
combattait	Third person Singular
dégoûté	None
déambulaient	Third person Plural
élançaient	Third person Plural
délivrant	None
dévastait	Third person Singular
desconseillast	Third person Singular
rénovera	Third person Singular
enfermaient	Third person Plural
restreindraient	Third person Plural
trappassions	First person Plural
alit	Third person Singular
cesseras	Second person Singular
reherseroie	First person Singular
engallasse	First person Singular
décollé	None
réarrangeront	Third person Plural
houeront	Third person Plural
reflètera	Third person Singular
valorisait	Third person Singular
symbolisassent	Third person Plural
relativisé	None
habiterait	Third person Singular
délabrasse	First person Singular
tumoies	Second person Singular
recherchait	Third person Singular
endetta	Third person Singular
bucherons	First person Plural
ferrer	None
décérébré	None
acoquinâmes	First person Plural
reformaient	Third person Plural
débuterait	Third person Singular
flut	Third person Singular
pisté	None
moquera	Third person Singular
s’enamoureraient	Third person Plural
excellera	Third person Singular
grossira	Third person Singular
lissa	Third person Singular
gerbé	None
différai	First person Singular
compressant	None
arborisera	Third person Singular
dévoilera	Third person Singular
enchevêtrant	None
rendre	None
réaménagea	Third person Singular
obtiendraient	Third person Plural
esquiva	Third person Singular
carençait	Third person Singular
tyrannisaient	Third person Plural
clarifia	Third person Singular
cochonnasses	Second person Singular
récompensera	Third person Singular
dalla	Third person Singular
fertilisant	None
avèreraient	Third person Plural
répertoria	Third person Singular
domicilia	Third person Singular
éveillaient	Third person Plural
pinçait	Third person Singular
surconduire	None
contribuera	Third person Singular
adressera	Third person Singular
focalisaient	Third person Plural
battu	None
représentait	Third person Singular
romanisé	None
recensera	Third person Singular
manœuvraient	Third person Plural
témoignèrent	Third person Plural
siglasse	First person Singular
surprendront	Third person Plural
élucidai	First person Singular
trainèrent	Third person Plural
migra	Third person Singular
imputera	Third person Singular
structura	Third person Singular
reconnaitra	Third person Singular
hydrolyser	None
règneraient	Third person Plural
appartenu	None
désinfectas	Second person Singular
regretteras	Second person Singular
éclosant	None
entretenaient	Third person Plural
survint	Third person Singular
proviendront	Third person Plural
javellisé	None
exposerait	Third person Singular
fructefioient	Third person Plural
créditait	Third person Singular
confronta	Third person Singular
analysera	Third person Singular
obtenu	None
obtenir	None
maillant	None
atteindront	Third person Plural
arretera	Third person Singular
observa	Third person Singular
chuteront	Third person Plural
discrétisassions	First person Plural
défaillant	None
enfreindrait	Third person Singular
attrapera	Third person Singular
félicitait	Third person Singular
fantasia	Third person Singular
écrit	Third person Singular
lâcheront	Third person Plural
eritiiens	First person Plural
chauntant	None
récoltant	None
ravageait	Third person Singular
planifia	Third person Singular
cernant	None
plaisantaient	Third person Plural
surprit	Third person Singular
découlait	Third person Singular
jeta	Third person Singular
survenaient	Third person Plural
arpentant	None
fussent	Third person Plural
dégradèrent	Third person Plural
décrocheront	Third person Plural
introduirait	Third person Singular
misé	None
tasterons	First person Plural
élaborera	Third person Singular
concernèrent	Third person Plural
aiguiller	None
augmentaient	Third person Plural
promeut	Third person Singular
explosèrent	Third person Plural
restreignait	Third person Singular
gêna	Third person Singular
redoublant	None
munirent	Third person Plural
lapa	Third person Singular
insultaient	Third person Plural
accostaient	Third person Plural
permît	Third person Singular
habilité	None
siègeront	Third person Plural
haleras	Second person Singular
sila	Third person Singular
germé	None
reconnaîtrons	First person Plural
deschargié	None
choisissaient	Third person Plural
enquiquiner	None
falsifier	None
élirait	Third person Singular
engraignai	First person Singular
propageant	None
implantant	None
dégroupât	Third person Singular
chassaient	Third person Plural
écriront	Third person Plural
crècherait	Third person Singular
amorçaient	Third person Plural
gagnerait	Third person Singular
supervisa	Third person Singular
adira	Third person Singular
observasses	Second person Singular
baut	Third person Singular
bates	Second person Singular
décimeront	Third person Plural
échafauda	Third person Singular
cuver	None
sollicitèrent	Third person Plural
ment	Third person Singular
amènerai	First person Singular
quereleroient	Third person Plural
dialysant	None
grippé	None
déshérita	Third person Singular
redécouper	None
concrétisera	Third person Singular
désinfectant	None
fouillaient	Third person Plural
nonceroient	Third person Plural
consacrerai	First person Singular
traquaient	Third person Plural
cotant	None
noyauter	None
arrangeait	Third person Singular
forniroies	Second person Singular
reprennes	Second person Singular
étira	Third person Singular
communiqueraient	Third person Plural
ressentit	Third person Singular
suspendre	None
pilota	Third person Singular
défendait	Third person Singular
celâtes	Second person Plural
fritté	None
leise	Third person Singular
tigrant	None
vaquera	Third person Singular
mimer	None
geté	None
ombra	Third person Singular
confina	Third person Singular
vigilé	None
fauchant	None
reviendrons	First person Plural
travestir	None
appelait	Third person Singular
bloqueront	Third person Plural
acquiescèrent	Third person Plural
déprécier	None
dédaignaient	Third person Plural
transfigurera	Third person Singular
éviterez	Second person Plural
accueillaient	Third person Plural
dones	Second person Singular
saxophonasses	Second person Singular
référait	Third person Singular
liait	Third person Singular
doutera	Third person Singular
renoncèrent	Third person Plural
échauffait	Third person Singular
somatiser	None
démontant	None
nomes	Second person Singular
refroidirent	Third person Plural
rencontrerons	First person Plural
tromperont	Third person Plural
proposerons	First person Plural
encaustiquasse	First person Singular
coiffant	None
tersa	Third person Singular
fulgurât	Third person Singular
crucifiant	None
devenir	None
flouasse	First person Singular
tireront	Third person Plural
tanes	Second person Singular
refondant	None
procédant	None
réécrire	None
polissant	None
voulaient	Third person Plural
déclencha	Third person Singular
cavit	Third person Singular
assistaient	Third person Plural
accueillerons	First person Plural
matérialisé	None
bivouaqua	Third person Singular
ouvrirent	Third person Plural
detrancier	None
bénéficiait	Third person Singular
accentuera	Third person Singular
tuma	Third person Singular
brasser	None
déroberas	Second person Singular
pondait	Third person Singular
imposerai	First person Singular
récidiva	Third person Singular
publiait	Third person Singular
sélectionné	None
époustouflé	None
zigouiller	None
fabriquaient	Third person Plural
réalisaient	Third person Plural
jutas	Second person Singular
émaneraient	Third person Plural
personnifia	Third person Singular
nourrissant	None
recevaient	Third person Plural
adossait	Third person Singular
régira	Third person Singular
dénommèrent	Third person Plural
opta	Third person Singular
tressaillé	None
punissaient	Third person Plural
fendait	Third person Singular
recueillir	None
beurré	None
diaboliser	None
terminassent	Third person Plural
déraciner	None
blésant	None
atandes	Second person Singular
bavai	First person Singular
fermait	Third person Singular
fusillait	Third person Singular
plaidaient	Third person Plural
desfissent	Third person Plural
reprendrait	Third person Singular
survivre	None
breast	Third person Singular
ateint	Third person Singular
capitula	Third person Singular
déniait	Third person Singular
essayeront	Third person Plural
resiphonneras	Second person Singular
stoppa	Third person Singular
rehausser	None
dispersant	None
désaccordé	None
rembarrant	None
délivraient	Third person Plural
dynamisant	None
consignera	Third person Singular
paginé	None
coacherai	First person Singular
brocarder	None
jugea	Third person Singular
rissoler	None
conclurent	Third person Plural
lancer	None
apparierai	First person Singular
conduirai	First person Singular
coûteront	Third person Plural
peller	None
plairont	Third person Plural
constituait	Third person Singular
populariseront	Third person Plural
badasse	First person Singular
emménagera	Third person Singular
bâtissaient	Third person Plural
réarmé	None
carbonisaient	Third person Plural
réhabituer	None
zieutaient	Third person Plural
ironisa	Third person Singular
dialoguaient	Third person Plural
relia	Third person Singular
prolongerait	Third person Singular
nuisîmes	First person Plural
multiplièrent	Third person Plural
agitant	None
comprimé	None
répudia	Third person Singular
propageasse	First person Singular
répartissait	Third person Singular
menaceriiez	Second person Plural
chaînas	Second person Singular
rouas	Second person Singular
advient	Third person Singular
osai	First person Singular
caoutchouteront	Third person Plural
déglaçâtes	Second person Plural
saloperas	Second person Singular
atterrirent	Third person Plural
implantas	Second person Singular
galvanisa	Third person Singular
souffrirait	Third person Singular
considèrerait	Third person Singular
féliciterai	First person Singular
détaillât	Third person Singular
exproprier	None
périclitait	Third person Singular
grevassiez	Second person Plural
désigneront	Third person Plural
dévoyer	None
baratter	None
essaimera	Third person Singular
opposerai	First person Singular
détériora	Third person Singular
popularisait	Third person Singular
émargeant	None
cofinancer	None
rentabilisant	None
peinturlurassiez	Second person Plural
enfanteras	Second person Singular
peuplait	Third person Singular
trahir	None
attaquèrent	Third person Plural
vécut	Third person Singular
écrasant	None
développa	Third person Singular
amonestera	Third person Singular
astien	Second person Singular
parvint	Third person Singular
retirât	Third person Singular
consommaient	Third person Plural
écrabouillâmes	First person Plural
ralieras	Second person Singular
trairons	First person Plural
oseriez	Second person Plural
brassa	Third person Singular
participa	Third person Singular
dépêtrassiez	Second person Plural
investira	Third person Singular
désintégrait	Third person Singular
montreront	Third person Plural
clicher	None
rassemblait	Third person Singular
repliait	Third person Singular
plaies	Second person Singular
encadré	None
succèderait	Third person Singular
concourra	Third person Singular
rééquilibré	None
virera	Third person Singular
lyer	None
professèrent	Third person Plural
enbuschier	None
concentrerait	Third person Singular
compactant	None
quichant	None
harnacher	None
terni	None
gabant	None
axa	Third person Singular
propulsait	Third person Singular
classera	Third person Singular
sombrera	Third person Singular
éplucherions	First person Plural
vaguer	None
esposa	Third person Singular
applaudissaient	Third person Plural
délimiter	None
collectionna	Third person Singular
mélangeaient	Third person Plural
surnommeront	Third person Plural
prohiba	Third person Singular
pagaya	Third person Singular
aanchroient	Third person Plural
assisterait	Third person Singular
unifièrent	Third person Plural
défrichèrent	Third person Plural
tanas	Second person Singular
desevriiens	First person Plural
cerques	Second person Singular
marchant	None
versas	Second person Singular
déhanchera	Third person Singular
appareillait	Third person Singular
poons	First person Plural
violerait	Third person Singular
userait	Third person Singular
volerait	Third person Singular
enflammera	Third person Singular
rallieraient	Third person Plural
charroyé	None
remplissait	Third person Singular
damnifïes	Second person Singular
expliqueront	Third person Plural
occulter	None
officialiserait	Third person Singular
enconcher	None
entretiendrait	Third person Singular
déroula	Third person Singular
élargirait	Third person Singular
promouvrait	Third person Singular
déchoit	Third person Singular
caparaçonné	None
attend	Third person Singular
inscrit	Third person Singular
factura	Third person Singular
déchaînera	Third person Singular
baragouinerez	Second person Plural
quadrillaient	Third person Plural
revoyait	Third person Singular
coopéra	Third person Singular
persistait	Third person Singular
désacralisé	None
juta	Third person Singular
commandera	Third person Singular
endimancherons	First person Plural
asticoter	None
attient	Third person Singular
catchant	None
abolirent	Third person Plural
confessera	Third person Singular
jouissait	Third person Singular
arsis	Second person Singular
creva	Third person Singular
foiré	None
étouffaient	Third person Plural
hallucinant	None
remportait	Third person Singular
nouns	Second person Singular
réformait	Third person Singular
retranscrit	Third person Singular
enceinter	None
entraperçu	None
levaient	Third person Plural
weyvant	None
délivrerai	First person Singular
iodler	None
pondu	None
remontait	Third person Singular
chalonger	None
pliera	Third person Singular
affruiterions	First person Plural
collaborèrent	Third person Plural
aboutira	Third person Singular
mitraillé	None
escaladait	Third person Singular
accorderai	First person Singular
bombarda	Third person Singular
dresçames	First person Plural
condamneront	Third person Plural
contribuait	Third person Singular
insufflèrent	Third person Plural
retranscrire	None
déparerait	Third person Singular
primeras	Second person Singular
lemmatisera	Third person Singular
rigolait	Third person Singular
ravagera	Third person Singular
déserté	None
offert	None
regnes	Second person Singular
rétabli	None
ferlerez	Second person Plural
recevait	Third person Singular
excelleraient	Third person Plural
abriteraient	Third person Plural
manipulerait	Third person Singular
plierait	Third person Singular
endossaient	Third person Plural
fleuré	None
endimanché	None
liké	None
dominer	None
emprosasses	Second person Singular
sécularisa	Third person Singular
délaissait	Third person Singular
incarnait	Third person Singular
télédiffusé	None
reprend	Third person Singular
ennuierai	First person Singular
jeûnait	Third person Singular
dispersera	Third person Singular
calmerait	Third person Singular
jeûnaient	Third person Plural
garderaient	Third person Plural
contrôlèrent	Third person Plural
conseillier	None
ôtaient	Third person Plural
requit	Third person Singular
abrogea	Third person Singular
rafler	None
folâtrer	None
assirent	Third person Plural
corrélé	None
copiant	None
turna	Third person Singular
rapetissé	None
ramassèrent	Third person Plural
établissaient	Third person Plural
ferras	Second person Singular
affrontaient	Third person Plural
squattériser	None
écrivît	Third person Singular
dotaient	Third person Plural
guetta	Third person Singular
parait	Third person Singular
trouvât	Third person Singular
chauvirai	First person Singular
scia	Third person Singular
consolidera	Third person Singular
achètera	Third person Singular
régulariser	None
possèderait	Third person Singular
regrettèrent	Third person Plural
anglaisant	None
colchié	None
allier	None
rodé	None
choisira	Third person Singular
tordant	None
dénouant	None
émergé	None
vivrez	Second person Plural
remplaça	Third person Singular
provoquai	First person Singular
surnommer	None
traitaient	Third person Plural
correspondirent	Third person Plural
complotant	None
blousassions	First person Plural
réserva	Third person Singular
vail	First person Singular
rebroussa	Third person Singular
précipiteraient	Third person Plural
embaumer	None
executé	None
bousculaient	Third person Plural
développerait	Third person Singular
gaspiller	None
tuna	Third person Singular
encaissant	None
occuperons	First person Plural
sacrifierait	Third person Singular
suda	Third person Singular
dégradait	Third person Singular
cacheront	Third person Plural
nourriraient	Third person Plural
suppurer	None
limai	First person Singular
giclas	Second person Singular
zippait	Third person Singular
succédé	None
interpréta	Third person Singular
redevenait	Third person Singular
cosigna	Third person Singular
maltraitant	None
basèrent	Third person Plural
longeait	Third person Singular
anéantirait	Third person Singular
dégoisâtes	Second person Plural
cessait	Third person Singular
publia	Third person Singular
insufflera	Third person Singular
trança	Third person Singular
subvertissant	None
signalisant	None
bousillassiez	Second person Plural
empilant	None
révolutionnerait	Third person Singular
dépêcha	Third person Singular
réarrangé	None
mélangea	Third person Singular
perturbera	Third person Singular
eures	Second person Singular
épiloguait	Third person Singular
alimenteront	Third person Plural
priait	Third person Singular
renouera	Third person Singular
décourageait	Third person Singular
procureraient	Third person Plural
agaçaient	Third person Plural
enraya	Third person Singular
constata	Third person Singular
accréditait	Third person Singular
indignait	Third person Singular
zaïrianiser	None
maintînt	Third person Singular
siphonner	None
racheté	None
butina	Third person Singular
consentaient	Third person Plural
douai	First person Singular
distinguerait	Third person Singular
ébrasant	None
existaient	Third person Plural
claustras	Second person Singular
consentirait	Third person Singular
commémora	Third person Singular
commença	Third person Singular
retransférassiez	Second person Plural
succeda	Third person Singular
déconnant	None
pester	None
inspirera	Third person Singular
tranché	None
essayeraient	Third person Plural
marcotter	None
stimulé	None
opposeraient	Third person Plural
déraisonnerez	Second person Plural
approvisionna	Third person Singular
illustreraient	Third person Plural
transigea	Third person Singular
affubleront	Third person Plural
soucié	None
escamotait	Third person Singular
faint	Third person Singular
légua	Third person Singular
oserait	Third person Singular
dépensé	None
adhérèrent	Third person Plural
répondront	Third person Plural
coécrit	Third person Singular
ociroiz	Second person Plural
sommant	None
paillasse	First person Singular
contrôleraient	Third person Plural
plongeront	Third person Plural
faucherions	First person Plural
fonctionnaient	Third person Plural
fissionné	None
romançâtes	Second person Plural
utiliseriez	Second person Plural
carras	Second person Singular
enchantera	Third person Singular
réfuter	None
authentifièrent	Third person Plural
pista	Third person Singular
débouta	Third person Singular
batist	Third person Singular
rayonnera	Third person Singular
parduna	Third person Singular
quidant	None
aimai	First person Singular
raviverons	First person Plural
fédéraient	Third person Plural
démordra	Third person Singular
procréé	None
délégué	None
arriveront	Third person Plural
vulgarisant	None
rachetant	None
censurant	None
réfuta	Third person Singular
détenaient	Third person Plural
soula	Third person Singular
réapprenant	None
inspectèrent	Third person Plural
trouver	None
franchir	None
monoacylant	None
notait	Third person Singular
ironisera	Third person Singular
curu	Third person Singular
redundiiens	First person Plural
tolèrera	Third person Singular
allégua	Third person Singular
tarderont	Third person Plural
désignaient	Third person Plural
approcherait	Third person Singular
jurèrent	Third person Plural
gageant	None
interromprait	Third person Singular
tournicoteraient	Third person Plural
japonisant	None
encourt	Third person Singular
tarai	First person Singular
traduisirent	Third person Plural
roeleroie	First person Singular
remplaçaient	Third person Plural
contribueront	Third person Plural
reversa	Third person Singular
observerait	Third person Singular
inaugurait	Third person Singular
touffait	Third person Singular
flinguer	None
accomplissait	Third person Singular
continrent	Third person Plural
solliciterait	Third person Singular
insultâmes	First person Plural
serré	None
ouvré	None
catégorisé	None
activera	Third person Singular
fineroient	Third person Plural
réoccupèrent	Third person Plural
bigler	None
remez	Second person Singular
empresseront	Third person Plural
laschassiez	Second person Plural
taster	None
culasse	First person Singular
japoniserait	Third person Singular
orientera	Third person Singular
caré	None
fes	Second person Singular
grimaçaient	Third person Plural
affaira	Third person Singular
communiquera	Third person Singular
ressusciterait	Third person Singular
reconvertira	Third person Singular
écrémé	None
équilibrant	None
confirmaient	Third person Plural
intimer	None
choisît	Third person Singular
succombera	Third person Singular
inféré	None
exalté	None
immigrèrent	Third person Plural
amorcera	Third person Singular
séchas	Second person Singular
considèreront	Third person Plural
caréner	None
évoluait	Third person Singular
complètera	Third person Singular
réalisait	Third person Singular
dessoulé	None
déplaît	Third person Singular
diagnostiquèrent	Third person Plural
sépara	Third person Singular
encaserné	None
évaluera	Third person Singular
rassérénant	None
pivotasse	First person Singular
séquestrant	None
desroutant	None
répéta	Third person Singular
emménagea	Third person Singular
leira	Third person Singular
trimeras	Second person Singular
punaisant	None
apporterai	First person Singular
trémoussèrent	Third person Plural
explicitera	Third person Singular
desgorgeant	None
résumait	Third person Singular
renforcir	None
botta	Third person Singular
effacera	Third person Singular
rencontreraient	Third person Plural
échiner	None
croupir	None
émergea	Third person Singular
commentaient	Third person Plural
prolongier	None
redéfinissant	None
momma	Third person Singular
pâtirent	Third person Plural
purifié	None
aencreroies	Second person Singular
planifié	None
accumula	Third person Singular
saignier	None
consulterai	First person Singular
boulai	First person Singular
fauché	None
entourlouper	None
décantant	None
rejetas	Second person Singular
firent	Third person Plural
éloignerait	Third person Singular
monoalkylant	None
guerroyé	None
proposai	First person Singular
redistribuant	None
reparu	None
tarabistouillé	None
briguant	None
préférant	None
collaient	Third person Plural
contrepoisé	None
idéalisant	None
étirera	Third person Singular
ébranlerai	First person Singular
étronçonnassions	First person Plural
accrédita	Third person Singular
executions	First person Plural
brida	Third person Singular
convenaient	Third person Plural
peinait	Third person Singular
relirai	First person Singular
réuniront	Third person Plural
endurait	Third person Singular
enverront	Third person Plural
séjournera	Third person Singular
ajouterait	Third person Singular
fauterez	Second person Plural
réexporté	None
mobilisassent	Third person Plural
tartiner	None
cognant	None
relança	Third person Singular
rembourser	None
barrissant	None
raviné	None
chapeautait	Third person Singular
serainerent	Third person Plural
es	Second person Singular
domineront	Third person Plural
spécialisant	None
entraimer	None
contesterai	First person Singular
gravissait	Third person Singular
recontacté	None
signèrent	Third person Plural
inversa	Third person Singular
béa	Third person Singular
planta	Third person Singular
émigrera	Third person Singular
waz	Second person Singular
opprimait	Third person Singular
pénètrera	Third person Singular
demanderont	Third person Plural
approché	None
explicitait	Third person Singular
remerqueras	Second person Singular
tortillas	Second person Singular
classerai	First person Singular
kayakant	None
dispersé	None
licencia	Third person Singular
acuinter	None
insufflerait	Third person Singular
recoupaient	Third person Plural
satellisé	None
garderont	Third person Plural
engendré	None
soulaigerai	First person Singular
sciait	Third person Singular
fuguerait	Third person Singular
répondant	None
enveloppa	Third person Singular
hé	Second person Singular
poussera	Third person Singular
transmettraient	Third person Plural
explosera	Third person Singular
prononçaient	Third person Plural
dériva	Third person Singular
entrechoqué	None
décapitera	Third person Singular
dactylographié	None
croustillant	None
bastonné	None
imputa	Third person Singular
devenaient	Third person Plural
subiuguierai	First person Singular
urai	First person Singular
attendront	Third person Plural
évacuera	Third person Singular
survécurent	Third person Plural
exalta	Third person Singular
fascinera	Third person Singular
fermaient	Third person Plural
esbauchassiez	Second person Plural
commerçaient	Third person Plural
résider	None
occupaient	Third person Plural
redevint	Third person Singular
acétalisas	Second person Singular
declairant	None
perturbèrent	Third person Plural
regroupèrent	Third person Plural
voyagèrent	Third person Plural
professaient	Third person Plural
citèrent	Third person Plural
prônâmes	First person Plural
confrontaient	Third person Plural
jouiront	Third person Plural
assurera	Third person Singular
veulent	Third person Plural
sauté	None
croiseraient	Third person Plural
égalisera	Third person Singular
vomissait	Third person Singular
distançant	None
codifiait	Third person Singular
compatissant	None
engouffrait	Third person Singular
changerons	First person Plural
argentera	Third person Singular
inventé	None
cumulait	Third person Singular
farci	None
agissait	Third person Singular
bêchassions	First person Plural
traluire	None
repayaient	Third person Plural
éliminèrent	Third person Plural
stimulèrent	Third person Plural
mesureront	Third person Plural
épousaient	Third person Plural
réprima	Third person Singular
confortèrent	Third person Plural
annoncera	Third person Singular
reietté	None
paraphant	None
ajouterez	Second person Plural
décapitèrent	Third person Plural
éduquera	Third person Singular
magnétoscoperaient	Third person Plural
maquillé	None
barbera	Third person Singular
réceptionnant	None
fatiguant	None
spiralé	None
installait	Third person Singular
réveillant	None
procurerait	Third person Singular
inhumer	None
coutera	Third person Singular
végéter	None
évitèrent	Third person Plural
voyageant	None
préfiguraient	Third person Plural
étouffé	None
desservirent	Third person Plural
restituera	Third person Singular
alimenta	Third person Singular
cliva	Third person Singular
officialisait	Third person Singular
commencerons	First person Plural
usai	First person Singular
pronostiquer	None
suant	None
traitera	Third person Singular
payerait	Third person Singular
démentit	Third person Singular
bouleversaient	Third person Plural
forçait	Third person Singular
masturber	None
rapportaient	Third person Plural
imbibant	None
hosta	Third person Singular
privatisa	Third person Singular
annonça	Third person Singular
dédommagerai	First person Singular
normas	Second person Singular
argüeront	Third person Plural
boulottâmes	First person Plural
dédia	Third person Singular
recrutèrent	Third person Plural
octroyèrent	Third person Plural
vouer	None
entoilâmes	First person Plural
signifiera	Third person Singular
rusant	None
maitrisait	Third person Singular
permet	Third person Singular
chargèrent	Third person Plural
mutilé	None
inséré	None
halas	Second person Singular
restèrent	Third person Plural
ficelât	Third person Singular
voueront	Third person Plural
décomposait	Third person Singular
amuseront	Third person Plural
labeurs	Second person Singular
arrimé	None
scorait	Third person Singular
vendaient	Third person Plural
brouderent	Third person Plural
inaugurera	Third person Singular
enchemisas	Second person Singular
reconduirait	Third person Singular
éberluait	Third person Singular
lister	None
échangea	Third person Singular
seller	None
confira	Third person Singular
anticipait	Third person Singular
clôturer	None
juraient	Third person Plural
condoléancé	None
oralisât	Third person Singular
transportèrent	Third person Plural
protestas	Second person Singular
lamas	Second person Singular
référé	None
armait	Third person Singular
soumettait	Third person Singular
rimait	Third person Singular
complèteront	Third person Plural
gacha	Third person Singular
convoyé	None
contemplaient	Third person Plural
affermaient	Third person Plural
empiétaient	Third person Plural
dépendit	Third person Singular
déconstruit	Third person Singular
aspirant	None
détournait	Third person Singular
vivra	Third person Singular
pardonnerait	Third person Singular
metre	None
supprimèrent	Third person Plural
ligoté	None
membrasse	First person Singular
déchiffrait	Third person Singular
dilaté	None
trias	Second person Singular
convolas	Second person Singular
soumettrait	Third person Singular
convertiraient	Third person Plural
résisté	None
nouant	None
aerera	Third person Singular
évoqua	Third person Singular
conditionneront	Third person Plural
poignant	None
bricolé	None
bagarrer	None
munissant	None
glisserait	Third person Singular
désinvestirons	First person Plural
catchera	Third person Singular
t’énamourerais	Second person Singular
induirait	Third person Singular
rasaient	Third person Plural
couvrirent	Third person Plural
perdrions	First person Plural
qualifieraient	Third person Plural
bornaient	Third person Plural
cisaillassiez	Second person Plural
électrifiant	None
strier	None
commenceront	Third person Plural
persista	Third person Singular
dégobilleras	Second person Singular
réfugiaient	Third person Plural
prenent	Third person Plural
transhumé	None
sécurisé	None
jauja	Third person Singular
pèseraient	Third person Plural
assortir	None
circoncisant	None
lutta	Third person Singular
adora	Third person Singular
encerclait	Third person Singular
sied	Third person Singular
désorientant	None
déformaient	Third person Plural
sanctionnera	Third person Singular
stockant	None
vend	Third person Singular
sous-dosassent	Third person Plural
remplacerait	Third person Singular
satisferaient	Third person Plural
épargnaient	Third person Plural
séchaient	Third person Plural
intimideriez	Second person Plural
reconterai	First person Singular
viseraient	Third person Plural
stoppaient	Third person Plural
disculpa	Third person Singular
vez	Second person Singular
entrefaisions	First person Plural
traverserai	First person Singular
aggravera	Third person Singular
fortifiaient	Third person Plural
defublant	None
contrecarra	Third person Singular
brouetter	None
décrit	Third person Singular
dresserait	Third person Singular
corrigèrent	Third person Plural
éluant	None
fiscaliser	None
désobligeant	None
rompirent	Third person Plural
abdiquèrent	Third person Plural
cristallisait	Third person Singular
téléverserai	First person Singular
envoyaient	Third person Plural
essaimât	Third person Singular
élut	Third person Singular
défîtes	Second person Plural
soudait	Third person Singular
grimperont	Third person Plural
aiguilletant	None
éveiller	None
abstint	Third person Singular
entrevoir	None
minimiserait	Third person Singular
devrait	Third person Singular
spécifiera	Third person Singular
déçu	None
dégonfler	None
zigzaguasses	Second person Singular
tocquerez	Second person Plural
cercler	None
prononcèrent	Third person Plural
accommodera	Third person Singular
encaissait	Third person Singular
baisseront	Third person Plural
levèrent	Third person Plural
réécrivant	None
argumentait	Third person Singular
écloses	Second person Singular
chaïr	None
concoururent	Third person Plural
ressemblant	None
apareillé	None
divorcera	Third person Singular
surprenaient	Third person Plural
embroudes	Second person Singular
abuser	None
franchiront	Third person Plural
sous-estimer	None
entamaient	Third person Plural
offrirait	Third person Singular
montreras	Second person Singular
invoquera	Third person Singular
ébousinerons	First person Plural
expatrièrent	Third person Plural
utilisera	Third person Singular
ressert	Third person Singular
multipliant	None
craindra	Third person Singular
consolidaient	Third person Plural
refusant	None
rayonna	Third person Singular
récupèrerait	Third person Singular
rôdant	None
fuisse	First person Singular
agrafant	None
fermera	Third person Singular
essuyait	Third person Singular
acculèrent	Third person Plural
étayant	None
apparenterait	Third person Singular
établirent	Third person Plural
fâcher	None
franchisé	None
parfait	Third person Singular
berginisâmes	First person Plural
échangèrent	Third person Plural
adultèreras	Second person Singular
bordait	Third person Singular
surdimensionnassent	Third person Plural
ard	Third person Singular
jalousâmes	First person Plural
espluchant	None
bâillassent	Third person Plural
attarderai	First person Singular
dégoûter	None
desprisoné	None
capoteras	Second person Singular
conformerait	Third person Singular
redéfinirai	First person Singular
catchait	Third person Singular
honorerait	Third person Singular
adonisâmes	First person Plural
témoignerait	Third person Singular
commettraient	Third person Plural
refilèrent	Third person Plural
empoisonna	Third person Singular
eschaperiiens	First person Plural
protègera	Third person Singular
bloguassions	First person Plural
aboutirai	First person Singular
aveuglant	None
retomberont	Third person Plural
récusèrent	Third person Plural
hivernait	Third person Singular
afficheraient	Third person Plural
assaillait	Third person Singular
putréfier	None
fusionnèrent	Third person Plural
profiteront	Third person Plural
désignait	Third person Singular
ignifugé	None
reformulé	None
regarda	Third person Singular
brassaient	Third person Plural
jurait	Third person Singular
ciselant	None
priera	Third person Singular
subirons	First person Plural
acoquiné	None
assiégèrent	Third person Plural
recunfortames	First person Plural
qualifia	Third person Singular
déchiquèterions	First person Plural
rentrait	Third person Singular
relevé	None
éclatera	Third person Singular
indagué	None
anatomiseraient	Third person Plural
complémenté	None
siffler	None
confondit	Third person Singular
moucha	Third person Singular
arqua	Third person Singular
insuffler	None
régionalisassions	First person Plural
salasses	Second person Singular
député	None
dégonflé	None
coutassent	Third person Plural
miterait	Third person Singular
bricolait	Third person Singular
persévérait	Third person Singular
joignant	None
croisa	Third person Singular
larguèrent	Third person Plural
patrouillant	None
accumuleront	Third person Plural
baptisant	None
badigeonné	None
paramétrant	None
coaillastes	Second person Plural
ahurant	None
encensé	None
retravaillé	None
écorçant	None
interrompait	Third person Singular
invectivas	Second person Singular
énonça	Third person Singular
miraculant	None
déjeûnant	None
assurerait	Third person Singular
épousa	Third person Singular
huas	Second person Singular
aimât	Third person Singular
plusse	First person Singular
figeait	Third person Singular
effectuerai	First person Singular
absolutisé	None
comptait	Third person Singular
raliassent	Third person Plural
abordait	Third person Singular
gênerait	Third person Singular
bornant	None
moqua	Third person Singular
suspendisse	First person Singular
jugerait	Third person Singular
recouvrerait	Third person Singular
veilla	Third person Singular
border	None
ascendit	Third person Singular
dénuder	None
alternèrent	Third person Plural
paralyserait	Third person Singular
zester	None
entreront	Third person Plural
ferai	First person Singular
posant	None
épuisera	Third person Singular
obvia	Third person Singular
réintroduisit	Third person Singular
déclenchait	Third person Singular
surpassèrent	Third person Plural
accordaient	Third person Plural
déstructuré	None
ralliait	Third person Singular
collectaient	Third person Plural
obstruait	Third person Singular
pulvérisait	Third person Singular
préparera	Third person Singular
résistèrent	Third person Plural
lâchant	None
distinguera	Third person Singular
singler	None
immatriculeras	Second person Singular
râpé	None
entrevit	Third person Singular
fortifia	Third person Singular
entroublïé	None
rouèrent	Third person Plural
afrayer	None
demoré	None
écoperont	Third person Plural
cambré	None
retourner	None
excursionnant	None
déséquilibrerait	Third person Singular
sermonné	None
countrefis	First person Singular
épouseras	Second person Singular
relatait	Third person Singular
glaçait	Third person Singular
rejouera	Third person Singular
occultera	Third person Singular
caoutchoutant	None
pérennisera	Third person Singular
bêché	None
gênerai	First person Singular
assommera	Third person Singular
rétractèrent	Third person Plural
songeant	None
manifesterons	First person Plural
rouspété	None
garant	None
embellir	None
dévalèrent	Third person Plural
déconnecteront	Third person Plural
murmurait	Third person Singular
leva	Third person Singular
essuya	Third person Singular
merda	Third person Singular
dopait	Third person Singular
endossant	None
envahiront	Third person Plural
déclinaient	Third person Plural
écraser	None
épanchant	None
moquaient	Third person Plural
examinait	Third person Singular
perpétuera	Third person Singular
pena	Third person Singular
voudrez	Second person Plural
bruslerons	First person Plural
recenseriez	Second person Plural
agoniser	None
pilotait	Third person Singular
blinder	None
couvrira	Third person Singular
malmenait	Third person Singular
marinas	Second person Singular
interpella	Third person Singular
couvrait	Third person Singular
épurant	None
murant	None
discréditèrent	Third person Plural
doctriné	None
terminant	None
gagné	None
désemparé	None
gober	None
égorgeant	None
ennuieraient	Third person Plural
enrayé	None
faillit	Third person Singular
subir	None
larguaient	Third person Plural
partiraient	Third person Plural
copieras	Second person Singular
atocha	Third person Singular
correspond	Third person Singular
aprocher	None
cité	None
codétient	Third person Singular
gansa	Third person Singular
songeaient	Third person Plural
data	Third person Singular
raisonner	None
appointa	Third person Singular
révéla	Third person Singular
maîtrisai	First person Singular
survenu	None
submerger	None
livrera	Third person Singular
présiderait	Third person Singular
operant	None
rocka	Third person Singular
entourèrent	Third person Plural
torner	None
analysant	None
conduisit	Third person Singular
rembourserait	Third person Singular
découlerait	Third person Singular
reliaient	Third person Plural
divisé	None
engouffra	Third person Singular
mascheriez	Second person Plural
demanderai	First person Singular
informatisé	None
embrochant	None
manquerons	First person Plural
sèmera	Third person Singular
résigné	None
ternir	None
produisit	Third person Singular
peignit	Third person Singular
lavera	Third person Singular
falistes	Second person Plural
éclaireront	Third person Plural
séduirait	Third person Singular
cumula	Third person Singular
défiscaliser	None
imposeraient	Third person Plural
réinsérant	None
saviez	Second person Plural
changeras	Second person Singular
approchait	Third person Singular
camas	Second person Singular
flouant	None
ahana	Third person Singular
emmenasse	First person Singular
perturbé	None
justes	Second person Singular
promènera	Third person Singular
suffixât	Third person Singular
pences	Second person Singular
empêcha	Third person Singular
découpa	Third person Singular
brandira	Third person Singular
galocher	None
transitait	Third person Singular
stockera	Third person Singular
escoffierait	Third person Singular
subsisteront	Third person Plural
remodelant	None
enflant	Third person Singular
corrigera	Third person Singular
démangeassiez	Second person Plural
coincèrent	Third person Plural
dirai	First person Singular
prônèrent	Third person Plural
