љубезно	Adjective
метална	Adjective
електрон	Noun
братската	Adjective
патолошкиов	Adjective
зоолозите	Noun
латвиското	Adjective
месец	Noun
разделба	Noun
смоква	Noun
решивме	Verb
куглање	Masdar
мокревме	Verb
детектор	Noun
кралско	Adjective
судиме	Verb
цифрите	Noun
подучуваат	Verb
отпорникот	Noun
воодушевувале	Participle
конзервативна	Adjective
непокор	Noun
имињата	Noun
грешни	Adjective
комората	Noun
бесконечен	Adjective
горни	Adjective
илјадалетиено	Noun
убиеме	Verb
асфалтиран	Participle
вратат	Verb
подигнав	Verb
виулициве	Noun
природниот	Adjective
придонесувам	Verb
манекенка	Noun
моделот	Noun
доживување	Masdar
невремињана	Noun
врежевте	Verb
починало	Participle
споредуваме	Verb
задолжителниот	Adjective
охрабрило	Participle
главниот	Adjective
фокусирал	Participle
расново	Adjective
одбран	Participle
видливоста	Noun
познати	Adjective
освоиле	Participle
направел	Participle
свршеникот	Noun
издржливава	Adjective
монасите	Noun
бозоните	Noun
кажувам	Verb
диктира	Verb
забавите	Verb
постигне	Verb
цитиран	Participle
статииве	Noun
свештеника	Noun
складот	Noun
бањање	Masdar
заградување	Masdar
обезбедите	Verb
сериозните	Adjective
ножниов	Adjective
нула	Noun
традиционален	Adjective
постанокот	Noun
косинус	Noun
стрмен	Adjective
тврдат	Verb
одмаздат	Verb
параванот	Noun
интимно	Adjective
надминев	Verb
триковите	Noun
доток	Noun
поништува	Verb
зрелиот	Adjective
мерел	Participle
армијата	Noun
напреднала	Participle
учествувал	Participle
повраќаат	Verb
атеист	Noun
новородена	Adjective
покојната	Adjective
падобранот	Noun
фонолошка	Adjective
доба	Noun
пропорционалниот	Adjective
филтрирајте	Verb
австриско	Adjective
безживотно	Adjective
нежен	Adjective
психолошкиот	Adjective
префрлило	Participle
конечна	Adjective
пердувот	Noun
крабите	Noun
смрдиме	Verb
параграфот	Noun
кривевте	Verb
исечен	Participle
колат	Verb
вработувала	Participle
штиклирање	Masdar
планиравме	Verb
зашилен	Participle
возбудлив	Adjective
премиер	Noun
бучните	Adjective
исенчиле	Participle
најдоа	Verb
износов	Noun
паничен	Adjective
танц	Noun
последните	Adjective
имаа	Verb
древното	Adjective
поистоветела	Participle
шведскана	Adjective
загрижуваат	Verb
дувала	Participle
амброзијана	Noun
изградил	Participle
рамноправните	Adjective
каучук	Noun
полицајците	Noun
дезинфекцијата	Noun
речам	Verb
добротворствоно	Noun
жнееш	Verb
симетричен	Adjective
мистериозниов	Adjective
потпишала	Participle
смртна	Adjective
гладна	Adjective
испиле	Participle
застапување	Masdar
додева	Verb
одиш	Verb
броејќи	Converb
трајниов	Adjective
облакодерите	Noun
смртоносно	Adjective
исчистите	Verb
продуцентите	Noun
напредувале	Participle
сервиса	Noun
мазен	Adjective
правоаголните	Adjective
пушел	Participle
просечното	Adjective
задолжителната	Adjective
кубон	Noun
споредбениот	Adjective
првава	Adjective
џаболебарине	Noun
рекламирање	Masdar
замка	Noun
молба	Noun
законито	Adjective
алкохол	Noun
изедначуваш	Verb
осет	Noun
задоволило	Participle
беспредметнана	Adjective
сонило	Participle
симетричните	Adjective
одбранат	Verb
декларирала	Participle
поставив	Verb
оствариме	Verb
физиолошкине	Adjective
водоземни	Adjective
велот	Noun
судбо	Noun
плашливците	Noun
засилат	Verb
располагаат	Verb
сага	Noun
понел	Participle
прицврстувала	Participle
наречеме	Verb
срушат	Verb
глобализира	Verb
работиме	Verb
воспоставувал	Participle
подредувајќи	Converb
религија	Noun
претседателот	Noun
одолеало	Participle
стрелата	Noun
попуштиле	Participle
кукливе	Noun
лае	Verb
дестилациине	Noun
естонскине	Adjective
тренирам	Verb
стишале	Participle
бибер	Noun
престрелките	Noun
кадифено	Noun
портокаловото	Adjective
стега	Verb
макотрпни	Adjective
демоните	Noun
повела	Participle
зборуваш	Verb
почекам	Verb
спорото	Adjective
покорување	Masdar
ефикасен	Adjective
хиероглифот	Noun
бесконечни	Adjective
преработила	Participle
југоисточни	Adjective
делумниот	Adjective
милувате	Verb
утринско	Adjective
употребам	Verb
формален	Adjective
поништуваат	Verb
ланчево	Noun
гордата	Adjective
раскошна	Adjective
тажен	Adjective
користен	Participle
касајте	Verb
пукнеме	Verb
настројуваа	Verb
седмата	Adjective
остварувал	Participle
мешунката	Noun
птичја	Adjective
лизгалкине	Noun
преведи	Verb
изедначија	Verb
сардисување	Masdar
ќерките	Noun
смарагдот	Noun
утврдувале	Participle
естетсково	Adjective
оговарчке	Noun
малубројната	Adjective
преткатнику	Noun
пуштиме	Verb
одобрување	Masdar
функционирало	Participle
потерата	Noun
поддржале	Participle
емоциите	Noun
граматичките	Adjective
одложила	Participle
сатира	Noun
црвот	Noun
афион	Noun
смарагд	Noun
одвоен	Participle
прочитај	Verb
големи	Adjective
социјалниот	Adjective
црепна	Noun
полжавите	Noun
продажни	Adjective
продажбата	Noun
претставиме	Verb
безобѕирен	Adjective
комплицирана	Adjective
стврднува	Verb
дозволува	Verb
виолетова	Adjective
небото	Noun
пржен	Participle
попречува	Verb
врежав	Verb
протезата	Noun
огништево	Noun
упатствата	Noun
корнишонот	Noun
статут	Noun
наводното	Adjective
јаките	Adjective
издавачот	Noun
прислушкување	Masdar
добив	Verb
митовите	Noun
врескота	Noun
пригоднана	Adjective
одморал	Participle
фрлач	Noun
партизанка	Noun
прикладен	Adjective
моторџикава	Noun
окупиран	Participle
демне	Verb
потенцирам	Verb
методите	Noun
предвремената	Adjective
доверат	Verb
ниските	Adjective
контактирање	Masdar
бифтек	Noun
склучело	Participle
провалите	Verb
плочине	Noun
трауматични	Adjective
брачно	Adjective
делат	Verb
вагонов	Noun
иницијатива	Noun
бившиве	Adjective
бил	Participle
донирање	Masdar
позицииве	Noun
идеологијата	Noun
татковата	Adjective
именсконо	Adjective
напневме	Verb
сервисот	Noun
поништуван	Participle
удирајќи	Converb
атомите	Noun
обноват	Verb
воздишката	Noun
пресечен	Participle
одмарање	Masdar
патриотските	Adjective
хрватската	Adjective
микроскопското	Adjective
тажниот	Adjective
турен	Participle
јагленот	Noun
верувал	Participle
мрсните	Adjective
препишат	Verb
предложувам	Verb
пешачење	Masdar
царските	Adjective
собно	Adjective
погоните	Noun
ноќни	Adjective
граѓанското	Adjective
холестеролот	Noun
побарај	Verb
вознемирував	Verb
истоштени	Adjective
жирито	Noun
учебник	Noun
необичната	Adjective
израмнат	Verb
мирољубивата	Adjective
културната	Adjective
алузија	Noun
ѕевгар	Noun
гребев	Verb
клиентката	Noun
ренесанса	Noun
необичново	Adjective
кочницата	Noun
еленот	Noun
немавме	Verb
минијатурни	Adjective
свртиме	Verb
нанесела	Participle
цветале	Participle
изедначувајќи	Converb
депортира	Verb
иде	Verb
оловно	Adjective
одговорно	Adjective
нуркајќи	Converb
објектот	Noun
проследевте	Verb
исцрпиле	Participle
затегне	Verb
виолетовава	Adjective
викал	Participle
правосмукалка	Noun
натрупаат	Verb
прераскажав	Verb
синтаксата	Noun
запцине	Noun
видат	Verb
изгледало	Participle
ориентирање	Masdar
загрозувајќи	Converb
наводот	Noun
автобуса	Noun
крцнела	Participle
поткренам	Verb
малечкото	Adjective
вечерниве	Adjective
доверливото	Adjective
следете	Verb
гостинка	Noun
бившиот	Adjective
запознае	Verb
западнана	Adjective
јаремов	Noun
малтретирајќи	Converb
чешмата	Noun
жилите	Noun
лебедово	Adjective
виола	Noun
напредувал	Participle
самана	Adjective
продаден	Participle
фудбалско	Adjective
блесок	Noun
вечната	Adjective
нанел	Participle
одразете	Verb
лабавата	Adjective
квадрата	Noun
грижливо	Adjective
молекуларните	Adjective
отседнев	Verb
објава	Noun
капетан	Noun
претставника	Noun
налетува	Verb
вклучила	Participle
развивајќи	Converb
либерална	Adjective
љубим	Adjective
сексизмот	Noun
интимната	Adjective
макотрпната	Adjective
медитираме	Verb
почине	Verb
географска	Adjective
забиберевме	Verb
пазарот	Noun
вознемируваат	Verb
катастрофално	Adjective
бота	Noun
детекторот	Noun
комисијата	Noun
спасен	Participle
погребале	Participle
вообичаеното	Adjective
балтијава	Noun
забната	Adjective
одоброволувавме	Verb
акнел	Participle
тактикине	Noun
поддржувал	Participle
хром	Noun
дводневно	Adjective
испаднал	Participle
сториш	Verb
каснеле	Participle
синџирот	Noun
програмскиве	Adjective
глумицата	Noun
поместил	Participle
распуштените	Adjective
залудна	Adjective
создаваат	Verb
спремате	Verb
семејните	Adjective
оценија	Verb
натрупување	Masdar
учествувала	Participle
земјиштана	Noun
етичко	Adjective
браќата	Noun
автограм	Noun
одѕив	Noun
часовничариве	Noun
аждеров	Noun
пума	Noun
пазарската	Adjective
злосторствата	Noun
краткорочната	Adjective
соборија	Verb
тврдел	Participle
миров	Noun
временската	Adjective
долгиот	Adjective
зададат	Verb
градска	Adjective
битието	Noun
растураа	Verb
излегла	Participle
објаснете	Verb
пубертетлијава	Noun
штитниците	Noun
изострен	Participle
уништат	Verb
аркада	Noun
маска	Noun
загрозуваат	Verb
повредиле	Participle
виолинана	Noun
палец	Noun
задржале	Participle
дезинфекцијо	Noun
чкрипам	Verb
потпаднала	Participle
жалел	Participle
тромавите	Adjective
издржливоста	Noun
придружничкине	Noun
капите	Noun
отстранив	Verb
ненадејните	Adjective
нулата	Noun
узенгија	Noun
побожно	Adjective
гушневме	Verb
составила	Participle
петел	Noun
добрино	Noun
затвореничка	Noun
проверевте	Verb
невидлива	Adjective
пријатно	Adjective
растопело	Participle
стеблово	Noun
задремаа	Verb
кроткава	Adjective
разрешиме	Verb
неправилно	Adjective
братсконо	Adjective
врбана	Noun
нездрав	Adjective
мрзливи	Adjective
отмениот	Adjective
резонирање	Masdar
соодветниот	Adjective
обесхрабрило	Participle
населуваат	Verb
стаорецот	Noun
збунува	Verb
Македонец	Noun
заживеале	Participle
прогонството	Noun
проститутките	Noun
алатон	Noun
исфрлиле	Participle
бескорисноста	Noun
кафето	Noun
дува	Verb
возрасна	Adjective
солен	Adjective
јаболковион	Adjective
чуло	Participle
цвеќаркана	Noun
поставуван	Participle
препуштиле	Participle
камилине	Noun
белките	Noun
економско	Adjective
неутронот	Noun
католик	Noun
бранител	Noun
карактерите	Noun
темната	Adjective
укинувајќи	Converb
објавуваме	Verb
двојните	Adjective
почувствуван	Participle
градинава	Noun
тинејџерките	Noun
заедничко	Adjective
активните	Adjective
шеснаесетгодишниве	Adjective
контејнерот	Noun
борбеноста	Noun
приватен	Adjective
попречило	Participle
значенската	Adjective
шарлатан	Noun
мироносец	Noun
загубите	Verb
тестис	Noun
расплакувај	Verb
бакнувајќи	Converb
одговорната	Adjective
ориентацијата	Noun
заменуваат	Verb
осрамотете	Verb
бабускерите	Noun
чудесна	Adjective
покрстев	Verb
соученик	Noun
славеја	Noun
суров	Adjective
ека	Noun
надворешна	Adjective
испотев	Verb
прасечко	Adjective
дискусиите	Noun
алкохоличар	Noun
нанало	Participle
литванскиот	Adjective
експериментира	Verb
преправал	Participle
провоцирајте	Verb
таткото	Noun
дај	Verb
ослепува	Verb
груба	Adjective
зевнам	Verb
безмернана	Adjective
стеблата	Noun
обвинителот	Noun
сведочел	Participle
осигурајте	Verb
ѕвончето	Noun
кокошарницине	Noun
утроеја	Verb
втемелен	Participle
оценила	Participle
неутрализирање	Masdar
убивме	Verb
озлогласениот	Adjective
осилоно	Noun
маслата	Noun
бургијата	Noun
одбрал	Participle
заробувале	Participle
стремен	Noun
кошулите	Noun
множеа	Verb
романтизмот	Noun
одрекла	Participle
вонредното	Adjective
нашла	Participle
словенскиот	Adjective
потфрлил	Participle
почетната	Adjective
полнолетнине	Adjective
шпекулација	Noun
змеј	Noun
честица	Noun
забиваат	Verb
соединува	Verb
вештачкиот	Adjective
хипотезите	Noun
ранат	Verb
поматен	Participle
одлучила	Participle
готовите	Adjective
течеле	Participle
ткаен	Participle
насилна	Adjective
лачен	Participle
тиреана	Noun
расеанине	Adjective
распределувате	Verb
очигледното	Adjective
плашилава	Noun
изменило	Participle
монголските	Adjective
забрзан	Participle
оставија	Verb
ставил	Participle
брате	Noun
прехрана	Noun
колибите	Noun
средствата	Noun
повлекување	Masdar
споредливо	Adjective
опишуван	Participle
честота	Noun
мие	Verb
црковни	Adjective
вир	Noun
моралната	Adjective
неписмено	Adjective
запише	Verb
правник	Noun
загинаа	Verb
крварат	Verb
прилагодувајќи	Converb
дождовна	Adjective
внатрешните	Adjective
произвеле	Participle
задржувала	Participle
одмотаме	Verb
коцка	Noun
разместен	Participle
заживее	Verb
течејќи	Converb
залудни	Adjective
разгалувате	Verb
полињата	Noun
шпицот	Noun
комплетните	Adjective
металиве	Noun
петка	Noun
оправдувам	Verb
речнана	Adjective
потрошувачот	Noun
вклучете	Verb
однесувањата	Noun
совршени	Adjective
преминувај	Verb
ноздрите	Noun
летување	Masdar
невротичен	Adjective
комисијана	Noun
нанеле	Participle
лососот	Noun
весела	Adjective
занемарлива	Adjective
решавала	Participle
трагичен	Adjective
бездушното	Adjective
прасето	Noun
деветтолетката	Noun
женствено	Adjective
апчево	Noun
пустата	Adjective
современа	Adjective
пливачкиот	Adjective
притискале	Participle
споделувал	Participle
натпреварување	Masdar
потекнувал	Participle
должниот	Adjective
Шпанец	Noun
кастрирал	Participle
давал	Participle
текстовите	Noun
замирисам	Verb
возрасниот	Adjective
колебање	Masdar
институциине	Noun
ловџијата	Noun
лажела	Participle
нерамни	Adjective
евидентирање	Masdar
скудни	Adjective
делотворна	Adjective
покорни	Adjective
галиите	Noun
сонам	Verb
бисквитите	Noun
извеснион	Adjective
ирското	Adjective
скратеницата	Noun
терапија	Noun
можи	Verb
копулацијана	Noun
правоаголно	Adjective
економската	Adjective
промените	Verb
русокосиве	Adjective
доведувала	Participle
бизарнине	Adjective
атмосферското	Adjective
преживеале	Participle
обвинувал	Participle
религиозните	Adjective
смолите	Noun
плетенките	Noun
подол	Adjective
црногорската	Adjective
составувал	Participle
вторична	Adjective
потрошувач	Noun
данско	Adjective
ламите	Noun
пазарна	Adjective
крошна	Noun
одредува	Verb
цитоплазмата	Noun
мјузиклот	Noun
нападнале	Participle
венеат	Verb
оделе	Participle
трпелива	Adjective
собарка	Noun
реалист	Noun
разменувал	Participle
манастирот	Noun
пружаат	Verb
досегашните	Adjective
промил	Participle
посвоил	Participle
доведуваат	Verb
најдевме	Verb
вештачкото	Adjective
зрнесто	Adjective
клоновите	Noun
доброволна	Adjective
лепезите	Noun
задавајќи	Converb
гимнастичар	Noun
пловидбата	Noun
храмот	Noun
искористивме	Verb
лексика	Noun
поткрене	Verb
урамила	Participle
доловил	Participle
упатам	Verb
занемарен	Participle
старосватовите	Noun
шипко	Noun
мраз	Noun
добата	Noun
умножуван	Participle
извршиле	Participle
рапаво	Adjective
темен	Adjective
магија	Noun
среќаваат	Verb
морската	Adjective
странското	Adjective
словачкото	Adjective
деветта	Adjective
одзел	Participle
празот	Noun
самурај	Noun
произведувала	Participle
станицата	Noun
наострела	Participle
полн	Adjective
темпераментен	Adjective
најди	Verb
струмичкото	Adjective
добиен	Participle
тековиве	Noun
отсвирија	Verb
сменила	Participle
испаѓа	Verb
ѕидарите	Noun
ментален	Adjective
езерцава	Noun
надгледуван	Participle
катапулт	Noun
споменуван	Participle
брзиот	Adjective
трпен	Participle
топка	Noun
процедура	Noun
неповолни	Adjective
кларинет	Noun
засилен	Participle
влажниот	Adjective
доцната	Adjective
регистрираат	Verb
копјата	Noun
соработување	Masdar
облога	Noun
гондола	Noun
дружеле	Participle
лажливи	Adjective
романите	Noun
припитомило	Participle
промет	Noun
разликуваме	Verb
поразувајќи	Converb
баскиска	Adjective
следите	Verb
дождливо	Adjective
Ирката	Noun
климатската	Adjective
побиле	Participle
петгодишниот	Adjective
срамотна	Adjective
боцнале	Participle
заразат	Verb
пекмез	Noun
уриван	Participle
пченко	Noun
елиминирање	Masdar
пустиот	Adjective
исклучеле	Participle
човекомрасците	Noun
слушала	Participle
имало	Participle
продажба	Noun
арамиите	Noun
пиел	Participle
отсек	Noun
одлучново	Adjective
тврдеа	Verb
клисура	Noun
процента	Noun
приватно	Adjective
исчезнале	Participle
озлогласен	Adjective
изјавија	Verb
исчистил	Participle
налазиве	Noun
палат	Verb
сировоно	Adjective
сликар	Noun
составувале	Participle
плитките	Adjective
сочна	Adjective
заварување	Masdar
појадувал	Participle
замислете	Verb
сафирот	Noun
лингвистика	Noun
гувеев	Verb
понатамошните	Adjective
праведните	Adjective
чуваров	Noun
грозен	Adjective
хранат	Verb
земаме	Verb
јасната	Adjective
ослепување	Masdar
разлутила	Participle
недолично	Adjective
росело	Participle
брашнестиот	Adjective
мешунка	Noun
првенствената	Adjective
мускулот	Noun
добиел	Participle
јавувајќи	Converb
рударско	Adjective
внимавале	Participle
аеродромите	Noun
испратила	Participle
влезеш	Verb
уловен	Participle
потврдува	Verb
асоцираат	Verb
деталниот	Adjective
сонуваат	Verb
истрел	Noun
бранеле	Participle
издржувал	Participle
потиштија	Verb
теоретското	Adjective
шугавион	Adjective
потврдување	Masdar
тимон	Noun
еукалиптус	Noun
црн	Adjective
етикетирал	Participle
термита	Noun
поседуваме	Verb
бисон	Noun
невозможноста	Noun
одвоила	Participle
бебешка	Adjective
азбучниот	Adjective
изумувале	Participle
прикрија	Verb
планетине	Noun
бескраен	Adjective
држам	Verb
тастерите	Noun
разговарала	Participle
колонизатор	Noun
жолтата	Adjective
уценував	Verb
бирократијата	Noun
понатамошно	Adjective
обединувало	Participle
етимолошко	Adjective
буквите	Noun
француските	Adjective
кристалнине	Adjective
остануваат	Verb
маалата	Noun
моделите	Noun
џема	Noun
уредат	Verb
бесот	Noun
облекуваат	Verb
тркалезни	Adjective
паралелно	Adjective
одгледувајќи	Converb
повеќекомпонентна	Adjective
универзум	Noun
удрив	Verb
борон	Noun
млечно	Adjective
немирните	Adjective
изметот	Noun
прекинаа	Verb
иглолисните	Adjective
употребува	Verb
работиш	Verb
порота	Noun
додворување	Masdar
падежа	Noun
шахта	Noun
видите	Verb
донесеме	Verb
технолошкана	Adjective
семејни	Adjective
трилобита	Noun
посочив	Verb
наградевте	Verb
алатката	Noun
крикот	Noun
снежни	Adjective
јагуарине	Noun
балетско	Adjective
преоптеретувам	Verb
таксона	Noun
русокоса	Adjective
врвката	Noun
оглас	Noun
дефинираа	Verb
прометнине	Adjective
гамета	Noun
вијулица	Noun
паркиралиштето	Noun
наизменичното	Adjective
многубројна	Adjective
живееја	Verb
свежино	Noun
дишам	Verb
тенкине	Adjective
соодветните	Adjective
наредувајте	Verb
ироничното	Adjective
Унгаркиве	Noun
вртен	Participle
преоѓаат	Verb
класицизам	Noun
носиите	Noun
наводниците	Noun
непогрешливо	Adjective
еврата	Noun
преобразувало	Participle
поручник	Noun
седмините	Noun
засегаат	Verb
мракот	Noun
доматите	Noun
трајната	Adjective
корисниците	Noun
одвратела	Participle
шумава	Noun
соберат	Verb
албанскиот	Adjective
балтија	Noun
неделно	Adjective
поживееле	Participle
кинескиот	Adjective
кочиш	Verb
јарбол	Noun
царската	Adjective
комичното	Adjective
спаѓаа	Verb
дефинитивното	Adjective
архаична	Adjective
љубам	Verb
гризне	Verb
хетерогена	Adjective
мистериозен	Adjective
опколуван	Participle
доминирала	Participle
прометот	Noun
временско	Adjective
вулгарен	Adjective
прифаќала	Participle
божицата	Noun
Кинезот	Noun
ќош	Noun
набран	Participle
намените	Noun
граѓанка	Noun
скијачите	Noun
непожелни	Adjective
подбуцнаа	Verb
садат	Verb
заложиле	Participle
животинско	Adjective
отворат	Verb
директорката	Noun
состојкине	Noun
дотогашниот	Adjective
деталната	Adjective
јако	Adjective
одразат	Verb
каноните	Noun
рендево	Noun
мамузана	Noun
дало	Participle
варијанта	Noun
казиното	Noun
смислиле	Participle
изгребела	Participle
растурен	Participle
фрлала	Participle
плашеле	Participle
влакното	Noun
фотосинтезата	Noun
стриптизер	Noun
ласана	Noun
префинета	Adjective
заразување	Masdar
духовито	Adjective
стивнат	Verb
фараоните	Noun
носело	Participle
бившите	Adjective
соработувале	Participle
слоготворниот	Adjective
посетете	Verb
успешна	Adjective
подобрувала	Participle
јад	Noun
сестраниот	Adjective
глаголските	Adjective
преобразил	Participle
продале	Participle
насетил	Participle
обележете	Verb
почнуваат	Verb
внука	Noun
слушнеш	Verb
споделува	Verb
манекенката	Noun
мртвата	Adjective
соодветна	Adjective
загубил	Participle
мечувалке	Noun
учителско	Adjective
напразноно	Adjective
набедил	Participle
дигалките	Noun
опозицијата	Noun
лосионите	Noun
гаѓање	Masdar
раскажало	Participle
преиначиле	Participle
испечатат	Verb
астрологијата	Noun
умножувало	Participle
стисне	Verb
расниот	Adjective
тргнеме	Verb
вибрира	Verb
програмерон	Noun
присвоил	Participle
дотурел	Participle
зависните	Adjective
алгебра	Noun
мекицине	Noun
припитомуваме	Verb
дери	Verb
одбил	Participle
распуштиле	Participle
јаглерод	Noun
пештерата	Noun
ослободува	Verb
пронајдел	Participle
усложнам	Verb
многубројни	Adjective
родов	Noun
заработиле	Participle
опфаќала	Participle
песна	Noun
подмладување	Masdar
кажувале	Participle
издржала	Participle
лупнаа	Verb
воденицата	Noun
вандализираат	Verb
недопирливите	Adjective
шутираа	Verb
смртен	Adjective
подмирен	Participle
градската	Adjective
лизгачка	Noun
макотрпен	Adjective
желад	Noun
подобна	Adjective
сами	Adjective
директорите	Noun
романтичната	Adjective
двосмислено	Adjective
учевме	Verb
скапоцената	Adjective
значеа	Verb
сефа	Noun
глув	Adjective
пријатната	Adjective
макал	Participle
развивала	Participle
зглобот	Noun
курвата	Noun
екваторот	Noun
недолични	Adjective
утврдуваат	Verb
отпуштија	Verb
соголите	Verb
дизајнирање	Masdar
пристигнало	Participle
злоупотребен	Participle
замолила	Participle
непријатните	Adjective
преминаа	Verb
водење	Masdar
расеано	Adjective
означувала	Participle
одделните	Adjective
меѓуѕвездена	Adjective
автомата	Noun
геномите	Noun
чилеанската	Adjective
отишле	Participle
неточнион	Adjective
колонизира	Verb
изрезбаривме	Verb
посмртно	Adjective
телефонската	Adjective
пирошка	Noun
берилиум	Noun
невидливите	Adjective
земјоделските	Adjective
домородни	Adjective
сарделава	Noun
мрачните	Adjective
поттикот	Noun
боранија	Noun
неопходната	Adjective
напишеш	Verb
изгонет	Participle
преобразив	Verb
округон	Noun
прегрнал	Participle
залаже	Verb
решила	Participle
диригент	Noun
Евреинот	Noun
афионите	Noun
победувал	Participle
најдеш	Verb
подучуван	Participle
воспоставил	Participle
копајќи	Converb
присвоен	Participle
памучно	Adjective
лондонска	Adjective
востаник	Noun
толпо	Noun
успокоија	Verb
плиткиов	Adjective
глаголска	Adjective
погодила	Participle
активистка	Noun
советниците	Noun
соодветната	Adjective
папагалскине	Adjective
објавив	Verb
посетиме	Verb
посветиле	Participle
гроздов	Noun
добронамерно	Adjective
источен	Adjective
одлучно	Adjective
деталните	Adjective
советувам	Verb
поддржала	Participle
ропската	Adjective
воочлива	Adjective
преведуваш	Verb
преведувајќи	Converb
алкохолите	Noun
поддржувало	Participle
складнава	Adjective
испраќаат	Verb
влоговите	Noun
возрасен	Adjective
сребрениот	Adjective
склопете	Verb
неплодните	Adjective
дарување	Masdar
применила	Participle
ограничувала	Participle
осудувала	Participle
коректорине	Noun
канење	Masdar
латинското	Adjective
распишал	Participle
бујните	Adjective
заслужил	Participle
црковно	Adjective
патријархалниот	Adjective
ноздрава	Noun
траеја	Verb
забни	Adjective
живописната	Adjective
преоѓање	Masdar
обезвредам	Verb
режирала	Participle
плачкото	Noun
спречувала	Participle
навлезен	Participle
омажат	Verb
банкрот	Noun
благонаклонети	Adjective
пратеник	Noun
незабележливи	Adjective
пропорционален	Adjective
дрвените	Adjective
растура	Verb
течен	Adjective
разгорело	Participle
созреан	Participle
медалов	Noun
купив	Verb
навратиле	Participle
роботската	Adjective
дојдам	Verb
целодневнион	Adjective
бубрег	Noun
матурантите	Noun
наврнала	Participle
плодни	Adjective
иглолисни	Adjective
говедското	Adjective
искористила	Participle
преболував	Verb
пропаѓале	Participle
влажнела	Participle
пишувам	Verb
иди	Verb
глумеле	Participle
џокеј	Noun
конечните	Adjective
поробат	Verb
зашеметивме	Verb
зелениот	Adjective
стихозбирка	Noun
поврзаа	Verb
запишат	Verb
математичките	Adjective
гуштер	Noun
моментите	Noun
печката	Noun
едногласна	Adjective
засукам	Verb
прашувал	Participle
првата	Adjective
шармот	Noun
семињата	Noun
квалитетното	Adjective
претпоследното	Adjective
филтрираат	Verb
погрешиле	Participle
умствениов	Adjective
дарител	Noun
дејствувам	Verb
флотите	Noun
бришачу	Noun
напреднеш	Verb
предвиден	Participle
фонд	Noun
огромно	Adjective
занимавала	Participle
осумнаесетгодишниот	Adjective
искомплицираме	Verb
своевидни	Adjective
заедничките	Adjective
чаура	Noun
наврат	Noun
текстот	Noun
доларот	Noun
носителите	Noun
забележан	Participle
загубив	Verb
виц	Noun
комбинира	Verb
пауза	Noun
шумското	Adjective
феудализмот	Noun
фатиле	Participle
забранија	Verb
навалите	Verb
јазични	Adjective
илузијата	Noun
отстранувај	Verb
гребените	Noun
специјалниот	Adjective
старинските	Adjective
вешти	Adjective
евангелието	Noun
игнорирајќи	Converb
потрошувача	Noun
полнолетнициве	Noun
влакната	Noun
рипа	Verb
мистериозна	Adjective
ладната	Adjective
патувал	Participle
подземна	Adjective
детскиот	Adjective
бисерот	Noun
непроценливо	Adjective
идеолошките	Adjective
рундата	Noun
кочете	Verb
патријарх	Noun
банка	Noun
страдањено	Noun
републиканкине	Noun
комуницирале	Participle
геологија	Noun
пресека	Noun
инекциите	Noun
перспективата	Noun
мајчин	Adjective
пират	Noun
оправдува	Verb
спречило	Participle
живеалиштето	Noun
напуштил	Participle
крунисуваат	Verb
шишарките	Noun
дивата	Adjective
доверила	Participle
хектариве	Noun
куба	Noun
прачка	Noun
поставувам	Verb
мочуриштето	Noun
коректор	Noun
очекувам	Verb
величествени	Adjective
душевно	Adjective
борците	Noun
клиент	Noun
интегритет	Noun
негувале	Participle
варен	Participle
револуцијата	Noun
важеле	Participle
празничната	Adjective
слатководната	Adjective
наполнило	Participle
цитира	Verb
подржат	Verb
преводите	Noun
продолжување	Masdar
поларната	Adjective
протестантите	Noun
седат	Verb
реално	Adjective
истакнувал	Participle
љубителите	Noun
подарокот	Noun
студентов	Noun
продажно	Adjective
купатилава	Noun
планетава	Noun
расизам	Noun
отфрлање	Masdar
потисне	Verb
попуштат	Verb
прекарот	Noun
молам	Verb
вокабуларот	Noun
комичните	Adjective
давај	Verb
изнесоа	Verb
дијамантската	Adjective
закопување	Masdar
генијално	Adjective
поплочеле	Participle
нејасно	Adjective
леење	Masdar
контролираа	Verb
наредбата	Noun
програмер	Noun
еку	Noun
тесливе	Noun
компромитираат	Verb
наметнала	Participle
тинејџерска	Adjective
рапер	Noun
сервирање	Masdar
ќефов	Noun
гарантирала	Participle
луксузно	Adjective
завчерашниот	Adjective
резервата	Noun
финансиските	Adjective
посипал	Participle
румон	Noun
добитничка	Noun
уморно	Adjective
извиткаат	Verb
украинско	Adjective
населувале	Participle
ангелот	Noun
разбременеа	Verb
употребете	Verb
крстопатон	Noun
радуваме	Verb
коваме	Verb
кимон	Noun
зажалување	Masdar
отфрлил	Participle
сожителине	Noun
дипломатското	Adjective
боенка	Noun
естрогенов	Noun
прашувале	Participle
назначил	Participle
лаванда	Noun
смееја	Verb
фантастичните	Adjective
ветрушка	Noun
здодевна	Adjective
поволни	Adjective
замолив	Verb
покренало	Participle
политичар	Noun
заменувајте	Verb
порастот	Noun
усовршила	Participle
објавувал	Participle
западнат	Verb
бруталното	Adjective
помошна	Adjective
удоволивме	Verb
драгоцена	Adjective
куќичките	Noun
железна	Adjective
трепнам	Verb
вандалскиот	Adjective
заминувајќи	Converb
дејствував	Verb
последичноно	Adjective
добивам	Verb
фразата	Noun
наводна	Adjective
погребувале	Participle
лизга	Verb
фатила	Participle
слободен	Adjective
платите	Verb
подучувавте	Verb
позиција	Noun
мекиот	Adjective
калуѓеркана	Noun
криење	Masdar
посребрил	Participle
роботска	Adjective
енциклопедиите	Noun
надгледувал	Participle
прогледаме	Verb
целејќи	Converb
коментираат	Verb
заслужува	Verb
зема	Verb
гиба	Verb
складиран	Participle
почитувало	Participle
прекарите	Noun
ефикасноста	Noun
изустен	Participle
бедните	Adjective
оловото	Noun
англиско	Adjective
тивката	Adjective
уапсат	Verb
мачејќи	Converb
пушеле	Participle
разбереме	Verb
предвременото	Adjective
подобрете	Verb
применувајќи	Converb
прегледај	Verb
општине	Adjective
одбиле	Participle
јаглехидратите	Noun
интензитетот	Noun
алармон	Noun
технолошкото	Adjective
збору	Noun
сопрен	Participle
натрупуваат	Verb
варење	Masdar
исфрлила	Participle
експериментираат	Verb
кикиришко	Noun
пчелите	Noun
плашел	Participle
гледало	Participle
проток	Noun
делото	Noun
признавав	Verb
инсталирате	Verb
студентките	Noun
гениј	Noun
мрзливине	Adjective
проработиме	Verb
педерско	Adjective
тестиран	Participle
постепен	Adjective
ножот	Noun
Марсовцине	Noun
удвојуваат	Verb
свирнаа	Verb
дисертацијата	Noun
првобитните	Adjective
изостава	Verb
кубур	Noun
слушнеле	Participle
орденот	Noun
горчење	Masdar
либералниве	Adjective
ткивата	Noun
бисексуална	Adjective
кандилата	Noun
стекнуваме	Verb
сила	Noun
петгодишни	Adjective
правоаголен	Adjective
глупавичката	Adjective
беџот	Noun
обезбедат	Verb
пресушен	Participle
ѕверскиве	Adjective
именсково	Adjective
воодушевување	Masdar
честиот	Adjective
југозапад	Noun
принудија	Verb
плинон	Noun
отплатен	Participle
натчинетине	Adjective
росела	Participle
Словенцине	Noun
работев	Verb
можел	Participle
подвидовите	Noun
изговорил	Participle
доближувала	Participle
кокошката	Noun
очен	Adjective
знаете	Verb
косата	Adjective
благородника	Noun
столбот	Noun
сателитите	Noun
истекла	Participle
грбите	Noun
пуфката	Noun
мисир	Noun
задолжил	Participle
сребреник	Noun
прераскаже	Verb
повеќегодишна	Adjective
ракавица	Noun
списаниjана	Noun
хармониине	Noun
ран	Adjective
украсот	Noun
горчина	Noun
аморфен	Adjective
жрец	Noun
хранење	Masdar
оженила	Participle
војвотката	Noun
јајцето	Noun
хомосексуален	Adjective
единицата	Noun
осудуваат	Verb
кусине	Adjective
носето	Noun
материјалните	Adjective
невообичаените	Adjective
суровите	Adjective
поштедувавме	Verb
касетите	Noun
компонирале	Participle
опседне	Verb
веслање	Masdar
придржела	Participle
повторувала	Participle
учам	Verb
дотуреа	Verb
програмската	Adjective
алелите	Noun
забуна	Noun
советувала	Participle
тешкиот	Adjective
пена	Noun
заработат	Verb
петгодишно	Adjective
наградиле	Participle
гимназиите	Noun
машината	Noun
собната	Adjective
основното	Adjective
Полјаков	Noun
производителите	Noun
ласкате	Verb
бавното	Adjective
продажбите	Noun
исклучат	Verb
ерупција	Noun
пријавевте	Verb
прониклив	Adjective
англиската	Adjective
покојнице	Noun
направила	Participle
очајувавте	Verb
издвоен	Participle
исполнува	Verb
поклопуваат	Verb
официјалново	Adjective
ѓаволите	Noun
оптегнал	Participle
нарекуваа	Verb
прснавте	Verb
ситното	Adjective
морале	Participle
сенките	Noun
злонамерна	Adjective
испеал	Participle
крварењето	Noun
толерантни	Adjective
приредувајќи	Converb
безболна	Adjective
пискаат	Verb
поздравил	Participle
кризо	Noun
харфата	Noun
недостигаат	Verb
изданиено	Noun
носеле	Participle
опишан	Participle
бришел	Participle
наоѓате	Verb
комуникативниот	Adjective
тортата	Noun
понудил	Participle
оригиналните	Adjective
рефлекс	Noun
починале	Participle
сокрил	Participle
гледаа	Verb
успивајте	Verb
верниот	Adjective
зебрата	Noun
паузата	Noun
руна	Noun
уредувал	Participle
надлежново	Adjective
јавноно	Adjective
бананите	Noun
материјалната	Adjective
докторат	Noun
штитникот	Noun
југословенската	Adjective
бесон	Noun
неприродна	Adjective
забременува	Verb
случаен	Adjective
имитацијата	Noun
кратенка	Noun
колонизираат	Verb
држат	Verb
ѕиркаа	Verb
белиот	Adjective
просеaвме	Verb
обединиме	Verb
гориш	Verb
историската	Adjective
клучен	Adjective
снег	Noun
горчливо	Adjective
терапијата	Noun
гласало	Participle
наизменичен	Adjective
борачов	Noun
милоснана	Adjective
симетриите	Noun
миграцијата	Noun
применија	Verb
основно	Adjective
шаторот	Noun
шупливото	Adjective
тужеле	Participle
пазарното	Adjective
сиви	Adjective
прозата	Noun
занемарува	Verb
плинот	Noun
нечиста	Adjective
рачка	Noun
осамена	Adjective
итно	Adjective
кружниот	Adjective
азот	Noun
природниов	Adjective
мастилово	Noun
жено	Noun
придвижување	Masdar
поврзевме	Verb
претседателката	Noun
искористете	Verb
челичен	Adjective
второво	Adjective
несоодветен	Adjective
мостовите	Noun
ослабнало	Participle
пофалнион	Adjective
демократот	Noun
богатата	Adjective
нагласување	Masdar
денешното	Adjective
истакнуваа	Verb
размрскаш	Verb
молчат	Verb
турнирот	Noun
обединувала	Participle
постигнале	Participle
лубрикантот	Noun
сочен	Adjective
првенството	Noun
крововите	Noun
ронат	Verb
војната	Noun
рударска	Adjective
членко	Noun
скакулците	Noun
подводните	Adjective
објаснувало	Participle
лечеле	Participle
крушо	Noun
проколнал	Participle
количествен	Adjective
источните	Adjective
зафатат	Verb
оброк	Noun
катастрофална	Adjective
отуѓила	Participle
плоштината	Noun
нацизам	Noun
нацистичка	Adjective
атмосферската	Adjective
капо	Noun
сончева	Adjective
зборовна	Adjective
безвезниве	Adjective
клучни	Adjective
напорната	Adjective
слузниците	Noun
наследила	Participle
оневозможила	Participle
планинарите	Noun
патките	Noun
еластични	Adjective
охрабрела	Participle
исклучувала	Participle
замислам	Verb
пророчкине	Adjective
заварев	Verb
подучував	Verb
дух	Noun
светицата	Noun
угледно	Adjective
хокејот	Noun
мораат	Verb
постмодерното	Adjective
осветлил	Participle
трахеите	Noun
дрските	Adjective
разубедите	Verb
претпоставете	Verb
наследно	Adjective
отворале	Participle
пропаднало	Participle
ливада	Noun
субјектите	Noun
нутрија	Noun
изразила	Participle
неверојатните	Adjective
докитело	Participle
летниот	Adjective
збунуваат	Verb
промовирале	Participle
превртивте	Verb
гасен	Participle
неелегантните	Adjective
потонаа	Verb
невиниот	Adjective
лигаво	Adjective
зенитот	Noun
оневозможиле	Participle
ставиш	Verb
просечни	Adjective
приближувавте	Verb
петгодишен	Adjective
шифра	Noun
крилести	Adjective
облекувала	Participle
вдишуваат	Verb
разделиле	Participle
параграф	Noun
очекува	Verb
густина	Noun
клоновине	Noun
биволот	Noun
шпанските	Adjective
почувствуваат	Verb
соочува	Verb
истекло	Participle
повратил	Participle
закачуваме	Verb
коњскиот	Adjective
овошно	Adjective
синдром	Noun
брутални	Adjective
лира	Noun
мајчино	Adjective
форо	Noun
ироничната	Adjective
распределиле	Participle
изведуваат	Verb
куќниот	Adjective
левата	Adjective
пратило	Participle
творците	Noun
чекориве	Noun
лансирале	Participle
бирокративе	Noun
ортопед	Noun
фудбалската	Adjective
менората	Noun
врзала	Participle
запаметеле	Participle
паунот	Noun
нарекувал	Participle
струмичка	Adjective
фрлиш	Verb
темелниот	Adjective
православиjана	Noun
запрепастувала	Participle
свесна	Adjective
тестирање	Masdar
изолирајќи	Converb
возеа	Verb
оздравиш	Verb
лежиме	Verb
масакрирал	Participle
грчкото	Adjective
шведските	Adjective
заверила	Participle
четириаголен	Adjective
подоцнежната	Adjective
остварила	Participle
горенаведениот	Adjective
дофатот	Noun
донеле	Participle
малиот	Adjective
ораторон	Noun
неравенствава	Noun
закачила	Participle
молитвиве	Noun
смееш	Verb
подобрила	Participle
аптекава	Noun
додавам	Verb
досадно	Adjective
тркалезна	Adjective
боси	Adjective
капиларите	Noun
израснал	Participle
етидо	Noun
краткорочни	Adjective
информациите	Noun
теолошката	Adjective
свадбена	Adjective
љубовното	Adjective
дотогашен	Adjective
загрижување	Masdar
подобрил	Participle
налагаат	Verb
неморални	Adjective
шаблона	Noun
етимолошка	Adjective
практичен	Adjective
величествена	Adjective
благодушноно	Adjective
собира	Verb
противречноста	Noun
разоружив	Verb
фалевте	Verb
тека	Noun
љубоморно	Adjective
темелниве	Adjective
сакаат	Verb
безбедносен	Adjective
автомобилите	Noun
забиле	Participle
камило	Noun
идентичните	Adjective
матријархални	Adjective
уживанцијата	Noun
менито	Noun
знаењата	Noun
воскреснал	Participle
ролна	Noun
минималистите	Noun
штаб	Noun
официјална	Adjective
принесовме	Verb
заемодавците	Noun
претставките	Noun
личните	Adjective
илустрирал	Participle
еволуирање	Masdar
покана	Noun
титула	Noun
дроба	Noun
сколиоза	Noun
летно	Adjective
програмеркине	Noun
раструбил	Participle
старомодни	Adjective
закажува	Verb
строгото	Adjective
извршат	Verb
дуелите	Noun
ронкине	Noun
истераат	Verb
маратонот	Noun
лесното	Adjective
смесите	Noun
странскиот	Adjective
тинејџерката	Noun
одговарал	Participle
човечко	Adjective
илустрирајќи	Converb
зиготот	Noun
придружуваа	Verb
праведната	Adjective
надимакон	Noun
љубоморниов	Adjective
образовно	Adjective
доверувај	Verb
шербетине	Noun
хемичарот	Noun
клинец	Noun
комбинирајќи	Converb
споредбените	Adjective
тренинзите	Noun
неписмен	Adjective
адаптирал	Participle
бунарот	Noun
безболнине	Adjective
настапат	Verb
шпекулирање	Masdar
бурек	Noun
литургија	Noun
комисија	Noun
гмечите	Verb
достигнеме	Verb
обилни	Adjective
одглас	Noun
отежнува	Verb
свештеникот	Noun
осамен	Adjective
стаклата	Noun
птичјо	Adjective
носев	Verb
претставувале	Participle
казниле	Participle
мрак	Noun
здрава	Adjective
активирање	Masdar
младо	Adjective
краста	Noun
силно	Adjective
одразот	Noun
спомнала	Participle
достојно	Adjective
дивтарката	Noun
глупавата	Adjective
повлекува	Verb
прехранбена	Adjective
укинало	Participle
сместиле	Participle
осудија	Verb
означил	Participle
довршил	Participle
извонредно	Adjective
неправедното	Adjective
дознаеле	Participle
металните	Adjective
попис	Noun
извираат	Verb
откажаа	Verb
зашеметело	Participle
сеништана	Noun
медицинската	Adjective
кивавица	Noun
недостоинственово	Adjective
свечен	Adjective
првенствени	Adjective
дивечот	Noun
сликарството	Noun
надворешноста	Noun
описно	Adjective
петнаесетгодишниот	Adjective
смирија	Verb
задоволна	Adjective
контактира	Verb
ферментиран	Participle
пратија	Verb
полнолетна	Adjective
проветрување	Masdar
плаче	Verb
филозофите	Noun
премиерка	Noun
инсектицид	Noun
краткорочниот	Adjective
замижан	Participle
грузискиот	Adjective
пиштола	Noun
онерасположив	Verb
дрдорлививе	Adjective
споменува	Verb
запаливото	Adjective
тресел	Participle
славни	Adjective
растоварил	Participle
проклетиов	Adjective
поттикнев	Verb
збегот	Noun
престолонаследничка	Noun
земјата	Noun
доживееш	Verb
почекај	Verb
усовршат	Verb
салона	Noun
гледачите	Noun
пекарките	Noun
неточен	Adjective
простиле	Participle
ококорел	Participle
хирургија	Noun
познатиот	Adjective
аларм	Noun
вработело	Participle
запира	Verb
осетливо	Adjective
тешките	Adjective
мрднате	Verb
злобава	Noun
движела	Participle
врнеле	Participle
ковачницава	Noun
анализите	Noun
прашувало	Participle
добредојдена	Adjective
пожелно	Adjective
сторите	Verb
рилката	Noun
верувај	Verb
Бразилец	Noun
доаѓал	Participle
уверила	Participle
шпоретот	Noun
изјавувајќи	Converb
ставивме	Verb
вообичаена	Adjective
отвораме	Verb
черепот	Noun
крилест	Adjective
косење	Masdar
диетални	Adjective
употребиме	Verb
цевка	Noun
извртен	Participle
сезоната	Noun
чајникот	Noun
вредна	Adjective
запамтен	Participle
вадејќи	Converb
болничарите	Noun
интензивен	Adjective
соковите	Noun
подвид	Noun
неточни	Adjective
Чехот	Noun
прикажливиот	Adjective
докажувал	Participle
поднесува	Verb
управуваат	Verb
пријатните	Adjective
определениот	Adjective
вмешува	Verb
трапезите	Noun
кошула	Noun
капетанот	Noun
јавите	Verb
оптимално	Adjective
оптужен	Participle
празно	Adjective
агенциите	Noun
затворил	Participle
лижне	Verb
разумната	Adjective
направија	Verb
нештата	Noun
проза	Noun
избрише	Verb
докторирале	Participle
чуван	Participle
коњушарот	Noun
почитувал	Participle
грлица	Noun
печел	Participle
малолетничка	Noun
залива	Noun
откупиле	Participle
пребоиме	Verb
склопил	Participle
залаевте	Verb
дејноста	Noun
возат	Verb
обработен	Participle
стапнале	Participle
потполошка	Noun
излегувал	Participle
намената	Noun
заемниве	Adjective
итни	Adjective
фудбалерот	Noun
крајностите	Noun
костенлива	Adjective
плажа	Noun
побожниот	Adjective
ласкање	Masdar
турне	Verb
шират	Verb
старечка	Adjective
почни	Verb
одморале	Participle
ќебап	Noun
поврзаноста	Noun
празнувале	Participle
прекршуваат	Verb
проценила	Participle
кандидат	Noun
оладат	Verb
островите	Noun
сексуално	Adjective
виден	Participle
истражувач	Noun
дроздовине	Noun
американска	Adjective
мижеа	Verb
навиките	Noun
длабоки	Adjective
комплицирани	Adjective
ископаат	Verb
надминало	Participle
угодела	Participle
виолетовите	Adjective
најавило	Participle
одбивајќи	Converb
пешачката	Adjective
потчинета	Adjective
лизгачките	Noun
запечатил	Participle
мумлаш	Verb
есента	Noun
пописа	Noun
впивање	Masdar
женка	Noun
вџашувавте	Verb
потрошен	Participle
моносахарид	Noun
употребуван	Participle
геолошкине	Adjective
понудија	Verb
пржев	Verb
рамни	Adjective
молчам	Verb
чувствителниот	Adjective
црнецот	Noun
ранила	Participle
неверствава	Noun
хектар	Noun
поен	Participle
наместивте	Verb
циркусот	Noun
слоганот	Noun
подвлечат	Verb
лаптоп	Noun
паричните	Adjective
горно	Adjective
измила	Participle
последица	Noun
сидата	Noun
учителскиве	Adjective
познато	Adjective
писмениот	Adjective
уплата	Noun
исцрпиме	Verb
клун	Noun
општиот	Adjective
аџилакот	Noun
сочни	Adjective
кланица	Noun
судница	Noun
проучивте	Verb
положило	Participle
употребило	Participle
обесхрабрат	Verb
фокусираа	Verb
акционер	Noun
океанските	Adjective
верна	Adjective
словачкана	Adjective
црвеникаво	Adjective
бестелесниве	Adjective
кинотеките	Noun
жлездите	Noun
вечерна	Adjective
белезите	Noun
весник	Noun
израмнила	Participle
салама	Noun
чесно	Adjective
награда	Noun
Грците	Noun
украсување	Masdar
радиусот	Noun
тежела	Participle
друштвениве	Adjective
домен	Noun
велича	Verb
доплатев	Verb
посвојување	Masdar
сив	Adjective
преведеме	Verb
држите	Verb
останувал	Participle
бескрајните	Adjective
безвредно	Adjective
закопчувајте	Verb
бесконечна	Adjective
посолевте	Verb
инвазија	Noun
лекомислена	Adjective
припишувавме	Verb
уживајте	Verb
сведоштвата	Noun
утврдило	Participle
турел	Participle
пеницилинот	Noun
черупка	Noun
покачуваат	Verb
помрачивме	Verb
интересираат	Verb
седмина	Noun
тубата	Noun
мигновената	Adjective
комите	Noun
силувач	Noun
повраќаш	Verb
скриј	Verb
предложите	Verb
сламкиве	Noun
русо	Adjective
овековечува	Verb
зедов	Verb
кловн	Noun
гредата	Noun
напуштиш	Verb
венецот	Noun
нестабилните	Adjective
слезел	Participle
вклучувале	Participle
верскиот	Adjective
норвешка	Adjective
останувам	Verb
партизаните	Noun
бистра	Adjective
нумериран	Participle
лај	Verb
конзервативизам	Noun
ѓаурите	Noun
згинел	Participle
диригирал	Participle
пештера	Noun
бисерите	Noun
волнените	Adjective
старовремскана	Adjective
факултетска	Adjective
силите	Noun
сетив	Verb
контактот	Noun
погубување	Masdar
осигуран	Participle
поткрепат	Verb
поттикнување	Masdar
дупчалкиве	Noun
избавувајте	Verb
препознале	Participle
кротка	Adjective
измислува	Verb
трпејќи	Converb
насочувајќи	Converb
дискутирајќи	Converb
смртоносен	Adjective
поводот	Noun
живородни	Adjective
амброзијата	Noun
глукозата	Noun
бетонов	Noun
мештанин	Noun
нелогични	Adjective
овулацијава	Noun
итри	Adjective
зрнести	Adjective
искажат	Verb
другарка	Noun
стварно	Adjective
забоболка	Noun
глаткото	Adjective
влезовине	Noun
батеријата	Noun
еврејско	Adjective
болничаров	Noun
заокружел	Participle
занемарете	Verb
вклучите	Verb
инкубаторот	Noun
обезбедувавте	Verb
крути	Adjective
комшиите	Noun
почитувале	Participle
рубину	Noun
ослободување	Masdar
создадам	Verb
нацртан	Participle
прикриваат	Verb
дупкиве	Noun
колк	Noun
вик	Noun
жестока	Adjective
принудувал	Participle
ретардираниот	Adjective
нештото	Noun
промашен	Participle
преземале	Participle
размислував	Verb
ќумбето	Noun
питите	Noun
шушкав	Verb
понуделе	Participle
ѕвонат	Verb
минерален	Adjective
репризирај	Verb
сложил	Participle
прилозите	Noun
змејот	Noun
ранец	Noun
мозок	Noun
формулираме	Verb
толпата	Noun
вршител	Noun
скопско	Adjective
оригинал	Noun
пушење	Masdar
покачување	Masdar
постмодерни	Adjective
јасен	Adjective
напредните	Adjective
обопштува	Verb
тресејќи	Converb
лизгам	Verb
средношколсково	Adjective
изрекле	Participle
пролог	Noun
развитокот	Noun
нетрпелив	Adjective
сирењата	Noun
наречи	Verb
италијанско	Adjective
побил	Participle
понизнана	Adjective
доследнион	Adjective
сувениру	Noun
заробил	Participle
гелот	Noun
алчните	Adjective
градителите	Noun
колективизам	Noun
кашлало	Participle
придушен	Participle
словенечко	Adjective
богатиот	Adjective
складен	Adjective
барака	Noun
подредите	Verb
продирајќи	Converb
каранфилон	Noun
урина	Noun
осмица	Noun
густината	Noun
тапан	Noun
почнаа	Verb
поканет	Participle
прашумиве	Noun
индиректна	Adjective
просечните	Adjective
челуста	Noun
автоматските	Adjective
влажно	Adjective
немоќта	Noun
Ерменецот	Noun
латвискиот	Adjective
архивирај	Verb
наврата	Noun
креативен	Adjective
подобрувал	Participle
драгана	Adjective
реткоста	Noun
лукот	Noun
леба	Noun
зениту	Noun
татковците	Noun
чувствувајќи	Converb
умножија	Verb
занемарувавте	Verb
погонот	Noun
пиштолот	Noun
детската	Adjective
осмолетке	Noun
мешавините	Noun
пожарникар	Noun
храбрите	Adjective
доверува	Verb
лактон	Noun
опасните	Adjective
припадниците	Noun
начелото	Noun
компјутерска	Adjective
петнаесетгодишна	Adjective
детален	Adjective
диск	Noun
пее	Verb
вепарот	Noun
дала	Participle
јазик	Noun
апсурдноста	Noun
дискутирала	Participle
скакулец	Noun
друштвен	Adjective
убиството	Noun
заслужуваш	Verb
доброта	Noun
фамилиите	Noun
струјниот	Adjective
господариме	Verb
грешење	Masdar
здебелен	Participle
исправна	Adjective
паметни	Adjective
толкувајќи	Converb
измамат	Verb
индивидуализам	Noun
рециклирајќи	Converb
влече	Verb
интервјуто	Noun
едноклеточен	Adjective
напуштила	Participle
претставникот	Noun
безбедносноно	Adjective
трактат	Noun
означувал	Participle
бомбардирање	Masdar
регионите	Noun
сексистичково	Adjective
глумат	Verb
суштинските	Adjective
полагала	Participle
стопанка	Noun
пролетните	Adjective
бисера	Noun
одгледување	Masdar
немите	Adjective
подметнела	Participle
кралската	Adjective
коскено	Adjective
капсулата	Noun
снабден	Participle
астрономска	Adjective
докторските	Adjective
става	Noun
филијала	Noun
бубрегот	Noun
обесхрабревте	Verb
световната	Adjective
сортите	Noun
астролошките	Adjective
открие	Verb
приоритетот	Noun
засаден	Participle
употребувајќи	Converb
упростил	Participle
убеден	Participle
сочинувало	Participle
клоца	Verb
кошулата	Noun
длабоконо	Adjective
прикажливо	Adjective
цвилеа	Verb
магнетната	Adjective
прочистевме	Verb
поистоветел	Participle
обилниот	Adjective
билката	Noun
врамуваа	Verb
краткиот	Adjective
струмите	Noun
буките	Noun
Хрватот	Noun
заробениците	Noun
акацијана	Noun
праќал	Participle
горила	Noun
џвакање	Masdar
смела	Adjective
србизам	Noun
широчината	Noun
пропустливион	Adjective
индиректен	Adjective
празнел	Participle
надживеале	Participle
внимателниот	Adjective
измрсело	Participle
правам	Verb
љубава	Noun
проектот	Noun
геолошките	Adjective
поаѓале	Participle
детството	Noun
чувате	Verb
конфискуван	Participle
подоцнежна	Adjective
вознемиреноста	Noun
пресоблечам	Verb
совесно	Adjective
запоставува	Verb
сложиле	Participle
осиромашен	Participle
потера	Noun
прекрасни	Adjective
поттикнувал	Participle
сензорите	Noun
покраина	Noun
спровело	Participle
ѕид	Noun
гранките	Noun
разведен	Participle
лижавчињата	Noun
стапа	Noun
откриваа	Verb
користев	Verb
обвинуваа	Verb
далекосежнава	Adjective
дигајте	Verb
доведува	Verb
изнајдат	Verb
распуштениот	Adjective
одземаа	Verb
растуриле	Participle
решило	Participle
молитвеник	Noun
Србинкава	Noun
долг	Adjective
велосипедист	Noun
заверен	Participle
манир	Noun
злобна	Adjective
тангенсот	Noun
применуван	Participle
птицата	Noun
луда	Adjective
горниве	Adjective
префрлила	Participle
излупивме	Verb
отворената	Adjective
кружна	Adjective
јазолот	Noun
секретиве	Noun
потребнана	Adjective
сјајно	Adjective
посевите	Noun
ѕверка	Noun
неопходниов	Adjective
придружничката	Noun
сопственичка	Noun
индивидуалист	Noun
огласите	Noun
забавувате	Verb
ќумурот	Noun
помфрит	Noun
карфиол	Noun
дијалектот	Noun
клинецов	Noun
плетенка	Noun
секојдневните	Adjective
произведување	Masdar
ан	Noun
ромб	Noun
белузлавово	Adjective
обореле	Participle
брег	Noun
оградиле	Participle
балкон	Noun
контактирале	Participle
подарен	Participle
милостина	Noun
стои	Verb
пукало	Participle
кафените	Adjective
донесоа	Verb
ветила	Participle
финесата	Noun
олицетворен	Participle
амперот	Noun
воскресне	Verb
привлеков	Verb
колен	Participle
спојува	Verb
мајмунскиот	Adjective
ладнокрвен	Adjective
хомофобијана	Noun
Швајцарците	Noun
ловел	Participle
министер	Noun
органското	Adjective
потпретседатела	Noun
венчаат	Verb
заклучил	Participle
тригодишното	Adjective
разјадевме	Verb
четиригодишниот	Adjective
несвесен	Adjective
привлекуваш	Verb
беснилото	Noun
старомодното	Adjective
црвенилоно	Noun
јорганов	Noun
судска	Adjective
отфрлал	Participle
гнев	Noun
песа	Noun
примитивна	Adjective
мисо	Noun
покорат	Verb
законското	Adjective
електрицитет	Noun
прицврстувавме	Verb
фактура	Noun
сместат	Verb
неподнослив	Adjective
скокоткате	Verb
ложата	Noun
умирање	Masdar
ракометаре	Noun
техничкиот	Adjective
храбрине	Adjective
привлекува	Verb
фантазирање	Masdar
ректум	Noun
насмее	Verb
проследете	Verb
здиплен	Participle
период	Noun
храбар	Adjective
зборовен	Adjective
јужнава	Adjective
веројатноста	Noun
творечка	Adjective
емоцијана	Noun
преведувате	Verb
тенисерка	Noun
етикетира	Verb
мораа	Verb
докажало	Participle
одржеа	Verb
мигот	Noun
отпорна	Adjective
канибалине	Noun
карактеризираат	Verb
спречила	Participle
сперматозоидите	Noun
желките	Noun
принципов	Noun
лажи	Verb
умирајќи	Converb
опитот	Noun
чешав	Verb
објавувај	Verb
зазеле	Participle
српскохрватската	Adjective
извршила	Participle
шанкер	Noun
софистицираниот	Adjective
банкротирале	Participle
последни	Adjective
извираа	Verb
налиеле	Participle
жешката	Adjective
восхитување	Masdar
сфинга	Noun
настапила	Participle
алтернатива	Noun
духовитиот	Adjective
вознемирување	Masdar
анонимниот	Adjective
поводите	Noun
примил	Participle
сабјите	Noun
оневозможувам	Verb
осата	Noun
наставките	Noun
неизделканите	Adjective
автомеханичар	Noun
наставничката	Noun
идеолошката	Adjective
водилките	Noun
развлечеш	Verb
Словенец	Noun
чинчилине	Noun
земавме	Verb
нумерирање	Masdar
покажувајќи	Converb
додатните	Adjective
славна	Adjective
слабиот	Adjective
исклоцате	Verb
глупавиот	Adjective
смешна	Adjective
будистот	Noun
посвоија	Verb
подбива	Noun
блиска	Adjective
живалциве	Noun
ѓаволскиот	Adjective
истријте	Verb
силиконите	Noun
транссексуалците	Noun
славните	Adjective
ненадејното	Adjective
казниви	Adjective
надмине	Verb
избегаат	Verb
провоцира	Verb
изоговарај	Verb
искуствата	Noun
вратичкине	Noun
правело	Participle
видон	Noun
финансиското	Adjective
крвава	Adjective
ранил	Participle
микроскопските	Adjective
јаболката	Noun
фантазирате	Verb
разгледувала	Participle
рефлекторите	Noun
променливово	Adjective
запее	Verb
кугла	Verb
надгледувала	Participle
траектот	Noun
детето	Noun
тргувал	Participle
војнициве	Noun
сештојад	Noun
пишувајте	Verb
младоликион	Adjective
научиме	Verb
остануваа	Verb
бесплатниот	Adjective
увозник	Noun
шестиниве	Noun
совеста	Noun
елегантниот	Adjective
маснотија	Noun
спопаднало	Participle
цитираат	Verb
разоткрила	Participle
уверил	Participle
магнетни	Adjective
сеф	Noun
колачињата	Noun
автоматска	Adjective
омаловажува	Verb
деспотите	Noun
извадил	Participle
ѕиду	Noun
кочел	Participle
подносливине	Adjective
согледуваат	Verb
метла	Noun
врзува	Verb
недостоинствени	Adjective
идентитетот	Noun
остроумната	Adjective
премиите	Noun
галама	Noun
повремениот	Adjective
образложувам	Verb
кристален	Adjective
поема	Noun
хирурзите	Noun
сеопшт	Adjective
изедначил	Participle
цигариштата	Noun
разубедување	Masdar
обележал	Participle
велшкиот	Adjective
чучам	Verb
постигнавме	Verb
споменица	Noun
лузните	Noun
теолошките	Adjective
бројките	Noun
наштетам	Verb
неспоредливата	Adjective
дадоа	Verb
истребен	Participle
режиран	Participle
безвластиево	Noun
пешачеа	Verb
писмените	Adjective
тригодишно	Adjective
крајното	Adjective
фотографите	Noun
бесплатен	Adjective
станица	Noun
објаснувајќи	Converb
мачителот	Noun
спаѓаат	Verb
километражава	Noun
ефективни	Adjective
раниле	Participle
форсира	Verb
наумуваат	Verb
регистрира	Verb
присутните	Adjective
взаемен	Adjective
капчињана	Noun
округло	Adjective
пратен	Participle
поскапила	Participle
обединил	Participle
дводелна	Adjective
доживувал	Participle
електронов	Noun
последователниот	Adjective
миленик	Noun
атентат	Noun
шитнам	Verb
вимето	Noun
дометот	Noun
бидневме	Verb
прифатливото	Adjective
отпорник	Noun
слушнам	Verb
предаваме	Verb
праќање	Masdar
отишла	Participle
гасениците	Noun
смешно	Adjective
привлечната	Adjective
концепта	Noun
боледуваат	Verb
смуван	Participle
месојадон	Noun
јуриша	Noun
туристичко	Adjective
прачката	Noun
туркајќи	Converb
разделило	Participle
припаѓајќи	Converb
потенцира	Verb
пензионерскиве	Adjective
коњската	Adjective
рокада	Noun
командувал	Participle
затворите	Verb
зглоба	Noun
потпишувале	Participle
искречивме	Verb
замарантине	Noun
цмокнел	Participle
клупичкине	Noun
заслужен	Participle
занимаваа	Verb
пожолтував	Verb
одбранет	Participle
мајчина	Adjective
ланците	Noun
жичкана	Noun
предадеме	Verb
виор	Noun
лилава	Adjective
везилката	Noun
побожни	Adjective
пробиен	Participle
градоначалничките	Noun
објаснувале	Participle
потонев	Verb
исклучителна	Adjective
потписа	Noun
ибис	Noun
домашен	Adjective
плавово	Adjective
струма	Noun
рашириле	Participle
останам	Verb
топ	Noun
коритото	Noun
спроведува	Verb
комплетнине	Adjective
детско	Adjective
задоволствата	Noun
планираа	Verb
воздухот	Noun
мелеле	Participle
паскал	Noun
глупав	Adjective
шаторов	Noun
основаат	Verb
можното	Adjective
полното	Adjective
завршеток	Noun
стилскине	Adjective
примерна	Adjective
погодно	Adjective
исплашен	Participle
дадов	Verb
отстранувате	Verb
босанскиот	Adjective
приближниот	Adjective
реагира	Verb
отпаѓале	Participle
стотиците	Noun
егзотично	Adjective
имајќи	Converb
округ	Noun
копиљаков	Noun
необработена	Adjective
тренерската	Adjective
пичено	Noun
даска	Noun
стара	Adjective
легендите	Noun
последователните	Adjective
кожно	Adjective
меана	Noun
бунтот	Noun
сврзни	Adjective
вработила	Participle
митралезот	Noun
лушпите	Noun
заемните	Adjective
бистата	Noun
разгазил	Participle
разјаснува	Verb
негувала	Participle
лажат	Verb
стопирајќи	Converb
џиновска	Adjective
освоија	Verb
цел	Adjective
туширав	Verb
депресивна	Adjective
изобличувајте	Verb
дефинирале	Participle
капката	Noun
раста	Noun
повлекло	Participle
полка	Noun
ненадеен	Adjective
прага	Noun
тврдокорни	Adjective
културните	Adjective
покојните	Adjective
забележителен	Adjective
измена	Noun
насилните	Adjective
провлака	Noun
одржите	Verb
подобриме	Verb
лажеш	Verb
другарството	Noun
меѓучовечката	Adjective
чембалата	Noun
модернион	Adjective
абортусот	Noun
гробиштата	Noun
симптомине	Noun
оклопниов	Adjective
интезивно	Adjective
гарнизон	Noun
семоќен	Adjective
гладување	Masdar
достигнувале	Participle
поевтинев	Verb
здупете	Verb
продлабочил	Participle
есенскиот	Adjective
половна	Adjective
навлезат	Verb
урамнотежам	Verb
пристигнуваат	Verb
спремни	Adjective
наизменичната	Adjective
мома	Noun
одете	Verb
патријархот	Noun
проштално	Adjective
максимална	Adjective
слетаат	Verb
створило	Participle
безумно	Adjective
нафтата	Noun
навивач	Noun
негувателките	Noun
купола	Noun
пријатен	Adjective
охрабрување	Masdar
модернист	Noun
раба	Noun
проколнува	Verb
гребе	Verb
решавал	Participle
пластична	Adjective
завршивме	Verb
убедувавме	Verb
декларирал	Participle
пропадневте	Verb
контекстот	Noun
издржале	Participle
вирусон	Noun
протестираа	Verb
намократ	Verb
рокадата	Noun
потопен	Participle
книгите	Noun
пофални	Adjective
украинските	Adjective
прашиниве	Noun
депресивните	Adjective
бојкотирало	Participle
натрупан	Participle
јатаган	Noun
прашинките	Noun
обвинат	Verb
реметон	Noun
одмара	Verb
разрешил	Participle
благословат	Verb
етничкото	Adjective
чашите	Noun
хипнотизирање	Masdar
качиле	Participle
спасите	Verb
бркале	Participle
атон	Noun
косинусине	Noun
победувале	Participle
кликне	Verb
ѕвонаре	Noun
срамежливава	Adjective
славеничкава	Noun
грабнал	Participle
суштинско	Adjective
цвеклото	Noun
неблагороднине	Adjective
фризерките	Noun
џебовиве	Noun
балканските	Adjective
додатната	Adjective
воспитуваат	Verb
понела	Participle
илузија	Noun
направило	Participle
поплавев	Verb
кулминацијата	Noun
рапот	Noun
монетата	Noun
нејаснине	Adjective
инфекцијата	Noun
долгорочното	Adjective
строги	Adjective
додавало	Participle
ветат	Verb
втората	Adjective
хлор	Noun
заложување	Masdar
златното	Adjective
соборецу	Noun
спречевте	Verb
неменливи	Adjective
речник	Noun
сегментите	Noun
грбоносниов	Adjective
татковинине	Noun
човечна	Adjective
цуфнал	Participle
едноклеточно	Adjective
применувало	Participle
сакан	Participle
негуваат	Verb
викаат	Verb
дозволувала	Participle
кумата	Noun
потекнуваат	Verb
ефективен	Adjective
првобитно	Adjective
надминела	Participle
увозниците	Noun
терена	Noun
собарот	Noun
даските	Noun
благодата	Noun
отпее	Verb
световните	Adjective
поплавил	Participle
настапуваат	Verb
хуморон	Noun
применување	Masdar
поларните	Adjective
мандарините	Noun
наставниве	Adjective
завиткување	Masdar
творец	Noun
крофна	Noun
восочна	Adjective
купатилото	Noun
бутни	Verb
медалот	Noun
приредува	Verb
известувајќи	Converb
прекриле	Participle
богаташот	Noun
трпеливо	Adjective
пролетна	Adjective
веѓа	Noun
инвестира	Verb
извинило	Participle
власникот	Noun
заразуваат	Verb
пилотите	Noun
усвоен	Participle
врзат	Verb
командува	Verb
осудила	Participle
кожниот	Adjective
директните	Adjective
потковица	Noun
затвореник	Noun
ангажирајќи	Converb
услужен	Adjective
слатководна	Adjective
убав	Adjective
вклучил	Participle
барикадата	Noun
еднакви	Adjective
дејството	Noun
овозможил	Participle
дозволувало	Participle
срцева	Adjective
размислете	Verb
уредуваме	Verb
мотела	Noun
неправедна	Adjective
пораснала	Participle
жив	Adjective
подземнине	Adjective
солите	Noun
филозофската	Adjective
цртал	Participle
заден	Adjective
гумена	Adjective
надзнак	Noun
врзе	Verb
дресурана	Noun
клиника	Noun
востаниците	Noun
коритата	Noun
скелетите	Noun
колач	Noun
придржеа	Verb
изненаден	Participle
блокадата	Noun
развијат	Verb
знаев	Verb
дување	Masdar
хаотичниот	Adjective
запознала	Participle
југозападна	Adjective
латинично	Adjective
потрошија	Verb
пресметка	Noun
незадоволните	Adjective
спасував	Verb
Британецот	Noun
валкаш	Verb
затвориле	Participle
минат	Adjective
влажното	Adjective
бејзбол	Noun
фолклорот	Noun
далечното	Adjective
разрешело	Participle
нектариве	Noun
семејно	Adjective
злобната	Adjective
пијат	Verb
отечеле	Participle
дождливата	Adjective
четава	Noun
причинат	Verb
заемка	Noun
ерменска	Adjective
трајно	Adjective
нагласувајќи	Converb
постоело	Participle
пичето	Noun
подобрите	Verb
пресадите	Verb
распуштена	Adjective
вперен	Participle
споредивте	Verb
изнајмил	Participle
споредбите	Noun
паралелограм	Noun
жестоко	Adjective
противнапад	Noun
вид	Noun
изговорен	Participle
незрелиов	Adjective
фрустриран	Participle
изневерувал	Participle
нанесен	Participle
бакнеж	Noun
вистинит	Adjective
водоотпорниот	Adjective
балчаков	Noun
коктел	Noun
глобусот	Noun
золва	Noun
коцко	Noun
непожелно	Adjective
расипуваат	Verb
ноја	Noun
утврдувал	Participle
запишавте	Verb
пече	Verb
целат	Verb
чекора	Noun
ќелава	Adjective
дипломатсково	Adjective
неформален	Adjective
мишка	Noun
споменувал	Participle
сината	Adjective
руската	Adjective
космос	Noun
пазарната	Adjective
електрицитетот	Noun
крукчено	Noun
самотно	Adjective
маршрута	Noun
грабливка	Noun
интервенцијата	Noun
хранеле	Participle
третата	Adjective
итна	Adjective
целокупното	Adjective
снопа	Noun
сниман	Participle
повторев	Verb
вештите	Adjective
бесшумно	Adjective
клиторисон	Noun
леј	Verb
стотките	Noun
романска	Adjective
жерав	Noun
бомбардирала	Participle
постон	Noun
иглолисна	Adjective
мебел	Noun
резервите	Noun
ироничен	Adjective
прста	Noun
пројавил	Participle
помрачен	Participle
фашистичките	Adjective
забавело	Participle
збег	Noun
срушил	Participle
руча	Verb
изведувал	Participle
вештерите	Noun
стоплило	Participle
очниот	Adjective
кралствово	Noun
лим	Noun
цвеќарон	Noun
видливото	Adjective
подведувач	Noun
покривајќи	Converb
готвеле	Participle
нејасната	Adjective
диви	Adjective
почетнион	Adjective
краткотрајни	Adjective
манометар	Noun
блокот	Noun
диплам	Verb
корејско	Adjective
пукотниците	Noun
камбана	Noun
магнетна	Adjective
трчаат	Verb
завидливеца	Noun
колонизиран	Participle
усвоила	Participle
проектов	Noun
западнеа	Verb
залижевме	Verb
спиралите	Noun
извинил	Participle
сретнав	Verb
златникот	Noun
соодветствува	Verb
речното	Adjective
несвесното	Adjective
лебот	Noun
пресметај	Verb
набројуван	Participle
искористат	Verb
средношколец	Noun
чета	Noun
недостижната	Adjective
боксот	Noun
признале	Participle
безумиено	Noun
меѓусебното	Adjective
модернизмот	Noun
убавата	Adjective
дигестивниот	Adjective
пренесувала	Participle
поддржиме	Verb
постигнеме	Verb
предела	Noun
соединиле	Participle
социјални	Adjective
покачувале	Participle
мантилите	Noun
изедначила	Participle
зевајте	Verb
бактериската	Adjective
корите	Noun
напуштиме	Verb
кафенине	Adjective
едрилица	Noun
кнедлите	Noun
дефиниран	Participle
лупат	Verb
вметне	Verb
прикажал	Participle
јужни	Adjective
зенитиве	Noun
либералните	Adjective
собрала	Participle
борбана	Noun
прекоруваме	Verb
прекинало	Participle
волнено	Adjective
прикажавме	Verb
постот	Noun
слушаат	Verb
глумицава	Noun
подмирело	Participle
прикријат	Verb
пипер	Noun
багерите	Noun
поцрнувало	Participle
секретите	Noun
суделе	Participle
стомакот	Noun
патката	Noun
манипулирање	Masdar
мед	Noun
нацист	Noun
обожавал	Participle
прегледан	Participle
славно	Adjective
вдлабнатината	Noun
клеточното	Adjective
настојуваш	Verb
згоиш	Verb
дошле	Participle
коментирајќи	Converb
немаме	Verb
просјаков	Noun
хрватскиот	Adjective
располагавме	Verb
неодамнешеноно	Adjective
мравкава	Noun
обработувало	Participle
месностите	Noun
дупките	Noun
изводливо	Adjective
сланина	Noun
видиш	Verb
отплатата	Noun
даб	Noun
симболизирало	Participle
спомнам	Verb
растурат	Verb
отсликувала	Participle
забранило	Participle
палецот	Noun
телесен	Adjective
безобразни	Adjective
астролошката	Adjective
прикриен	Participle
самозаштита	Noun
должела	Participle
мочање	Masdar
подготвил	Participle
деминутивот	Noun
излечила	Participle
продавачка	Noun
разделуваат	Verb
наплатат	Verb
напуштање	Masdar
ковчезите	Noun
тираните	Noun
прашувате	Verb
грмело	Participle
хронолошките	Adjective
трапавана	Adjective
пропорционално	Adjective
дождовнава	Adjective
колонизирале	Participle
позерка	Noun
надувувате	Verb
иден	Participle
фините	Adjective
пусто	Adjective
менлив	Adjective
запишувало	Participle
пречело	Participle
женско	Adjective
мешаницата	Noun
образложува	Verb
било	Participle
ограбија	Verb
доспремиме	Verb
поставувал	Participle
спроведуваа	Verb
вакуумон	Noun
стапот	Noun
мускула	Noun
заострила	Participle
откажува	Verb
чадење	Masdar
манирите	Noun
жрецот	Noun
претворил	Participle
драго	Adjective
штитник	Noun
продажноно	Adjective
мелодијата	Noun
попладневнине	Adjective
помислат	Verb
прејди	Verb
двојната	Adjective
вонбрачниот	Adjective
долгорочна	Adjective
најавите	Verb
завршувала	Participle
истрошен	Participle
ехидна	Noun
судиите	Noun
извонредниот	Adjective
крематориумот	Noun
криејќи	Converb
стресни	Adjective
потчинетиот	Adjective
таинствена	Adjective
дувнал	Participle
моментов	Noun
тензија	Noun
питом	Adjective
матриците	Noun
нудење	Masdar
подбутнеме	Verb
шпанскиот	Adjective
стигне	Verb
смртно	Adjective
одговорниов	Adjective
омразата	Noun
папокот	Noun
наметливоста	Noun
бранам	Verb
скромно	Adjective
доцниот	Adjective
влошувало	Participle
сторија	Verb
будејќи	Converb
замавнал	Participle
кадри	Adjective
забележителни	Adjective
зглобовиве	Noun
дефинитивните	Adjective
пораст	Noun
зел	Participle
грчко	Adjective
секретарка	Noun
објавувале	Participle
приговараат	Verb
морфолошко	Adjective
природното	Adjective
дигиталната	Adjective
поднесувал	Participle
допирала	Participle
вградат	Verb
почетно	Adjective
барањето	Noun
докторирам	Verb
програмот	Noun
доцен	Adjective
заборавало	Participle
споредувајќи	Converb
доминантното	Adjective
приготвен	Participle
повратните	Adjective
припрема	Verb
успешен	Adjective
разоноделе	Participle
збунат	Verb
исландскииот	Adjective
недоволен	Adjective
дејностите	Noun
занимавало	Participle
кампањите	Noun
криело	Participle
преработиле	Participle
уредивме	Verb
смолата	Noun
свесниот	Adjective
осамувавте	Verb
непопустливи	Adjective
ној	Noun
прецветај	Verb
примитивен	Adjective
постојана	Adjective
надминаа	Verb
факторот	Noun
пристрасно	Adjective
близина	Noun
треперела	Participle
донесам	Verb
шушнел	Participle
прекажал	Participle
поправиле	Participle
заслужиле	Participle
образ	Noun
интелигентната	Adjective
карактеристично	Adjective
износила	Participle
книжевното	Adjective
спремаат	Verb
слободниот	Adjective
погромот	Noun
згодниот	Adjective
рогатана	Adjective
рибја	Adjective
ларвата	Noun
никнала	Participle
сплетеме	Verb
гасеницата	Noun
читам	Verb
вел	Noun
малите	Adjective
тропнев	Verb
наговориле	Participle
верував	Verb
проверките	Noun
неменливите	Adjective
преведов	Verb
воспоставило	Participle
умножил	Participle
кларинетот	Noun
почитување	Masdar
подвижните	Adjective
повластил	Participle
единството	Noun
викнев	Verb
истоварил	Participle
посочете	Verb
објаснив	Verb
астрономското	Adjective
посее	Verb
вметнеме	Verb
техничарот	Noun
идеалу	Noun
ефектот	Noun
шанкон	Noun
менингитисите	Noun
оптекот	Noun
молер	Noun
благословувај	Verb
ладните	Adjective
дофрлен	Participle
лежел	Participle
царското	Adjective
неделната	Adjective
преминувало	Participle
зачуван	Participle
зачинување	Masdar
лажните	Adjective
опишеме	Verb
туршија	Noun
неточно	Adjective
пловидба	Noun
придонесувајќи	Converb
пченичниве	Adjective
затвориме	Verb
забават	Verb
веројатно	Adjective
викаш	Verb
флотата	Noun
аџилаците	Noun
сегментот	Noun
удобно	Adjective
наречјето	Noun
девојчиштана	Noun
одбива	Verb
земјоделската	Adjective
имиџот	Noun
откажуван	Participle
покажала	Participle
одбивни	Adjective
молитвеникот	Noun
извалкаат	Verb
осуденикот	Noun
тинејџерската	Adjective
селско	Adjective
тромава	Adjective
етничко	Adjective
безгрижен	Adjective
раскинуваат	Verb
груби	Adjective
предуслов	Noun
пристоен	Adjective
истата	Adjective
латинска	Adjective
издадоа	Verb
завршеле	Participle
кинеската	Adjective
мајкана	Noun
прогласиме	Verb
целово	Adjective
пракса	Noun
удобен	Adjective
индиректни	Adjective
битни	Adjective
кревала	Participle
цензурирање	Masdar
заспивала	Participle
калата	Noun
женска	Adjective
фонетска	Adjective
водоскоков	Noun
растворливи	Adjective
зајакнал	Participle
ерген	Noun
зборување	Masdar
предните	Adjective
престапот	Noun
деген	Noun
фламингата	Noun
господине	Noun
вработување	Masdar
затворило	Participle
навратиме	Verb
киното	Noun
уплатата	Noun
балканската	Adjective
раскомотувате	Verb
надлежната	Adjective
блокада	Noun
објаснило	Participle
задолжителни	Adjective
засебната	Adjective
куц	Adjective
измил	Participle
соблекувална	Noun
кревет	Noun
вегетаријанките	Noun
повеќенаменскине	Adjective
афричка	Adjective
рандевуво	Noun
кама	Noun
помогнало	Participle
ѕвездичката	Noun
актуелни	Adjective
расистичкиот	Adjective
знаело	Participle
наводната	Adjective
свадбенион	Adjective
грмушките	Noun
одразуваат	Verb
површната	Adjective
обичната	Adjective
намесник	Noun
виновниците	Noun
наметката	Noun
беснеев	Verb
засадат	Verb
смислуваат	Verb
наслонам	Verb
согледување	Masdar
благородни	Adjective
витештвото	Noun
вдахнала	Participle
израснеа	Verb
разјаснување	Masdar
челична	Adjective
маченица	Noun
месниот	Adjective
шестите	Adjective
споредно	Adjective
студирале	Participle
пополнат	Verb
ширело	Participle
архаичните	Adjective
ножен	Adjective
уверува	Verb
првенствените	Adjective
дуелот	Noun
книшка	Noun
поттикнува	Verb
стаклената	Adjective
џигер	Noun
проверете	Verb
долините	Noun
дарувам	Verb
весника	Noun
циклусите	Noun
актерот	Noun
портата	Noun
селанецу	Noun
распуштената	Adjective
настапите	Verb
оправдувал	Participle
вторите	Adjective
ѕвоната	Noun
искористиле	Participle
шипка	Noun
отвореа	Verb
спречува	Verb
онтолошките	Adjective
муслиман	Noun
илјадитата	Adjective
снаодливово	Adjective
гимнастичарите	Noun
претпоставувала	Participle
штитат	Verb
престижни	Adjective
постепената	Adjective
дотогашното	Adjective
државни	Adjective
битовите	Noun
функционираа	Verb
морковот	Noun
населија	Verb
раслоија	Verb
автомобилот	Noun
акцент	Noun
гаранциите	Noun
квачка	Noun
колонизирала	Participle
мислев	Verb
женкарско	Adjective
топлокрвни	Adjective
отплеткувал	Participle
марионетине	Noun
интернетскиот	Adjective
калливото	Adjective
поминало	Participle
просвето	Noun
гела	Noun
спомнува	Verb
аскер	Noun
изреките	Noun
калуѓерите	Noun
заборавила	Participle
подучуваме	Verb
исполнувал	Participle
вистинитите	Adjective
страстен	Adjective
џебовите	Noun
густите	Adjective
променет	Participle
точната	Adjective
полетаат	Verb
абортусите	Noun
нинџана	Noun
бакшишов	Noun
испаѓаш	Verb
преместете	Verb
верзииве	Noun
тера	Verb
настојување	Masdar
фашистичкиов	Adjective
запленил	Participle
сокрие	Verb
дугмето	Noun
боцкање	Masdar
налозите	Noun
хомогени	Adjective
празнат	Verb
козјо	Adjective
питома	Adjective
брои	Verb
одобруваат	Verb
запирката	Noun
излегоа	Verb
скокај	Verb
замислил	Participle
излажала	Participle
могилите	Noun
компромитира	Verb
стигам	Verb
капиталистичката	Adjective
нагласувале	Participle
темињата	Noun
определеното	Adjective
конечен	Adjective
абдомен	Noun
поврзувајќи	Converb
пулсот	Noun
докажале	Participle
образовал	Participle
платила	Participle
миел	Participle
адутите	Noun
откажувајќи	Converb
дијаметрине	Noun
постаноците	Noun
мукаме	Verb
жедни	Adjective
тамошниот	Adjective
затурев	Verb
кројачко	Adjective
нагризеа	Verb
Финците	Noun
сувомеснат	Adjective
спојат	Verb
приклучен	Participle
окапаа	Verb
прераскажува	Verb
малолетен	Adjective
таратур	Noun
естетскиот	Adjective
испружен	Participle
дискутираат	Verb
портите	Noun
наидувала	Participle
невротична	Adjective
дискретните	Adjective
големиот	Adjective
делотворни	Adjective
смртоносната	Adjective
јорганиве	Noun
влакнестите	Adjective
случајната	Adjective
неквалитетен	Adjective
правно	Adjective
телесното	Adjective
навредува	Verb
белег	Noun
стимулиран	Participle
растителната	Adjective
ширел	Participle
могилата	Noun
кров	Noun
џебот	Noun
учителска	Adjective
прегрнеме	Verb
петицијата	Noun
спонтаното	Adjective
лежеле	Participle
регулативата	Noun
управуваа	Verb
контрастите	Noun
програмските	Adjective
дигни	Verb
занимавам	Verb
теретите	Noun
клуча	Noun
лажно	Adjective
конкурсите	Noun
глатко	Adjective
ергенска	Adjective
куќен	Adjective
програмскиот	Adjective
шахот	Noun
споиле	Participle
угасивме	Verb
мера	Noun
атомот	Noun
охрабруваа	Verb
плазмата	Noun
маичка	Noun
задгробни	Adjective
макавме	Verb
уверите	Verb
задоволувале	Participle
починуваш	Verb
крстителон	Noun
урива	Verb
капитал	Noun
неопходен	Adjective
Бугарине	Noun
мотоциклот	Noun
велосипедот	Noun
рашират	Verb
печките	Noun
гатале	Participle
портретот	Noun
издржувала	Participle
цртежите	Noun
корекцијата	Noun
спречен	Participle
плачливоно	Adjective
пајтонот	Noun
владетелите	Noun
силуваат	Verb
торба	Noun
мазно	Adjective
мајтапчике	Noun
лингвистот	Noun
реновирање	Masdar
суетен	Adjective
префрлиле	Participle
култура	Noun
издувам	Verb
автоматската	Adjective
отпише	Verb
звучење	Masdar
првичен	Adjective
врзувала	Participle
распуштенана	Adjective
алкохолен	Adjective
надворешни	Adjective
известуваме	Verb
мешунките	Noun
бранува	Verb
показалец	Noun
оревот	Noun
кроасан	Noun
ѕвоното	Noun
спарел	Participle
одрекувајте	Verb
повториме	Verb
работите	Verb
навален	Participle
слегуваат	Verb
прекрасна	Adjective
органскиот	Adjective
наметнуваат	Verb
претпостават	Verb
очевидците	Noun
летуваш	Verb
смируваат	Verb
множејќи	Converb
украсната	Adjective
младите	Adjective
беспомошно	Adjective
уредна	Adjective
мјаукав	Verb
соединија	Verb
меѓусебната	Adjective
потколеница	Noun
теснава	Adjective
изразел	Participle
нашле	Participle
држењето	Noun
испапај	Verb
комплетното	Adjective
финансирале	Participle
борбите	Noun
кренал	Participle
вештачката	Adjective
учествува	Verb
памучен	Adjective
зборувајте	Verb
шушневме	Verb
разликуваа	Verb
Холанѓанецон	Noun
десниот	Adjective
полскиот	Adjective
ангелов	Noun
диригирање	Masdar
целосни	Adjective
значел	Participle
обука	Noun
плашта	Noun
богатото	Adjective
заразно	Adjective
жртвуван	Participle
пробијат	Verb
измерија	Verb
ликвидирање	Masdar
прибран	Participle
биди	Verb
чистосрдечна	Adjective
мандарина	Noun
чујат	Verb
јагода	Noun
алигатор	Noun
книжевната	Adjective
одецине	Noun
танчерката	Noun
шушнавме	Verb
хора	Noun
капина	Noun
мускул	Noun
словенечките	Adjective
традиционални	Adjective
обложувалниците	Noun
благиот	Adjective
хуморите	Noun
века	Noun
чувал	Participle
пазарни	Adjective
златните	Adjective
запаливите	Adjective
набијат	Verb
сечела	Participle
невротични	Adjective
свесното	Adjective
апсен	Participle
укинал	Participle
правопропорционален	Adjective
забрануван	Participle
сексуалната	Adjective
мечувалец	Noun
пополниле	Participle
привилегиравме	Verb
насрчело	Participle
викавме	Verb
дополнителните	Adjective
подава	Verb
среќаваа	Verb
иницијативата	Noun
скршивме	Verb
наведи	Verb
расни	Adjective
повлечеш	Verb
лабораторија	Noun
порнографските	Adjective
циркулираат	Verb
блескаат	Verb
тава	Noun
животни	Adjective
бингоно	Noun
бомбардирале	Participle
раствораат	Verb
потчинат	Verb
џемов	Noun
достигнувал	Participle
преработил	Participle
праќаме	Verb
охридската	Adjective
повредувајќи	Converb
расистичката	Adjective
трошачот	Noun
алатките	Noun
проширија	Verb
предното	Adjective
тажната	Adjective
шопинзиве	Noun
непреодниот	Adjective
освестува	Verb
Украинците	Noun
морална	Adjective
поседуваа	Verb
одлучувајќи	Converb
штрковите	Noun
прославија	Verb
орадава	Noun
расплет	Noun
интернационални	Adjective
легне	Verb
дробниот	Adjective
погребан	Participle
бакарен	Adjective
портрет	Noun
лулашко	Noun
копал	Participle
истава	Adjective
придвижен	Participle
напуштаа	Verb
љубоморноно	Adjective
почитуваат	Verb
акробат	Noun
верска	Adjective
цензурирајќи	Converb
тргувајќи	Converb
надвојвода	Noun
прехранбената	Adjective
опкружил	Participle
фараон	Noun
примач	Noun
добрината	Noun
тенџерињата	Noun
трампа	Noun
зајак	Noun
почитува	Verb
географскиот	Adjective
принудувајќи	Converb
сметав	Verb
ветувало	Participle
свештеник	Noun
невозможното	Adjective
избегнуваа	Verb
потисни	Verb
искрварев	Verb
бодовите	Noun
елегантно	Adjective
читливи	Adjective
инсистира	Verb
сфатила	Participle
раѓан	Participle
партијата	Noun
латиничното	Adjective
остариме	Verb
вообичаениот	Adjective
огорчена	Adjective
галериите	Noun
деценијава	Noun
пченкарноно	Adjective
собрал	Participle
воншколско	Adjective
открил	Participle
катастрофалнана	Adjective
половиот	Adjective
наведнав	Verb
нос	Noun
проблематична	Adjective
променлива	Adjective
пејачките	Noun
основач	Noun
пожелни	Adjective
апсолутни	Adjective
астрономската	Adjective
силинана	Noun
клекнал	Participle
избие	Verb
луксузната	Adjective
спонтана	Adjective
стоело	Participle
очните	Adjective
еврејското	Adjective
комунист	Noun
дознало	Participle
отуѓија	Verb
доостриш	Verb
насилно	Adjective
нареднава	Adjective
шпионирање	Masdar
сличностине	Noun
древен	Adjective
смелине	Adjective
вајарството	Noun
умереното	Adjective
пренасочил	Participle
рецепторот	Noun
технолошкиот	Adjective
планирање	Masdar
накурчивте	Verb
крушите	Noun
спасениево	Noun
апсолутен	Adjective
удирале	Participle
остреле	Participle
сложениот	Adjective
симнувајќи	Converb
приговарате	Verb
првичната	Adjective
изработија	Verb
интересирајќи	Converb
произведувало	Participle
мир	Noun
складно	Adjective
скиците	Noun
јазично	Adjective
вратија	Verb
хранливава	Adjective
карале	Participle
едноличнион	Adjective
паричниот	Adjective
бабичкине	Noun
минуваа	Verb
погубила	Participle
пружање	Masdar
закачивме	Verb
објавиле	Participle
затвораа	Verb
предосетев	Verb
опасниот	Adjective
задоволат	Verb
возев	Verb
јогуртот	Noun
рефлексите	Noun
магионичарот	Noun
запленет	Participle
познава	Verb
набабреле	Participle
добијте	Verb
познаат	Verb
наметнал	Participle
губат	Verb
првото	Adjective
терористот	Noun
благородник	Noun
шпекулирал	Participle
собирајќи	Converb
карал	Participle
препорачан	Participle
деецот	Noun
засебните	Adjective
разговарале	Participle
поправите	Verb
кумана	Noun
барикадира	Verb
товарната	Adjective
белката	Noun
естрогените	Noun
набедувам	Verb
туристите	Noun
пописов	Noun
овозможувавме	Verb
тиранин	Noun
миксер	Noun
бестрашниот	Adjective
паузирање	Masdar
накалемев	Verb
марионета	Noun
кадрави	Adjective
смалиле	Participle
повлекувала	Participle
плочникот	Noun
воведувавме	Verb
медузите	Noun
огнометот	Noun
тетовските	Adjective
ширеа	Verb
цветавме	Verb
здружила	Participle
споредите	Verb
произведи	Verb
надитрија	Verb
вола	Noun
лечеа	Verb
шеќерни	Adjective
интелигентна	Adjective
албанска	Adjective
крвавата	Adjective
бледнее	Verb
лапање	Masdar
совршените	Adjective
придружниците	Noun
нарекуван	Participle
сложила	Participle
стеснувајќи	Converb
прикажан	Participle
внимателните	Adjective
умираат	Verb
појдат	Verb
гладуваат	Verb
лектор	Noun
тврдоглав	Adjective
тортите	Noun
безбројните	Adjective
духовнана	Adjective
внук	Noun
збива	Verb
разбудете	Verb
врамувал	Participle
фашизмот	Noun
фрустрирав	Verb
математичко	Adjective
разновидна	Adjective
румена	Adjective
трагичните	Adjective
питана	Noun
агол	Noun
навиеја	Verb
кириличните	Adjective
реката	Noun
претевте	Verb
архивира	Verb
брзаат	Verb
трпелив	Adjective
вирусниот	Adjective
трагични	Adjective
подводниот	Adjective
интегритетот	Noun
јаглехидрат	Noun
предвидуваат	Verb
прогресивново	Adjective
португалските	Adjective
симнале	Participle
режирајќи	Converb
кафеавата	Adjective
словачкион	Adjective
паметните	Adjective
слушнав	Verb
повратнава	Adjective
кукло	Noun
споредат	Verb
лед	Noun
станон	Noun
хетеросексуалноно	Adjective
почетничка	Noun
препратевме	Verb
дресирајќи	Converb
загубат	Verb
америчките	Adjective
самата	Adjective
наметне	Verb
варат	Verb
краток	Adjective
поцрнува	Verb
зафатените	Adjective
орудието	Noun
потопува	Verb
бучни	Adjective
рима	Noun
глумење	Masdar
умерената	Adjective
шпица	Noun
местен	Adjective
пеперутката	Noun
океанскиот	Adjective
цврсти	Adjective
вознесението	Noun
тргувале	Participle
запаметат	Verb
потрошувачите	Noun
разгорила	Participle
претурело	Participle
совршено	Adjective
стекнувал	Participle
катастрофален	Adjective
скалпирање	Masdar
дефинитивно	Adjective
разговара	Verb
наплатите	Verb
воините	Noun
костенливиот	Adjective
впечатлив	Adjective
плавите	Adjective
неприкосновениот	Adjective
сакавме	Verb
план	Noun
срната	Noun
присуствува	Verb
деветаголник	Noun
положува	Verb
натприродна	Adjective
преземеме	Verb
игран	Participle
буреков	Noun
создадовме	Verb
продирале	Participle
измешам	Verb
рачно	Adjective
сувомеснато	Adjective
синтаксине	Noun
програмирајте	Verb
неприкосновен	Adjective
прогонствата	Noun
мајсторите	Noun
стапицава	Noun
погрешните	Adjective
истушувал	Participle
ставив	Verb
чекање	Masdar
белодробниот	Adjective
сонувам	Verb
небесни	Adjective
темелно	Adjective
тренираме	Verb
спаѓа	Verb
застане	Verb
настинеа	Verb
реагирам	Verb
бадемот	Noun
фондот	Noun
вклучија	Verb
неразделни	Adjective
војно	Noun
историска	Adjective
надгледување	Masdar
кажувај	Verb
древната	Adjective
бакни	Verb
челичнине	Adjective
Корејките	Noun
блиско	Adjective
страшната	Adjective
нормалното	Adjective
козите	Noun
возвишението	Noun
кожата	Noun
паѓале	Participle
купувач	Noun
големо	Adjective
животинка	Noun
округол	Adjective
бодење	Masdar
лажам	Verb
престапувате	Verb
влезен	Participle
шуплината	Noun
пиленцево	Noun
зумбул	Noun
добричела	Participle
месечен	Adjective
ѕидот	Noun
просто	Adjective
невролошкана	Adjective
носел	Participle
првенственото	Adjective
румот	Noun
албум	Noun
определбите	Noun
мрзлив	Adjective
развивал	Participle
штукана	Noun
преколнуваме	Verb
брзо	Adjective
младоженеца	Noun
достоинството	Noun
крпата	Noun
ушниот	Adjective
отсечен	Participle
либерал	Noun
фонолошкиот	Adjective
завршило	Participle
додркајте	Verb
поништил	Participle
преселиле	Participle
облекувал	Participle
ограничувало	Participle
продавање	Masdar
биде	Verb
проклетството	Noun
сеопфатните	Adjective
шницло	Noun
традиционалниот	Adjective
оставаат	Verb
шапките	Noun
куца	Adjective
осиромашиле	Participle
вежбање	Masdar
увидувајќи	Converb
утврдила	Participle
милицијата	Noun
модра	Adjective
шилец	Noun
уплашам	Verb
мислиме	Verb
јазичар	Noun
преобразило	Participle
афродизијак	Noun
гласање	Masdar
мување	Masdar
отпеала	Participle
разговарајќи	Converb
бравариве	Noun
подигнаа	Verb
потсмевање	Masdar
тројка	Noun
избркан	Participle
ситниот	Adjective
росење	Masdar
кравине	Noun
откажало	Participle
забележевте	Verb
коњиве	Noun
готово	Adjective
феудалецот	Noun
збуневте	Verb
посрамотувам	Verb
вечна	Adjective
умна	Adjective
влашко	Adjective
прогоните	Verb
образуван	Participle
побожните	Adjective
исцрпат	Verb
пратила	Participle
адаптира	Verb
мангото	Noun
покривите	Noun
манифестирало	Participle
опатијата	Noun
хранливите	Adjective
пливачот	Noun
непредвидливоста	Noun
хлоропластите	Noun
коритоно	Noun
гајда	Noun
директорките	Noun
сакало	Participle
пријателско	Adjective
глувците	Noun
пресметките	Noun
ризик	Noun
уживал	Participle
проѕирна	Adjective
уриваат	Verb
растителни	Adjective
потврдувавме	Verb
отфрламе	Verb
незрели	Adjective
развија	Verb
завршетоците	Noun
попладневна	Adjective
финансирала	Participle
прифаќаат	Verb
преувеличуваме	Verb
дворска	Adjective
алелот	Noun
мешање	Masdar
морепловецу	Noun
печурките	Noun
субјектот	Noun
космонаут	Noun
раскажува	Verb
тенисерот	Noun
доверил	Participle
прешла	Participle
подобруваат	Verb
долнава	Adjective
темјанот	Noun
изразување	Masdar
приспособливите	Adjective
пеат	Verb
сочно	Adjective
шаблонот	Noun
бамјата	Noun
балерините	Noun
стабилно	Adjective
партитурата	Noun
смислува	Verb
видовит	Adjective
инвестирање	Masdar
раскинуваме	Verb
илустриран	Participle
добивате	Verb
милува	Verb
прекинале	Participle
меѓународниот	Adjective
стоплиле	Participle
качила	Participle
гимнастичариве	Noun
донесеш	Verb
успевање	Masdar
избегнување	Masdar
јавувавте	Verb
научна	Adjective
киднапирал	Participle
празната	Adjective
астрономијата	Noun
венците	Noun
новогодишен	Adjective
велиме	Verb
терминологијава	Noun
животниот	Adjective
недостигала	Participle
запознајте	Verb
избушете	Verb
потпишувал	Participle
тврдоглави	Adjective
мајмуните	Noun
вирусот	Noun
поседуваат	Verb
полицаец	Noun
различната	Adjective
проблематичното	Adjective
задоволителните	Adjective
беспомошнине	Adjective
белодробната	Adjective
бранов	Noun
чума	Noun
босилек	Noun
преместиме	Verb
маринирало	Participle
шкотскиот	Adjective
вклучам	Verb
гасовитоно	Adjective
корејската	Adjective
приватното	Adjective
грака	Verb
несреќникон	Noun
вдишување	Masdar
квалитетен	Adjective
потенциран	Participle
опфатив	Verb
контејнерите	Noun
среќни	Adjective
возен	Participle
дождовните	Adjective
последиците	Noun
барокна	Adjective
свечено	Adjective
истрела	Noun
вроденоно	Adjective
држело	Participle
силниот	Adjective
придадоа	Verb
изебав	Verb
подложноста	Noun
учествуваат	Verb
ненаситноста	Noun
сочуваме	Verb
непристојни	Adjective
наоѓаме	Verb
барон	Noun
тиква	Noun
настапува	Verb
карактеризираа	Verb
глатките	Adjective
горчлив	Adjective
преобразува	Verb
греј	Verb
лични	Adjective
читаа	Verb
униформата	Noun
срцевина	Noun
прават	Verb
тренинг	Noun
дарувала	Participle
временските	Adjective
дигиталниот	Adjective
опсегот	Noun
обезбедија	Verb
урната	Noun
пеколниот	Adjective
програмскана	Adjective
завивање	Masdar
загреан	Participle
бунтовничка	Noun
загрозувала	Participle
кодекс	Noun
изговара	Verb
згрутчуваш	Verb
палеле	Participle
македонскиот	Adjective
истушите	Verb
наградувале	Participle
мислеа	Verb
пролетната	Adjective
наместиле	Participle
целиме	Verb
двогодишна	Adjective
барот	Noun
местата	Noun
почнавме	Verb
радувале	Participle
газелата	Noun
испитуваме	Verb
речна	Adjective
поздравен	Participle
толкува	Verb
ветеринарот	Noun
побелел	Participle
пофалила	Participle
изразуваме	Verb
понесен	Participle
снабдување	Masdar
неразделново	Adjective
папка	Noun
каење	Masdar
поддржувавте	Verb
дуел	Noun
продадоа	Verb
прошират	Verb
комуницирање	Masdar
обновува	Verb
нејасноста	Noun
божествава	Noun
ситана	Noun
невин	Adjective
праксата	Noun
љубомора	Noun
броел	Participle
војна	Noun
времето	Noun
фонетската	Adjective
свинска	Adjective
помагал	Participle
марширала	Participle
минималните	Adjective
доказот	Noun
телефонот	Noun
истребеа	Verb
опуштено	Adjective
империја	Noun
портокалите	Noun
норвешко	Adjective
назначите	Verb
еластичноста	Noun
прифаќаме	Verb
јарем	Noun
мрднаат	Verb
одмараат	Verb
китките	Noun
зажалите	Verb
стоен	Participle
константа	Noun
загриземе	Verb
бојкотирале	Participle
новине	Adjective
неважен	Adjective
хиперболата	Noun
смут	Noun
нерва	Noun
простувате	Verb
загатка	Noun
волненото	Adjective
тренерскиот	Adjective
безбедносно	Adjective
изданието	Noun
херпесон	Noun
праведен	Adjective
створила	Participle
предложија	Verb
костенот	Noun
отштетата	Noun
масана	Noun
оневозможување	Masdar
пензионерските	Adjective
лавана	Noun
работничкото	Adjective
закитиле	Participle
плодна	Adjective
одбранил	Participle
творечкиот	Adjective
екскреторниве	Adjective
лен	Noun
чаршијата	Noun
исправката	Noun
докосило	Participle
волшебник	Noun
дигестивнион	Adjective
минимализмот	Noun
ненадејно	Adjective
симболизирајќи	Converb
досетка	Noun
помогнеш	Verb
обесправело	Participle
препорачувале	Participle
скотовине	Noun
капиталистичкине	Adjective
симболично	Adjective
бршлен	Noun
гладен	Adjective
колонизирајќи	Converb
наставен	Adjective
разрушиле	Participle
дивите	Adjective
качат	Verb
навредивте	Verb
поразите	Verb
испуштат	Verb
чувар	Noun
законитоста	Noun
пребледувам	Verb
повеќегодишни	Adjective
умри	Verb
раскинал	Participle
јо	Noun
меѓуѕвезденово	Adjective
пита	Noun
огрдевме	Verb
бисерна	Adjective
кесево	Noun
исполнуваат	Verb
мртвиот	Adjective
младата	Adjective
исправно	Adjective
инспирираме	Verb
осетливите	Adjective
гледајќи	Converb
здогледувавме	Verb
преданието	Noun
менувачницата	Noun
замине	Verb
тропал	Participle
израмнив	Verb
едногодишната	Adjective
брич	Noun
отсечка	Noun
неорганските	Adjective
владите	Noun
плива	Verb
соодветни	Adjective
името	Noun
убиеш	Verb
преживување	Masdar
заработуваат	Verb
чучат	Verb
јасното	Adjective
обие	Verb
временскиот	Adjective
купатилана	Noun
адекватни	Adjective
откривајќи	Converb
научното	Adjective
платнената	Adjective
јак	Adjective
приватната	Adjective
надворешното	Adjective
разговорниот	Adjective
тргнала	Participle
шуплина	Noun
задоволувала	Participle
китката	Noun
доживееја	Verb
свињиве	Noun
сижето	Noun
матурант	Noun
убиствата	Noun
собиравме	Verb
недоверливи	Adjective
опииш	Verb
рингла	Noun
забивање	Masdar
двоножново	Adjective
очекувал	Participle
неуредна	Adjective
проѕирноно	Adjective
доработиле	Participle
тенџерево	Noun
акупунктура	Noun
епиглотисон	Noun
интелигенцијата	Noun
читање	Masdar
поиграм	Verb
прелудиумов	Noun
славеницине	Noun
објаснуваме	Verb
мразеа	Verb
потребен	Adjective
неморал	Noun
сонувајќи	Converb
хронолошко	Adjective
поевтинам	Verb
удоволите	Verb
капут	Noun
исушат	Verb
охриѓанецот	Noun
југозападно	Adjective
развиваат	Verb
југозападниот	Adjective
исклучувале	Participle
урбани	Adjective
перницата	Noun
дејствува	Verb
виткаат	Verb
ротација	Noun
одлучувале	Participle
свежи	Adjective
модерните	Adjective
жмигавцине	Noun
прелистувач	Noun
обезбедува	Verb
спаѓав	Verb
тревка	Noun
етнолог	Noun
упатиле	Participle
јавнело	Participle
избезумен	Participle
турни	Verb
прицврстување	Masdar
хамбургер	Noun
врие	Verb
правоаголна	Adjective
релативното	Adjective
оптималната	Adjective
хемичаркава	Noun
логичен	Adjective
обединиле	Participle
членката	Noun
оздравување	Masdar
разреден	Participle
средновековно	Adjective
снимка	Noun
отсликуваа	Verb
Норвежанецот	Noun
рипнев	Verb
правната	Adjective
неписмени	Adjective
габите	Noun
оправдувале	Participle
сеидба	Noun
каснало	Participle
покривал	Participle
ергенско	Adjective
предложува	Verb
стандард	Noun
парфем	Noun
пристигнаа	Verb
женет	Participle
охридското	Adjective
чумите	Noun
посрамотување	Masdar
касета	Noun
наводник	Noun
размислуваат	Verb
генерацијата	Noun
обилно	Adjective
заградувавме	Verb
дајте	Verb
продавало	Participle
чекорот	Noun
главното	Adjective
метаболизам	Noun
чуварот	Noun
одобрувајќи	Converb
фармата	Noun
соперништвово	Noun
цветање	Masdar
докторирајте	Verb
незгодната	Adjective
дошло	Participle
зачетоците	Noun
поздравувајќи	Converb
глумен	Participle
летнала	Participle
пружило	Participle
склучија	Verb
запираа	Verb
дискусијата	Noun
неприфатливи	Adjective
тепале	Participle
немирот	Noun
случување	Masdar
пребараат	Verb
даваш	Verb
куклен	Adjective
црвенилото	Noun
самостојната	Adjective
моделирал	Participle
уживам	Verb
бившо	Adjective
текстов	Noun
варира	Verb
статуите	Noun
лебдат	Verb
љубомората	Noun
предал	Participle
унгарската	Adjective
прифатливиот	Adjective
заборават	Verb
топат	Verb
сликарката	Noun
незадоволително	Adjective
кител	Participle
геноцидот	Noun
водестава	Adjective
бесните	Adjective
ползат	Verb
поднесувам	Verb
сирова	Adjective
опаш	Noun
унаказиш	Verb
виршло	Noun
плоден	Adjective
погодат	Verb
живеат	Verb
дојката	Noun
помателе	Participle
архива	Noun
упатија	Verb
повторил	Participle
преминуваш	Verb
навалуваме	Verb
ризикуваа	Verb
смок	Noun
шут	Noun
чаршијо	Noun
автобусот	Noun
пакуван	Participle
затвореника	Noun
прстите	Noun
Албанецот	Noun
србизмон	Noun
составното	Adjective
антонима	Noun
јавило	Participle
полнач	Noun
бирократ	Noun
образување	Masdar
остра	Adjective
крапот	Noun
брокула	Noun
онесвестил	Participle
двособното	Adjective
заработите	Verb
потега	Noun
одбивање	Masdar
заглавувам	Verb
неспоредливо	Adjective
неприспособливион	Adjective
данска	Adjective
окапал	Participle
манифестација	Noun
привлекувајќи	Converb
пронашло	Participle
неприродни	Adjective
усложнување	Masdar
буцнале	Participle
софрата	Noun
срцевиот	Adjective
типични	Adjective
стојам	Verb
составување	Masdar
ставот	Noun
биле	Participle
проколнаа	Verb
Хрватите	Noun
орден	Noun
гитаристите	Noun
лажејќи	Converb
паштета	Noun
израмниш	Verb
дневна	Adjective
индиректната	Adjective
миен	Participle
авторитетните	Adjective
истурпијате	Verb
пикник	Noun
визија	Noun
припишувало	Participle
безропотново	Adjective
прогресивен	Adjective
фротиров	Noun
Американец	Noun
густа	Adjective
полудува	Verb
обрежеле	Participle
дослушај	Verb
бутот	Noun
фиока	Noun
внесоа	Verb
материјалниот	Adjective
усвоило	Participle
лаже	Verb
мозочната	Adjective
есенскион	Adjective
лепливи	Adjective
специјалитетот	Noun
земате	Verb
грешам	Verb
планираат	Verb
прасечково	Adjective
стварање	Masdar
онеспособија	Verb
топлата	Adjective
земјите	Noun
говорникон	Noun
омилено	Adjective
присутната	Adjective
златник	Noun
возбудливине	Adjective
рециклирање	Masdar
билетов	Noun
следни	Adjective
лебед	Noun
обврзат	Verb
берберот	Noun
дехидрирај	Verb
сторив	Verb
мандаринските	Adjective
измамничка	Noun
потенцираат	Verb
лавов	Noun
обожаваат	Verb
глатки	Adjective
поплочен	Participle
портирниците	Noun
будат	Verb
вторичниот	Adjective
традиционалните	Adjective
израснало	Participle
среќна	Adjective
препорачува	Verb
педијатар	Noun
регенерирање	Masdar
косело	Participle
полнолетничките	Noun
шапката	Noun
задржуваме	Verb
стигмите	Noun
треснело	Participle
доближувал	Participle
бесовите	Noun
латвискиов	Adjective
беспомошна	Adjective
операторот	Noun
прецизни	Adjective
прозорот	Noun
уживање	Masdar
цистерните	Noun
гламните	Noun
личен	Adjective
прогласил	Participle
сварат	Verb
телето	Noun
влечејќи	Converb
баклава	Noun
градите	Verb
балконот	Noun
созреат	Verb
коњушарите	Noun
антибиотициве	Noun
интелигентните	Adjective
шеќерните	Adjective
донесен	Participle
неделни	Adjective
нечисто	Adjective
подготвувала	Participle
привлекувале	Participle
пополнила	Participle
засениш	Verb
пргавиве	Adjective
менувајќи	Converb
ферментираат	Verb
пропадне	Verb
прекрасен	Adjective
старомоден	Adjective
визбите	Noun
глупачиштана	Noun
напредувавте	Verb
товареа	Verb
отстранат	Verb
шприцаа	Verb
студенткава	Noun
зимувалиштено	Noun
отковеале	Participle
захефтате	Verb
воодушевуваат	Verb
спремале	Participle
промовиран	Participle
итрец	Noun
шестото	Adjective
одделниот	Adjective
премолчивте	Verb
отсутниот	Adjective
чајни	Adjective
безжичен	Adjective
морничави	Adjective
независниот	Adjective
надминувал	Participle
медовина	Noun
остро	Adjective
беспомошноно	Adjective
непцето	Noun
присутен	Adjective
ајдуку	Noun
јарено	Noun
компликација	Noun
внукот	Noun
применувал	Participle
трлото	Noun
апартманите	Noun
зачнала	Participle
жирафата	Noun
забележувам	Verb
клекнев	Verb
новите	Adjective
интимните	Adjective
запрепастен	Participle
грчкана	Adjective
самостојното	Adjective
оперите	Noun
насмеaв	Verb
четвртоодделенецов	Noun
навикнал	Participle
матна	Adjective
еретиците	Noun
поставувате	Verb
непријатноста	Noun
жилаво	Adjective
вентил	Noun
возможното	Adjective
доверитела	Noun
толерираш	Verb
дарежлив	Adjective
непропустливи	Adjective
оден	Participle
корисноста	Noun
киднапира	Verb
присутна	Adjective
френулумот	Noun
переа	Verb
развеселел	Participle
забележувал	Participle
споредба	Noun
муштеријана	Noun
итрите	Adjective
автократиине	Noun
релативно	Adjective
утринска	Adjective
фокуса	Noun
занимација	Noun
мачнината	Noun
гаѓа	Verb
купувачите	Noun
последичниот	Adjective
претворила	Participle
бел	Adjective
вдахнувајќи	Converb
здружението	Noun
жалат	Verb
информирање	Masdar
автопатите	Noun
разговорно	Adjective
поклоник	Noun
конкретен	Adjective
прашалните	Adjective
безначајнава	Adjective
причинителите	Noun
остарен	Participle
повреден	Participle
пресметан	Participle
егоист	Noun
непоколебливо	Adjective
прашалната	Adjective
влашкото	Adjective
обработката	Noun
инсталирал	Participle
полагање	Masdar
недоверливана	Adjective
роденденската	Adjective
измателе	Participle
следните	Adjective
мачениците	Noun
прифатливо	Adjective
прикачат	Verb
прецизната	Adjective
истушување	Masdar
жолтеникавите	Adjective
потценев	Verb
благословувајќи	Converb
несоодветни	Adjective
цитирате	Verb
лансирала	Participle
бронхиите	Noun
засенат	Verb
разменувавме	Verb
суштинскиот	Adjective
глумејќи	Converb
поправал	Participle
лепливово	Adjective
исплашил	Participle
бесење	Masdar
присвојуваат	Verb
успокојување	Masdar
раскошниот	Adjective
спалните	Adjective
маѓепсницана	Noun
сиво	Adjective
интензитетите	Noun
избере	Verb
мрачен	Adjective
раниме	Verb
изрезбарам	Verb
можеш	Verb
лав	Noun
расен	Adjective
поканивте	Verb
кремирање	Masdar
тастериве	Noun
изместен	Participle
боксовиве	Noun
земјоделието	Noun
сензорот	Noun
смета	Verb
искажам	Verb
останувало	Participle
бушење	Masdar
противничката	Noun
циклусот	Noun
доцното	Adjective
користевме	Verb
гушнеа	Verb
туристичката	Adjective
ориентација	Noun
сошие	Verb
редактор	Noun
споредил	Participle
доброволното	Adjective
габа	Noun
мачењето	Noun
нацистичко	Adjective
неврологот	Noun
произведуваат	Verb
оценките	Noun
брачната	Adjective
планирајќи	Converb
подучувајќи	Converb
шолја	Noun
задушен	Participle
бојов	Noun
крвави	Adjective
поранешната	Adjective
поставувајте	Verb
проценките	Noun
пофалиле	Participle
вкупното	Adjective
производител	Noun
ѕевгаров	Noun
невозможната	Adjective
повраќање	Masdar
избегнале	Participle
битните	Adjective
идеолошка	Adjective
велигденска	Adjective
расно	Adjective
заработува	Verb
задоволнана	Adjective
конец	Noun
влезам	Verb
хетеросексуална	Adjective
опивал	Participle
поврзувало	Participle
губејќи	Converb
загноив	Verb
шемата	Noun
служеле	Participle
неспособнана	Adjective
жива	Adjective
Ирец	Noun
наречен	Participle
поставен	Participle
вроденото	Adjective
соопштиле	Participle
одразила	Participle
монархијата	Noun
блесокот	Noun
обичен	Adjective
пудлица	Noun
акцентот	Noun
одмораат	Verb
црковен	Adjective
боцкава	Adjective
општење	Masdar
обрежан	Participle
молекуларна	Adjective
студентите	Noun
доцнел	Participle
полисахарид	Noun
посетување	Masdar
распределуваат	Verb
неразделен	Adjective
негираа	Verb
прегледаат	Verb
фреска	Noun
наведоа	Verb
литиумот	Noun
довршивте	Verb
фраза	Noun
непопустлив	Adjective
вложување	Masdar
молчење	Masdar
преправаат	Verb
алела	Noun
набеделе	Participle
безопасно	Adjective
тирето	Noun
значеле	Participle
поразиле	Participle
нем	Adjective
супите	Noun
бунтовите	Noun
комплетирање	Masdar
хибернирај	Verb
поставила	Participle
исцрцорев	Verb
мразовите	Noun
коваат	Verb
припадникот	Noun
уништувач	Noun
додадете	Verb
шмрка	Verb
монашкото	Adjective
централна	Adjective
одобрува	Verb
пристрасна	Adjective
спроведат	Verb
поразија	Verb
брзи	Adjective
изразил	Participle
помножиме	Verb
белоруските	Adjective
порочноста	Noun
софистицирано	Adjective
ленто	Noun
ушите	Noun
испушил	Participle
помогни	Verb
турцизам	Noun
свртен	Participle
осигурувачите	Noun
бери	Verb
идеа	Verb
наполнат	Verb
изедевте	Verb
бруталната	Adjective
советувалиштено	Noun
слатки	Adjective
препознае	Verb
самостојно	Adjective
луксузна	Adjective
поставела	Participle
тетовското	Adjective
авантурист	Noun
издишување	Masdar
дефинираме	Verb
личниот	Adjective
побудило	Participle
предложиме	Verb
убиван	Participle
подмачкате	Verb
фонолошко	Adjective
паролана	Noun
претворија	Verb
неспоредлива	Adjective
повторат	Verb
проштални	Adjective
раскопчај	Verb
очекувањата	Noun
борачу	Noun
мажење	Masdar
тремовите	Noun
нарачан	Participle
својствено	Adjective
чудотворната	Adjective
позајмувајќи	Converb
љубовџија	Noun
соединување	Masdar
магнетните	Adjective
губела	Participle
аван	Noun
лепливава	Adjective
времињата	Noun
познаваме	Verb
избрало	Participle
образуваа	Verb
искрата	Noun
бронза	Noun
излезите	Noun
летното	Adjective
овозможат	Verb
решија	Verb
раженот	Noun
закрепнала	Participle
умножам	Verb
воведувајќи	Converb
одбира	Verb
загрижував	Verb
врнежлив	Adjective
принудо	Noun
навлегле	Participle
сенаторите	Noun
обработливите	Adjective
подвижен	Adjective
вегетаријанската	Adjective
убедија	Verb
слабине	Adjective
маската	Noun
комплетно	Adjective
ренесансана	Noun
пеј	Verb
кротки	Adjective
привилегираш	Verb
поканело	Participle
цицо	Noun
стомачна	Adjective
шинело	Participle
оставај	Verb
гола	Adjective
стабилна	Adjective
ражен	Noun
дрвен	Adjective
презерватививе	Noun
моќен	Adjective
задната	Adjective
авторитетни	Adjective
современиот	Adjective
офицер	Noun
учат	Verb
вилица	Noun
потценил	Participle
спомнување	Masdar
побарајте	Verb
вперуван	Participle
зона	Noun
сексуалнана	Adjective
попречуваме	Verb
бескорисна	Adjective
пренесување	Masdar
принципот	Noun
денешни	Adjective
симболизирал	Participle
навалува	Verb
сметајќи	Converb
студиите	Noun
попречувале	Participle
ќелијата	Noun
католичкиот	Adjective
свратите	Verb
тесната	Adjective
кренавте	Verb
агрегатното	Adjective
располага	Verb
изработам	Verb
снимија	Verb
медарката	Noun
сметала	Participle
отидам	Verb
оплодуваат	Verb
метеоролошките	Adjective
пукнатина	Noun
префаќан	Participle
располагала	Participle
разнесен	Participle
авторитет	Noun
довршен	Participle
приговорил	Participle
изработат	Verb
моравме	Verb
вложила	Participle
австралиска	Adjective
муслиманска	Adjective
заробеник	Noun
доверувајќи	Converb
шинале	Participle
молитва	Noun
анус	Noun
садам	Verb
случајниот	Adjective
означуван	Participle
уредиле	Participle
Македонците	Noun
минимална	Adjective
кораба	Noun
консултација	Noun
потклекнев	Verb
згодната	Adjective
проповедале	Participle
менувале	Participle
проповедам	Verb
натриумов	Noun
посветил	Participle
пејачка	Noun
оревите	Noun
бранителот	Noun
оспособуваат	Verb
охрабрува	Verb
одмогнавте	Verb
мрена	Noun
намалуваат	Verb
царството	Noun
згодни	Adjective
ќутете	Verb
аптеката	Noun
деветтото	Adjective
одбивале	Participle
наизменично	Adjective
ножните	Adjective
острото	Adjective
прекрасниов	Adjective
компатибилен	Adjective
контактирала	Participle
чувствата	Noun
замисла	Noun
множење	Masdar
школото	Noun
незгодни	Adjective
смее	Verb
кучињата	Noun
обновило	Participle
признаат	Verb
жанровите	Noun
магнезиум	Noun
пропаѓа	Verb
борбената	Adjective
дорешат	Verb
серејќи	Converb
дефинирал	Participle
финската	Adjective
пурпурен	Adjective
добитник	Noun
чукнатото	Adjective
покрстија	Verb
добиваат	Verb
произведоа	Verb
жолтите	Adjective
наследните	Adjective
широк	Adjective
туристичка	Adjective
мрмот	Noun
средила	Participle
лакот	Noun
поднесуваш	Verb
споредбена	Adjective
смешен	Adjective
бандитите	Noun
адут	Noun
оценет	Participle
соработката	Noun
бактерискиов	Adjective
ослободувале	Participle
фигуричка	Noun
каже	Verb
шестаголни	Adjective
набројува	Verb
привлекле	Participle
недостасувала	Participle
разгневела	Participle
пишуваме	Verb
кристалната	Adjective
описната	Adjective
најавен	Participle
падежот	Noun
презентација	Noun
пишав	Verb
месноста	Noun
планиравте	Verb
ладното	Adjective
семрежјето	Noun
несовршен	Adjective
замислување	Masdar
речната	Adjective
диктирал	Participle
хемиско	Adjective
очите	Noun
повторило	Participle
китите	Verb
гуска	Noun
освестувај	Verb
дизајнерката	Noun
умерениот	Adjective
орките	Noun
нормалните	Adjective
ќефовине	Noun
пакосното	Adjective
Данците	Noun
самовилската	Adjective
ковал	Participle
силната	Adjective
израснале	Participle
обработил	Participle
морало	Participle
панаѓур	Noun
неделниот	Adjective
квалитативно	Adjective
зрново	Noun
лижавчето	Noun
комбинацијата	Noun
кенгур	Noun
важни	Adjective
булевар	Noun
прикрие	Verb
поврземе	Verb
скок	Noun
говедска	Adjective
расното	Adjective
готова	Adjective
ровкава	Noun
исфалиш	Verb
предизвикуваа	Verb
зборувате	Verb
згрбавен	Participle
спроведувавте	Verb
олеснел	Participle
императорот	Noun
ненадејниот	Adjective
басов	Noun
вез	Noun
сатаната	Noun
можно	Adjective
расцепат	Verb
заминале	Participle
жалиме	Verb
слабината	Noun
збунувале	Participle
републиканците	Noun
јавно	Adjective
лондонските	Adjective
одведен	Participle
австралиско	Adjective
непознати	Adjective
градеа	Verb
понижуваат	Verb
шипкава	Noun
финалистот	Noun
ботаничарите	Noun
клиенткана	Noun
веловине	Noun
белина	Noun
стременот	Noun
соочувајќи	Converb
навратил	Participle
темелите	Noun
прифатил	Participle
задал	Participle
старогрчкана	Adjective
назначат	Verb
базените	Noun
заверка	Noun
малер	Noun
слушнал	Participle
советувале	Participle
француска	Adjective
бомбардер	Noun
гнева	Noun
запишувале	Participle
поедноставуваат	Verb
доминирање	Masdar
разбирливи	Adjective
топол	Adjective
работ	Noun
доменот	Noun
одвлечевме	Verb
поранешното	Adjective
зафркнел	Participle
најадеме	Verb
возможни	Adjective
раштимате	Verb
турија	Verb
делта	Noun
лушпата	Noun
прикажеме	Verb
пригоден	Adjective
фашисту	Noun
латвиските	Adjective
смешното	Adjective
педал	Noun
добитниците	Noun
чина	Noun
занаетчија	Noun
мопс	Noun
послугата	Noun
артилерија	Noun
розево	Adjective
поробен	Participle
бавен	Adjective
патекана	Noun
правопропорционална	Adjective
теснецот	Noun
зборувал	Participle
поход	Noun
размислуваш	Verb
девизите	Noun
патријархалново	Adjective
распоредите	Verb
обработам	Verb
претпочитаа	Verb
побива	Verb
пирустија	Noun
приведен	Participle
хуманитарка	Noun
претседателка	Noun
пијанството	Noun
истрпам	Verb
железен	Adjective
прегледате	Verb
сјајни	Adjective
преносниот	Adjective
северозападни	Adjective
минува	Verb
побегнаа	Verb
атомскион	Adjective
подучува	Verb
ублажуваат	Verb
предвидувајќи	Converb
нападнеш	Verb
стројно	Adjective
прашината	Noun
калливите	Adjective
електризиравте	Verb
прашална	Adjective
многуаголник	Noun
оригиналите	Noun
повлекувале	Participle
донело	Participle
продолжија	Verb
човечкиот	Adjective
идентична	Adjective
лапни	Verb
чудното	Adjective
варирале	Participle
присуствував	Verb
тажаленка	Noun
ѕвездени	Adjective
добродетелта	Noun
претерува	Verb
неограниченото	Adjective
чистат	Verb
вратник	Noun
темелни	Adjective
патриотско	Adjective
шарената	Adjective
вдахнаа	Verb
избувливиов	Adjective
паунине	Noun
поскапите	Verb
селидба	Noun
здробен	Participle
белетристика	Noun
пропуштање	Masdar
норвешкото	Adjective
укажувале	Participle
магични	Adjective
помине	Verb
покоривте	Verb
наредат	Verb
срушило	Participle
бакар	Noun
орбитата	Noun
издржам	Verb
истријат	Verb
бебињата	Noun
гушкаат	Verb
спрел	Participle
недостижно	Adjective
предложев	Verb
возрасната	Adjective
простевте	Verb
блескави	Adjective
тигрестата	Adjective
контролирале	Participle
искрвареле	Participle
внимава	Verb
вежбајте	Verb
безбедна	Adjective
соблекувалната	Noun
економскиот	Adjective
полнат	Verb
памучни	Adjective
закопаат	Verb
занимлива	Adjective
декларираат	Verb
максимални	Adjective
инспирирате	Verb
овците	Noun
жестоките	Adjective
идеалот	Noun
избрзајте	Verb
аџија	Noun
снабдуван	Participle
адаптиран	Participle
објаснам	Verb
педалин	Noun
кадрите	Adjective
демонстрирале	Participle
нагласила	Participle
плашливке	Noun
прекршил	Participle
стоел	Participle
опишуваа	Verb
присилат	Verb
престрелката	Noun
хоризонт	Noun
отпаѓа	Verb
училиштата	Noun
мускулатурата	Noun
живи	Adjective
разговорна	Adjective
сведокот	Noun
непогрешлив	Adjective
клоака	Noun
естетското	Adjective
долгорочни	Adjective
извршија	Verb
вишнине	Noun
бразилското	Adjective
купувачот	Noun
романтичарите	Noun
превртуваат	Verb
нетрпеливана	Adjective
ударон	Noun
избран	Participle
влашката	Adjective
киклопот	Noun
утврдите	Verb
комплицираниот	Adjective
банкротирал	Participle
долгнавеста	Adjective
зебра	Noun
натпеaвте	Verb
архивите	Noun
декларациите	Noun
слабее	Verb
создадов	Verb
испраќале	Participle
бас	Noun
безбожнициве	Noun
изрекоа	Verb
масираа	Verb
фален	Participle
тревко	Noun
неефикасността	Noun
носачот	Noun
уточнив	Verb
среќавал	Participle
влекачите	Noun
процент	Noun
смелоста	Noun
попримат	Verb
осетлива	Adjective
противпримерот	Noun
медар	Noun
содржат	Verb
прочистен	Participle
портир	Noun
изѕидан	Participle
припишува	Verb
слаткарката	Noun
хомофобични	Adjective
еднакво	Adjective
жабите	Noun
истиот	Adjective
рачна	Adjective
ноктите	Noun
означува	Verb
дремнеме	Verb
сфатиле	Participle
натрупува	Verb
благонаклонетово	Adjective
бунтовничките	Noun
југоисточните	Adjective
гласна	Adjective
кроток	Adjective
гледал	Participle
утврдат	Verb
ослепен	Participle
лицемеркине	Noun
овозможува	Verb
топело	Participle
телепатијата	Noun
детска	Adjective
аптека	Noun
смог	Noun
селово	Noun
множиме	Verb
сличностите	Noun
обезбедуван	Participle
менијата	Noun
фудбалскиот	Adjective
прашајте	Verb
неменлив	Adjective
корисен	Adjective
типичното	Adjective
менувачница	Noun
бактерија	Noun
џелатите	Noun
пружате	Verb
чекав	Verb
етикетираме	Verb
лупење	Masdar
стигнам	Verb
разумни	Adjective
еврејска	Adjective
овозможен	Participle
опседнала	Participle
потпиши	Verb
склучела	Participle
ќумур	Noun
преболивте	Verb
печка	Noun
мрачниот	Adjective
редактира	Verb
спроведувал	Participle
пристигнување	Masdar
зависеа	Verb
искорнаа	Verb
заклучување	Masdar
пиленцата	Noun
невидливана	Adjective
подготвувало	Participle
трет	Adjective
колеблив	Adjective
предвесниците	Noun
прилагоден	Participle
прифаќан	Participle
заработувачка	Noun
ерупцијата	Noun
талогот	Noun
постојаните	Adjective
гласот	Noun
Гркот	Noun
приклучат	Verb
крутите	Adjective
приспособил	Participle
монархиите	Noun
внимаваме	Verb
растеретев	Verb
ампера	Noun
подметнала	Participle
блокирање	Masdar
продолжила	Participle
самоконтролата	Noun
сметаш	Verb
целокупнине	Adjective
индиректно	Adjective
разбираме	Verb
земјоделска	Adjective
испокинав	Verb
продолжението	Noun
десни	Adjective
запознавал	Participle
механика	Noun
аматер	Noun
жалосно	Adjective
водено	Adjective
олеснувала	Participle
делотворно	Adjective
оствариле	Participle
чешкото	Adjective
достигнале	Participle
крунисува	Verb
убивање	Masdar
жилав	Adjective
повикаат	Verb
маршираат	Verb
преведува	Verb
влегуваа	Verb
тврдам	Verb
зборовите	Noun
мирислива	Adjective
менливи	Adjective
обновил	Participle
кобила	Noun
безалкохолен	Adjective
припишување	Masdar
еврејската	Adjective
смер	Noun
Унгарецот	Noun
земала	Participle
причинител	Noun
негувателка	Noun
воспоставен	Participle
натприродната	Adjective
економичен	Adjective
губиме	Verb
комплицираш	Verb
значајно	Adjective
железара	Noun
насочил	Participle
јана	Noun
мајка	Noun
невозможна	Adjective
разложам	Verb
вродениот	Adjective
свинската	Adjective
вратовите	Noun
покренал	Participle
легенда	Noun
обезбедете	Verb
олеснување	Masdar
тесниот	Adjective
молитвава	Noun
водостојов	Noun
учествувало	Participle
наследството	Noun
антагонистот	Noun
печатач	Noun
финалето	Noun
рибарот	Noun
опколував	Verb
прогласел	Participle
наследниот	Adjective
потфат	Noun
раѓаат	Verb
расипе	Verb
квалитетите	Noun
длабоката	Adjective
кажав	Verb
доверен	Participle
упорна	Adjective
финион	Adjective
контролорите	Noun
чапјата	Noun
владеење	Masdar
надмоќното	Adjective
разгледувајќи	Converb
останавме	Verb
забележуваат	Verb
бездушни	Adjective
предлогот	Noun
затвораме	Verb
иделе	Participle
создадете	Verb
бесмислен	Adjective
љубовницата	Noun
храбра	Adjective
сатирата	Noun
подучеле	Participle
исфрла	Verb
пренесувал	Participle
задават	Verb
вродената	Adjective
радосна	Adjective
плетен	Participle
копнеел	Participle
тамошното	Adjective
гравитацијата	Noun
киднапирале	Participle
мешавина	Noun
покажаа	Verb
притворот	Noun
јагнето	Noun
живеев	Verb
составило	Participle
турнеа	Verb
дедовските	Adjective
чајџилниците	Noun
непоколебливиот	Adjective
обвиен	Participle
обесправуваат	Verb
лаеж	Noun
преносните	Adjective
припитомување	Masdar
значајноста	Noun
фантастичен	Adjective
спуштила	Participle
жичката	Noun
потврден	Participle
убиствен	Adjective
роденденска	Adjective
гадливата	Adjective
дотерувам	Verb
цврстина	Noun
отплаќал	Participle
тесна	Adjective
космосиве	Noun
ниска	Adjective
сожител	Noun
негувајќи	Converb
обединат	Verb
подготвувал	Participle
обвинуваат	Verb
комичниот	Adjective
квалитетна	Adjective
ослабнала	Participle
ублажен	Participle
масерот	Noun
опушта	Verb
мистериозните	Adjective
неупотреблив	Adjective
стомна	Noun
тркалезниот	Adjective
ветувам	Verb
љубопитните	Adjective
поразуваат	Verb
камшикување	Masdar
тресела	Participle
рецепционерите	Noun
подберевте	Verb
конструкцијата	Noun
дрољо	Noun
мечкиното	Adjective
завршела	Participle
беседата	Noun
сфатив	Verb
безобразнициве	Noun
соблекува	Verb
фиоката	Noun
прескокнал	Participle
пица	Noun
барокни	Adjective
мртви	Adjective
соцветието	Noun
продолжувала	Participle
компилациите	Noun
големото	Adjective
басот	Noun
едноставен	Adjective
измочате	Verb
содржел	Participle
дарувал	Participle
патријархален	Adjective
дораскажавме	Verb
неизвесни	Adjective
морфемата	Noun
открија	Verb
дроздовите	Noun
веселба	Noun
преубедевме	Verb
злите	Adjective
свирол	Noun
смртниот	Adjective
заверкиве	Noun
погачо	Noun
извајан	Participle
несреќно	Adjective
крилестиот	Adjective
савана	Noun
праќај	Verb
втиснуваат	Verb
скројте	Verb
сопственото	Adjective
отстранил	Participle
заклучија	Verb
разубавувало	Participle
попречиле	Participle
матни	Adjective
куќниов	Adjective
населил	Participle
четвртата	Adjective
убрзаш	Verb
разубедува	Verb
истрелот	Noun
подот	Noun
приближната	Adjective
расите	Noun
обновуваат	Verb
деценијата	Noun
описменување	Masdar
обновила	Participle
куфер	Noun
занемаруваат	Verb
подлогата	Noun
плав	Adjective
комплицирано	Adjective
почувствувам	Verb
радиус	Noun
интернетскион	Adjective
збунило	Participle
максимално	Adjective
парохијата	Noun
циркулирање	Masdar
непожелноно	Adjective
поттикнал	Participle
освестуваме	Verb
отшрафам	Verb
јазичното	Adjective
легнуваш	Verb
печатарот	Noun
востанието	Noun
книгава	Noun
костенливо	Adjective
кучево	Noun
Британец	Noun
прекорувавте	Verb
јавето	Noun
темелот	Noun
црвениот	Adjective
работливи	Adjective
испраќање	Masdar
темни	Adjective
кривичната	Adjective
преправање	Masdar
поттикнаа	Verb
задоволството	Noun
некропола	Noun
категорија	Noun
паметноно	Adjective
билка	Noun
пател	Participle
прелудиум	Noun
разврзавме	Verb
блескавата	Adjective
опколила	Participle
изјавила	Participle
запоставил	Participle
плашите	Verb
питомата	Adjective
своевиден	Adjective
погодоците	Noun
кундак	Noun
пченичен	Adjective
трае	Verb
споредбено	Adjective
одбило	Participle
прашуваме	Verb
прикачен	Participle
поврзало	Participle
канцелариско	Adjective
хемичар	Noun
незадоволниот	Adjective
згрозен	Participle
објаснил	Participle
заиграме	Verb
откривам	Verb
дивеч	Noun
труба	Noun
Украинецот	Noun
глупавите	Adjective
бившото	Adjective
нихилистичка	Adjective
разговаравме	Verb
поддржувајќи	Converb
пристигнале	Participle
кубе	Verb
камчето	Noun
раштркуваме	Verb
студено	Adjective
крекавме	Verb
преведуваат	Verb
шимпанзава	Noun
сочинувале	Participle
плима	Noun
расеаниот	Adjective
директорот	Noun
увото	Noun
неразумниов	Adjective
мрдање	Masdar
непроменливи	Adjective
поевтиниме	Verb
расонето	Adjective
порекнувала	Participle
бивша	Adjective
тркалезен	Adjective
подготвам	Verb
строгоста	Noun
јазиците	Noun
слаба	Adjective
безвредново	Adjective
зглобило	Participle
економист	Noun
заработија	Verb
извозник	Noun
скелет	Noun
статутите	Noun
другарскине	Adjective
важење	Masdar
утрината	Noun
десетто	Adjective
отстранила	Participle
неприспособлив	Adjective
закона	Noun
салонот	Noun
надгледувај	Verb
освоевме	Verb
безобразието	Noun
едноклеточнине	Adjective
сечилата	Noun
особена	Adjective
потклекнал	Participle
вратиштено	Noun
безвредна	Adjective
бркал	Participle
правни	Adjective
островските	Adjective
ужасното	Adjective
готови	Adjective
плика	Noun
победничка	Noun
трговскана	Adjective
рангира	Verb
булеварите	Noun
дрзок	Adjective
покровителството	Noun
свршуваат	Verb
назначете	Verb
затворал	Participle
орел	Noun
памучна	Adjective
ротацијата	Noun
повторила	Participle
осудениците	Noun
фашистичкото	Adjective
паѓала	Participle
земало	Participle
посветев	Verb
мегдан	Noun
мртва	Adjective
спектрите	Noun
докосиме	Verb
паниката	Noun
волкот	Noun
донесела	Participle
вкупна	Adjective
избришаа	Verb
минливите	Adjective
таблицата	Noun
безбројно	Adjective
копитата	Noun
романско	Adjective
докажеме	Verb
населбана	Noun
убод	Noun
надворешно	Adjective
брчко	Noun
подозрививе	Adjective
географските	Adjective
привремениот	Adjective
утрава	Noun
смртноста	Noun
човечката	Adjective
менувачот	Noun
донацијава	Noun
законодавството	Noun
милиција	Noun
полјаните	Noun
пристигневме	Verb
учителскиот	Adjective
достапниот	Adjective
флота	Noun
порачува	Verb
аргументирање	Masdar
пеху	Noun
вировите	Noun
извичник	Noun
предвесник	Noun
ниско	Adjective
траела	Participle
пролетен	Adjective
валута	Noun
чадат	Verb
ножнава	Adjective
иронична	Adjective
мистериозно	Adjective
предвременана	Adjective
печатницата	Noun
ткивото	Noun
дијалог	Noun
официјални	Adjective
гласни	Adjective
покорив	Verb
бреза	Noun
дрско	Adjective
нозете	Noun
избушевме	Verb
сакаш	Verb
неупотреблива	Adjective
дипломатска	Adjective
мускулните	Adjective
едноока	Adjective
хермафродит	Noun
припаѓал	Participle
незабележително	Adjective
војуваме	Verb
термометар	Noun
светат	Verb
математичкото	Adjective
влечеа	Verb
главо	Noun
трапезот	Noun
петиција	Noun
тетовска	Adjective
паѓаа	Verb
фустаните	Noun
параброда	Noun
вложен	Participle
пребришам	Verb
универзумот	Noun
различниот	Adjective
незначајни	Adjective
димензиите	Noun
клукајдрвецот	Noun
завидлививе	Adjective
вирусен	Adjective
преминувала	Participle
паѓал	Participle
австралискиот	Adjective
самовилскиов	Adjective
раководела	Participle
надробевте	Verb
разгален	Participle
автопатот	Noun
нечистите	Adjective
наоѓа	Verb
враќајќи	Converb
жалела	Participle
жената	Noun
прикладни	Adjective
депресивен	Adjective
партииве	Noun
граматичарот	Noun
одредуваат	Verb
препознавајќи	Converb
оптичаркине	Noun
делумен	Adjective
принципа	Noun
покрила	Participle
немале	Participle
кањиве	Noun
глеѓта	Noun
воинот	Noun
британска	Adjective
општествен	Adjective
треси	Verb
ресурс	Noun
преуредувале	Participle
блуза	Noun
мрежава	Noun
поправавте	Verb
огладнувајќи	Converb
кошаркаркава	Noun
потпишаа	Verb
известуваат	Verb
позајмила	Participle
стоиш	Verb
урбаните	Adjective
дискретно	Adjective
поткупуваш	Verb
игово	Noun
леду	Noun
состојката	Noun
мршав	Adjective
кралевите	Noun
шоферот	Noun
добитничкана	Noun
коритава	Noun
полковите	Noun
сенка	Noun
посвоила	Participle
запленивте	Verb
смел	Adjective
аморфните	Adjective
врбите	Noun
движиш	Verb
јачмен	Noun
мило	Adjective
посветеа	Verb
мистериозниот	Adjective
отпуштал	Participle
кисел	Adjective
самоизмачувањето	Noun
недостојни	Adjective
џемпер	Noun
полнолетството	Noun
Грузиецот	Noun
здив	Noun
пропуштеа	Verb
зачинете	Verb
препоните	Noun
песните	Noun
жетвата	Noun
лековите	Noun
модерниот	Adjective
наведеме	Verb
тргнал	Participle
хранливиот	Adjective
коктеливе	Noun
владееја	Verb
голтаат	Verb
пофалат	Verb
поседувате	Verb
издај	Verb
земјиниот	Adjective
простиот	Adjective
судирање	Masdar
присилило	Participle
гитарист	Noun
побудела	Participle
ќошевите	Noun
отпуштајте	Verb
превртување	Masdar
атласот	Noun
тежнеел	Participle
железното	Adjective
културна	Adjective
нормативната	Adjective
заробуваш	Verb
преземаа	Verb
отежнување	Masdar
чајџилницата	Noun
потпаднале	Participle
збрлавен	Participle
одереа	Verb
душевна	Adjective
комора	Noun
малуброен	Adjective
помисливме	Verb
руското	Adjective
брава	Noun
зело	Participle
врвца	Noun
марамата	Noun
еуфорија	Noun
замениците	Noun
парков	Noun
рангирала	Participle
планско	Adjective
правниот	Adjective
осо	Noun
учителските	Adjective
филозофот	Noun
забележавме	Verb
ампутирал	Participle
монетите	Noun
кардиолог	Noun
усложнува	Verb
бомбардерите	Noun
најават	Verb
победник	Noun
чинчилава	Noun
запишува	Verb
единица	Noun
суштествоно	Noun
дочекаат	Verb
засегала	Participle
пливач	Noun
прабабана	Noun
лековити	Adjective
забрзуваат	Verb
ограничело	Participle
топчено	Noun
смислував	Verb
италијанските	Adjective
тепан	Participle
телесните	Adjective
симболичен	Adjective
дводелни	Adjective
млечниот	Adjective
ниски	Adjective
портокаловата	Adjective
царе	Noun
пуловерот	Noun
зачетока	Noun
отворениот	Adjective
безначаен	Adjective
багремот	Noun
настапела	Participle
едноклеточните	Adjective
растовине	Noun
четврто	Adjective
надмоќен	Adjective
кало	Noun
претрпиле	Participle
медала	Noun
романтичар	Noun
превод	Noun
разложување	Masdar
преодна	Adjective
самоубиец	Noun
триен	Participle
акроним	Noun
мисла	Noun
каца	Noun
собрале	Participle
изневерувавте	Verb
повремено	Adjective
закуска	Noun
целосно	Adjective
угњавел	Participle
калето	Noun
положиле	Participle
поддржуван	Participle
достигнал	Participle
имате	Verb
улиштево	Noun
фруктоза	Noun
обилен	Adjective
манипулирале	Participle
зеленикаво	Adjective
тажно	Adjective
средуваме	Verb
англискиот	Adjective
кризата	Noun
толерираат	Verb
преобратите	Verb
дроздот	Noun
ампутираме	Verb
безбедната	Adjective
габана	Noun
темпераментноно	Adjective
додавале	Participle
интересирал	Participle
освоил	Participle
јасноста	Noun
средната	Adjective
јажето	Noun
раното	Adjective
бркање	Masdar
зашилите	Verb
потребо	Noun
коли	Verb
шлагот	Noun
мирните	Adjective
индивидуализмот	Noun
носиштана	Noun
кусиот	Adjective
куклите	Noun
ветровита	Adjective
астролошково	Adjective
волшебникот	Noun
тромбоцитите	Noun
прашник	Noun
врачување	Masdar
противпредлог	Noun
мостов	Noun
трошат	Verb
манијак	Noun
донаторе	Noun
нимфоманкава	Noun
изненадила	Participle
топот	Noun
задолжителното	Adjective
циклус	Noun
неприроднана	Adjective
факултетско	Adjective
влегла	Participle
информација	Noun
покрстил	Participle
момата	Noun
кобилите	Noun
слушнаа	Verb
слушало	Participle
послужиле	Participle
бегството	Noun
безличен	Adjective
бисексуалците	Noun
кромидот	Noun
единствени	Adjective
скратеница	Noun
имотните	Adjective
твореа	Verb
гламната	Noun
волк	Noun
поканила	Participle
личеа	Verb
истовареа	Verb
паралелното	Adjective
придонеси	Verb
волчото	Adjective
смртната	Adjective
вресневте	Verb
изложба	Noun
смислат	Verb
целината	Noun
исчезнувала	Participle
блазонот	Noun
неразумен	Adjective
парадира	Verb
разбрало	Participle
обезбедуваат	Verb
гарантиран	Participle
покровителите	Noun
молива	Noun
спаѓал	Participle
помислиле	Participle
траума	Noun
пријателу	Noun
осетил	Participle
врачен	Participle
декларација	Noun
чистилиштето	Noun
древни	Adjective
срамниот	Adjective
француското	Adjective
разбуткај	Verb
виновник	Noun
доволен	Adjective
напреднеме	Verb
баскискава	Adjective
џеб	Noun
наредило	Participle
бегајте	Verb
мозочен	Adjective
мантилот	Noun
учтив	Adjective
кастриран	Participle
ушното	Adjective
либерално	Adjective
град	Noun
сплотите	Verb
безвучна	Adjective
воспоставува	Verb
архаичната	Adjective
крадецот	Noun
вниманиево	Noun
пазувата	Noun
заградува	Verb
гасовитата	Adjective
студентиве	Noun
опфатил	Participle
формална	Adjective
независно	Adjective
задоволувајќи	Converb
влезат	Verb
месојадите	Noun
завршиле	Participle
коњ	Noun
скромниот	Adjective
добротвор	Noun
безусловна	Adjective
доживувајќи	Converb
банкарине	Noun
долната	Adjective
опишуваат	Verb
босилоков	Noun
умрат	Verb
наречат	Verb
прелистаат	Verb
гасовит	Adjective
селанката	Noun
кафеаво	Adjective
репутацијата	Noun
притиснав	Verb
златар	Noun
проекта	Noun
горат	Verb
документот	Noun
киклопите	Noun
опивала	Participle
неизвесните	Adjective
оправдувала	Participle
триаголниот	Adjective
одредуваме	Verb
кревал	Participle
трговските	Adjective
автоматскава	Adjective
спротивното	Adjective
патријархалната	Adjective
изнела	Participle
малечките	Adjective
славела	Participle
раскитат	Verb
приклучија	Verb
граѓаните	Noun
мажественоста	Noun
светиците	Noun
деминутив	Noun
македонска	Adjective
овековечат	Verb
независните	Adjective
екскреторна	Adjective
читлив	Adjective
избегнаа	Verb
велигденско	Adjective
фонетските	Adjective
одбија	Verb
традиција	Noun
шмукаат	Verb
преоѓајќи	Converb
везовите	Noun
испеала	Participle
дупнала	Participle
озборувачка	Noun
бариерата	Noun
сметан	Participle
деловната	Adjective
атомско	Adjective
требаа	Verb
водев	Verb
газење	Masdar
распарчуваш	Verb
дождомер	Noun
ботаничар	Noun
печалине	Noun
проституцијата	Noun
пристапила	Participle
делела	Participle
утврден	Participle
вошките	Noun
бучно	Adjective
ранела	Participle
употребија	Verb
исклучителен	Adjective
залогот	Noun
арома	Noun
шпекулациите	Noun
одморил	Participle
