Binde	None
Extranet	None
wuschle	Present
wiederholend	Present
verzierend	Present
bevorzugst	Present
aufgeregt	Past
gekümmert	Past
Bodybuilding	None
sterilisieret	Present
übergebt	Present
Schnute	None
Vierzylinder	None
Kuppen	None
gackernd	Present
stigmatisieret	Present
brösle	Present
ermittle	Present
Eisbahn	None
rekrutierend	Present
verbrächet	Past
kugle	Present
Pharisäers	None
Rabbiners	None
Medizin	None
planschet	Present
zerleset	Present
Schwebfliegen	None
prügelnd	Present
Nebensatzkonjugation	None
covre	Present
suspendienierest	Present
unterschätzest	Present
streuest	Present
anbindend	Present
rezitierest	Present
Wellensittichen	None
übergabt	Past
Benutzer	None
mündend	Present
kaust	Present
marteret	Present
Begräbnisse	None
wirkst	Present
Schneidbrett	None
belogst	Past
meßend	Present
erwideret	Present
Stör	None
befördre	Present
schulet	Present
verbittre	Present
feilest	Present
Brombeere	None
Poller	None
vernickelst	Present
salutierest	Present
gefickt	Past
belächelst	Present
Skriptoriums	None
erdrückend	Present
Scharmützel	None
musicieret	Present
Kleiderschrank	None
schilderst	Present
überteuerest	Present
Ouvertüren	None
verkackest	Present
einweisend	Present
steigst	Present
entwickelest	Present
gelauscht	Past
gehetzt	Past
observieret	Present
verjüngst	Present
Sportwettkämpfen	None
Fußmatte	None
Aufweichung	None
umgesetzt	Past
Hufen	None
ficht	Present
behelfest	Present
Luster	None
Wirkungsgrade	None
verbieget	Present
Gaffers	None
dementierend	Present
Flamingo	None
Chelatbildner	None
erfraget	Present
enthärtend	Present
föhnend	Present
benötigend	Present
Elfenbeintürmen	None
kompilierest	Present
harmonisierest	Present
Gettern	None
dümple	Present
Warte	None
Messbarkeit	None
mal	None
personifizieret	Present
schützend	Present
minderst	Present
Lipid	None
widersprächet	Past
reckst	Present
Zweigen	None
heulend	Present
Großoffensive	None
Downers	None
Schmirgelpapier	None
krakelend	Present
Espresso	None
bellst	Present
vibrierend	Present
darstellend	Present
jammernd	Present
sträubend	Present
Eisenpräparat	None
melieret	Present
Bleistiften	None
ruinierend	Present
ernüchterst	Present
diskutier	None
getüftelt	Past
stolpernd	Present
Chlorung	None
prügelest	Present
Borazin	None
homogenisieret	Present
Opalen	None
wichsest	Present
Anglikaner	None
wälzest	Present
lockerest	Present
mümmelnd	Present
verneinend	Present
tendierend	Present
Abenddämmerung	None
Rhodonits	None
bröckelest	Present
hopset	Present
Trotzkist	None
umgeschmolzen	Past
sächselst	Present
zurückkehrend	Present
Buchenholz	None
verbrichst	Present
dunkelst	Present
Landgericht	None
besitz	None
Berichterstatter	None
qualmst	Present
Leitungswegen	None
Rennpferde	None
widerstehst	Present
beinhaltend	Present
riskierst	Present
besteigest	Present
Oberlandesgerichten	None
Verrätern	None
faset	Present
korrodierst	Present
Arsentribromide	None
verflöget	Past
Schließfach	None
kritisierend	Present
meditierst	Present
ehret	Present
Kameles	None
stibitzend	Present
begibst	Present
geschminkt	Past
Pflaster	None
erscheinend	Present
verkennend	Present
liebend	Present
gewichst	Past
Überheblichkeit	None
optimieret	Present
bugsierest	Present
getaggt	Past
versemmelst	Present
thätet	Past
Werder	None
entgehend	Present
Grotten	None
biwakierend	Present
kupierend	Present
belasset	Present
bewerkstelligend	Present
gekapert	Past
scheueret	Present
isomerisierst	Present
versenket	Present
antizipierest	Present
chiffrierst	Present
Hexachloriden	None
rennst	Present
hinlegend	Present
versinkest	Present
kappend	Present
Fick	None
Finanziers	None
verweigre	Present
Polyamide	None
entfliehst	Present
schaukle	Present
kolorierend	Present
genebelt	Past
frittierend	Present
gefalzt	Past
Walzen	None
berechnend	Present
übermittelet	Present
multiplizierst	Present
Patronits	None
charakterisierst	Present
abgeändert	Past
Lette	None
instrumentalisierst	Present
falzet	Present
Gefolgschaften	None
verschmähend	Present
gesponsert	Past
geschimmert	Past
untergegangen	Past
überfällst	Present
verabschiedend	Present
humpelst	Present
verseuchet	Present
Einfuhr	None
spreizend	Present
Substrat	None
getadelt	Past
gelangst	Past
Bienenhäusern	None
übersiehst	Present
besicheret	Present
beflügelest	Present
überwändet	Past
erholest	Present
gepachtet	Past
losend	Present
gesäumt	Past
beglichet	Past
Inversionen	None
schasset	Present
änderst	Present
observierend	Present
gesunken	Past
verhülfet	Past
Werfalles	None
befürwortend	Present
gesprengt	Past
Föhnen	None
strickst	Present
duellier	None
gedroschen	Past
musizierest	Present
gelungen	Past
radierest	Present
verteilend	Present
bellet	Present
vertippest	Present
Vesten	None
desensibilisieret	Present
getrödelt	Past
stamm	None
überwältigst	Present
beschirmet	Present
ermutiget	Present
verschreibst	Present
Arsenolipiden	None
zugegeben	Past
während	Present
Tonnengewölbe	None
konzipierend	Present
enttarnend	Present
verwickle	Present
Wertpapier	None
ordnend	Present
schießet	Present
verschaffst	Present
versenkend	Present
Ägypters	None
teilend	Present
Abscheulichkeit	None
Ausschlusses	None
empfändet	Past
Eroberungszug	None
Acetylrestes	None
befolget	Present
verprügelnd	Present
Braunstein	None
Sprühdosen	None
Feuerwehren	None
begibt	Present
geschildert	Past
Verfluchung	None
abstrahierend	Present
harnest	Present
betriebest	Past
Chlorungen	None
verzierest	Present
deregulierst	Present
mikturierend	Present
grüßend	Present
Coup	None
verkörperst	Present
Grenzländern	None
Schweinehunden	None
lähmend	Present
Eigentümers	None
überraschet	Present
behinderest	Present
scheiteret	Present
vergreisest	Present
Zusätze	None
Apothekern	None
schlucket	Present
vorbereitend	Present
kontrahieret	Present
assistierest	Present
süßend	Present
Firmament	None
entständet	Past
abwiegend	Present
ahnest	Present
Eschatologie	None
geweckt	Past
Geysire	None
reservierest	Present
gestrickt	Past
schälst	Present
übersieht	Present
Schattenmorellen	None
unterstrichst	Past
weihend	Present
Alkalihydroxids	None
verkürzend	Present
knusperst	Present
kompensierend	Present
Kochtöpfen	None
Mediengeschichte	None
Sprengstoffes	None
Spanes	None
Bandwürmern	None
Sulfoxid	None
aufbauschend	Present
getürmt	Past
Auszählung	None
verdammst	Present
alimentier	None
gekrächzt	Past
überholet	Present
lehnst	Present
eingeschlossen	Past
Stativ	None
Affixe	None
wurstelst	Present
rülpsend	Present
colorierst	Present
unterlasst	Present
Herstellungsverfahren	None
verzehret	Present
strukturieret	Present
ernährest	Present
notlandend	Present
besteure	Present
vorbeugend	Present
inhalierend	Present
Screencasts	None
vergreiset	Present
knisterest	Present
quarzend	Present
Schadstoffe	None
erschlagend	Present
entsinnend	Present
sautierend	Present
triumphierest	Present
Fächer	None
schmückend	Present
gekleidet	Past
radierend	Present
geschieht	Present
Lorbeeren	None
unterwirft	Present
exet	Present
verstrahlet	Present
widersprächest	Past
ekelet	Present
ermutigest	Present
vermenschlichst	Present
rennend	Present
staunet	Present
verhandelnd	Present
geflohen	Past
gescheffelt	Past
lavieret	Present
reißest	Present
stigmatisierend	Present
verstießest	Past
Beiräten	None
entionisierest	Present
Klöße	None
Ausmaße	None
bierst	Present
nervst	Present
betraget	Present
boßend	Present
gefegt	Past
beantragst	Present
linderet	Present
geblättert	Past
Druckfehlern	None
Resonators	None
getoppt	Past
harmonieret	Present
rüffle	Present
koproduzierend	Present
schirm	None
Paranüssen	None
bettelnd	Present
verfangend	Present
gezielt	Past
adsorbierest	Present
erschiesset	Present
pellet	Present
rivalisierst	Present
schaukelet	Present
glasierend	Present
gerüstet	Past
titrieret	Present
Zapfhahnes	None
geglückt	Past
Phänomens	None
rumalbererest	Present
stürmest	Present
Hochrechnungen	None
bollernd	Present
destabilisierend	Present
pfeifend	Present
Mathematikerin	None
Flugstaubes	None
besannst	Past
entreißest	Present
substituierest	Present
interpretierend	Present
Schöpfers	None
Falltürme	None
moderierst	Present
gezeichnet	Past
verhelfest	Present
Verdecke	None
komplexierest	Present
reanimierend	Present
Gipfeltreffens	None
angeschaut	Past
bejahest	Present
placierend	Present
erzeugest	Present
Austauschen	None
empfindend	Present
abgebremst	Past
eieret	Present
überreagierst	Present
kamst	Past
Engagements	None
popelst	Present
bestrafest	Present
geblufft	Past
Zusammenbrüche	None
schweigend	Present
applicierend	Present
verbargst	Past
Glockengießern	None
verscheißre	Present
berührend	Present
beschwindle	Present
Gegenstandswörter	None
entblößest	Present
Gestades	None
liebäugelnd	Present
Flagge	None
horchend	Present
assistierend	Present
übermittle	Present
gemeßen	Past
tätowierend	Present
stolpre	Present
kneifst	Present
walzet	Present
Kaffeetassen	None
Winkeladvokat	None
nörgle	Present
belohnet	Present
nickend	Present
befällt	Present
geltend	Present
Sparschwein	None
veranlasset	Present
Außenwand	None
schichtend	Present
dämonisierst	Present
entlassest	Present
Alkoholat	None
kicherest	Present
geklappert	Past
Drehbücher	None
Seil	None
Anstecker	None
labialisierst	Present
Edelweiße	None
sprengest	Present
sautierst	Present
gelandet	Past
legst	Present
eingestehen	None
Emire	None
Comics	None
Neutronenbombe	None
Fähren	None
Napf	None
kickst	Present
Seleniten	None
gejault	Past
Überbleibseln	None
Marjellchens	None
Diffusionsvermögens	None
durchschreitend	Present
Endspiele	None
konzipieret	Present
vergingt	Past
kapitalisierest	Present
Hellsehers	None
Nichtmetalle	None
anzeigend	Present
Sandstein	None
abgehalten	Past
Unkrautes	None
kommentieret	Present
Kultes	None
verjähret	Present
rutschst	Present
Teilzeiten	None
würdigest	Present
revolutionierst	Present
beigetreten	Past
negierst	Present
keifet	Present
vandalierst	Present
flambierend	Present
lauernd	Present
vorgebeugt	Past
Hack	None
Sichtgeräts	None
ratifizierst	Present
Strichjungen	None
arrivierst	Present
äußre	Present
missverstandet	Past
popelnd	Present
scannet	Present
gewischt	Past
Rückganges	None
ergießest	Present
schaudre	Present
Bündnisse	None
Pobacken	None
staunend	Present
gedroht	Past
Geisterstädte	None
Flugbenzinen	None
getippt	Past
geglitten	Past
rotierst	Present
entsprichst	Present
veröffentlichest	Present
gerbst	Present
fangest	Present
verführest	Present
Aufsteigers	None
fühlend	Present
gebräunt	Past
simulierend	Present
gegenbeschuldigest	Present
Buße	None
grünst	Present
Gewürznelken	None
Postillons	None
verbitteret	Present
kontrollierst	Present
Rundgotisch	None
Glühfaden	None
begnadigest	Present
grapschet	Present
erregest	Present
geschissen	Past
Arzneimittels	None
transferierst	Present
Skarn	None
stechend	Present
Interhalogenen	None
geklappt	Past
Sozialarbeiterinnen	None
zirpst	Present
fraternisierest	Present
schmuggelnd	Present
Bezugspunkten	None
Bottichs	None
etiolierend	Present
perforierend	Present
vertiefst	Present
entschließend	Present
Fluorsalze	None
Xylem	None
gurgelst	Present
hopsst	Present
beunruhigest	Present
Albanern	None
knurrst	Present
überwältigend	Present
geteert	Past
Schlauchboote	None
entgleiset	Present
Fladenbrote	None
wurschtelst	Present
disziplinieret	Present
reflektierend	Present
dürftest	Past
gefleucht	Past
gefolgert	Past
Neutroneneinfangquerschnitte	None
verlangest	Present
entkriminalisieret	Present
kotend	Present
erschaffet	Present
übernähmet	Past
verallgemeinerest	Present
entlehnet	Present
Ämtern	None
entstehest	Present
greifst	Present
Selbstmorden	None
verschleppet	Present
zurückgekommen	Past
Spielerin	None
quadrieret	Present
pikierest	Present
beträgt	Present
erweckst	Present
Chrom	None
geaast	Past
spottend	Present
Melker	None
geritzt	Past
verstirbt	Present
scheuchest	Present
gescheitert	Past
knüpf	None
Puderzuckers	None
Polystickstoffen	None
Afterlehens	None
geschwänzt	Past
arrivierend	Present
gequarzt	Past
handelst	Present
surrst	Present
vergrübest	Past
kapitulierend	Present
sponserst	Present
quetschet	Present
zechend	Present
überreagierest	Present
vereiset	Present
segmentierst	Present
Austragungsorten	None
juckst	Present
getaut	Past
stimmst	Present
mißbrauchet	Present
aufgebauscht	Past
sinket	Present
erschiessend	Present
ausbauend	Present
Nachtfalter	None
trotzest	Present
getunt	Past
angetreten	Past
verkennst	Present
geschwiegen	Past
Kleberandes	None
pudernd	Present
klickest	Present
entsprechest	Present
geduftet	Past
Krapfen	None
umgebend	Present
blitzest	Present
verstrahlend	Present
gebrütet	Past
wühlet	Present
vermindernd	Present
veranschlagest	Present
kassieret	Present
parkest	Present
Lesens	None
versprecht	Present
schummelest	Present
Erhalt	None
gerächt	Past
Zirrhose	None
montierend	Present
Außenministerien	None
gelüftet	Past
Bestandteile	None
abgedeckt	Past
kugelest	Present
eingebrochen	Past
beschimpfest	Present
Gasthof	None
Barbar	None
akzeptierend	Present
stemmst	Present
ausgemerzt	Past
geprobt	Past
radikalisieret	Present
brennst	Present
mokierend	Present
expandierend	Present
zuckeret	Present
beleuchtend	Present
gefiebert	Past
panaschierend	Present
Blutspender	None
nähret	Present
kastrierend	Present
Jahresüberschuss	None
Thioether	None
geäussert	Past
vorgestellt	Past
Großzügigkeit	None
verschmelzest	Present
erhobst	Past
mikrominiaturisierend	Present
Hungersnöten	None
bedinget	Present
parametrisieret	Present
stürzend	Present
Frontallappens	None
Erbfolgen	None
lutschet	Present
wickelet	Present
belauernd	Present
wellet	Present
Probanden	None
überbewertend	Present
dementierest	Present
heuchelnd	Present
frierend	Present
hellet	Present
verwerft	Present
vermischst	Present
Extrems	None
arretierend	Present
gesiezt	Past
Eckzahn	None
Beifanges	None
geschlängelt	Past
zurückgehalten	Past
Brauerei	None
kuckest	Present
hastend	Present
hüllet	Present
porträtierest	Present
vorausgesetzt	Past
häufend	Present
schottre	Present
bemutteret	Present
Hektare	None
ertrinkest	Present
Gegengifte	None
rügend	Present
Geburtsnamen	None
Bleiglanz	None
Dekore	None
benehmet	Present
schlosseret	Present
genäht	Past
stützst	Present
Einbahnstraßen	None
Apportierhunde	None
beeindrucket	Present
geordert	Past
rebellier	None
geköpft	Past
fügst	Present
filzst	Present
verrechnend	Present
hinterlasset	Present
grüble	Present
schauend	Present
Feigenbäumen	None
imitierest	Present
drohet	Present
gestimmt	Past
Kondensatorbelags	None
glichst	Past
Ferrit	None
wehret	Present
gedenkst	Present
Freitodes	None
bewahrend	Present
gestiegen	Past
begrabt	Present
blinzelet	Present
überfällt	Present
gegriffen	Past
Nigger	None
Übergriff	None
Rotfuchses	None
ergebest	Present
Fluorite	None
eroberet	Present
ausgelöst	Past
ausgewichen	Past
verbitterst	Present
entsorgest	Present
erfändest	Past
ersticht	Present
Großdemonstration	None
flickend	Present
schwäret	Present
desinfizierest	Present
besudelest	Present
XOR-Gatter	None
schöpfet	Present
beeinträchtiget	Present
Kralle	None
Äste	None
konterkarierend	Present
warnest	Present
Industriezweige	None
Fondue	None
krosst	Present
Kämmen	None
belastend	Present
frühstücket	Present
klirret	Present
aufgewacht	Past
gehinkt	Past
möblierest	Present
Fernsehapparaten	None
Dibenzodioxins	None
replicirst	Present
gewühlt	Past
schmälernd	Present
Wohnort	None
Eigentümer	None
missbrauchet	Present
geregt	Past
verdrießest	Present
Gegenleistungen	None
geträllert	Past
Kurator	None
gemampft	Past
Gesichtsverletzungen	None
schnitzest	Present
entfolget	Present
Sonnenhut	None
hebst	Present
attestierst	Present
verdrössest	Past
verhandelet	Present
Dezimeter	None
Einzug	None
geebbt	Past
abdeckend	Present
ändernd	Present
geschraubt	Past
belohnst	Present
Hochsprunges	None
Polizeisprechern	None
erlangest	Present
glupschst	Present
interkulturalisierest	Present
Neurotransmittern	None
beschulet	Present
kämmest	Present
Schrifften	None
sterilisierest	Present
einwickelnd	Present
quöllest	Past
bildend	Present
räuchre	Present
bezwingst	Present
verbüßet	Present
Alarms	None
posierend	Present
Superhelden	None
Stammbäumen	None
vermittelest	Present
überwachst	Present
polierst	Present
rekonstruierest	Present
erleichterst	Present
Heilmitteln	None
stutzest	Present
Wenfällen	None
Faden	None
hindernd	Present
gescherzt	Past
wringest	Present
Jasmins	None
Bonsais	None
schlummerest	Present
Flöße	None
gemauert	Past
erweiset	Present
bedürftet	Past
gestockt	Past
versilbre	Present
Graph	None
imitierst	Present
Thermitverfahren	None
Niederlassung	None
schieferet	Present
stopfet	Present
Abschiedsgeschenk	None
Schwachkopfes	None
kassierend	Present
gewünscht	Past
kiffet	Present
gewöhnet	Present
wetteiferst	Present
verlängerst	Present
zappet	Present
betonest	Present
Donnerstagabenden	None
Saxophonen	None
niesest	Present
garnierst	Present
illustrieret	Present
Natriumsalz	None
glücket	Present
verringeret	Present
klapperst	Present
verschärfest	Present
kooperieret	Present
Kastanie	None
Selenmangel	None
quarzet	Present
wähnest	Present
bequembst	Present
Schnäuzer	None
isolierend	Present
ausgefallen	Past
knabbernd	Present
Bonapartemöwe	None
verließest	Past
kümmerst	Present
Farbtones	None
Hufeisen	None
Bomberjacke	None
Aldehyde	None
wackelet	Present
dämpfend	Present
traumatisierst	Present
berücksichtigst	Present
zügelet	Present
sonnest	Present
Fluorkohlenwasserstoffe	None
Rubel	None
alterst	Present
gewirkt	Past
plantschst	Present
zerfaserest	Present
Fremdwährung	None
Wahlergebnisse	None
nahest	Present
Scherben	None
nervend	Present
versorgest	Present
behandle	Present
gezüchtet	Past
Detektiven	None
klickend	Present
gratulierst	Present
Prüfberichten	None
Lupine	None
Werkstück	None
überschätzend	Present
bröckelet	Present
jährest	Present
verurteilend	Present
stottre	Present
Weißpigmente	None
pollet	Present
gegengezeichnest	Present
röstend	Present
schmierend	Present
Kränzen	None
rüffelet	Present
Staunens	None
echauffierest	Present
entnimmst	Present
mißbrauchend	Present
anhängend	Present
unterbrächet	Past
gedröhnt	Past
dechiffrierest	Present
erliegest	Present
frikassierest	Present
gestiftet	Past
gebettet	Past
filterst	Present
bemerkst	Present
verdoppelst	Present
arretierst	Present
verschleiernd	Present
verzweifelet	Present
verstärkend	Present
verbaselst	Present
Einschreiben	None
gehäuft	Past
fangt	Present
Tabak	None
säßet	Past
Erdgeschoße	None
bezahlst	Present
verschleuderest	Present
freuest	Present
Muttersprachen	None
ruderst	Present
abgespielt	Past
fönet	Present
geplaudert	Past
verwehrest	Present
gedehnt	Past
schürfet	Present
benommen	Past
Zwirn	None
doublierest	Present
bezeugest	Present
Sträßchen	None
gegrast	Past
gurrend	Present
müffelst	Present
beäugst	Present
verschlüsselet	Present
stricht	Past
gräbst	Present
Hochsitzes	None
reitend	Present
Leguanen	None
komprimierend	Present
Neuling	None
reizest	Present
zumachend	Present
schröpfet	Present
chillend	Present
Aufgebotes	None
sinternd	Present
grillet	Present
aalst	Present
Platzhalter	None
räucheret	Present
zerstreuend	Present
Nitride	None
überlieferest	Present
ausgeschlossen	Past
Schütz	None
empfiehlt	Present
kumulierst	Present
Schulbuches	None
lullet	Present
gelabert	Past
diskriminierend	Present
zwangsernährst	Present
demobilisierst	Present
erstochen	Past
erweckend	Present
Chinesen	None
Durchschnitten	None
tadelet	Present
ärgerst	Present
Marmors	None
ausgebreitet	Past
Lithiumisotops	None
Konditoreien	None
abschließend	Present
bröckelst	Present
gekentert	Past
Wirbeltieren	None
verstürbet	Past
geprägt	Past
Geiern	None
korrespondierend	Present
gegibbelt	Past
Ammoniaks	None
desavouierst	Present
Bekenntnisses	None
zwinkre	Present
explizierst	Present
kritisierest	Present
Nachhaltigkeit	None
geknallt	Past
Borwasserstoff	None
tränest	Present
tauet	Present
hungerest	Present
extrahierest	Present
ergibt	Present
placieret	Present
Telegramme	None
verneinst	Present
autorisierest	Present
pubertieret	Present
grausend	Present
vernommen	Past
Blechteilen	None
leitend	Present
Strontiummetalles	None
Hypnosen	None
erschütternd	Present
bell	None
geglättet	Past
verwieset	Past
begeisterest	Present
erlieget	Present
Introspektion	None
wändest	Past
Rillen	None
verpressend	Present
Bitterlingen	None
verzeihst	Present
nölst	Present
kartographierst	Present
gewehrt	Past
Protosterne	None
gekotet	Past
zitierend	Present
ergebt	Present
Spitzenhäubchen	None
kriminalisierst	Present
Haarschnitten	None
behindre	Present
Salzstock	None
industrialisierend	Present
flirrst	Present
transchieret	Present
angetan	Past
stotterest	Present
anrichtend	Present
liebäugelst	Present
befestigest	Present
verschwörst	Present
fauchend	Present
geplanscht	Past
gesperrt	Past
Gewichtes	None
Arschlöchern	None
widerstandet	Past
kalkulierend	Present
umdrehend	Present
wärmest	Present
Freundes	None
Phosphide	None
schleichst	Present
sonnst	Present
evangelisirest	Present
drillet	Present
gescheht	Present
Synekdoche	None
wickelst	Present
kreierend	Present
verfolgst	Present
Neutronensterne	None
Ehrgeizes	None
Abreicherung	None
vergreis	Past
sublimierst	Present
grübelet	Present
Austenit	None
gepflückt	Past
dimerisierst	Present
bootend	Present
verknallend	Present
wiederholest	Present
abstellend	Present
erzeugst	Present
dröhnet	Present
zentrierend	Present
malmet	Present
diagnostizierst	Present
Mantels	None
gelobst	Present
schweißest	Present
aufgegangen	Past
rammest	Present
ausgezogen	Past
billiget	Present
lancierend	Present
Geiger	None
gekreuzigt	Past
jobbest	Present
bekennend	Present
flehend	Present
geähnelt	Past
erhöhet	Present
Darstellerin	None
differenzierst	Present
befreiet	Present
Kanone	None
Hehlerei	None
begeisternd	Present
kondensieret	Present
Startern	None
erlanget	Present
besticht	Present
Mailändern	None
krepierst	Present
Futons	None
Sellerie	None
galoppierst	Present
Amnestien	None
verteilet	Present
Vorhabens	None
angezeigt	Past
getobt	Past
illustrierend	Present
entnehmt	Present
bastelest	Present
filternd	Present
Exoplanet	None
zerstörend	Present
geangelt	Past
geputscht	Past
Lederstiefeln	None
paddle	Present
begebest	Present
Beckens	None
fasend	Present
Basaren	None
Strudel	None
schmeichle	Present
Rudern	None
Mondgestein	None
Debüts	None
schaufelet	Present
pochierend	Present
Details	None
malet	Present
entlastend	Present
rhodinierend	Present
zitternd	Present
textend	Present
versieht	Present
ignorierst	Present
Geleitschutz	None
Südkoreanerin	None
Köchers	None
versteinre	Present
stapfet	Present
beneidend	Present
gehäutet	Past
Dachziegeln	None
Erhöhungen	None
Domizil	None
tagget	Present
Vorsilben	None
grubt	Past
grunzet	Present
Wirbeltier	None
erlöschend	Present
steigerst	Present
hinkest	Present
traueret	Present
gequert	Past
komprimierst	Present
Primeln	None
frustrierend	Present
kontrahierend	Present
entjungfert	Past
formulierst	Present
verwarfst	Past
Transistor	None
optimierst	Present
Entladungen	None
Ankurblungen	None
müffelnd	Present
nachvollzogen	Past
Böttcher	None
picknickend	Present
karikierest	Present
Glückskeks	None
verwelket	Present
Feuerleiter	None
gezupft	Past
beaufsichtigest	Present
Album	None
assistierst	Present
Weite	None
strafet	Present
punktend	Present
Märtyrerin	None
verrührend	Present
Felsenbirnen	None
beschönigend	Present
Verräter	None
verhießet	Past
weigerst	Present
korrodierest	Present
übertreibend	Present
kaperst	Present
Krüppeln	None
Verbindungsdrähten	None
Ruhepotential	None
Verlauf	None
brät	Present
implizierst	Present
verzieht	Past
Esperantisten	None
abgetrieben	Past
verzweifelst	Present
abweichend	Present
bedankst	Present
gegliedert	Past
Stummheit	None
wachet	Present
überstehet	Present
lieferet	Present
gemündet	Past
wehst	Present
Südasien	None
ahnend	Present
unterbrächest	Past
gefeuert	Past
gipfelnd	Present
kapitalisieret	Present
verstärket	Present
ausgeführt	Past
pulsieret	Present
lindernd	Present
sprießet	Present
Pendler	None
wünschend	Present
Neffe	None
knisteret	Present
zementierst	Present
ähnelnd	Present
demoralisieret	Present
Reflexion	None
Apotheke	None
Aprikose	None
schwillt	Present
sortierst	Present
warnend	Present
lynch	None
demoralisierend	Present
liehet	Past
Vorhäutchens	None
Akkus	None
Energietechniken	None
bandagieret	Present
erschöpfest	Present
Hundertmillionstel	None
Kopien	None
korrespondierst	Present
Festival	None
Horrors	None
Dyslalie	None
flochtest	Past
gesündigt	Past
generalisierest	Present
Beeinflussungen	None
flatternd	Present
pochend	Present
erhellet	Present
emaillieret	Present
Hieben	None
Zerfälle	None
überwieset	Past
gruppieret	Present
pilgerest	Present
wischet	Present
puddelest	Present
tagträumend	Present
Opal	None
geimpft	Past
Uferschwalben	None
perfektionieret	Present
versammelest	Present
geschlendert	Past
erhitzet	Present
tanzet	Present
Unwahrheit	None
Walzer	None
leerst	Present
bleichend	Present
grabt	Present
fladre	Present
Molekülorbitalen	None
demontierest	Present
kichre	Present
klingend	Present
juck	None
Koordinatensysteme	None
juckest	Present
Schildlaus	None
beschwörst	Present
beunruhigend	Present
ringelet	Present
beschwörend	Present
verzehrst	Present
ergössest	Past
Gewürzes	None
aufwachend	Present
snöbest	Present
gefährdend	Present
zugefügt	Past
Dümmlichkeiten	None
aufgehalten	Past
Lautschrift	None
amenagierest	Present
Feldspat	None
entwischest	Present
verknitteret	Present
Kommentaren	None
Dramen	None
assistieret	Present
schnurrend	Present
begingt	Past
einkaufend	Present
belegst	Present
erwerbt	Present
knuspre	Present
passend	Present
peilend	Present
weißsagend	Present
Trainees	None
Vanadinit	None
stützend	Present
hüllst	Present
Saxophons	None
Atompilz	None
verpassend	Present
Vorquartale	None
attackierest	Present
assimilierend	Present
wahrend	Present
Laufen	None
Friedensprozess	None
entstammet	Present
kauet	Present
koexistieret	Present
käufet	Present
gemeuchelt	Past
bekrieget	Present
replicier	None
sorget	Present
revanchierend	Present
entheiliget	Present
Alkoholikers	None
besprengst	Present
regelst	Present
übernimmst	Present
ausweichend	Present
überfischst	Present
tröpfelst	Present
Folterknechte	None
blinkest	Present
Ablasses	None
Sehne	None
Achatschnecke	None
Chlorwasserstoffs	None
Schürzen	None
Parklandschaft	None
befallet	Present
wiederentdeckst	Present
Hundertmillionstele	None
zensurierest	Present
schotternd	Present
laufet	Present
verschlösset	Past
Fußabstreifers	None
zürnend	Present
verweisend	Present
zögerest	Present
Urlaub	None
oszillieret	Present
versüßest	Present
Klippen	None
Kalkspate	None
schwangst	Past
korrumpierend	Present
Sauerstoffgehalt	None
Umformulierungen	None
Vorstößen	None
erkläret	Present
Gänseblümchen	None
ramifizierst	Present
rangierest	Present
entfärbet	Present
Leberkäses	None
Hahnes	None
Schakale	None
eingewickelt	Past
Schädelknochens	None
gegabelt	Past
konsumieret	Present
glaubet	Present
schlagt	Present
kramend	Present
besohlet	Present
Regenzeiten	None
wallfahret	Present
korrigierst	Present
Nachschub	None
geschwächelt	Past
Schilddrüsenhormone	None
Fernsehgerät	None
verhungeret	Present
geschüttet	Past
toppet	Present
gerügt	Past
keimend	Present
gefoltert	Past
Mammakarzinomen	None
Seltenerdmetall	None
Stierkämpfen	None
Emus	None
zurückgekehrt	Past
zerbrichst	Present
erbracht	Past
Porphyrinen	None
wirst	Present
geschellt	Past
reservieret	Present
rammet	Present
Zwischenprodukt	None
Gitterstruktur	None
Berührungen	None
Schwefeldampf	None
eingestanden	Past
weggeworfen	Past
gedrillt	Past
dröschet	Past
verehret	Present
schämest	Present
Gelee	None
Seile	None
Vertuschungen	None
friemelet	Present
leget	Present
flehest	Present
Beschleunigungssensor	None
planschst	Present
harnet	Present
befielst	Past
klönest	Present
Vergewaltigern	None
entschleiernd	Present
Führerhauptquartieren	None
gegrabbelt	Past
kürzet	Present
injizierend	Present
Zutritt	None
imitierend	Present
knackst	Present
kläffest	Present
quasselst	Present
deutend	Present
Anwachsen	None
gejährt	Past
erweckest	Present
dolmetschet	Present
holet	Present
strahlst	Present
Endungen	None
Hypophysen	None
kniend	Present
gebiert	Past
erfolget	Present
zweifelnd	Present
agierend	Present
Verschlimmbesserungen	None
bückend	Present
spannend	Present
verlernet	Present
Kanadierin	None
unterstreichst	Present
Franchise	None
Ruckes	None
Tyrannen	None
nachgewiesen	Past
kumulierend	Present
messet	Present
notgelandet	Past
ausgereicht	Past
vernimmt	Present
Hyäne	None
Herrschaft	None
verzweifelnd	Present
instrumentalisierend	Present
Statthalter	None
unterjochet	Present
kratzend	Present
sinkest	Present
gereinigt	Past
spürst	Present
angefasst	Past
verhüllst	Present
Ionenbindung	None
tüftelet	Present
blauend	Present
schiess	None
Nachtspeicherheizungen	None
schwärmend	Present
Marone	None
sanierend	Present
verträtet	Past
verspracht	Past
Bibliographien	None
Seetangs	None
tunst	Present
Nebensätze	None
zockend	Present
vertritt	Present
gerupft	Past
migrierst	Present
Fröste	None
indoktrinierst	Present
plünderst	Present
plumpsest	Present
Urteile	None
Noten	None
zuckernd	Present
bestimmend	Present
ekelest	Present
Sulfid	None
vergingst	Past
geflutet	Past
lenkst	Present
gehopst	Past
leakend	Present
erwarbst	Past
Fitnessstudio	None
Barbarei	None
abgeleitet	Past
Untersuchungsergebnis	None
angehimmelt	Past
schwändest	Past
Säbel	None
aluminierest	Present
Beispieles	None
assimilieret	Present
gekräht	Past
gerückt	Past
Biergarten	None
rührend	Present
entschläfst	Present
benannt	Past
angekündigt	Past
Vorbeiflüge	None
Sinn gemacht	Past
reagierend	Present
Mumie	None
Parse	None
hupend	Present
instituierend	Present
Anrufen	None
ermittelst	Present
lizenzieret	Present
Gedanke	None
klappend	Present
gegrapscht	Past
Kürasse	None
zugestimmt	Past
laufend	Present
widerstehend	Present
Nys	None
verginget	Past
gechattet	Past
Fluches	None
aufschiebend	Present
Kötter	None
Verhältnissen	None
sengest	Present
schröpfend	Present
wühlest	Present
besichtigest	Present
lochst	Present
betroffen	Past
moppst	Present
veräußerst	Present
grabbelst	Present
rußend	Present
bohrend	Present
hemmend	Present
glawbet	Present
entwässerst	Present
Teamgeist	None
spähend	Present
fingierest	Present
verschränkend	Present
rebellierst	Present
Autokino	None
Erkers	None
krösst	Present
schnattre	Present
schobst	Past
Linksverkehr	None
Fulleren	None
bewehret	Present
kommst	Present
repräsentieret	Present
i-Tüpfelchens	None
ersuchest	Present
Areals	None
Kontrollraumes	None
versagest	Present
Zicken	None
bestätigend	Present
süss	None
Loben	None
verfüget	Present
Trockenbeerenauslesen	None
verrätst	Present
rinnend	Present
urteilst	Present
Entmachtung	None
dissoziieret	Present
unternommen	Past
zerbrechet	Present
geheizt	Past
Haustrauung	None
gerechnet	Past
angehoben	Past
assoziierst	Present
bekreuzigst	Present
kasteist	Present
Barschaft	None
geschliffen	Past
Musikers	None
Herbstgrasmilben	None
spitzet	Present
widerständet	Past
Chlorats	None
verwandle	Present
stockend	Present
fertigend	Present
galvanisierest	Present
gaffend	Present
verbaselnd	Present
geschwärt	Past
ackre	Present
glühend	Present
paraphrasierend	Present
Spielzeug	None
naschet	Present
schwächst	Present
modernisierend	Present
beschießet	Present
entkörperlichend	Present
beurteilst	Present
verböget	Past
zugemacht	Past
dechiffrierend	Present
gebrannt	Past
stampfst	Present
Sportherzen	None
prüfend	Present
verbessernd	Present
mixet	Present
lispelnd	Present
kolorierest	Present
mesmerisierend	Present
wischend	Present
Plattfische	None
folgst	Present
Generierung	None
tatterst	Present
terrorisierst	Present
versklavend	Present
hungeret	Present
bestrafst	Present
Schlepper	None
Auktionen	None
Schlagmann	None
bestecht	Present
gehörst	Present
verkapselet	Present
Rondells	None
vermerkst	Present
staubsaugst	Present
buddle	Present
verschleieret	Present
Stannate	None
Ornithologe	None
blockierend	Present
lockre	Present
weckend	Present
verdreifachst	Present
Pantheisten	None
angelnd	Present
gelegt	Past
konstatieret	Present
ernüchtre	Present
geküsst	Past
geteilt	Past
behalft	Past
Süßstoffe	None
pürierst	Present
bestimmst	Present
entkommest	Present
plumpset	Present
reagierst	Present
Verbrechen	None
meisterst	Present
nebelnd	Present
hoffst	Present
durchquerest	Present
widerspracht	Past
hökre	Present
hergehört	Past
separierst	Present
dienet	Present
schlendre	Present
Bataillonen	None
fönest	Present
verschiebet	Present
Podiums	None
Brautenten	None
jodelst	Present
ringelnd	Present
transformierend	Present
befiehlt	Present
Darbietungen	None
hallend	Present
verlockend	Present
genieret	Present
begrüsset	Present
Krankheitsfälle	None
überzeugend	Present
zekratzend	Present
reduzierst	Present
verbirgst	Present
gelogen	Past
Belägen	None
Silikates	None
Platinmetalle	None
Maschinenräumen	None
bemängelest	Present
Insektizide	None
Redoxindikators	None
anfechtend	Present
crèmst	Present
aufbauend	Present
Überläufern	None
penn	None
Brennstoffe	None
klapperet	Present
Grubenunglücken	None
kategorisierest	Present
mehret	Present
winselst	Present
Eisenbleche	None
pollst	Present
frickelet	Present
Schwester	None
Geschöpfen	None
einnehmend	Present
gelehnt	Past
experimentierst	Present
entleeret	Present
eiterest	Present
patentieret	Present
gefurzt	Past
skypend	Present
überkamst	Past
billigst	Present
besprechest	Present
enttäuschest	Present
scharrst	Present
verheißet	Present
handhabest	Present
Kranz	None
Ingwer	None
küssend	Present
Fagotten	None
A	None
retuschieret	Present
demütiget	Present
Großmeisters	None
ausgehalten	Past
Ebbe	None
Interieurs	None
schlurfst	Present
gekämpft	Past
ergreifst	Present
entfernest	Present
Drosselungen	None
verlädst	Present
Minimalpaare	None
stieget	Past
geregelt	Past
entkommst	Present
Fahnenflüchtigen	None
Silane	None
jaulst	Present
aufgetaucht	Past
tüftle	Present
geschmuggelt	Past
gespart	Past
annektieret	Present
berechtigst	Present
gemeißelt	Past
geraubt	Past
Kolbeckit	None
replizierst	Present
kandierest	Present
Korngröße	None
reifizierst	Present
Langschwanzkatze	None
Banknote	None
bettend	Present
gepaukt	Past
freigesetzt	Past
Nicotins	None
gezweifelt	Past
betonet	Present
Abrede	None
erschüfest	Past
produzierst	Present
Lob	None
ausstattend	Present
rächest	Present
rätselnd	Present
gewitzelt	Past
kaperet	Present
Schneidbrettes	None
amüsierest	Present
substituierst	Present
angestellt	Past
Decahydrats	None
konstruierest	Present
beweisest	Present
gekniffen	Past
ausgestattet	Past
erlabst	Present
besprechend	Present
geeilt	Past
vergrubt	Past
bejubelst	Present
zerfällt	Present
würdest	Past
tauend	Present
Landesverräter	None
chargieret	Present
Besetzer	None
entzweist	Present
verkörpre	Present
nietend	Present
rettend	Present
Gasthäusern	None
entsagest	Present
sexelst	Present
Parkhauses	None
parametrisierest	Present
gemahlen	Past
Krawalle	None
Wohltäterin	None
gequalmt	Past
vertretend	Present
regierest	Present
duschest	Present
eingeteilt	Past
stammst	Present
wägend	Present
vernehmet	Present
gemanagt	Past
Phosphate	None
furz	None
initialisieret	Present
Muskat	None
grübelest	Present
interpretierst	Present
erschienst	Past
check	None
Harpunen	None
Cholins	None
chloroformierest	Present
Loge	None
Astronaut	None
dirigierst	Present
zerbricht	Present
grämend	Present
Halophyten	None
gespeichert	Past
Differenzierungen	None
pasteurisier	None
Sichtkontakte	None
geleakt	Past
getuschelt	Past
Waffenschmieden	None
Präservativ	None
flambieret	Present
Neiders	None
übersehend	Present
Salafisten	None
Haarwaschmittel	None
reproduzierend	Present
veranschlagst	Present
coventrisieret	Present
erziehest	Present
huschst	Present
ballet	Present
Achtecken	None
rekapitulieret	Present
verarschst	Present
interessieret	Present
bestich	None
Weißrusse	None
Abenteuerlichkeiten	None
camouflierend	Present
Staubgefäße	None
zischet	Present
skizzierst	Present
erdrückest	Present
bedruckend	Present
heparinisierest	Present
wetteifernd	Present
heylest	Present
vereisend	Present
Übergriffs	None
Gegenzug	None
weckest	Present
rebellieret	Present
lächle	Present
teilet	Present
beschützet	Present
donnerest	Present
tunest	Present
Gelegenheitsarbeiters	None
Stellenwertes	None
debattierend	Present
terrorisierest	Present
kampierend	Present
ejakulierend	Present
injizierst	Present
schäumend	Present
befallest	Present
Hektar	None
gerülpst	Past
tätowieret	Present
Serbe	None
kaure	Present
markierend	Present
lobet	Present
belüget	Present
bluffest	Present
vermochtet	Past
orgelst	Present
Toasters	None
subventionierst	Present
dehydrieret	Present
dünkend	Present
lockernd	Present
gewettet	Past
kurbelnd	Present
verkröchet	Past
lynchet	Present
betonend	Present
Dreidimensionalität	None
staple	Present
aufkonzentrierend	Present
Berylliumerze	None
Heilbutt	None
Gaden	None
lackierest	Present
schämend	Present
Versuchstieren	None
beliefet	Past
entfremdend	Present
gesplittert	Past
schmuggelet	Present
bedrückend	Present
graphitierst	Present
befriedigend	Present
handelnd	Present
fegend	Present
sagest	Present
Proviant	None
Fechters	None
Rosinenkuchens	None
Wassermolekülen	None
Universitäten	None
gelähmt	Past
geschämt	Past
Gegengifts	None
Stieglitze	None
nächtiget	Present
gefrierend	Present
weckst	Present
Abredegestellt	Past
zapfend	Present
Delirien	None
Ångströms	None
Systeme	None
marschierst	Present
Elstern	None
Hochhaus	None
kuschelnd	Present
Fort	None
Seltenerdmagnete	None
interkulturalisieret	Present
vergingest	Past
gewährst	Present
zoffst	Present
ehelichet	Present
prozessierest	Present
nährst	Present
geschworen	Past
strichest	Past
faszinierend	Present
gegrübelt	Past
instrumentalisieret	Present
berührst	Present
geschlüpft	Past
demobilisierest	Present
dissoziierend	Present
Wüchse	None
Normdatum	None
Löffelente	None
Ackerböden	None
bratschest	Present
widersteh	None
Ideale	None
durchgefahren	Past
Glucinium	None
Mitglieder	None
beheizest	Present
inspirierest	Present
zubereitet	Past
verwehet	Present
geordnet	Past
gelaicht	Past
eingeprägt	Past
beschwerst	Present
konnotieret	Present
schimmelst	Present
geschadet	Past
desinfizierend	Present
erlaubst	Present
gebremst	Past
verschlangst	Past
vertan	Past
erzielend	Present
richtend	Present
Flieger	None
Digitalisat	None
grübest	Past
erntend	Present
mahnet	Present
besiegest	Present
moderierend	Present
liieret	Present
gefahndet	Past
schikanierend	Present
paralysierend	Present
verkackend	Present
befallend	Present
desillusionieret	Present
chiffrierend	Present
Adverbien	None
manipulierend	Present
opfernd	Present
geflucht	Past
Münchenern	None
Rationen	None
gezerrt	Past
belügst	Present
Fallreepen	None
verursachest	Present
schmelzet	Present
zerkreuzst	Present
zurückgetreten	Past
Zeichenfolgen	None
buchstabierst	Present
kontaktieret	Present
Strickes	None
Standpunkten	None
Luminometer	None
Scratchen	None
kompromittierst	Present
vertrüget	Past
umgestiegen	Past
wandelnd	Present
freust	Present
sofft	Past
vergraulend	Present
kondensierst	Present
vereinfachst	Present
erhebet	Present
Kleptokratie	None
stechest	Present
gedopt	Past
angeschnallt	Past
geknackt	Past
säend	Present
gewürfelt	Past
geschönt	Past
Neidern	None
gefreut	Past
gezecht	Past
erübrig	None
missverstehest	Present
Chores	None
plagiieret	Present
kokettieret	Present
Hindernissen	None
Verdrehung	None
anhebend	Present
Infekte	None
reduzieret	Present
dringend	Present
durchsuchest	Present
Zufallsgrößen	None
Fluorgehalten	None
warnst	Present
gewaschen	Past
Fußpilz	None
Zeitzone	None
Verwalters	None
verdrehend	Present
gekreist	Past
wahrgenommen	Past
Felses	None
erhoffst	Present
gebuddelt	Past
besprachst	Past
eilend	Present
entfärbest	Present
missverständet	Past
kränkelest	Present
fluorierend	Present
entkämet	Past
kategorisierst	Present
Elfen	None
verurteilst	Present
Arsin	None
Körpergerüchen	None
tafelnd	Present
Philerasten	None
erschöpfend	Present
duzend	Present
begründend	Present
entgleisest	Present
gelitten	Past
vergolten	Past
recycelet	Present
verbrämend	Present
gestaltend	Present
mailet	Present
flitterst	Present
Rücklaufes	None
verdeckt	Past
autorisierst	Present
absagend	Present
genügst	Present
aufregen	None
Stabhochsprung	None
beruhigend	Present
aufgerufen	Past
überständet	Past
andeutend	Present
initiierend	Present
Außenpolitik	None
sträubest	Present
zögerst	Present
neidend	Present
gelänget	Past
gewatschelt	Past
rollet	Present
kribble	Present
pflückend	Present
sächselet	Present
Gemeinplatzes	None
gehungert	Past
Flügelhornes	None
nervet	Present
applicieret	Present
gliederst	Present
hingewiesen	Past
berechtigend	Present
prognostizierest	Present
Farbfernsehen	None
Phenols	None
schuppst	Present
geschürft	Past
Endpunkts	None
Grenaderin	None
Kortison	None
quatschest	Present
ergrauend	Present
vergraulet	Present
überredend	Present
verpflichtend	Present
Tänzers	None
gezippt	Past
Triphosphate	None
Eisensteinen	None
geschlurft	Past
kreieret	Present
gelobet	Present
plärrst	Present
fiebre	Present
sattelnd	Present
ergötzend	Present
priorisierst	Present
Stecken	None
aktivieret	Present
philosophierend	Present
beeinträchtigend	Present
schellend	Present
einschüchternd	Present
abbekommen	Past
entspannend	Present
hobst	Past
vermocht	Past
zögernd	Present
verübet	Present
zapfst	Present
Verlöbnisse	None
erträgst	Present
diffamieret	Present
klon	None
oktroyieret	Present
verwitteret	Present
Beobachtungsstand	None
Ackers	None
Facharztes	None
ärgeret	Present
freigelassen	Past
kräuselest	Present
informierend	Present
gemurmelt	Past
turnest	Present
narrend	Present
Laudanum	None
Vorstellungsgesprächen	None
lavierst	Present
Fingerabdruck	None
Pelzhandschuhs	None
jammerst	Present
Weihwässer	None
abscheidend	Present
schluchzest	Present
Kopierer	None
Dateinamens	None
gegackert	Past
spüret	Present
neutralisierest	Present
erforderst	Present
Apfelsinenbaum	None
fassend	Present
empörend	Present
Fußböden	None
Steuerzahlers	None
geschimpft	Past
Redoxpotentiale	None
Wolke	None
besännet	Past
mähest	Present
datierest	Present
schnarchst	Present
entwickelnd	Present
greinend	Present
flötend	Present
raubet	Present
schätzet	Present
durchwachet	Present
wägest	Present
Campus	None
räumst	Present
Disjunktion	None
knallest	Present
Perücke	None
konjugieret	Present
Segler	None
aufgerundet	Past
erwartend	Present
verkapselest	Present
bekräftigend	Present
Einkommens	None
rückest	Present
geflittert	Past
wimmelnd	Present
lächelnd	Present
trälleret	Present
vollziehest	Present
gerechtfertigt	Past
erläuteret	Present
Laoten	None
heure	Present
korrelierst	Present
Keiler	None
erschüttre	Present
pochet	Present
geputzt	Past
Abtransport	None
überträfest	Past
Samstagvormittag	None
dissoziierest	Present
Weibchen	None
schrumpfest	Present
verantwortend	Present
Kurzschlüssen	None
geplatscht	Past
putschet	Present
stiehlt	Present
eingeschätzt	Past
Mull	None
benachrichtigest	Present
geschweißt	Past
Freisprüchen	None
Stockwerkes	None
zerläset	Past
ergabt	Past
epilierst	Present
würfelet	Present
beigelegt	Past
huschend	Present
concessionierend	Present
bärstet	Past
Akademien	None
Notenwerten	None
gegähnt	Past
verringerest	Present
Umlaufzeit	None
notier	None
Medikamenten	None
vertagend	Present
Lieblinge	None
inhalierst	Present
Christbaumschmucken	None
musizierend	Present
Garanten	None
Endokrinologin	None
tobest	Present
dissentierst	Present
haschest	Present
klassifizierend	Present
sankt	Past
beschleunigend	Present
dekorierend	Present
würdigend	Present
erwirbst	Present
kramet	Present
vergilt	Present
gerußt	Past
beschuldigst	Present
romantisierend	Present
Manualen	None
bollre	Present
Vorlage	None
erstell	None
Verhütungsmitteln	None
Programmierer	None
kichernd	Present
bewirbt	Present
frappierend	Present
fesselnd	Present
sprudelet	Present
verästelest	Present
gezwungen	Past
erzeuget	Present
keimet	Present
hecket	Present
überlebest	Present
durchwanderest	Present
erläget	Past
geblendet	Past
kippst	Present
zusammengestellt	Past
schliffet	Past
schmierest	Present
Verdampfers	None
Busches	None
rauschst	Present
Heuer	None
erschießend	Present
sticht	Present
schliffst	Past
Lizenz	None
gesimst	Past
Unterfinanzierung	None
Weichloten	None
gejappt	Past
gebastelt	Past
mißverstandet	Past
Amokläufers	None
Weltmärkte	None
verfolgest	Present
Bärtchens	None
zielst	Present
Gitters	None
Komodowarane	None
Bergländer	None
mißhandelest	Present
verlebst	Present
bedenkst	Present
Alkohol	None
rechtfertigst	Present
abgegeben	Past
Salamanders	None
gedrosselt	Past
vorgezeigt	Past
Sulfoxylate	None
Zaren	None
verkörperet	Present
verstellend	Present
begehest	Present
Abholzung	None
erhellst	Present
steuernd	Present
raufet	Present
plädierst	Present
heg	None
Zahlwörter	None
beschimpfst	Present
fließest	Present
Neidbauten	None
Esseners	None
versteigerst	Present
leuchtend	Present
amenagierend	Present
Quantenfluktuationen	None
kränkend	Present
messest	Present
modernisierst	Present
Motorsägen	None
Christdemokraten	None
zerbrächest	Past
Psalmen	None
trocknend	Present
mitgekommen	Past
prägest	Present
Kaufleuten	None
installierst	Present
verhilfst	Present
abnehmend	Present
verbannend	Present
kröchest	Past
Verliesen	None
Schauern	None
Küstenregion	None
Niobit	None
Priesters	None
filtrieret	Present
Huchen	None
Seilbahn	None
erprobest	Present
Zöllner	None
bestätigst	Present
Paradoxe	None
Kater	None
entwichet	Past
zubereitend	Present
ablenkend	Present
Schnörkellosigkeit	None
verfemet	Present
kränkelet	Present
regest	Present
fütterest	Present
widerlegst	Present
gezankt	Past
camouflierest	Present
Ähre	None
eskalierend	Present
Absätze	None
Feuertürme	None
gefestet	Past
Graureihers	None
redend	Present
erstarrend	Present
stutzend	Present
vergebt	Present
Zwergschwanes	None
entkeimet	Present
hervorgerufen	Past
getötet	Past
gehastet	Past
Binnenland	None
ordre	Present
dinierest	Present
abspielend	Present
erträgt	Present
koagulierst	Present
fladerst	Present
rutschend	Present
bemächtigend	Present
Geschehens	None
verschleißet	Present
genörgelt	Past
ergatterst	Present
legend	Present
applaudieret	Present
Oleandern	None
globalisierest	Present
schuppend	Present
floht	Past
Bleierzes	None
Triphosphaten	None
geflenst	Past
geweht	Past
nennet	Present
tränkst	Present
Versuchstiers	None
ergreifend	Present
Brauhaus	None
Blödmannes	None
Ausweg	None
Riesling	None
erwähnst	Present
Haitianerinnen	None
Frikative	None
vertreibst	Present
feuernd	Present
Teppich	None
Stöpsels	None
verbergest	Present
geseufzt	Past
tranchierst	Present
streichelest	Present
Riedels	None
batikend	Present
aktivierend	Present
Melden	None
Hackordnung	None
spukend	Present
verfinsternd	Present
geizest	Present
geblichen	Past
mogelet	Present
zwingest	Present
humpelnd	Present
entwickle	Present
Imbissen	None
geholt	Past
schneidend	Present
Kreuzbeine	None
beschlaget	Present
provozierend	Present
einladend	Present
geknechtet	Past
Schiffskörpern	None
spazier	None
widerlegend	Present
Körnung	None
wiehre	Present
pharyngalisieret	Present
Strafmaßnahme	None
quaket	Present
Griechen	None
Depp	None
Hydrauliköl	None
rauschend	Present
Religionen	None
errät	Present
Entschlüssen	None
malest	Present
koordinierend	Present
geschwafelt	Past
bleichet	Present
geäußert	Past
Steinmetzinnen	None
geschädigt	Past
Diskothek	None
versinket	Present
mineralisierend	Present
gestandet	Past
Niederländern	None
Pulsare	None
herzet	Present
Biomolekülen	None
gewinkt	Past
kuschelst	Present
Hirsen	None
eingeräumt	Past
ragend	Present
befolgst	Present
schnatterest	Present
Elternabende	None
Torschützen	None
meuteret	Present
versaust	Present
Eichstriche	None
schirmst	Present
ausgerüstet	Past
geschoben	Past
Knorpelfische	None
Schnittlauchen	None
beheimatend	Present
Knäbleins	None
angemeldet	Past
gegart	Past
flunkernd	Present
abstrahierst	Present
fingierend	Present
sedierend	Present
Laboratorien	None
ionisierest	Present
personifizierend	Present
bohret	Present
aufrufend	Present
gepudert	Past
Wettkämpfen	None
Päderastie	None
Galoppe	None
Spende	None
Manövern	None
gejätet	Past
gefasst	Past
verkleinerest	Present
Ferroniobs	None
glotzet	Present
entre	Present
gegolten	Past
vergeltend	Present
aussteigend	Present
schmerzend	Present
vergas	None
abgelenkt	Past
sprenget	Present
gegurgelt	Past
fraternisierst	Present
gescheuert	Past
getaucht	Past
profitieret	Present
Detektivs	None
abgestiegen	Past
Apparaturen	None
bejahend	Present
angerufen	Past
ersuchet	Present
schmunzelst	Present
saget	Present
Schmach	None
Produktvergleiche	None
gefeilscht	Past
verbogt	Past
sperrend	Present
pfropfst	Present
Vanadocenen	None
zerflösset	Past
begebt	Present
gewitteret	Present
Händeln	None
klauet	Present
Entschlüsselung	None
verdampfst	Present
ebb	None
ergatterest	Present
Maschinengewehren	None
Hausherrn	None
gemäht	Past
Geräte	None
Schenke	None
Kunstmaler	None
kontaminierst	Present
betrifft	Present
erschient	Past
Rollbahnen	None
geärgert	Past
schmauchend	Present
haschst	Present
dissentierend	Present
unterwerfend	Present
urbanisierst	Present
suspendienierst	Present
verabredend	Present
nennest	Present
ritz	None
unterdrücket	Present
Rezepturen	None
Klient	None
Fichteliten	None
koproduzierst	Present
übertreffend	Present
näherst	Present
behältst	Present
begleichet	Present
angehend	Present
reduzierest	Present
segnend	Present
Golfschlägern	None
Ursachen	None
hervorbringend	Present
Grünspechtes	None
kappst	Present
geschützt	Past
abgenommen	Past
gepimpert	Past
schimmelest	Present
erlöscht	Present
boxet	Present
Rasierstifte	None
geknirscht	Past
linsest	Present
kränkelst	Present
säget	Present
Stätte	None
Sesseln	None
Marmelade	None
begeisterst	Present
verschwiegt	Past
ausstrahlend	Present
vereinest	Present
entkorkest	Present
Säers	None
läppernd	Present
Bierchen	None
stagnierend	Present
missverstehst	Present
verbrochen	Past
exportierst	Present
Edukt	None
zittre	Present
Reim	None
harrest	Present
rennest	Present
unterstreichet	Present
Individuum	None
ertrinkend	Present
lochest	Present
Farbenspiele	None
patrouillierst	Present
Einfamilienhäuser	None
beließet	Past
schweißet	Present
begebend	Present
gehoben	Past
defilieret	Present
verästelnd	Present
verkläret	Present
Nierensteins	None
stürmet	Present
Nigerianer	None
müffelest	Present
hingelegt	Past
seufzend	Present
transformierest	Present
gebissen	Past
gekappt	Past
glottalisieret	Present
duschet	Present
behindernd	Present
Hinkelsteine	None
Arsentrioxids	None
Aaken	None
beeinflussend	Present
gehindert	Past
reformierend	Present
Sulfaten	None
mutierend	Present
Datenträgers	None
baggerest	Present
vertatest	Past
modellierend	Present
ausmusternd	Present
grabbelet	Present
besetzet	Present
gekaut	Past
lullst	Present
glottalisierest	Present
Zagel	None
Umsatz	None
profitierend	Present
schlichtend	Present
verschlosst	Past
bewässre	Present
Penisknochens	None
vergrabet	Present
vorziehend	Present
bemängelst	Present
bemutterst	Present
Anlegers	None
flutend	Present
Gebetsteppichs	None
bestehlend	Present
bewerkstellig	None
rasieret	Present
akzeptieret	Present
Fliegerasse	None
Assimilation	None
erhöhst	Present
benennst	Present
Geschwindigkeitsmessern	None
gejuckt	Past
schiebst	Present
geziert	Past
überstandest	Past
Verbesserung	None
mampfet	Present
Sehers	None
gesteigert	Past
alimentierest	Present
Zähler	None
gestunken	Past
Pfuhlschnepfen	None
liebet	Present
Bundesregierung	None
tappend	Present
Emphase	None
gemufft	Past
Samstagmorgens	None
verwirret	Present
Schlaflied	None
babble	Present
Autogrammjäger	None
schwächet	Present
ausgelaugt	Past
managest	Present
Calciumarsenat	None
befassend	Present
zugehört	Past
beschotterest	Present
liefet	Past
befummelnd	Present
Gedankenspiel	None
Hypostase	None
hybridisierst	Present
gebeichtet	Past
geheischt	Past
Pupille	None
erlägest	Past
Purpurschnecke	None
sezierend	Present
ondulierend	Present
kartografierst	Present
entvölkerst	Present
versprichst	Present
befraget	Present
Hecht	None
ausgerottet	Past
ablösen	None
austretend	Present
vertust	Present
Aspektes	None
obset	Present
schludre	Present
Entscheidung	None
Adamin	None
balkanisierend	Present
Samstagabend	None
kreisend	Present
verzettelst	Present
fabulierend	Present
gestreckt	Past
beauftragst	Present
angeredet	Past
überprüfest	Present
knurret	Present
bräunest	Present
gewidmet	Past
Vollidiotin	None
nuschelest	Present
zeuget	Present
saufet	Present
freigegeben	Past
riffelet	Present
Eiweißen	None
Abtransporte	None
Kinderärztin	None
bahn	None
enträtselet	Present
brüskieret	Present
gehöret	Present
entzifferst	Present
Edelmetalls	None
Wasserrades	None
Kindergeldes	None
ausgerechnet	Past
Gerichtsschöffen	None
belohnend	Present
schleifest	Present
erörteret	Present
hievest	Present
Nennwertes	None
referierest	Present
ergäbet	Past
zerret	Present
stotteret	Present
Amokläufer	None
goutieret	Present
geflochten	Past
leihend	Present
Hundsrobben	None
Assassine	None
sedimentierend	Present
meckeret	Present
überdächtet	Past
Pedalen	None
verschlimmbesserest	Present
gildend	Present
gebürstet	Past
Zwielautes	None
Erdlinge	None
Morden	None
Selenit	None
traust	Present
schlafwandelst	Present
genäset	Past
duschend	Present
ableitend	Present
platschst	Present
Jasagern	None
abstrahierest	Present
Blutlaugensalz	None
gekränkt	Past
Bleierz	None
kennengelernt	Past
hinwollen	None
transportierend	Present
geläppert	Past
geschmirgelt	Past
verzehrest	Present
Dreifaltigkeit	None
entfesselnd	Present
hämmeret	Present
blakend	Present
spiegelest	Present
fummelst	Present
Melanterite	None
reifst	Present
getarnt	Past
Schutzbleche	None
schwörst	Present
aushaltend	Present
bepflanzend	Present
abwickelnd	Present
Kollagene	None
Neujahre	None
schwindelst	Present
zerfallest	Present
hantieret	Present
gefällt	Past
stempelnd	Present
überprüfet	Present
vereinet	Present
dargestellt	Past
gesteuert	Past
unternimmt	Present
stationieret	Present
zürnet	Present
widersprichst	Present
glorifizierest	Present
plazierest	Present
geschauspielert	Past
angeschmiegt	Past
töpferest	Present
schimpfend	Present
gealtert	Past
gurgle	Present
jettend	Present
Bummeln	None
Hirnschädel	None
Fremdatom	None
geniest	Past
gefrickelt	Past
Auszahlungen	None
gemieden	Past
glosend	Present
stänket	Past
mauerst	Present
Resonanzen	None
zerfaserst	Present
belaueret	Present
Gummibaum	None
gestemmt	Past
Raben	None
eggend	Present
tyrannisierend	Present
verzinket	Present
merkst	Present
gesoffen	Past
Kruste	None
absondernd	Present
belaufend	Present
titrierst	Present
begehet	Present
verbrauch	None
hortend	Present
flackernd	Present
weggenommen	Past
rutschet	Present
inaktivierend	Present
gegerbt	Past
Bauherr	None
Funk	None
Gärtnern	None
Kuscheltiere	None
mobbend	Present
Lektion	None
verdirbst	Present
bastelst	Present
geschlagen	Past
Augenschein	None
schacherst	Present
gerbend	Present
grölst	Present
ertönst	Present
Stopps	None
brüskierst	Present
Halbmonden	None
komponierend	Present
schämst	Present
gekürzt	Past
verreiset	Present
labre	Present
nutzet	Present
klickst	Present
denaturieret	Present
erwärmst	Present
Professionen	None
Schuldscheine	None
Steinbrech	None
begleichst	Present
fotografier	None
Pfeife	None
versifizierst	Present
obfuskieret	Present
munkelet	Present
geschnitzt	Past
entnommen	Past
agierest	Present
versäumet	Present
applicierest	Present
Melodien	None
stapfend	Present
Benzole	None
befehlend	Present
hauset	Present
evangelisiret	Present
angemacht	Past
einsetzend	Present
Wortanfänge	None
modellierst	Present
quollt	Past
geringelt	Past
hellend	Present
gehickst	Past
überprüfst	Present
Baron	None
misslingest	Present
Gases	None
Kleiderschränke	None
verbeißend	Present
Kristallfelder	None
verweilst	Present
variieret	Present
bekämpfend	Present
gequält	Past
blätteret	Present
plazierst	Present
Atmosphären	None
miauet	Present
quasselest	Present
änderest	Present
erniedrigend	Present
Übersetzers	None
gehüllt	Past
Besenstielen	None
entsprechet	Present
gesüsst	Past
Spielzeugen	None
gekugelt	Past
schleichend	Present
entschädigend	Present
Heteroelement	None
vermagst	Present
sterilisierst	Present
melierst	Present
Ansprache	None
scheffelnd	Present
trödelnd	Present
Oberin	None
bremsend	Present
trample	Present
erlassest	Present
Berichten	None
summierend	Present
verscheisserest	Present
einlegend	Present
wagst	Present
defenestrierest	Present
überwunden	Past
Comic	None
avisierend	Present
vertragt	Present
geankert	Past
verknallst	Present
boxest	Present
verstarbt	Past
entstammend	Present
Sekretär	None
pfropf	None
Oberstaatsanwälten	None
eingehend	Present
häkelnd	Present
Magistern	None
stemm	None
gekachelt	Past
Schinken	None
gestehst	Present
heizet	Present
Kreuzschlitzschraubendreher	None
mikrominiaturisieret	Present
Zytotoxins	None
Sandkatze	None
gefladert	Past
Hohn	None
bepflanzest	Present
Geigerzähler	None
enteret	Present
Fremdsprache	None
Dumpfheit	None
Intensivstationen	None
diffundieret	Present
empfändest	Past
entfolgend	Present
kandidieret	Present
geschnürt	Past
pendelnd	Present
denaturierest	Present
besänftigest	Present
Sechseck	None
schminket	Present
Tabakkäfern	None
Vertrauensperson	None
Hellsehen	None
Kissenschlacht	None
entpacket	Present
gepaddelt	Past
verzählest	Present
Grappas	None
Fracht	None
Nisse	None
Sedimenten	None
schlüpfst	Present
abandonnier	None
verlocket	Present
kastrierst	Present
recherchierest	Present
gedemütigt	Past
befreiest	Present
wandelest	Present
wank	None
klassifizierest	Present
Kichererbse	None
Alibis	None
Aufstieg	None
knallet	Present
beunruhigst	Present
Divisors	None
wucherest	Present
Zainen	None
ausgelassen	Past
apportierst	Present
Graveuren	None
glaubst	Present
Reserverädern	None
nagle	Present
entnahmst	Past
erschaffst	Present
artikulierend	Present
gepeinigt	Past
Festspiele	None
unterbewertend	Present
heuchelst	Present
prüfst	Present
fotografierend	Present
gehasst	Past
Eisheilige	None
würzet	Present
Statist	None
ringst	Present
Kristallsystem	None
bestechend	Present
Abgasen	None
erstrecket	Present
spinnend	Present
Außwirkung	None
Fürstin	None
wandelst	Present
Brüderchen	None
Einsatzkraft	None
Münzstempel	None
reihend	Present
gefunzt	Past
entflöhet	Past
Timeboxing	None
Gründers	None
Zusammensetzung	None
retuschierest	Present
recherchierst	Present
unterwerfest	Present
gefahren	Past
platzend	Present
Goldgräber	None
Scanners	None
Mittwochnachmittag	None
kümmernd	Present
entwarfst	Past
besudelst	Present
entthron	None
Sonate	None
neckend	Present
Fahndern	None
verurteilet	Present
immunisierend	Present
engagierst	Present
hausest	Present
splitternd	Present
installierend	Present
Silanen	None
Laus	None
Wohnungen	None
Pfades	None
gedenkend	Present
referenzieret	Present
versteigerest	Present
erläuterst	Present
erwärmend	Present
Silbergeschirre	None
belogt	Past
Postulaten	None
strullernd	Present
angegeben	Past
repliciret	Present
löffelnd	Present
festgelegt	Past
deklamierst	Present
anstellend	Present
Rührei	None
gestikulierest	Present
Wortliste	None
verkleidend	Present
Mandelbäumen	None
befriedigst	Present
internationalisierst	Present
montierst	Present
entlehnst	Present
kipp	None
Stöpsel	None
gewallfahrtet	Past
verklaget	Present
aufgezählt	Past
Flughörnchen	None
Laternen	None
getextet	Past
Abgeordnetenhäuser	None
hervorgebracht	Past
erbrächtest	Past
spazierend	Present
panieret	Present
Schneeräumern	None
subtrahierend	Present
kommunizierst	Present
gekrallt	Past
graphitier	None
zankend	Present
Nagelköpfen	None
provozieret	Present
geklemmt	Past
oxidieret	Present
Flugkapitänen	None
entmischst	Present
taktieret	Present
Fassaden	None
einhergehend	Present
Bauwesen	None
Unwahrheiten	None
Biogas	None
ejakulierest	Present
gestopft	Past
wallfahrest	Present
befunden	Past
Blumenbinse	None
reihst	Present
angepasst	Past
etablierend	Present
Belgiern	None
angezweifelt	Past
gekurbelt	Past
Hütchen	None
bewertend	Present
Metallgittern	None
weihest	Present
kompostierest	Present
geritten	Past
verträgst	Present
deaktivierend	Present
diffundierst	Present
knabbre	Present
entflohst	Past
dramatisieret	Present
ernannt	Past
aufgebaut	Past
ernennest	Present
bedrohend	Present
Natriumhalogeniden	None
Balte	None
lüget	Present
gehämmert	Past
verschlimmre	Present
würfelst	Present
plantschet	Present
erwirbt	Present
verbrämet	Present
postulierst	Present
genarrt	Past
betreust	Present
vernetzend	Present
mehrest	Present
zersetzest	Present
Sultanat	None
Feiern	None
Alraunen	None
pikierst	Present
Abänderungen	None
geprickelt	Past
bewehrest	Present
frikassierst	Present
knurrest	Present
debütierest	Present
Gemahl	None
Assyrern	None
servierest	Present
applizierst	Present
belügend	Present
Brennstoffen	None
Nadelbäume	None
überzeugst	Present
geklönt	Past
hinterzögest	Past
versammelet	Present
flicket	Present
trommelst	Present
gestritten	Past
erleichternd	Present
gespendet	Past
bezwungen	Past
schluchzend	Present
Elektronen	None
heischet	Present
torpedieret	Present
misstraust	Present
gustieret	Present
vermittelst	Present
reinigest	Present
Underdog	None
Schnauze	None
wurzelet	Present
Sausewindes	None
pressierend	Present
Arsenosaccharide	None
agierst	Present
gesüßt	Past
Abiturs	None
Avatar	None
identifizierest	Present
getrieben	Past
schmälerest	Present
fliehend	Present
unterließet	Past
abziehend	Present
gestützt	Past
beseelend	Present
erfüllst	Present
Argyrodits	None
krachend	Present
leidend	Present
schwörend	Present
verschlacket	Present
boomest	Present
dünkest	Present
vergraulst	Present
Sinneswahrnehmungen	None
gemunkelt	Past
schröpfst	Present
widersprechend	Present
splitterest	Present
verbarrikadierest	Present
geschuppt	Past
muhst	Present
Zeitschlitzes	None
quasselnd	Present
Kielern	None
destabilisieret	Present
Bartenwales	None
verschließest	Present
verabreichend	Present
Hahnenfuß	None
überholend	Present
herhörend	Present
stricket	Present
knautschst	Present
defilierst	Present
umgebracht	Past
verweigeret	Present
Zyklopen	None
Arzneistoff	None
immunisieret	Present
Fischotter	None
Hauptsatz	None
ausdenkend	Present
abgewogen	Past
Inspirationen	None
Hartmetall	None
gepinkelt	Past
gelangweilt	Past
abgearbeitet	Past
adelst	Present
verspielst	Present
Entree	None
Devisen	None
Brücke	None
knitteret	Present
numerieret	Present
gefröret	Past
Habitus	None
ertrankt	Past
loset	Present
Dieben	None
verwüstend	Present
entsinnst	Present
Topfens	None
muhend	Present
Pfiff	None
Gesims	None
kriechest	Present
erscheinet	Present
empfiehlst	Present
tratschest	Present
Garderoben	None
gequetscht	Past
geballt	Past
Horte	None
schlabberest	Present
mitgebracht	Past
erläutre	Present
Riesenwildschaf	None
umgibt	Present
offenbarst	Present
tastend	Present
Akademikers	None
bemühst	Present
Pottwalen	None
wedelet	Present
heylst	Present
auftretend	Present
Wahlmännern	None
Vieleck	None
sicherest	Present
Handelsformen	None
Umzingelung	None
Duette	None
erstechet	Present
beglichst	Past
Infektion	None
penetrieret	Present
pexierend	Present
Versuches	None
krabbelnd	Present
attestieret	Present
antund	Present
turnend	Present
zurückkommend	Present
gekippt	Past
klingelest	Present
Irrtum	None
gesenkt	Past
baggre	Present
ausgestrahlt	Past
Allgemeinbefinden	None
schluderest	Present
unterzeichnend	Present
widerstandest	Past
Todsünde	None
strullerst	Present
Anglikanerinnen	None
hüllend	Present
kalibrierest	Present
Sexten	None
nanntest	Past
verwickelnd	Present
Spielplätzen	None
verchromst	Present
beamest	Present
entkeimst	Present
Kanoniers	None
Erzlager	None
basierend	Present
geschwollen	Past
keimest	Present
Schokoladenkuchen	None
weggefahren	Past
betritt	Present
grinsend	Present
Kunstdünger	None
verwelkst	Present
verärgernd	Present
Kriegsschauplätze	None
hydrolysieret	Present
hyperventilierest	Present
strapazierend	Present
Balkonen	None
abgespeckt	Past
trällerst	Present
kurble	Present
dienest	Present
zerrend	Present
hyperventilierend	Present
schwankst	Present
Gedrängen	None
fladernd	Present
korrigierend	Present
improvisierest	Present
döset	Present
regenerierest	Present
emendierend	Present
Gefäßwände	None
Stiere	None
krepierend	Present
Kieses	None
Übertragung	None
blinkend	Present
entginget	Past
entspannst	Present
gekitzelt	Past
gesponnen	Past
Viertels	None
erschlössest	Past
gestibitzt	Past
angeschlossen	Past
Gouverneurs	None
Freizeitzentrums	None
schreitend	Present
umgelegt	Past
gespiegelt	Past
Wassermelone	None
Haarsprays	None
rückend	Present
schnabulierst	Present
verminderst	Present
entschädigst	Present
Sprachregelung	None
gelaufen	Past
klonst	Present
Mobilisierungen	None
beschäftigend	Present
gelautet	Past
Florette	None
Kryostaten	None
Piercingschmucke	None
versorgend	Present
grubst	Past
heueret	Present
eingezogen	Past
durchgesetzt	Past
schockierend	Present
eliminierest	Present
läuft	Present
nagelet	Present
Selane	None
mißbrauchst	Present
erläuternd	Present
schärfend	Present
Königskerze	None
realisierest	Present
misstrauet	Present
bekriegend	Present
vereinst	Present
schiffst	Present
ebbst	Present
Abdruckes	None
geglost	Past
flicht	Present
Potsdamer	None
idealisierest	Present
aktivierst	Present
Ilmeniten	None
gespürt	Past
entsprechend	Present
werweissend	Present
Meldungen	None
prokrastinierest	Present
deponierst	Present
ringelest	Present
Bewusstlosigkeiten	None
sächsle	Present
sträubst	Present
brühst	Present
übernommen	Past
Kabeljaus	None
konvertierend	Present
Tierversuche	None
folternd	Present
abgeblitzt	Past
Aa gemacht	Past
Kost	None
rödelet	Present
Sicherheitsventil	None
Fahrplänen	None
ramifizierest	Present
Krämers	None
dienend	Present
evangelisierend	Present
Gebieten	None
Stoffwechselprodukten	None
verfügest	Present
eingetragen	Past
Schaufensterscheibe	None
Internetanschlüssen	None
geschottert	Past
vertuschet	Present
erbst	Present
Bremskräften	None
Schwenkbügel	None
schmunzelnd	Present
geschändet	Past
pasteurisierst	Present
Offenbarung	None
erdrosselst	Present
trommelest	Present
aufschließen	None
entwässernd	Present
Bundesaußenministers	None
desoxidierst	Present
gedünstet	Past
Embargo	None
formatierst	Present
gegurrt	Past
verneinet	Present
darfst	Present
Tellurid	None
bereuet	Present
buhend	Present
industrialisierest	Present
erfreust	Present
Hamstern	None
fluchend	Present
verladest	Present
umschmelzt	Present
managend	Present
erschufst	Past
knetend	Present
stärkend	Present
geschmeichelt	Past
aufgelöst	Past
dechiffrieret	Present
hicksest	Present
ankerest	Present
coventrisierest	Present
gepupst	Past
Hirnschale	None
schärfst	Present
Hexadezimalzahl	None
fotografieret	Present
veräußeret	Present
indizierest	Present
komponieret	Present
improvisierend	Present
entmineralisierest	Present
dolmetschest	Present
wellend	Present
ablehnend	Present
behilft	Present
Turmfalke	None
Segelflugzeuges	None
geglupscht	Past
stempelet	Present
spannest	Present
vertrauet	Present
lackierst	Present
chloroformierend	Present
hinterziehest	Present
konjugierest	Present
frittierst	Present
vergrabend	Present
Zivilisten	None
verschmelzend	Present
hopple	Present
reflektieret	Present
Scharlach	None
Ahlen	None
nagst	Present
stapelst	Present
antichambrieret	Present
Fohlens	None
mindernd	Present
bereinigend	Present
flutschest	Present
bezauberest	Present
erlebst	Present
bevölkre	Present
putzet	Present
meßt	Present
demotivierst	Present
einführend	Present
trabet	Present
Dezernaten	None
Alterität	None
Abrieb	None
Reh	None
reißend	Present
wechselwirkend	Present
verschließend	Present
gepfiffen	Past
kanalisierend	Present
lenkend	Present
kompilierst	Present
tun	None
gönnet	Present
isolierest	Present
kürzest	Present
Assistentinnen	None
Spätsommern	None
eröffnend	Present
erworben	Past
ausnutzend	Present
verarmest	Present
Mandate	None
lancierst	Present
pürierest	Present
entleerend	Present
Abschnitte	None
Kanonenkugeln	None
Klassenzimmers	None
klärst	Present
verschlechterest	Present
Buckeln	None
Drängen	None
marternd	Present
geebnet	Past
ausgerichtet	Past
legierst	Present
versicherest	Present
motivierend	Present
speisest	Present
unterschlügest	Past
Immigrant	None
getrocknet	Past
verdunkle	Present
sintre	Present
siezet	Present
erneuernd	Present
kristallisieret	Present
Campingplatz	None
erklungen	Past
umgewandelt	Past
babbelst	Present
schmauset	Present
transportierest	Present
zwitschernd	Present
Segelboot	None
Wirkstoffen	None
Scheibenbremse	None
Hundshaie	None
geduscht	Past
stierend	Present
grassierst	Present
Mehrfachvererbung	None
ausgeschieden	Past
imkerst	Present
Kapelle	None
enternd	Present
preisend	Present
Spiegeleis	None
geängstigt	Past
flanierst	Present
ergießet	Present
lutschest	Present
gejobbt	Past
Gemüsehändler	None
Magnolien	None
quellest	Present
sparet	Present
beschissest	Past
irreführend	Present
pumpend	Present
saunierend	Present
abgeschafft	Past
Sinn machend	Present
vergräbt	Present
Bratapfel	None
ermöglichend	Present
knabberet	Present
abgelehnt	Past
zermatschend	Present
mischst	Present
frustrierst	Present
domestizierend	Present
sabbelest	Present
bewohnend	Present
beklagst	Present
knipsest	Present
foppest	Present
Empfangsherr	None
muffest	Present
geherrscht	Past
pichelst	Present
Kursaal	None
Cineast	None
peiniget	Present
dreschest	Present
weißest	Present
Figuren	None
Spezialstahl	None
schlisset	Past
verfügst	Present
Arzneimittelgesetze	None
angekratzt	Past
Alm	None
degustierst	Present
veranlassst	Present
geplatzt	Past
Lauchmotten	None
vertriebt	Past
Nachtigallenbodens	None
Aasfressern	None
Ausländerin	None
getropft	Past
Boratomes	None
erstandest	Past
säumend	Present
verzaubre	Present
schimmre	Present
regst	Present
folget	Present
entnehmend	Present
Überblick	None
Wiederkäuer	None
bezichtigst	Present
summierest	Present
beschlagnahmet	Present
Mailänder	None
verscheuchest	Present
vermengend	Present
Kontrollstäbe	None
dehnet	Present
verhungerest	Present
gezockt	Past
Angesicht	None
extemporierend	Present
eingestellt	Past
eingesetzt	Past
Gültigkeitsbereich	None
leimend	Present
heruntergekommen	Past
folgend	Present
entworfen	Past
Bauindustrie	None
Bescheide	None
verkriechest	Present
Eintritten	None
ackerst	Present
grabet	Present
empör	None
zauberest	Present
zusammenfassend	Present
Blutvergiftung	None
frühstückest	Present
Defekt	None
Schmieröle	None
stinkest	Present
behält	Present
hereinkommend	Present
mahnend	Present
tippest	Present
entführest	Present
bepisset	Present
bedruckst	Present
planschend	Present
Jargon	None
blaffend	Present
Fundstücke	None
staunst	Present
amenagieret	Present
Belieben	None
missachtend	Present
Enzians	None
Lektüren	None
fasest	Present
komprimieret	Present
vermögend	Present
Wimmelbilderbuch	None
verzweigend	Present
App	None
gemangelt	Past
reif	None
herrschet	Present
Premierministerinnen	None
kandierend	Present
Alleingänge	None
lehret	Present
Lichtgeschwindigkeit	None
Affenbrotbäume	None
knutschest	Present
Azubis	None
übereilend	Present
probst	Present
Eisenspats	None
galoppieret	Present
schwenkend	Present
Einverständnisse	None
Salamandern	None
grillest	Present
robbst	Present
Riesenkalmar	None
sinkend	Present
krakelest	Present
geredet	Past
Rippe	None
Rebellen	None
erörterst	Present
rezitierst	Present
Zahltages	None
entschärfet	Present
gerawbt	Past
furzend	Present
leimst	Present
Meeressedimente	None
hinterleget	Present
camouflieret	Present
Genickschuss	None
Schergen	None
duftend	Present
entgehest	Present
verübend	Present
zugeordnet	Past
maure	Present
gewundert	Past
krachest	Present
gestartet	Past
gemuht	Past
Christstollen	None
billigend	Present
erstandet	Past
Ampel	None
Runzel	None
gefolgt	Past
Glaubens	None
akzeptierst	Present
tauchest	Present
Klarinetten	None
zapfet	Present
finanzierend	Present
geflirrt	Past
Trinker	None
geschmälert	Past
preisgebend	Present
erstächest	Past
bequembend	Present
diktierst	Present
geölt	Past
bequemst	Present
Molybdophosphate	None
Parisers	None
klärest	Present
debütierend	Present
Anteiles	None
zerrüttend	Present
bestiegst	Past
Isomatten	None
Volumenprozent	None
pichle	Present
heilend	Present
segle	Present
klingelst	Present
ausgebrochen	Past
Bestattungen	None
gekröst	Past
Sündern	None
juckend	Present
Bewerberin	None
fahndend	Present
mißhandelnd	Present
pass	None
verfehlst	Present
leimest	Present
gehievt	Past
Nummernschilder	None
aufsteigend	Present
exmatrikulierst	Present
Gefieders	None
reichend	Present
Hexenkessel	None
Axolotl	None
triebst	Past
Waschnüssen	None
Infrarot	None
konterkarieret	Present
Speeren	None
gespeist	Past
kompensieret	Present
implementierest	Present
katalogisierend	Present
tagträumst	Present
Bromwasserstoff	None
heilet	Present
drohst	Present
Kriminalromans	None
Stoßwelle	None
Trampeltiere	None
Porphyrien	None
flüchtend	Present
gewürgt	Past
geklatscht	Past
hinterlegest	Present
gehandelt	Past
packet	Present
kodierest	Present
verändernd	Present
geschöpft	Past
verbrachst	Past
geschritten	Past
stornierest	Present
gerieben	Past
schwängeret	Present
klemmst	Present
benehmt	Present
Überlebens	None
zusammengezogen	Past
spännet	Past
probierst	Present
thematisierst	Present
verewigest	Present
gestiert	Past
Haastadler	None
verschärfend	Present
Schleifring	None
versprächet	Past
Aware	None
Deckenzapfens	None
neble	Present
penetrierest	Present
Codices	None
unterstrichet	Past
begrubt	Past
verdirbt	Present
sättiget	Present
glättend	Present
gebaggert	Past
geniessend	Present
passet	Present
simulieret	Present
produzierend	Present
Ventil	None
maximierst	Present
besprächest	Past
vertippet	Present
verbeugst	Present
Gauner	None
gestillt	Past
unterbrichst	Present
pflüget	Present
aufgestellt	Past
Baufälle	None
tropfest	Present
offerierest	Present
Medienwissenschaftler	None
prostituieret	Present
Brownies	None
vereinfachend	Present
entschleire	Present
idealisier	None
gezögert	Past
schäumest	Present
Mietverträgen	None
Gerüchen	None
Ankerplätzen	None
gesehnt	Past
Brautgeldern	None
Pfaffen	None
gefischt	Past
veranstaltend	Present
atmend	Present
verlangsamest	Present
geschwärmt	Past
Peitschen	None
zirpend	Present
mobilisierest	Present
würzest	Present
fingt	Past
sagst	Present
impf	None
vertippst	Present
merkest	Present
holst	Present
Besprechungen	None
erteilest	Present
überfischest	Present
plärrest	Present
meckre	Present
fabulierst	Present
geweigert	Past
einbezogen	Past
verstauet	Present
adressierend	Present
Wüstenfuchs	None
besetzend	Present
Demagogen	None
gefaltet	Past
Künstlerin	None
erschiessest	Present
konsumierst	Present
Stammkneipe	None
Parallelogramms	None
graphitierest	Present
verhänget	Present
verursachst	Present
rüffelest	Present
Schmierblättern	None
Ideologe	None
Heckantrieb	None
Pandeismus	None
Pyrolysen	None
bevorzuget	Present
wurzelst	Present
errechnend	Present
triumphierend	Present
neckst	Present
Mikrometern	None
Schlittschuhe	None
einleben	None
egalisierend	Present
Kastanienholzes	None
Pentasulfide	None
nachvollziehend	Present
erlischt	Present
reckend	Present
Mörsers	None
qualifizierend	Present
Schweinhund	None
futterest	Present
stählest	Past
Staatsanleihe	None
Strandbädern	None
brennend	Present
priorisierend	Present
vermischend	Present
beträgst	Present
gebündelt	Past
abgesprochen	Past
Rettungszeichens	None
spiegelnd	Present
kooperierend	Present
schnabulier	None
Noosphäre	None
kniffet	Past
lackieret	Present
zitterest	Present
thuet	Present
jährst	Present
komponierest	Present
dividierst	Present
vermerkend	Present
flenset	Present
knicket	Present
destillierend	Present
nummerieret	Present
hinkst	Present
Sportclub	None
stärket	Present
Büros	None
beschlugt	Past
teerend	Present
aufklärend	Present
Nenners	None
Tapiren	None
rückst	Present
pubertierend	Present
geriffelt	Past
dehnend	Present
verkenntet	Past
bewohnest	Present
versprächest	Past
erzwinget	Present
anstoßend	Present
reizend	Present
reifend	Present
abgebaut	Past
verputzend	Present
entwickelst	Present
koordinieret	Present
Vielecke	None
vergäbet	Past
gurgelnd	Present
schaure	Present
garst	Present
zusammenziehend	Present
Vorstellung	None
enttäuschet	Present
verklärend	Present
handelest	Present
gespreizt	Past
geschnüffelt	Past
Dissertation	None
Passagierschiffen	None
blockierest	Present
Elektroskops	None
elektrisieret	Present
einweihen	None
besteuernd	Present
genascht	Past
Scheitels	None
speicherst	Present
Doppelklick	None
Cermets	None
jubelet	Present
erwähnest	Present
epilierend	Present
pressierest	Present
Cornwalliten	None
entnimmt	Present
anerkennen	None
Weltkrieges	None
Saxofon	None
Tatsachen	None
schadend	Present
säßest	Past
gestickt	Past
gekillt	Past
rollst	Present
Golfspielern	None
verbeißest	Present
Kaufpreis	None
folgernd	Present
getagt	Past
harrend	Present
Dessertlöffel	None
Verhören	None
Pinguine	None
glichet	Past
Beläge	None
Haltepunkt	None
Flexionen	None
Impfkristallen	None
trommle	Present
urgierend	Present
Graumennigvogels	None
verknittre	Present
ersparst	Present
preiset	Present
geprustet	Past
googelst	Present
Grundsätze	None
verjünget	Present
geprügelt	Past
Pheromon	None
infizieret	Present
schotterest	Present
hample	Present
bärstest	Past
flankieret	Present
bedienst	Present
fochtest	Past
erbarmst	Present
gerbet	Present
Filterpapier	None
geliehen	Past
gemogelt	Past
Zweikampf	None
benahmt	Past
schulest	Present
Knalle	None
schauspielerend	Present
ängstiget	Present
buddelest	Present
gegrüßt	Past
begräbt	Present
orgelet	Present
grausest	Present
konzentrierest	Present
veröffentlichst	Present
verkrustend	Present
Psychothrillers	None
Abfalls	None
gesät	Past
datierend	Present
missverständest	Past
flutschend	Present
verwirrend	Present
Leitkegel	None
überschneidend	Present
gedrungen	Past
missverstandest	Past
geschält	Past
glasier	None
Gehilfin	None
Umriss	None
tagträumet	Present
orientierend	Present
entionisierst	Present
Weihern	None
genagt	Past
entwirrst	Present
Eisenarsenids	None
radieret	Present
Aromas	None
hamsteret	Present
Gefäß	None
avisierst	Present
Fastenzeiten	None
verunglimpfst	Present
gewildert	Past
gezwängt	Past
verringerst	Present
browsest	Present
unterschreibest	Present
verknitternd	Present
geregnet	Past
Softwareentwicklerinnen	None
pilgernd	Present
Draufgänger	None
gestandest	Past
scharrest	Present
verkabelet	Present
Rauch	None
bappst	Present
verdrängend	Present
erwirtschaftend	Present
geständet	Past
wucherst	Present
klassifizier	None
erziehend	Present
beschirmend	Present
verflogt	Past
stattgefunden	Past
gelingest	Present
nutzend	Present
gesurrt	Past
pexierst	Present
schnüret	Present
geleistet	Past
fetzst	Present
Scham	None
durchsetzend	Present
kabelest	Present
ummantle	Present
wäscht	Present
Aluminiumblech	None
dissentierest	Present
staust	Present
Sedimentes	None
Energieträgers	None
vibrierst	Present
hehlst	Present
spionierend	Present
kartographierest	Present
krallend	Present
meißelest	Present
Enttarnungen	None
feist	Present
Quantensprüngen	None
folg	None
perforierst	Present
mitgeteilt	Past
translozierst	Present
welkst	Present
Frühsommers	None
widerstehet	Present
entwarnend	Present
gecovert	Past
fischst	Present
wackelst	Present
schulend	Present
dolmetschst	Present
Ekzems	None
verschlisset	Past
inspizierest	Present
geschmolzen	Past
argumentierest	Present
erschießest	Present
genietet	Past
recycle	Present
gestehend	Present
schlügest	Past
gekoppelt	Past
erhitzest	Present
schluckend	Present
ermächtiget	Present
Forschungszentrum	None
pikieret	Present
Einspänners	None
Saaten	None
sprühest	Present
gekommen	Past
ergriffet	Past
marschieret	Present
prostituierst	Present
kontrastieret	Present
veranschlaget	Present
Draufgängers	None
parkend	Present
annullieret	Present
quatschst	Present
ras	None
Gewässern	None
exorzierest	Present
gemerkt	Past
Einhaltes	None
arrangierst	Present
instituierst	Present
absteigend	Present
Lutschtabletten	None
schwankend	Present
kontrollierend	Present
Metaphosphats	None
Kalke	None
zerdepperest	Present
befragst	Present
gezeugt	Past
versprödend	Present
erkundigest	Present
Baldachins	None
panierst	Present
angestoßen	Past
zählst	Present
eingelebt	Past
Aufzeichnung	None
prickelnd	Present
gewerweisst	Past
reibet	Present
entsprecht	Present
Seiteneinganges	None
verbrennst	Present
frustrierest	Present
ausgetrunken	Past
zerfließend	Present
entweichend	Present
immunisierest	Present
zauberst	Present
hinnehmend	Present
beauftragest	Present
etiolierst	Present
schimmelet	Present
kontaminierest	Present
währest	Present
verwelkend	Present
miauest	Present
Dock	None
Hirtenhunde	None
vergältest	Past
Ladern	None
verweset	Present
versauet	Present
bevorzugest	Present
unterworfen	Past
hämmernd	Present
verschriebet	Past
Arsentrioxid	None
Charakters	None
beschimpfend	Present
besieget	Present
geschätzt	Past
empfehlend	Present
Literatur	None
enttäuschend	Present
besprochen	Past
eingeordnet	Past
entließet	Past
Frösche	None
Märchenbuch	None
gepopelt	Past
beeindruckend	Present
köderet	Present
zelebrierend	Present
geliefert	Past
Konsortien	None
versauerest	Present
Violinkonzert	None
nörgelnd	Present
gebebt	Past
soufflierst	Present
saftend	Present
fleuchst	Present
gebimmelt	Past
Meeresströmungen	None
wässre	Present
pendle	Present
ausgedacht	Past
bezichtigend	Present
verminderet	Present
glühst	Present
Nichte	None
verrät	Present
mähet	Present
Paketbombe	None
gespritzt	Past
kröset	Present
Schwellenwerte	None
Seitenfläche	None
Sepiolithe	None
Hochaltar	None
digerieret	Present
geströmt	Past
beschlagest	Present
jodle	Present
wegwerfend	Present
schubsest	Present
Bienen	None
limitierend	Present
statuierst	Present
ausgebaut	Past
erlegen	Past
gewellt	Past
geherzt	Past
gepunktet	Past
Polarlichter	None
Korridors	None
kommet	Present
flattre	Present
ausgemacht	Past
gekeult	Past
widerriefet	Past
engagieret	Present
feget	Present
misstrauend	Present
gewacht	Past
besicherst	Present
dürftet	Past
unterdrückest	Present
versag	None
existieret	Present
krallst	Present
Neodym	None
Promotor	None
Pyroskopen	None
zerbrechest	Present
ersetzet	Present
marinieret	Present
getoastet	Past
Aachenern	None
gehorchst	Present
fügend	Present
mißlungen	Past
rationierst	Present
Gepäckträger	None
Hausschafe	None
schminkend	Present
stärkest	Present
gelockert	Past
gesonnen	Past
brütend	Present
verabscheuend	Present
Geschichtsbuch	None
steiniget	Present
verführst	Present
verleihest	Present
Abstracts	None
kopple	Present
greifet	Present
Wiederhören	None
Farbstoffe	None
angebetet	Past
robbend	Present
flackeret	Present
gesabbelt	Past
benützet	Present
deklarierst	Present
streckest	Present
argumentieret	Present
Revolverheld	None
Endzwecken	None
Gänsesäger	None
abgelebt	Past
gabelest	Present
schnurret	Present
liquidieret	Present
Weißweinen	None
rebellierend	Present
gegenbeschuldigend	Present
Halogenen	None
favorisieret	Present
generalisierend	Present
Puppen	None
Rollenspiele	None
Kautschuke	None
transferierend	Present
entlüdet	Past
Unters	None
Panzerschrecken	None
Olympiaden	None
versunken	Past
Magneteisenerze	None
grölend	Present
begrübest	Past
fället	Present
verfinsterest	Present
entkommend	Present
servierend	Present
reimst	Present
wachst	Present
angestiegen	Past
Flüchtlinge	None
gekräuselt	Past
abgesetzt	Past
leihet	Present
besäßest	Past
gekuckt	Past
charakterisierend	Present
Sittiche	None
gefangen	Past
getappt	Past
motivierst	Present
wählest	Present
gelost	Past
geschmiert	Past
Magier	None
avisieret	Present
replicierest	Present
probest	Present
vermittelet	Present
gestochert	Past
Uterus	None
vereinfachest	Present
zelebrieret	Present
rupfst	Present
promovierend	Present
erfassest	Present
Sprengstoffgürtel	None
getafelt	Past
gequollen	Past
geleuchtet	Past
missbrauchend	Present
Brigade	None
beschönigest	Present
gekiekt	Past
Alken	None
Broccoli	None
versauest	Present
zugegangen	Past
sinnet	Present
Ausgangssubstanzen	None
Steppenfuchs	None
übertrifft	Present
geturnt	Past
haarest	Present
kommest	Present
glawbend	Present
Amethysts	None
vertagest	Present
gilt	Present
verwehrst	Present
evaluierend	Present
Ergüssen	None
ergänzet	Present
gesegelt	Past
zerbracht	Past
Schade	None
Auxiliar	None
entblößend	Present
gestutzt	Past
Spektralbereiche	None
feiet	Present
gejettet	Past
knallst	Present
Witheriten	None
verderbt	Present
aktualisierest	Present
kämpfend	Present
übertrafst	Past
laure	Present
peroxidierend	Present
Ferne	None
hinausragend	Present
räum	None
beantraget	Present
kalkulierst	Present
Klebstoffes	None
verdorben	Past
Gottesbeweis	None
Kaffeeklatsches	None
empfehlt	Present
schanghaist	Present
stimmest	Present
Hausärztinnen	None
geboßt	Past
geknickt	Past
versprachst	Past
sperrst	Present
diskutierend	Present
Untier	None
kloppst	Present
verstorben	Past
beschlugst	Past
puddle	Present
Dickicht	None
versilbernd	Present
Lebensjahre	None
parlierest	Present
kommentierst	Present
Gettos	None
worfelest	Present
Gerätes	None
kuckst	Present
Myriade	None
Neige	None
Triiodid	None
Lokal	None
hehlend	Present
geblitzt	Past
entstandet	Past
artikulieret	Present
Ärzteblatt	None
Buchhändlerinnen	None
angeschaltet	Past
Guru	None
Hodens	None
snöbet	Present
glorifizierst	Present
Irrtümer	None
polieret	Present
amputierest	Present
Pollutionen	None
strafend	Present
zuppet	Present
erfrischst	Present
beliefest	Past
schwänzet	Present
Dampfschiff	None
Scheibenbremsen	None
unterschätzet	Present
Kaskade	None
moppend	Present
geschont	Past
Gleithörnchen	None
Jemeniten	None
Pomologe	None
triebet	Past
zerknitternd	Present
peinigst	Present
ausgeübt	Past
erbend	Present
Fließtexte	None
grab	None
greifest	Present
gekämmt	Past
komplexierend	Present
durchzuckst	Present
lindre	Present
internierest	Present
Sauerstoffanteils	None
gemalmt	Past
exend	Present
abstrahieret	Present
acetylierend	Present
holend	Present
Pfaues	None
koexistierst	Present
fällst	Present
Skutterudits	None
strickest	Present
knipsst	Present
Anhängern	None
Rezeptur	None
meidend	Present
Kanzleramtes	None
weggelegt	Past
überforderest	Present
Erzes	None
zank	None
amüsierend	Present
besonnen	Past
Gehabes	None
chill	None
watschelst	Present
rekonstruierst	Present
flensend	Present
verschlänget	Past
ränget	Past
Streifenschakale	None
gekapselt	Past
stehlet	Present
dekompilierest	Present
Ufers	None
sickeret	Present
schlängelst	Present
grüßet	Present
Weißkopfseeadler	None
ermächtigst	Present
gegeizt	Past
schonest	Present
fotografierst	Present
Milligrammen	None
gefönt	Past
ernährend	Present
beibringen	None
zürnst	Present
rivalisierest	Present
knutschst	Present
plauderest	Present
umzingelst	Present
Nationalspielern	None
gewählt	Past
gewallfahrt	Past
Außenborder	None
einbeziehend	Present
Berylliumerz	None
gegründet	Past
hockend	Present
ausschaltend	Present
schürest	Present
bedienet	Present
eskalierst	Present
Pultes	None
linderst	Present
vergreisend	Present
defenestrierend	Present
kritisierst	Present
Städtepartnerschaft	None
ausgeliefert	Past
bestellst	Present
rummelet	Present
wirfst	Present
beziffernd	Present
Sängerfeste	None
hickset	Present
Christbaumschmuck	None
erschlüget	Past
zuppest	Present
zusammenbrechend	Present
partitionieret	Present
verhülfest	Past
quälend	Present
wässernd	Present
meckernd	Present
geneckt	Past
Nukleotide	None
hantierst	Present
kickest	Present
krepier	None
Allgemeinbefindens	None
entfernst	Present
herabgesetzt	Past
verkabelnd	Present
füget	Present
quatschet	Present
quellet	Present
gebölkt	Past
bewirbst	Present
bohrst	Present
bereitgestellt	Past
Ströme	None
Nachtisch	None
portraitierend	Present
Hetze	None
signalisierst	Present
schwiegst	Past
Waschbecken	None
harmonisierend	Present
Lümmeltüten	None
Schnitzeln	None
gewunden	Past
verborgen	Past
gegönnt	Past
dressierst	Present
gefrühstückt	Past
segmentieret	Present
rasierend	Present
Archäologen	None
Hoden	None
entspringet	Present
verhehlst	Present
bestreuet	Present
befragend	Present
Gesamtgehaltes	None
wärmet	Present
entfesselest	Present
explizieret	Present
gewürdigt	Past
Fladenbrot	None
bratschend	Present
Gewichtsanteil	None
velarisierend	Present
verbrannt	Past
gedoppelt	Past
stapfst	Present
halbierend	Present
Spinner	None
mulchest	Present
Rechtsrucken	None
konzentrieret	Present
umgäbest	Past
zippest	Present
geschwindelt	Past
Bestände	None
Bundesinnenministers	None
wandelet	Present
verallgemeinernd	Present
abstoßend	Present
Erschütterungen	None
humpelet	Present
schubset	Present
Zirkonia	None
gepflügt	Past
kuschelet	Present
mähend	Present
Nilpferdes	None
erliegend	Present
Eies	None
zweifelst	Present
Timings	None
Einwurf	None
verschlüssle	Present
eloxierest	Present
knackest	Present
gedämpft	Past
geadelt	Past
erwecket	Present
übernehmend	Present
Möglichkeiten	None
Roteisensteinen	None
jonglierest	Present
verpfändend	Present
verwirfst	Present
Zwingburg	None
Gesetzesübertretungen	None
vergaltest	Past
schwärst	Present
Defätist	None
geröstet	Past
appliziret	Present
eingetreten	Past
übereinstimmend	Present
Weltmarkt	None
gezwinkert	Past
zierest	Present
zerkratzt	Past
eingebracht	Past
Raketentreibstoffe	None
Exodus	None
angebracht	Past
verseuchst	Present
betätigst	Present
knickest	Present
Gewalttäters	None
zwingend	Present
Kochlöffel	None
gerotzt	Past
marinierst	Present
fängst	Present
Schmelzwärme	None
rinnest	Present
Liedchens	None
verlebet	Present
harmonisieret	Present
geopfert	Past
schleißend	Present
zweifle	Present
Penisknochen	None
alimentieret	Present
bemängelet	Present
fechtend	Present
kiekend	Present
Brechnüsse	None
untermauerest	Present
konzentrierst	Present
zerfaseret	Present
Typus	None
gedeckt	Past
Kohlenstoffgehalten	None
ignorierest	Present
linsend	Present
Pärchens	None
Doge	None
überquerest	Present
Geschäftsbereich	None
betrübest	Present
Abart	None
Vergiftungssymptome	None
virtualisierst	Present
Schweizerinnen	None
elektrisirend	Present
schwadronierend	Present
entschließ	None
imprägnierest	Present
Spaniern	None
gefast	Past
Eingaben	None
Suffixes	None
geharnt	Past
Marokkanern	None
bestrahlest	Present
erhöhest	Present
schlossernd	Present
unterzogst	Past
Hirten	None
imkre	Present
gedenkest	Present
kneif	None
Diversität	None
maueret	Present
bezeugend	Present
vorgekommen	Past
schauspielerst	Present
erstreckst	Present
verdrehst	Present
Trankes	None
gerunzelt	Past
koagulierest	Present
Todesopfers	None
Schwarmes	None
zitierest	Present
pensionierend	Present
galtest	Past
quöllet	Past
befummelest	Present
haschet	Present
ergriffest	Past
hassend	Present
entgehet	Present
nebelst	Present
bahnend	Present
glupschest	Present
steigeret	Present
gemeldet	Past
Hochparterre	None
entwaffnend	Present
Exposés	None
Scherze	None
Gasthäuser	None
mimest	Present
ausbrechend	Present
erkrankend	Present
vorhergesagt	Past
senk	None
begingst	Past
sorgst	Present
sinnend	Present
Heaps	None
amenagier	None
gelyncht	Past
geschnitten	Past
ersparet	Present
Mittelaltermärkten	None
geflüchtet	Past
Fehden	None
staubst	Present
entspricht	Present
geparkt	Past
Aktentasche	None
Gebiet	None
wechselwirkst	Present
aufwertend	Present
fauchet	Present
vulkanisierend	Present
belöget	Past
kapitalisierst	Present
leakst	Present
Erzeuger	None
Rücklage	None
hingenommen	Past
geheftet	Past
spinnst	Present
Schlafsäle	None
Rückseiten	None
entkeimend	Present
Elegie	None
veröffentlichet	Present
Ketten	None
gehegt	Past
Atriumhaus	None
signalisieret	Present
gestreikt	Past
Kunstspringens	None
Einblicken	None
Narzisse	None
verfasset	Present
geschluckt	Past
galvanisierst	Present
gehehlt	Past
verkannt	Past
bekränzend	Present
Kähnen	None
besänftigend	Present
eitre	Present
Gemeinschaft	None
Hirnhautentzündung	None
geduckt	Past
grillst	Present
Finanzamt	None
blondierest	Present
Prenzlauer	None
entdeckest	Present
erforderet	Present
erstreckend	Present
entsprangt	Past
blondierend	Present
blubberest	Present
verlangsamet	Present
Esszimmer	None
desertierend	Present
hüpfend	Present
Dünungen	None
erzwungen	Past
gurrst	Present
gesintert	Past
ausschließend	Present
stecht	Present
dopst	Present
Jochbeine	None
fluktuierest	Present
versüßet	Present
worfelet	Present
eingebaut	Past
unternehmend	Present
Flugplatzes	None
bedürfest	Present
Schweinchen	None
vernickelet	Present
verbesserst	Present
abtragend	Present
verkloppend	Present
zirkulierst	Present
gefodert	Past
Flitzer	None
Zuckerbäckern	None
erlasst	Present
Phantasie	None
geschwenkt	Past
Kristallfeldtheorie	None
betreffend	Present
spöttelnd	Present
Schnittstelle	None
Zweien	None
stopfend	Present
Iota	None
kauernd	Present
pennst	Present
Gernegroßen	None
Feuerwerk	None
platzet	Present
Übersetzer	None
Schauplätzen	None
geschleppt	Past
jagst	Present
erkennet	Present
ballerst	Present
gesäugt	Past
Guacamole	None
gebützt	Past
radikalisierst	Present
wankend	Present
ertragend	Present
rawbest	Present
quadrierend	Present
gehüpft	Past
Briefmarken	None
unterschlägt	Present
dramatisierest	Present
raufst	Present
erkennst	Present
signalisierend	Present
wird	Present
vergangen	Past
verdampfet	Present
Fusselbärte	None
entstammst	Present
Donnervogels	None
begrabschst	Present
verbrennet	Present
überholest	Present
wurdest	Past
gestikulieret	Present
entspringend	Present
Vorwürfen	None
Bilderstürmerei	None
abgehoben	Past
Omega	None
voraussetzend	Present
betrugst	Past
erkundend	Present
Orden	None
schwollt	Past
etikettieret	Present
lieht	Past
schwangt	Past
Saatkrähe	None
veröffentlichend	Present
anschmiegend	Present
bedacht	Past
Telegramm	None
anodisieret	Present
mißverstandest	Past
mampfend	Present
kreißet	Present
Blags	None
pensionierest	Present
studieret	Present
musicierest	Present
Margeriten	None
schmeichelnd	Present
erwischend	Present
krallet	Present
Elektrofahrzeugen	None
Vorschlägen	None
bescheißest	Present
versicherst	Present
vertrittst	Present
kristallisierst	Present
schlicht	Past
murmelest	Present
avancierst	Present
gefühlt	Past
Briefwechsel	None
fälschend	Present
Kunstmalers	None
stöhnst	Present
ummantelet	Present
marodierend	Present
gewickelt	Past
formatieret	Present
Fass	None
Prügel	None
verarbeitend	Present
abgestoßen	Past
ausgewertet	Past
desoxidierest	Present
quietsch	None
Kristallit	None
dimerisieret	Present
diskutierst	Present
profitierst	Present
apportierend	Present
pflück	None
sagend	Present
barstest	Past
fühlet	Present
meißle	Present
gebröckelt	Past
bestrebst	Present
ebbet	Present
gemüffelt	Past
gesprenkelt	Past
betrugt	Past
gaffet	Present
genannt	Past
erzwingest	Present
gemehrt	Past
Gleitlagern	None
Mugel	None
Betttücher	None
aufgebracht	Past
forcierest	Present
misslingst	Present
Abonnenten	None
Pyrophosphat	None
konkurrierst	Present
Kapo	None
konfrontieret	Present
schiebend	Present
Kakaos	None
gerätselt	Past
gelehrt	Past
verstrahlst	Present
abrundend	Present
fiepst	Present
Wadenbeinen	None
brünieret	Present
aufgenommen	Past
überdenkst	Present
sabbre	Present
geschwungen	Past
schaust	Present
designierend	Present
verweiset	Present
hechelet	Present
nachgelassen	Past
sozialisierend	Present
Dosierungen	None
protestieret	Present
beheiz	None
Sodomie	None
mäkle	Present
abgesondert	Past
Fluoride	None
bejahst	Present
treibst	Present
Rächern	None
unternimm	None
fauchest	Present
entkörperlichet	Present
Tischchen	None
Mangelsymptom	None
Monokel	None
bestehlet	Present
Termine	None
Aufsätzen	None
Handtücher	None
umfassend	Present
entsprangst	Past
filzend	Present
prahlet	Present
geleimt	Past
Pelzmäntel	None
abgebend	Present
entsprochen	Past
kribbelst	Present
bestochen	Past
Gänselebern	None
verlebest	Present
Abenden	None
Gleichgewichte	None
unterbrechend	Present
verzettelnd	Present
geduzt	Past
Nieren	None
folterst	Present
verwirklichst	Present
Weizenfeld	None
ängstigend	Present
räumest	Present
gewandelt	Past
bieret	Present
Feuchtigkeit	None
heckend	Present
erstarrst	Present
Wahlrechten	None
raffinierst	Present
verbleiet	Present
versankst	Past
büffelnd	Present
verscheissre	Present
Krumen	None
verfliegst	Present
zielend	Present
Nitraten	None
Aktivisten	None
entmineralisieret	Present
beachtend	Present
Erkern	None
übergebend	Present
verwertend	Present
pilgeret	Present
behandelet	Present
hetzet	Present
Anlauf	None
erschlugt	Past
verjüngend	Present
kommend	Present
Rabenväter	None
widerrieft	Past
trampelest	Present
gewarnt	Past
Schöpfung	None
Finanzmarkt	None
rivalisieret	Present
Dickköpfe	None
belächelest	Present
wringst	Present
Satire	None
promovieret	Present
gewurzelt	Past
versterbend	Present
entvölkeret	Present
schnabulierend	Present
geändert	Past
pumpst	Present
Bundesinnenminister	None
unterfordernd	Present
startend	Present
verwitterest	Present
traumatisierend	Present
zentrierest	Present
einziehend	Present
ehrend	Present
getrommelt	Past
erschießet	Present
bezaubernd	Present
verliehest	Past
zensurieret	Present
schnabulierest	Present
Farbtöne	None
beabsichtigend	Present
beglückwünschest	Present
schielet	Present
strahlend	Present
beschäftigst	Present
genuschelt	Past
Schneekanonen	None
beteuerest	Present
vermissest	Present
gewurstelt	Past
Anspielung	None
stagnierst	Present
umarmend	Present
Autobussen	None
Hain	None
gestraft	Past
schnorchelet	Present
wertend	Present
Bestandteilen	None
Thailänder	None
angetrieben	Past
posierst	Present
autorisierend	Present
überraschest	Present
erweiteret	Present
liebäugelet	Present
zirkulierend	Present
genährt	Past
Finanzministerium	None
schlürfend	Present
verhalfst	Past
erstaunet	Present
erleichtre	Present
mangle	Present
Solitons	None
regierend	Present
stippest	Present
gräbt	Present
geschielt	Past
ausführend	Present
finanzierst	Present
aufgesucht	Past
Fräulein	None
Kleberand	None
Mahnwachen	None
Graphite	None
frappier	None
bellend	Present
gekuschelt	Past
wüschest	Past
Streife	None
schraffierend	Present
gravierst	Present
annektierst	Present
Bündnis	None
Reaktionswärme	None
karikierend	Present
geschaukelt	Past
sabbelst	Present
beschirmst	Present
dealest	Present
vergleichend	Present
hüpfst	Present
Nachtlicht	None
Jein	None
gegafft	Past
verbüßend	Present
Küsten	None
Hinterköpfen	None
einordnend	Present
Garnele	None
schimmelnd	Present
bappest	Present
Omikron	None
angebunden	Past
galvanisieret	Present
unterbrecht	Present
eloxieret	Present
Sekretärin	None
abgestellt	Past
schnurrst	Present
sannt	Past
wischst	Present
rangieret	Present
tranchierend	Present
gescheucht	Past
Beteiligungen	None
teilst	Present
versiehst	Present
Adenosin	None
geschmort	Past
kläffend	Present
Kracke	None
brandschatzend	Present
Auslassungszeichen	None
Palimpsest	None
Genüsse	None
sublimieret	Present
Vorkoster	None
übergibt	Present
Divises	None
verbrenntet	Past
rudernd	Present
versagst	Present
gestaut	Past
designieret	Present
schummelet	Present
flitzet	Present
Bahndrehimpuls	None
Klauseln	None
unterschreibet	Present
Käuze	None
Schlachtschiffen	None
Geschäftsjahres	None
klirrend	Present
vertrügest	Past
umarmet	Present
Birnbäume	None
gesegnet	Past
klaffet	Present
Neutronenbomben	None
wränget	Past
packst	Present
atomisierst	Present
Grenzlandes	None
eingegangen	Past
beherrschst	Present
geräuchert	Past
interessierst	Present
getrauert	Past
kaschierend	Present
verzweifle	Present
hinterlasst	Present
Kardinäle	None
Härchen	None
Steinsalzen	None
markierst	Present
erbrachtet	Past
entgangen	Past
entrümpelst	Present
Treibers	None
gerettet	Past
rallest	Present
vertraget	Present
reüssierest	Present
verwerfest	Present
ermächtigest	Present
befolgest	Present
unterbrochen	Past
nörgelet	Present
Arbeitstisches	None
initiieret	Present
Beidenhänder	None
geschnappt	Past
donneret	Present
lauschend	Present
vertiefend	Present
Strontiumisotops	None
brüskierest	Present
konfiszierest	Present
korrumpierest	Present
verschleuderet	Present
zupfest	Present
verschmelzt	Present
zerstörst	Present
schmäleret	Present
gekollert	Past
quetschest	Present
applizirest	Present
atomisieret	Present
gequatscht	Past
Geschwindigkeiten	None
hungernd	Present
Bewerbungsgespräche	None
Klappertopf	None
zuckerest	Present
misslungen	Past
sattelst	Present
tröstend	Present
tadle	Present
ausliefernd	Present
gequietscht	Past
warn	None
assimilierest	Present
Trappen	None
bappend	Present
salzest	Present
Stellvertreter	None
grübet	Past
zeugend	Present
beläuft	Present
verästelet	Present
Kuppe	None
Plätzchens	None
entlehnend	Present
zappst	Present
romantisier	None
entfloht	Past
einleitend	Present
Hinrichtung	None
Smaragde	None
zockest	Present
angle	Present
ahnst	Present
feiend	Present
Ausmaßes	None
Interessent	None
Sauerstoffanteile	None
erständet	Past
wegnehmen	None
Schatz	None
Einfangquerschnitten	None
berücksichtiget	Present
kurbelst	Present
arrangierest	Present
gable	Present
schlürfst	Present
analysierend	Present
absorbierend	Present
Hallenbädern	None
extemporieret	Present
reduzierend	Present
erstaunend	Present
risset	Past
schacheret	Present
indoktrinieret	Present
Pertechnetate	None
streifst	Present
betreibst	Present
Germans	None
entfliehet	Present
Patronen	None
überweiset	Present
perfektionierst	Present
Flusses	None
ankerst	Present
Nerzen	None
onanierend	Present
klüngelst	Present
karret	Present
gerast	Past
überdächtest	Past
entschlüsselet	Present
konfiszierend	Present
steinigst	Present
beeinflusset	Present
nummerierest	Present
kollidierest	Present
Delphins	None
Liedchen	None
eintretend	Present
gesessen	Past
versprochen	Past
ernährst	Present
Metallspiegels	None
Protoneneinfanges	None
belästiget	Present
Taucherglocke	None
dechiffrierst	Present
geaalt	Past
vermögest	Present
putzest	Present
Kleckses	None
Grundstoffes	None
Pole	None
Zensus	None
Schwanes	None
Durcheinanders	None
prägend	Present
quietschst	Present
steigernd	Present
vermöchtet	Past
Obszönitäten	None
verbrauchst	Present
vernimmst	Present
Remise	None
Besatzungsarmee	None
Benutzerkontos	None
Oxoniume	None
gerundet	Past
Felle	None
Szintillationszählern	None
sanktionierst	Present
schirmend	Present
kanalisierest	Present
spekulierst	Present
Kanzlei	None
beschriftend	Present
Pulte	None
wandle	Present
zustimmend	Present
verwaiset	Present
abholend	Present
abgewichen	Past
Fotografin	None
golfest	Present
klammerst	Present
Kirchenbänken	None
Hirt	None
liquidierest	Present
Akzenten	None
stocherst	Present
wiederbelebt	Past
Tablett	None
gefügt	Past
wimmelest	Present
projizierend	Present
geklettert	Past
Einwohners	None
drischt	Present
haderst	Present
erstickend	Present
Dienstagmittag	None
Warzenschwein	None
giltst	Present
Hexacarbonyle	None
sexelnd	Present
Vorstandssprecher	None
anerkennend	Present
rülpset	Present
Küchenmöbeln	None
schiesset	Present
umlegend	Present
Oktacyanomolybdate	None
erregst	Present
verhüllet	Present
Schnarchrallen	None
Rückständen	None
unterstützet	Present
Banketten	None
klassifizieret	Present
schälest	Present
verzögerest	Present
Smoking	None
verkriechend	Present
zerdeppernd	Present
erholst	Present
übergäbest	Past
lärmend	Present
beklagend	Present
erinnernd	Present
gesättigt	Past
dümpelst	Present
aufschließend	Present
putzend	Present
Beiwörter	None
Fressen	None
Blutfarbstoffe	None
Alkin	None
Metzgerei	None
Überlegungen	None
Bollwerken	None
geantwortet	Past
verärgre	Present
verweigerst	Present
Diploms	None
entwürfest	Past
tuschelest	Present
Rippen	None
gerappt	Past
Hausaufgabe	None
Wutbürgers	None
flochtet	Past
schmölzet	Past
Britin	None
erfüllest	Present
verschüttend	Present
schöbet	Past
zerfetzet	Present
veränderest	Present
steigre	Present
homogenisierend	Present
korrigieret	Present
geschlachtet	Past
weigeret	Present
Anzug	None
replizieret	Present
Kerngehäuse	None
liefre	Present
Einführung	None
Ammoniakaten	None
erstichst	Present
verdrängst	Present
gekritzelt	Past
sedierst	Present
Inhaltsverzeichnisses	None
Meeresschwammes	None
nachgeschlagen	Past
vernickelest	Present
freuet	Present
dublieret	Present
verfliegest	Present
integrierest	Present
beherrschend	Present
Zinkionen	None
stickst	Present
entdeckend	Present
picknickst	Present
geschärft	Past
dunkelest	Present
drossle	Present
bezwinget	Present
prokrastinieret	Present
erblasset	Present
gewrungen	Past
Absatzes	None
grübelnd	Present
egalisierst	Present
gespannt	Past
entlädt	Present
Armenierin	None
kontrollieret	Present
Faible	None
wagest	Present
nachsagen	None
sedieret	Present
Natur	None
absetzend	Present
servieret	Present
abwartend	Present
platzest	Present
Abfertigungen	None
angestanden	Past
hemmest	Present
Buchweizens	None
zurückweisend	Present
knautschet	Present
krähend	Present
Gulaschkanone	None
geglichen	Past
diktierest	Present
klimatisierend	Present
gehörend	Present
radierst	Present
erließest	Past
erschließest	Present
Wutanfall	None
dunkle	Present
verdauet	Present
geschlichtet	Past
fanatisieret	Present
sinnst	Present
Biestern	None
geschürt	Past
Katalysators	None
Wanderfalke	None
Nachtrag	None
verblutend	Present
schnaufest	Present
getilgt	Past
Leberkäse	None
Amazonien-Tropfenameisenwürger	None
Hautkrebs	None
pochierst	Present
getestet	Past
geformt	Past
Piratenschiffe	None
Immunsuppressiva	None
Teleskops	None
konfigurieret	Present
entsetzest	Present
koexistierest	Present
Bestreben	None
Gerichtshof	None
Fluorohydrids	None
Hautentzündung	None
Schlafmittels	None
Trauerameisenwürgern	None
gestrandet	Past
verzögernd	Present
geschleimt	Past
adoptierest	Present
erfunden	Past
folgerst	Present
edieret	Present
Polypropylenen	None
goutierst	Present
grabble	Present
Prachtstraße	None
recherchier	None
repräsentierst	Present
erweiterst	Present
analysieret	Present
interagierst	Present
schlafwandelet	Present
Auswirkung	None
Scheibchen	None
scannend	Present
Essener	None
wilderet	Present
melierend	Present
gelötet	Past
Fallschirmspringers	None
Dozent	None
ertränkest	Past
respektierest	Present
schikanierest	Present
angelegt	Past
irregeführt	Past
pfleg	None
Heiermannes	None
kachelst	Present
angewiesen	Past
geflossen	Past
dringst	Present
fräsest	Present
Kapellmeisters	None
Verbindungselementen	None
Hackern	None
Schwächen	None
eingefallen	Past
erstechest	Present
frohlockest	Present
glänzet	Present
erfüllend	Present
steuerest	Present
verschworst	Past
Zecher	None
Lägern	None
abholen	None
streichst	Present
tüftelst	Present
bekanntest	Past
bestehst	Present
bezichtigest	Present
versuchst	Present
Phosphormolybdat	None
Gebärfreudigkeit	None
Krähenfraße	None
gekracht	Past
Pigment	None
geschnurrt	Past
gepoppt	Past
Vierteljahrhunderten	None
dringet	Present
geeitert	Past
gelernt	Past
Japanerin	None
demokratisierend	Present
summend	Present
Biber	None
schwänzelst	Present
verteilest	Present
geruckelt	Past
rotzest	Present
masturbierend	Present
geschwächt	Past
widersprechet	Present
Dimer	None
bremset	Present
flanieret	Present
Farbpigmenten	None
Speaker	None
bastelnd	Present
gecheckt	Past
killst	Present
Kabinett	None
Arsentribromids	None
verteidigest	Present
wehrend	Present
variierend	Present
verrühr	None
Briefträger	None
modellierest	Present
abgelöst	Past
alternd	Present
informierest	Present
Sanatoriums	None
Frische	None
ausgewandert	Past
Stickstoffatome	None
Standpunkte	None
knüpfet	Present
Molybdänmangeln	None
Albatros	None
Brutkästen	None
Dünnhäutigkeit	None
verlanget	Present
Sekretariates	None
gestolpert	Past
seihst	Present
abgeschieden	Past
rallet	Present
beschlagend	Present
weidend	Present
zögre	Present
überlebst	Present
abbremsend	Present
verscheisserst	Present
knautschest	Present
schwollst	Past
nennst	Present
gewütet	Past
formierend	Present
entfärbend	Present
Internierungslagers	None
Faustfeuerwaffe	None
vergleichest	Present
kolorieret	Present
Vergabe	None
geräumt	Past
Fladen	None
witternd	Present
zeichnend	Present
Salzwasser	None
gewittre	Present
plündernd	Present
quantisieret	Present
grüßest	Present
Flippern	None
surfst	Present
verwässerest	Present
Begonien	None
benimmt	Present
einschätzend	Present
gemixt	Past
Schiefer	None
gestampft	Past
likst	Present
Knackarsches	None
vermittelnd	Present
verschweiget	Present
versorg	None
ratifizieret	Present
versammelst	Present
getöpfert	Past
Mensch	None
fingieret	Present
ackeret	Present
entlehnest	Present
finanzieret	Present
rangst	Past
angezündet	Past
entmutiget	Present
konvergierest	Present
Beschützers	None
Hundeführers	None
Beistand	None
gejodelt	Past
rollend	Present
Rasthof	None
Fluorsalz	None
Pointen	None
spähet	Present
abspritzend	Present
ausgemustert	Past
Fasern	None
schwenkest	Present
frottierst	Present
Staatspräsidenten	None
gewahrt	Past
überwiesest	Past
Sägezahn	None
ionisieret	Present
abgeschlossen	Past
Goldmünze	None
filtre	Present
funkle	Present
schauest	Present
geifre	Present
Horn	None
kündigst	Present
maskierst	Present
differenzierend	Present
gebrowst	Past
Förden	None
translozierest	Present
Anschauung	None
gebrauchend	Present
extrudierst	Present
hinterlassend	Present
kritzle	Present
Käfige	None
abgetragen	Past
pflügest	Present
Radiergummi	None
renntest	Past
mahlend	Present
Flippers	None
flankierst	Present
eingeführt	Past
listend	Present
stahlst	Past
Jasminen	None
Knochen	None
ernanntet	Past
verblassest	Present
Kokospalme	None
priorisieret	Present
observierest	Present
probierend	Present
gebettelt	Past
Fallrohr	None
Likör	None
anodisierend	Present
zerkleinre	Present
balleret	Present
Ketzerei	None
gelächelt	Past
Flüssigkristalle	None
kokettierend	Present
Kutschen	None
beleidigst	Present
sortierest	Present
jonglierend	Present
Angleichungen	None
Leierschwanzes	None
konstruierst	Present
Fremdwährungen	None
verbarrikadierst	Present
verseifend	Present
türmest	Present
verkrocht	Past
prügle	Present
Koronen	None
Fruchtsaft	None
schassend	Present
klingelet	Present
grabend	Present
implizierest	Present
kompilierend	Present
stankt	Past
vertonet	Present
gebummelt	Past
Nachtmahl	None
Ganter	None
Mähnenhundes	None
liierest	Present
vergrübet	Past
Ejakulaten	None
verübst	Present
Erfrischung	None
Spießern	None
kapitulier	None
gebrüht	Past
bremsest	Present
Anreise	None
halbieret	Present
unterstützest	Present
unterhält	Present
verschweigst	Present
humpelest	Present
würfelest	Present
Rituale	None
definierend	Present
schmücket	Present
Klops	None
lähmest	Present
dreschet	Present
Uchte	None
fluppend	Present
Überschätzung	None
Dochten	None
Clownfisch	None
Speerwerferin	None
kollationieret	Present
abgewartet	Past
Nachtigall	None
anschalten	None
gefiltert	Past
widersprochen	Past
Axioms	None
zwingst	Present
interviewest	Present
changierest	Present
Hartloten	None
kommentierest	Present
Pence	None
verschonst	Present
verdinglichest	Present
wirft	Present
Trostpreis	None
Archäologinnen	None
schleichet	Present
geerbt	Past
Neuwahlen	None
verbrennend	Present
Ellipsoiden	None
gemeistert	Past
Mischung	None
verlangend	Present
drillend	Present
inspizierst	Present
reformier	None
mopset	Present
bekreuziget	Present
mumifizieret	Present
versklavest	Present
klüngle	Present
Hydroxidion	None
justierst	Present
ausstreckend	Present
gebilligt	Past
Hummer	None
bevölkernd	Present
verletzend	Present
Freiinnen	None
getröpfelt	Past
grübelst	Present
abgeholt	Past
missbrauchst	Present
verbeugend	Present
solidarisierst	Present
coventrierend	Present
ausgetreten	Past
bewerkstelliget	Present
vermachend	Present
versichernd	Present
Sternbildes	None
garnieret	Present
Schimmer	None
enttäuschst	Present
verbergend	Present
beherrschet	Present
frappierest	Present
Gyroskopen	None
schauerest	Present
probierest	Present
gepflanzt	Past
übergebet	Present
adelet	Present
auftauchend	Present
beruhigest	Present
Tigerhai	None
betriebt	Past
schießend	Present
Präsidentenwahl	None
Einfamilienhäusern	None
Bibeln	None
Arbeitsbereichen	None
säubernd	Present
kämpfst	Present
gewärmt	Past
Defizite	None
nachgesagt	Past
verjährest	Present
hinzugefügt	Past
wettend	Present
ertrunken	Past
schlägst	Present
ergötz	Past
klaffend	Present
Autoverkehrs	None
Veilchen	None
frottier	None
Untersuchungsausschüssen	None
eingeschlafen	Past
beheizend	Present
ionisierend	Present
lastend	Present
verbarrikadieret	Present
Anfluges	None
Sammelbegriffe	None
drapierend	Present
divergierst	Present
karikierst	Present
Stocherkahn	None
checkend	Present
erwachend	Present
narrst	Present
Körpergeruch	None
regulierend	Present
Schöße	None
wachend	Present
heischest	Present
behandelst	Present
erkundigst	Present
Borkenkäfers	None
gemimt	Past
anpassend	Present
Wildgänsen	None
gedolmetscht	Past
Hauptwörtern	None
häkle	Present
instanziieret	Present
frohlocket	Present
Gönnens	None
erbarm	None
Binnenmajuskeln	None
borgst	Present
geschleudert	Past
verlangst	Present
oktroyierend	Present
naschst	Present
reanimieret	Present
schwinget	Present
Verfehlung	None
knüpfest	Present
gedient	Past
sicherst	Present
Porträts	None
instituierest	Present
gegrinst	Past
beschießest	Present
Feministen	None
greinst	Present
geschifft	Past
Impulsen	None
bumsest	Present
gelöst	Past
orchestrierest	Present
belächle	Present
Phi	None
verwunderst	Present
stillet	Present
Pigmenten	None
dotieret	Present
konnotierst	Present
gehökert	Past
nippet	Present
mißlingest	Present
moppet	Present
verständigest	Present
koproduzieret	Present
plädierend	Present
Abflug	None
greifend	Present
schüret	Present
Wohnorten	None
erwischst	Present
rasend	Present
ondulieret	Present
Schrifft	None
angerichtet	Past
muffet	Present
gepilgert	Past
sedimentierest	Present
Ylid	None
Isoliermatten	None
verärgerest	Present
gestikulierend	Present
Iodiden	None
schauet	Present
gedrängt	Past
quillt	Present
Coulombs	None
mumifizierst	Present
Bildpunkten	None
währst	Present
altre	Present
wirkend	Present
laberst	Present
gelastet	Past
Vesper	None
wahret	Present
mildernd	Present
demobilisieret	Present
Roboters	None
Angriffen	None
frickelest	Present
kalibrieret	Present
geschlabbert	Past
masturbierest	Present
Mikrokristalls	None
entmachtest	Present
krach	None
begabt	Past
verlernest	Present
Blech	None
versperrst	Present
gebrandschatzt	Past
Verleger	None
stimulierend	Present
nähend	Present
hinterzöget	Past
Menage	None
verselbstständigend	Present
glänzend	Present
Aufwandes	None
Behüter	None
Bolzplatz	None
rätselest	Present
kroset	Present
Erklärung	None
Libyern	None
Biwak	None
gravieret	Present
wurzelnd	Present
vermischest	Present
schädigest	Present
eingewiesen	Past
verwirklichend	Present
beziehst	Present
Novellen	None
zertrampelet	Present
Übergangsmetalloxid	None
tippst	Present
wurschtelnd	Present
stürzet	Present
informierst	Present
gebildet	Past
Eigenkapital	None
interviewet	Present
Musikchen	None
Furie	None
verfliegend	Present
tolerierend	Present
postulierend	Present
Onkologe	None
zupfend	Present
desensibilisierest	Present
Abdeckplatte	None
stichst	Present
gelauert	Past
bemutterest	Present
oxidierst	Present
sorgend	Present
torpedierst	Present
blakest	Present
rotierend	Present
gefeilt	Past
gekickt	Past
schwächelet	Present
gelängest	Past
Lepidolith	None
gelindert	Past
definierest	Present
freigesprochen	Past
verjagest	Present
geiferst	Present
verschobst	Past
Tonerde	None
Magensäften	None
bescherst	Present
belauerst	Present
schauerst	Present
demütigend	Present
identifizierend	Present
schmirgelnd	Present
hervorgehoben	Past
Asymptote	None
patrouillieret	Present
errätst	Present
Porphyrins	None
paginieret	Present
besprenget	Present
nachsagend	Present
tagträumest	Present
aufkonzentrierst	Present
zweifelet	Present
gekühlt	Past
irreführen	None
rußest	Present
desertierst	Present
bastle	Present
Bridge	None
gegrollt	Past
verfilmest	Present
beanspruchst	Present
schabet	Present
zoom	None
gefoult	Past
verbrüderest	Present
Wollen	None
hydrierend	Present
sprühend	Present
verbrennest	Present
amenagierst	Present
erwürgst	Present
Armenhäusern	None
Pfeil	None
gedealt	Past
knurrend	Present
Endemiten	None
dürft	Present
schauspieleret	Present
geschirmt	Past
Suspendierungen	None
katalogisieret	Present
Röhrenspinnen	None
nagest	Present
behandelest	Present
pople	Present
versammle	Present
zechet	Present
abgezogen	Past
wütend	Present
geeignet	Past
gleitend	Present
wäget	Present
Streckenverlaufes	None
gesattelt	Past
popelest	Present
walzend	Present
Pegmatite	None
rivalisierend	Present
stationierend	Present
Spänen	None
misslinget	Present
borgest	Present
beschmutzest	Present
auflösend	Present
strullerest	Present
Protestant	None
beissend	Present
taggest	Present
schnäuzst	Present
stöhnet	Present
stierst	Present
ebbest	Present
benahmst	Past
Bundesinstitutes	None
Höhlenforscher	None
desoxidieret	Present
beleidigend	Present
verbaselest	Present
Walrosses	None
bewahrest	Present
Vorstellungen	None
montierest	Present
kommentierend	Present
wischest	Present
Weißgoldes	None
hebet	Present
Divisoren	None
abhakend	Present
digerierst	Present
aufhebend	Present
knabberest	Present
verpuffend	Present
gebrauchst	Present
zerstreuet	Present
beabsichtigst	Present
geplumpst	Past
Investor	None
grünest	Present
Bergkristall	None
Goldkopflöwenäffchens	None
Granatapfel	None
marschierend	Present
konstatierest	Present
Kriechtieres	None
Protestanten	None
Ärgernissen	None
Arbeitsfläche	None
Schalentiere	None
verglichst	Past
schockierest	Present
wichset	Present
geniessest	Present
Pfirsiche	None
reiniget	Present
platzieret	Present
gegrölt	Past
verfängt	Present
Lüstern	None
fesselest	Present
fessle	Present
röntgend	Present
Dosierung	None
schwadronierest	Present
vorgezogen	Past
Weiher	None
schüttle	Present
kokettierest	Present
bombardieret	Present
geehrt	Past
gepennt	Past
verfolgend	Present
Schreie	None
meuterest	Present
logieret	Present
entwirrest	Present
Beiständen	None
Auflage	None
beteuerst	Present
Kultusministerium	None
kick	None
gekennzeichnet	Past
Schneidwerkzeugen	None
zählet	Present
strapazier	None
kitzelnd	Present
flittre	Present
Hader	None
emendierest	Present
verseifet	Present
ernennet	Present
emittieret	Present
Seilbahnen	None
ermutigend	Present
verdunkelet	Present
Benzine	None
plauderst	Present
entschleierst	Present
Risiken	None
robbet	Present
versteckend	Present
geahnt	Past
Handelsblattes	None
Sonnenfinsternis	None
munkelnd	Present
Nervensystems	None
knipsend	Present
übersähest	Past
geschaut	Past
verdeckend	Present
stächest	Past
schisset	Past
Zurückzahlungen	None
geflötet	Past
orderest	Present
kartografieret	Present
patrouillierend	Present
belästigend	Present
beigebracht	Past
absagen	None
Feststellung	None
wögest	Past
Schalttages	None
dünktest	Past
geworden	Past
Tombolas	None
preis	None
gehallt	Past
abweisend	Present
wehend	Present
feilgeboten	Past
reinstitutionalisierst	Present
angesiedelt	Past
schmusend	Present
infizierest	Present
betrag	None
meditieret	Present
haschierest	Present
überraschst	Present
besinnet	Present
vibrierest	Present
Katechismen	None
Hockeyschlägern	None
Radfahrerinnen	None
Grenzflüsse	None
verscheissernd	Present
Kohlenhydrate	None
überquerend	Present
Sitzplatzes	None
aufgetreten	Past
versperret	Present
Nüstern	None
missbrauchest	Present
Mangroverallen	None
debattierest	Present
funktionieret	Present
Buntbarsch	None
mauernd	Present
benanntet	Past
doppelest	Present
zerstörest	Present
Erschütterung	None
begrabschend	Present
Zunahme	None
jodelest	Present
Hindernisses	None
heilst	Present
Kontakte	None
emittierest	Present
steuerst	Present
abgewiesen	Past
geschwängert	Past
Umspannwerk	None
Buchweizenmehlen	None
importierend	Present
rühret	Present
verbleibst	Present
hexest	Present
stornieret	Present
lieferst	Present
Bogenfenstern	None
gesäubert	Past
sinnierest	Present
Siedepunktes	None
schädiget	Present
Immergrünen	None
regelest	Present
Steinadler	None
betrunken	Past
bestehet	Present
Weihen	None
stinkend	Present
zitierst	Present
vergiftend	Present
Bischöfe	None
erhellend	Present
gerichtet	Past
gehütetet	Past
Gören	None
Abendmahl	None
flöhet	Past
Biologin	None
Gouverneuren	None
verbleibet	Present
poppest	Present
krakeelest	Present
Zeichnungen	None
geizet	Present
gestochen	Past
schiffend	Present
Anwesen	None
kühlend	Present
verschleire	Present
verlobst	Present
genesest	Present
verfingest	Past
lodernd	Present
einbauend	Present
Panter	None
Hüftgelenk	None
gelobest	Present
triebest	Past
Traggas	None
prahl	None
manipulierst	Present
Fluiden	None
Parsec	None
gespitzt	Past
hinderest	Present
Geißeln	None
entludet	Past
Käfig	None
deckest	Present
Gewichte	None
erprobet	Present
handhabend	Present
konstatierst	Present
verschleppend	Present
sinteret	Present
Laden	None
ausbreitend	Present
ramponieret	Present
Ammen	None
gehör	None
brennet	Present
unterlasset	Present
konfigurierest	Present
dämonisierest	Present
Ritual	None
benötigest	Present
umarmst	Present
gemahnt	Past
inszenierend	Present
Demobilisierungen	None
verschöbest	Past
mailst	Present
durchquerend	Present
geflattert	Past
Trisulfiden	None
Ferritine	None
Schaluppe	None
saunierest	Present
begünstigend	Present
eingegriffen	Past
Legierungselement	None
glück	None
erschöpfst	Present
bellest	Present
importierest	Present
kämest	Past
glotzend	Present
entschleierest	Present
erschlägt	Present
Bistums	None
gewährleistend	Present
verstauend	Present
Brechnüssen	None
misshandelst	Present
aufregend	Present
Klärung	None
arrivieret	Present
geschasst	Past
Pfostens	None
Geheimdiensten	None
bewirkend	Present
checkst	Present
verlängeret	Present
Bürgerinnen	None
denunzieret	Present
besorgst	Present
gelutscht	Past
entscheidend	Present
Karteikastens	None
Geisterfahrer	None
gratulierend	Present
dürfest	Present
Krankenschwester	None
Warane	None
besprichst	Present
Kummerbunde	None
drohest	Present
empörst	Present
parkettierst	Present
verbrechend	Present
gereckt	Past
flüsternd	Present
zügelnd	Present
löffelet	Present
Oberlippe	None
simset	Present
flutschst	Present
Himmelsschreiberin	None
Polymere	None
schnappend	Present
holpernd	Present
reflektierest	Present
Herbstwind	None
verirret	Present
kompostierend	Present
gezürnt	Past
buddelnd	Present
verklagend	Present
attackierst	Present
gestreift	Past
geentert	Past
Cheerleaderinnen	None
vereinigest	Present
Bebauungspläne	None
abreisend	Present
Galerien	None
verschleißend	Present
operierend	Present
Grundsatzes	None
enträtselst	Present
waschend	Present
schonend	Present
schielend	Present
Pflegling	None
kenterst	Present
murksest	Present
brünierst	Present
holperet	Present
sitzend	Present
vergabst	Past
Luftschläge	None
Japanerinnen	None
überdenkest	Present
schauderst	Present
Allegorie	None
Exoten	None
Vergebungen	None
verstaust	Present
knüpfend	Present
trödle	Present
entkommet	Present
Punks	None
begehend	Present
ätzend	Present
dienst	Present
geeinigt	Past
wahrest	Present
operieret	Present
besprecht	Present
ausfallend	Present
rummelnd	Present
verformend	Present
Kampfflugzeuge	None
Laptops	None
geknetet	Past
verlangsamst	Present
bereinigst	Present
passest	Present
Strauch	None
schwätzet	Present
Chats	None
Kopfsalates	None
Butt	None
gebahnt	Past
erlösest	Present
defragmentierst	Present
gemartert	Past
besteigst	Present
industrialisierst	Present
beschweret	Present
killend	Present
eskalieret	Present
bezauberet	Present
bedienend	Present
verwerfet	Present
mißtrauend	Present
Eierklars	None
Pfarrers	None
geklopft	Past
entschlössest	Past
brühend	Present
fischest	Present
improvisierst	Present
schlängelnd	Present
Panflöten	None
Kamine	None
formulierest	Present
erwähnet	Present
erdrosselet	Present
vorhersagend	Present
Gefängniswärtern	None
Kreisläufe	None
schnorret	Present
branntest	Past
Zahnärztin	None
Hafenmeistern	None
Triglycerids	None
Diaphragmen	None
widerstehest	Present
geliebt	Past
lehnend	Present
vergräbst	Present
bessre	Present
Fädchens	None
Verfassungsgerichtes	None
läpperst	Present
provozierst	Present
vergrößerest	Present
