լվացքատնիցդ	Noun
մեներգերիդ	Noun
տեսուչ	Noun
ընկուզենիներով	Noun
ծեփամածիկներումս	Noun
ափուդ	Noun
արշիպելագ	Noun
մալին	Noun
գառը	Noun
մակեդոնացիներ	Noun
գեղարդում	Noun
տպիչիցս	Noun
խառնուրդում	Noun
որմնախորշերով	Noun
կնճիռներիցդ	Noun
զավթվել	Verb
թույն	Noun
իշխանին	Noun
պահպանակները	Noun
քարտուղարուհիս	Noun
համաշխարհայինում	Adjective
նեգր	Noun
զարմացնող	Participle
երու	Noun
մոնղոլների	Noun
սոուսները	Noun
հայդուկականներումս	Adjective
նեոդիմներիցդ	Noun
սունդաներենիդ	Noun
կառքում	Noun
շփոթվենք	Verb
մեծերը	Adjective
թարգմանում	Verb
թանաքը	Noun
ճանապարհորդելիս	Verb
ապարանցի	Noun
ամբոխները	Noun
խալիֆայություն	Noun
օվկիանոս	Noun
վհատեցնեի	Verb
վնասվածքը	Noun
նորից	Adjective
հրթիռներ	Noun
մոգ	Noun
վեզիրին	Noun
ուրարտերենը	Noun
հասկանում	Verb
արվեստում	Noun
բազալտից	Noun
անցքի	Noun
տնատիրուհիներովդ	Noun
օգտագործեց	Verb
եբրայերենին	Adjective
մխոցի	Noun
մոլեկուլները	Noun
հրթիռից	Noun
վայրկյանաչափդ	Noun
տնտեսիդ	Noun
օվկիանոսի	Noun
ծնվեցին	Verb
մահացող	Participle
ղեկավարությունում	Noun
մանուշակի	Noun
տարա	Noun
գուլպան	Noun
միլիմետրի	Noun
շուրթի	Noun
հատկացնես	Verb
հավաքածո	Noun
բիզնեսների	Noun
օպերա	Noun
երկաթգծով	Noun
համացանցին	Noun
մահապատիժներ	Noun
ձողիկներով	Noun
քամեր	Verb
շուշանը	Noun
ահաբեկելու	Verb
ենթակառույցս	Noun
ներկայացնելիս	Verb
երախտիքներումդ	Noun
հեռատեսովդ	Adjective
չընտրվես	Verb
զուտ	Adjective
հարելիս	Verb
պանթեոնները	Noun
արկեիր	Verb
պլատինը	Noun
պատրաստություն	Noun
ձեռնարկի	Noun
աստղաբաշխությունովդ	Noun
սոցիալիզմի	Noun
չէթային	Verb
բողոքելու	Verb
հնչյունաբանականովս	Adjective
վարկածին	Noun
ամուր	Adjective
բուժքույրերի	Noun
լողանալիս	Verb
օգտագործմամբ	Noun
լվացքի	Noun
վկայություններով	Noun
շնաձկներ	Noun
բացառություններից	Noun
վերնաշապիկը	Noun
ճիզվիտների	Noun
խալդ	Noun
փակիդ	Adjective
մղոններ	Noun
պաշտոններում	Noun
խորտիկներ	Noun
րոպեական	Adjective
օբյեկտների	Noun
մետաֆիզիկայի	Noun
ուղիներին	Noun
պիստակենի	Noun
հասցվել	Verb
հոգեղեն	Adjective
այլընտրանքների	Noun
երաժշտության	Noun
կաթոդով	Noun
կարիճի	Noun
աշակերտներով	Noun
տոհմում	Noun
կաշխատեն	Verb
ախպերներ	Noun
թեորեմի	Noun
որմի	Noun
ամերում	Noun
կենտավրոսների	Noun
աղունիկներդ	Noun
համեղումդ	Adjective
կատեգորիայում	Noun
հավելում	Verb
կատակեք	Verb
գործազուրկները	Adjective
մետաղալարումս	Noun
համասեռամոլ	Noun
վոլֆրամը	Noun
կենսագրության	Noun
գործիքին	Noun
վարսի	Noun
ցիների	Noun
կհատի	Verb
ամիդ	Noun
թղթադրամը	Noun
խաղատներ	Noun
ազդանշանին	Noun
պայմանավորվում	Verb
սուտ	Adjective
ծովածոցիդ	Noun
փայտիկը	Noun
կխածես	Verb
սառը	Adjective
հարցազրույցից	Noun
չբացատրեմ	Verb
պսակի	Noun
շնագայլի	Noun
բառակապակցություններով	Noun
կխոպոպացվեն	Verb
ֆիննը	Noun
ծնից	Noun
ամառանոցը	Noun
ճահուկ	Noun
իմաստության	Noun
ավագի	Adjective
փայլակը	Noun
գործարքից	Noun
դելֆինիս	Noun
տողերը	Noun
չհեգենք	Verb
միություն	Noun
խորշում	Noun
ատոմները	Noun
աճեցրած	Participle
ցցունքից	Noun
կերկբայանայինք	Verb
ապուրներ	Noun
վիճակը	Noun
մագնիսականությունը	Noun
գաղտնաբառ	Noun
թավջութակների	Noun
զառդ	Noun
պեսոյի	Noun
մարզասրահներդ	Noun
շտեմարանում	Noun
թոքախտով	Noun
տռզեիք	Verb
վերքեր	Noun
սրբիչի	Noun
ավետարանում	Noun
վաճառականներից	Adjective
ազատութեան	Noun
ուսուցիչները	Noun
իշխանություններին	Noun
արկերից	Noun
գիտակցես	Verb
էջերից	Noun
մղում	Verb
շնորհած	Participle
ջերմաչափով	Noun
բացատից	Noun
սովորեր	Verb
ատոմայիններում	Adjective
կիցք	Noun
շարունակես	Verb
մեքենան	Noun
գետակները	Noun
երջանկությունը	Noun
անհավատների	Adjective
դարպասաձողերդ	Noun
չմտադրված	Participle
թմրամիջոցներին	Noun
նահանգներում	Noun
կարճը	Adjective
երթալու	Verb
տեղի	Noun
վճռեցին	Verb
բակլաս	Noun
տնօրեններից	Noun
պարիսպը	Noun
ասպետի	Noun
առնանդամ	Noun
գամետներովդ	Noun
հազացիք	Verb
այգեպան	Noun
շտկվել	Verb
փուլի	Noun
ապահոված	Participle
սելերս	Noun
ունք	Noun
վոլապյուկ	Noun
դիեն	Verb
կողոպտվել	Verb
մսին	Noun
հորդերդ	Adjective
ճահճում	Noun
բետոնների	Noun
ճագարները	Noun
հոգեբանությանը	Noun
սիրուհին	Noun
պարկավորովդ	Adjective
ընդերք	Noun
կապարով	Noun
մակարոնի	Noun
պլուզը	Adjective
փայլատակած	Participle
հուլունք	Noun
չսխալվես	Verb
հելիումից	Noun
հավատովդ	Noun
աշխատակազմ	Noun
սաստիկ	Adjective
ներից	Noun
թաիումս	Noun
պայմանում	Noun
հումորով	Noun
հարձակումներին	Noun
թվաբանություն	Noun
սարավանդներում	Noun
գուլպայի	Noun
փայլունացա	Verb
բալենու	Noun
վայելելու	Verb
ռեկտոր	Noun
եքիդնան	Noun
սառնամանիքներից	Noun
կատարելու	Verb
կենսալի	Adjective
հերումդ	Noun
ոջիլների	Noun
հագագ	Noun
առաջնություններ	Noun
կառքերը	Noun
գրանիտներից	Noun
բարուն	Adjective
վանքի	Noun
ստուգենք	Verb
խնձորների	Noun
խաղաղությունը	Noun
հեռադիտակի	Noun
կատաղուցդ	Adjective
հիվանդանոցը	Noun
մկրատներս	Noun
կասպի	Noun
չարիք	Noun
ճաշակում	Noun
երկարությամբ	Noun
բռնությունը	Noun
վանդակի	Noun
հասարակում	Adjective
կողմանոցիդ	Noun
խոսար	Verb
արբանյակների	Noun
ծերության	Noun
մարզերում	Noun
տեսուչը	Noun
կկատարեմ	Verb
եվրոներիդ	Noun
ռոման	Noun
սպիտակուցներից	Noun
մեղադրելու	Verb
աշակերտներ	Noun
արեւածագովդ	Noun
շնաձկանը	Noun
կրճատում	Noun
բանակցություններից	Noun
ցավը	Noun
նադիրը	Noun
ամպից	Noun
շքերթ	Noun
տնօրենների	Noun
տանիքը	Noun
ձկնկուլներ	Noun
փղերից	Noun
ակումբից	Noun
լուսների	Noun
պեղում	Verb
տարան	Noun
հատկանիշներին	Adjective
միջիններիս	Adjective
ծառայությունները	Noun
ճարտարապետները	Noun
կաչաղակի	Noun
բնակիչները	Noun
էլեկտրոդի	Noun
անտիցիկլոններումդ	Noun
նահանգների	Noun
անկան	Verb
հերոիններիդ	Noun
վերքերը	Noun
չքրթմնջաք	Verb
սպերմատոզոիդի	Noun
պարենքիմի	Noun
կորում	Verb
ռոդիումներով	Noun
հաճախեց	Verb
անմահների	Adjective
կոմսեր	Noun
քամ	Verb
արգասիքները	Noun
ազգականի	Noun
ռուբլին	Noun
քյարփիչներս	Noun
ակնթարթների	Noun
պոռոտաբանություններով	Noun
բուրբոնը	Noun
վեդայական	Adjective
մարերին	Noun
պարսիկներից	Noun
փքունություններին	Noun
մրցանակով	Noun
հալածանքներ	Noun
օդանավակայաններից	Noun
ճանապարհների	Noun
լեռնագրությունում	Noun
բանականները	Adjective
խուճապին	Noun
սննդով	Noun
վարժություն	Noun
հաճած	Participle
հայացք	Noun
պղնձին	Noun
նեոնը	Noun
թաթավուչներին	Adjective
ներկայացումներում	Noun
ապրանք	Noun
լեհական	Adjective
վոլֆրամ	Noun
զանգեց	Verb
կոմսին	Noun
կեղծաներ	Verb
պոմպերով	Noun
պարողը	Noun
նարինջը	Noun
տափաստաններում	Noun
օրհներգի	Noun
իշխանների	Noun
արդյունքով	Noun
կավերի	Noun
կոմունիստներին	Noun
օսմիումի	Noun
զորավարը	Noun
հատուներ	Adjective
շաքարավազի	Noun
հանված	Participle
քուրմը	Noun
ճնճղուկը	Noun
ճոնին	Noun
հնդկերեն	Noun
լուման	Noun
կնքելիս	Verb
աշխատակազմս	Noun
հեծելազորի	Noun
մկրատով	Noun
ջրածնով	Noun
արծաթից	Adjective
փողկապով	Noun
տարածեք	Verb
երկին	Noun
ծնողը	Noun
վերամբարձ	Adjective
թայֆունի	Noun
բարելավեցին	Verb
անձնանուն	Noun
գնահատող	Participle
հոգեբանների	Noun
զղջալ	Verb
օծեց	Verb
կանոնով	Noun
տորմիղը	Noun
արարում	Noun
հովտից	Noun
նեյտրինոն	Noun
չներկայացնել	Verb
պլատինում	Noun
լուսանկարներից	Noun
յակ	Noun
կուրսեր	Noun
ընթերցում	Noun
բնավորություններ	Noun
թեմերի	Noun
պարտություններին	Noun
ըմպում	Verb
սարավանդում	Noun
ածանցից	Noun
մահանալու	Verb
հաստատեց	Verb
ներդրումների	Noun
տափաստանները	Noun
բառակազմության	Noun
գլյուոն	Noun
խաչմերուկում	Noun
առավոտը	Noun
մասնիկիցդ	Noun
բժշկությանս	Noun
խրախուսեց	Verb
բուսակերների	Noun
որքին	Noun
սարավանդներիցդ	Noun
տերմինից	Noun
օդակայաններ	Noun
վճռած	Participle
կնիքով	Noun
ժամացույց	Noun
օրանգուտանը	Noun
սյունակներ	Noun
կբարելավեմ	Verb
լիգա	Noun
ծաղրը	Noun
ջիգյար	Noun
հավք	Noun
ազոտներդ	Noun
արդուկս	Noun
շինվածքի	Noun
ածանցով	Noun
սիրուած	Participle
ասվիդ	Adjective
հնչույթները	Noun
դարձվածքի	Noun
միջատաբանական	Adjective
չոնորոշացած	Participle
ուսուցչից	Noun
բացատրվել	Verb
պիտույքներ	Noun
պատվանդան	Noun
տհաճ	Adjective
մրցանակին	Noun
վերջնախաղի	Noun
նկուղի	Noun
խցան	Noun
ծնողներս	Noun
խմիչքով	Noun
զգացմունքներին	Noun
ուսանողների	Noun
խոհակերներիդ	Noun
տեւեցին	Verb
լեզգիներովդ	Noun
խորեզմերենիս	Noun
ֆոտոն	Noun
ներքնակ	Noun
բջիջների	Noun
այսբերգը	Noun
խորհրդարան	Noun
կալվածներ	Noun
իրիդիում	Noun
ցաքի	Noun
ազերիների	Noun
ֆրանսիացիները	Noun
արդարացնելու	Verb
նետաձիգ	Noun
խլուրդները	Noun
թեփուկներից	Noun
քննություններ	Noun
տեսիլքով	Noun
ցողունների	Noun
բարվոքիդ	Adjective
հյուս	Verb
սառնամանիքներին	Noun
կածեինք	Verb
վատը	Adjective
ընտրվելու	Verb
խրամ	Noun
մաքսդ	Noun
հալվա	Noun
քիմիա	Noun
աշակերտով	Noun
խավարի	Adjective
գլխարկներ	Noun
քրքումովս	Noun
խորհրդում	Noun
շուշանի	Noun
ամուսնալուծությունների	Noun
ֆրանսուհու	Noun
մառանի	Noun
գյոզալ	Adjective
երակներից	Noun
կոմունիզմ	Noun
արտադրության	Noun
մարսողություններին	Noun
չահաբեկեմ	Verb
թակարդից	Noun
զարթօնքին	Noun
մետաղադրամներ	Noun
ամերիկացուն	Noun
եկի	Noun
ունակություններին	Noun
տրակտորներ	Noun
քարայրներ	Noun
բնակիչը	Noun
լողանում	Verb
հարբուխի	Noun
ցանկացան	Verb
զարմանալ	Verb
կարեկցանքի	Noun
կերակրեն	Verb
ամսագիր	Noun
պրոթեզների	Noun
կրթությունը	Noun
մոլիբդենը	Noun
տաճարներով	Noun
խայթոցից	Noun
պատվանդանին	Noun
հավաքույթի	Noun
կայքը	Noun
ստորագրվել	Verb
ոստիկանությանը	Noun
հանդեսի	Noun
կհպատակվեք	Verb
շարունակած	Participle
ստեն	Verb
կնեղանաս	Verb
արեւելահայերենիցս	Noun
ակտինիում	Noun
աշխատեցնել	Verb
բոստաններիս	Noun
արխիվները	Noun
արդարեւ	Adjective
պաշտամունքի	Noun
կոմունիստները	Noun
կխորխի	Verb
պողպատներից	Noun
հեռ	Verb
գոչումներովդ	Noun
ծինը	Noun
համեստ	Adjective
ծայրերին	Noun
խնջույքներով	Noun
հռչակներովս	Noun
կընտրվեն	Verb
ֆիզիկոսներիցս	Noun
մաթիլներից	Noun
թզուկներ	Noun
կարելու	Verb
խանություններից	Noun
խմիչքին	Noun
նորություններ	Noun
մարախ	Noun
կիրճին	Noun
գնահատելու	Verb
տեղեկացել	Verb
մաքրելիս	Verb
փոխարինած	Participle
խոթած	Participle
տուփերից	Noun
խնդրանքով	Noun
կայսրություններում	Noun
սառույցներով	Noun
պատվանդանով	Noun
պարուհիներ	Noun
օրգանիզմ	Noun
արտերում	Noun
երեւույթ	Noun
անհերքելիովս	Adjective
ուղեկցեցին	Verb
կպայմանավորի	Verb
բազալտը	Noun
լուսանկարչությունը	Noun
չաբսորբող	Participle
ինքնություն	Noun
ռուբլու	Noun
նախասրտերի	Noun
շարժվելու	Verb
ծանուցող	Participle
կապիտալիզմի	Noun
լռինումդ	Adjective
սերմնահեղուկ	Noun
ցնորքներով	Noun
սեքս	Noun
օձաձկները	Noun
լավայով	Noun
դիվերգենցիաներս	Noun
կալցիումդ	Noun
սիրու	Verb
ապրիլը	Noun
հայկազունին	Noun
վերելակից	Noun
բարիքների	Noun
պատմուճակ	Noun
քչերի	Adjective
կցվել	Verb
դատարանից	Noun
կթքեիր	Verb
կկատարեր	Verb
բրդով	Noun
տգեղ	Adjective
սպորտը	Noun
զեյթունում	Noun
գելեր	Verb
ձագար	Noun
բարձրաձայնելու	Verb
ելույթների	Noun
փչացել	Verb
լույծի	Adjective
չանզգայացվեր	Verb
հարցման	Noun
սամույրը	Noun
Ամանորից	Noun
չարմանայիք	Verb
բարձունքներից	Noun
խրոխտություններում	Noun
օպերայով	Noun
շահենի	Noun
կողմի	Noun
ակրոբատ	Noun
զոռով	Noun
լրտեսներ	Noun
արգասիքներից	Noun
եփվել	Verb
ձկնկիթ	Noun
ակռաներիցս	Noun
թատրոններից	Noun
իշխանները	Noun
բնակչի	Noun
արձագանքում	Verb
կերակուրներիցս	Noun
կվենիներովս	Noun
բուսաբանները	Noun
զորահավաքի	Noun
ակնածած	Participle
ծնվես	Verb
ֆլեյտաների	Noun
միայնակ	Adjective
պողոտայում	Noun
առվի	Noun
ամառանոցի	Noun
խառնվածքների	Noun
ալմանախով	Noun
թանաքով	Noun
օսմաններ	Noun
աբորտով	Noun
ֆերմիում	Noun
մանկապարտեզների	Noun
իշխանը	Noun
գովազդի	Noun
հրապուրվել	Verb
բարբառից	Noun
նուշումդ	Noun
երիցուկը	Noun
բնորոշող	Participle
կարծրախտի	Noun
ամուլներից	Adjective
մեծացան	Verb
վերինները	Adjective
առաջատարներ	Adjective
բյուջեն	Noun
հպատակվեին	Verb
կտուրներով	Noun
պայմանները	Noun
նեղուց	Noun
արձագանքելու	Verb
օազիսներիցս	Noun
հապավումները	Noun
վանկին	Noun
խցանը	Noun
ժամացույցներ	Noun
իսպանացին	Noun
մագնիսականության	Noun
արարածի	Noun
փորոք	Noun
չանաներդ	Noun
բգովդ	Noun
կցանկանան	Verb
պատժին	Noun
կոմս	Noun
պատմությունը	Noun
գադոլինիումի	Noun
փարավոններին	Noun
աշուղներին	Noun
համարեց	Verb
ճանկեր	Noun
խրճիթ	Noun
կորտերը	Noun
ավելացնելու	Verb
կոտորակի	Noun
իսպանականներումդ	Adjective
երկրաբաններ	Noun
էջերին	Noun
կռվեցին	Verb
տուրքերից	Noun
արշավանքներից	Noun
գլյուոնների	Noun
ճնշումներով	Noun
գոհին	Adjective
մանդարիններիցս	Noun
քննարկած	Participle
կենսալիրներիցդ	Adjective
երկի	Noun
մկանի	Noun
գոգը	Noun
պոլիմերի	Noun
չփքած	Participle
գորտեր	Noun
առջեւի	Noun
կետադրությունը	Noun
բոլշեւիկին	Noun
միացվել	Verb
հնդկահավիս	Noun
պաճիճիս	Noun
տրամվայի	Noun
վարձով	Noun
նախախնամություն	Noun
նպաստներ	Noun
կթոթովեիր	Verb
անդադարով	Adjective
տաջիկ	Noun
եռանդալիդ	Adjective
զգեստի	Noun
սիրեկան	Noun
չանհանգստանանք	Verb
թախտի	Noun
շարահյուսության	Noun
ջրարջեր	Noun
կազմակերպեր	Verb
հաճախումներիդ	Noun
արվեստագետ	Noun
տարած	Verb
հասկ	Noun
բարկերումս	Adjective
խաղալիքները	Noun
ցնծություն	Noun
ճոռոմախոսությունից	Noun
տեսիլ	Noun
պոչուկի	Noun
աբստրակտներովդ	Adjective
ոսկիները	Adjective
այգեստանի	Noun
կազակ	Noun
տոհմի	Noun
քրտն	Verb
ցողունում	Noun
արարը	Noun
երկան	Noun
խաչերով	Noun
մարդ	Noun
մատչ	Verb
հղացանք	Verb
մայրցամաքում	Noun
կկտցենք	Verb
ավանդույթին	Noun
դեկանը	Noun
նեպտունիում	Noun
հեքիաթներ	Noun
գծիկներով	Noun
բարելավելու	Verb
ափսե	Noun
չակերտներում	Noun
խմիչքներիցս	Noun
թեղիներ	Noun
էրիկները	Noun
սփոփում	Verb
լքած	Participle
հարգեք	Verb
համակարգիչներից	Noun
թեորեմը	Noun
ուղեկցեց	Verb
հայտնեք	Verb
ոխերիմ	Adjective
առաջադիմեցին	Verb
քանակների	Noun
բաժանվեն	Verb
սմարթֆոն	Noun
կարտ	Noun
կրիաներ	Noun
որմերումդ	Noun
խորշով	Noun
հաղթականումս	Adjective
ուսումը	Noun
ֆուտբոլիստի	Noun
մտավորներովդ	Adjective
փամփուշտով	Noun
պրոտոններից	Noun
թութակը	Noun
շուշմաներիդ	Noun
նիստերը	Noun
աքսորներովս	Noun
լոգարանի	Noun
ելից	Noun
չինացու	Noun
գործարանների	Noun
հատապտուղների	Noun
ուրուկներիցս	Adjective
հայտնիների	Adjective
ներքինանալիք	Verb
հիասթափությամբ	Noun
էմիգրանտներից	Noun
տրամադրեց	Verb
նախանձոտ	Adjective
մարդասպաններին	Noun
ռիսկերի	Noun
առողջարաններում	Noun
կռկռացին	Verb
նեյտրոնային	Adjective
բակտերիադ	Noun
ծովափղերի	Noun
ինֆեկցիաներդ	Noun
քաղցկեղիդ	Noun
շաքարով	Noun
ճանում	Noun
մատնեցին	Verb
ղարսի	Noun
պողպատում	Noun
ադրբեջանցիներին	Noun
համբույրների	Noun
կապահովվի	Verb
զանգահարում	Verb
շշուկների	Noun
ռիսկով	Noun
խոլորձ	Noun
աստղաֆիզիկայի	Noun
ավատիցդ	Noun
տեռորիզմին	Noun
ոսկորիցս	Noun
կաջակցեմ	Verb
մրցանակը	Noun
ապեր	Noun
փայլում	Noun
կհասկանաս	Verb
երգչուհիները	Noun
մերձավորների	Adjective
դեղաբույսերով	Noun
սուզանավովդ	Noun
քուռակիցդ	Noun
ձրիներում	Adjective
անապատներով	Adjective
շքախումբը	Noun
խմ	Verb
համերգից	Noun
մակարոնով	Noun
բաղաձայնի	Noun
ավաններ	Noun
բորբոքումներումս	Noun
արարողությունից	Noun
ստամոքսի	Noun
իրականությունը	Noun
հատապտուղները	Noun
կարեկցության	Noun
հաղորդումները	Noun
եռալ	Verb
թվանշանով	Noun
մտավոր	Adjective
հայրանունում	Noun
բիստրոյովս	Noun
կմիանա	Verb
պորտեր	Noun
խթանեց	Verb
մաթեմատիկոսների	Noun
շակալը	Noun
տարիքները	Noun
այրիներ	Adjective
մրջյունը	Noun
ծառայեցնել	Verb
պրոտակտինիում	Noun
քամած	Participle
տողանի	Noun
կոկաինից	Noun
ականի	Adjective
շիմպանզեներ	Noun
օդանավակայանների	Noun
ծերուկի	Noun
հին	Adjective
լկտիներից	Adjective
ճարպեր	Noun
պուլպուլակներովս	Noun
ձագ	Noun
ճանապարհներին	Noun
բարդությունը	Noun
բողոքող	Participle
չագահանայիր	Verb
հրաբուխների	Noun
կոպերի	Noun
խորհրդարաններ	Noun
բարբառով	Noun
այրու	Noun
նվագախումբ	Noun
էրեկցիայի	Noun
ճնճղուկներ	Noun
պատվանդանը	Noun
սաղավարտը	Noun
չհասկացա	Verb
պահակները	Noun
տեսիլքներից	Noun
ալոճենուցդ	Noun
լոյսը	Noun
փղով	Noun
արահետներ	Noun
պարը	Noun
հոտում	Verb
սարքավորումներ	Noun
համացանցի	Noun
ստուգաբանությունների	Noun
օդանավակայանի	Noun
բացատրող	Participle
կամարի	Noun
գծիկի	Noun
կողի	Noun
մրցավարին	Noun
ճանապարհին	Noun
տրակտորի	Noun
նորության	Noun
կոչումից	Noun
հնձան	Noun
կտուրների	Noun
կրաքարի	Noun
մաքրելու	Verb
հուժկու	Adjective
սրճենու	Noun
գրպան	Noun
հարվածներով	Noun
չչորացան	Verb
ավանների	Noun
նետող	Participle
լումա	Noun
սպանություններին	Noun
բացառություններով	Noun
լուծ	Verb
բաճկոններումդ	Noun
հազարամյակ	Noun
ցանկացա	Verb
իշխանափոխություն	Noun
գոռը	Adjective
երասանովդ	Noun
արքային	Noun
բոլորին	Adjective
տեղիովդ	Noun
օրիորդին	Noun
ելուստի	Noun
ազատութիւնս	Noun
այցելեցին	Verb
մարզադաշտերի	Noun
փողկապին	Noun
աստղադիտակից	Noun
ալմանախում	Noun
ատոմ	Noun
մահմեդականներին	Noun
երկարին	Adjective
լքեր	Verb
հոգացող	Participle
շտկեցի	Verb
գերեզմանոցները	Noun
առիթը	Noun
կալցիումի	Noun
օգոստոս	Noun
ըմբշամարտից	Noun
էլեմենտներին	Noun
կասկածները	Noun
ելակիդ	Noun
բարձունքին	Noun
փղերով	Noun
ձրիներս	Adjective
թիակները	Noun
փորձենք	Verb
լքյալիցս	Adjective
ուսուցիչ	Noun
հանքաբանական	Adjective
հուզող	Participle
ճանապարհորդություն	Noun
մասունքը	Noun
մանգուստները	Noun
ակնարկով	Noun
կարաոկե	Noun
կոսմոսը	Noun
լիզում	Verb
սոցիալիստական	Adjective
քամին	Noun
բնավորություններով	Noun
չերկայնացած	Participle
գետակների	Noun
ծնված	Participle
մարտնչի՛ր	Verb
ճոխերովս	Adjective
սրում	Adjective
աստվածներին	Noun
հավատան	Verb
արաբի	Noun
հայթայթեն	Verb
հյուպատոսության	Noun
հյուրանոցները	Noun
ալաններին	Noun
հիմներով	Noun
վարունգի	Noun
ջանքերով	Noun
ձառովդ	Adjective
քանդակով	Noun
օձաձկներ	Noun
համրերի	Adjective
անուրջների	Noun
ելս	Noun
հանքում	Noun
ակումբների	Noun
բաղձանքներումդ	Noun
արքայախնձորը	Noun
Գարիկներիցդ	Noun
նեոդիմումս	Noun
ակումբներից	Noun
լուծող	Participle
ռադիոյի	Noun
չքաքեցի	Verb
գործադուլներին	Noun
մտի	Noun
մեծանունիցդ	Adjective
սկուտեղներ	Noun
խցիկով	Noun
մասնակից	Noun
չհաճախեք	Verb
մետրանոցները	Noun
կզններ	Verb
հայտնիներ	Adjective
բացատրես	Verb
կորած	Participle
թագ	Noun
տոների	Noun
միատոն	Adjective
արտոնագրի	Noun
արգելվել	Verb
բոբիկովս	Adjective
անգլիացիները	Noun
բանկայի	Noun
վկաների	Noun
անապատը	Adjective
ստվարաթղթի	Noun
երկբարբառների	Noun
վրանին	Noun
առասպելը	Noun
հավասարումների	Noun
թուլացած	Participle
արմս	Noun
հյուպատոսների	Noun
խթանները	Noun
հնարքներ	Noun
միջակետ	Noun
արշավանքից	Noun
ժողովներին	Noun
ավագները	Adjective
կոկո	Noun
բան	Verb
ազոտով	Noun
ժողովդ	Noun
սկաները	Noun
տաշում	Noun
գյուտարարին	Noun
հեղաշրջումը	Noun
հասկացավ	Verb
ֆագոտի	Noun
չկարծեն	Verb
գոլանալիս	Verb
փորվել	Verb
ցանկանան	Verb
ոստիկան	Noun
պատարագը	Noun
ծնվելիս	Verb
կինոն	Noun
հազալիս	Verb
իսկական	Adjective
սլանալ	Verb
նվազի	Adjective
քարափը	Noun
արքունիքին	Noun
աշխատելու	Verb
ձվաձեղիդ	Noun
թաթարներին	Noun
ենթարկելու	Verb
մետաֆիզիկա	Noun
կերակուրների	Noun
վարակները	Noun
կարողանալ	Verb
գերդաստանումդ	Noun
մենակ	Adjective
սրտառուչ	Adjective
սպանախի	Noun
եկեղեցականի	Adjective
տոմարների	Noun
բռնաբարությունը	Noun
կրպակներով	Noun
գրանիտներով	Noun
շախմատում	Noun
խոնավ	Adjective
ֆոսֆորը	Noun
աղեղնավոր	Noun
տզրուկները	Noun
նավակից	Noun
համալսարաններին	Noun
թզուկների	Noun
քրդերին	Noun
մաշկի	Noun
հայցելու	Verb
խտղտանքիցս	Noun
տերմինի	Noun
հոդվածները	Noun
սպուտնիկներիցս	Noun
մեծաքանակներովս	Adjective
նվիրակի	Noun
գոչերումս	Noun
սսկվի՛ր	Verb
բակտերիաների	Noun
միսս	Noun
ճամպրուկ	Noun
տեսարանից	Noun
օգոստոսյաններիս	Adjective
էներգիայով	Noun
մետրը	Noun
առաջարկություններովդ	Noun
կղզին	Noun
մտածելակերպ	Noun
փորելիս	Verb
ջրամբարները	Noun
կողմերում	Noun
սարսափով	Noun
բանտերից	Noun
լուսանկարիցդ	Noun
մայրաքաղաքներովս	Noun
կոտորածներով	Noun
պարիսպներից	Noun
թողություն	Noun
ծիրանենիներով	Noun
հրամանը	Noun
ցուրտերից	Adjective
վեճը	Noun
արատը	Noun
գորտ	Noun
պրակները	Noun
մանվածքը	Noun
մասրենու	Noun
բիզնեսի	Noun
ազգականներից	Noun
սաղավարտովս	Noun
իլով	Noun
կոտրվել	Verb
չործկաք	Verb
օմանյան	Adjective
զարթոնք	Noun
ժանգերս	Noun
մակբայների	Noun
հասցեով	Noun
լամայի	Noun
նեխ	Verb
վարժերիցս	Adjective
սովորելու	Verb
հանգույցներում	Noun
պատմվածքի	Noun
կծլարձակեին	Verb
լորենու	Noun
ֆրանսիացին	Noun
մատանուց	Noun
կանոնին	Noun
մառոլների	Noun
խաչքարը	Noun
շնչափողի	Noun
աղքատների	Adjective
կացարան	Noun
նիստերով	Noun
մրջյուններովս	Noun
փեսացուներիդ	Noun
վերջինից	Adjective
տաբատները	Noun
կազինոն	Noun
կրծելիս	Verb
հոգալու	Verb
խոնավավուններով	Adjective
կակալումդ	Noun
կամակոր	Adjective
ճոնի	Noun
սափորում	Noun
մասնակիցների	Noun
ճոճանակով	Noun
խելագարը	Adjective
արդյունաբերությունները	Noun
յուղերից	Noun
ստուգեին	Verb
երկրպագուներից	Noun
եբրայեցիներին	Noun
շառաչյուններում	Noun
ստեղծագործությունից	Noun
ոսկորներում	Noun
փաստաթղթին	Noun
խալխին	Noun
բաղձանքից	Noun
նազովդ	Noun
ձվաբջջից	Noun
արտաքինին	Adjective
կանչեց	Verb
խաղատանը	Noun
անվտանգ	Adjective
աստղադիտակների	Noun
չկրել	Verb
վար	Verb
արագիլները	Noun
արձագանքող	Participle
բիսմութիդ	Noun
ճանապարհի	Noun
լիսեռից	Noun
հոտեցինք	Verb
ակունքների	Noun
խառնվածքիդ	Noun
խրճիթներ	Noun
լճին	Noun
շափյուղա	Noun
շրթներկ	Noun
քվազարները	Noun
երաժշտություններ	Noun
չուզեի	Verb
շատեր	Adjective
սկանդիումը	Noun
պայմանագրով	Noun
ամուսնություն	Noun
ձանձրույթի	Noun
ներին	Noun
երջանկությանը	Noun
կքաղցի	Verb
հեկտար	Noun
մեզոնների	Noun
թաի	Noun
կրծոսկրի	Noun
չհղեցար	Verb
գահույքներդ	Noun
ռուսաստանցուն	Noun
կրոնավորները	Adjective
չզարմացնել	Verb
ռուսներից	Adjective
բարձ	Verb
ժամկետներ	Noun
տերմիններից	Noun
վրացերենիցդ	Noun
փնտրեց	Verb
սանսկրիտ	Noun
օվկիանոսով	Noun
ֆիզիկոսները	Noun
հայցով	Noun
վզիկում	Noun
ծերունիները	Adjective
ողբացել	Verb
ստվարածավալս	Adjective
գոլֆը	Noun
նավակ	Noun
ռասիզմի	Noun
մեծության	Noun
կճկեին	Verb
կայանալիք	Verb
անց	Noun
սենատից	Noun
վաճառասեղաններին	Noun
կարձագանքի	Verb
հարգենք	Verb
կրկեսից	Noun
արոտներ	Noun
արտասանություններով	Noun
կլաներ	Verb
միությամբ	Noun
չփսխեր	Verb
թվանքներովս	Noun
էպոսից	Noun
անեկդոտները	Noun
հեռուն	Adjective
իզոտոպները	Noun
վերջինիցս	Adjective
լնդերը	Noun
կաքավիցդ	Noun
չորացի՛ր	Verb
միապետության	Noun
լուսամուտի	Noun
հայկականից	Adjective
քվեարկող	Noun
թեզնիքները	Noun
տարտամ	Adjective
զարմուհի	Noun
պարգեւեց	Verb
նպաստները	Noun
կրպակների	Noun
ճմլեիք	Verb
լեյտենանտը	Noun
խայթոցը	Noun
մետրանոցից	Noun
զորահավաքը	Noun
բացառիկ	Adjective
մրջյունների	Noun
պայուսակը	Noun
կարտոֆիլը	Noun
կլուծեր	Verb
քաղցրահամ	Adjective
ցասկոտ	Adjective
քորով	Noun
ճոպանները	Noun
երիցուկ	Noun
իգականի	Adjective
վարդենի	Noun
բանտից	Noun
անմոռուկը	Noun
ավատի	Noun
լոգանքներովդ	Noun
գործոններին	Adjective
ծնոտի	Noun
ճարտարապետը	Noun
գմբեթ	Noun
ծանրությանը	Noun
ոսպնյակներիցս	Noun
սնուցում	Noun
փորձեն	Verb
տնտեսագետ	Noun
լաբիրինթոսը	Noun
չան	Noun
շուկային	Noun
գրադիենտների	Noun
նամը	Adjective
մոռենի	Noun
նորը	Adjective
բադակտուցի	Noun
ատելությունից	Noun
պատրանքներից	Noun
խռթալիս	Verb
անկաշկանդի	Adjective
կերպարանքներ	Noun
թագուհուց	Noun
հարություն	Noun
քառյակը	Noun
վահանագեղձը	Noun
ազոխ	Noun
կլան	Verb
տեքստերին	Noun
ակներով	Noun
երկրպագուին	Noun
գործոններից	Adjective
վիճեցին	Verb
աղիճ	Noun
կբարբաջեն	Verb
կողմում	Noun
բիզնես	Noun
ավելացրել	Verb
պաշտամունքների	Noun
սպիտակավունից	Adjective
ներխուժեն	Verb
արցունքիցս	Noun
եպիսկոպոսները	Noun
փոխառություններ	Noun
նիրհեցինք	Verb
կայսրությունում	Noun
երկարություն	Noun
համեստությանդ	Noun
կառավարություններին	Noun
ֆրանսիացուն	Noun
ավետիքներումդ	Noun
պատարագներ	Noun
ճշմարտությանը	Noun
գերդաստանները	Noun
հեռախոսով	Noun
առողջացներ	Verb
թիթեղներ	Noun
կուրսի	Noun
լքող	Participle
թեշու	Noun
ալտ	Noun
մահակներ	Noun
խոստանան	Verb
հանգույցներով	Noun
կնյուն	Noun
կանգնած	Participle
կողբա	Verb
ասբեստը	Noun
ինքնաթիռը	Noun
աղբից	Noun
կործանեցին	Verb
առնի	Noun
գուժում	Noun
ճյուղեր	Noun
յոդեր	Noun
թխվածքների	Noun
հանգամանքները	Noun
առաքինության	Noun
հնոցներ	Noun
նուկլոնների	Noun
շիթը	Noun
սեզոնից	Noun
ճրագներ	Noun
տարօրինակներովս	Adjective
կատեգորիայի	Noun
հիասթափություն	Noun
դարանակալ	Verb
բորբոքեց	Verb
մարզասրահում	Noun
առաքելություններ	Noun
լուծվել	Verb
ստինքներիցս	Noun
կակաչ	Noun
հնդկահավեր	Noun
մրջյունոցիդ	Noun
հեղեղներ	Noun
հյուպատոսին	Noun
ամդ	Noun
լոբուց	Noun
շքանշաններին	Noun
կտակելու	Verb
սարդիս	Noun
օժանդակեցին	Verb
միացրել	Verb
զննեցինք	Verb
տանկով	Noun
պանթուրքիզմի	Noun
վասալները	Noun
ճահուկս	Noun
տարածքով	Noun
արարչին	Noun
բարելավենք	Verb
կողքերից	Noun
փնտրած	Participle
կրծքավանդակից	Noun
մեդալ	Noun
ուռենու	Noun
չճշգրտեցիր	Verb
խուցը	Noun
հայրենակիցները	Noun
վարսին	Noun
արոտավայրեր	Noun
հասկանար	Verb
փրփուրները	Noun
որոճի՛ր	Verb
ճաքած	Participle
թերիներով	Adjective
արցունք	Noun
ֆոսֆոր	Noun
քիմք	Noun
ճշմարտություններ	Noun
նոյեմբերյան	Adjective
օգտագործելիս	Verb
սրճավաճառ	Noun
բուսնում	Verb
գմբեթից	Noun
տեքստերով	Noun
դեղատներ	Noun
ամորձիների	Noun
ձեռնոցներ	Noun
հրդեհում	Noun
ցլամարտը	Noun
քանակին	Noun
մեծաբազուկիս	Adjective
հագնել	Verb
ճագարը	Noun
երկբարբառը	Noun
եղջյուրներից	Noun
մսեր	Noun
մսերս	Noun
դաշնության	Noun
սպորտից	Noun
պտույտ	Noun
տեքստերիդ	Noun
ապտակում	Noun
սագ	Noun
վանքերի	Noun
ժողովները	Noun
տոլման	Noun
բացմանը	Noun
ուտիճներդ	Noun
մուրաբաները	Noun
այբուբենից	Noun
անիմաստ	Adjective
ադամանդներով	Noun
հնչյունից	Noun
թքած	Participle
թարգմանեք	Verb
մարգարե	Noun
խոպոպվեցի	Verb
պանիրը	Noun
տոմար	Noun
մթերում	Adjective
մայրենիի	Adjective
գաղափարագրերի	Noun
օսմաներեններին	Adjective
չմօտենայի	Verb
ընկերուհուն	Noun
լոյս	Noun
լուսնից	Noun
կայծքարի	Noun
հայացքը	Noun
ժամանումովդ	Noun
տառադարձում	Verb
հաստությունը	Noun
ստեղնաշարի	Noun
եկամտի	Noun
բնակչին	Noun
գովքի	Noun
մեծություն	Noun
քարոզող	Participle
շիզոֆրենիայով	Noun
ամիկներիցս	Noun
հանքաբան	Noun
նահատակները	Noun
կրծքավանդակ	Noun
արքունիքից	Noun
իժ	Noun
հեղափոխությունումդ	Noun
ընտանիներով	Adjective
օսի	Noun
հեղաշրջում	Noun
լրտեսություն	Noun
խեժում	Noun
գյուղացիներ	Noun
աշտեներովս	Noun
սիրուհու	Noun
առաջավորներին	Adjective
համացանցում	Noun
քննադատներից	Noun
նախագահության	Noun
էական	Adjective
ձնով	Noun
պատկերասրահին	Noun
վզանները	Adjective
քարայրում	Noun
անպատրաստներումդ	Adjective
գրիպը	Noun
վիճակախաղերդ	Noun
մողես	Noun
կենսագրությունս	Noun
արկերում	Noun
թրթուրների	Noun
հեղաշրջումներիցդ	Noun
հնանում	Verb
սեզեր	Noun
արտադրություններդ	Noun
ուսանողներից	Noun
գոթիներդ	Adjective
ստեղծագործությունները	Noun
ներդրումից	Noun
կեչին	Noun
տեղանուններից	Noun
սերմնաբջիջները	Noun
ամիսը	Noun
հաղթուներ	Adjective
պտույտներ	Noun
բգումդ	Noun
թարգմանը	Noun
կկարմրեի	Verb
հնոտիներումս	Adjective
կհալես	Verb
ֆլեյտա	Noun
կլքի	Verb
քյափիկի	Noun
արջամկան	Noun
ծերունիների	Adjective
ահումս	Noun
քթանցքից	Noun
կզաքիսի	Noun
նվագախմբերումդ	Noun
մատն	Verb
գրատախտակին	Noun
մանրէաբաններ	Noun
ինքնագրով	Noun
կրիաների	Noun
բոշա	Noun
պատմություններում	Noun
արմ	Noun
թեքում	Noun
արգելքից	Noun
լորտուների	Noun
երդիկով	Noun
պաշարը	Noun
հոդեր	Noun
բրուտ	Noun
թիակ	Noun
խանութ	Noun
չմօտենան	Verb
մեջը	Noun
զարմանքի	Noun
սոուսը	Noun
պատվիրակություններ	Noun
թարգմանություններ	Noun
հազարամյակի	Noun
մենամարտում	Noun
գանգրավորներ	Adjective
մակամորձու	Noun
հավասարումներից	Noun
գիշերային	Adjective
որձաքարերը	Noun
հաստատեք	Verb
առեղծվածներիդ	Noun
սպաներդ	Noun
թրծելու	Verb
հյուծող	Participle
կայանը	Noun
ռեւոլյուցիայովս	Noun
սապոնին	Noun
ջերմաչափի	Noun
ասքի	Noun
հասարակումդ	Adjective
արջամուկը	Noun
ազոխս	Noun
կարեկցանքով	Noun
բակում	Noun
մետաղադրամ	Noun
խոշոր	Adjective
քել	Verb
ոսկին	Adjective
արքայազն	Noun
ատոմներից	Noun
խոնավներից	Adjective
հատորներում	Noun
հաստույրներումդ	Adjective
թանաքամանով	Noun
արցունքները	Noun
պատուհանում	Noun
մարգագետիններ	Noun
սուսերամարտիկ	Noun
ոստրեներիցդ	Noun
հեղաշրջումներիդ	Noun
ցանկացավ	Verb
ժանիքներից	Noun
ահաբեկչական	Adjective
ինքնագրին	Noun
առագաստանավով	Noun
զարթօնքի	Noun
օղակներից	Noun
պոկերներով	Noun
ընդգծող	Participle
ազնվամորու	Noun
երդիքներում	Noun
շերեփուկները	Noun
գնահատում	Verb
ուզեն	Verb
բառակապակցություններ	Noun
քաղցից	Noun
աճպարարությունը	Noun
վարչապետները	Noun
համերգներում	Noun
ազգականներին	Noun
ուսուցիչներից	Noun
ճակատագիրը	Noun
հաշվումներով	Noun
ծայր	Noun
թաիս	Noun
ձմերուկի	Noun
շտկում	Verb
պառակտություններիցս	Noun
շքերթներ	Noun
աքիլեսյան	Adjective
կարապ	Noun
ուղտի	Noun
ոսկրի	Noun
տետրի	Noun
ուսուցանելու	Verb
քննությանը	Noun
աճեցնեն	Verb
սովետական	Adjective
շափյուղաներիցս	Noun
ածանցներով	Noun
հրավեր	Noun
մոլեգնող	Participle
տժվժիկ	Noun
թենիսին	Noun
պայմանների	Noun
ընդեղենի	Noun
աղանդավորներ	Noun
մասնիկները	Noun
անվտանգությունից	Noun
լատինականներդ	Adjective
լուս	Noun
պորտում	Noun
զարկերակով	Noun
թամաշաներիցս	Noun
փորեցի	Verb
մոլեկուլի	Noun
բուժքույրեր	Noun
անդամով	Noun
կատակների	Noun
բարգավաճում	Adjective
կղկղանքը	Noun
ահ	Noun
քավելու	Verb
խորհրդանշեն	Verb
խեթերենի	Noun
ագուցահանած	Participle
սառուցյալ	Adjective
հնագետները	Noun
լրացումներից	Noun
ճոռոմաբանականիցդ	Adjective
մարզադաշտերից	Noun
ձայնդարձերովս	Noun
շախմատին	Noun
վանկերի	Noun
ժողովուրդների	Noun
երգիծանքի	Noun
գարու	Noun
ստադիոններիցս	Noun
խելախոսներով	Noun
տաճկերեն	Noun
մրցույթով	Noun
կծելու	Verb
սվիններով	Noun
ապստամբող	Participle
հնդիկ	Noun
ներկայացուցչության	Noun
ավագների	Adjective
աղվամազ	Noun
գտածոները	Noun
այցը	Noun
չհյուսեին	Verb
էջին	Noun
սպունգները	Noun
առն	Noun
շտապելու	Verb
ձեռովս	Noun
կտարվեին	Verb
չգրադարձել	Verb
շփագիտականդ	Adjective
անթներիցդ	Noun
համաշխարհայիններովդ	Adjective
կինոների	Noun
թաքցնեն	Verb
ալիս	Adjective
հողմեր	Noun
կարելին	Adjective
կռնակ	Noun
քարտը	Noun
տակառներ	Noun
հնարավոր	Adjective
այծենուն	Adjective
փաստաթղթի	Noun
քննադատը	Noun
ոսկրերով	Noun
չհանգստանայիք	Verb
ավանդություններով	Noun
նավատորմով	Noun
ծովախորշում	Noun
հինդիի	Noun
գայթակղում	Verb
դոդերում	Adjective
կիրճերի	Noun
տեւումս	Noun
աստղադիտարանները	Noun
մերսումը	Noun
ռեֆորմ	Noun
հովանի	Noun
տպիչները	Noun
տղամարդու	Noun
ապենինյան	Adjective
ոտանավորով	Noun
երը	Noun
թիթեռնիկների	Noun
ունկնդիրներ	Noun
պատկերած	Participle
մանդարինը	Noun
սիրահարների	Noun
աղերս	Verb
փյունիկի	Noun
ալգորիթմներից	Noun
հասկանալի	Adjective
լազերները	Noun
կհետազոտեն	Verb
կաթսաներ	Noun
մետրանոցներ	Noun
չցանկացող	Participle
կխրտնես	Verb
թոքաբորբից	Noun
մերկանում	Verb
մզկիթներին	Noun
ձուլեն	Verb
ամուսնությունների	Noun
սպիրտ	Noun
պետերը	Noun
ձագեր	Noun
բանականությանը	Noun
յոգուրտ	Noun
ճյուղերով	Noun
դոլարներով	Noun
սարավանդներով	Noun
հեկտարի	Noun
միությունից	Noun
հացահատիկ	Noun
ճամբար	Noun
ակնոցների	Noun
կալբասները	Noun
ոգեշնչումս	Noun
բոռ	Noun
հալածանքին	Noun
տանիքներով	Noun
աշտարակների	Noun
ազնավոր	Noun
խառնվածքը	Noun
ֆունտը	Noun
չզգածվեց	Verb
ձվաբջիջները	Noun
լեզվաընտանիքներ	Noun
չհամենաք	Verb
թվանքներիցս	Noun
ջայլամները	Noun
երկաթգիծը	Noun
կրծքից	Noun
ճոռոմաբանությունների	Noun
մորենին	Noun
պահածոյի	Noun
հուներում	Noun
լողակի	Noun
ծարավիներին	Adjective
ֆլեյտայի	Noun
կողերի	Noun
անորոշի	Adjective
որովայնին	Noun
զգացմունքներ	Noun
խնամք	Noun
նվագախմբեր	Noun
արարյալ	Adjective
պահպանեցիք	Verb
հայրեր	Noun
ստեպղին	Noun
հույներին	Noun
ուսուցիչներին	Noun
աքաղաղի	Noun
տեգ	Noun
գետակից	Noun
ձկնկուլի	Noun
գունի	Noun
կվիճեն	Verb
արտասահմանին	Noun
փոխհատուցող	Participle
չուդ	Noun
օմանական	Adjective
արծաթեովդ	Adjective
կնազես	Verb
շեշտող	Participle
վերադարձին	Noun
իսպանացիները	Noun
ուսումնասիրեցին	Verb
բոստան	Noun
գլխիս	Adjective
հռովմեականների	Adjective
շնորհող	Participle
կեսով	Noun
հրդեհի	Noun
պանիր	Noun
վեճերով	Noun
ճիճու	Noun
վզիկով	Noun
բողոքարկում	Verb
ազգությունից	Noun
տելուրը	Noun
մարզդ	Noun
կանչեն	Verb
արձագանք	Verb
կայանային	Verb
լեմուրը	Noun
առաջավորներ	Adjective
վեճի	Noun
սլավոնները	Noun
պատվիրակություններովդ	Noun
հակասեմիտականության	Noun
համբավներս	Noun
պատճենում	Noun
տարօրինակների	Adjective
հուլիսի	Noun
խառնաշփոթության	Noun
խոպոպիքներս	Noun
պարտվելու	Verb
գնչուները	Noun
չմոգոնեիք	Verb
դարձվածք	Noun
թվիստի	Noun
շահագործելու	Verb
լամաներդ	Noun
վարսակ	Noun
ալքիմիկոսների	Noun
ակնհայտ	Adjective
չառաքենք	Verb
բուսականումդ	Adjective
բացառություն	Noun
աչեր	Noun
կկրի	Verb
քաղաքականությունից	Noun
գետաձիերից	Noun
սպուտնիկումս	Noun
զանգահարեց	Verb
սիգ	Noun
նեղանալ	Verb
արերիցդ	Noun
ճամբարներ	Noun
պակասի	Adjective
ճամբարներում	Noun
հունը	Noun
որսալու	Verb
խթանների	Noun
անցգայացի՛ր	Verb
ապրանքների	Noun
առաջադեմներովս	Adjective
սաղավարտները	Noun
կաղամարներ	Noun
սառելու	Verb
պայմանագրերում	Noun
պաղպաղակը	Noun
ստուգեց	Verb
ճեմասրահովդ	Noun
կանխող	Participle
ռեստորանիցդ	Noun
գերմանականներումս	Adjective
հուշանվերների	Noun
հնդիկներին	Noun
ծաղրով	Noun
սփռեց	Verb
տարամիտում	Verb
իտերբիումի	Noun
գրասենյակ	Noun
ապրուստը	Noun
տարաները	Noun
կարճառոտովդ	Adjective
վասալներին	Noun
այցերը	Noun
սանդերը	Noun
տուփ	Noun
կհուզի	Verb
ուժեղացան	Verb
հարբում	Verb
ամուսնացնել	Verb
ռադիոյից	Noun
սառնամանիքին	Noun
քիմիկոսների	Noun
համոզկերովս	Adjective
ձորին	Noun
ագահեիր	Verb
կարմիրին	Noun
հնարամիտը	Adjective
մեքենա	Noun
հելլենների	Noun
ձուլարանների	Noun
արմունկը	Noun
վարչապետներ	Noun
ամպրոպդ	Noun
մեկնաբանությունից	Noun
ոսկորներով	Noun
էներգիայից	Noun
եռացած	Participle
հրեայի	Noun
դաշտամուկս	Noun
նպաստեցին	Verb
սպառնալիքները	Noun
նեոններս	Noun
լիգայից	Noun
պարասրահներումս	Noun
նուկլոններից	Noun
բնաբան	Noun
պլուտոնիումի	Noun
վիների	Noun
ամրակազմներումդ	Adjective
մեներգը	Noun
բազմոցին	Noun
պայմանագրից	Noun
եռանդոտիս	Adjective
կիբեռնետիկաներդ	Noun
թանգարաններին	Noun
ջանացած	Participle
խխունջը	Noun
նյարդից	Noun
չշփոթեն	Verb
սերնդումս	Noun
հոբելյարներդ	Noun
յուղաներկերով	Noun
ներկայացուցչություն	Noun
զուգարաններ	Noun
արս	Noun
չխոթես	Verb
գալակտիկաներից	Noun
կազդի	Verb
առանցքներիցս	Noun
նավաստու	Noun
արտաքինով	Adjective
ահեղ	Adjective
թաթուլի	Noun
ֆաշիզմիդ	Noun
վաղվա	Noun
վայրկենական	Adjective
խութի	Noun
թաթերով	Noun
թարգմանած	Participle
մտադրող	Participle
անշարժս	Adjective
ակումբներով	Noun
զոմբիով	Noun
գարշումդ	Adjective
միջատին	Noun
կառավարություններից	Noun
գառնարած	Noun
ալյումինով	Noun
ավելացրած	Participle
օազիսները	Noun
տարիքից	Noun
չթարգմանել	Verb
մանկապարտեզը	Noun
բոզբաշովս	Noun
շքամուտքով	Noun
ազգություն	Noun
կանխամտածվածիցդ	Adjective
արագացում	Noun
հողմը	Noun
արփին	Noun
մեծաբանովդ	Adjective
տառեխը	Noun
փողոտես	Verb
անկանեցիք	Verb
հագեց	Verb
պուլսարի	Noun
հոդվածներին	Noun
փուլերի	Noun
մյուռոն	Noun
լուսանկարը	Noun
համառեր	Verb
մետրերով	Noun
էներգիայի	Noun
նեղացած	Participle
խեղաթյուրում	Adjective
տաճարները	Noun
բնական	Adjective
վերջինին	Adjective
սուզանավ	Noun
հուշարձանից	Noun
ճանապարհորդությունները	Noun
հնձանը	Noun
ջիլը	Noun
տերտերը	Noun
ծաղրելու	Verb
սկզբնաղբյուրի	Noun
անհատակս	Adjective
թաղած	Participle
սերմերից	Noun
սագերը	Noun
չվելու	Verb
մետաղով	Noun
հաճարենու	Noun
թով	Verb
փախցրել	Verb
հեղափոխությամբ	Noun
պիստակ	Noun
բենզինով	Noun
ատոմների	Noun
որովայնում	Noun
ախոյան	Noun
հողդողդեցինք	Verb
տղամարդկանց	Noun
տեղյակ	Adjective
լոտոյի	Noun
ձեռներս	Noun
մշուշը	Noun
ավշի	Noun
մղոնի	Noun
ստեղծագործություններից	Noun
օտարոտի	Adjective
հյուրանոցը	Noun
հանգ	Verb
անհրաժեշտս	Adjective
գանգրաշուքներդ	Adjective
խաչերից	Noun
թիթեռներ	Noun
արխիվներից	Noun
չձաղեիք	Verb
հաղորդումներով	Noun
ակնոց	Noun
խոշորներից	Adjective
մարմարիս	Noun
թրթուրը	Noun
սանդը	Noun
վտարումից	Noun
երակ	Noun
ոտանավորը	Noun
հյուպատոսություններ	Noun
խրձերը	Noun
փախի	Noun
արկղի	Noun
նախադասություններից	Noun
արհեստավորներ	Noun
կվասը	Noun
չսլանաս	Verb
կոչումներիցդ	Noun
պարսիկները	Noun
ալերի	Adjective
բառագիրք	Noun
լուծելիս	Verb
հալելու	Verb
տասնամյակից	Noun
տնակի	Noun
վարուժանը	Noun
ունկնդրած	Participle
պարզորոշ	Adjective
բուրդը	Noun
բանաստեղծները	Noun
պիոններ	Noun
առատուկներովդ	Noun
կասկածելիությունների	Noun
երկանքում	Noun
կթարգմանեք	Verb
կալա	Verb
հայտնելու	Verb
սառույցներդ	Noun
զսպանակներով	Noun
կարտեր	Noun
աջակցելու	Verb
քահանաներից	Noun
բուրբոններին	Noun
մետաղներում	Noun
ուրիշի	Adjective
ամիկ	Noun
պարսիկ	Noun
յուղերի	Noun
սպերմա	Noun
լուծեց	Verb
կալվածքներից	Noun
բորբոքումովս	Noun
սառնիցս	Adjective
խորհրդարանը	Noun
քչերը	Adjective
ատրճանակների	Noun
արվեստ	Noun
վրդովված	Participle
տեսք	Noun
ախտորոշումը	Noun
ակնածանքից	Noun
բանասիրություն	Noun
արարողություններիցդ	Noun
ապահովող	Participle
այծքաղների	Noun
գնչուերենիդ	Noun
սովորույթների	Noun
կղզիներին	Noun
համարեն	Verb
մասուրիցս	Noun
չբուծեիք	Verb
հեղափոխություններին	Noun
ավտովարորդդ	Noun
գրչատուփերով	Noun
բացառիկության	Noun
հարաբերությունից	Noun
կմրցեն	Verb
պատուհաններից	Noun
հյուսիսայինը	Adjective
ստորագրություններում	Noun
տույժ	Noun
բջիջներից	Noun
հոբելյանին	Noun
թալիում	Noun
խաչմերուկներում	Noun
մրցակցից	Noun
սելենի	Noun
մայրաքաղաքներին	Noun
կլուծեն	Verb
պարող	Noun
մասնագիտություններով	Noun
գրառող	Participle
կռունկ	Noun
քաղցկեղից	Noun
կատեգորիան	Noun
իլիկ	Noun
հոլով	Noun
ականջից	Noun
սափորներով	Noun
գյավուր	Noun
փոխվարչապետ	Noun
ոսպնյակների	Noun
ճոճաթոռը	Noun
հնչույթը	Noun
անկախ	Adjective
մեղադրեն	Verb
աբորտների	Noun
կապարճներ	Noun
հանքերով	Noun
հերոիններս	Noun
ծիրանենի	Noun
մասունքների	Noun
չգանգրվեի	Verb
վերելակներով	Noun
կենսաֆիզիկա	Noun
կարողանաք	Verb
հնարքից	Noun
խույրերը	Noun
հայեցակարգեր	Noun
բաժանումների	Noun
գլխարկով	Noun
խաղալիքից	Noun
բարբառները	Noun
ուսերով	Noun
հյուրանոցներին	Noun
խաղալիքներիդ	Noun
անհրաժեշտիդ	Adjective
մարտակառքով	Noun
բուժքրոջիցս	Noun
ամերիցիումդ	Noun
արտադրությունում	Noun
ամսագրի	Noun
հնի	Adjective
կարիճների	Noun
պանիրների	Noun
կաչաղակների	Noun
ամբոխի	Noun
լոբով	Noun
արտասուքը	Noun
ծածկույթներից	Noun
կուղեկցի	Verb
հեծանիվի	Noun
ելուզակների	Noun
կոշկեղենի	Noun
արեգին	Noun
կաթնուկ	Noun
մայրցամաքներից	Noun
աբխազերեն	Adjective
մարգագետինները	Noun
պողոտաներից	Noun
փքունություններս	Noun
սանդուղքների	Noun
կիրճերը	Noun
ունակությունները	Noun
այտուցներով	Noun
վայրեր	Noun
երշիկների	Noun
ռեստորաններ	Noun
յաղութներովս	Noun
խորհրդանշող	Participle
արգանակների	Noun
ֆիզիկոսի	Noun
չջեռուցեմ	Verb
գովազդում	Noun
կապտավուններիդ	Adjective
հողեղեն	Adjective
ասպետ	Noun
էրեկը	Noun
կեռնեխի	Noun
դաշնությունում	Noun
մորուքի	Noun
քյոմուրս	Noun
չորացնելու	Verb
վախճանից	Noun
ուղղությամբ	Noun
հեքիաթը	Noun
շարահյուսությանը	Noun
վարկածը	Noun
պոմպ	Noun
տեղեկության	Noun
չխառնել	Verb
առու	Noun
բորոտ	Adjective
չմխիթարող	Participle
ճարտար	Adjective
ձագերին	Noun
իմպերիալիստները	Noun
ֆուտբոլիստ	Noun
թագուհի	Noun
ֆիջիականիցս	Adjective
լեղապարկի	Noun
պանդոկի	Noun
ռեփս	Noun
տրոլեյբուսի	Noun
հաղորդումում	Noun
առաքյալների	Noun
կերտվել	Verb
կոպեր	Noun
կաղինները	Noun
թեղուս	Noun
նախագահությունից	Noun
մարդագայլի	Noun
անմարդաբնակ	Adjective
ավազակներ	Noun
հոլմիումներով	Noun
լաստենուս	Noun
թոռնիկի	Noun
հավատայինք	Verb
ապարանքներ	Noun
աղքատներ	Adjective
ստիպեն	Verb
օսմանականով	Adjective
նախասրտերիցդ	Noun
երգիծաբանի	Noun
քաղաքացիություններին	Noun
երակը	Noun
չպեղեիր	Verb
թրթուրներով	Noun
կորտերովդ	Noun
նորվեգերեններով	Adjective
անհանգիստ	Adjective
մաճառին	Noun
նշագեղձերը	Noun
կղզով	Noun
բնակչություն	Noun
քշած	Participle
ռեակցիաներում	Noun
դրվատեիր	Verb
վարորդներին	Noun
մարկից	Noun
գործազրկության	Noun
ավազաքարերի	Noun
չվող	Participle
ճակնդեղից	Noun
նախապատմություններդ	Noun
պատճեերում	Noun
միացրած	Participle
հայտարարումը	Noun
արմավենի	Noun
սովորույթի	Noun
օրորումդ	Noun
լանջքումդ	Noun
հաղարջենի	Noun
ոլոռներում	Noun
փուլ	Noun
արամեացիները	Noun
սնդիկ	Noun
հեղեղվել	Verb
հոյաշեն	Adjective
թարգմանիչը	Noun
ահից	Noun
քարափներ	Noun
սամարիումովդ	Noun
մալուխի	Noun
բոստանովս	Noun
քրդերը	Noun
ընտրվող	Participle
ծանրությունից	Noun
կառավարություններ	Noun
թերակղզուն	Noun
բազալտների	Noun
կամարիս	Noun
մաքի	Noun
կավի	Noun
գանձարան	Noun
ջանասիրությամբ	Noun
ղազախից	Noun
խալերից	Noun
ատոլներից	Noun
խրճիթից	Noun
խոցող	Participle
ճոպանը	Noun
ճիգերով	Noun
պարզերից	Adjective
տարիքով	Noun
խորդուբորդ	Adjective
ձագը	Noun
քարտ	Noun
շախմատը	Noun
ավիշը	Noun
երկրաշարժի	Noun
կանգնենք	Verb
նիստերովդ	Noun
տեւեց	Verb
նորություններին	Noun
գերդաստանների	Noun
մայրուղիներից	Noun
զարդենի	Noun
քերականություններս	Noun
կոմբայն	Noun
հեծելազորին	Noun
արքայիդ	Noun
քայլերին	Noun
պարաշյուտներին	Noun
տափաստաններովս	Noun
փախցնելու	Verb
կազմակերպությունից	Noun
թեն	Noun
բեկորների	Noun
պանդոկովս	Noun
նավթադոլարներով	Noun
ճառերի	Noun
շրջահայաց	Adjective
առաքվել	Verb
չինացիների	Noun
թագի	Noun
մատուռները	Noun
իռացիոնալներից	Adjective
փիլիսոփան	Noun
զարթօնքը	Noun
կողովներ	Noun
գետակներ	Noun
խորենացի	Noun
խղճում	Verb
չղջիկները	Noun
խութը	Noun
խրոխտագինով	Adjective
գլուխներում	Adjective
կիլոմետրեր	Noun
ինդիում	Noun
հետազոտողներից	Noun
ատոմային	Adjective
վերջածանցներ	Noun
շարժեր	Noun
արքունիքի	Noun
երկայնքը	Noun
արջերի	Noun
կուսակցությունը	Noun
հրապույր	Noun
հերքումը	Noun
նորույթները	Noun
փետրվարին	Noun
բարձեցին	Verb
օդակայաններիցդ	Noun
ռինգերը	Noun
ջահուկցովս	Noun
տարիքը	Noun
անդեորդովս	Noun
աքսորման	Noun
գնդակահարության	Noun
բանականներին	Adjective
խթանեցին	Verb
հավատքից	Noun
չզրնգացինք	Verb
լատինական	Adjective
առաջատարները	Adjective
ուսանողներին	Noun
գերդաստանի	Noun
բիզոնին	Noun
վնասվածքին	Noun
թիթեղից	Noun
շնորհից	Noun
հոդվածներից	Noun
տարածքների	Noun
կվճարեիր	Verb
մեխանիզմից	Noun
բազալտները	Noun
նանով	Noun
բռնաբարության	Noun
կենսուրախ	Adjective
պահեստներում	Noun
արժեքներով	Noun
աղիքում	Noun
ֆագոտ	Noun
սպիտակուցներին	Noun
կոստղաշատիցս	Adjective
աշուղները	Noun
հարցուկիցս	Noun
լողավազանում	Noun
մկանունքի	Noun
տերմինով	Noun
համբավավորներումս	Adjective
տարածությամբ	Noun
պատյանների	Noun
փղերին	Noun
ոստիկանի	Noun
արվեստագետի	Noun
փռշտացել	Verb
զարմուհու	Noun
հայուհիների	Noun
բացատրություններից	Noun
հրեշի	Noun
քեֆ	Noun
սոուլը	Noun
արարածներին	Noun
աթլետիկայի	Noun
արագ	Adjective
փչելու	Verb
գագաթնաժողով	Noun
վակուումով	Noun
աբրեշումիս	Noun
հիգիենային	Noun
ընդդիմություն	Noun
զանգակը	Noun
տառապանքներից	Noun
նշենի	Noun
հանրագիտարանը	Noun
ավանակը	Noun
տոկոսը	Noun
ձվաբջիջներ	Noun
առանցքներից	Noun
պարտիզաններին	Noun
նվագախմբով	Noun
գոս	Noun
վարելու	Verb
հակասեմիտականություններ	Noun
չմտադրվեն	Verb
ջրաքիս	Noun
ալմանախներում	Noun
լերդաբույթերովս	Noun
հերքեց	Verb
ապաշխարում	Verb
քեռորդիներին	Noun
փորոքը	Noun
չսպանել	Verb
ժանրը	Noun
քարտաշների	Noun
կախարդական	Adjective
անտիցիկլոնի	Noun
ուռեր	Verb
լոբին	Noun
հայդուկների	Noun
նեղուցներով	Noun
նինջայի	Noun
տույժերս	Noun
ինքնասպանություն	Noun
կողմով	Noun
շուկաներից	Noun
հալածանք	Noun
փարպեցի	Noun
ակկոյունլուների	Noun
գորշուկի	Noun
երկաթգիծ	Noun
տեքստում	Noun
մզկիթներով	Noun
հավաքածուներում	Noun
արշիպելագը	Noun
բոժոժի	Noun
պալասատովիները	Adjective
պատկերեց	Verb
անգյալովս	Adjective
կենսագրություններ	Noun
ձեթերի	Noun
գնող	Participle
բիզնեսները	Noun
ցուցանակների	Noun
քաղաքովս	Noun
նավատորմը	Noun
խաղաքարտերի	Noun
հասցնող	Participle
տրամաբանությանը	Noun
բնակչով	Noun
սենյակներով	Noun
նիշով	Noun
փաստերին	Noun
զարդարանքներ	Noun
զգուշացումներումդ	Noun
ճիգեր	Noun
կատալիզատորներով	Noun
ատամանի	Noun
կակտուս	Noun
հեյզեր	Noun
կոկտեյլներ	Noun
զղջալու	Verb
բաճկոնով	Noun
հատկացրեց	Verb
վերջինի	Adjective
տառապող	Participle
բացատրությունները	Noun
հատկանիշները	Adjective
մուշ	Noun
նավթին	Noun
վհուկներ	Noun
մեղադրող	Participle
խեցգետինները	Noun
հուշանվեր	Noun
գովազդով	Noun
պղնձաձույլ	Adjective
խորհուրդ	Noun
համացանցից	Noun
հնագետը	Noun
չկախարդվող	Participle
բառակապակցությունից	Noun
չերկբայես	Verb
բժշկագիտությունը	Noun
կթոտներից	Adjective
թուլացել	Verb
մոլորակներով	Noun
ռուբլով	Noun
մանաթի	Noun
փաշան	Noun
հրեշներից	Noun
անորոշությունը	Noun
ուրախը	Adjective
ստորագրությանը	Noun
կնքվել	Verb
շատանում	Verb
տեղեկատվություններ	Noun
ակադեմիային	Noun
չայի	Noun
ծառայելիս	Verb
սաղմոնովդ	Noun
էսպերանտոն	Noun
հայացքներից	Noun
քննությամբ	Noun
նկարչին	Noun
կենդանաբան	Noun
վաշտերից	Noun
ուրարտական	Adjective
հնչյունների	Noun
ռուսին	Adjective
գործիքներ	Noun
կախարդված	Participle
ողբերգություն	Noun
վիճակների	Noun
գամփռի	Noun
կնպաստեր	Verb
արտասանությանը	Noun
ճանդաններին	Noun
խալերի	Noun
ապուրը	Noun
սանձահարես	Verb
նեոդիմի	Noun
սառնարան	Noun
մուճակովս	Noun
մատուցած	Participle
ձուլեինք	Verb
ղեկավարին	Noun
գանգրավարսով	Adjective
հպատակվում	Verb
քամակներով	Noun
մտավորին	Adjective
խնձորներով	Noun
ազգագրական	Adjective
վարորդին	Noun
քսիլոֆոններովս	Noun
նախադասության	Noun
բացման	Noun
արագացմամբ	Noun
ոռոգում	Verb
ջուլհակ	Noun
հոբելյարները	Noun
հայտնեց	Verb
ճիգերի	Noun
հրաշքով	Noun
հարսնազգեստիս	Noun
ոսպնյակներից	Noun
փարավոնների	Noun
ծղոտը	Noun
քանակից	Noun
դադարին	Noun
հիմունքի	Noun
ձեռնաշարժությունը	Noun
տենչում	Verb
հոլովումներիցս	Noun
տառապանքներով	Noun
տղամարդուն	Noun
ապուրների	Noun
կոկոսներից	Noun
փուշթու	Noun
ներողությունումս	Noun
քերականական	Adjective
մութը	Adjective
աստղաբույլ	Noun
գերմանացին	Noun
դիվերգենցիան	Noun
մանիշակս	Noun
խիզախի	Adjective
տպիչների	Noun
ցածրից	Adjective
դիրհամ	Noun
լուսատտիկների	Noun
ճոճանակիցս	Noun
ռուսականից	Adjective
ցլամարտ	Noun
ստիպում	Verb
զարդարանքով	Noun
բարելաված	Participle
դառնենուդ	Adjective
թուլիումի	Noun
պատվերներով	Noun
եպիսկոպոսներ	Noun
ուղիղս	Adjective
հոգատար	Adjective
աքերին	Noun
պատկերեն	Verb
բառապաշարի	Noun
ասորու	Noun
սկզբնաղբյուր	Noun
ծորան	Noun
ամիճի	Noun
պնդուկը	Noun
ծառայություններից	Noun
մոլուցք	Noun
տեսախցիկի	Noun
հեռավորությանը	Noun
մրցույթ	Noun
մեդալներով	Noun
բարձրավանդակներում	Noun
չհատակեցինք	Verb
մրսում	Verb
սիրահարներին	Noun
համաներմամբ	Noun
մեծանում	Verb
խուրմաներից	Noun
ամսվանից	Noun
պարտեզներ	Noun
թանգարաններից	Noun
նատրիումի	Noun
յուղդ	Noun
անհրաժեշտությամբ	Noun
սգացող	Participle
ներդաշնակներումդ	Adjective
անգլիացունս	Noun
գյուղացու	Noun
ընթերցասրահի	Noun
օսեթականներումս	Adjective
միակի	Adjective
գոգերը	Noun
թեորեմ	Noun
չարիքների	Noun
ավանդույթներում	Noun
ցինկից	Noun
տագերկնոջովդ	Noun
շշնջում	Verb
ելույթներից	Noun
լիբրետոն	Noun
գերդաստանով	Noun
բենզինի	Noun
գերմանացու	Noun
երկը	Noun
խոյացած	Participle
կիբեռնետիկան	Noun
մատենագիտությունը	Noun
ապրանքին	Noun
ճագարներդ	Noun
հասուններից	Adjective
երկաթյա	Adjective
հայտարարեց	Verb
հարսին	Noun
բկի	Noun
իրականությունները	Noun
վերքը	Noun
խցիկից	Noun
գործարկվել	Verb
դեղաբույսերից	Noun
մկանների	Noun
գրասենյակի	Noun
ծիլերը	Noun
միապետություններում	Noun
գեղարդի	Noun
եղեւնի	Noun
գործարաններում	Noun
կողպէքումդ	Noun
պուրակներում	Noun
պատրաստով	Adjective
հասարակածը	Noun
հաստատունները	Adjective
սրբուհու	Noun
այրվեց	Verb
բարդություններից	Noun
հաղարջ	Noun
բարբառներ	Noun
արհեստանոցի	Noun
լողավազաններ	Noun
սենատը	Noun
հյուծե՛ք	Verb
ծովեզերքը	Noun
ներքնակի	Noun
մնջախաղերի	Noun
պարողներին	Noun
փաղանգին	Noun
սփռոց	Noun
համերգասրահին	Noun
չվճարած	Participle
էլիպսը	Noun
հոկեյում	Noun
սարյակներովս	Noun
ճանապարհորդություններով	Noun
չմոտեցնեիք	Verb
կողմերի	Noun
գոմաղբը	Noun
մշակույթ	Noun
բազկաթոռը	Noun
վարկածներով	Noun
քծնում	Verb
հրեային	Noun
կայքին	Noun
մարտիրոսի	Noun
զգուշացումներ	Noun
լաստանավերի	Noun
մումիա	Noun
կշռելու	Verb
սառույցը	Noun
բաճկոնների	Noun
մատերիալիզմին	Noun
չերգիծեցիք	Verb
մակերիկամներում	Noun
հանգամանքների	Noun
տարածությունները	Noun
զոհասեղանին	Noun
ժամադրություն	Noun
սաունա	Noun
մարդաբանները	Noun
սարդենովդ	Noun
արածեցին	Verb
չօծենք	Verb
չնեղանան	Verb
անտարբերությունը	Noun
վաճառքին	Noun
քակորները	Noun
աղքատը	Adjective
մանաթումս	Noun
ատոմներին	Noun
կազակի	Noun
ործկալիս	Verb
պատուհանի	Noun
աթոռակից	Noun
սիբիրախտը	Noun
ֆոտոններ	Noun
հորանջեցի	Verb
թրծած	Participle
մեգի	Noun
մամուռից	Noun
չթքես	Verb
ավագանու	Noun
առագաստանավումդ	Noun
հրամանում	Noun
խմբագրվել	Verb
ընկղմեինք	Verb
կոչմամբ	Noun
օդանավով	Noun
աթեիզմի	Noun
սառցադաշտի	Noun
սահմանեց	Verb
պողպատները	Noun
կացինները	Noun
մումիայի	Noun
տրոմբոն	Noun
ռոբոտին	Noun
մաղթեց	Verb
ներս	Noun
ստուգումները	Noun
մարկիզի	Noun
տեսակին	Noun
մյուռոնովդ	Noun
հասցեում	Noun
առնետը	Noun
վեղարը	Noun
շարժումների	Noun
բնորոշվել	Verb
փռյուգերենը	Noun
գյուտ	Noun
ախտորոշելու	Verb
գոհանամ	Verb
կողքին	Noun
գյոզ	Noun
մոլախաղումս	Noun
ֆրանսիացիների	Noun
քմծիծաղով	Noun
եպիսկոպոսներից	Noun
անշուքներիցդ	Adjective
չկործանեիր	Verb
գուշակությունը	Noun
պատանիներ	Adjective
ֆոնոն	Noun
բարդություն	Noun
լավագույնով	Adjective
ալյանսը	Noun
կենտրոններին	Noun
չզոդեինք	Verb
համեմունքներով	Noun
մեծաշքեղություններում	Noun
փտում	Verb
անմոռուկներ	Noun
ձողեր	Noun
թաթարներ	Noun
ողբերգությամբ	Noun
մթության	Noun
շնաձուկ	Noun
ծոծրակին	Noun
երկար	Adjective
երիցուկներից	Noun
պահպանած	Participle
լոգարան	Noun
թակ	Noun
ցեղին	Noun
պարտքի	Noun
տեսություններին	Noun
փորած	Participle
ինֆեկցիա	Noun
վիրուսից	Noun
պատշգամբները	Noun
հնչյունին	Noun
կայսրուհին	Noun
հոռովելիցս	Noun
մարկիզովս	Noun
ծախերս	Noun
չխղճայիր	Verb
պատրաստության	Noun
թաթի	Noun
շիմպանզեները	Noun
պատվոգրերով	Noun
կիթ	Noun
կոչումներ	Noun
պարտիայում	Noun
միրգը	Noun
գոգեն	Verb
ջրաղացների	Noun
մայրցամաքներ	Noun
դառը	Adjective
մետրոպոլիտենի	Noun
արտասահմանում	Noun
մանուշակ	Noun
առերես	Verb
հարձակումներից	Noun
մթությունը	Noun
կրեցին	Verb
տարածությանը	Noun
վարսակի	Noun
նեյտրինոներին	Noun
կցորդիչներով	Noun
մայրուղիներում	Noun
հնացել	Verb
բժշկության	Noun
կտրոնի	Noun
կռանում	Verb
անմեռից	Adjective
ցուցանակ	Noun
գյուղացիս	Noun
հալածանքներին	Noun
արտոնագրով	Noun
թեմին	Noun
համառոտ	Adjective
արդարի	Adjective
օբյեկտին	Noun
խանութին	Noun
ամուսնացածումդ	Adjective
մերում	Noun
հարաբերությունների	Noun
թեփ	Noun
հատորը	Noun
ռեակցիայի	Noun
խխունջի	Noun
ծափահարություններով	Noun
արշավանքներով	Noun
որոճիցս	Noun
հեթանոսներ	Noun
լանջքից	Noun
խափանեց	Verb
ինքնագիրը	Noun
քարայրները	Noun
նեգրեր	Noun
խոհարարը	Noun
հեքիաթի	Noun
ողջույններ	Noun
մորմենիների	Noun
հարբեցինք	Verb
կենտրոնները	Noun
վաճառքից	Noun
պատմվածքներով	Noun
կվանի	Verb
պտղաբերում	Adjective
արդյունքին	Noun
հետազոտ	Verb
շարքայիններ	Adjective
ուղիները	Noun
հնագույնները	Adjective
վերադառնայինք	Verb
կհենեն	Verb
թութ	Noun
հալածանքը	Noun
վախը	Noun
շուրջպարը	Noun
քերականությանը	Noun
մոգեր	Noun
փայծաղներ	Noun
սպիտակներով	Adjective
ակումբը	Noun
կիպարիսը	Noun
թենիսիստներից	Noun
սրճարանին	Noun
հայտարարությունը	Noun
հղվել	Verb
լացի	Noun
ճահիճը	Noun
թավա	Noun
կայաններովս	Noun
հասցեին	Noun
կայծակներ	Noun
բոսորներիցս	Adjective
գլխարկին	Noun
ակնոցով	Noun
հատկանիշներից	Adjective
հղիության	Noun
կուսակցություններին	Noun
լեռնագրականս	Adjective
խիթ	Noun
օձաձուկը	Noun
չլքնենք	Verb
փուշթուում	Noun
վասալին	Noun
պայմանավորած	Participle
քարայրներից	Noun
լեզվանի	Adjective
սպիներով	Noun
կնքում	Verb
էսօր	Noun
սերնդի	Noun
հարդը	Noun
շվեդ	Noun
վարազ	Noun
շքեղություն	Noun
ռոբոտի	Noun
բարիում	Noun
ստեղնաշարիցդ	Noun
մաքառելիս	Verb
կանչվել	Verb
հաստոցներ	Noun
փորոքներից	Noun
լուտեցիումը	Noun
երթուղով	Noun
արտագաղթից	Noun
ժանիով	Noun
տերություններ	Noun
հրդեհ	Noun
կազմակերպությունները	Noun
աստղագուշակություն	Noun
ինքնահողերից	Noun
գգվանքներումդ	Noun
երեւույթներովս	Noun
թռչունը	Noun
խայթը	Noun
ձմերուկին	Noun
ընթեռնեն	Verb
կողքերի	Noun
մեխակդ	Noun
բոլորշի	Adjective
վարակների	Noun
ցանցաճոճերի	Noun
խորաններում	Noun
անվտանգությամբ	Noun
հունվարյան	Adjective
բեյսբոլով	Noun
մկաններում	Noun
թելադրիչներից	Noun
գնդերը	Noun
Զատկից	Noun
տոներից	Noun
լայնությունների	Noun
շահավետիս	Adjective
կարկին	Noun
մոնիտորովդ	Noun
հառած	Participle
թենիսիստիս	Noun
երկարավուններովդ	Adjective
առէջքի	Noun
նամականիները	Noun
առյուծի	Noun
զգացմունքով	Noun
բանանը	Noun
քահանաներին	Noun
ոզնիների	Noun
տորֆեր	Noun
արմավենու	Noun
նեռին	Noun
անարդարներիդ	Adjective
մողեսներով	Noun
շապիկ	Noun
կոլխոզ	Noun
նիզակը	Noun
վեղարին	Noun
գլյուոնովս	Noun
ատոլների	Noun
կայունիդ	Adjective
կռիվներ	Noun
սիրուն	Adjective
ծեծում	Noun
գրախոսությունը	Noun
գլխարկներին	Noun
առասանս	Noun
ամիրսպասալարի	Noun
ազդում	Verb
ամորձակալիս	Noun
հայտնագործություններից	Noun
մարգագետինների	Noun
պարսիկներ	Noun
շվեդի	Noun
աղանդավորությունները	Noun
բավիղից	Noun
վայելող	Participle
ջինսի	Noun
խիթի	Noun
հայթայթում	Verb
լազերներում	Noun
իլիկով	Noun
կեռը	Noun
հոնքերի	Noun
արմունկներդ	Noun
արգելքին	Noun
դատարաններ	Noun
ծածկույթներ	Noun
կոստյումներով	Noun
հմայող	Participle
մամուռների	Noun
պղպեղ	Noun
հուսահատ	Adjective
ազատութիւններին	Noun
պուլսար	Noun
կաղինը	Noun
բացատրելիս	Verb
բարում	Adjective
պանթեոնը	Noun
շինարարը	Noun
թորշոմած	Participle
դիսպրոզիումը	Noun
հարթի	Adjective
հայտնագործություններում	Noun
փոքրի	Adjective
համաստեղության	Noun
համր	Adjective
չմոլեգնեն	Verb
դպրոցականներին	Adjective
պատգամը	Noun
չխարխալեցինք	Verb
համերգներ	Noun
լալոն	Noun
զորքեր	Noun
կաղամախու	Noun
արգելած	Participle
ամուսնություններ	Noun
պսակից	Noun
ապահովություն	Noun
պատկերասրահը	Noun
եր	Noun
բլթակներով	Noun
տաքսի	Noun
շուկաների	Noun
շավիղ	Noun
կարտերը	Noun
պայթեց	Verb
կրավորականներիցդ	Adjective
էրբիում	Noun
ճամբարդ	Noun
կարկանդակը	Noun
արքայազնին	Noun
օժիտ	Noun
մահափորձին	Noun
հյուսնի	Noun
ռոդիում	Noun
աստիճանավորում	Noun
գործադուլը	Noun
համոզեցին	Verb
ալաբաստրներս	Noun
ողբ	Noun
հրաբուխ	Noun
թալիումներումդ	Noun
բիրմաներենները	Adjective
բժշկությունից	Noun
հայլիներովդ	Noun
շվեդներին	Noun
աղորիքները	Noun
հիվանդություններին	Noun
սերնդին	Noun
հառնում	Verb
ծոծրակը	Noun
չճախրեն	Verb
ազգության	Noun
հագեն	Verb
բիրմաներեններումդ	Adjective
զեբրին	Noun
այգիներից	Noun
ուսանողին	Noun
կուժ	Noun
հեռուստատեսություններից	Noun
սիրեկանների	Noun
քվեարկողներին	Noun
ծորանին	Noun
կողքից	Noun
տարածությունների	Noun
լեզվաընտանիքների	Noun
փլվում	Verb
աղորիք	Noun
սպիտակուցներով	Noun
այգուց	Noun
երթուղու	Noun
կոկտեյլը	Noun
ակնածականներով	Adjective
փչեն	Verb
ակներեւ	Adjective
բամբասանք	Noun
արգոն	Noun
շփոթեցնող	Participle
կապիկի	Noun
խոչընդոտելու	Verb
քիչը	Adjective
ղպտիերեն	Noun
մժեղը	Noun
քիմիաների	Noun
կղմինդրով	Noun
արգելից	Noun
կիրառող	Participle
ծովաշներ	Noun
չկռվեիր	Verb
մկաններից	Noun
արեգակնայիններով	Adjective
վարձի	Noun
մեծանալու	Verb
դառում	Adjective
բժշկագիտությանը	Noun
ռեգգիի	Noun
նորերը	Adjective
տոմս	Noun
հելիումի	Noun
կփռթկացնեինք	Verb
շնաձկան	Noun
լորտու	Noun
բզեզ	Noun
լեյտենանտներիցդ	Noun
համաստեղություններից	Noun
հեշտոցային	Adjective
սոմալիում	Noun
ճակատագրով	Noun
արհեստականներս	Adjective
կաղամար	Noun
ապշում	Verb
մառոժնիներումս	Noun
հատիկ	Noun
բոյերիս	Noun
կաշխատեմ	Verb
ողջույններումս	Noun
օծելու	Verb
լճերում	Noun
կադմիումը	Noun
պատկերում	Verb
փոքրը	Adjective
խեժով	Noun
կայտառներին	Adjective
հանգամանքներով	Noun
խնամքով	Noun
կատարեր	Verb
հարկադրելու	Verb
նախադասություն	Noun
խմբագրեցիր	Verb
վեհ	Adjective
արագիլների	Noun
կոպ	Noun
շտեմարաններ	Noun
հափշտակումդ	Noun
չգեղգեղեին	Verb
կառավարում	Verb
հյուրանոցներ	Noun
տափիցս	Noun
ղեկավարությունդ	Noun
ոսկյան	Adjective
գիտակարգերի	Noun
մարգագետին	Noun
հորդորեց	Verb
անզգայացրեց	Verb
հրապուրում	Verb
տուփը	Noun
քանդակների	Noun
այգով	Noun
ընկերք	Noun
չինացիներ	Noun
բզեզի	Noun
անդաստանիցդ	Noun
սպարապետովդ	Noun
փուչ	Adjective
կխոյանար	Verb
հանվելու	Verb
մարթելու	Verb
կառչած	Participle
առնետներ	Noun
յուղը	Noun
նատրիում	Noun
օրգանիզմով	Noun
լրացումից	Noun
երազած	Participle
վիճում	Verb
վերնաշապիկի	Noun
կործանումս	Adjective
հացենիս	Noun
փաշա	Noun
խավարներիցս	Adjective
աղբանոց	Noun
արտիս	Noun
նուկլոնին	Noun
չտպենք	Verb
հորդոր	Verb
արսենը	Noun
ծղոտ	Noun
վերելակդ	Noun
խորենացու	Noun
սելավը	Noun
խլուրդ	Noun
կնճիթի	Noun
ծովակալի	Noun
ճանապարհորդություններից	Noun
չաքուչով	Noun
սերմ	Noun
հուսալքված	Adjective
քերականներ	Noun
աթեիզմը	Noun
ռազմիկներով	Noun
լամպոչկեքից	Noun
հիմարները	Adjective
պսակները	Noun
թվանշանը	Noun
զավտրիկներիդ	Noun
մագնեզիում	Noun
թեյնիկ	Noun
մեջտեղը	Noun
տատրակին	Noun
ճանկերում	Noun
աղեկ	Adjective
պարերին	Noun
հմայք	Noun
հիմնախնդիրներից	Noun
խորքերից	Noun
զարդենուդ	Noun
կաստաներ	Noun
ուսումներիս	Noun
չվերթներ	Noun
ծավի	Adjective
սպին	Noun
սրճագույն	Adjective
բաստուրմա	Noun
բոլորշիներով	Adjective
երաժշտությունից	Noun
գարշապարից	Noun
միջատներ	Noun
չստորագրեցիք	Verb
դեղատներից	Noun
էյնշտեյնիումիցս	Noun
տեսախցիկների	Noun
ձորիցս	Noun
ակնարկները	Noun
ֆլոմումդ	Noun
զարմացրեց	Verb
հղացավ	Verb
վեպից	Noun
չեմպիոններովդ	Noun
կղկղանքներումդ	Noun
ասպազենում	Noun
վագոնները	Noun
լավայի	Noun
չծնված	Participle
հարվածին	Noun
վանդակներից	Noun
շինվածքները	Noun
սուսերամարտ	Noun
տոհմից	Noun
հնագետներին	Noun
աննկուն	Adjective
ծնոտով	Noun
ծիրանին	Noun
որձերի	Adjective
վկաները	Noun
տարածության	Noun
ազդեցության	Noun
եղջյուրից	Noun
կսազեիք	Verb
բրոմի	Noun
աշուն	Noun
ընթերցումը	Noun
կոչենք	Verb
առնետները	Noun
մեծարոյիդ	Adjective
կրաքարերից	Noun
պետություններին	Noun
փաստաթղթերին	Noun
աքայական	Adjective
ստամոքս	Noun
լանչովս	Noun
քարշ	Verb
երկաթեներիցս	Adjective
ճանգերովս	Noun
փիլիսոփայությունում	Noun
ֆիլիպինական	Adjective
հուզիչ	Adjective
դեղաբոյսի	Noun
մրցավար	Noun
կոֆեովս	Noun
ներդրմամբ	Noun
կծնվեք	Verb
նավակատիք	Noun
հորդող	Participle
ծովախեցգետնի	Noun
վտանգը	Noun
պրազեոդիմի	Noun
տրամվայներ	Noun
այրվեր	Verb
աղանդերներ	Noun
վերնագրեր	Noun
ողջույններիցս	Noun
ամնիստիա	Noun
տրամաչափը	Noun
չվերթ	Noun
մուշտակներ	Noun
չսնգուրեք	Verb
մողեսը	Noun
մաղթում	Verb
բարիքներից	Noun
վիճակներից	Noun
ղայիշս	Noun
մեծությամբ	Noun
հնձանին	Noun
հարուստների	Adjective
փայտիկները	Noun
բակտերիաներով	Noun
չփորձեք	Verb
զրույցին	Noun
աշակերտուհու	Noun
այրվում	Verb
նախարարից	Noun
աճուրդին	Noun
մոնիտորին	Noun
սիրեկաններ	Noun
հնարքներից	Noun
հավատայի	Verb
փնջերի	Noun
ուրարտերենի	Noun
պոմիդոր	Noun
արտավարին	Noun
տխմարներս	Adjective
կազմությունը	Noun
տեղանուններումդ	Noun
սխտորի	Noun
ռեֆորմը	Noun
նախազգուշացումներին	Noun
ջանի	Noun
ճիզվիտները	Noun
համակարգիչ	Noun
ֆեոդալի	Noun
մանրէաբանների	Noun
սկեսուր	Noun
անվանը	Noun
պարտատոմսերը	Noun
ծիլը	Noun
պատմությունից	Noun
չարգելեցի	Verb
լայնատարածներիցս	Adjective
խտրականությունը	Noun
համոզեց	Verb
վտանգավոր	Adjective
չպատկերեին	Verb
կողմից	Noun
կիր	Noun
ռազմիկներին	Noun
շքերթը	Noun
սպիտակուցը	Noun
ծովածոց	Noun
քվազարներ	Noun
մերսում	Noun
արդյունաբերությունից	Noun
քննելու	Verb
արկած	Participle
խնձորից	Noun
ով	Noun
ստից	Adjective
Արշակունյաց	Adjective
մոլեն	Verb
նիզակներից	Noun
կղզիներից	Noun
ահեր	Noun
սկզբնատառերը	Noun
ծլիկը	Noun
վարորդը	Noun
պուպուլը	Noun
կաղամբը	Noun
մայրցամաքը	Noun
բացումից	Noun
երգչուհիներ	Noun
կնիրհեի	Verb
պատկանելիս	Verb
ակնաղբյուրումդ	Noun
ավանին	Noun
կուսակցությանդ	Noun
գրավիտոնը	Noun
աստվածներ	Noun
ատամնաբույժը	Noun
ամայացավ	Verb
ներկայացումներով	Noun
կարողացանք	Verb
դրդելու	Verb
կեսօր	Noun
բազեի	Noun
անգամով	Noun
ցեմենտը	Noun
ալիգատորների	Noun
ուցդ	Noun
գեղարդից	Noun
ոչխարի	Noun
արխիվիցդ	Noun
թերակղզում	Noun
մատյանում	Noun
քաղցկեղ	Noun
չափազանց	Adjective
քուֆտայովդ	Noun
վայր	Noun
տառադարձությամբ	Noun
հարթը	Adjective
օգուտը	Noun
վարակներով	Noun
կվասով	Noun
աշտարակով	Noun
նպաստեց	Verb
գորովեք	Verb
ճանկերը	Noun
ջայնիզմը	Noun
հանրապետությունների	Noun
թույլիցս	Adjective
բեղերով	Noun
զղջում	Verb
քրդերի	Noun
աղքատներին	Adjective
մաշարայովս	Noun
փաթեթներով	Noun
սպորտին	Noun
հեստապարերումս	Noun
հոգնածություն	Noun
վայրկենաչափին	Noun
փողահարներիս	Noun
աղաչանք	Noun
հելլենացովդ	Noun
պապայան	Noun
ծխից	Noun
պայմանավորվեց	Verb
տնտեսությունը	Noun
հրեշտակին	Noun
արարողության	Noun
ուկրաինական	Adjective
գթություն	Noun
զեբրի	Noun
այսբերգին	Noun
մեծահանդեսներս	Adjective
տոմարի	Noun
գովքովս	Noun
յուանի	Noun
հնգամյա	Adjective
մետրով	Noun
կոճակներովս	Noun
կխորովեիք	Verb
բուգը	Noun
նախասրահի	Noun
արագիլ	Noun
չագահեցի	Verb
վեճերի	Noun
չկիրառվեիք	Verb
ժողովածու	Noun
նվագող	Participle
բանտարկեցինք	Verb
բեւեռներովս	Noun
ամրոցներով	Noun
կառուցվածքներից	Noun
անկախությունից	Noun
գլեն	Verb
չարիքիդ	Noun
քանդակներից	Noun
մեկնաբանության	Noun
գնահատած	Participle
տեղեկությունների	Noun
ճանապարհորդությունից	Noun
նավակների	Noun
թռնել	Verb
կոնֆետներից	Noun
վալս	Noun
փարոսի	Noun
կերպը	Noun
պարբերությունները	Noun
թամբի	Noun
ողնաշարը	Noun
շաքարեղեգներին	Noun
կես	Noun
տեքստ	Noun
սվիտերից	Noun
ապառաժիս	Noun
բողոք	Verb
բացառում	Verb
սուզանավի	Noun
երգահաններից	Noun
արցունքներ	Noun
երիցս	Noun
խրախուսող	Participle
շահնշահը	Noun
մարտակառքերով	Noun
վհուկի	Noun
թերի	Adjective
մետաղներին	Noun
գետաձին	Noun
թոքախտի	Noun
կոբալտին	Noun
կկռանար	Verb
ինգուշների	Noun
հաստատող	Participle
որջում	Noun
ծեփում	Verb
կցորդների	Noun
թալիումները	Noun
մուրաբա	Noun
խարդախից	Adjective
աղկաղկիդ	Adjective
գեղձի	Noun
վախեցավ	Verb
լաբիրինթոսով	Noun
կասպեր	Noun
փչացնել	Verb
մուրճը	Noun
կրծքանշանի	Noun
ցավով	Noun
մազուրկան	Noun
օդանավում	Noun
տակնուվրայով	Adjective
տատ	Noun
սպասարկեց	Verb
զորավարին	Noun
պաշար	Noun
ժամանակաշրջանով	Noun
ներկայացրել	Verb
քնարով	Noun
չմեկնենք	Verb
նամազիս	Noun
նորություն	Noun
առակների	Noun
արքաներին	Noun
մարդաշատիս	Adjective
ծանուցումը	Noun
փարավոնի	Noun
քրքում	Noun
լոլիկներդ	Noun
չխոպոպացվեցին	Verb
հրթիռ	Noun
հիացած	Participle
դադարով	Noun
իշխանությունը	Noun
կախարդվելիք	Verb
վագոնով	Noun
ընդունակ	Adjective
չկարողացավ	Verb
խաչմերուկներ	Noun
ոստանիկ	Noun
ձեռնոցիս	Noun
կիսանդրիի	Noun
ահազդուներից	Adjective
գլյուոններիցս	Noun
սարքավորում	Noun
կառավարությունները	Noun
տաղանդը	Noun
օձիքի	Noun
հորիզոնները	Noun
ուսուցչին	Noun
կազակներ	Noun
հեղինակների	Noun
կնճիթիդ	Noun
պատվիրակությունների	Noun
կուսակցությունների	Noun
անշուք	Adjective
ժանյակները	Noun
տանտալ	Noun
սրամտելիք	Verb
հեղինակին	Noun
մոնղոլս	Noun
մյուոնների	Noun
կանաչապատով	Adjective
մարդասպանների	Noun
հասցեները	Noun
հույները	Noun
ուզած	Participle
մայրուղով	Noun
անիծյալներիցդ	Adjective
ապստամբների	Noun
հաստատունի	Adjective
ճամփորդները	Noun
ակոս	Noun
չբզզամ	Verb
դաշնությունը	Noun
արդյունքի	Noun
փարթամությունս	Noun
հսկաներից	Adjective
ֆիզիոլոգիային	Noun
բավարարում	Verb
ընծաներով	Noun
բարձունքում	Noun
խուտուտ	Noun
թիթեռնիկ	Noun
փաստերից	Noun
չկիսեց	Verb
ձանձրույթիցդ	Noun
օրհներգ	Noun
ամբարտավանականում	Adjective
խոցելու	Verb
քարտով	Noun
ճամբարին	Noun
մատուռի	Noun
կրոնները	Noun
դարանակալած	Participle
իսլամի	Noun
հերոինի	Noun
դոդի	Adjective
պերեստրոյկայիցս	Noun
աղանդը	Noun
ակկոյունլու	Noun
հեղինակները	Noun
պարբերություններով	Noun
հայլովս	Noun
արձագանքեք	Verb
նորդ	Adjective
խառնաշփոթություն	Noun
աջակցեցին	Verb
հոլանդացիներ	Noun
հողանցման	Noun
ապացուցեցին	Verb
սկզբնատառով	Noun
հապավում	Noun
ինգուշներդ	Noun
ապուշումս	Noun
փուչիկների	Noun
դաշնությամբս	Noun
բացառական	Adjective
բուսակերություն	Noun
կաթողիկոսի	Noun
պատճենը	Noun
պրոթեզը	Noun
տապին	Noun
նավահանգիստներ	Noun
ճաշը	Noun
հաշվառման	Noun
տեքստերից	Noun
նիշքը	Noun
վճարեր	Verb
ժամանակաշրջանի	Noun
ակնթարթին	Noun
գանձարանից	Noun
դարպասներին	Noun
երկունքի	Noun
խաչապուրի	Noun
մաքառումներ	Noun
շառավիղը	Noun
մեջ	Noun
ամորձիներից	Noun
երգեցողությամբ	Noun
ունակություններ	Noun
բարիոնների	Noun
հումորիս	Noun
սերմնահեղուկի	Noun
խրախուսում	Verb
հայրերին	Noun
մառախուղով	Noun
հյուրանոցի	Noun
կկկեիք	Verb
ժողովներից	Noun
գյավուրդ	Noun
գործազրկությունը	Noun
մետաֆիզիկային	Noun
տրամաչափովդ	Noun
չառոգանեմ	Verb
կուլտուրայում	Noun
օղակի	Noun
նախահայրերի	Noun
խօսէին	Verb
ինչքը	Noun
կախվել	Verb
կրկեսի	Noun
տավիղը	Noun
կրաքար	Noun
նեպալի	Noun
մանրէիս	Noun
գաղտակուրներիցդ	Noun
հարձակումները	Noun
հնագույնը	Adjective
գոռոզ	Adjective
ապարանջանները	Noun
երկմտանքները	Noun
սոմելիեիս	Noun
բուծում	Verb
մատենագիրների	Noun
թմրամիջոցները	Noun
տաբատը	Noun
բաղբանջեմ	Verb
ռիսկ	Noun
կարմրելու	Verb
ակնթարթ	Noun
գանգրահերներիս	Adjective
նահանգներ	Noun
հրապուրելու	Verb
խուրձը	Noun
տկռեն	Verb
օգտանուններից	Noun
տոհմեր	Noun
մեծերի	Adjective
առաջնություն	Noun
հնարավորը	Adjective
գործարկեց	Verb
մնացյալը	Adjective
նեգրերը	Noun
գլանդիցդ	Noun
վեհը	Adjective
մեծությունը	Noun
մթնոլորտներում	Noun
բռնաբարեի	Verb
բանտարկած	Participle
տրակտորների	Noun
մենդելեեւիումներումդ	Noun
աշխարհագրությամբ	Noun
բարբանջանքովդ	Noun
դրսեւորվեցին	Verb
կտուրովս	Noun
նմանների	Adjective
աղբանոցի	Noun
արտադրություններում	Noun
կարիք	Noun
սիլիցիումը	Noun
կատակերգություններից	Noun
ճաշակը	Noun
կտակած	Participle
կայծակին	Noun
կրավորական	Adjective
համբերում	Verb
հեռավորությունների	Noun
ակոսը	Noun
արտադրությանը	Noun
պարտավորության	Noun
պլուտոնիում	Noun
լուսանկարում	Noun
խոզանակի	Noun
կողքեր	Noun
բացատրություն	Noun
կզակով	Noun
ավագանուն	Noun
աքաղաղ	Noun
կղկղանքի	Noun
խորհրդով	Noun
հռոմեական	Adjective
բռնություններ	Noun
ցավերի	Noun
բացվածքներումս	Noun
անորոշելի	Adjective
երգչուհիներից	Noun
մամուլում	Noun
մրգերի	Noun
թզուկները	Noun
հանքը	Noun
վարդենուն	Noun
պաշարով	Noun
կուցերից	Noun
առեւտուրը	Noun
շատի	Adjective
ծավալների	Noun
հունդիդ	Noun
ակնարկներում	Noun
առաքինությունների	Noun
երկրաբան	Noun
նեղացել	Verb
մեռյալի	Adjective
կազմակերպ	Verb
անձնագրերում	Noun
կբանտարկեինք	Verb
եկեր	Noun
բնավորությունը	Noun
բողբոջներումդ	Noun
ակումբներին	Noun
կատարեք	Verb
կենտրոններում	Noun
ամուսնացածով	Adjective
հասկանալու	Verb
քաղաքացիականի	Adjective
ածելիներովս	Noun
չափանիշները	Noun
բաղեղը	Noun
համառեցին	Verb
երգահանների	Noun
կուլակների	Noun
խմորին	Noun
ներքնաձիգի	Noun
սկյուռի	Noun
նանայի	Noun
անգ	Noun
ականջ	Noun
վեղարով	Noun
չբարելավեց	Verb
պանթեոն	Noun
բաժանումներով	Noun
պահակներդ	Noun
ծայրը	Noun
հասկանամ	Verb
վարժություններից	Noun
ֆոսֆորով	Noun
մրցեին	Verb
չկարողանամ	Verb
հնարների	Noun
ձայնավորի	Noun
թեզանիքը	Noun
կառուցվածքից	Noun
հրվանդանի	Noun
շիթերը	Noun
հորթը	Noun
արգելող	Participle
կզենեիր	Verb
փաստաթղթով	Noun
կրծքին	Noun
սփռող	Participle
կնճիթը	Noun
գոհացնող	Participle
բակը	Noun
վկայությունները	Noun
հեղում	Verb
գինարբուքս	Noun
կրծքի	Noun
բողբոջներ	Noun
չղջիկների	Noun
տորթերի	Noun
արկանեիր	Verb
տրամաչափերի	Noun
բազեների	Noun
նավազներ	Noun
թարգմանություններից	Noun
բենգալերենի	Noun
առյուծով	Noun
ֆրանսիական	Adjective
կելտերիդ	Noun
կատալիզատորը	Noun
քաղցրավուն	Adjective
հրթիռին	Noun
մետաղումդ	Noun
ջրասամույրների	Noun
կցանկանա	Verb
կրունկը	Noun
տրոլեյբուսումդ	Noun
պատյանները	Noun
շեշտում	Verb
տանջելու	Verb
ճոնը	Noun
աստղադիտարաններից	Noun
խոհարարական	Adjective
ծայրեր	Noun
մոխիրներից	Noun
թարթում	Verb
նամակատան	Noun
ծածանների	Noun
կլանում	Verb
օսմանի	Noun
խրատներիցդ	Noun
կշնչեք	Verb
գորշիդ	Adjective
ճախրում	Verb
վասալներ	Noun
աշտարակ	Noun
պարտիաները	Noun
կասպերը	Noun
տռելիք	Verb
քարտաշի	Noun
մղձավանջը	Noun
չմուշկ	Noun
երգիծաբաններ	Noun
հաշվառումներիցդ	Noun
ներքնազգեստների	Noun
օգտագործեր	Verb
կճղակների	Noun
կհանգեիր	Verb
առյուծներիս	Noun
բոյի	Noun
չխածես	Verb
ամբարտակների	Noun
տզրուկ	Noun
վարեն	Verb
կազինոյի	Noun
պտուտակահան	Noun
նուկլոնիս	Noun
օֆիսը	Noun
արգանակ	Noun
կանչող	Participle
փետրվար	Noun
տուրքում	Noun
չհարես	Verb
երկիմաստներդ	Adjective
հռետորներ	Noun
կփսխեն	Verb
այցերից	Noun
տարածքներում	Noun
կատարելիս	Verb
փայծաղներս	Noun
ստուգումներ	Noun
պանթեոնում	Noun
հանքերը	Noun
սկզբունքներից	Noun
գնում	Verb
արույր	Noun
ձեռնարկում	Noun
նվագելու	Verb
քրմուհի	Noun
ծոծրակիցդ	Noun
մեռելների	Noun
թշվառները	Adjective
գյուղով	Noun
յոգուրտիս	Noun
ապրանքը	Noun
հատակ	Verb
խաղատներից	Noun
կակաչներին	Noun
սեքսը	Noun
կելտերին	Noun
շախմատիստներին	Noun
ջորու	Noun
արտասանությունը	Noun
խորհրդանշում	Verb
ապստամբներին	Noun
գրող	Noun
հիմնի	Noun
ներկայացներ	Verb
մտրակ	Noun
ստեղնաշարեր	Noun
անգլիականիս	Adjective
հանգստացել	Verb
կփորձենք	Verb
օծանելիքիցս	Noun
ազդեցին	Verb
արթնանում	Verb
սպանեն	Verb
հայտարարը	Noun
եբրայերեն	Adjective
վռնդեցին	Verb
կովբոյներ	Noun
շենքեր	Noun
ըմպելիք	Verb
օգտագործումը	Noun
կավիճը	Noun
հորթիդ	Noun
ձորը	Noun
այգաբացով	Noun
թաղերով	Noun
ձեւով	Noun
սպուտնիկի	Noun
կերակրելիս	Verb
արգասիքը	Noun
օղակներին	Noun
ստամոքսից	Noun
քշեց	Verb
նոբելիումի	Noun
գիտակարգ	Noun
նեոդիումովդ	Noun
սնդիկի	Noun
պտույտով	Noun
հայագետի	Noun
բանտարկեցին	Verb
նիկելից	Noun
նեգրերին	Noun
կիլոմետրով	Noun
կտակարանի	Noun
արարքը	Noun
ղազախ	Noun
ման	Noun
բացակային	Adjective
բանկլներիս	Noun
հետազոտողների	Noun
քարանձավի	Noun
զվարճանալու	Verb
անապեստովս	Noun
թատրոնիցդ	Noun
աստվածաբանի	Noun
կձուլեիր	Verb
քորը	Noun
շախմատիստին	Noun
պատուհաններով	Noun
արվեստի	Noun
արվեստներ	Noun
պարով	Noun
օբյեկտից	Noun
էլեկտրականություն	Noun
հուռթիներիցս	Adjective
ծնծղայիս	Noun
սպանություններ	Noun
չզատել	Verb
չհասկացավ	Verb
նշանավորը	Adjective
իրականություններդ	Noun
քարտուղարուհի	Noun
դատարաններում	Noun
անհուն	Adjective
չղջիկներ	Noun
դաշտայիններումս	Adjective
կբավարարեն	Verb
փարպեցին	Noun
գինետուն	Noun
գառաժումս	Noun
ուսանողներով	Noun
հնէաբանների	Noun
հոգեբանությունից	Noun
ազգանուն	Noun
ցողուններում	Noun
կազմերը	Noun
ուստրերիս	Noun
նազիցդ	Noun
համախոհ	Noun
ճաշարանները	Noun
կողմ	Noun
բարութ	Noun
էջը	Noun
կսաղացնեին	Verb
ոսկրերի	Noun
հավկիթ	Noun
կոնքերիդ	Noun
օգտագործվել	Verb
մեղքի	Noun
զանգ	Verb
կավ	Noun
սպանեին	Verb
ծուծից	Noun
գարնանայիններում	Adjective
մադուրերենի	Noun
ֆուտբոլիստից	Noun
ստամոքսին	Noun
քաղաքներում	Noun
լիբերալիզմը	Noun
սեպտեմբերի	Noun
հապավումներից	Noun
չկաշառած	Participle
բաղաձայնիցս	Noun
քմծիծաղովս	Noun
բաժանված	Participle
մինարեթներդ	Noun
օլիգարխիան	Noun
աստղաբաշխությունը	Noun
ցանկապատների	Adjective
լրտեսների	Noun
բախումներից	Noun
կրունկ	Noun
օդային	Adjective
նեղուցին	Noun
խիճ	Noun
տուփին	Noun
հափշտակումը	Noun
երիկամներում	Noun
խաբարը	Noun
մրսածության	Noun
բարեկամություն	Noun
նիշքում	Noun
նեյտրոնների	Noun
հեղինակություններ	Noun
հավասարը	Adjective
հոգնա	Noun
ցուրտի	Adjective
զոհասեղանի	Noun
խորվաթական	Adjective
կեր	Noun
սաղմին	Noun
աշխարհաքաղաքացիներովդ	Noun
փչակներովս	Noun
վերնագրերը	Noun
կողպեքիդ	Noun
ճամբարում	Noun
ճարտարապետություններիցս	Noun
թեւին	Noun
թրթուրներից	Noun
սադրանքների	Noun
բալետից	Noun
մայրաքաղաքներում	Noun
բոխիիս	Noun
լալոնքների	Noun
հարցմունք	Noun
աստղաֆիզիկային	Noun
առնետներիդ	Noun
տոկոսի	Noun
տողադարձի	Noun
աղաղակներ	Noun
տեղանուն	Noun
կուռթեր	Verb
պնակիցդ	Noun
ընդունակություններս	Noun
քննարկելիս	Verb
միջատների	Noun
ավազաքարերից	Noun
ատոմին	Noun
հոխորտանում	Noun
լեղապարկում	Noun
էնցեֆալիտի	Noun
մաթեմատիկայի	Noun
հոյակառույցներ	Adjective
եբրայեցի	Noun
ռեբուսներ	Noun
ծովահենները	Noun
կաղամբ	Noun
ոսկուն	Adjective
բակերի	Noun
քարտերով	Noun
առէջքին	Noun
ականատեսներ	Noun
ստեղնաշար	Noun
աղալու	Verb
սպարապետի	Noun
կայքերին	Noun
գանգրածածկ	Adjective
հարդում	Noun
մատնություն	Noun
ձգտած	Participle
ծիծեռներովդ	Noun
ծածկույթ	Noun
սպիրտի	Noun
կուլտուրաները	Noun
շուկայի	Noun
խոպոպանմաններիցս	Adjective
կկարողանամ	Verb
կովբոյի	Noun
քոռերի	Adjective
ճանճ	Noun
մրցույթներին	Noun
փամփուշտները	Noun
պարարտ	Adjective
մոգերին	Noun
նյարդերում	Noun
մարտնչելիս	Verb
կուլիս	Noun
ուրարտերեն	Noun
մեյդանումդ	Noun
առաքելությունների	Noun
վիճակախաղի	Noun
գորտը	Noun
նախասրահը	Noun
մղած	Participle
կալվածքները	Noun
հանցանք	Noun
յենս	Noun
հնչույթներ	Noun
ալբոմը	Noun
կապտավուն	Adjective
ջունգլիներում	Noun
ժողովածուումդ	Noun
եռացնել	Verb
հուզելիք	Verb
ազգայնացման	Noun
աքաղաղների	Noun
պանրով	Noun
չքննարկեն	Verb
վճիտներին	Adjective
մարզիկի	Noun
գլուխներին	Adjective
խավիար	Noun
տեխնեցիումը	Noun
պատշգամբից	Noun
հերոս	Noun
երջանկություն	Noun
գուլպա	Noun
վարկածով	Noun
օծովս	Noun
ածանցը	Noun
եղծեցիր	Verb
բանանները	Noun
բժշկագիտության	Noun
ապրանքներ	Noun
բազկաթոռին	Noun
բոխին	Noun
կազմակերպիչներին	Noun
լահմաջոյիդ	Noun
հադրոններ	Noun
ավանդույթներին	Noun
հիմունքներում	Noun
ծառայած	Participle
կենսուրախի	Adjective
պատանիներից	Adjective
հումքեր	Noun
պողպատից	Noun
չմուշկներ	Noun
ուսումնասիրեք	Verb
տարիքում	Noun
բացակայի	Adjective
քաղաք	Noun
հայկազներ	Adjective
երաշխավորման	Noun
մոտիկ	Adjective
չղջիկիցդ	Noun
տեղեկացնեմ	Verb
շքամուտքից	Noun
ըմբիշ	Noun
գագաթաժողովը	Noun
ձեռնոցներով	Noun
ֆիզիոլոգիա	Noun
հաշվառքներումդ	Noun
հավաքածուների	Noun
զտում	Verb
ծովեզերքին	Noun
մեքսիկացի	Noun
երիկամ	Noun
կաղապար	Noun
վերագրելու	Verb
բացատները	Noun
ցինկ	Noun
սպանվել	Verb
պնդուկիցս	Noun
փտելու	Verb
քերական	Noun
բժիշկների	Noun
զարկերակներից	Noun
սարավանդները	Noun
ներբեռնվել	Verb
թղթադրամներ	Noun
տիկնիկի	Noun
քերականագետներ	Noun
գուրզ	Noun
ռունգից	Noun
վիրուսներով	Noun
նախուտեստ	Noun
լեղի	Noun
փոխարիներ	Verb
անտունների	Adjective
բամբասանքները	Noun
կհայտարարի	Verb
հերուդ	Noun
ցնծությամբ	Noun
կատակը	Noun
մայրաքաղաքի	Noun
կխազեմ	Verb
խոշորացույցի	Noun
թխվածք	Noun
իսկականից	Adjective
ջանքերը	Noun
նախահայրը	Noun
ամայի	Adjective
ճանճերը	Noun
բացառվեն	Verb
խառնարան	Noun
հյուսենք	Verb
ամբարտակները	Noun
ձիթենի	Noun
թեզնիքիս	Noun
փայտիկով	Noun
կեռ	Noun
որոշմանը	Noun
քահանայից	Noun
ճանապարհորդում	Verb
երկկենցաղներ	Noun
մանկապարտեզները	Noun
հաճո	Adjective
նեյտրոն	Noun
առաջադիմումներումդ	Noun
հարվածով	Noun
թագավորներ	Noun
վտակին	Noun
դրացիական	Adjective
պոլոնիում	Noun
կործանելու	Verb
վոլֆրամի	Noun
ուրանը	Noun
պարապսարապից	Adjective
վրացովս	Noun
մատուռում	Noun
կոռներեններին	Adjective
ժաման	Adjective
ռենիում	Noun
զբոսանավի	Noun
կծիծաղային	Verb
պարսկերենին	Noun
դաշտամկներ	Noun
ողջագուրեք	Verb
սփռած	Participle
ցերիում	Noun
վարակդ	Noun
ամեոբաներ	Noun
մեթոդով	Noun
քարտի	Noun
քվարկից	Noun
հաղորդումներ	Noun
հոլ	Noun
համաստեղություն	Noun
սմբակի	Noun
ծաղրվել	Verb
բիրտ	Adjective
կազմակերպությունում	Noun
ասպանդակներին	Noun
հյուսիսում	Noun
օսլայում	Noun
բառարանը	Noun
ցուցասրահներում	Noun
շախմատիստուհիների	Noun
ահազդիկումս	Adjective
հայտնեցին	Verb
մամուլի	Noun
զուգարանը	Noun
ժողովներ	Noun
կատակերգությունում	Noun
կմեծանա	Verb
պահպանակի	Noun
ասպականու	Noun
անիծելու	Verb
կաշխատի	Verb
կիրառվում	Verb
ոտանավորների	Noun
կոմսուհու	Noun
մաթրախիցս	Noun
արքայախնձոր	Noun
տձեւը	Adjective
ստորագրությունների	Noun
վերծանող	Participle
պնդի	Adjective
առողջացնեք	Verb
դասակ	Noun
հավատի	Noun
երկարությունների	Noun
լուսանկարչություն	Noun
մա	Noun
ձկնաբան	Noun
կլիմաներ	Noun
կազմակերպությանը	Noun
ցար	Noun
գյուղացիները	Noun
սերմնահեղուկներումդ	Noun
պիցցայի	Noun
խաչակիրը	Noun
սուպեր	Noun
գլխուղեղների	Noun
այրված	Participle
հյուպատոսությանդ	Noun
խուրձ	Noun
հայտնիներից	Adjective
չլվացած	Participle
քննարկումների	Noun
աստղադիտակ	Noun
շախմատ	Noun
պիստակենով	Noun
տնտեսությունում	Noun
ճղոպուրին	Noun
ուղղով	Adjective
տաքություն	Noun
լծում	Verb
բարկերը	Adjective
ներկայացնող	Participle
հեկտարներին	Noun
հետազոտողը	Noun
քերականագիտական	Adjective
կիսանդրի	Noun
վանկերով	Noun
ալանների	Noun
ուտիճի	Noun
կմագլցեինք	Verb
պարանը	Noun
թաղանթով	Noun
ենթամնան	Noun
սուզվել	Verb
թենիսիստի	Noun
արտոնագրերից	Noun
հասցնելու	Verb
շռեցիք	Verb
խրոխտները	Adjective
մողեսներին	Noun
արբանյակում	Noun
կոգեն	Verb
կույտը	Noun
սիլիցիումից	Noun
հոտած	Participle
գարնանայինին	Adjective
հինը	Adjective
աղեղներով	Noun
հազարամյակներովդ	Noun
հիմունքները	Noun
վշտերիցս	Noun
անխելքս	Adjective
պարսկերենից	Noun
կարծեցի	Verb
հիմնադրամներ	Noun
չմոլորվեր	Verb
պարիս	Noun
մաթեմատիկոսի	Noun
նետեց	Verb
մեծացող	Participle
բուլղարացիների	Noun
կսառչես	Verb
խմորի	Noun
մրցակցի	Noun
ձայնավորների	Noun
զարմիկը	Noun
շատից	Adjective
պահպանեք	Verb
գործադուլի	Noun
ժամկետով	Noun
բժիշկներ	Noun
կրոնականումդ	Adjective
լվեր	Noun
մուղամների	Noun
վիզաների	Noun
հառաչքիդ	Noun
գույքից	Noun
կարիքների	Noun
մաղադանոսներումս	Noun
սպիտակներ	Adjective
ցուցասրահները	Noun
ամբարտակներով	Noun
արագություններ	Noun
ոլորունիցդ	Adjective
քանդակին	Noun
վասալի	Noun
խավիարը	Noun
իլենի	Noun
հաշիվ	Noun
վերքերից	Noun
լաստենին	Noun
այբուբենը	Noun
նախապայմանի	Noun
գործվածք	Noun
հաստատուններից	Adjective
պալայերեն	Noun
կոսմոպոլիտիզմի	Noun
արարածներից	Noun
արդուկող	Participle
ազդելու	Verb
կիրառեցին	Verb
հասարակածին	Noun
նկարիչների	Noun
սպերմատոզոիդների	Noun
ճիրաններով	Noun
չքելեին	Verb
սոճիներից	Noun
ակտինիումներ	Noun
ազգություններից	Noun
արվեստագետը	Noun
պիրոլը	Noun
շենքերից	Noun
հիմնադրամներին	Noun
հոդվածին	Noun
մաթեմատիկայից	Noun
չհատեց	Verb
յաթաղանը	Noun
ռեժիսորներից	Noun
բոլորիս	Adjective
ընդավոր	Noun
երկյուղ	Noun
աղյուսեներին	Adjective
հոդով	Noun
փղեր	Noun
ֆոտոնների	Noun
քամիներ	Noun
կրոնից	Noun
մկանում	Noun
տաքություններովս	Noun
նահանգի	Noun
վանդակիցս	Noun
հելիումը	Noun
զորքի	Noun
ուց	Noun
խաչբառովդ	Noun
հրվանդանին	Noun
ազդեցություններից	Noun
գումարի	Noun
աղամողիցս	Noun
ախտորոշվել	Verb
հոպոպի	Noun
անմահությունից	Noun
կողմերից	Noun
լիբիդոներով	Noun
կաղինների	Noun
ֆիզիկոսների	Noun
կողքիդ	Noun
առաջադիմության	Noun
զորախումբ	Noun
կապիկը	Noun
նոյեմբերյանում	Adjective
ազգուտակերիդ	Noun
խուճուճ	Adjective
գնդով	Noun
ոջիլ	Noun
ասպարեզներում	Noun
հայագետներ	Noun
անգլիացիներից	Noun
քրդերովդ	Noun
կակաչներումդ	Noun
դոլարից	Noun
վաճառող	Participle
շարունակեմ	Verb
երախտիքում	Noun
փայլյուններովս	Noun
աշխարհագրության	Noun
մատուցողին	Noun
երախտիքի	Noun
հացահատիկի	Noun
փայծաղ	Noun
մրցակցում	Noun
կերը	Noun
գրախանութում	Noun
մասուր	Noun
կառավարելու	Verb
ծովափղեր	Noun
տուփով	Noun
կնիքը	Noun
հորդորանքով	Noun
պաստեղս	Noun
հերթերին	Noun
ճկունության	Noun
թենիսիստներ	Noun
թիթեղներով	Noun
արագոներեններիցս	Adjective
համոզակերս	Adjective
պրոլետարի	Noun
յոգայովս	Noun
խոռոչով	Noun
հաստատուններով	Adjective
ավել	Noun
սազով	Noun
տաքության	Noun
հերոսի	Noun
ազգություններով	Noun
երեխան	Noun
որսացող	Participle
քերականագիտության	Noun
խորքերը	Noun
գրանիտներդ	Noun
ժողովածուները	Noun
հալոգենները	Noun
նշանավոր	Adjective
ձաղկելիք	Verb
պայմաններիցդ	Noun
լրտեսեցիր	Verb
լուսան	Noun
նախարարներին	Noun
վաշտ	Noun
մտադրված	Participle
գյոզերի	Noun
նեղուցների	Noun
կաթնուկում	Noun
խմիչքները	Noun
հոլանդերեններումդ	Adjective
օրգանիզմներում	Noun
մռայլ	Adjective
պատշգամբը	Noun
ամորձին	Noun
զարկերակների	Noun
գոյականներից	Noun
հղած	Participle
մեդալներին	Noun
տրամադրելու	Verb
մանգաղներ	Noun
խոռոչում	Noun
գանգրահեր	Adjective
տեղեկացնում	Verb
շաքարավազով	Noun
ավարը	Noun
յակից	Noun
հաստատություններից	Noun
Զատիկը	Noun
հաճախորդին	Noun
հինդ	Adjective
իսլամական	Adjective
լիբիացիների	Noun
հացահատիկներ	Noun
միություններին	Noun
ազդանշան	Noun
չմալեցիք	Verb
քյարեր	Noun
խութերով	Noun
սոուսներ	Noun
հանցանքները	Noun
ուռած	Participle
ձեղնահարկում	Noun
ուտեստի	Noun
ամայանում	Verb
վակուումը	Noun
պեղեց	Verb
սկեսրայրին	Noun
քարտեզագրականովս	Adjective
մոնիտորները	Noun
մետրոպոլիտեն	Noun
առեղներս	Noun
աղյուսակում	Noun
գթասիրտս	Adjective
չափանիշներում	Noun
երևման	Noun
ինգուշները	Noun
բառգրքին	Noun
սովորեցի	Verb
արդյունաբերությունների	Noun
տաճարում	Noun
կառքով	Noun
հղությունումս	Noun
նեյտրոններից	Noun
արածեցնելու	Verb
սպանությունից	Noun
առաջնությունը	Noun
որսալ	Verb
ճկուն	Adjective
վտակներ	Noun
մալը	Noun
աղախինը	Noun
բրդից	Noun
սառչող	Participle
թաղանթները	Noun
ավետարաններում	Noun
մահմեդականները	Noun
գոմեշի	Noun
ժանիքներ	Noun
ինֆեկցիաների	Noun
չգլդորենք	Verb
ասպետներով	Noun
հավատալ	Verb
կրակելու	Verb
հատիդ	Noun
անիոնները	Noun
համբույրից	Noun
կրպակները	Noun
բարքը	Noun
թանգարանի	Noun
ատոմի	Noun
կարթի	Noun
տուբերկուլյոզից	Noun
տեսակներում	Noun
սպիներ	Noun
ձողերով	Noun
նիշքի	Noun
ազբի	Noun
փոր	Verb
հիպերբոլի	Noun
լիբիացովս	Noun
բողոքեցին	Verb
հնդիկները	Noun
ուրդուի	Noun
տոնից	Noun
գրադարձեցի	Verb
կզատեինք	Verb
ժողովից	Noun
թույներ	Noun
իմունիտետը	Noun
փղերը	Noun
նիդեռլանդացի	Noun
մոնիտորի	Noun
ջանան	Verb
ներկաներ	Adjective
խաչքարերի	Noun
զգուշացնել	Verb
վրաններում	Noun
գերու	Adjective
պիրոլ	Noun
ստեղծագործություններում	Noun
աղեղի	Noun
հագնվի՛ր	Verb
ալբոմների	Noun
խնջույքներ	Noun
խնդրագրի	Noun
տարածություն	Noun
մոտոցիկլով	Noun
տեխնեցիումներիդ	Noun
գորտնուկների	Noun
ավիաընկերությունների	Noun
առերեսումը	Noun
տերեփուկի	Noun
բացատրեն	Verb
մետաղներից	Noun
հանվում	Verb
ցիկլոնի	Noun
ֆտորի	Noun
մարդասպաններից	Noun
կեղեքեք	Verb
բեյսբոլ	Noun
բարկս	Adjective
այծը	Noun
գյուտերից	Noun
մետրովս	Noun
նախադասությամբ	Noun
մեծանուն	Adjective
ենթաշերտումդ	Noun
պատրաստությանը	Noun
կրծքավանդակին	Noun
գթասիրտի	Adjective
փարթամագեղներիցդ	Adjective
փտող	Participle
լվի	Noun
կոպեկ	Noun
բարտի	Adjective
թատրոններին	Noun
ֆուտբոլային	Adjective
փայլունակություններովդ	Noun
ավար	Noun
բուսական	Adjective
թարթեր	Verb
ավարների	Noun
ռեփի	Noun
ժողովրդից	Noun
հատապտուղներ	Noun
ամրոց	Noun
ճանապարհորդներին	Noun
կայտառովդ	Adjective
նանան	Noun
գրանցման	Noun
հիվանդներից	Adjective
ջղայինումս	Adjective
խոյը	Noun
հաշվումները	Noun
տունդրայից	Noun
գոյակցությունները	Noun
աղյուսակին	Noun
ճտերը	Noun
շարժմանը	Noun
նարինջս	Noun
երշիկի	Noun
ճտի	Noun
կով	Noun
կմերկանայինք	Verb
ինգուշներիցս	Noun
իմաստություններով	Noun
հումոր	Noun
հումքը	Noun
քահանա	Noun
կուսումնասիրեր	Verb
քվարցը	Noun
գանգրածայրներիցս	Adjective
միջի	Noun
պահպանելու	Verb
վանկով	Noun
գետաձիերի	Noun
ավազակները	Noun
նախադասությունները	Noun
հովազի	Noun
խառնարաններ	Noun
համաստեղությունները	Noun
փիլիսոփայություն	Noun
կաչաղակները	Noun
ջանասիրություններիդ	Noun
սեռական	Adjective
էվոլյուցիոնից	Adjective
գործընկեր	Noun
քաղաքը	Noun
վագր	Noun
թարխունը	Noun
մեծամասնությունը	Noun
թաղապետերով	Noun
վարկածում	Noun
ալյումինից	Noun
հրամանները	Noun
մանգաղով	Noun
տարածքներ	Noun
բաղեղներ	Noun
շնորհավորում	Noun
շաշի	Adjective
հղումներիդ	Noun
տարբերին	Adjective
քաջքերը	Noun
մատղաշները	Adjective
քարայրից	Noun
կկեղեքենք	Verb
արագիլներ	Noun
արտադրությունների	Noun
ցուլի	Noun
հիգիենա	Noun
գնեցին	Verb
հածանավի	Noun
պատրանքները	Noun
ոլորք	Noun
մարս	Noun
մեկնաբանություններով	Noun
ժողովածուով	Noun
հունվարի	Noun
կսաղանան	Verb
հեռուստատեսության	Noun
ոսկիներին	Adjective
մղոնը	Noun
նկարիչները	Noun
գերեզմանոցներից	Noun
ավարով	Noun
չհանվեիր	Verb
օսմանցիների	Noun
ձավարը	Noun
գերանի	Noun
չաղոյով	Noun
ճակատագրում	Noun
գեղարքունի	Noun
կաթսաներից	Noun
եպիսկոպոսների	Noun
բոցեղեններդ	Adjective
թարխուն	Noun
կր	Verb
ցեղերով	Noun
տառեխիդ	Noun
հնոց	Noun
եղջյուրների	Noun
փշերը	Noun
նիդեռլանդերեններ	Adjective
գտածոներ	Noun
դարվինիզմի	Noun
մատիտները	Noun
լեռնաշխարհով	Noun
արահետներով	Noun
պահպանում	Verb
անգլիացի	Noun
ուզելու	Verb
գմբեթի	Noun
արարքները	Noun
մարսողությունը	Noun
թխվածքի	Noun
խորդուբորդներին	Adjective
խանդից	Noun
բացատներով	Noun
ածուներումդ	Noun
խորհրդի	Noun
խռթամ	Verb
խավարում	Adjective
տեղանունները	Noun
օժանդակը	Adjective
կատարեն	Verb
պարանները	Noun
բալիկի	Noun
առիթից	Noun
ավանդություններ	Noun
արտադրանքի	Noun
զարդարանք	Noun
սիգը	Noun
կապտում	Adjective
անասնաբույժներ	Noun
արարողությունում	Noun
հեռատես	Adjective
կանխամտածվե՛ք	Verb
ճառագայթով	Noun
ձվարանի	Noun
բռնաբարում	Verb
մոլեկուլներում	Noun
Զատկին	Noun
վտակների	Noun
թվիստ	Noun
խեղդվել	Verb
կփորձեմ	Verb
հիասթափեցրեց	Verb
կուրչատովիումովդ	Noun
կանչեր	Verb
մուշտակների	Noun
էլեկտրոլիզով	Noun
առեղծված	Noun
արծվի	Noun
լքեցին	Verb
փյունիկ	Noun
լայնությամբ	Noun
ճարպերով	Noun
հուշանվերիդ	Noun
ապարանջան	Noun
խաչմերուկի	Noun
անձնագրի	Noun
հոգալ	Verb
սարավանդների	Noun
մեծությունից	Noun
կոնյակների	Noun
ձեւանմուշներիս	Noun
սպիտակուցների	Noun
մանանայումդ	Noun
ուղիներում	Noun
տանտիկին	Noun
կուրծքը	Noun
շառավիղներից	Noun
ավտոբուսների	Noun
չբորբոքեմ	Verb
լայնը	Adjective
լուծած	Participle
ծեծերովս	Noun
տենդախտներում	Noun
պորտուգալերենին	Noun
շոնա	Noun
համեմ	Verb
խճի	Noun
հատող	Participle
ուսումնասիրած	Participle
արտում	Noun
քոչարուն	Noun
մաստակներդ	Noun
ջինսերի	Noun
տատիկի	Noun
զամբիկի	Noun
հանումը	Noun
մարկեր	Noun
թակարդների	Noun
ապարանք	Noun
բույն	Noun
հղումը	Noun
հանրակացարանի	Noun
երկրաչափություն	Noun
տունդրայի	Noun
կիմերներդ	Noun
մամուռներ	Noun
ալանին	Noun
առողջարանում	Noun
պանծան	Verb
քոռերից	Adjective
կտուժի	Verb
էմիգրանտները	Noun
ճուճուլովդ	Noun
պատճառականներ	Adjective
աշխատավարձերը	Noun
բոլորքիդ	Noun
պարտավորություններիցդ	Noun
ժամադրությունների	Noun
կայքում	Noun
բանտին	Noun
ոխ	Noun
չառողջացրիր	Verb
պայուսակները	Noun
հիդրատ	Noun
կոթողներ	Noun
նախահայր	Noun
լուրերից	Noun
բանեցնելու	Verb
արվեստագետներին	Noun
բարիոններովդ	Noun
տկլորով	Adjective
սեռականը	Adjective
նադիրի	Noun
կազմակերպեն	Verb
գործարաններ	Noun
սուպերմարկետ	Noun
կոր	Verb
բարելավեց	Verb
հայկական	Adjective
սմբուլը	Noun
օազիսի	Noun
սանդ	Noun
հիդրոլիզ	Noun
փակ	Adjective
իրադարձություններից	Noun
թոքը	Noun
հայրենիք	Noun
ձվարան	Noun
չհորանջես	Verb
խմելիս	Verb
քարանձավների	Noun
բազեովս	Noun
անկումներ	Noun
նյարդերի	Noun
ածանցները	Noun
ակումբի	Noun
հաճար	Noun
մերու	Noun
գլորվել	Verb
դեղձանիցս	Adjective
նավաստիներ	Noun
մերի	Noun
ճանապարհորդությունների	Noun
կտղող	Participle
կղզու	Noun
ուսումնասիրեց	Verb
սառնամանիքներիս	Noun
գրանցմամբ	Noun
երեխայի	Noun
թիակի	Noun
ցխնքումդ	Noun
կիսանդրին	Noun
բույլին	Noun
ատյանի	Noun
շքանշաններով	Noun
պահածոներ	Noun
երգեցիկ	Adjective
չածանցեցի	Verb
կատարներ	Noun
ռեկտորներ	Noun
քաջալերանքներում	Noun
ջինսը	Noun
հնչույթի	Noun
չազդեինք	Verb
ռնգեղջյուրը	Noun
չմոռացավ	Verb
ողորկում	Adjective
սոսինձ	Noun
արքայազնի	Noun
յուրայինների	Noun
խեժերը	Noun
ուսմանը	Noun
մեկնաբանություններին	Noun
նշենու	Noun
մշակույթին	Noun
վաստակները	Noun
տանտալը	Noun
պատանուն	Noun
կոմունիստների	Noun
ուսումնասիրում	Verb
տեղեկությունները	Noun
պակասում	Adjective
մեծի	Adjective
էակները	Noun
սխալը	Adjective
առանցք	Noun
կոսմոսին	Noun
անկումները	Noun
մարգարեության	Noun
պաշտոնականներով	Adjective
ցուցակի	Noun
մերիս	Noun
կլիանային	Verb
քաղ	Verb
բլրի	Noun
ինքնաթիռներ	Noun
էնցեֆալիտ	Noun
ապստամբելու	Verb
ողնուղեղի	Noun
երնջակների	Noun
հեծնելու	Verb
բացվածքներով	Noun
ուրուր	Noun
թորիում	Noun
խորտիկից	Noun
կեղծերիդ	Adjective
այրիների	Adjective
երշիկը	Noun
տառապանքները	Noun
իրականը	Adjective
թաքցնեինք	Verb
համոզելու	Verb
օբյեկտով	Noun
վայելքի	Noun
գերմանիումի	Noun
ատյանները	Noun
հաճախությամբ	Noun
մայրիկին	Noun
խրոխտանաք	Verb
հայտնած	Participle
արտադրություններ	Noun
պոզի	Noun
ճիրանումս	Noun
մրջյունով	Noun
Աղասու	Noun
ըմպանակներումդ	Noun
նացիստդ	Noun
արկղ	Noun
մոծակների	Noun
գաղափարի	Noun
կակտուսներ	Noun
փաստերը	Noun
ապրանքով	Noun
թաթերեն	Noun
զառ	Noun
տասնամյակում	Noun
նորս	Adjective
ողորկություններին	Noun
կայացող	Participle
փախլավաներիդ	Noun
փորեց	Verb
վեհանձն	Adjective
դեղատուն	Noun
վարչապետից	Noun
կարտոֆիլին	Noun
ազդանշանով	Noun
մրցակիցներին	Noun
Ամանոր	Noun
շառաչյունով	Noun
կովին	Noun
լոխով	Noun
հայկյան	Adjective
հանրագիտարանին	Noun
արագիլի	Noun
գեղեցկությամբ	Noun
երկրպագուի	Noun
թոքախտը	Noun
ճնշումների	Noun
անուշ	Adjective
սիրելիի	Adjective
մատուռ	Noun
կետադրություններումդ	Noun
թիկունքը	Noun
ռենիումի	Noun
մարզիկը	Noun
դեգերումներից	Noun
կատեգորիային	Noun
ճաշակներիցդ	Noun
կղզիներ	Noun
կիրառվելու	Verb
թակույկներ	Noun
ամսագիրը	Noun
գալակտիկա	Noun
մաշկերիցդ	Noun
քմծիծաղ	Noun
կարապը	Noun
ակոսով	Noun
նիշում	Noun
պատվերիցս	Noun
ծպտվեիր	Verb
նախամայր	Noun
ամրոցին	Noun
տեսակի	Noun
խրատները	Noun
արգելքներ	Noun
սարսափը	Noun
ղուշգիրներիդ	Noun
միացրին	Verb
տառապանքից	Noun
գումարում	Noun
թաղանթներ	Noun
առոգանես	Verb
ձողիկով	Noun
ճակատագիր	Noun
կողմնացույցի	Noun
նշենին	Noun
մուշտակում	Noun
արսենիդ	Noun
վերջնախաղում	Noun
հրթիռներով	Noun
նախարարներ	Noun
ձախլիկների	Noun
աճուրդը	Noun
թղթադրամից	Noun
կղկղանքդ	Noun
անապատից	Adjective
ներդրումիցս	Noun
բակտերիաներում	Noun
նեղուցները	Noun
մաորի	Noun
մերկացած	Participle
հոդերից	Noun
մոտոցիկլետ	Noun
կապարը	Noun
տողը	Noun
համբույրներ	Noun
ալյումինը	Noun
ֆոյեում	Noun
ղեկը	Noun
կաղնիներումս	Noun
բարդությունից	Noun
արձակուրդից	Noun
պարտեզները	Noun
լոգանքի	Noun
կրկեսը	Noun
երազում	Verb
կայծակը	Noun
հանգույցով	Noun
հասունին	Adjective
ծայրով	Noun
սաղմերը	Noun
կենսաբանության	Noun
միջատներին	Noun
թվանշաններից	Noun
յոգուրտներումս	Noun
շնաձուկը	Noun
հոլովակի	Noun
ձայնավորները	Noun
աղոթեցի	Verb
գիսաստղերը	Noun
նախածանց	Noun
հանգստանան	Verb
բնորոշելու	Verb
ավաններում	Noun
սպիտակուց	Noun
շառավիղների	Noun
պիտանացուներում	Adjective
պատմվածքների	Noun
օտարները	Adjective
մարգարեություն	Noun
մեծին	Adjective
կործանած	Participle
մեծամիտ	Adjective
նավթը	Noun
սպայի	Noun
սաղմոնների	Noun
այցելություններ	Noun
կխածնեին	Verb
շնագայլ	Noun
պայմանական	Adjective
ավարներ	Noun
մրջյուններ	Noun
խրծիկներս	Noun
աբսոլյուտից	Adjective
կայարան	Noun
կանչած	Participle
երկարավուն	Adjective
նավատորմիղ	Noun
չակերտներ	Noun
ուժեղանալ	Verb
իմաստուն	Adjective
պեսո	Noun
պարերը	Noun
կարուսելի	Noun
փենջաբի	Noun
չափար	Noun
տասնամյակը	Noun
կուլակները	Noun
թագից	Noun
այլեւայլ	Adjective
կորյունին	Noun
կմիանամ	Verb
տեսիլներ	Noun
ապստամբություն	Noun
կատակերգություններ	Noun
լեհերին	Noun
համոզում	Verb
մետրանոցների	Noun
արույրի	Noun
հայդուկականին	Adjective
խցիկներով	Noun
բռնությամբ	Noun
քերած	Participle
վաշտին	Noun
գիտակցված	Participle
մեծություններից	Noun
ջրամբարներից	Noun
կախած	Participle
տառապանք	Noun
սարդերովս	Noun
ուղղից	Adjective
ճահիճները	Noun
շտեմարանի	Noun
փայլուն	Adjective
կլորավուն	Adjective
հանցագործին	Noun
բնույթի	Noun
մտածողներին	Adjective
կայքեր	Noun
վերուվերդ	Noun
կախաղանի	Noun
ֆուտբոլասեր	Noun
ամբարտավանանայիր	Verb
ձիթապտուղը	Noun
ուժգինից	Adjective
բերիլիումը	Noun
լողանալ	Verb
սգալու	Verb
ճառագայթը	Noun
նախաճաշը	Noun
լրջմտություններովդ	Noun
վարագույրներ	Noun
տերությունում	Noun
քիլիս	Noun
աքայականները	Adjective
ուկրաինականներին	Adjective
ջունգլիներ	Noun
վեպեր	Noun
թիթեռները	Noun
ազդ	Verb
մոլուցքը	Noun
պարտությունից	Noun
արտադրանքում	Noun
գործիքներով	Noun
ահաբեկիչ	Noun
զարդենիներդ	Noun
սպանությունների	Noun
մեղուս	Noun
մարդասպանը	Noun
թաթը	Noun
գրախոսություն	Noun
վինի	Noun
բնութագրելու	Verb
վարուժանին	Noun
վարորդների	Noun
ներկայացուցչություններում	Noun
կուրսերը	Noun
արկանեինք	Verb
բաոբաբի	Noun
կազմից	Noun
մրցանակները	Noun
շիկացած	Participle
լյարդովդ	Noun
աղալ	Verb
կայծքարից	Noun
նահատակովս	Noun
որբացան	Verb
անհանգստանալու	Verb
սառնարանները	Noun
մոռենուցդ	Noun
այրուն	Noun
որորը	Noun
ներկայացնեք	Verb
նախադասությունից	Noun
անգերը	Noun
թխկին	Noun
ընդունակություններ	Noun
կաստային	Noun
մարիխուանան	Noun
կարեկցանքը	Noun
կանաչավունից	Adjective
սարդերից	Noun
պահպանակը	Noun
տաճարների	Noun
կեսի	Noun
հայրս	Noun
բերկլիում	Noun
բաղնիքների	Noun
պատասխանատվություն	Noun
բաժը	Noun
կոնքեր	Noun
նախկինից	Adjective
թռչունից	Noun
նիդեռլանդական	Adjective
պարոնի	Noun
պրակ	Noun
հավատով	Noun
կառեներովդ	Noun
հաճույքի	Noun
ծավալներում	Noun
գագաթնաժողովին	Noun
առաքյալից	Noun
տապ	Noun
բռնակալների	Adjective
քննություններին	Noun
վագոնների	Noun
հայհոյում	Verb
ժողովածուից	Noun
նպաստավոր	Adjective
մայրուղիներ	Noun
թենիսիստուհիներից	Noun
մետաղադրամի	Noun
դոլարի	Noun
մոնիտորը	Noun
սնուկերը	Noun
սխալով	Adjective
հոլովակներում	Noun
հղանում	Verb
խութերից	Noun
ջաղացներիցս	Noun
գնդերից	Noun
սարյակ	Noun
սուսերամարտով	Noun
բնակիչների	Noun
չսաղանալ	Verb
ռեկտորը	Noun
նադիր	Noun
պուրակով	Noun
քարոզում	Verb
դեղինը	Adjective
պարտավորությունները	Noun
վհատումներս	Noun
սրճարանը	Noun
կարտոֆիլում	Noun
ջղայնացած	Participle
ճառից	Noun
վիրակապեր	Noun
հանրագիտարան	Noun
գոմեշիցդ	Noun
չվհատած	Participle
կանայք	Noun
շարունակվել	Verb
հաստոցովս	Noun
գոճովդ	Noun
ժողովածուներում	Noun
լոտոներ	Noun
խաչեր	Noun
իտալացիների	Noun
կենդանակերպում	Noun
նկուղները	Noun
խրամի	Noun
երգահանը	Noun
ուժեղանում	Verb
գաղտնաբառերի	Noun
քարփինջներով	Noun
աճուրդ	Noun
գեղեցկության	Noun
հալվել	Verb
հասկացնել	Verb
վիկինգներին	Noun
պատվաստումները	Noun
փչակներում	Noun
աստղաբան	Noun
գոնադովս	Noun
տանիքում	Noun
վայրերին	Noun
վիկինգ	Noun
գողացող	Participle
ավետիսի	Noun
ժողովուրդներից	Noun
հերոսականներին	Noun
բարձիթողիին	Adjective
գլխարկումդ	Noun
երգեհոնի	Noun
կոճակը	Noun
հատապտղի	Noun
բարքի	Noun
որորները	Noun
պլատինին	Noun
կատարեմ	Verb
խցիկներում	Noun
մրցակիցներից	Noun
լիթիումը	Noun
խոլերայից	Noun
իսպանականովդ	Adjective
պատրանքներով	Noun
մատենագիտություն	Noun
հնագետներ	Noun
ճակատագրին	Noun
պարբերությունը	Noun
հոդված	Noun
խազելիս	Verb
անգիովդ	Adjective
հաշվառքից	Noun
կանաչը	Adjective
թագին	Noun
հաճախումների	Noun
թոքերի	Noun
որքինի	Noun
հացահատիկների	Noun
քարտուղարը	Noun
ֆաշիզմից	Noun
լեզգիիդ	Noun
շքեղությամբ	Noun
հանգած	Participle
տափ	Noun
պիոն	Noun
մորեղբոր	Noun
գրախանութը	Noun
ափիոնից	Noun
սառչում	Verb
տեգերի	Noun
սառույցները	Noun
մարզերը	Noun
ուլունքներից	Noun
վասալ	Noun
պրոթեզներին	Noun
նահանգ	Noun
թղթապանակս	Noun
մսագործների	Noun
ուսումնասիրեին	Verb
բացառականը	Adjective
գոյերից	Noun
բորենիներ	Noun
քիմիայով	Noun
որովայնը	Noun
շպրտեինք	Verb
պորտով	Noun
շատերից	Adjective
խճուղուն	Noun
ճկույթներիցս	Noun
պորտերից	Noun
ասբեստ	Noun
փոխառություններից	Noun
վայրերով	Noun
պալադիում	Noun
խեղաթյուրներումդ	Adjective
վաճառեցին	Verb
չքորեցիր	Verb
շարահյուսություն	Noun
կլեպիցդ	Noun
էջով	Noun
տարածեցին	Verb
կեղծամով	Noun
մետաղալարից	Noun
մզկիթում	Noun
փորոքովս	Noun
ուռչես	Verb
չգլել	Verb
ձագերով	Noun
շնորհավորանքները	Noun
գորով	Verb
խմում	Verb
թաղանթներով	Noun
նախասրտերից	Noun
գթասիրտներովդ	Adjective
մոռացնել	Verb
խաշում	Noun
կոալան	Noun
տեսակով	Noun
սահման	Verb
տաջիկները	Noun
կախեցին	Verb
աշխարհահռչակներով	Adjective
հաղթակամարի	Noun
չցավես	Verb
ներգաղթիդ	Noun
լեզվաբան	Noun
մատիտը	Noun
չշպռտեիր	Verb
կտակարանումդ	Noun
հղիների	Adjective
ստիպեց	Verb
շնորհելու	Verb
չխոպոպեիր	Verb
հենդ	Noun
գաղձ	Noun
կասպից	Noun
գաղափարագրերով	Noun
նստարանների	Noun
հավել	Verb
հեղինակներ	Noun
առաքյալը	Noun
մարթեն	Verb
աշորայի	Noun
տանջեց	Verb
խորհուրդներումս	Noun
աթեիստ	Noun
վնասվածքների	Noun
հարգանք	Noun
միանձներով	Noun
գումար	Noun
տնտեսագետներ	Noun
մարզադաշտերիս	Noun
փնջերով	Noun
հինդուիզմի	Noun
ստեղծագործություններով	Noun
կատիկով	Noun
ֆիննական	Adjective
ենթարկեց	Verb
արոտավայրերով	Noun
շաշկի	Noun
աղիքներ	Noun
ճախարակների	Adjective
թզենին	Noun
հարգանքը	Noun
չափագիտություն	Noun
փականագործի	Noun
կացարանում	Noun
կոնյակը	Noun
կկրեն	Verb
մեխակներ	Noun
մնացականով	Adjective
լավայից	Noun
պոմպը	Noun
հաշվետախտակներս	Noun
ադամաթուզ	Noun
հայտարարությամբ	Noun
կազմին	Noun
վիրուսները	Noun
թույնումս	Noun
բոժոժում	Noun
շագանակագեղձը	Noun
հոգնածությունը	Noun
նվագած	Participle
մանրէի	Noun
կրծքավանդակը	Noun
ներողության	Noun
ավտոբուսներ	Noun
գագաթնաժողովի	Noun
պատվոգրով	Noun
առաջադիմությունները	Noun
համալսարան	Noun
էջերի	Noun
նախընտրեցին	Verb
տեսքերը	Noun
քաոսային	Adjective
գերմանացուն	Noun
սոսնձի	Noun
ծնողներից	Noun
մորթու	Noun
էրեկցիաներիդ	Noun
չծպտեցիր	Verb
ուզբեկ	Noun
համաստեղությունների	Noun
սպաս	Noun
խուճապը	Noun
ստամբակություններից	Noun
զամբիկին	Noun
շարժվում	Verb
չմոռանան	Verb
կողմնացույցներիցս	Noun
երկբայե՛ք	Verb
խմիչքդ	Noun
մարդասպանի	Noun
վալիզումս	Noun
կողոպտեն	Verb
մարդասպանին	Noun
գներ	Verb
պարբերություն	Noun
չբնակվեինք	Verb
զգեստներին	Noun
հարկադրեց	Verb
տաշի	Noun
տնտեսագիտականների	Adjective
չհամեիր	Verb
վարդապետների	Noun
համրովդ	Adjective
Աքեմենյաններ	Adjective
շարահյուսությամբ	Noun
աչիցս	Noun
աստվածաբանության	Noun
տնօրեններ	Noun
քուրդ	Noun
ռացիոնալ	Adjective
ցախի	Noun
աշխարհամասը	Noun
բարքերը	Noun
ընկուզենիները	Noun
արարողություններում	Noun
կեռնեխը	Noun
կոչով	Noun
վերնագրով	Noun
սկզբնատառ	Noun
կարտոֆիլից	Noun
խելացի	Adjective
հաճախորդներին	Noun
տրցակաձեւդ	Adjective
զրուցեցին	Verb
մղեցին	Verb
մականախաղի	Noun
դարպասից	Noun
մթնոլորտով	Noun
օգտագործեցին	Verb
խորշերի	Noun
սարավանդին	Noun
նվիրակ	Noun
այրան	Noun
շախմատիստը	Noun
շրջանագծով	Noun
թալիշերենին	Noun
աղվան	Noun
կլանող	Participle
վիրուսների	Noun
հոդվածի	Noun
ձեթերից	Noun
հանդուգն	Adjective
տեղին	Noun
խաղողը	Noun
գծիկը	Noun
արտասվող	Participle
քուղը	Noun
լյարդումս	Noun
որովայնի	Noun
ծիծաղկոտների	Adjective
չկտակեն	Verb
պատասխանատվությունները	Noun
սելավները	Noun
վճարեց	Verb
տորթի	Noun
վարունգին	Noun
ոգեշնչող	Participle
հարսները	Noun
կամարով	Noun
գործառնությունը	Noun
պետի	Noun
փախլավա	Noun
տեղեկություն	Noun
մեղքեր	Noun
աշտարակները	Noun
կուլտուրայով	Noun
վտանգի	Noun
գադոլինիումներովդ	Noun
կղկղանք	Noun
առանցքայինը	Adjective
ջրհորի	Noun
նոթին	Adjective
կրթություն	Noun
մեծագույնը	Adjective
սնդուկը	Noun
անապատականների	Adjective
կանաչում	Adjective
ցարին	Noun
թուլիումը	Noun
զարմիկներին	Noun
կառավարած	Participle
մողեսները	Noun
էրեկցիա	Noun
նիդերլանդական	Adjective
սենյակներից	Noun
տեսարաններ	Noun
զգուշանում	Verb
նավթի	Noun
ֆոտոնը	Noun
կտուց	Noun
անշարժ	Adjective
բադրիջան	Noun
հարեցինք	Verb
կորեկը	Noun
սխրանքներով	Noun
թեղու	Noun
շրջանագծեր	Noun
քաղաքականությունների	Noun
կանտոնս	Noun
խոնարհման	Noun
ժանրերում	Noun
երկարություններ	Noun
կոնքերի	Noun
նետաձիգներին	Noun
սուզանավերը	Noun
ժպիտս	Noun
չտարածեցիք	Verb
արքունիքներից	Noun
պարտքը	Noun
ուղտերով	Noun
մոռանալ	Verb
խաղաղություն	Noun
մեկնե՛ք	Verb
լրջությանը	Noun
ավելը	Noun
տաճարով	Noun
պոզիտրոնը	Noun
խորքում	Noun
դարպասը	Noun
լանչի	Noun
նավակատիկդ	Noun
մահանում	Verb
լյարդին	Noun
մեղրամոմ	Noun
ֆուտբոլիստներով	Noun
ամնիստիան	Noun
ֆրանսիացի	Noun
արատի	Noun
բանվորների	Noun
բուտ	Noun
հոգեբանություն	Noun
ականատեսի	Noun
տողերով	Noun
թարխանայիցս	Noun
սառուցյալովս	Adjective
վաշտերի	Noun
հասկանան	Verb
ատոլներովդ	Noun
գերմանական	Adjective
ջայնիզմի	Noun
մշակույթի	Noun
թանգարանը	Noun
փականագործ	Noun
զատելու	Verb
պաշտամունքը	Noun
թուշ	Noun
կեռասներիցդ	Noun
խայթոցի	Noun
օսման	Noun
հրեաների	Noun
ռիսկերը	Noun
կնքելու	Verb
գոյականով	Noun
սպային	Noun
բարձունքների	Noun
մարգագետնի	Noun
ձայնարկություն	Noun
հետազոտում	Verb
ահեղիս	Adjective
նախամայրը	Noun
երեխային	Noun
ենթակառուցվածքներ	Noun
հանրագիտարաններում	Noun
այտերին	Noun
պլատին	Noun
քաղաքականությունում	Noun
վիճակներում	Noun
քեֆերիս	Noun
կայսրուհիների	Noun
արմունկներիցս	Noun
վանքը	Noun
հարությունիցս	Noun
էլեմենտներից	Noun
լավագույնս	Adjective
նախագահությամբ	Noun
պուրակների	Noun
ալբոմով	Noun
գնաճի	Noun
աղբանոցում	Noun
բառարաններում	Noun
շահագործ	Verb
վճիռներին	Noun
բացառվում	Verb
փաթեթների	Noun
կարկինը	Noun
երկբարբառ	Noun
տարածքից	Noun
աֆղաներեն	Noun
համարած	Participle
խոհեմներով	Adjective
հանքից	Noun
խուզող	Participle
շոկոլադով	Noun
կառավարության	Noun
ակրոպոլիսը	Noun
հաշիվներին	Noun
բակ	Noun
մակամորձումս	Noun
բխում	Verb
առաքող	Participle
ճամփորդում	Verb
գաղափարները	Noun
վարդակակաչի	Noun
նորությունները	Noun
շարունակեին	Verb
ժպիտ	Noun
երդումներ	Noun
խաչքարին	Noun
ամերիցիումներիդ	Noun
բժշկում	Noun
բառացիներ	Adjective
ակնածեց	Verb
խանութներ	Noun
ճանապարհներով	Noun
սումոյիցդ	Noun
վրան	Noun
ճշմարտություն	Noun
զարթուցիչ	Noun
նավահանգիստ	Noun
անհերքելի	Adjective
գիդ	Noun
քվարկներից	Noun
հնչյունով	Noun
մրսածություն	Noun
հանդեսին	Noun
հռչակում	Noun
պատշգամբով	Noun
աջարականդ	Adjective
ագնոստիցիզմի	Noun
մոռանամ	Verb
տապի	Noun
կտակարանը	Noun
նվիրակներիցս	Noun
թեզաուրուսները	Noun
հեղափոխություն	Noun
ռետին	Noun
կուզենար	Verb
փառասիրության	Noun
աղեղները	Noun
գերմանացիներ	Noun
նախարարին	Noun
չողբանք	Verb
գումարներից	Noun
հեռախոսներից	Noun
սրբիչ	Noun
ավարներին	Noun
նախազգուշացումը	Noun
հանրախանութներիս	Noun
տենդով	Noun
ուսումնասիրենք	Verb
կանխեց	Verb
տենայի	Verb
որոշումներով	Noun
մրցույթները	Noun
համար	Verb
համախոհները	Noun
պարսկերենի	Noun
խորին	Adjective
հագեցր	Verb
ֆրանսուհուս	Noun
կռվախնձոր	Noun
թույները	Noun
կրոններ	Noun
գործվածքներից	Noun
թիթեղով	Noun
թիկունքից	Noun
բարձունքներում	Noun
մնջախաղերը	Noun
մանվածք	Noun
աղվանի	Noun
շալվարը	Noun
հատվել	Verb
բերբերներից	Noun
կենսագրությունից	Noun
չվերադարձան	Verb
քյամանչաները	Noun
հագավ	Verb
արտաքսելու	Verb
կաղապարի	Noun
հայրենիներիդ	Adjective
մարզադաշտի	Noun
վախին	Noun
հայուհի	Noun
հաջորդներին	Adjective
շարժի	Noun
փնտրում	Verb
մահափորձեր	Noun
շաշկու	Noun
ոսկորներին	Noun
անբանի	Adjective
փախնելիս	Verb
օվկիանոսներով	Noun
վակուումի	Noun
ծնոտին	Noun
խարույկը	Noun
առաքյալի	Noun
հոսանուտներիդ	Adjective
մերձավորներից	Adjective
ոսկրին	Noun
շահագործական	Adjective
կաղամախից	Noun
ճկույթ	Noun
շաքար	Noun
ավագումս	Adjective
նկարի	Noun
փչակիցս	Noun
դատարանով	Noun
հորիզոններ	Noun
Ամանորի	Noun
համբարձումը	Noun
լճեր	Noun
ստորինի	Adjective
խոյացող	Participle
բանային	Verb
ակնարկին	Noun
շախմատիստների	Noun
եկեղեցականներից	Adjective
պտերները	Noun
խորհուրդը	Noun
ապարանջանների	Noun
վանկերից	Noun
վառարանում	Noun
գարնանայիններին	Adjective
պատյանի	Noun
յուղալավաշներիցս	Noun
սմարթֆոնը	Noun
լոյսին	Noun
մրցավարները	Noun
չվերթները	Noun
բորշչի	Noun
արշավանքի	Noun
մուրցին	Noun
օրհներգերի	Noun
աճեն	Verb
սերմնաբշտիկներին	Noun
ախտորոշեցիք	Verb
քաշի	Noun
մանթով	Noun
մատյանը	Noun
բիբ	Noun
չորանում	Verb
կրոնը	Noun
խինդ	Noun
սպուտնիկումդ	Noun
ինքնուրույն	Adjective
ստվարածավալ	Adjective
աստղագնաց	Noun
հաղթակամար	Noun
ծայրակարմիրներում	Adjective
հոտելիք	Verb
խորհուրդների	Noun
զանգակներ	Noun
մտրակի	Noun
բազալտով	Noun
հաճախորդներ	Noun
կկարողանա	Verb
պատվերով	Noun
հետեւելու	Verb
բենգալի	Noun
խառնարաններով	Noun
մաթեմատիկոսներից	Noun
զորախմբերը	Noun
կովը	Noun
պարզում	Adjective
պարտեզում	Noun
փիլիսոփաների	Noun
խառնելիս	Verb
ռադիում	Noun
իմպերիալիստ	Noun
գավաթով	Noun
ժամկետներով	Noun
չխրոխտայիր	Verb
գործադուլների	Noun
նացիզմը	Noun
անթերի	Adjective
ֆրանկերեններիդ	Adjective
հաշիվներից	Noun
հերոսությամբ	Noun
հովտին	Noun
կառուցվածքում	Noun
սնդիկով	Noun
չափանիշներից	Noun
օպերայի	Noun
ապարոշիցս	Noun
բացառականում	Adjective
արական	Adjective
մանրադիտակով	Noun
հիվանդությունից	Noun
ավետարանը	Noun
մույթեր	Noun
քլորիդ	Noun
նարնջի	Noun
միզապարկ	Noun
բատիսկաֆում	Noun
բախի	Noun
բեղերից	Noun
աստղադիտարանը	Noun
հագեցնելու	Verb
հոտոտում	Verb
կատեգորիաներից	Noun
սպիտակները	Adjective
մատուցեն	Verb
վտիտ	Adjective
շուշաններ	Noun
հարբեցող	Participle
արամեացիներ	Noun
հովս	Adjective
խորհրդարանից	Noun
ռեակցիայով	Noun
լեզվաընտանիքը	Noun
ավիաընկերություններ	Noun
հղումների	Noun
բժիշկներիցդ	Noun
փայտիկներով	Noun
վրանները	Noun
մոլուցքներովս	Noun
պնակներ	Noun
աքսորին	Noun
կոտորածը	Noun
մայեր	Verb
աղեղին	Noun
անվճռականության	Noun
վաճառականների	Adjective
ատրճանակները	Noun
քաոսականներիդ	Adjective
մոծակներին	Noun
քվես	Noun
ոսպնյակից	Noun
հերոին	Noun
վարսավիր	Noun
ռեստորաններից	Noun
նավակով	Noun
հունիսի	Noun
ադամանդի	Noun
պլաստիկներիս	Adjective
տասնամյակների	Noun
կենսաբանությունը	Noun
սեռով	Noun
ֆունտով	Noun
վան	Verb
խաչմերուկների	Noun
արգոնը	Noun
թերակղզու	Noun
սառնարաններ	Noun
հանվող	Participle
բանվորները	Noun
զգուշացում	Noun
կհամարեն	Verb
պտույտից	Noun
գոթերեններով	Adjective
գրախոսությունումս	Noun
ստվարախումբներդ	Adjective
ուսերից	Noun
լուրերով	Noun
նախապայմանները	Noun
կզանգեիր	Verb
բաղաձայնները	Noun
սրբուհին	Noun
արծաթե	Adjective
հապավումից	Noun
նիստերի	Noun
խրձերով	Noun
հասկացանք	Verb
մեջքին	Noun
խառնաշփոթությունիցս	Noun
խավար	Adjective
աղբերակներում	Noun
բետոնը	Noun
մեղադրեք	Verb
կոչմանը	Noun
հուրը	Noun
հայես	Verb
կայքերից	Noun
ծորանը	Noun
տաքսին	Noun
չկակազեի	Verb
գրտնակների	Noun
չմիացրի	Verb
ճապոնացին	Noun
նահատակի	Noun
մետաղից	Noun
չարերը	Adjective
տեսություններից	Noun
ղասաբին	Noun
պիտոյից	Adjective
սկլերոզով	Noun
մեկնաբանություններ	Noun
վճռող	Participle
նախիրի	Noun
արտին	Noun
հարցազրույցը	Noun
հասին	Noun
փայլակով	Noun
ոչխարներին	Noun
եղջյուրի	Noun
կզաքիսով	Noun
սպիրտներում	Noun
ապուրով	Noun
արեւածագիդ	Noun
միահամուռ	Adjective
արաբներովդ	Noun
ֆլեշմոբի	Noun
արարողություններով	Noun
ժպիտով	Noun
հայդուկներից	Noun
ամսագրերի	Noun
մոտեցրել	Verb
այրուկ	Noun
ուզես	Verb
աղաների	Noun
թզուկներին	Noun
կալվածք	Noun
հուլիսյան	Adjective
վարչապետին	Noun
խուզում	Verb
աստղադիտարանում	Noun
ջինը	Noun
նեռի	Noun
համերի	Noun
պայմանավորվող	Participle
թենիսով	Noun
սերմնահեղուկում	Noun
ստրկացրել	Verb
տաղանդի	Noun
տորֆին	Noun
համակարգող	Participle
հատոր	Noun
սովորույթ	Noun
սաղմոններ	Noun
պիոնների	Noun
կամաց	Adjective
կարագում	Noun
կաջակցի	Verb
հալածանքի	Noun
անտարբերություն	Noun
նալբանդի	Noun
խօսելու	Verb
միկրոօրգանիզմի	Noun
գործարանին	Noun
մեքսիկիցդ	Noun
շնորհեինք	Verb
նստարանից	Noun
տեսությունում	Noun
հաշվով	Noun
ամորձիները	Noun
կարուսելներիս	Noun
խտրականությանը	Noun
ավագին	Adjective
չբանած	Participle
չծնգցնող	Participle
ցարի	Noun
վիճեինք	Verb
կենաց	Noun
փուլեր	Noun
ֆեոդալին	Noun
կիրճերով	Noun
խածնեինք	Verb
չընտրվեց	Verb
ամերիկացիները	Noun
գերիների	Adjective
պոլոնիումի	Noun
բջջովս	Noun
զուռնաներում	Noun
լիագումար	Adjective
թմրամիջոց	Noun
բացվածքներ	Noun
միմոս	Noun
մեծեր	Adjective
երկարի	Adjective
ցել	Noun
նախալեզուներդ	Noun
վարչապետացուներին	Noun
մրջնակերներ	Noun
կաղամբով	Noun
կորեկում	Noun
հարցումներին	Noun
ոսկրեր	Noun
կաթնուկին	Noun
էժաններում	Adjective
տրամաչափեր	Noun
հայկականում	Adjective
գործարկող	Participle
որջը	Noun
խխունջներիցդ	Noun
կճախրեի	Verb
հավաստիքը	Noun
արաբներին	Noun
գլխի	Adjective
կանչեցին	Verb
նավահանգստից	Noun
մալարիայի	Noun
չսփռեն	Verb
լուրերին	Noun
ֆեոդալներից	Noun
անհեթեթություն	Noun
սերմնաժայթքումից	Noun
խորանով	Noun
խեցգետին	Noun
լեմուրները	Noun
ամլիկներիցս	Noun
տորթումս	Noun
մղելու	Verb
ավարները	Noun
կեղծամներ	Noun
հանքերին	Noun
կարմրավուն	Adjective
հազարամյակից	Noun
մրմնջամ	Verb
չկճեիք	Verb
կրեսլոները	Noun
հունիսը	Noun
կանտոնում	Noun
արգասիքներով	Noun
հնչյուններով	Noun
խոտերը	Noun
ձեւը	Noun
տիք	Noun
հարձակմանը	Noun
թզուկի	Noun
նալբանդ	Noun
քյարումս	Noun
սպիրտները	Noun
քաղաքականությամբ	Noun
բիրմաներեններում	Adjective
լեզվաբանը	Noun
պաղպաղակ	Noun
ֆիզիկային	Noun
բեկորները	Noun
պարիսպներին	Noun
ջիները	Noun
մեդալը	Noun
հար	Verb
հագնվեր	Verb
ազազ	Verb
սանդուղք	Noun
սափորների	Noun
ձայնարկությունների	Noun
մեկնաբանություններումդ	Noun
հաշվումներ	Noun
խոհարար	Noun
հեկտարից	Noun
թեորեմները	Noun
գրառած	Participle
թեւերը	Noun
կանաչավուն	Adjective
փշերով	Noun
մոխրով	Noun
գեղեցկություններում	Noun
քառյակ	Noun
ոջիլը	Noun
մեքենաների	Noun
խաղամոլ	Noun
մաքսերի	Noun
շերեփ	Noun
զեյթուն	Noun
մաքրող	Participle
նիկելումս	Noun
չկռնչել	Verb
գրասենյակները	Noun
չափսով	Noun
բազալտներ	Noun
խոլերան	Noun
հոդին	Noun
արշիպելագին	Noun
վճիռները	Noun
մոլեկուլից	Noun
հատիկից	Noun
բեկորներով	Noun
ճահուկը	Noun
ֆրիզը	Noun
մատանիների	Noun
մթին	Adjective
մատուցելու	Verb
կերպերումդ	Noun
ստեղծագործությունը	Noun
մրցանակ	Noun
խեժի	Noun
առաջադիմող	Participle
կինձերիդ	Noun
ժամ	Noun
ամբոխից	Noun
լանջքերիդ	Noun
արգելքների	Noun
բնութագրեցին	Verb
լավաշ	Noun
հետեւեք	Verb
արհամարհում	Verb
ափիոնի	Noun
ինդոնեզերեն	Noun
աղեղում	Noun
ունկնդրին	Noun
պողպատներում	Noun
դժվար	Adjective
սպաները	Noun
լավաներ	Noun
օճառը	Noun
ալտին	Noun
շախմատիստներից	Noun
հաստության	Noun
հռչակի	Noun
ուտեստները	Noun
ներբեռնեց	Verb
հրահրող	Participle
ֆերմիոն	Noun
կապտուկ	Noun
խելագարների	Adjective
մոգը	Noun
աշտանակներ	Noun
յենը	Noun
թուլաներիցդ	Noun
փրփրալիք	Verb
արդյունաբերությունում	Noun
պարսիկների	Noun
թանգարանից	Noun
գլխարկը	Noun
պարուհի	Noun
գնդացրով	Noun
ջանար	Verb
նալբանդիցդ	Noun
ուղտերից	Noun
ունակությանը	Noun
համատեքստը	Noun
տառադարձվել	Verb
թիթեռներին	Noun
տարիքի	Noun
կդատապարտի	Verb
այծեր	Noun
աշխատեք	Verb
աղցանը	Noun
ցեղից	Noun
կարծեք	Verb
նպաստը	Noun
մոշենու	Noun
թոքերում	Noun
անզգայացման	Noun
քաոս	Noun
այրվող	Participle
ջերմությանը	Noun
ընկղմում	Verb
փեսայի	Noun
արջամուկ	Noun
կայծքար	Noun
բանտարկվել	Verb
ծաղկամաններում	Noun
անվտանգներով	Adjective
մոտո	Noun
մեկն	Verb
չպոռոտաբանեցիք	Verb
ածխածնով	Noun
արտաքսեց	Verb
մոխիրը	Noun
մրցավարների	Noun
ելուստները	Noun
համաժամանակյաներովդ	Adjective
բրոմը	Noun
ծորանով	Noun
անմնացորդներումդ	Adjective
բարիոններ	Noun
երկրպագուն	Noun
կուրերում	Noun
սովորույթները	Noun
առնանդամի	Noun
կալանքից	Noun
հրամանին	Noun
քլունգիս	Noun
նախածանցը	Noun
զորքերին	Noun
առաջադրանքի	Noun
լեհերից	Noun
հարցումից	Noun
անձեռոցիկի	Noun
իշխանությունները	Noun
չգնեցին	Verb
ավատ	Noun
ոսկեդրամ	Noun
անիոն	Noun
ֆաշիզմի	Noun
ոսկրը	Noun
վարունգից	Noun
պորտուգալացիներ	Noun
մեծաշուք	Adjective
թարգմանչի	Noun
շտապեն	Verb
ավարիցս	Noun
ջինսիդ	Noun
կոլիբրիին	Noun
պարաններից	Noun
ավանդույթով	Noun
յուղից	Noun
բարեկամ	Noun
կքաղցեք	Verb
տեղեկատուներդ	Adjective
ատրճանակներ	Noun
տրամվայները	Noun
քամիներին	Noun
ասացվածքներ	Noun
ազնավորներիցդ	Noun
ստեղծագործությամբ	Noun
ինտերնետի	Noun
աղանդավորները	Noun
զավթեց	Verb
ատոքների	Adjective
ոսկյա	Adjective
հաճախեն	Verb
պատրանքի	Noun
գետակին	Noun
ոսկուց	Adjective
հեռուստաընկերությանը	Noun
սիրածի	Noun
քննվել	Verb
ամերին	Noun
թոքաբորբը	Noun
վախեցիր	Verb
նախատանքիցս	Noun
բախումները	Noun
արկդ	Noun
խորքերում	Noun
առասպելներ	Noun
հագնված	Participle
մնացյալները	Adjective
շորերով	Noun
մետաֆիզիկադ	Noun
չթարթեն	Verb
սնգուրեինք	Verb
հաստոցի	Noun
օբյեկտներով	Noun
հորաներ	Noun
կալանքը	Noun
խճուղի	Noun
կլքեմ	Verb
համոզեն	Verb
խաչերին	Noun
սեպտեմբերյաններովս	Adjective
ճնշմանը	Noun
օմարի	Noun
անցքերը	Noun
մարգագետիններում	Noun
հրամայեց	Verb
կճուճներ	Noun
մակեդոնացին	Noun
պայտ	Noun
գանգաթիթեռդ	Noun
արտագաղթը	Noun
լաբիրինթոս	Noun
կափարիչին	Noun
շտեմարանների	Noun
անհանգստացած	Participle
ծիծեռնակ	Noun
պետերի	Noun
ուռենին	Noun
մարտկոցս	Noun
մարը	Noun
մասունք	Noun
բառարանների	Noun
ատաղձագործովս	Noun
արվեստների	Noun
ներբողների	Noun
նստարանի	Noun
հավասարումները	Noun
բխեցնել	Verb
կարմրավունին	Adjective
հատկացրել	Verb
մարքսիզմի	Noun
գծիկ	Noun
գրասենյակներ	Noun
ադրբեջաներենից	Adjective
տաճարներում	Noun
փուշ	Noun
նպաստած	Participle
լամպերը	Noun
ընտրվեցին	Verb
հոլովում	Noun
հաստատություն	Noun
ձեղնահարկի	Noun
կենդանացել	Verb
ռուսաստանցին	Noun
նմանի	Adjective
գուշակությունումս	Noun
գյուղատնտեսությունից	Noun
դիեցիկներովդ	Adjective
բորենու	Noun
սառույցների	Noun
մոլորակներից	Noun
բախը	Noun
քարանձավից	Noun
պրակրիտներով	Noun
պատանյակ	Noun
պառկելու	Verb
քյարը	Noun
օգտագործումից	Noun
երկնակամարի	Noun
կռիվների	Noun
վերջածանցների	Noun
տուփերը	Noun
սյունակներով	Noun
խրձեր	Noun
մուղտերս	Noun
կենդանիներից	Adjective
շուրթերից	Noun
հեշտ	Adjective
համալսարանին	Noun
իշխանության	Noun
կղմինդր	Noun
կանաչների	Adjective
տեսակներին	Noun
կակտուսի	Noun
կրաքարից	Noun
ֆտորից	Noun
ուռեցնել	Verb
պոռոտաբանությունները	Noun
հրվանդանում	Noun
տապակում	Noun
կովի	Noun
անմահ	Adjective
խնամած	Participle
գորշ	Adjective
գառանս	Noun
համաստեղությունից	Noun
իրադարձությունների	Noun
հեգնական	Adjective
տեքստերի	Noun
անկախություն	Noun
սեզ	Noun
աքսորատեղիներիս	Noun
արից	Noun
մեթոդներում	Noun
պարտեզի	Noun
լաբիրինթոսներովս	Noun
կուլին	Noun
կուլտուրաներում	Noun
հաքերով	Noun
չորոճեց	Verb
հյուպատոսությունումս	Noun
երթուղիներ	Noun
ժամկետներում	Noun
սպիտակուցներ	Noun
լենինիզմ	Noun
կերակրվել	Verb
ամպերին	Noun
հրաբուխներ	Noun
հանդեսներում	Noun
խաղամոլներ	Noun
հնարամտությամբ	Noun
ջերմաստիճաններով	Noun
ցեմենտ	Noun
երկաթգծերի	Noun
հոլովումներ	Noun
կարիճ	Noun
շուրթեր	Noun
հալոգենի	Noun
օդանավերը	Noun
պատրաստվել	Verb
օդանավերով	Noun
մաղթանքներ	Noun
հատկանիշներ	Adjective
բորենի	Noun
լացիցս	Noun
ժամկետների	Noun
եկով	Noun
հումանիզմի	Noun
կրոններից	Noun
բանվորներ	Noun
նվագածուներ	Noun
զննում	Verb
ոլորանների	Noun
սառնամանիքիցդ	Noun
պոլկա	Noun
արհեստավորների	Noun
գոյացած	Participle
ճգնաժամերի	Noun
վրացերենով	Noun
մորեղբայրներ	Noun
լեզգիով	Noun
սխալների	Adjective
պաշտամունքում	Noun
ջինսով	Noun
բղավեց	Verb
քերականը	Noun
իներտ	Adjective
գերշուկայից	Noun
շենքի	Noun
իտրիումի	Noun
դարձգրի	Noun
ջայլամի	Noun
կակազում	Verb
ոտանավորներին	Noun
խաշը	Noun
բղավեն	Verb
քյանդրբազություններս	Noun
շինարարիցս	Noun
նկուղ	Noun
արքունիքներում	Noun
մաքրենք	Verb
շագանակագեղձի	Noun
մտցնելիս	Verb
հացենու	Noun
հատու	Adjective
սկլերոզի	Noun
ոսոխին	Noun
պայմանագիր	Noun
իրական	Adjective
ժանտախտից	Noun
հույնի	Noun
սկզբունքին	Noun
բոյդ	Noun
անխելք	Adjective
խոցերը	Noun
սովորույթից	Noun
նվագում	Verb
թղթախաղի	Noun
հույլիցդ	Noun
վերադարձնել	Verb
սփռում	Verb
գուշակում	Noun
գաղափարներին	Noun
նախազգուշացում	Noun
պահապանների	Adjective
քամով	Noun
կոստյումներ	Noun
ընտրվեին	Verb
տիեզերագնացների	Noun
գոհացնեն	Verb
վարսեր	Noun
սմոգ	Noun
բառախաղումս	Noun
բնակված	Participle
ուղարկում	Verb
ընձառյուծի	Noun
չափանիշին	Noun
լուրեր	Noun
խոնարհի	Adjective
զուտերովդ	Adjective
դեկանի	Noun
փուլերում	Noun
բժշկից	Noun
նախանձը	Adjective
պարտիաների	Noun
նանիներս	Noun
վեպերի	Noun
քննության	Noun
տոկոսով	Noun
երդվյալները	Adjective
կպեղեիր	Verb
որսորդներին	Noun
կայսրուհիներ	Noun
փոխառությունը	Noun
հնարամիտների	Adjective
արգելոցում	Noun
խօսէր	Verb
թվաբանությունը	Noun
լճի	Noun
փեսան	Noun
հրամայականումդ	Adjective
մեղրամոմի	Noun
հազարամյակների	Noun
թագեր	Noun
անորոշությունները	Noun
մայրենին	Adjective
ընտիրումս	Adjective
կայծի	Noun
սվինը	Noun
տախտերի	Noun
գիտելիքներիցս	Noun
բանակցությունները	Noun
փուչիկը	Noun
դեղատունը	Noun
ցեծ	Noun
կլորավուններովս	Adjective
կոգեշնչեի	Verb
առաքինություններ	Noun
մետաղագործությունը	Noun
կրոնավորների	Adjective
կերակուրը	Noun
ռեակցիաներից	Noun
ավանակ	Noun
ծովախորշ	Noun
բազկաթոռ	Noun
ճարտարապետներ	Noun
առաքինությունը	Noun
շատերը	Adjective
արժեքից	Noun
գրասենյակումս	Noun
չհամակարգես	Verb
մեխանիզմ	Noun
վիճակից	Noun
հարսնացուի	Noun
հարվածը	Noun
հրդեհների	Noun
առանցքի	Noun
կոմսերին	Noun
անցքերում	Noun
բարձրավանդակում	Noun
խաղալիքներին	Noun
ռիսկին	Noun
լեմուրների	Noun
տոմսը	Noun
բարին	Adjective
ունակությունը	Noun
ճոճանակի	Noun
տորմիղից	Noun
սլացավ	Verb
աղանդեր	Noun
ականջներում	Noun
հակաճառություններիցս	Noun
բնակչությանը	Noun
ճանապարհորդը	Noun
հայրերը	Noun
սովորականը	Adjective
կներկայացնի	Verb
ընթացող	Participle
նախամոր	Noun
ցեց	Noun
մագմայի	Noun
գերդաստանում	Noun
աճյունի	Noun
առանցքից	Noun
սպաներին	Noun
ավտոտնակից	Noun
ալկոհոլ	Noun
սիգալ	Verb
ախոյաններով	Noun
առաքելության	Noun
դառն	Adjective
ողնուղեղ	Noun
գրողից	Noun
մերկացել	Verb
մարզադաշտից	Noun
կենսաբանները	Noun
հարաբերություններից	Noun
բաշը	Adjective
ընդգծեցին	Verb
ղափամաներդ	Noun
վիրուսներ	Noun
բողբոջներով	Noun
ամուսնացրին	Verb
որորներ	Noun
վճիտովդ	Adjective
զանգակներիցդ	Noun
ուրախների	Adjective
նավակայանին	Noun
փաստաբանին	Noun
հարգում	Verb
լիթիում	Noun
լոուրենսիումներում	Noun
չկրծեցի	Verb
շտկող	Participle
լաչառներովդ	Adjective
մուղերը	Noun
կցելու	Verb
սանձես	Verb
տնտեսական	Adjective
բզզալիք	Verb
հարաբերությունը	Noun
կրոնական	Adjective
գրախոսություններ	Noun
թարխանով	Noun
մանրամաս	Noun
ակումբներում	Noun
ազդեցությունները	Noun
օրակարգին	Noun
կործանվել	Verb
ակադեմիաներ	Noun
դարպասներով	Noun
ահաբեկված	Participle
խրատներով	Noun
երախներումդ	Noun
գավազանների	Noun
մսով	Noun
պարանոցից	Noun
աջակցեն	Verb
ճվիցս	Noun
պարսիկներիցդ	Noun
տեքստին	Noun
տնակներով	Noun
լավաշով	Noun
երկբարբառները	Noun
ընծաների	Noun
կորեկի	Noun
վարկածների	Noun
ժողովածուն	Noun
հացով	Noun
դանիական	Adjective
կբացատրեք	Verb
հետազոտեցին	Verb
չխնամած	Participle
բուխարականից	Adjective
մեխակի	Noun
վարդակակաչս	Noun
խոստմանս	Noun
կոնյակի	Noun
քայլերով	Noun
օժանդակեցի	Verb
կազմակերպության	Noun
գրողներ	Noun
էրիկին	Noun
արսենով	Noun
լեռնաշխարհներով	Noun
շատին	Adjective
պայմանավորվենք	Verb
հուշարձան	Noun
ներքնազգեստի	Noun
բարիումները	Noun
գործարանից	Noun
ծիրանենին	Noun
լվացող	Participle
ելույթներին	Noun
գերմանացիներից	Noun
բոկոտն	Adjective
ձմուկիս	Noun
տարափը	Noun
զանգակ	Noun
բարիք	Noun
մանրէաբանովս	Noun
արսենի	Noun
նոյեմբերին	Noun
բողոքեց	Verb
շքերթի	Noun
ծայրերով	Noun
ֆտորը	Noun
մամուռներով	Noun
օգուտ	Noun
թութը	Noun
բանտը	Noun
խոնարհումների	Noun
սահմանելու	Verb
խորամանկդ	Adjective
արկերի	Noun
հորդեցիք	Verb
աստղադիտակները	Noun
նվագ	Verb
տատիկներովդ	Noun
ասվեղովս	Adjective
հայցերի	Noun
լեհեր	Noun
պատկերվել	Verb
վտանգներ	Noun
մավիումդ	Adjective
կոլխոզներ	Noun
տարածքին	Noun
մորմոնների	Noun
կարտոֆիլ	Noun
ակունքում	Noun
սարքավորումը	Noun
կրծքանշան	Noun
իրիկվադ	Noun
վաճառքում	Noun
սյունակները	Noun
տոհմը	Noun
վիկինգները	Noun
մայրցամաքով	Noun
մամիկ	Noun
կպայմանավորեինք	Verb
ապարանջանդ	Noun
քահանան	Noun
մատիտով	Noun
հունվարին	Noun
հոշոտում	Verb
մկրտում	Noun
գորշից	Adjective
կավելացնեմ	Verb
գուշակի	Noun
տափաստաններից	Noun
քարտուղարներ	Noun
աղանդները	Noun
կրակեք	Verb
ուսուցչի	Noun
կույրեր	Adjective
քուրդը	Noun
խոխոջացել	Verb
հյուրանոցներում	Noun
գործվածքով	Noun
ուտեստներում	Noun
ավիաընկերությունը	Noun
պարիկներս	Noun
բեկորներ	Noun
սիգաներին	Noun
հաստությունների	Noun
խթանը	Noun
ճնշումներ	Noun
շնչելիս	Verb
կեղտից	Noun
հնձաններից	Noun
երաժշտություն	Noun
իմունիտետի	Noun
ահդ	Noun
հանրապետություն	Noun
մամուլներիս	Noun
անապատներում	Adjective
աշխատեին	Verb
հրեաներին	Noun
թան	Noun
փարթամակեցություններիս	Noun
մնջախաղ	Noun
երախտիքը	Noun
անդյա	Noun
վախենալ	Verb
լեմուրներ	Noun
կնճիթով	Noun
լայնությունից	Noun
նոյեմբերյանի	Adjective
կանխած	Participle
չերգիծել	Verb
սպիի	Noun
արջեր	Noun
անհույս	Adjective
ցավացինք	Verb
հոլովակ	Noun
փորձեմ	Verb
չգթայինք	Verb
վալտորնով	Noun
խոյանում	Verb
զվարթներովդ	Adjective
ճանապարհներ	Noun
կարմրեցի	Verb
մտադրությամբ	Noun
խցիկի	Noun
այգիների	Noun
կմուրայի	Verb
հնարներով	Noun
արագովդ	Adjective
օծանելիքը	Noun
անագ	Noun
օսմիումներով	Noun
նկարիչներ	Noun
ծերուկին	Noun
արտոնագրերի	Noun
ծրարները	Noun
ծնոտները	Noun
յուղերով	Noun
գմբեթիցս	Noun
ապտակը	Noun
գլուխ	Adjective
ցիրկոնիումի	Noun
կիմերներ	Noun
իրիգունները	Noun
հորաններիցս	Noun
կատարենք	Verb
բաժի	Noun
ժամացույցներից	Noun
օճառների	Noun
տնօրինող	Participle
օրհներգում	Noun
երթեւեկությանս	Noun
շենքում	Noun
անհրաժեշտության	Noun
կազմակերպություններից	Noun
ասորիներ	Noun
ընծայիս	Noun
համակարգեց	Verb
գորտնուկ	Noun
ակնը	Noun
տանգոներին	Noun
ցածրս	Adjective
կառքին	Noun
կրպակներում	Noun
քայլող	Participle
ծնին	Noun
ապացուցվող	Participle
հեռացրեց	Verb
որջի	Noun
հարցմանը	Noun
ալկոհոլով	Noun
հերը	Noun
ղպտիական	Adjective
կրունկին	Noun
նեռը	Noun
բարձրավանդակների	Noun
մագմա	Noun
ելույթները	Noun
շառավղով	Noun
ծն	Verb
կավելացնեի	Verb
կրոնների	Noun
այցելություններից	Noun
ծնողներ	Noun
կոսմոպոլիտ	Noun
