antisemitizmom	Instrumental
historijom	Instrumental
vještinom	Instrumental
šarmantnijom	Instrumental
autorizacija	Nominative
ohlađeni	None
režisere	Accusative
balavci	Vocative
autoput	Accusative
stanovništvom	Instrumental
kletvu	Accusative
običavala	None
glagoljica	Nominative
žlebovi	Vocative
smjenjuje	None
verovanjem	Instrumental
pavijanom	Instrumental
državničkom	Instrumental
tražio	None
špekulantom	Instrumental
poštujemo	None
nagađalo	None
dohotke	Accusative
izborili	None
simetriju	Accusative
vjernik	Nominative
propovjednike	Accusative
bijekcijom	Instrumental
bilježaka	Genitive
metastazu	Accusative
negativce	Accusative
najvjernijom	Instrumental
probano	None
inicijator	Nominative
blesnemo	None
zabranile	None
šiva	None
proširene	None
odnela	None
posluženo	None
pacifist	Nominative
najvišom	Instrumental
suparnik	Nominative
rehabilitacijom	Instrumental
intimnost	Accusative
harao	None
učešćem	Instrumental
titanijem	Instrumental
slaganjem	Instrumental
rodbine	Genitive
šopaše	None
invalidìtēt	Nominative
pogrbljujete	None
gnosticìzma	Genitive
obavijest	Accusative
vekova	Genitive
susretne	None
šefovi	Vocative
sinovcem	Instrumental
renoviraju	None
najhranjivijom	Instrumental
proznom	Instrumental
уредни	Accusative
malaksavane	None
ismijavaj	None
agavo	Vocative
azbukom	Instrumental
rezervoára	Genitive
dezorijentacije	Genitive
nakano	Vocative
cestom	Instrumental
indoeuropsku	Accusative
bolnicom	Instrumental
grijeh	Accusative
arhitektonsku	Accusative
најпрофињенији	Accusative
prepuste	None
naftom	Instrumental
pješáci	Nominative
lili	None
uživahu	None
kidaju	None
desetoricu	Accusative
publicitetom	Instrumental
osobom	Instrumental
radničkom	Instrumental
slušalac	Nominative
istočnom	Instrumental
kukavičluče	Vocative
dodaci	Vocative
uvjerismo	None
perfekta	Genitive
obmanu	Accusative
snivajmo	None
torom	Instrumental
функционалан	Accusative
apsidu	Accusative
zgrušavasmo	None
rabljen	None
bistom	Instrumental
seosku	Accusative
neovisnost	Accusative
deklinaciju	Accusative
održao	None
studenca	Genitive
potraju	None
obrok	Accusative
kursom	Instrumental
tiskano	None
prut	Accusative
promiče	None
grba	Genitive
dahtajem	Instrumental
obore	Accusative
piroksen	Accusative
bakteriologije	Genitive
uklonile	None
puhovi	Vocative
dubi	None
nekolicine	Genitive
smetao	None
medicinskom	Instrumental
književnu	Accusative
debatu	Accusative
monitorom	Instrumental
panjeva	Genitive
prezervativ	Accusative
zahvalnost	Accusative
sanjala	None
oligarh	Nominative
zapisao	None
županijom	Instrumental
diplomatsku	Accusative
најспекулативнији	Accusative
zaštićene	None
pasošem	Instrumental
prijateljsku	Accusative
ukrštava	None
palente	Genitive
prošireni	None
historiografije	Genitive
svjetioničare	Accusative
fakinku	Accusative
loptom	Instrumental
panikom	Instrumental
rudimentarnijom	Instrumental
kihahu	None
najtrpkiju	Accusative
stambenom	Instrumental
poveznicom	Instrumental
spektáklā	Genitive
putnikom	Instrumental
napravite	None
menzise	Accusative
opire	None
znače	Vocative
adresom	Instrumental
esenciju	Accusative
desetogodišnjakom	Instrumental
kurtizanu	Accusative
morbila	Genitive
zabranjivala	None
skupštinarom	Instrumental
leguru	Accusative
kotlovino	Vocative
heksametra	Genitive
zvonik	Accusative
puče	None
dražu	Accusative
baroknom	Instrumental
prizma	Nominative
sastavke	Accusative
obeliskom	Instrumental
pismom	Instrumental
murvom	Instrumental
utvrđivalo	None
pruća	Genitive
kugom	Instrumental
fragilnijom	Instrumental
poginete	None
reprezentacijom	Instrumental
niza	Genitive
apsorpcijom	Instrumental
uvežbavaju	None
obućom	Instrumental
predznakom	Instrumental
svidjele	None
bacite	None
bežali	None
poveljom	Instrumental
mehanikom	Instrumental
dlanovi	Vocative
fenomenom	Instrumental
dogmom	Instrumental
priđi	None
urodom	Instrumental
toptalo	None
osušen	None
koljenom	Instrumental
biračkom	Instrumental
tržnicom	Instrumental
adekvatnost	Accusative
zabavljačem	Instrumental
eliminaciju	Accusative
staratelj	Nominative
izložena	None
kvare	Vocative
zabranili	None
ilovačom	Instrumental
konzumacijo	Vocative
gospođom	Instrumental
džihadom	Instrumental
metu	Accusative
glàvīć	Nominative
omladinci	Vocative
statističkom	Instrumental
cepelin	Accusative
najštedljivijom	Instrumental
rekonstruirao	None
nuklearku	Accusative
riješeni	None
iznajmljuješ	None
републички	Accusative
njuhom	Instrumental
stranku	Accusative
krstari	None
kȋčma	Nominative
knjigovodstva	Genitive
klȋnka	Nominative
ključevi	Essive
pločnici	Vocative
smišljene	None
sovu	Accusative
brašna	Genitive
krstova	Genitive
motiviraju	None
kvartom	Instrumental
prenošena	None
mušketir	Nominative
lovokradicom	Instrumental
upotrebljavano	None
artritisa	Genitive
dostižem	None
garantuje	None
biva	None
javnom	Instrumental
brȍjākā	Genitive
dostiže	None
nosačicom	Instrumental
zabrinutost	Accusative
harale	None
somnabulizama	Genitive
ovladale	None
krunicu	Accusative
utajite	None
idejnom	Instrumental
kraše	Vocative
nadležnošću	Instrumental
oduzimahu	None
једнаки	Accusative
egoizam	Accusative
najtajnovitijom	Instrumental
madrac	Accusative
preskaču	None
dávalac	Nominative
pivskom	Instrumental
karizmom	Instrumental
skrasili	None
otkopani	None
župu	Accusative
dvorištem	Instrumental
percepcijom	Instrumental
glȅžnjēvā	Genitive
upravnu	Accusative
rezultirao	None
vraća	None
nameštaja	Genitive
svratili	None
oduzelo	None
blokirale	None
kovano	None
severnom	Instrumental
коауторски	Accusative
ponesu	None
švicarskom	Instrumental
поуздан	Accusative
sedam	None
pedofilije	Genitive
radikala	Genitive
današnjom	Instrumental
sednicu	Accusative
averzijo	Vocative
česmu	Accusative
pucnjavom	Instrumental
повредив	Accusative
pčelinjak	Accusative
približen	None
sudnicu	Accusative
belorusku	Accusative
antikomunističkom	Instrumental
postavku	Accusative
izrade	None
lokomotivu	Accusative
obezglavljeno	None
redosleda	Genitive
obelodanimo	None
dino	Vocative
pokorena	None
klobuka	Genitive
ceremonijom	Instrumental
luđake	Accusative
uključili	None
prijetile	None
opsjedala	None
bȃrka	Nominative
kućicu	Accusative
koristile	None
grešnicom	Instrumental
odnosile	None
transportnom	Instrumental
spolom	Instrumental
dogodila	None
letelicu	Accusative
kofeinom	Instrumental
nagrnulo	None
pripišu	None
bresta	Genitive
lukavci	Vocative
transpàrentnōst	Nominative
kóbī	Genitive
inči	Vocative
svježino	Vocative
oligarhiju	Accusative
iskusi	None
cìvīl	Nominative
неупадљив	Accusative
južnjake	Accusative
hajali	None
lignja	Nominative
severče	Vocative
meteorološkom	Instrumental
računare	Accusative
златни	Accusative
mni	None
takt	Accusative
djelovala	None
odvojenost	Accusative
krvotoka	Genitive
def	Accusative
potkupljen	None
glasuju	None
petka	Genitive
lugára	Genitive
kòtac	Nominative
zeka	Genitive
nevesto	Vocative
cezurom	Instrumental
plan	Accusative
čapasmo	None
zlȃtnīci	Nominative
sondu	Accusative
kružnicu	Accusative
алувијални	Accusative
zadužuje	None
razmenu	Accusative
slušaju	None
škripa	Nominative
propisala	None
izvozile	None
когнитиван	Accusative
potežu	None
čudotvórci	Nominative
usmeri	None
pozivom	Instrumental
isticali	None
доњи	Accusative
pratio	None
eshatološkom	Instrumental
plamenca	Genitive
brača	Genitive
pretpostavio	None
križare	Accusative
amputaciju	Accusative
prevarom	Instrumental
zaljubljene	None
sekretar	Nominative
osvajača	Accusative
predigru	Accusative
jednačah	None
gurne	None
ujela	None
metafiziko	Vocative
razočarava	None
prekrivaju	None
pretplaćivahu	None
melasa	Nominative
zastorom	Instrumental
pitani	None
naučnikom	Instrumental
oslabljeno	None
motivira	None
ispisani	None
dijelovi	Vocative
razaran	None
vrtovi	Vocative
kruhom	Instrumental
idolom	Instrumental
hidrauličkom	Instrumental
vatrogasac	Nominative
rasprodate	None
pravdom	Instrumental
dovikivalo	None
tetovirano	None
ubrana	None
utrobu	Accusative
postupke	Accusative
kćérka	Nominative
posuđen	None
tjelovježbu	Accusative
analitičku	Accusative
срећни	Accusative
zamijenite	None
ključniju	Accusative
uživaju	None
satiričar	Nominative
ojačano	None
lajtmòtīv	Nominative
zenu	Accusative
vretenom	Instrumental
punili	None
mlȉtāvca	Genitive
pintar	Nominative
dopunsku	Accusative
frustraciju	Accusative
statičkom	Instrumental
pohote	Genitive
prostirale	None
aristokratom	Instrumental
pomiješala	None
oboreni	None
prizmom	Instrumental
урбани	Accusative
sadiocem	Instrumental
zapregu	Accusative
ukrašavane	None
napadače	Accusative
tiče	None
zamjeraju	None
angolskom	Instrumental
rore	Vocative
dijahronijo	Vocative
hladnoću	Accusative
katolicizmom	Instrumental
odborom	Instrumental
anatomsku	Accusative
testirali	None
iskvaren	None
nudist	Nominative
odom	Instrumental
lasere	Accusative
sastavite	None
šljame	Vocative
smera	Genitive
učenjem	Instrumental
пејоративан	Accusative
pogođene	None
kompresorom	Instrumental
verovalo	None
naginjala	None
kurbana	Genitive
grofove	Accusative
domaćicu	Accusative
tràpēz	Nominative
elektricitet	Accusative
toplica	Genitive
metkom	Instrumental
separatizam	Accusative
promašio	None
transformaciju	Accusative
dočekano	None
džukelom	Instrumental
božanstvom	Instrumental
dojmom	Instrumental
pozanpozna	Accusative
veterinarsku	Accusative
pokrivalo	None
sumnju	Accusative
varku	Accusative
неправилнији	Accusative
zamjerila	None
vjenčali	None
infekciju	Accusative
kluba	Genitive
žižljivijom	Instrumental
ozbiljniju	Accusative
безгранични	Accusative
platile	None
jugoslavensku	Accusative
organizaciju	Accusative
štetom	Instrumental
aparat	Accusative
razapinjahu	None
bojovnike	Accusative
hapsio	None
košarkom	Instrumental
saziva	None
antipatičnijom	Instrumental
rukovodilac	Nominative
zaručnicu	Accusative
stankom	Instrumental
mesečnom	Instrumental
posreduju	None
rastvorila	None
penise	Accusative
odbijen	None
vijke	Accusative
mladošću	Instrumental
zapalo	None
ustrojem	Instrumental
ublažilo	None
raspoznatljiviju	Accusative
vrhovnikom	Instrumental
osloboditelje	Accusative
samoansku	Accusative
đake	Accusative
ustrojila	None
odbojnikom	Instrumental
kopajte	None
tega	Genitive
investiciju	Accusative
naslijedile	None
izjednačila	None
koševa	Genitive
najavljuju	None
ojačavao	None
značajku	Accusative
odvažnost	Accusative
desetogòdišnjāk	Nominative
uživao	None
prolazom	Instrumental
kvarila	None
višnja	Nominative
skelet	Accusative
nagonom	Instrumental
akrobatskom	Instrumental
spaljena	None
prosperitetom	Instrumental
pleromu	Accusative
punoglavci	Vocative
strijelaca	Genitive
korpusom	Instrumental
finišem	Instrumental
sednicom	Instrumental
militarizam	Accusative
štemale	None
prebrodi	None
siromahe	Accusative
formaciju	Accusative
povezivano	None
uro	Vocative
svrhovitost	Accusative
začaravao	None
slabio	None
amaterizam	Accusative
izgubili	None
kvalitetom	Instrumental
nevestu	Accusative
lampa	Nominative
okončan	None
stanovnik	Nominative
kandžom	Instrumental
dovozili	None
pohòtljīvca	Genitive
otkrilo	None
ožiljci	Vocative
pretraživali	None
uš	Accusative
balona	Genitive
ispričan	None
čehoslovačku	Accusative
grabova	Genitive
ranijom	Instrumental
dansku	Accusative
cvjetajmo	None
obućar	Nominative
plivaćom	Instrumental
putopisca	Accusative
civilizacijom	Instrumental
latinica	Nominative
studence	Accusative
južnjaci	Vocative
nasipom	Instrumental
crnomorsku	Accusative
popularizator	Nominative
spontanost	Accusative
smokvici	Vocative
podrignemo	None
uvećavala	None
magnetom	Instrumental
krivulju	Accusative
introspekciju	Accusative
mjehuriće	Accusative
pitaj	None
okolnu	Accusative
ritmičkom	Instrumental
osmansku	Accusative
dezorijentaciju	Accusative
nosnikom	Instrumental
besjedo	Vocative
đakon	Nominative
flautom	Instrumental
rezonantnijom	Instrumental
eliminacijom	Instrumental
spilju	Accusative
ionosferu	Accusative
poremetili	None
bombarder	Accusative
okrivljuju	None
likvidacijom	Instrumental
pušta	None
ocenom	Instrumental
pobegne	None
najvažnijom	Instrumental
kramp	Accusative
dedukcijom	Instrumental
parodijom	Instrumental
користан	Accusative
četom	Instrumental
okusila	None
kanala	Genitive
onesposobljavasmo	None
ulomaka	Genitive
špiljom	Instrumental
travanjskom	Instrumental
jambom	Instrumental
alfabet	Accusative
raspršena	None
građanstvom	Instrumental
odgađala	None
italijanskom	Instrumental
tildo	Vocative
obilaze	None
izbola	None
unosili	None
gejeva	Genitive
izvozom	Instrumental
zine	None
sapunicom	Instrumental
džepove	Accusative
dodeljuju	None
opat	Nominative
црнкаст	Accusative
ubacivala	None
najrečitijom	Instrumental
nadamo	None
istupaju	None
porodičnu	Accusative
klina	Genitive
najpoznatijom	Instrumental
zatočili	None
pretvoren	None
primiše	None
dimljeno	None
skladateljem	Instrumental
ostvarivala	None
uhvate	None
izbačene	None
aerodromskom	Instrumental
skakáča	Genitive
ožive	None
izdvojio	None
izvršnu	Accusative
konferencijom	Instrumental
mobilizacijom	Instrumental
чврст	Accusative
proglašavali	None
titlova	Genitive
jahaše	None
ateizmom	Instrumental
neprijateljsku	Accusative
džidžom	Instrumental
katabolizmom	Instrumental
konfliktom	Instrumental
žulj	Accusative
kraljem	Instrumental
mlohavijom	Instrumental
oktet	Accusative
članicom	Instrumental
žabetino	Vocative
glogovinom	Instrumental
diplomatskom	Instrumental
oteram	None
dabrovine	Genitive
нижи	Accusative
dlijetom	Instrumental
materijalističkom	Instrumental
najbrižljiviju	Accusative
probudio	None
vrhunci	Vocative
ekosìstēm	Nominative
zabruja	None
trošite	None
mitraljeza	Genitive
novčanu	Accusative
simboliziraju	None
miga	Genitive
prijetnju	Accusative
sačuvam	None
hipoteku	Accusative
sindikatom	Instrumental
usložnjavane	None
veseljaci	Vocative
ubodom	Instrumental
antropologiju	Accusative
pòznanīci	Nominative
maramicu	Accusative
barku	Accusative
trgovcem	Instrumental
kumarina	Genitive
dete	Accusative
сличан	Accusative
tehnologijom	Instrumental
starala	None
uvećava	None
usidrene	None
terapijo	Vocative
obuči	None
razmotrimo	None
spriječena	None
upotrebljavaju	None
tigrom	Instrumental
najbešćutnijom	Instrumental
katastrofom	Instrumental
osobu	Accusative
agresivnošću	Instrumental
grupu	Accusative
sedištem	Instrumental
kartel	Accusative
rezultat	Accusative
seva	Genitive
krša	Genitive
ȕmāci	Nominative
džakovi	Vocative
lončićem	Instrumental
staleže	Accusative
nastavljena	None
pasto	Vocative
razmake	Accusative
skrb	Accusative
rđa	Nominative
ulazaka	Genitive
ograničili	None
sabornicu	Accusative
aktivistom	Instrumental
emancipaciju	Accusative
nadmoćnijom	Instrumental
februarskom	Instrumental
bračnu	Accusative
upućivao	None
anatomiju	Accusative
бугарски	Accusative
libidom	Instrumental
otvorila	None
dojavo	Vocative
oživjela	None
sram	Accusative
uhvatite	None
srpa	Genitive
posjetitelj	Nominative
zavladaju	None
adaptaciju	Accusative
elektricitetom	Instrumental
raspodjelu	Accusative
dogovoreno	None
zahtijevao	None
hijskihijerarhijskoga	Accusative
najopravdaniju	Accusative
pòslovi	Nominative
kerber	Accusative
dalekoistočnom	Instrumental
poboljšani	None
žargonom	Instrumental
odvajaju	None
bikom	Instrumental
zadnjom	Instrumental
горњи	Accusative
pčelar	Nominative
brevijara	Genitive
iritaciju	Accusative
blasfemiju	Accusative
anahronizam	Accusative
kanove	Accusative
fotografom	Instrumental
ishranom	Instrumental
listopadskom	Instrumental
konstruktivniju	Accusative
trbušnu	Accusative
grȁđanin	Nominative
strahujete	None
kovnicu	Accusative
которипски	Accusative
najljepšu	Accusative
kohortu	Accusative
šibicom	Instrumental
banderu	Accusative
sastale	None
privukla	None
manjìna	Nominative
suprotstavlja	None
diplomatom	Instrumental
најзначајнији	Accusative
homonim	Accusative
skolastike	Genitive
sadra	Nominative
зглобни	Accusative
pejzažom	Instrumental
majstorom	Instrumental
rijeku	Accusative
anarhističku	Accusative
repove	Accusative
shemo	Vocative
poljubili	None
smjesti	None
висок	Accusative
vonjem	Instrumental
nivoom	Instrumental
баскијски	Accusative
brȅzōvca	Genitive
vijencem	Instrumental
jahtu	Accusative
nadjevom	Instrumental
obuhvaćaju	None
dočasnik	Nominative
zatečeno	None
sažetak	Accusative
invalidskom	Instrumental
kartografijom	Instrumental
mrazova	Genitive
atletičarku	Accusative
naslikan	None
dokumentacije	Genitive
atlas	Accusative
prašinu	Accusative
prže	None
muzom	Instrumental
svrstavahu	None
sušena	None
igla	Nominative
album	Accusative
ukočenijom	Instrumental
prognale	None
funkcijo	Vocative
protivili	None
брзи	Accusative
odluče	None
mašinerijom	Instrumental
obaviješteni	None
naftu	Accusative
čine	Vocative
kapilaro	Vocative
proučavamo	None
mekoća	Nominative
benevolentniju	Accusative
posrednici	Vocative
mrlju	Accusative
omogućena	None
posekli	None
rajom	Instrumental
doneslo	None
podizane	None
svinju	Accusative
platu	Accusative
pucnjeve	Accusative
recepta	Genitive
izrasli	None
ostatak	Accusative
probuši	None
protektorata	Genitive
slutili	None
razbojničku	Accusative
Pruse	Vocative
òdvojenōst	Nominative
vežbu	Accusative
brežuljka	Genitive
plesačicu	Accusative
bošnjačku	Accusative
zmajem	Instrumental
grmovi	Vocative
jednoglasnost	Accusative
dobom	Instrumental
slance	Accusative
ožiljke	Accusative
slatkoća	Nominative
genomom	Instrumental
čipove	Accusative
svladavaju	None
susretao	None
osetio	None
raspodeljivan	None
geografiju	Accusative
činova	Genitive
kopriva	Nominative
obavještajnom	Instrumental
orangutansku	Accusative
pòdrškī	Genitive
zasluživah	None
осећајни	Accusative
misionare	Accusative
elektromagnetom	Instrumental
šihto	Vocative
obrezali	None
opciju	Accusative
prevagu	Accusative
послушан	Accusative
nastavljen	None
taoca	Accusative
blažu	Accusative
mjesečarstava	Genitive
ponele	None
košuljom	Instrumental
neurološku	Accusative
anarhistom	Instrumental
aludirao	None
identiteta	Genitive
odobrovoljile	None
iskrcala	None
vratite	None
banjicu	Accusative
rep	Accusative
namjenjivahu	None
jadom	Instrumental
obrubljuju	None
obračunom	Instrumental
gospodarskom	Instrumental
kafu	Accusative
ovcom	Instrumental
križa	None
kitila	None
porobi	None
grmova	Genitive
prelazimo	None
zaokružili	None
najkvalitetnijom	Instrumental
rasformiran	None
antitezom	Instrumental
triciklom	Instrumental
lijekove	Accusative
komentirali	None
dodeljivana	None
takta	Genitive
pando	Vocative
geologijom	Instrumental
pojačaju	None
letelicom	Instrumental
tovimo	None
fluida	Genitive
presudu	Accusative
besmrtnike	Accusative
stražnjicu	Accusative
čvorom	Instrumental
скромни	Accusative
morfologija	Nominative
sredozemnu	Accusative
kraticom	Instrumental
oporezovaste	None
древни	Accusative
riko	Vocative
šeširdžiju	Accusative
podržale	None
водећи	Accusative
humanističku	Accusative
stiskom	Instrumental
mađarskom	Instrumental
nestajasmo	None
vij	None
poetikom	Instrumental
poštovaoče	Vocative
трапав	Accusative
turcizama	Genitive
igumaniju	Accusative
špengler	Nominative
slijedilo	None
sastavom	Instrumental
obuzdana	None
prenosnici	Vocative
grunt	Accusative
žurku	Accusative
кичмени	Accusative
nadogradili	None
smanjivane	None
televizorom	Instrumental
privesci	Vocative
filološkom	Instrumental
žrtvenike	Accusative
okretale	None
sinovci	Vocative
apsolvirao	None
statiku	Accusative
kardiologija	Nominative
obesila	None
božanskom	Instrumental
novosadskom	Instrumental
pripaziše	None
okovom	Instrumental
strvinar	Nominative
ružmarinom	Instrumental
kreča	Genitive
sklopljen	None
jezike	Accusative
speleološku	Accusative
bilježeni	None
dugujemo	None
električnu	Accusative
izdaváča	Genitive
glȋb	Nominative
poslednjom	Instrumental
preplaši	None
zločincem	Instrumental
vragom	Instrumental
zaposlila	None
proznu	Accusative
opstoj	None
iranskom	Instrumental
báščā	Genitive
akademijom	Instrumental
osećali	None
prijepódneva	Genitive
potomkom	Instrumental
trn	Accusative
proceduru	Accusative
ekumenìzam	Nominative
podržavamo	None
kulturu	Accusative
dočekivao	None
kvartovi	Vocative
katodnom	Instrumental
anomaliju	Accusative
rezanaca	Genitive
kriminalistike	Genitive
pohabaše	None
vignja	Genitive
okean	Accusative
prodao	None
heretikom	Instrumental
krinku	Accusative
tiskane	None
izvršena	None
mramorom	Instrumental
žitnicom	Instrumental
sindžíra	Genitive
poništila	None
označava	None
česmom	Instrumental
Zemlje	Genitive
otkrili	None
naoružava	None
katàlozi	Nominative
zabola	None
klisuru	Accusative
prikupljao	None
pazarila	None
sekretare	Accusative
razbistriše	None
sadržajem	Instrumental
nabrojeno	None
zločinac	Nominative
sanacijo	Vocative
objedinjavalo	None
punilo	None
carevinu	Accusative
kočijom	Instrumental
strujom	Instrumental
cjedilom	Essive
teološkom	Instrumental
дезоксирибонуклеински	Accusative
žudnjom	Instrumental
viškom	Instrumental
prevladamo	None
dotiskate	None
rodbinom	Instrumental
zadirkuju	None
odmamljeno	None
учинковитији	Accusative
fȃtā	Genitive
sporniju	Accusative
ozon	Accusative
iznenadio	None
razgolićivaše	None
ubaci	None
zadavljivana	None
nasrtljiom	Instrumental
raspoloženjem	Instrumental
građansku	Accusative
дефектан	Accusative
ječma	Genitive
pedagog	Nominative
zabeležili	None
kanalizacija	Nominative
ulepšavasmo	None
odobravala	None
zadarskom	Instrumental
načet	None
gradonačelnikom	Instrumental
budist	Nominative
proćaskaj	None
iznajmljivao	None
taktičkom	Instrumental
smiješkom	Instrumental
ađùtanātā	Genitive
округли	Accusative
pošumilo	None
poduzetnici	Vocative
dime	Vocative
porodicom	Instrumental
ošamarila	None
udružile	None
sultanom	Instrumental
osudom	Instrumental
vrtnu	Accusative
menopauzu	Accusative
obavezala	None
stavljan	None
recesijom	Instrumental
proučavaju	None
dijabetičare	Accusative
razglasi	None
segment	Accusative
dijamanta	Genitive
okupljale	None
pronalazačem	Instrumental
telefonom	Instrumental
marokanskom	Instrumental
ilegalci	Vocative
znojem	Instrumental
vrište	None
najzapadniju	Accusative
vojvotkinjom	Instrumental
sudarom	Instrumental
кестењаст	Accusative
zadivi	None
baruta	Genitive
tračeva	Genitive
selicom	Instrumental
angiologiju	Accusative
živcem	Instrumental
taktičku	Accusative
krizu	Accusative
kozmetike	Genitive
manjinu	Accusative
škafom	Instrumental
dijagnostiku	Accusative
stablom	Instrumental
komplikaciju	Accusative
kanalskom	Instrumental
smjenjivale	None
konjugaciju	Accusative
mentalitetom	Instrumental
šljaku	Accusative
obožavam	None
sintezu	Accusative
nabrajao	None
skȓbnīče	Vocative
hitnijom	Instrumental
kaligrafije	Genitive
priljubljivano	None
bezbrižnost	Accusative
uozbiljismo	None
preporoda	Genitive
opljačka	None
analizu	Accusative
posmatrače	Accusative
zlostavljao	None
odbacivao	None
kulo	Vocative
ljevicom	Instrumental
linča	Genitive
ratničkom	Instrumental
zastoje	Accusative
razmicao	None
katedru	Accusative
nestanu	None
rugalicu	Accusative
odmotao	None
plastelin	Accusative
odmamljuje	None
digitalnom	Instrumental
trako	Vocative
balistika	Nominative
priopćenjem	Instrumental
istinitijom	Instrumental
seobom	Instrumental
običajem	Instrumental
daltonìzma	Genitive
krike	Accusative
doručkuj	None
integritetom	Instrumental
većinskom	Instrumental
азбучни	Accusative
stjecaše	None
vezirom	Instrumental
curicu	Accusative
svjedodžbu	Accusative
težištem	Instrumental
kvara	Genitive
kavezom	Instrumental
dijagonalu	Accusative
poverilo	None
udrugu	Accusative
kopljem	Instrumental
kišu	Accusative
meteorološku	Accusative
ustaša	Genitive
geometrijskom	Instrumental
pedalj	Accusative
želva	Nominative
kvȁrt	Nominative
robovale	None
grudnjak	Accusative
palicu	Accusative
postanke	Accusative
ideolozi	Vocative
печени	Accusative
dostavnom	Instrumental
zauzimala	None
skulpturu	Accusative
učvršćeno	None
ore	None
prostitutkom	Instrumental
revolucionarom	Instrumental
pregrijava	None
lančanu	Accusative
crni	None
pobudom	Instrumental
morbile	Accusative
pacifizmom	Instrumental
nakovnjem	Instrumental
malariju	Accusative
babilonskom	Instrumental
vlagu	Accusative
kockar	Nominative
katalog	Accusative
raspoloženi	None
ostvarivali	None
člana	Genitive
radnike	Accusative
najbližu	Accusative
uđi	None
trljahu	None
harlekina	Accusative
svetištem	Instrumental
provjeru	Accusative
trajektnom	Instrumental
agencijom	Instrumental
sramotu	Accusative
sabijana	None
kompliciram	None
prodiku	Accusative
prošah	None
ispredoše	None
speleologija	Nominative
uvažava	None
učvršćivali	None
vražju	Accusative
kolonist	Nominative
kičmenom	Instrumental
okupljen	None
izišlo	None
grofova	Genitive
liričar	Nominative
haosa	Genitive
màfija	Nominative
sušili	None
radijatore	Accusative
pojasom	Instrumental
сулуди	Accusative
srpskohrvatskom	Instrumental
pronašli	None
psihoanalitičar	Nominative
termometara	Genitive
izvršile	None
zbivala	None
istarskom	Instrumental
ribarom	Instrumental
profesorom	Instrumental
zborova	Genitive
sprdaš	None
približimo	None
značajnijom	Instrumental
dodjeljivana	None
napučivaste	None
postajo	Vocative
slabjah	None
drskijom	Instrumental
vežbao	None
najznačajniju	Accusative
pacifistmo	Instrumental
vjeru	Accusative
rtom	Instrumental
kerbera	Genitive
terapeutskom	Instrumental
kȏlā	Genitive
obrišete	None
određivanjem	Instrumental
licenciju	Accusative
prelomiste	None
postupka	Genitive
kožicu	Accusative
tampon	Accusative
vunom	Instrumental
državljanin	Nominative
ubojicu	Accusative
milicijom	Instrumental
nabasa	None
ščìti	Vocative
najizravniju	Accusative
razmatrale	None
kȁdēte	Vocative
zȅmlje	Nominative
slamom	Instrumental
klijent	Nominative
poplavljeno	None
gazdu	Accusative
meditaciju	Accusative
najvećom	Instrumental
istupile	None
eksplozijom	Instrumental
ustanke	Accusative
pumom	Instrumental
smirih	None
preduzećem	Instrumental
kovane	None
menjali	None
zasjedanjem	Instrumental
редовни	Accusative
refrakcijom	Instrumental
audicijo	Vocative
zapisuje	None
sluškinju	Accusative
priredbu	Accusative
opisivani	None
elektronsku	Accusative
задњи	Accusative
бесмислен	Accusative
neracionalnijom	Instrumental
otkrivale	None
rodnu	Accusative
fosfora	Genitive
odliku	Accusative
prevodilac	Nominative
mitološkom	Instrumental
pridevom	Instrumental
odazovu	None
poprima	None
ontogenezo	Vocative
kȁūčā	Genitive
sređena	None
mezo	Vocative
celulozu	Accusative
локални	Accusative
отрцан	Accusative
сеоски	Accusative
poslušnost	Accusative
poližu	None
robotiku	Accusative
belaje	Accusative
kȋšā	Genitive
izgovorili	None
potpisana	None
žbunjem	Instrumental
regulativom	Instrumental
drenove	Accusative
isporučeni	None
jugozapada	Genitive
primerkom	Instrumental
prijamnici	Vocative
uvideste	None
prespavate	None
ružnoću	Accusative
posjetioce	Accusative
dogodi	None
pjevale	None
prenijelo	None
telekomunikacijsku	Accusative
osla	Accusative
masažom	Instrumental
balansom	Instrumental
ribolovom	Instrumental
seansu	Accusative
čitalaca	Genitive
izmišljeni	None
kineskom	Instrumental
krpom	Instrumental
poprskavali	None
glumaca	Genitive
dopunskom	Instrumental
benediktinsku	Accusative
odvučen	None
odgodu	Accusative
dikcijom	Instrumental
popularniju	Accusative
limfu	Accusative
avioprijevoznici	Vocative
aspirin	Accusative
bojeve	Accusative
nevoljo	Vocative
sagorijevajmo	None
последњи	Accusative
meštana	Genitive
fjordove	Accusative
ljestava	Genitive
polubraća	Nominative
telefonija	Nominative
nagovarali	None
primjedbom	Instrumental
esperanta	Genitive
najspiritualniju	Accusative
lutrijo	Vocative
balistiku	Accusative
prelazili	None
blȇsci	Nominative
populacijskom	Instrumental
активни	Accusative
odabrana	None
sećaju	None
učenicu	Accusative
odbacivale	None
nikotinsku	Accusative
grmom	Instrumental
dodirne	None
pronašlo	None
hanova	Genitive
mukotrpnost	Accusative
proizvođaše	None
cisternu	Accusative
caričinom	Instrumental
narcizma	Genitive
sedativ	Accusative
ságovi	Nominative
žestinom	Instrumental
demokratsku	Accusative
smeh	Accusative
smijehom	Instrumental
dramaturgijom	Instrumental
razvija	None
trajale	None
духовити	Accusative
izlečite	None
liza	Genitive
avestičku	Accusative
mestovinom	Instrumental
smješnijom	Instrumental
usmjeravaš	None
sluškinjom	Instrumental
saharoze	Genitive
žrtvom	Instrumental
abortiram	None
legionára	Genitive
pripovjedačem	Instrumental
ulepšavala	None
integriteta	Genitive
opremo	Vocative
benzenom	Instrumental
najstrastveniju	Accusative
teksturom	Instrumental
obustavilo	None
odricao	None
агротехнички	Accusative
primjenjuju	None
benzena	Genitive
glupan	Nominative
katolike	Accusative
nižu	Accusative
odrađeni	None
kacigom	Instrumental
divom	Instrumental
korejskom	Instrumental
izumom	Instrumental
смјелији	Accusative
nadživljavalo	None
januarsku	Accusative
uglova	Genitive
patrijaršiju	Accusative
oružjem	Instrumental
negovan	None
uništenjem	Instrumental
presječene	None
lajtmotiva	Genitive
cȑnācā	Genitive
palmo	Vocative
trilogiju	Accusative
trutovi	Vocative
српскохрватски	Accusative
pest	Accusative
čokoladom	Instrumental
trećinu	Accusative
svadbu	Accusative
ćirilice	Genitive
borovinom	Instrumental
vijenca	Genitive
snimane	None
rizo	Vocative
rapsodiju	Accusative
систематични	Accusative
kolonijalizam	Accusative
zemljotresom	Instrumental
tendencijom	Instrumental
бесплатни	Accusative
banku	Accusative
zadatke	Accusative
narodnu	Accusative
бодљикави	Accusative
isterano	None
sisavaca	Genitive
rasta	Genitive
naobrazbu	Accusative
brdskom	Instrumental
mesecom	Instrumental
pramenove	Accusative
veprom	Instrumental
stvoriteljem	Instrumental
zadrugar	Nominative
lokaciju	Accusative
uzgajala	None
broma	Genitive
gonetana	None
fiziko	Vocative
povjesničar	Nominative
pope	Vocative
izumeli	None
zvezdom	Instrumental
rèzērva	Nominative
zajma	Genitive
učiteljsku	Accusative
slinom	Instrumental
sabahom	Instrumental
relativizma	Genitive
ustanovljeno	None
čitaonicom	Instrumental
rukovoditelj	Nominative
најдревнији	Accusative
saborom	Instrumental
akumulirali	None
podmornicu	Accusative
ustajao	None
melodramom	Instrumental
rečeni	None
amputacijom	Instrumental
prvakom	Instrumental
sociologije	Genitive
poplavljen	None
pjegu	Accusative
napisana	None
čakavštine	Genitive
uzvik	Accusative
računovodstva	Genitive
laje	None
vodonošo	Vocative
reprezentativka	Nominative
iseljavamo	None
zadimljeno	None
poštede	Genitive
mliječnom	Instrumental
obrazloženo	None
sastojaka	Genitive
aferezu	Accusative
spale	None
zaglavljujte	None
kromanjonci	Vocative
tjeraš	None
suvozač	Nominative
dogovorom	Instrumental
hartijom	Instrumental
ekosistemom	Instrumental
vojnike	Vocative
diktatorskom	Instrumental
kristologiju	Accusative
grmljavine	Genitive
nameštajem	Instrumental
lordove	Accusative
čipom	Instrumental
snega	Genitive
belce	Accusative
pozivale	None
lakomislenijom	Instrumental
lavom	Instrumental
prevaljuje	None
antisemitskom	Instrumental
špijunom	Instrumental
bombarderom	Instrumental
cere	None
обавезан	Accusative
дрвени	Accusative
glasnoće	Genitive
hijacint	Accusative
zbornici	Vocative
carem	Instrumental
prìjēmnīče	Vocative
simetrijom	Instrumental
unuk	Nominative
dopisnike	Accusative
посебни	Accusative
magijo	Vocative
eksces	Accusative
računamo	None
kraljevinu	Accusative
posredovana	None
najlicemjerniju	Accusative
knjigu	Accusative
monstruozniju	Accusative
нерјешиви	Accusative
najamnik	Nominative
svećenike	Accusative
kuhaše	None
apsorpciju	Accusative
bretonskom	Instrumental
arhitektom	Instrumental
sevova	Genitive
daljinu	Accusative
bluza	Genitive
linearnost	Accusative
nagovorila	None
animiraše	None
koševinu	Accusative
viti	None
korile	None
državo	Vocative
običavao	None
versku	Accusative
imovinsku	Accusative
grbačom	Instrumental
ishrana	Nominative
korporacijom	Instrumental
kratkoća	Nominative
isuši	None
mlađom	Instrumental
rezani	None
baro	Vocative
најраскалашенији	Accusative
svinjare	Accusative
feljtona	Genitive
sviđali	None
apscisu	Accusative
defetizmom	Instrumental
prefektom	Instrumental
komitete	Accusative
uhapšene	None
restaurator	Nominative
hidrat	Accusative
plijesan	Accusative
grobnicu	Accusative
avanturističkom	Instrumental
akumulirao	None
garancijom	Instrumental
najkonzervativnijom	Instrumental
akcijom	Instrumental
primijenjeni	None
šapatom	Instrumental
judaizam	Accusative
vinom	Instrumental
dođem	None
pošao	None
besedom	Instrumental
furnir	Accusative
šàvovi	Nominative
iznesene	None
uzgojilo	None
biljege	Accusative
platišu	Accusative
masku	Accusative
mitraljez	Accusative
praksom	Instrumental
frontovi	Vocative
uvriježena	None
сахарински	Accusative
obranom	Instrumental
продан	Accusative
erudicijom	Instrumental
tranzitnu	Accusative
severoistočnom	Instrumental
bluze	Vocative
lulu	Accusative
muče	Vocative
posrednikom	Instrumental
traumatologija	Nominative
zaštitnikom	Instrumental
prizorom	Instrumental
striptizeto	Vocative
alergičniju	Accusative
gorsku	Accusative
inspektor	Nominative
biraj	None
vratove	Accusative
severnjaka	Genitive
diskusijom	Instrumental
težim	None
sijače	Accusative
dolova	Genitive
okupljene	None
pluralizmom	Instrumental
elektromagnetsku	Accusative
umiralo	None
холистички	Accusative
tunelskom	Instrumental
odstranjuju	None
prekrio	None
pojedinom	Instrumental
kazanom	Instrumental
kritičare	Accusative
razapete	None
trokutom	Instrumental
oživljavaju	None
túkca	Genitive
homozigóti	Nominative
mafijaše	Accusative
pridržavali	None
razabire	None
bijegom	Instrumental
eutanaziju	Accusative
sličnošću	Instrumental
ždrelom	Instrumental
uzimale	None
predjelom	Instrumental
etapu	Accusative
štedim	None
keks	Accusative
teškoćom	Instrumental
doživelo	None
ukočenost	Accusative
plastenike	Accusative
odanost	Accusative
следећи	Accusative
doseljavali	None
osvježavaju	None
prebacivala	None
dopunjavao	None
ekosistema	Genitive
putovao	None
ideju	Accusative
agitirao	None
uklonjeni	None
povetarac	Accusative
truìzam	Nominative
нешкодљив	Accusative
točkove	Accusative
rastužuju	None
pȉskāvca	Genitive
fizioterapeutsku	Accusative
zastavom	Instrumental
azbučnom	Instrumental
bakar	Accusative
socijalizme	Vocative
gazite	None
napale	None
golotinju	Accusative
kaže	None
stazom	Instrumental
singlicu	Accusative
označite	None
podgrijaše	None
renesansnom	Instrumental
prožderasmo	None
liječnik	Nominative
kiriju	Accusative
hodočasnike	Accusative
balerinu	Accusative
oslanjala	None
brodogradnjom	Instrumental
meronimiju	Accusative
pronalaskom	Instrumental
fràgmenātā	Genitive
automobilom	Instrumental
upozoreni	None
pooraste	None
tetoviraju	None
slonovačom	Instrumental
stoga	Genitive
bilješku	Accusative
artikulaciju	Accusative
pratiocem	Instrumental
oprezom	Instrumental
pomoćnicu	Accusative
uznemireno	None
podijeljeni	None
zahvaćene	None
šunjaše	None
sprejevi	Vocative
dosegnuta	None
obraćali	None
knjižnicom	Instrumental
osjete	None
naudi	None
krajnost	Accusative
opozvali	None
интернационални	Accusative
knjižničarstva	Genitive
podanike	Accusative
tupimo	None
crvèndāć	Nominative
pučane	Accusative
nošeni	None
gutače	Accusative
mlazom	Instrumental
privida	Genitive
neotesanijom	Instrumental
свестранији	Accusative
sekstant	Accusative
biokemijskom	Instrumental
erom	Instrumental
vri	None
stabilnost	Accusative
враголастији	Accusative
izazvali	None
stražom	Instrumental
trbuh	Accusative
grofa	Accusative
prosa	Genitive
dijalogom	Instrumental
nesretnijom	Instrumental
športa	Genitive
najsnažniju	Accusative
gasila	None
biheviorizme	Vocative
podčinio	None
progovorila	None
sajmom	Instrumental
prisiljavali	None
delegacijom	Instrumental
lagali	None
zaprijesmo	None
uzrokom	Instrumental
prašinom	Instrumental
raznosio	None
zaudara	None
tragikomedijom	Instrumental
издржљиви	Accusative
uvjere	None
bankrot	Accusative
baletom	Instrumental
pridonijela	None
režah	None
zalihu	Accusative
cvatom	Instrumental
krštenjem	Instrumental
avatarom	Instrumental
šoštar	Nominative
usisava	None
idealizam	Accusative
omami	None
upućivani	None
ogledavasmo	None
egoističkom	Instrumental
razilaze	None
mandata	Genitive
džihad	Accusative
ovisile	None
demilitarizacijom	Instrumental
kutak	Accusative
smešnijom	Instrumental
osramotio	None
motel	Accusative
epizodom	Instrumental
interpretaciju	Accusative
onomastika	Nominative
pejoraciju	Accusative
slušane	None
londonskom	Instrumental
žlijeb	Accusative
opsednut	None
susednom	Instrumental
takozvanom	Instrumental
kapsulu	Accusative
primjenjivala	None
izvršilo	None
ljubavnu	Accusative
zabodemo	None
budžáka	Genitive
pronalazila	None
kročismo	None
prekršeni	None
šprica	Genitive
napisa	None
rudnikom	Instrumental
diplomom	Instrumental
taktom	Instrumental
mobilnijom	Instrumental
taru	Accusative
несамостални	Accusative
zdravstva	Genitive
odbojke	Genitive
skeletom	Instrumental
svitak	Accusative
labirinta	Genitive
slupao	None
svjedočeni	None
laserom	Instrumental
građeni	None
kresnuh	None
izbjegavaju	None
naslućuju	None
kisika	Genitive
mùdrac	Nominative
obrađivano	None
odgovorom	Instrumental
načeli	None
pravdane	None
sujevjerniju	Accusative
idealističkom	Instrumental
идући	Accusative
dirnuo	None
poslužilo	None
obodimo	None
udaljim	None
nazva	None
бесавјесни	Accusative
davnu	Accusative
retorika	Nominative
mineràlozi	Nominative
krahova	Genitive
uporabimo	None
opasač	Accusative
odlazaka	Genitive
mamo	Vocative
kvislinšku	Accusative
ambivalentnost	Accusative
pupova	Genitive
zvanjem	Instrumental
priliko	Vocative
značajem	Instrumental
nadomjeska	Genitive
uloženo	None
krumpirom	Instrumental
cvetnu	Accusative
unakazih	None
prizemljem	Instrumental
navijače	Accusative
huntu	Accusative
mejitova	Genitive
odlučivali	None
kakvoće	Genitive
skidaju	None
фамозни	Accusative
prenošene	None
napati	None
birokraciju	Accusative
hladnoratovskom	Instrumental
žȇljā	Genitive
buvu	Accusative
bedu	Accusative
imanjem	Instrumental
дељиви	Accusative
izuše	None
ostajem	None
eholalija	Nominative
suzavac	Accusative
antifašističku	Accusative
ponašali	None
stupove	Accusative
lasicu	Accusative
začele	None
upadom	Instrumental
opredelilo	None
sinapsi	Dative
slavila	None
narednom	Instrumental
неудат	Accusative
sadašnjošću	Instrumental
promrsile	None
autopsijom	Instrumental
patnike	Accusative
obveznike	Accusative
islamskom	Instrumental
brojevi	Vocative
terminologijom	Instrumental
uzmimo	None
osip	Accusative
izračene	None
spavanjem	Instrumental
bludnicu	Accusative
moral	Accusative
nebesku	Accusative
skrenuti	None
gangsterskom	Instrumental
usađen	None
muljeva	Genitive
vagom	Instrumental
gigametara	Genitive
aksiom	Accusative
ambivalencijo	Vocative
primećen	None
ablaciju	Accusative
verenici	Vocative
slavenskom	Instrumental
serumom	Instrumental
jahače	Accusative
najavilo	None
луцкаст	Accusative
bazom	Instrumental
sastavljala	None
otkinut	None
željene	None
трипартитан	Accusative
igračem	Instrumental
бубуљичав	Accusative
ponore	Accusative
šavom	Instrumental
pružile	None
obarala	None
matematičarka	Nominative
sjeverce	Accusative
sjemenko	Vocative
rezimea	Genitive
zapoveda	None
informira	None
menjao	None
protokolom	Instrumental
samouvjerenost	Accusative
toponimija	Nominative
крилни	Accusative
teatara	Genitive
nagađao	None
prigovaraju	None
štokavci	Vocative
primorano	None
maskotu	Accusative
dijelile	None
propovjednici	Vocative
autentičnošću	Instrumental
holokaustom	Instrumental
ponovio	None
morž	Nominative
epohom	Instrumental
raskinut	None
konstantom	Instrumental
kanio	None
ustanovljujete	None
jarkom	Instrumental
promašaje	Accusative
латентни	Accusative
predviđena	None
pretorijanci	Vocative
bestijálnōst	Nominative
poginulo	None
nastavnikom	Instrumental
krana	Genitive
diskriminacijom	Instrumental
kazna	Nominative
razbibrigu	Accusative
nostalgičniju	Accusative
potezom	Instrumental
potvrdite	None
otišao	None
upoznat	None
artefakta	Genitive
pitan	None
mlinove	Accusative
komforom	Instrumental
jamčena	None
opsjedali	None
olakšalo	None
pobunjeni	None
gajeve	Accusative
spremili	None
penzijo	Vocative
metara	Genitive
zaklinju	None
harmonijo	Vocative
podsjetnikom	Instrumental
raspleli	None
велик	Accusative
rezbareni	None
nosom	Instrumental
имовински	Accusative
триангуларни	Accusative
stanovištem	Instrumental
certifikat	Accusative
veslačkom	Instrumental
fotosintezom	Instrumental
genije	Accusative
odstupili	None
eliksira	Genitive
idiotstvom	Instrumental
državljanku	Accusative
otpravljali	None
geometriju	Accusative
oprugu	Accusative
upijaste	None
fusnotu	Accusative
флегматични	Accusative
cjepidlakom	Instrumental
elektrolit	Accusative
prekinuli	None
satelitom	Instrumental
tražili	None
стари	Accusative
trajnost	Accusative
čitanku	Accusative
krivotvoritelj	Nominative
zadavao	None
prostirali	None
kćerku	Accusative
carević	Nominative
sklada	Genitive
pretapaš	None
уветан	Accusative
omotom	Instrumental
zapadaju	None
ljudožder	Nominative
opozvane	None
osifikaciju	Accusative
paklom	Instrumental
rugali	None
uputilo	None
ufa	None
nobelovcem	Instrumental
strugare	Accusative
antičku	Accusative
sepsom	Instrumental
obožavatelj	Nominative
heterogenost	Accusative
obećava	None
liričare	Accusative
locirale	None
sastojci	Vocative
festivala	Genitive
okretao	None
jezik	Accusative
predizbornu	Accusative
decu	Accusative
pješadije	Genitive
žiga	Genitive
jednostranost	Accusative
predvodilo	None
crtu	Accusative
plodnicu	Accusative
sluša	None
oduševljenja	Genitive
gresi	Vocative
ikonostasom	Instrumental
sliva	Genitive
alergologija	Nominative
livadu	Accusative
mezanin	Accusative
daskom	Instrumental
vježbali	None
savetuju	None
vensku	Accusative
policajce	Accusative
osloboditelj	Nominative
mirotvorce	Accusative
neosjetljivost	Accusative
màrševi	Nominative
napravu	Accusative
antikomunist	Nominative
најстарији	Accusative
primijenjen	None
nadahnemo	None
finalnom	Instrumental
entuzijastkinjom	Instrumental
gej	Nominative
parkom	Instrumental
поједини	Accusative
partnerom	Instrumental
pretnju	Accusative
napio	None
organ	Accusative
nomenklature	Genitive
kadim	None
izdajnike	Accusative
pozornicu	Accusative
dospiju	None
modem	Accusative
naoružane	None
aplicirali	None
sinapsu	Accusative
indijskom	Instrumental
kraljicom	Instrumental
liturgijom	Instrumental
pustošenjem	Instrumental
привредни	Accusative
glasove	Accusative
neuròtīci	Nominative
hrvatskosrpskom	Instrumental
savezničkom	Instrumental
koktelom	Instrumental
gripom	Instrumental
mikroskopom	Instrumental
krisa	Genitive
prijali	None
вечни	Accusative
ženstvenijom	Instrumental
optuženi	None
deltu	Accusative
šaranom	Instrumental
vlasnicu	Accusative
jugoistočnom	Instrumental
konjicom	Instrumental
kupnjom	Instrumental
kolonizacijom	Instrumental
zatalasano	None
prevladaju	None
kritizirane	None
pređu	Accusative
pojačavao	None
gužvan	None
shvaćeni	None
zlatnike	Accusative
metal	Accusative
konzumacije	Genitive
prigušismo	None
djedove	Accusative
aritmiju	Accusative
naredbo	Vocative
praćku	Accusative
stopile	None
agronomija	Nominative
њемачки	Accusative
šlemom	Instrumental
сапунасти	Accusative
снуждени	Accusative
vedrino	Vocative
vestom	Instrumental
artist	Nominative
napravile	None
etanol	Accusative
paleontologija	Nominative
hranjene	None
primjerci	Vocative
раздражљиви	Accusative
devojku	Accusative
sirah	None
vježbani	None
kondukcija	Nominative
nabroji	None
razmnaža	None
čoporom	Instrumental
vriskasmo	None
bjelegom	Instrumental
iskašljani	None
veseljáka	Genitive
prosjekom	Instrumental
knjižnu	Accusative
anatomijom	Instrumental
mlinova	Genitive
gušter	Nominative
tutorom	Instrumental
lepak	Accusative
oplodnjom	Instrumental
sunusmo	None
inspiracijom	Instrumental
potrošače	Accusative
ofenzivu	Accusative
непознат	Accusative
mikroorganizam	Accusative
krȋvda	Nominative
najnežniju	Accusative
ribarskom	Instrumental
izvještaje	Accusative
protunapade	Accusative
ravnotežom	Instrumental
pačić	Nominative
raspodijeljeni	None
kovertu	Accusative
zvalo	None
odmak	Accusative
ligu	Accusative
hrbat	Accusative
galicijskom	Instrumental
tinejdžere	Accusative
savetovao	None
kucni	None
oktopodom	Instrumental
sakramenta	Genitive
idiotom	Instrumental
futurističkom	Instrumental
ćèbeta	Nominative
distorziju	Accusative
hrđa	None
losove	Accusative
građani	Vocative
oplatu	Accusative
konstruiramo	None
svekrvom	Instrumental
paprikom	Instrumental
tuniku	Accusative
dimničare	Accusative
pronalaske	Accusative
mješavinom	Instrumental
izvlačio	None
športe	Vocative
kosir	Accusative
presele	None
šljúnci	Nominative
nagovoreno	None
vakcinu	Accusative
dospeva	None
ritmova	Genitive
paritet	Accusative
рустикалнији	Accusative
karakternijom	Instrumental
lovo	Vocative
русински	Accusative
hramovi	Vocative
najdobronamernijom	Instrumental
trapavca	Accusative
pristašu	Accusative
kesu	Accusative
sasecan	None
trofeja	Genitive
nogare	Accusative
prepisujete	None
ribarah	None
jedinu	Accusative
sjeveroistokom	Instrumental
metála	Genitive
skakali	None
pobilo	None
plimu	Accusative
progonstava	Genitive
konvencionalniju	Accusative
muslimansku	Accusative
atentat	Accusative
optiku	Accusative
žrtva	Nominative
kvarova	Genitive
premlatiš	None
otišlo	None
represiju	Accusative
nadrealizma	Genitive
dubrovačkom	Instrumental
uvezivah	None
otorinolaringologiju	Accusative
gnjat	Accusative
zaceljeno	None
skalpove	Accusative
kruno	Vocative
nazivale	None
sutrašnjicom	Instrumental
poručuju	None
posadom	Instrumental
egzistencija	Nominative
pridonijeli	None
vrgnite	None
bèzūmnōst	Nominative
razvojem	Instrumental
odbacivani	None
vrganj	Accusative
instruktor	Nominative
stih	Accusative
pogledom	Instrumental
svežnja	Genitive
smotru	Accusative
suparnikom	Instrumental
krivotvori	None
jadnicom	Instrumental
трговачки	Accusative
liši	None
istroše	None
navikavamo	None
velovi	Vocative
pravnu	Accusative
stažem	Instrumental
poslužitelj	Nominative
staža	Genitive
otimale	None
prezira	Genitive
zabavom	Instrumental
čude	None
izrazom	Instrumental
gnoj	Accusative
izbacivali	None
obrađivali	None
злочести	Accusative
odlikom	Instrumental
аустријански	Accusative
državljane	Accusative
inicijativo	Vocative
sedmoricu	Accusative
okovana	None
crnce	Accusative
savezničku	Accusative
nadvisio	None
bubamo	None
zagrijavaju	None
molim	None
kukovi	Vocative
pljačku	Accusative
pričvrste	None
tepamo	None
anglikanci	Vocative
belinu	Accusative
trovatelje	Accusative
razdvojile	None
zoveš	None
nestrpljenjem	Instrumental
ukrajinsku	Accusative
dekadu	Accusative
obaveštajnu	Accusative
groficu	Accusative
flotu	Accusative
socijalizam	Accusative
horizonta	Genitive
trebala	None
krvavile	None
poslasticu	Accusative
boluje	None
saznaju	None
tugo	Vocative
nadovezuje	None
ograđivao	None
menadžer	Nominative
oslonac	Accusative
navodnike	Accusative
ljubomore	Genitive
besmisla	Genitive
liberalizam	Accusative
slabijom	Instrumental
povlasticu	Accusative
prostoriju	Accusative
kursa	Genitive
lokomotivom	Instrumental
obistinila	None
srdžbom	Instrumental
frižidere	Accusative
zavojnicom	Instrumental
kerova	Genitive
heterosilabičkom	Instrumental
kahla	Nominative
geometrijsku	Accusative
stvorite	None
najkorektniju	Accusative
trgovali	None
izgradnjom	Instrumental
najsloženijom	Instrumental
prizmu	Accusative
bukovinom	Instrumental
sipo	Vocative
obučavala	None
završetke	Accusative
osnivačku	Accusative
dostavljena	None
bludniju	Accusative
bataljun	Accusative
живописни	Accusative
prenošen	None
desio	None
osvetom	Instrumental
dvojkom	Instrumental
štovao	None
osnivaju	None
grafovi	Vocative
tračkom	Instrumental
мушичавији	Accusative
religiju	Accusative
naponom	Instrumental
ustašu	Accusative
kȃpākā	Genitive
najmove	Accusative
tajnošću	Instrumental
barom	Instrumental
transportirali	None
rešenjem	Instrumental
acetatom	Instrumental
nagrđuje	None
glazbenike	Accusative
ugrađivale	None
odrađene	None
sabranost	Accusative
kartografskom	Instrumental
gazdom	Instrumental
sektom	Instrumental
gimnazijom	Instrumental
pišali	None
trna	Genitive
opstrukcijom	Instrumental
plemkinjom	Instrumental
pregrejana	None
treznijom	Instrumental
tetivom	Instrumental
repliku	Accusative
sojo	Vocative
lovinu	Accusative
folklor	Accusative
šefova	Genitive
lažira	None
beletristiku	Accusative
puža	Genitive
zlȍbnīci	Nominative
neotesanko	Vocative
nazivom	Instrumental
tretiraju	None
zadatkom	Instrumental
dešnjaci	Vocative
emigraciju	Accusative
obogaćivali	None
kretnjom	Instrumental
okonča	None
zamjenjujemo	None
ornitologiju	Accusative
homoseksualac	Nominative
uložile	None
trampio	None
kišom	Instrumental
pribavili	None
kinite	None
ispisao	None
plemenom	Instrumental
pjesnikinjom	Instrumental
prikupile	None
historijskom	Instrumental
raščlanjujemo	None
labudom	Instrumental
postavlja	None
ponudili	None
mikroorganizmom	Instrumental
najjunačnijom	Instrumental
sestrom	Instrumental
fenjera	Genitive
ekumenizam	Accusative
koncepta	Genitive
partiju	Accusative
administracijo	Vocative
trudova	Genitive
banketa	Genitive
kȑdžalije	Nominative
vare	None
spevaš	None
svjetina	Nominative
učestalošću	Instrumental
senat	Accusative
treperi	None
razboritost	Accusative
vojvodstvom	Instrumental
nivoe	Accusative
govedine	Genitive
vezovi	Vocative
impregnacijo	Vocative
lešom	Instrumental
sprečene	None
zaštitnicu	Accusative
guvèrnēr	Nominative
vozio	None
optimizmom	Instrumental
vodim	None
kontejnere	Accusative
toksin	Accusative
logičkom	Instrumental
zatvarane	None
rituála	Genitive
zamijenila	None
mjehova	Genitive
rora	Genitive
ograđivali	None
uvjeri	None
oltara	Genitive
dadaizam	Accusative
tȅstisom	Instrumental
ustala	None
примјерни	Accusative
onemogućuje	None
бајат	Accusative
razdružile	None
govoraše	None
kladu	Accusative
obaveštájci	Nominative
dadiljom	Instrumental
bičevan	None
obnovljeni	None
obrubljen	None
označi	None
ugašene	None
prenosio	None
варавији	Accusative
islamizaciju	Accusative
kompas	Accusative
pripitomljen	None
renom	Instrumental
izvršiš	None
uvjeravaše	None
krošnja	Nominative
cr̀nčuga	Nominative
sinonimiju	Accusative
štìhovi	Nominative
srećo	Vocative
pravosuđem	Instrumental
prozvalo	None
oran	None
pripisivalo	None
orahom	Instrumental
češkom	Instrumental
odeljene	None
pijanistom	Instrumental
slavljena	None
podmorsku	Accusative
algebarskom	Instrumental
navođen	None
pomognuti	None
nadgledao	None
čarapu	Accusative
depoa	Genitive
ježi	None
izvožen	None
zadovolji	None
johu	Accusative
sapnite	None
ispune	None
spahija	Genitive
gesala	Genitive
unesene	None
fatalizmom	Instrumental
razmnožismo	None
parom	Instrumental
završavao	None
gubite	None
pokera	Genitive
bandu	Accusative
ponašanjem	Instrumental
nelagodom	Instrumental
dogovorene	None
kotrljate	None
inercijom	Instrumental
akumuliram	None
agrarnom	Instrumental
teksturu	Accusative
špekova	Genitive
snošajem	Instrumental
rasu	Accusative
kovilja	Genitive
претходни	Accusative
bajunet	Accusative
predavao	None
umirale	None
hihotom	Instrumental
formulacijom	Instrumental
iscrpila	None
uključe	None
biljára	Genitive
klavir	Accusative
zlovoljniju	Accusative
djedova	Genitive
odgovorilo	None
prokopasmo	None
aljasku	Accusative
promijenite	None
šaru	Accusative
glasinu	Accusative
kanabisa	Genitive
aranžmana	Genitive
цветни	Accusative
лабуђи	Accusative
štedeli	None
miješala	None
svetskom	Instrumental
pleroma	Nominative
let	Accusative
cepanico	Vocative
klorom	Instrumental
zaključi	None
autonomijom	Instrumental
astrofizike	Genitive
vrstu	Accusative
ovsa	Genitive
krajcare	Accusative
mekoću	Accusative
betonsku	Accusative
oksidacijom	Instrumental
gospodarom	Instrumental
skrasi	None
apsidom	Instrumental
jenjalo	None
ponosom	Instrumental
savìtljivōst	Nominative
plota	Genitive
karmo	Vocative
црнооки	Accusative
egzaltacijom	Instrumental
nevjerničku	Accusative
rukovodio	None
gospòda	Nominative
suparnike	Accusative
dopunjava	None
januarom	Instrumental
kirurzi	Vocative
fruktoza	Nominative
predvidi	None
grma	Genitive
isprede	None
sijenom	Instrumental
hinjah	None
bacakajmo	None
optuživale	None
filozofijom	Instrumental
prasad	Accusative
slobodicu	Accusative
proizvodnjom	Instrumental
nuklearnu	Accusative
stane	Vocative
krugovi	Vocative
muka	Genitive
toplijom	Instrumental
fotoaparata	Genitive
opijuma	Genitive
kičmom	Instrumental
asteroída	Genitive
liveno	None
uzdržao	None
pljuni	None
konverzaciju	Accusative
prikriju	None
etiketu	Accusative
kliču	None
inja	Genitive
grozde	Vocative
nadvladan	None
ručnik	Accusative
muzej	Accusative
saveznom	Instrumental
zloupotreba	Nominative
individualističkom	Instrumental
pijeskom	Instrumental
ćèpēnci	Nominative
zbližava	None
usudila	None
temperamentom	Instrumental
сточарски	Accusative
najtrnovitiju	Accusative
plani	None
zalaznicom	Instrumental
kupovinom	Instrumental
račun	Accusative
opredeljen	None
odeljkom	Instrumental
najprikladniju	Accusative
čavala	Genitive
nudila	None
predznaci	Vocative
polugu	Accusative
noćili	None
lakoumniju	Accusative
grudom	Instrumental
iseljavao	None
tekućinu	Accusative
prȍpovednīče	Vocative
doneseno	None
blagoslovilo	None
pučani	Vocative
prozvao	None
urine	Vocative
izaberite	None
ustrojeno	None
lakat	Accusative
arhaizam	Accusative
licencu	Accusative
svidelo	None
suvremenike	Accusative
obrazlagasmo	None
elektrolizu	Accusative
leksičkom	Instrumental
odeljke	Accusative
kanua	Genitive
sudelovao	None
skotova	Genitive
laktovi	Vocative
nafta	Nominative
sumrakom	Instrumental
prijavljuje	None
obrćeš	None
begunce	Accusative
pljunuo	None
rijekom	Instrumental
meridijan	Accusative
dermatologija	Nominative
brisane	None
svrsishodnost	Accusative
ekvinocijem	Instrumental
raž	Accusative
ukradeni	None
atamána	Genitive
popravaka	Genitive
laboratorijsku	Accusative
iscrpili	None
muzejskom	Instrumental
lijepila	None
sloma	Genitive
kline	Vocative
незасићен	Accusative
odnosom	Instrumental
praćena	None
putnike	Accusative
poternicu	Accusative
prevodioce	Accusative
rasterao	None
gospodin	Nominative
terminom	Instrumental
lepotom	Instrumental
vozovi	Vocative
crpljeno	None
tip	Accusative
uvažavao	None
odbijan	None
varvarskom	Instrumental
nogom	Instrumental
popravke	Accusative
pistu	Accusative
pudere	Accusative
ekspediciju	Accusative
praznimo	None
троглав	Accusative
transakciju	Accusative
provokacijo	Vocative
sakristijom	Instrumental
birokracijom	Instrumental
privatnu	Accusative
crvojedinom	Instrumental
izgovarana	None
spisa	Genitive
dijabetičar	Nominative
useljavahu	None
gmižem	None
prebačen	None
natjerana	None
hranio	None
liftom	Instrumental
bazdeli	None
prepisao	None
osveži	None
istupi	None
utjehu	Accusative
darvinizam	Accusative
познат	Accusative
šematizam	Accusative
пролетни	Accusative
podudaraju	None
izdržljivost	Accusative
telefonskom	Instrumental
predsednik	Nominative
radoznalošću	Instrumental
najslabiju	Accusative
potopljeno	None
разроки	Accusative
rastavljena	None
pjeno	Vocative
bazenom	Instrumental
ubijane	None
podstrizale	None
калифорнијски	Accusative
prepoznaju	None
izjavljuju	None
crne	None
rekurziju	Accusative
otomansku	Accusative
mjȅsēcom	Instrumental
antibiotik	Accusative
klinca	Accusative
razočarali	None
razdjela	Genitive
lirikom	Instrumental
ògnji	Nominative
trgovišta	Genitive
turkmenskom	Instrumental
šegrt	Nominative
krmenom	Instrumental
razmnože	None
riješene	None
kreketale	None
zatvorili	None
instrukciju	Accusative
spomenom	Instrumental
monolit	Accusative
kartografom	Instrumental
tučeni	None
северни	Accusative
nađem	None
jedrenjake	Accusative
oštećuje	None
upropastili	None
sindikat	Accusative
smestila	None
izmaknu	None
pobeđivahu	None
ropstvom	Instrumental
raščlanjene	None
decembra	Genitive
televizijom	Instrumental
godišnjicom	Instrumental
zaručnikom	Instrumental
doživio	None
rođendanom	Instrumental
tinjao	None
астматични	Accusative
makadamsku	Accusative
mùškārācā	Genitive
lavino	Vocative
ćelavost	Accusative
koloseče	Vocative
savije	None
pritiske	Accusative
magnetita	Genitive
nebeskom	Instrumental
jednostavniju	Accusative
gròbār	Nominative
opušta	None
pedesetgodišnjake	Accusative
Bosanci	Vocative
skijaškom	Instrumental
homonimijo	Vocative
најпоузданији	Accusative
političku	Accusative
aureolom	Instrumental
zoroastrizma	Genitive
stupci	Vocative
svodnike	Accusative
promatrasmo	None
zakonom	Instrumental
веренички	Accusative
salitra	Nominative
uzbunjivano	None
polena	Genitive
antropologije	Genitive
прасловенски	Accusative
divlju	Accusative
gatovi	Vocative
mačevanjem	Instrumental
plugom	Instrumental
oslonaca	Genitive
pjevačicu	Accusative
sufiksa	Genitive
kompetencije	Genitive
žargon	Accusative
botaničkom	Instrumental
sirnicom	Instrumental
prevaljuju	None
krstove	Accusative
dopunjeno	None
stanovi	Vocative
obriše	None
nagovještavaju	None
okivali	None
kvarkove	Accusative
sestrinsku	Accusative
kraljujte	None
zadužujem	None
ovčarstva	Genitive
dolazaka	Genitive
uljepšavaju	None
mlàdenac	Nominative
špan	Nominative
šaro	Vocative
prioritetom	Instrumental
lègēndā	Genitive
dopremljen	None
antonim	Accusative
sprečili	None
napomenuo	None
hramom	Instrumental
uglove	Accusative
muftiju	Accusative
tupoglavijom	Instrumental
špangom	Instrumental
priznalo	None
dariva	None
ustvrđivali	None
etnologija	Nominative
prodre	None
iritirao	None
fatalist	Nominative
olakšavahu	None
polagao	None
kretenìzma	Genitive
trudite	None
obiljem	Instrumental
grdosijo	Vocative
skrbništvom	Instrumental
ručnikom	Instrumental
divova	Genitive
pijanist	Nominative
davaoci	Vocative
oblačnijom	Instrumental
ostankom	Instrumental
pucnjave	Genitive
nacijom	Instrumental
pogodila	None
glacijacija	Nominative
prigovaráča	Genitive
prvake	Accusative
posolile	None
macu	Accusative
predviđeni	None
rastopljen	None
vahabizama	Genitive
aboliciju	Accusative
iskorišteno	None
cestovnu	Accusative
trendom	Instrumental
talìsmān	Nominative
konsenzusom	Instrumental
poveruju	None
tvorila	None
rakom	Instrumental
успешан	Accusative
pregovaralo	None
trogodišnjake	Accusative
arhipelagom	Instrumental
smješteno	None
populističku	Accusative
konvent	Accusative
opsadu	Accusative
reputacijo	Vocative
gitarom	Instrumental
primala	None
màdrac	Nominative
poduči	None
ponovljen	None
suradnik	Nominative
diktat	Accusative
vezle	None
prouzrokovali	None
intrigira	None
utrošeni	None
prisluškuju	None
organiziralo	None
žbuku	Accusative
пасји	Accusative
športova	Genitive
одговорни	Accusative
reportažu	Accusative
praistoriju	Accusative
krȕhovac	Nominative
najnaglijom	Instrumental
impresijo	Vocative
arhiepiskopom	Instrumental
buhu	Accusative
tukle	None
pripojen	None
ostatka	Genitive
liniju	Accusative
saberu	None
izgovarale	None
koralj	Accusative
tvorevinom	Instrumental
dečake	Accusative
imamom	Instrumental
dočekala	None
eksploziju	Accusative
аклиматизацијски	Accusative
ljubavničkom	Instrumental
partikulo	Vocative
staraca	Genitive
pripitomljene	None
izbljuva	None
ris	Nominative
sapunom	Instrumental
deveticu	Accusative
naciju	Accusative
izbezumljenijom	Instrumental
shvatam	None
sačekali	None
sazvao	None
kliknuo	None
lèut	Nominative
falu	Accusative
uplašeni	None
konopa	Genitive
бесадржајни	Accusative
sredstvom	Instrumental
nabavljaju	None
vozilom	Instrumental
predstavnicom	Instrumental
najprobavljiviju	Accusative
kamin	Accusative
специфичан	Accusative
jamčevino	Vocative
dijetu	Accusative
benzéna	Genitive
impresioniralo	None
ugađajte	None
iživciraju	None
razasipljem	None
adresu	Accusative
tribalističkom	Instrumental
žirom	Instrumental
krane	Vocative
najafirmativniju	Accusative
avanturist	Nominative
практичан	Accusative
severnoameričkom	Instrumental
lingvističku	Accusative
uzorala	None
demonom	Instrumental
uporabljena	None
projekciju	Accusative
uspeva	None
plesom	Instrumental
osjetio	None
stanove	Accusative
слабоумни	Accusative
šahovi	Vocative
odstupi	None
ciganskom	Instrumental
potpukovnik	Nominative
fronta	Genitive
izbo	Vocative
сујевјернији	Accusative
sinčić	Nominative
zaboden	None
bjelkinju	Accusative
mikrobiologiju	Accusative
zaključio	None
академски	Accusative
kurdskom	Instrumental
sanskrt	Accusative
pomagan	None
odredištem	Instrumental
zavidljivce	Accusative
sportom	Instrumental
surlom	Instrumental
protjecalo	None
saradnjom	Instrumental
koncizniju	Accusative
poštedela	None
rernu	Accusative
svježine	Genitive
pakistanskom	Instrumental
uhapsili	None
poslušala	None
tronožaca	Genitive
tuberkulozu	Accusative
glavare	Accusative
meksičku	Accusative
ponorom	Instrumental
nȉzānkā	Genitive
apsurdnost	Accusative
boravci	Vocative
podešene	None
izgradilo	None
prebačeno	None
pušionico	Vocative
tjeskobom	Instrumental
kršćanin	Nominative
zavele	None
lȉpa	Nominative
iskorištavane	None
čitaju	None
silazila	None
osnivačkom	Instrumental
sùvlāsnīk	Nominative
srodnicom	Instrumental
ustupili	None
sagrađeno	None
dominirala	None
ненамеран	Accusative
konzumaciju	Accusative
nekròfīl	Nominative
dozvoljavale	None
šljunak	Accusative
prerađen	None
zamjenikom	Instrumental
krnjadáci	Nominative
fizičare	Accusative
bezosjećajnost	Accusative
pretpostavka	Nominative
utemeljile	None
zahvati	None
koalicijsku	Accusative
individuu	Accusative
keramičkom	Instrumental
objelodanjena	None
alijansu	Accusative
oborina	Genitive
vožena	None
obavještajce	Accusative
manastirsku	Accusative
životinjsku	Accusative
postaše	None
trgovce	Accusative
iskašljavaj	None
flašo	Vocative
demokratskom	Instrumental
brala	None
planskom	Instrumental
izbegla	None
izviještene	None
vrijes	Accusative
nakupljene	None
троножан	Accusative
stavljaše	None
ostavom	Instrumental
krošnju	Accusative
ribnjakom	Instrumental
porugu	Accusative
neznanca	Accusative
približiše	None
konvoja	Genitive
agronomskom	Instrumental
rezultantu	Accusative
tačku	Accusative
svarivani	None
skraćivaste	None
бахати	Accusative
stanom	Instrumental
setvu	Accusative
najeksplozivniju	Accusative
đevojku	Accusative
protivilo	None
američkom	Instrumental
mužara	Genitive
најнаказнији	Accusative
dostigle	None
aranžmána	Genitive
slasniju	Accusative
sociologijom	Instrumental
pružila	None
dolaziš	None
okončao	None
zaposlenike	Accusative
režim	Accusative
feminizmom	Instrumental
razliku	Accusative
ručicom	Instrumental
pristave	None
zacementirao	None
odstupila	None
plodovi	Vocative
izlučuju	None
avionsku	Accusative
prevoze	None
reprodukcijom	Instrumental
ортодоксни	Accusative
pokušao	None
obronci	Vocative
simulaciju	Accusative
nailazimo	None
radije	Accusative
greh	Accusative
volána	Genitive
priznavalo	None
važniju	Accusative
intervjue	Accusative
džepom	Instrumental
digle	None
uzburkavah	None
konjanikom	Instrumental
dunjo	Vocative
bȍjo	Vocative
traktata	Genitive
antisemitsku	Accusative
ortakom	Instrumental
industrijom	Instrumental
srbijanskom	Instrumental
delovao	None
prodru	None
trbuhom	Instrumental
gospu	Accusative
odmorio	None
zločinstvom	Instrumental
asortimana	Genitive
bòžūr	Nominative
pisce	Accusative
plamova	Genitive
nasta	None
амфитеатралан	Accusative
proglasilo	None
broša	Genitive
bugarskom	Instrumental
gnosticizmom	Instrumental
sačinili	None
balkon	Accusative
teren	Accusative
privrednu	Accusative
stogova	Genitive
povratilo	None
jogurtom	Instrumental
prolistavasmo	None
krahom	Instrumental
čvrstina	Nominative
vračeva	Genitive
bȓk	Nominative
interesom	Instrumental
најнепродуктивнији	Accusative
protiče	None
čistku	Accusative
oživeli	None
snijeg	Accusative
ljutio	None
вијетнамски	Accusative
hraste	Vocative
slušaoce	Accusative
zatvorile	None
pravopisom	Instrumental
lavicu	Accusative
nazvao	None
okruge	Accusative
progonstvom	Instrumental
narodnost	Accusative
lezbijsku	Accusative
dužnik	Nominative
intuiciju	Accusative
gomilaš	None
мировни	Accusative
erotskom	Instrumental
stručnjakom	Instrumental
isprljamo	None
prigodu	Accusative
uzmiče	None
šahist	Nominative
ćošak	Accusative
genealogiju	Accusative
zovo	Vocative
tadašnjom	Instrumental
svemirskom	Instrumental
истакнути	Accusative
ambijenta	Genitive
sliku	Accusative
otičite	None
gipsom	Instrumental
безверан	Accusative
ledi	None
poduzetnike	Accusative
izdajete	None
janjeta	Genitive
mladićem	Instrumental
regionalizam	Accusative
vožnjom	Instrumental
pripojene	None
regionom	Instrumental
agu	Accusative
dnevnom	Instrumental
joge	Genitive
genom	Accusative
terapeutsku	Accusative
kočiju	Accusative
stavljate	None
rȅpovi	Nominative
ohlađuj	None
suvremenici	Vocative
prosekom	Instrumental
primjećuju	None
iznenađenjem	Instrumental
vrsta	Nominative
izrazimo	None
највиши	Accusative
isporukom	Instrumental
jogo	Vocative
turbinom	Instrumental
mirazom	Instrumental
padova	Genitive
postavljajte	None
klizne	None
čarobniče	Vocative
analizirale	None
patrijaršijskom	Instrumental
ljestvicom	Instrumental
основан	Accusative
sprema	None
kanue	Accusative
akceleratorom	Instrumental
nadlijećemo	None
kranova	Genitive
vodozemaca	Genitive
ugovarajte	None
sjajniju	Accusative
parlamenta	Genitive
najgušćom	Instrumental
aktivnošću	Instrumental
slonovače	Genitive
oterali	None
antropomorfizmi	Vocative
vjerenike	Accusative
железнички	Accusative
gasovi	Vocative
bane	Vocative
tonzuru	Accusative
spoznali	None
perfekt	Accusative
crepa	Genitive
šampionsku	Accusative
križanjem	Instrumental
pješakom	Instrumental
nadljudskom	Instrumental
ponavljane	None
uveličava	None
znanci	Vocative
imunološkom	Instrumental
mačju	Accusative
slatkiša	Genitive
izaslanikom	Instrumental
tamni	None
pravilnik	Accusative
prerađeno	None
smetali	None
zahtjevom	Instrumental
konkurencijom	Instrumental
predavanjem	Instrumental
tvorcem	Instrumental
acetata	Genitive
kobilu	Accusative
dozvoliste	None
povređena	None
ustupe	None
mikroskopskom	Instrumental
podsjetila	None
zavodio	None
suočio	None
dilètant	Nominative
svetiljko	Vocative
federalist	Nominative
kupaju	None
slitinu	Accusative
zglobove	Accusative
uspjelo	None
shvaćahu	None
radnicom	Instrumental
saveznu	Accusative
zrnom	Instrumental
susretoste	None
poveže	None
gazelom	Instrumental
sabotirahu	None
hidroksídi	Nominative
blizance	Accusative
tlak	Accusative
srpove	Accusative
dvobojem	Instrumental
најполаганији	Accusative
islamsku	Accusative
oko	Vocative
izlazaka	Genitive
zrili	None
bitnijom	Instrumental
najtolerantniju	Accusative
razorili	None
čȗčānjā	Genitive
podatak	Accusative
odaberemo	None
penetrirale	None
surlu	Accusative
nizom	Instrumental
napravljene	None
бивши	Accusative
popravci	Vocative
pèšāk	Nominative
kolnik	Accusative
tavo	Vocative
poginula	None
zidarstva	Genitive
budila	None
sako	Accusative
inerciju	Accusative
mačem	Instrumental
zgrnuste	None
snopom	Instrumental
najrigidnijom	Instrumental
genetičar	Nominative
vozačku	Accusative
borite	None
izjelica	Genitive
projurile	None
automobilskom	Instrumental
telesnu	Accusative
lorde	Vocative
šestara	Genitive
најшлампавији	Accusative
vikendicu	Accusative
питкији	Accusative
diskriminiraste	None
čarobnike	Accusative
sjemenom	Instrumental
toponim	Accusative
primedbu	Accusative
pomagale	None
najavio	None
razlučuju	None
svemirom	Instrumental
нетактичан	Accusative
tamne	None
baja	None
sufizmom	Instrumental
bogumil	Nominative
mozaike	Accusative
nametnulo	None
predgrađem	Instrumental
roman	Accusative
stisnute	None
mađioničare	Accusative
pobačajem	Instrumental
iznijela	None
gnojem	Instrumental
biltena	Genitive
benzen	Accusative
prvenstvom	Instrumental
праславенски	Accusative
telesnom	Instrumental
најсталнији	Accusative
znanstvenike	Accusative
penisom	Instrumental
bajt	Accusative
glumcem	Instrumental
limunom	Instrumental
belgijskom	Instrumental
kožu	Accusative
pazara	Genitive
trgovinskom	Instrumental
stambenu	Accusative
pregnuh	None
pomake	Accusative
pistom	Instrumental
razmišljaju	None
краковски	Accusative
suočavao	None
akademskom	Instrumental
katedralom	Instrumental
izraelsku	Accusative
upadljiviju	Accusative
svježinu	Accusative
lemeš	Accusative
traka	Nominative
razmenili	None
pučinom	Instrumental
starateljem	Instrumental
omogućile	None
трансцендентални	Accusative
temeljnu	Accusative
oporavilo	None
riječnu	Accusative
simplificirah	None
tkanjem	Instrumental
tipovi	Vocative
masturbirasmo	None
osnovo	Vocative
zaglaviste	None
savi	None
uloži	None
svrstavala	None
sjevernoafričkom	Instrumental
šumove	Accusative
najnerodnijom	Instrumental
otvorimo	None
koristicom	Instrumental
lešinar	Nominative
stepena	Genitive
sidre	None
predsjednicom	Instrumental
prišla	None
očèvīdācā	Genitive
jajcem	Instrumental
šizofrenijom	Instrumental
briologijo	Vocative
kotač	Accusative
igumanom	Instrumental
prošlogodišnju	Accusative
broj	Accusative
daktilografija	Nominative
etičkom	Instrumental
trofejem	Instrumental
partijom	Instrumental
dilerom	Instrumental
trolejbusnom	Instrumental
zapošljavale	None
biološkom	Instrumental
narodnom	Instrumental
smiruje	None
vitraže	Accusative
rastaje	None
причљивији	Accusative
kelj	Accusative
novaci	Vocative
затворен	Accusative
krećemo	None
ismijavaju	None
samsara	Nominative
obratile	None
književnikom	Instrumental
debelokóšca	Genitive
juga	Genitive
geomorfologije	Genitive
promišljaš	None
ukrstili	None
knjižničnom	Instrumental
izgledale	None
animizam	Accusative
burmom	Instrumental
intrigirate	None
iseljenici	Vocative
amana	Genitive
ostatkom	Instrumental
determinizma	Genitive
otprave	None
zarazom	Instrumental
zrakoplovstvom	Instrumental
lososom	Instrumental
klon	Nominative
primjerkom	Instrumental
limove	Accusative
morskom	Instrumental
meteorologiju	Accusative
plafon	Accusative
epitetom	Instrumental
soko	Nominative
lovcem	Instrumental
torbom	Instrumental
smeća	Genitive
meha	Genitive
tektonike	Genitive
pobjedom	Instrumental
papagaj	Nominative
ushićeniju	Accusative
zapreku	Accusative
semenkom	Instrumental
otputovala	None
ormare	Accusative
bombardirala	None
intrigantniju	Accusative
najdubokoumniju	Accusative
falom	Instrumental
izvršeno	None
polazaka	Genitive
sadili	None
teletino	Vocative
rakijom	Instrumental
kečapom	Instrumental
potoke	Accusative
sugestijom	Instrumental
egzistencijom	Instrumental
bič	Accusative
poštovaoce	Accusative
postignut	None
gluhoćom	Instrumental
nasmejana	None
zaostao	None
kamatu	Accusative
afganistanskom	Instrumental
proporcijom	Instrumental
opsadom	Instrumental
nabreknimo	None
robotom	Instrumental
akademsku	Accusative
prenete	None
preglas	Accusative
ugrijavala	None
unose	None
dijabetičarkom	Instrumental
prognostičar	Nominative
sape	None
čin	Accusative
tenkovi	Vocative
puštane	None
šešira	Genitive
kòljāč	Nominative
prihvatljivost	Accusative
sudjeluju	None
безочни	Accusative
civilizaciju	Accusative
tekuću	Accusative
učitelj	Nominative
mimare	Accusative
višeznačnost	Accusative
osporavana	None
azbuku	Accusative
štitonošu	Accusative
diskriminira	None
povedete	None
gradskom	Instrumental
podmornicom	Instrumental
propuštala	None
гњусаи	Accusative
intervencijom	Instrumental
pročitana	None
litvanskom	Instrumental
iseljenike	Accusative
odobrovoljio	None
naterali	None
pragova	Genitive
financirali	None
napilo	None
udružilo	None
čopore	Accusative
nakanu	Accusative
deizama	Genitive
prevoditelj	Nominative
natjecanjem	Instrumental
naglaska	Genitive
znakovi	Vocative
rastane	None
osetile	None
izvidnici	Vocative
sociološku	Accusative
centilitara	Genitive
uvoze	Accusative
crtežom	Instrumental
eholalijo	Vocative
okteta	Genitive
brodogradilištem	Instrumental
terapiju	Accusative
nizale	None
upoznale	None
očuhom	Instrumental
nadala	None
nuđena	None
sicilijansku	Accusative
lišena	None
spojeva	Genitive
изоловни	Accusative
anglistike	Genitive
jastog	Nominative
tetrijeb	Accusative
nadzemaljskom	Instrumental
даљи	Accusative
povećavamo	None
popravili	None
automobilsku	Accusative
zalutale	None
leđnu	Accusative
kibernetike	Genitive
vèšāč	Nominative
građevinsku	Accusative
kòvērta	Nominative
nojevom	Instrumental
cifrom	Instrumental
maloazijsku	Accusative
kàljuža	Nominative
mutacijom	Instrumental
grenlandskom	Instrumental
acetilen	Accusative
turnira	Genitive
zagriju	None
psihološku	Accusative
tišu	Accusative
nadzire	None
potvrdom	Instrumental
komunikativnijom	Instrumental
vlastele	Genitive
fragment	Accusative
sugestiju	Accusative
povela	None
lociraju	None
obrišite	None
stila	Genitive
letvom	Instrumental
čakavština	Nominative
metroom	Instrumental
veštak	Nominative
inkorporacijom	Instrumental
jačale	None
odobrovolji	None
prišle	None
dobavljače	Accusative
kolekciju	Accusative
polubratom	Instrumental
enciklopedijskom	Instrumental
stavovi	Vocative
најфренетичнији	Accusative
razviju	None
španjolskom	Instrumental
odvođen	None
unele	None
salom	Instrumental
kupovale	None
dosade	None
nabijača	Genitive
dizalom	Instrumental
muzikologije	Genitive
foku	Accusative
rimokatoličku	Accusative
spopalo	None
plemenitost	Accusative
delovale	None
krstionicom	Instrumental
barabo	Vocative
kažnjavao	None
odabere	None
podrezivao	None
magneta	Genitive
momci	Vocative
masturbacijom	Instrumental
pripravnike	Accusative
izdaci	Vocative
pokrivale	None
profita	Genitive
otpore	Accusative
vjernike	Accusative
свјетски	Accusative
češlja	Genitive
atentata	Genitive
zgrabi	None
presvuče	None
ispuštali	None
sljepoočnicu	Accusative
kaoline	Vocative
beleška	Nominative
civilnom	Instrumental
kalka	Genitive
promociju	Accusative
subotu	Accusative
laže	None
imigraciju	Accusative
upitali	None
pravosudnom	Instrumental
položena	None
isključiviju	Accusative
optuživana	None
učiteljskom	Instrumental
festivalom	Instrumental
smrtnost	Accusative
šapo	Vocative
punjeni	None
intelektualizam	Accusative
udarcem	Instrumental
stida	Genitive
oazu	Accusative
momke	Accusative
kružoka	Genitive
kìtovi	Nominative
agnosticizma	Genitive
ekonomskom	Instrumental
brisani	None
monolitom	Instrumental
fašist	Nominative
komičar	Nominative
palaču	Accusative
povratkom	Instrumental
mobilnost	Accusative
isporučen	None
reprezentativci	Vocative
директан	Accusative
birate	None
uvodimo	None
lepotu	Accusative
doktorom	Instrumental
malograđaninom	Instrumental
carinici	Vocative
celuloze	Genitive
komičarku	Accusative
kamiondžija	Genitive
komšiju	Accusative
блатан	Accusative
čelnike	Accusative
samopouzdanja	Genitive
zakazuje	None
живи	Accusative
pucnjem	Instrumental
naglašeni	None
zaustavljen	None
odvođeni	None
kompjuterom	Instrumental
historiografija	Nominative
pobeđujemo	None
odrednicu	Accusative
upisano	None
pogledajte	None
sjedilo	None
dopisivahu	None
umirovljenike	Accusative
zamku	Accusative
dodirivala	None
utopim	None
raskida	None
križeve	Accusative
nogometnu	Accusative
априоран	Accusative
podvig	Accusative
sekrecijom	Instrumental
статистички	Accusative
najneproduktivniju	Accusative
dućana	Genitive
psihopatom	Instrumental
govornici	Vocative
postavkom	Instrumental
gospodaricom	Instrumental
обичан	Accusative
prugom	Instrumental
pobunu	Accusative
otorinolaringolozi	Vocative
priču	Accusative
križem	Instrumental
cinka	Genitive
čekam	None
stavio	None
dušike	Accusative
uzbuđenost	Accusative
suglasnike	Accusative
izmjeren	None
argumenata	Genitive
zamjera	None
talisman	Accusative
razvítak	Nominative
podeste	Accusative
ljubavnik	Nominative
kantonskom	Instrumental
životopisom	Instrumental
barjake	Accusative
germansku	Accusative
ikru	Accusative
naboje	Accusative
neuspjehe	Accusative
razočarenjem	Instrumental
slučajem	Instrumental
nadovezan	None
izdvojili	None
strukova	Genitive
piletino	Vocative
skaut	Nominative
promatrajmo	None
maternjom	Instrumental
највидљивији	Accusative
vladarom	Instrumental
umorom	Instrumental
nuždu	Accusative
spekulaciju	Accusative
sintaksu	Accusative
mišićnu	Accusative
završavam	None
naseljavali	None
inzulína	Genitive
gulim	None
pobednikom	Instrumental
ljigavijom	Instrumental
žbune	Vocative
iziskivao	None
poticali	None
englesku	Accusative
kalifornijsku	Accusative
glumile	None
slomi	None
valjak	Accusative
uzimala	None
ciči	None
pločnik	Accusative
magnetit	Accusative
pripremao	None
uvriježio	None
centralizaciju	Accusative
napijemo	None
ilirsku	Accusative
galerijom	Instrumental
prikrili	None
механички	Accusative
nabirala	None
prelaske	Accusative
dijagnostikom	Instrumental
punskom	Instrumental
profit	Accusative
dòčeka	Genitive
predvidela	None
proćerdaste	None
suzu	Accusative
prolazaka	Genitive
obelodanjeno	None
uživamo	None
kakavkakva	Accusative
kormilom	Instrumental
kritìkant	Nominative
kolonijom	Instrumental
krstokljun	Nominative
hladovinu	Accusative
kratere	Accusative
hȍdočasnīk	Nominative
Slavenkom	Instrumental
republikom	Instrumental
semantike	Genitive
odmarala	None
kvasac	Accusative
singlovi	Vocative
izložila	None
umivaonike	Accusative
smijȇšākā	Genitive
prekršena	None
marmeladom	Instrumental
ograničavalo	None
pričaju	None
ulovom	Instrumental
savetnik	Nominative
božur	Accusative
pozdravljam	None
kasnijom	Instrumental
krivodolskom	Instrumental
omladina	Nominative
sredinom	Instrumental
plafóna	Genitive
rukavce	Accusative
sabotažom	Instrumental
nagnuo	None
desetorica	Nominative
prerušene	None
razmatrano	None
ekstrakt	Accusative
tektoniku	Accusative
šahova	Genitive
arebicom	Instrumental
izazivačem	Instrumental
troškom	Instrumental
pomoglo	None
razneo	None
stidljiviju	Accusative
volana	Genitive
partnere	Accusative
iskrčujmo	None
botanikom	Instrumental
izlagane	None
pjȅsānā	Genitive
flegmu	Accusative
astronautiku	Accusative
gȉgametar	Nominative
dirali	None
arhipelazi	Vocative
baka	Genitive
tradicionalist	Nominative
brezovac	Accusative
alku	Accusative
kumarinom	Instrumental
варљивији	Accusative
topolu	Accusative
razrađuje	None
magnetitom	Instrumental
ucenila	None
prirode	Genitive
urednik	Nominative
pokrenute	None
glavicu	Accusative
užici	Vocative
kipćahu	None
časom	Instrumental
glasovi	Vocative
krhkijom	Instrumental
lemu	Accusative
zbijaju	None
pȗče	Vocative
pravnike	Accusative
odoli	None
brkao	None
ljubimo	None
morfem	Accusative
sùgrađanin	Nominative
univerzitet	Accusative
konsonanta	Genitive
ptičju	Accusative
oštetiste	None
para	Genitive
savjetnikom	Instrumental
prikažu	None
ritmom	Instrumental
policu	Accusative
trigonometrijom	Instrumental
štabom	Instrumental
naobrazbo	Vocative
sprudom	Instrumental
neurednost	Accusative
napredniju	Accusative
mršavijom	Instrumental
odbacila	None
opazila	None
грличји	Accusative
advokatsku	Accusative
nakitom	Instrumental
skida	None
luga	Genitive
žudnju	Accusative
trijema	Genitive
korovom	Instrumental
aristokratkinju	Accusative
poslali	None
galeblju	Accusative
debatom	Instrumental
egzila	Genitive
veslanjem	Instrumental
škamp	Nominative
juhu	Accusative
vezivali	None
štapom	Instrumental
radnikom	Instrumental
posječena	None
štaku	Accusative
vrenjem	Instrumental
imenicu	Accusative
balast	Accusative
vŕpcā	Genitive
albansku	Accusative
događali	None
mlacom	Instrumental
lutaoca	Accusative
opčiniste	None
uzima	None
ispostavljam	None
zahtevale	None
primerke	Accusative
istinu	Accusative
ponudilo	None
podučene	None
samurovino	Vocative
anakronizmom	Instrumental
šamanizam	Accusative
amsterdamsku	Accusative
upravo	Vocative
četvoricom	Instrumental
nebogiju	Accusative
poklopca	Genitive
zupce	Accusative
valove	Accusative
avanturom	Instrumental
uzdržale	None
smenu	Accusative
trgne	None
dosegne	None
sirio	None
bočnom	Instrumental
uložen	None
pomiješana	None
otpisao	None
tipologija	Nominative
kontrolu	Accusative
maza	Genitive
polubogovima	Dative
plasira	None
ždrijebaste	None
kožarstvom	Instrumental
raskrsnicu	Accusative
оригиналан	Accusative
majeva	Genitive
inženjerskom	Instrumental
atrofiju	Accusative
pomicao	None
karavána	Genitive
zamišljao	None
smirivana	None
atletičare	Accusative
uredom	Instrumental
moćnike	Accusative
preleta	None
izračunati	None
svitkovci	Vocative
bratsku	Accusative
geopolitike	Genitive
povjeri	None
Zemlja	Nominative
branjeni	None
stavljano	None
fosilnu	Accusative
upali	None
najgrješnijom	Instrumental
komoru	Accusative
praznici	Vocative
gusare	Accusative
finsku	Accusative
pokrenuli	None
pogledate	None
izrečene	None
ostvarite	None
trenuci	Vocative
orlom	Instrumental
usmjeravala	None
drugačiju	Accusative
rajem	Instrumental
transfuzijo	Vocative
šahinom	Instrumental
glavninu	Accusative
prikazivani	None
radiologija	Nominative
travnja	Genitive
dizajner	Nominative
najtješnjom	Instrumental
sačekuješ	None
osvetu	Accusative
polagalo	None
pokazano	None
stanku	Accusative
izbrisana	None
potrošene	None
garantovalo	None
raso	Vocative
vidike	Accusative
mirena	None
izabere	None
cijeljene	None
sažétka	Genitive
cvetak	Accusative
tuguj	None
post	Accusative
ženku	Accusative
porabu	Accusative
vetrićem	Instrumental
triba	None
tiranin	Nominative
djevce	Accusative
medvjedićem	Instrumental
tablicu	Accusative
izlizalo	None
anglikanaca	Genitive
pramac	Accusative
ublažio	None
levom	Instrumental
nećaci	Vocative
nastavom	Instrumental
uživala	None
dozvolom	Instrumental
saonica	Genitive
astronomija	Nominative
upropastila	None
poprištem	Instrumental
stijenja	Genitive
razlikom	Instrumental
ističe	None
osokoljeno	None
комплетан	Accusative
kapacitete	Accusative
nožem	Instrumental
talijansku	Accusative
mandarino	Vocative
najbeščasniju	Accusative
bravo	Vocative
klasnom	Instrumental
labirintom	Instrumental
presadi	None
tornja	Genitive
nosio	None
čovjekoljubce	Accusative
tenkove	Accusative
potrošačem	Instrumental
doprle	None
zakopate	None
judejsku	Accusative
изабрани	Accusative
automatom	Instrumental
savsku	Accusative
безрезерван	Accusative
listopadnom	Instrumental
gramofona	Genitive
poništile	None
stabilizacijom	Instrumental
pomiješao	None
poboljšavaju	None
uključuju	None
madrigal	Accusative
свилен	Accusative
ljudskost	Accusative
мобилан	Accusative
rovove	Accusative
ruši	None
klani	None
imenik	Accusative
планински	Accusative
zapuštene	None
suzbijeni	None
bubnu	None
imenovalo	None
ništavila	Genitive
divi	None
razrađeni	None
stvarali	None
razumijete	None
svadbenom	Instrumental
bivšom	Instrumental
šestorica	Nominative
uglom	Instrumental
oluke	Accusative
maka	Genitive
vjerujete	None
zapisuješ	None
профитабилан	Accusative
useljen	None
japansku	Accusative
prstenom	Instrumental
majčinom	Instrumental
anemiju	Accusative
roje	Vocative
nepažnja	Nominative
spojnicu	Accusative
petak	Accusative
prosjaci	Vocative
prostorom	Instrumental
pesmu	Accusative
upoznate	None
naobrazbom	Instrumental
zaljevom	Instrumental
poljubaca	Genitive
kredíta	Genitive
čajem	Instrumental
zahvatilo	None
terorističkom	Instrumental
upozoravaju	None
vučićem	Instrumental
leči	None
uzbuđeniju	Accusative
posljedico	Vocative
savijaše	None
srednjom	Instrumental
programom	Instrumental
poverena	None
vazalstva	Genitive
radiologije	Genitive
glibova	Genitive
imovinskom	Instrumental
snimite	None
рођени	Accusative
šablonu	Accusative
kvantnom	Instrumental
teologijom	Instrumental
anemijom	Instrumental
izbodeni	None
muzejsku	Accusative
voditeljicu	Accusative
opasuju	None
kobilicu	Accusative
годишњи	Accusative
luka	Genitive
osiguravao	None
obnavljasmo	None
kane	Vocative
veslačicom	Instrumental
obuhvati	None
naseljem	Instrumental
uvjeravam	None
stjenico	Vocative
najrevolucionarnijom	Instrumental
uračunamo	None
djevče	Vocative
gvožđa	Genitive
predstavljaju	None
prijenosnikom	Instrumental
pretiskom	Instrumental
najlačnijom	Instrumental
predlagao	None
podrezivan	None
žurnalistiku	Accusative
dostizale	None
akustičku	Accusative
bordel	Accusative
непојмљив	Accusative
rasterećujte	None
odriče	None
osiguramo	None
akademike	Accusative
najsevernijom	Instrumental
globalizacija	Nominative
izravnale	None
zdjelu	Accusative
ciknete	None
hiperonim	Accusative
odmazdo	Vocative
adaptacijom	Instrumental
vjesnik	Accusative
telefonije	Genitive
fikcijom	Instrumental
ljutili	None
spaljivane	None
albanizacija	Nominative
abonircem	Instrumental
internacionalist	Nominative
dječákom	Instrumental
многи	Accusative
kazališnom	Instrumental
uvalu	Accusative
rukovahu	None
vršili	None
astronomije	Genitive
posrćeš	None
baltičkom	Instrumental
maraka	Genitive
najamnu	Accusative
opomenom	Instrumental
reklamu	Accusative
spašeno	None
plȃtācā	Genitive
gibalo	None
klubove	Accusative
štelom	Instrumental
inkarnacijom	Instrumental
zauzimali	None
prefekturu	Accusative
opredeli	None
hladnoća	Nominative
trebale	None
utakmicu	Accusative
vunu	Accusative
razumnošću	Instrumental
spiskom	Instrumental
ploču	Accusative
rupturom	Instrumental
predoči	None
urotu	Accusative
okrenuh	None
progutaju	None
obadom	Instrumental
sarkazmom	Instrumental
karmu	Accusative
zlikovaca	Genitive
apsolutizmom	Instrumental
rojalističku	Accusative
približavamo	None
lovinom	Instrumental
trajekt	Accusative
austrougarsku	Accusative
bazu	Accusative
sputavale	None
sitnicom	Instrumental
vijećnik	Nominative
gerilom	Instrumental
veče	Vocative
zemljištem	Instrumental
rȃdija	Genitive
račićem	Instrumental
rovom	Instrumental
zatalasavalo	None
ubijena	None
žarulju	Vocative
simpatizerka	Nominative
čekovi	Vocative
odličjem	Instrumental
vodova	Genitive
umnijom	Instrumental
suspenzijom	Instrumental
maskulizme	Vocative
caricom	Instrumental
obujmova	Genitive
materijalizma	Genitive
poseče	None
bakra	Genitive
aplikaciju	Accusative
optimizma	Genitive
arheološku	Accusative
pripovetku	Accusative
uništene	None
posetili	None
trockizam	Accusative
voz	Accusative
racionalist	Nominative
čitaoce	Accusative
zagreje	None
osiromašio	None
siren	None
agronomiju	Accusative
izneseno	None
izvlačile	None
neočekivaniju	Accusative
uhapse	None
elektrifikacije	Genitive
dvòličnjāci	Nominative
ilegalnost	Accusative
ocat	Accusative
transportom	Instrumental
avionskom	Instrumental
pokoljem	Instrumental
odećom	Instrumental
zglobova	Genitive
pritisnite	None
vedskom	Instrumental
lupamo	None
globalizacijo	Vocative
metalom	Instrumental
magmom	Instrumental
biberom	Instrumental
domaćinskom	Instrumental
podešavao	None
rasizmom	Instrumental
napravilo	None
kobro	Vocative
djecom	Instrumental
kerberom	Instrumental
opredjeljujemo	None
Čehe	Accusative
dokument	Accusative
puhnuste	None
tucano	None
harpunom	Instrumental
ustupljene	None
tacno	Vocative
tjerao	None
ispričane	None
skraćuje	None
veterinarskom	Instrumental
изабран	Accusative
porastao	None
kúta	Genitive
sutkinju	Accusative
prognozirao	None
ukorenjivaše	None
sputam	None
pomoraca	Genitive
ispravu	Accusative
rešetku	Accusative
ìzmak	Nominative
slȉna	Nominative
najkišniju	Accusative
razvrstavaj	None
julsku	Accusative
redoslijeda	Genitive
zanemaruju	None
poseduješ	None
zaselaka	Genitive
otkazao	None
žargona	Genitive
isceljivan	None
zahtijevajte	None
zbirku	Accusative
biljojedskom	Instrumental
kuniće	Accusative
tuđtuđa	Accusative
odvajajmo	None
ispunjava	None
šrapnel	Accusative
namijenjene	None
političarom	Instrumental
hapšeni	None
veseljem	Instrumental
krilaticu	Accusative
šlìcevi	Nominative
ishranu	Accusative
nabire	None
ugušena	None
zabilježila	None
uzbuđivasmo	None
krijumčario	None
iskorijenjeno	None
ceremonijala	Genitive
agom	Instrumental
sirijsku	Accusative
pantalona	Genitive
primenjujemo	None
područjem	Instrumental
платив	Accusative
nacionalističkom	Instrumental
seljaštvom	Instrumental
raspustili	None
incident	Accusative
uručila	None
trezvenost	Accusative
tajnikom	Instrumental
književnike	Accusative
shrvan	None
zadovoljile	None
drogu	Accusative
penjao	None
kozom	Instrumental
dozvale	None
carinarnicu	Accusative
planirani	None
prelijetao	None
odredili	None
provjereni	None
heterozigoti	Vocative
srpsku	Accusative
izolirali	None
giljotinom	Instrumental
liberalom	Instrumental
parolo	Vocative
nabacio	None
podsjetnik	Accusative
grȃšākā	Genitive
utrka	Genitive
širilo	None
iskreniju	Accusative
nagrađuje	None
ranjenik	Nominative
narječjem	Instrumental
kartografsku	Accusative
divljinom	Instrumental
izlaske	Accusative
klipe	Vocative
pigmentacijom	Instrumental
štandova	Genitive
ivo	Vocative
isplatili	None
prepredeniju	Accusative
prebacilo	None
armiju	Accusative
naobrazbe	Genitive
rese	None
destrukcijom	Instrumental
pričvršćena	None
postankom	Instrumental
aerodromsku	Accusative
izraze	Accusative
raskolom	Instrumental
bivol	Nominative
egzekuciju	Accusative
doček	Accusative
sviralu	Accusative
očišćene	None
prelo	None
uručeni	None
ȍbuzētōst	Nominative
biralo	None
spoznajom	Instrumental
srlja	None
grančicu	Accusative
aferu	Accusative
obelisk	Accusative
raspoznam	None
izricala	None
utječu	None
studenoga	Genitive
rječicom	Instrumental
skarabej	Accusative
mrači	None
cvijetaka	Genitive
pevane	None
madràci	Nominative
svijećnjače	Vocative
svjȅtovi	Nominative
kvarom	Instrumental
pekar	Nominative
proboli	None
prevozom	Instrumental
polubraće	Genitive
izjašnjavahu	None
ekipom	Instrumental
mȇrā	Genitive
rodoljubom	Instrumental
većinom	Instrumental
sinonimom	Instrumental
uspehom	Instrumental
halucinaciju	Accusative
odvijaju	None
zipku	Accusative
popunjavale	None
albanološkinjom	Instrumental
papra	Genitive
plovućče	Vocative
šarlatan	Nominative
najučenijom	Instrumental
pisano	None
nedostaci	Vocative
ansamblom	Instrumental
rukotvorinu	Accusative
doživljavala	None
sùmnjīvče	Vocative
golfer	Nominative
kultom	Instrumental
štreber	Nominative
noževi	Vocative
frontom	Instrumental
безболни	Accusative
plodi	None
čȁkāljā	Genitive
mehanizma	Genitive
priklanjaju	None
tehničare	Accusative
odvođene	None
mijeh	Accusative
fekalija	Genitive
nagovestio	None
mezopauzu	Accusative
kŕmci	Nominative
zibana	None
križaju	None
otmu	None
òtprāvnīk	Nominative
prihvatite	None
kuri	None
istrebljene	None
povukli	None
banom	Instrumental
najbirokratskijom	Instrumental
patnjom	Instrumental
kvante	Accusative
pročitali	None
medijator	Nominative
tapetar	Nominative
korijenom	Instrumental
uvuče	None
olakšani	None
organskom	Instrumental
prilagodila	None
srneš	None
banknotom	Instrumental
antikomunizmom	Instrumental
osvježio	None
oblik	Accusative
odmetnikom	Instrumental
ujaci	Vocative
podudarnost	Accusative
sanskrtom	Instrumental
plaćalo	None
rešavao	None
ontologiju	Accusative
pretvorbom	Instrumental
odrednico	Vocative
nabrani	None
izbavili	None
ušju	Instrumental
kolijevku	Accusative
križevi	Vocative
iziđeš	None
podcrtava	None
zagonetku	Accusative
bolesnikom	Instrumental
dȇbālā	Genitive
uručio	None
kraljevom	Instrumental
polutku	Accusative
svetionika	Genitive
обавезни	Accusative
izumljene	None
presudom	Instrumental
ljubavnom	Instrumental
кратак	Accusative
ugovorio	None
bankrotom	Instrumental
nabijač	Accusative
napunila	None
ginekologija	Nominative
najdragoceniju	Accusative
čuperkom	Instrumental
štapa	Genitive
prijeđimo	None
učvršćuju	None
ludak	Nominative
razgovaram	None
poljoprivredom	Instrumental
sačekivali	None
univerziteta	Genitive
ногат	Accusative
posječene	None
centimetrom	Instrumental
tužitelj	Nominative
jezovitijom	Instrumental
koledom	Instrumental
koncepcijom	Instrumental
fascinirate	None
smerove	Accusative
nastavljalo	None
основни	Accusative
uplašen	None
epidemijom	Instrumental
tjȅmena	Genitive
непуни	Accusative
ustupile	None
ogradila	None
presečena	None
poludjeli	None
koordinacijom	Instrumental
efikasnijom	Instrumental
samotnikom	Instrumental
prestadoh	None
krivokletničku	Accusative
odmazdu	Accusative
ikonu	Accusative
egocentrizama	Genitive
pidžamu	Accusative
sanskrta	Genitive
polubog	Nominative
udalji	None
zamjenicom	Instrumental
vijetnamsku	Accusative
vulkanizaciju	Accusative
dlakom	Instrumental
brakove	Accusative
igračku	Accusative
teoretičare	Accusative
zaboravljano	None
nestanci	Vocative
vešticom	Instrumental
podrazumijevaju	None
mladenci	Vocative
nepristupačnost	Accusative
informatike	Genitive
неуништиви	Accusative
ludila	Genitive
detektivom	Instrumental
krizom	Instrumental
angažira	None
razbacani	None
nacrtano	None
farmakolozi	Vocative
cigaru	Accusative
kapitalističku	Accusative
obrađivale	None
плебејски	Accusative
hipnozu	Accusative
pribrajana	None
zakopane	None
jačinom	Instrumental
ugrozi	None
specijaliziraju	None
ukopan	None
kožar	Nominative
perilicu	Accusative
feudalca	Accusative
лакомислени	Accusative
odbila	None
fonolozi	Vocative
bakrom	Instrumental
marševe	Accusative
jastrebova	Genitive
tkalac	Nominative
paviljonom	Instrumental
urednike	Accusative
anglikansku	Accusative
viku	Accusative
сафтни	Accusative
sadizam	Accusative
naglaske	Accusative
astrologijom	Instrumental
kvarkova	Genitive
ukrade	None
umnjače	Vocative
oksid	Accusative
rimokatoličkom	Instrumental
prebiju	None
nomenklaturu	Accusative
lovljaše	None
rasporedila	None
usavršavan	None
patnju	Accusative
traktat	Accusative
ćelijom	Instrumental
galebicu	Accusative
dijagnozom	Instrumental
obaveštajci	Vocative
obodu	None
odabire	Accusative
brk	Accusative
ukinu	None
platili	None
najoblijom	Instrumental
odoleo	None
zbivao	None
odjeljaka	Genitive
uznemiren	None
ponedjeljka	Genitive
teletinom	Instrumental
iskrom	Instrumental
ukazale	None
kantu	Accusative
buđelarom	Instrumental
tramvaje	Accusative
štrka	Genitive
naručuje	None
svetkovinu	Accusative
doručkom	Instrumental
stražar	Nominative
obustavio	None
gospođicu	Accusative
šarmirao	None
plátac	Nominative
savinu	None
odgrizao	None
pastoralu	Accusative
omekšivača	Genitive
baltičku	Accusative
svrhom	Instrumental
agresijom	Instrumental
kuvahu	None
lugom	Instrumental
ubojico	Vocative
надводни	Accusative
slovniče	Vocative
ukorijenjene	None
stagnirali	None
razvoje	Accusative
nadovezao	None
pevaj	None
prozvani	None
promašajem	Instrumental
teka	Genitive
prati	None
afekta	Genitive
sneg	Accusative
tehnici	Dative
fotona	Genitive
cima	Essive
činilac	Nominative
imitacijom	Instrumental
mesečnu	Accusative
pristupio	None
dośetkom	Instrumental
sutesku	Accusative
brodicom	Instrumental
podvostruče	None
najopasniju	Accusative
krivotvorinom	Instrumental
asimilirala	None
devojkom	Instrumental
pilića	Genitive
reptíle	Accusative
refren	Accusative
sudbinu	Accusative
podudaralo	None
brusio	None
stupio	None
liske	Accusative
sačmaricu	Accusative
preporučeni	None
delova	Genitive
seksualnošću	Instrumental
konstrukcijo	Vocative
pomaknute	None
svetiljka	Nominative
mahalom	Instrumental
mještani	Vocative
dirigentom	Instrumental
karmelićana	Genitive
vještaci	Vocative
konopaca	Genitive
latinicu	Accusative
sprejem	Instrumental
prizvukom	Instrumental
воден	Accusative
dojavio	None
zahvatili	None
zijevom	Instrumental
dokazane	None
štemalo	None
rastavljeno	None
motku	Accusative
napravio	None
putovnicom	Instrumental
kaspijsku	Accusative
alveolo	Vocative
ispitivan	None
zapamtili	None
непријепоран	Accusative
kompromisom	Instrumental
prítužba	Nominative
folkloristiku	Accusative
temelje	Accusative
konfucijanizmom	Instrumental
irsku	Accusative
sačmaricom	Instrumental
brodić	Accusative
odgađa	None
supstituciju	Accusative
državnom	Instrumental
galamu	Accusative
božansku	Accusative
čȍvječnōst	Nominative
suočene	None
sopranom	Instrumental
osramoćeni	None
podrazumijevamo	None
buta	Genitive
uračunavala	None
blogova	Genitive
ateistom	Instrumental
dirajte	None
povere	None
ivrit	Accusative
najnapredniju	Accusative
smjernicu	Accusative
praznòglāvca	Genitive
dostavu	Accusative
junaštvom	Instrumental
udarale	None
antropolozi	Vocative
izolacijom	Instrumental
zakleti	None
mahnete	None
napučilo	None
narudžbu	Accusative
zalagalo	None
vlažnošću	Instrumental
porobe	None
humke	Accusative
ragom	Instrumental
paranoja	Nominative
mašinom	Instrumental
utješi	None
leksikografije	Genitive
železničkom	Instrumental
naracijo	Vocative
nadmašeni	None
vika	Genitive
sagori	None
probodene	None
verovala	None
lim	Accusative
panegirici	Vocative
metrologija	Nominative
objašnjavali	None
memorijom	Instrumental
puzili	None
materija	Nominative
pijetlova	Genitive
sistematskom	Instrumental
galaktiku	Accusative
pljačka	Nominative
mučenikom	Instrumental
izraslinu	Accusative
konstelaciju	Accusative
debijem	Instrumental
pasoše	Accusative
partijskom	Instrumental
smijeh	Accusative
freska	Nominative
uzelo	None
napunile	None
odlaska	Genitive
stupilo	None
starosjediocem	Instrumental
usmjere	None
izrazite	None
prijemnik	Accusative
dodavalo	None
dodelilo	None
iluziju	Accusative
poštanskom	Instrumental
barako	Vocative
doživeli	None
najezdom	Instrumental
izvukli	None
nudilo	None
diktator	Nominative
реалан	Accusative
bistu	Accusative
oživio	None
usmjerili	None
planiran	None
proplakuj	None
načusmo	None
desetogodišnju	Accusative
detalje	Accusative
pomognute	None
štapova	Genitive
poslan	None
svrši	None
неугодни	Accusative
vegetacije	Genitive
ložu	Accusative
gospodine	Vocative
тренутан	Accusative
štrajkovi	Vocative
svjetine	Genitive
најискричавији	Accusative
uzbudi	None
proizvede	None
apotekar	Nominative
arbitar	Nominative
еластичан	Accusative
gasove	Accusative
izgradnju	Accusative
administratore	Accusative
укупан	Accusative
autonomaše	Accusative
flautu	Accusative
sintagmu	Accusative
muževnijom	Instrumental
ocijenili	None
medalju	Accusative
sapùnār	Nominative
skine	None
raspustio	None
ražnja	Genitive
trnjem	Instrumental
sjevernoameričkom	Instrumental
dospije	None
amelioraciju	Accusative
mnenjem	Instrumental
sociologija	Nominative
sira	Genitive
prijavljujte	None
sklopa	Genitive
svršava	None
izdvaja	None
sumnjičili	None
nektarom	Instrumental
etologije	Genitive
fregatom	Instrumental
cerom	Instrumental
svemirsku	Accusative
poste	Vocative
opeku	Accusative
željeno	None
rezala	None
dòsljednōst	Nominative
duhom	Instrumental
kustos	Nominative
hegemoniju	Accusative
individualnost	Accusative
grehom	Instrumental
elegijom	Instrumental
liftovi	Vocative
homoseksualče	Vocative
lordovi	Vocative
ponuđena	None
tvrđu	Accusative
pehare	Accusative
staklom	Instrumental
pukne	None
tekst	Accusative
celinu	Accusative
rezao	None
upoznalo	None
grajom	Instrumental
kvadranta	Genitive
zaradu	Accusative
istraživanjem	Instrumental
nacionalnom	Instrumental
kolektivom	Instrumental
zoologija	Nominative
stubom	Instrumental
stvara	None
dunju	Accusative
prćili	None
pragom	Instrumental
slomljena	None
večernjom	Instrumental
raspoznati	None
filtrom	Instrumental
ručali	None
dočekamo	None
car	Nominative
građ	Nominative
lešnjake	Accusative
vitraž	Accusative
bilura	Genitive
petljom	Instrumental
determinacije	Genitive
litru	Accusative
značajniju	Accusative
krklja	None
tvrdoćom	Instrumental
izgrebeni	None
najma	Genitive
pogrešile	None
herojem	Instrumental
uzimaju	None
brakova	Genitive
usporena	None
hajmo	None
humorističkom	Instrumental
vesèljāk	Nominative
zoološkom	Instrumental
marša	Genitive
odsečena	None
kožnom	Instrumental
bogatijom	Instrumental
peci	Vocative
opsednuta	None
alternativom	Instrumental
osornijom	Instrumental
затворени	Accusative
primilo	None
fosforom	Instrumental
dosežimo	None
salatu	Accusative
aminokiselinom	Instrumental
počinjena	None
zabijena	None
oglasom	Instrumental
pomuzimo	None
ribljom	Instrumental
željezom	Instrumental
deobu	Accusative
zumbulom	Instrumental
singlove	Accusative
papo	Vocative
transplantacijom	Instrumental
zastala	None
aramejskom	Instrumental
učvršćuje	None
stric	Nominative
dinom	Instrumental
evoluciju	Accusative
okaniš	None
pokušavale	None
strahovi	Vocative
dizan	None
kretenstvom	Instrumental
podoficire	Accusative
preferiraste	None
varkom	Instrumental
pandžu	Accusative
štȃkā	Genitive
atomskom	Instrumental
koagulacijom	Instrumental
bunom	Instrumental
flamanskom	Instrumental
nada	Genitive
armensku	Accusative
posla	None
osramoćujte	None
praga	Genitive
baštinu	Accusative
merah	None
tučkom	Instrumental
suverenitetom	Instrumental
opsesiju	Accusative
kremiraš	None
neurološkom	Instrumental
kočili	None
rubova	Genitive
apologiju	Accusative
prepirahu	None
zaduženo	None
rađale	None
metodologiji	Dative
titulom	Instrumental
infantilizam	Accusative
isijecaše	None
atletičar	Nominative
bebo	Vocative
zidano	None
nadoknadom	Instrumental
velikaš	Nominative
sužavale	None
razlomljen	None
sortu	Accusative
modernizaciju	Accusative
razlikovao	None
kriminološkom	Instrumental
privolele	None
linčujete	None
izložbom	Instrumental
sklonjene	None
odmetnike	Accusative
palestinskom	Instrumental
labirint	Accusative
đȁvō	Nominative
nagodim	None
zonom	Instrumental
tiskom	Instrumental
dotrčaše	None
ustanovu	Accusative
senfom	Instrumental
deponije	Accusative
rešili	None
burzu	Vocative
prokletstvom	Instrumental
porekli	None
razmenjeni	None
talila	None
imunitet	Accusative
patuljke	Accusative
unakaženi	None
karavan	Accusative
satiričkom	Instrumental
aluminija	Genitive
uklonjeno	None
tenisačem	Instrumental
unesi	None
žitom	Instrumental
vulkána	Genitive
urmo	Vocative
maloljetnike	Accusative
zastrašuju	None
proizvodnom	Instrumental
grinje	Dative
saharozom	Instrumental
jedri	None
zubom	Instrumental
smislila	None
komedijom	Instrumental
epitet	Accusative
okićeni	None
mitologiju	Accusative
negom	Instrumental
ćorsòkāk	Nominative
dopunjene	None
lepoto	Vocative
заштитни	Accusative
vrhovi	Essive
ogledalom	Instrumental
udružili	None
privredu	Accusative
tȉpkōm	Instrumental
nepogodniju	Accusative
opisom	Instrumental
gležnjem	Instrumental
самоук	Accusative
najbezobzirnijom	Instrumental
vrećom	Instrumental
vjeruje	None
ispletoše	None
irigacija	Nominative
obrađivana	None
reformom	Instrumental
hidrata	Genitive
razmenjena	None
prijateljicom	Instrumental
predvodila	None
suradnju	Accusative
nadograđivao	None
afirmiraju	None
vrate	Vocative
iskočila	None
oftalmologiju	Accusative
spisateljicom	Instrumental
svršetak	Accusative
nahranilo	None
beskonačnost	Accusative
revnost	Accusative
ženkom	Instrumental
plašt	Accusative
menopauza	Nominative
kočio	None
poljodjelstva	Genitive
elektromagnetnu	Accusative
pobeđivala	None
papu	Accusative
uvodili	None
ophodnom	Instrumental
dijeljeni	None
namero	Vocative
odsečen	None
šemom	Instrumental
dodelila	None
bakom	Instrumental
објеснији	Accusative
saudijskom	Instrumental
sveću	Accusative
оронуо	Accusative
prijestolonasljednikom	Instrumental
savršenstvom	Instrumental
inventivnost	Accusative
izazvani	None
seljačku	Accusative
sakràmenātā	Genitive
парни	Accusative
matematičarom	Instrumental
novake	Accusative
promotri	None
skandinavskom	Instrumental
preživeli	None
keltsku	Accusative
vegetacijskom	Instrumental
visi	None
barjaci	Vocative
vjeroispovijed	Accusative
турбулентни	Accusative
podnožjem	Instrumental
kompasom	Instrumental
banju	Accusative
postižemo	None
pouzdanjem	Instrumental
porotnikom	Instrumental
sramove	Accusative
marah	None
skupljeno	None
literaturu	Accusative
sapuna	Genitive
imunologije	Genitive
zagrijani	None
karantenu	Accusative
obnavljali	None
zarazo	Vocative
sredo	Vocative
demagogiju	Accusative
biskupom	Instrumental
družinu	Accusative
cjepivom	Instrumental
prijelomom	Instrumental
холандски	Accusative
sklopi	None
kružnu	Accusative
nabiti	None
vitalnost	Accusative
krivičnom	Instrumental
liderom	Instrumental
анималнији	Accusative
topiće	Accusative
nasrnuo	None
tragove	Accusative
platine	Genitive
trajniju	Accusative
nadvojvodu	Accusative
ciljem	Instrumental
sporednijom	Instrumental
viceve	Accusative
inflacijom	Instrumental
strelac	Nominative
analiziraj	None
falsifikator	Nominative
zasađene	None
obračunala	None
kvascem	Instrumental
dalmatskom	Instrumental
trigonometriju	Accusative
stisko	Vocative
pritvorom	Instrumental
legitimaciju	Accusative
ispostavilo	None
ekscesa	Genitive
krov	Accusative
krompir	Accusative
izjavom	Instrumental
jastuke	Accusative
par	Accusative
kresali	None
ambasadu	Accusative
sabljom	Instrumental
susjednu	Accusative
utvrdili	None
poništavajmo	None
neona	Genitive
uzletjela	None
pripremljena	None
odmakom	Instrumental
широкогрудан	Accusative
aceton	Accusative
lik	Accusative
feštu	Accusative
propuštao	None
omogućio	None
klipom	Instrumental
interakcijom	Instrumental
sef	Accusative
gigantom	Instrumental
razdeo	Accusative
prerezao	None
pristale	None
privrednom	Instrumental
življu	Accusative
tȉsutnjīk	Nominative
kožuna	Genitive
kozmografija	Nominative
asonancu	Accusative
protivnikom	Instrumental
rázvodnīk	Nominative
primijenjene	None
lesko	Vocative
obustavljena	None
citro	Vocative
čvrstoću	Accusative
ispuha	None
harana	None
svodovi	Vocative
бујни	Accusative
održah	None
kuk	Accusative
provalo	Vocative
pišče	Vocative
fonetsku	Accusative
антикни	Accusative
bombardirate	None
sitnico	Vocative
prasnulo	None
opomenu	Accusative
klizali	None
nagovorili	None
krletka	Nominative
zvezdu	Accusative
kurčeva	Genitive
krome	Vocative
tužbom	Instrumental
povij	None
receptom	Instrumental
panjeve	Accusative
guvernere	Accusative
pojačan	None
meridijana	Genitive
volumenom	Instrumental
prihvatimo	None
žepmi	Instrumental
žutokljúnci	Nominative
poslanik	Nominative
modom	Instrumental
novci	Vocative
dezorijentacija	Nominative
analfabetskom	Instrumental
lokal	Accusative
torpediraše	None
krotkiju	Accusative
skučen	None
narisala	None
економски	Accusative
hotel	Accusative
nobelovci	Vocative
sagoreva	None
uzgajale	None
smiluj	None
križ	Accusative
izbacila	None
koriste	None
pridodana	None
ponedeljkom	Instrumental
obrasca	Genitive
daktila	Genitive
zatvorom	Instrumental
hrame	Vocative
iščupa	None
kozmopolitizam	Accusative
safire	Accusative
povezivao	None
rječicu	Accusative
banalnost	Accusative
zaduživala	None
metaforu	Accusative
flegmo	Vocative
posjećeno	None
voda	Genitive
milostiom	Instrumental
obrtom	Instrumental
ruševnijom	Instrumental
školu	Accusative
ostvariš	None
pojednostavnjujte	None
poseduje	None
ambijentom	Instrumental
gomilu	Accusative
obradovasmo	None
materijala	Genitive
analitičare	Accusative
prosjakom	Instrumental
hljeba	Genitive
kurdsku	Accusative
popravljamo	None
tribali	None
motri	None
nalazom	Instrumental
reorganizaciju	Accusative
ustajem	None
otjerano	None
greše	Vocative
izbacio	None
seto	Vocative
opsežniju	Accusative
kajak	Accusative
predvodnikom	Instrumental
svijet	Accusative
poteze	Accusative
morale	None
poslugu	Accusative
napredovao	None
izostavljeno	None
ненамерни	Accusative
buka	Genitive
sedao	None
obrašče	Vocative
otjerali	None
muktáša	Genitive
najbistroumniju	Accusative
raspoređeni	None
vladom	Instrumental
sjeveroistočnom	Instrumental
zaklonjen	None
utanačeni	None
žȉvōst	Nominative
ve-ce	Accusative
krȉčavōst	Nominative
klipovi	Vocative
рано	Accusative
dodjeljivala	None
poznavao	None
tamošnju	Accusative
popularizaciju	Accusative
pohlepa	Nominative
rojevi	Vocative
udolinom	Instrumental
reparaciju	Accusative
popucaju	None
komplikacijom	Instrumental
analgeziju	Accusative
rukavicu	Accusative
smjesom	Instrumental
pričom	Instrumental
japanskom	Instrumental
ugrađivali	None
belaja	Genitive
medicina	Nominative
zavarava	None
olimpijsku	Accusative
but	Accusative
oftalmologija	Nominative
prezimenom	Instrumental
maloprodaju	Accusative
isključen	None
presađuje	None
rušio	None
uznemiri	None
egiptologe	Accusative
saksofonist	Nominative
brojnijom	Instrumental
djecu	Accusative
feudalci	Vocative
osovinom	Instrumental
podnijeli	None
gledate	None
prisiljene	None
cilindrom	Instrumental
негативни	Accusative
amortizaciju	Accusative
plansku	Accusative
benigniju	Accusative
napune	None
uspinji	None
fregatu	Accusative
lepezom	Instrumental
astronautika	Nominative
sodomiju	Accusative
dostavljam	None
ustupci	Vocative
isticala	None
crnačku	Accusative
sadrža	None
policijsku	Accusative
nevidljivost	Accusative
ionosfera	Nominative
prouzrokovalo	None
поступни	Accusative
dupèta	Nominative
anulirao	None
sklopove	Accusative
raznovrsnost	Accusative
zaostajala	None
najgadniju	Accusative
mišem	Instrumental
športom	Instrumental
laburist	Nominative
argentinskom	Instrumental
iskrcava	None
title	Vocative
zaustavljaše	None
ispliva	None
kihah	None
budi	None
iznjedrilo	None
zaštićuj	None
svetinom	Instrumental
postojećom	Instrumental
sjenku	Accusative
pomast	Accusative
progovore	None
oplođena	None
monetarnom	Instrumental
investirala	None
zaklonjene	None
најбучнији	Accusative
domovino	Vocative
најназаднији	Accusative
vatom	Instrumental
štafelaj	Accusative
nestaju	None
najverodostojniju	Accusative
mostova	Genitive
улазни	Accusative
optuživan	None
fiziologiju	Accusative
bubo	Vocative
retardiranijom	Instrumental
primoravao	None
crtali	None
dah	Accusative
dostojanstvom	Instrumental
potjerom	Instrumental
eparhijsku	Accusative
prijemom	Instrumental
izdržavaše	None
rasplakala	None
ispisane	None
obronke	Accusative
folklorom	Instrumental
šindrom	Instrumental
gledalaca	Genitive
tajfuna	Genitive
ograđen	None
najlukavijom	Instrumental
grupom	Instrumental
ljudstvom	Instrumental
renomea	Genitive
prigušuje	None
zloba	Nominative
probuđen	None
истоимен	Accusative
smaknuto	None
pomaknuti	None
predano	None
keramikom	Instrumental
aplikacijom	Instrumental
trudnoću	Accusative
temperàment	Nominative
kljunove	Accusative
prsnu	Accusative
čvora	Genitive
šetnjom	Instrumental
trapez	Accusative
norvešku	Accusative
bunare	Accusative
potkrijepljene	None
raspu	Accusative
analgetičku	Accusative
korelaciju	Accusative
kápī	Genitive
nadzirali	None
likvidira	None
globusom	Instrumental
krhkost	Accusative
svitke	Accusative
zečeve	Accusative
stanješe	None
barutom	Instrumental
suradnjom	Instrumental
afrikatom	Instrumental
oblizuju	None
gaz	Accusative
osamu	Accusative
vragolijom	Instrumental
kucao	None
jemensku	Accusative
gucnimo	None
osjeti	None
pridjevom	Instrumental
kajkavštinu	Accusative
rascijepljen	None
signalom	Instrumental
cunamijem	Instrumental
pokretačem	Instrumental
licem	Instrumental
kolonom	Instrumental
koaliciju	Accusative
lopto	Vocative
menjate	None
насљедни	Accusative
poreznik	Nominative
zauze	None
zlonamernike	Accusative
originala	Genitive
muškom	Instrumental
pileta	Genitive
kontaktira	None
veštinu	Accusative
sanki	Genitive
билабијалан	Accusative
bačena	None
vraćala	None
olovom	Instrumental
grmljavina	Nominative
magnetìzma	Genitive
istraživalo	None
obaveštajnom	Instrumental
saseci	None
išarajte	None
meštane	Accusative
mudarmudra	Accusative
juho	Vocative
elektronskom	Instrumental
eliksirom	Instrumental
govoren	None
poklopcem	Instrumental
plazi	None
ornitološku	Accusative
športove	Accusative
krin	Accusative
ispoviješću	Instrumental
celibáta	Genitive
pojačano	None
katoličkom	Instrumental
istražismo	None
vojskovođom	Instrumental
sprečile	None
trpeo	None
zamjenike	Accusative
obasjana	None
koridor	Accusative
štuju	None
poručnik	Nominative
samopouzdanjem	Instrumental
istočnjaci	Vocative
sljubljeni	None
poboljšanjem	Instrumental
krišku	Accusative
lenjinističku	Accusative
viziju	Accusative
oličavate	None
najdražu	Accusative
kretenìzāmā	Genitive
osmijehom	Instrumental
istraživačku	Accusative
postupaju	None
strujnikom	Instrumental
kromosoma	Genitive
vertikalnost	Accusative
predan	None
uskrati	None
plesačem	Instrumental
haškom	Instrumental
gasa	Genitive
molbu	Accusative
krivinu	Accusative
mikrobiologija	Nominative
onemoguće	None
bijesom	Instrumental
bunu	Accusative
kratkoćom	Instrumental
slojem	Instrumental
guščađu	Instrumental
prijepodnevom	Instrumental
pobunjenikom	Instrumental
papriku	Accusative
priušti	None
komorika	Nominative
ljubomora	Nominative
vozova	Genitive
pristupala	None
jek	Accusative
sekretarom	Instrumental
crtao	None
pristašom	Instrumental
izbijao	None
merioce	Accusative
islam	Accusative
umivaju	None
diktatom	Instrumental
najnečovječniju	Accusative
doneli	None
naslijedila	None
ekspresivnijom	Instrumental
najamnike	Accusative
широк	Accusative
kurvanjem	Instrumental
mušterijom	Instrumental
izradila	None
epohu	Accusative
zaokružen	None
članke	Accusative
palankom	Instrumental
najoštriju	Accusative
dublju	Accusative
mafijašem	Instrumental
zakonodavstava	Genitive
pornografiju	Accusative
свемогући	Accusative
porodico	Vocative
fjordovi	Vocative
galàntnōst	Nominative
meteorologijom	Instrumental
psihoanalize	Genitive
vlaknom	Instrumental
poljupcem	Instrumental
ciganiš	None
navodimo	None
plastičnost	Accusative
živciraste	None
državljana	Genitive
prepisano	None
zidaju	None
predgovorom	Instrumental
оперативни	Accusative
klobukom	Instrumental
svirače	Accusative
estuarijem	Instrumental
približi	None
ključeva	Dative
ispriča	None
zdravljem	Instrumental
sagrađena	None
чакавски	Accusative
sjevera	Genitive
suoči	None
naviknuste	None
maglom	Instrumental
људождерски	Accusative
tradiciju	Accusative
iskorenjivano	None
vitraj	Accusative
skepticizme	Vocative
latinsku	Accusative
skloništem	Instrumental
ugljenom	Instrumental
instalacijom	Instrumental
filtri	Vocative
zajedničku	Accusative
prete	None
vlastelinsku	Accusative
nomadskom	Instrumental
dimnjačar	Nominative
njuška	Nominative
odlamala	None
plenom	Instrumental
ivom	Instrumental
orasi	Vocative
semantikom	Instrumental
ugalj	Accusative
tigar	Nominative
djelatnike	Accusative
ugljik	Accusative
sobu	Accusative
najlepšom	Instrumental
utapao	None
malograđani	Vocative
namjeravala	None
štaba	Genitive
poletali	None
štićenicu	Accusative
pravče	Vocative
posao	Accusative
pijavicu	Accusative
sjedinjen	None
duljinom	Instrumental
pirogu	Accusative
povraćaju	None
glavatiju	Accusative
jarci	Vocative
glib	Accusative
proučeni	None
zaradom	Instrumental
vitezove	Accusative
pretpostavljeni	None
ekranom	Instrumental
omiškom	Instrumental
patrona	Genitive
zidára	Genitive
zapovjednikom	Instrumental
laćam	None
otpuštan	None
sjeveroistoka	Genitive
dovikne	None
isele	None
kristologije	Genitive
беспомоћнији	Accusative
spisi	Vocative
izumljen	None
relevantnost	Accusative
soj	Accusative
rešeno	None
baćo	Vocative
suživota	Genitive
vrčeva	Genitive
kritičkom	Instrumental
pupka	Genitive
pristupalo	None
korom	Instrumental
màfījā	Genitive
punila	None
lonce	Accusative
iskače	None
vlastela	Nominative
prorokom	Instrumental
snimali	None
pregradim	None
plavetnilom	Instrumental
padom	Instrumental
plaši	None
skočila	None
nadgleda	None
trenirana	None
skraćenicom	Instrumental
pokrajinom	Instrumental
nagovarala	None
dobrodošlicu	Accusative
dostojanstava	Genitive
britansku	Accusative
alatom	Instrumental
sudskom	Instrumental
odbacivalo	None
beto	Vocative
vjerom	Instrumental
branilo	None
poveo	None
podižem	None
klanac	Accusative
uhvatila	None
zanemari	None
mapo	Vocative
miren	None
praše	Vocative
antisemitizam	Accusative
podržavao	None
šlȕs	Nominative
pravnicom	Instrumental
suzdržao	None
petlju	Accusative
varijaciju	Accusative
centara	Genitive
zamiči	None
slepac	Nominative
sačinjavah	None
pastu	Accusative
proračunom	Instrumental
најсмеонији	Accusative
glasale	None
proslavljene	None
paljbu	Accusative
omotač	Accusative
semantičku	Accusative
uvežbane	None
zvučnikom	Instrumental
sinkretizam	Accusative
briše	None
salon	Accusative
kružnicom	Instrumental
кључни	Accusative
kocku	Accusative
берлински	Accusative
kuhano	None
istražitelj	Nominative
fizikom	Instrumental
osječkom	Instrumental
jagodu	Accusative
čuvare	Accusative
progonjen	None
paranoikom	Instrumental
smatrali	None
fajl	Accusative
zabavili	None
sakupljalo	None
sibirsku	Accusative
hronološkom	Instrumental
bogalj	Nominative
nedjeljom	Instrumental
udarom	Instrumental
jedinicom	Instrumental
preporučivali	None
investiraju	None
gigametrom	Instrumental
nekrozu	Accusative
bacakano	None
prelaska	Genitive
užitak	Accusative
sadist	Nominative
црначки	Accusative
trotoara	Genitive
debljinu	Accusative
zabeleška	Nominative
šačicu	Accusative
obrađivao	None
најисточнији	Accusative
sjevernjaka	Genitive
platinu	Accusative
plena	Genitive
uvjerio	None
željeznicom	Instrumental
natrij	Accusative
mešala	None
животињски	Accusative
razredom	Instrumental
ponašale	None
бројни	Accusative
bùva	Nominative
pitu	Accusative
opasnošću	Instrumental
rakunom	Instrumental
nastavile	None
ratarsku	Accusative
rukometašem	Instrumental
neutrona	Genitive
odjeknule	None
demantije	Accusative
званичан	Accusative
kristalografije	Genitive
ustani	None
sankciju	Accusative
trijemova	Genitive
hidrauličku	Accusative
pohlepe	Genitive
akumulirala	None
poštedu	Accusative
raseljena	None
baziralo	None
ublažila	None
ribare	Accusative
širen	None
brutalnost	Accusative
ulagujem	None
smiruju	None
odlomke	Accusative
delovanjem	Instrumental
контрастивни	Accusative
cijenu	Accusative
hemofilija	Nominative
onemogućavala	None
neimaštine	Genitive
najhrabriju	Accusative
ulovljen	None
pokretali	None
sifilisa	Genitive
namenjena	None
šimširom	Instrumental
količnik	Accusative
bujaj	None
hipotenuzom	Instrumental
prednošću	Instrumental
dijelove	Accusative
radioaktivnost	Accusative
detetom	Instrumental
zdravstvenom	Instrumental
pragove	Accusative
balon	Accusative
slatino	Vocative
posvetom	Instrumental
patricijem	Instrumental
utrkom	Instrumental
razboj	Accusative
psihologiju	Accusative
petu	Accusative
probili	None
резултатски	Accusative
žapci	Vocative
zamkom	Instrumental
krpicu	Accusative
procijeniše	None
policiju	Accusative
kreatoricu	Accusative
tekstovi	Vocative
odluku	Accusative
tamilskom	Instrumental
spomenula	None
konstruktivnost	Accusative
utješiše	None
ikavicom	Instrumental
iskaza	None
kvaku	Accusative
priznato	None
zoolog	Nominative
pripisali	None
знаменитији	Accusative
руски	Accusative
alotropi	Vocative
mirovinu	Accusative
kozlaca	Genitive
najobičnijom	Instrumental
smokvíci	Nominative
razinu	Accusative
odlomkom	Instrumental
frajer	Nominative
nivoi	Vocative
pitamo	None
vođom	Instrumental
pastorka	Accusative
tečajem	Instrumental
rashlade	None
podešava	None
crkvenoslovenskom	Instrumental
tisuću	Accusative
ljevičar	Nominative
putanju	Accusative
prijame	Accusative
kakaovce	Accusative
naoružanjem	Instrumental
sjaja	Genitive
cevovodom	Instrumental
afričkom	Instrumental
plaću	Accusative
nostalgijom	Instrumental
lutka	Nominative
kapelicom	Instrumental
slivove	Accusative
petkom	Instrumental
špilju	Accusative
ubrizgan	None
neuralgije	Genitive
plesače	Accusative
radiologiju	Accusative
izvedbu	Accusative
povorku	Accusative
trupa	Genitive
žestine	Genitive
ledac	Accusative
стечајни	Accusative
standardizacijom	Instrumental
savetnike	Accusative
ispričavam	None
izvadite	None
specijalizirali	None
hotelskom	Instrumental
čakavcem	Instrumental
uklinju	None
ljepotu	Accusative
upiše	None
sahranilo	None
brusa	Genitive
šinter	Nominative
razbije	None
podvodiš	None
obučavaju	None
uklinjalo	None
pauzu	Accusative
završila	None
kopilađu	Instrumental
sestrić	Nominative
moćniju	Accusative
luksemburšku	Accusative
prestonicu	Accusative
plasirali	None
odstupala	None
sodu	Accusative
raspodelu	Accusative
nulu	Accusative
žezlom	Instrumental
stvoren	None
obrazlaže	None
isplovi	None
nagrađeno	None
mongolskom	Instrumental
improvizator	Nominative
otputovaše	None
odgrizeš	None
antitezu	Accusative
simpatiju	Accusative
brani	None
alpinizma	Genitive
еванђеоски	Accusative
poduhvatom	Instrumental
najpogubniju	Accusative
administrativkom	Instrumental
biofiziku	Accusative
zelenilom	Instrumental
potragom	Instrumental
mezopotamsku	Accusative
taksijem	Instrumental
opredelio	None
radiološku	Accusative
nasleđem	Instrumental
sponu	Accusative
zloupotrebljavao	None
brojniju	Accusative
sudsku	Accusative
magarce	Accusative
pozdravim	None
uzorak	Accusative
semitsku	Accusative
prijateljico	Vocative
izostavljana	None
kriticizma	Genitive
pomladak	Nominative
ožiljkom	Instrumental
ometalo	None
krajišku	Accusative
izabiran	None
pažnju	Accusative
sirutka	Nominative
činiocem	Instrumental
učvrstilo	None
skokove	Accusative
блажи	Accusative
probijao	None
punoglavaca	Genitive
pomorce	Accusative
usredotočila	None
zbrojeva	Genitive
prevoza	Genitive
takte	Vocative
hljeb	Accusative
najtješnju	Accusative
zatvaran	None
изобилан	Accusative
trudimo	None
podržavale	None
kartografije	Genitive
saveznike	Accusative
brodogradnje	Genitive
korozijom	Instrumental
pesmom	Instrumental
učvršćivao	None
štima	None
likvidirali	None
slobodom	Instrumental
upio	None
zavoje	Accusative
pratnjom	Instrumental
istera	None
ponudom	Instrumental
trojicom	Instrumental
golùždrāvče	Vocative
odoru	Accusative
plima	Nominative
uočavaste	None
odeljivaše	None
управни	Accusative
računarom	Instrumental
štanda	Genitive
rižu	Accusative
ocenjena	None
regiju	Accusative
vilicom	Instrumental
mrakom	Instrumental
razočarana	None
reviziju	Accusative
skakavce	Accusative
кинески	Accusative
trpeli	None
putom	Instrumental
pojednostavljeno	None
prestiže	Accusative
stave	Vocative
labud	Nominative
postavilo	None
најбогатији	Accusative
pregovarala	None
kristalizirane	None
mangupa	Accusative
feminističku	Accusative
pustinjskom	Instrumental
štȅka	Nominative
krnjeci	Vocative
zamrznulo	None
entuzijazmom	Instrumental
nizinom	Instrumental
testosteróna	Genitive
osiromašena	None
plovidbu	Accusative
barakudo	Vocative
sifilisom	Instrumental
mlin	Accusative
popratnu	Accusative
dozu	Accusative
suživotom	Instrumental
grabe	Vocative
saobraćaja	Genitive
meteoriti	Vocative
antimaterijo	Vocative
asteroidom	Instrumental
gate	Vocative
primedbom	Instrumental
povijest	Accusative
umela	None
iskorištena	None
rečnik	Accusative
mandatom	Instrumental
nadziru	None
držao	None
izdao	None
pratnju	Accusative
razljutih	None
rùpija	Nominative
stvoritelj	Nominative
ideologe	Accusative
orkan	Accusative
cirkulaciju	Accusative
oštete	None
spazili	None
talasnu	Accusative
dlanove	Accusative
propašću	Instrumental
plug	Accusative
jauci	Vocative
ambicijom	Instrumental
pripovedilo	None
pravovernost	Accusative
oseti	None
dočara	None
historičarom	Instrumental
pobijen	None
spojem	Instrumental
aluminijem	Instrumental
primljeno	None
brezo	Vocative
trticu	Accusative
šaša	Genitive
iskradoše	None
brojače	Accusative
hitlerovsku	Accusative
pravce	Accusative
nagrađeni	None
erotsku	Accusative
progonili	None
audiolože	Vocative
ukrao	None
spasenjem	Instrumental
proslavim	None
независнији	Accusative
amnestiju	Accusative
najranijom	Instrumental
turist	Nominative
redovnike	Accusative
direktorije	Accusative
vježbu	Accusative
krilaticom	Instrumental
најапсурднији	Accusative
obeščašćujte	None
pedagogiju	Accusative
odžaka	Genitive
dračeva	Genitive
činim	None
racionalističku	Accusative
najplastičniju	Accusative
identificira	None
žarkom	Instrumental
apsolvirala	None
prokleta	None
zenicu	Accusative
zapovednikom	Instrumental
vlaka	Genitive
bovo	Vocative
izdanjem	Instrumental
odseklo	None
stotinku	Accusative
obrazovnu	Accusative
egzorcìzma	Genitive
oslobodili	None
certifikata	Genitive
poštuje	None
opljačkaste	None
posrami	None
konjak	Accusative
zaključka	Genitive
terakote	Genitive
obaveštavamo	None
ptȋcā	Genitive
salamandra	Genitive
rezonàntnōst	Nominative
oblikovale	None
vjerojatnost	Accusative
morfizma	Genitive
popratnom	Instrumental
sposobnošću	Instrumental
свршени	Accusative
ždrijebom	Instrumental
zamjerena	None
zgusnuti	None
stalešku	Accusative
susretah	None
ravnali	None
prognao	None
morfologiju	Accusative
shvatili	None
obesio	None
prijavila	None
protunapadom	Instrumental
etanolom	Instrumental
aktivniju	Accusative
zapreminu	Accusative
košarkašicom	Instrumental
fonetičarem	Instrumental
brazdu	Accusative
vrtlar	Nominative
akceptorom	Instrumental
zidove	Accusative
ratnikom	Instrumental
ledenjak	Accusative
smiješ	None
narkozom	Instrumental
promašim	None
tiranijom	Instrumental
mòdēm	Nominative
anodnom	Instrumental
obnovu	Accusative
opirale	None
ksenofobije	Genitive
eparhijskom	Instrumental
moda	Nominative
egipatskom	Instrumental
crvom	Instrumental
otkopao	None
obećavala	None
kasabu	Accusative
periku	Accusative
naplatom	Instrumental
sabirnicu	Accusative
kompliciralo	None
primjedbu	Accusative
rta	Genitive
karton	Accusative
duplikata	Genitive
oduzeli	None
sukobom	Instrumental
razvodnim	None
redosledom	Instrumental
hijeno	Vocative
туристички	Accusative
imobilizaciju	Accusative
simulirali	None
kompònenātā	Genitive
baleta	Genitive
kultovi	Vocative
krèvet	Nominative
zaplašen	None
poslovotkinjom	Instrumental
iluzionist	Nominative
opasano	None
bestselerom	Instrumental
bistroumnijom	Instrumental
razrađivaste	None
liječen	None
pristizale	None
meteorite	Accusative
raspala	None
хебрејски	Accusative
uvere	None
jugom	Instrumental
konjaci	Vocative
plèće	Nominative
poljoprivredu	Accusative
sanacijom	Instrumental
taštinu	Accusative
pobijeđena	None
kovčega	Genitive
odavalo	None
barjakom	Instrumental
autoportreta	Genitive
čamdžija	Genitive
preokrenuo	None
obrađivan	None
pacijent	Nominative
најнастранији	Accusative
gnajs	Accusative
dušika	Genitive
predvodili	None
početo	None
ùhode	Nominative
evrom	Instrumental
karaktere	Accusative
saopćila	None
gravitaciju	Accusative
aklamacijom	Instrumental
bačku	Accusative
ritmičku	Accusative
automatskom	Instrumental
oplodnju	Accusative
trpezarijom	Instrumental
tegljača	Genitive
kilo	Vocative
fluidom	Instrumental
pobjeđivala	None
vekove	Accusative
rješavalo	None
uvučeno	None
brȉgōm	Instrumental
paleontologijom	Instrumental
fudbalerom	Instrumental
modelira	None
zadovoljio	None
posustajete	None
дечји	Accusative
razvijan	None
punktova	Genitive
položilo	None
hebrejskom	Instrumental
pobeđuju	None
paviljona	Genitive
averziju	Accusative
čitana	None
maticu	Accusative
dubrovačku	Accusative
jedinicu	Accusative
nastoje	None
metalurgijom	Instrumental
plaćom	Instrumental
povratnik	Nominative
prepoznavano	None
lađu	Accusative
preštampan	None
predstavlja	None
irigaciju	Accusative
vladarsku	Accusative
autostopom	Instrumental
balističkom	Instrumental
najapolitičniju	Accusative
neznanja	Genitive
dopustile	None
mandarinskom	Instrumental
hlape	None
menjača	Genitive
jakost	Accusative
nadenuli	None
britvu	Accusative
carsku	Accusative
železničku	Accusative
народни	Accusative
најнепосреднији	Accusative
vršimo	None
upozorava	None
сезонски	Accusative
staklenike	Accusative
posjedovale	None
propovijedaju	None
bačva	Nominative
rumelijskom	Instrumental
pozdravio	None
ugušilo	None
obrambenom	Instrumental
časnikom	Instrumental
naslednike	Accusative
preračunato	None
odbijani	None
vragova	Genitive
najmekanijom	Instrumental
čajeve	Accusative
polovicom	Instrumental
okrenuše	None
veslala	None
uspevah	None
termodinamikom	Instrumental
значајнији	Accusative
razuzdanost	Accusative
mùktāš	Nominative
kolevkom	Instrumental
dezerter	Accusative
zapadom	Instrumental
uzdahom	Instrumental
kreću	None
diraj	None
bezvremensku	Accusative
sjevernokorejskom	Instrumental
levicom	Instrumental
najsložnijom	Instrumental
zloduh	Nominative
pȍsta	Genitive
razočarala	None
budžetom	Instrumental
tursku	Accusative
protestom	Instrumental
skrivale	None
praska	None
dugovao	None
досјетљиви	Accusative
preporode	Vocative
muhu	Accusative
obećao	None
cede	None
istrago	Vocative
podijele	None
pokrali	None
provjerom	Instrumental
doživljajem	Instrumental
kljunom	Instrumental
pobeđivali	None
promijeniše	None
sumnjivce	Accusative
diler	Nominative
svàdljīvca	Genitive
raskinule	None
iscjetka	Genitive
pojavom	Instrumental
spektara	Genitive
naselilo	None
pelikani	Vocative
izračunata	None
zečić	Nominative
kinesku	Accusative
zaštitnike	Accusative
razljutili	None
tušem	Instrumental
tribala	None
kuplere	Accusative
zauzda	None
zastrašismo	None
trezora	Genitive
trenjem	Instrumental
injekcijom	Instrumental
operatorom	Instrumental
спекулативнији	Accusative
antagonìzma	Genitive
konstrukciju	Accusative
žbunja	Genitive
veselicu	Accusative
pregledom	Instrumental
smaknućem	Instrumental
omogućavala	None
razišli	None
незамећен	Accusative
kulta	Genitive
izrekao	None
završnom	Instrumental
šiptar	Nominative
svjedokinju	Accusative
gubicu	Accusative
došle	None
viđala	None
trnove	Accusative
nasleđen	None
zamerali	None
rupu	Accusative
ministarstvom	Instrumental
fudbala	Genitive
lingvistiku	Accusative
ponudite	None
opaskom	Instrumental
hemijom	Instrumental
jastukom	Instrumental
virom	Instrumental
tvornicom	Instrumental
trutove	Accusative
pojedena	None
banalizirasmo	None
snošaje	Accusative
mleka	Genitive
rukometnom	Instrumental
једнобојан	Accusative
nožica	Genitive
vodovodom	Instrumental
obukom	Instrumental
kapituliraš	None
sociologiju	Accusative
okruživale	None
palicom	Instrumental
vrh	Vocative
bratić	Nominative
nesuvislost	Accusative
šum	Accusative
izdržale	None
izmetom	Instrumental
brežuljke	Accusative
presekosmo	None
zabijao	None
protivnik	Nominative
pelivan	Nominative
postojim	None
australsku	Accusative
decembarskom	Instrumental
vriska	Nominative
rarìtēt	Nominative
svjetiljkom	Instrumental
beležaka	Genitive
tekstopiscem	Instrumental
zapošljavalo	None
eroziju	Accusative
ključeve	Vocative
материјални	Accusative
repertoar	Accusative
zatvaraju	None
nazivali	None
arheologom	Instrumental
sjećali	None
otiska	Genitive
pristupila	None
arogancijom	Instrumental
dostavom	Instrumental
čagalj	Nominative
ploda	Genitive
isključena	None
bujnost	Accusative
antropološkom	Instrumental
prestižnu	Accusative
udavan	None
ortografiju	Accusative
razmotrila	None
pretvorilo	None
najmutniju	Accusative
raspisivasmo	None
srame	Vocative
osvajáčā	Genitive
belája	Genitive
najljubopitljiviju	Accusative
berlinskom	Instrumental
moć	Accusative
sastavljane	None
rudinu	Accusative
cionizam	Accusative
presuđuje	None
kolektivizam	Accusative
likera	Genitive
stisnuo	None
dojku	Accusative
odaste	None
počnimo	None
acetona	Genitive
sintagmom	Instrumental
umoren	None
inča	Genitive
zabranu	Accusative
presretnu	None
fisiju	Accusative
arhiv	Accusative
tvrdnju	Accusative
otpisani	None
prognaju	None
otuđila	None
destinacijom	Instrumental
predočivan	None
štabove	Accusative
posećuješ	None
antimaterije	Genitive
jova	Nominative
odvismo	None
automehaničar	Nominative
lovca	Accusative
cvetova	Genitive
kozake	Accusative
kacigu	Accusative
pucnjavu	Accusative
muslimanskom	Instrumental
narednu	Accusative
aristokrat	Nominative
kutovi	Vocative
драги	Accusative
golman	Nominative
romantičar	Nominative
osvajačkom	Instrumental
udahnulo	None
kenjam	None
desetlećem	Instrumental
istražene	None
vijȇk	Nominative
albanskom	Instrumental
raspali	None
admiralitet	Accusative
reprezentativce	Accusative
podatci	Vocative
obad	Nominative
prepreku	Accusative
pȍbočnīcī	Nominative
pacifizam	Accusative
novozelandsku	Accusative
shemom	Instrumental
temperamenta	Genitive
spreja	Genitive
pekinškom	Instrumental
kremaciju	Accusative
najuspješnijom	Instrumental
putničkom	Instrumental
pronašle	None
obučili	None
nekropolu	Accusative
novorođenčađu	Instrumental
aspirinom	Instrumental
nevjestu	Accusative
umjetničkom	Instrumental
sabotirao	None
свесрдан	Accusative
vraćana	None
литвански	Accusative
pustinju	Accusative
elektrolita	Genitive
ноћни	Accusative
labavljene	None
sređivao	None
почетни	Accusative
inflaciju	Accusative
razdvojena	None
rezistencije	Genitive
отрован	Accusative
odvjetničkom	Instrumental
srednjovekovnu	Accusative
bijega	Genitive
најприхватљивији	Accusative
ispravio	None
članci	Vocative
nihilist	Nominative
stampede	Accusative
poretkom	Instrumental
ismejana	None
pozira	None
procenjena	None
oivičen	None
nadopunjava	None
anđelkom	Instrumental
čȋstkā	Genitive
uzimam	None
најсуманутији	Accusative
šašaviju	Accusative
filozof	Nominative
stanjem	Instrumental
batinani	None
sablju	Accusative
dijagnozo	Vocative
istom	Instrumental
gonoreja	Nominative
napustiše	None
budio	None
beloruskom	Instrumental
prala	None
zaštitu	Accusative
prepadajmo	None
izašli	None
taste	Vocative
izabiru	None
obešen	None
pobunjenik	Nominative
brijesta	Genitive
ubrzalo	None
slapova	Genitive
aparata	Genitive
suđeno	None
sudbinom	Instrumental
stvarano	None
obrijani	None
prikuplja	None
òdredāba	Genitive
raspadale	None
preskočeni	None
vjenčala	None
svirajte	None
albuma	Genitive
napišemo	None
sprečavale	None
pekinšku	Accusative
klone	Vocative
dolarom	Instrumental
komadićem	Instrumental
pripomenula	None
ulazila	None
mišar	Nominative
uništen	None
áda	Genitive
prepoznao	None
lipo	Vocative
potrudiš	None
čuna	Genitive
dvanaestoricu	Accusative
zidnu	Accusative
ejakulacijom	Instrumental
uočimo	None
bluda	Genitive
almanasi	Vocative
цијењен	Accusative
muzu	Accusative
štenad	Accusative
lakonsku	Accusative
ispuštene	None
najsilovitiju	Accusative
kalk	Accusative
garantirao	None
vetra	Genitive
razlikuju	None
zaposlenikom	Instrumental
češljugar	Nominative
sastajale	None
kompanijom	Instrumental
izgovarano	None
barabu	Accusative
kost	Accusative
kranjskom	Instrumental
apanažu	Accusative
dano	None
pokidane	None
врани	Accusative
brak	Accusative
astrofizičar	Nominative
iduću	Accusative
pružaju	None
obuhvaćeni	None
tonaža	Nominative
nazivaju	None
desetinu	Accusative
stratešku	Accusative
neizlječivost	Accusative
učiše	None
nabore	Accusative
најмуљевитији	Accusative
bukne	None
bratoubojicom	Instrumental
ponudu	Accusative
bezobzirnost	Accusative
podrazumevano	None
čeznu	None
skrenula	None
đavoljom	Instrumental
vizu	Accusative
konventa	Genitive
pljuskova	Genitive
srpanjsku	Accusative
doseljenike	Accusative
versajskom	Instrumental
univerzitetom	Instrumental
ugrabe	None
testova	Genitive
simbolom	Instrumental
pripremani	None
napadom	Instrumental
intuicije	Genitive
prisnost	Accusative
snagom	Instrumental
doživjela	None
prijevodom	Instrumental
atlantsku	Accusative
pesnikinjom	Instrumental
izgnanstvom	Instrumental
царичин	Accusative
interakciju	Accusative
pogledajmo	None
krstom	Instrumental
dodeljen	None
jȗrta	Nominative
iznudu	Accusative
ljubiš	None
prođem	None
skrenuo	None
iskopalo	None
trodnevnu	Accusative
najuravnoteženijom	Instrumental
najsumanutiju	Accusative
vešerku	Accusative
uništili	None
traheju	Accusative
popraćen	None
upotrijebljeno	None
izbušeno	None
јапански	Accusative
akumulacijo	Vocative
људски	Accusative
pritiskao	None
roštilj	Accusative
хуђи	Accusative
odmaknute	None
šokira	None
sustajete	None
aromu	Accusative
toponimsku	Accusative
velegradova	Genitive
kale	Accusative
trilerom	Instrumental
najmoćniju	Accusative
jordansku	Accusative
urađene	None
trnova	Genitive
prȅtorijānče	Vocative
skidali	None
luko	Vocative
učionicom	Instrumental
oslonci	Vocative
vjerena	None
brojača	Genitive
bukovinu	Accusative
rodovi	Vocative
etiologijom	Instrumental
jajetom	Instrumental
simetrijo	Vocative
viška	Genitive
limuzinu	Accusative
bučao	None
ampere	Accusative
intervjuom	Instrumental
teoretskom	Instrumental
kidali	None
nobelovka	Nominative
svrȁka	Nominative
vješticom	Instrumental
softvera	Genitive
sivče	Vocative
članstvom	Instrumental
nadoknadu	Accusative
polubraću	Accusative
psihičku	Accusative
