albinoasele	sănătoasele	lemma
răciserăți	răcisem	Person
învinșilor	învinsului	Gender
plicticos	plicticoase	Gender
sătuilor	sătulul	Gender
secundarul	secundara	Gender
recunoștință	recunoștințelor	Number
lungii	electromagneticei	lemma
completei	compleții	Gender
îndemnași	îndemnarăți	Person
extragem	extrag	Person
îndobitocea	îndobitoceați	Person
creștina	creștinilor	Gender
haleați	halea	Person
tovărășească	tovărășesc	Gender
onomatopeice	exterioare	lemma
biochimic	biochimică	Gender
întrețineți	întreții	Person
colaborator	colaboratoare	Gender
insidios	insidioasă	Gender
omogenă	omogeni	Gender
senin	senine	Gender
sfârșiseră	făuriseră	lemma
învecinează	învecinez	Person
istoricul	istoricilor	Gender
invizibilă	invizibili	Gender
activa	activați	Person
prelungeau	prelungea	Number
ponegriți	ponegrește	Person
citește	citesc	Person
mlaștină	mlaștinilor	Number
prăjită	creștinească	lemma
tinseră	arseră	lemma
clinică	clinicilor	Number
ascultaserăți	ascultasem	Person
ocroti	făli	lemma
reținem	rețin	Person
înghiți	înghit	Person
mărinimoșilor	mărinimosului	Gender
parazitare	tranzitive	lemma
amical	amicală	Gender
nădăjduiseră	nădăjduiserăm	Person
economică	economic	Gender
lipite	lipit	Gender
indiferenții	indiferenta	Gender
juisase	juisaseră	Number
integral	integrali	Gender
primul	primii	Gender
mișcați	mișcau	Person
vânăt	vineți	Gender
afidă	afidelor	Number
maghiarii	maghiarul	Gender
interesantul	interesanților	Gender
mutație	mutațiilor	Number
micșorasem	micșoraserăți	Person
uscat	uscați	Gender
desculț	desculți	Gender
scrimerii	bazilica	lemma
haitienii	haitianul	Gender
împăunăm	împăunează	Person
căscarăm	căscai	Person
rare	friguroase	lemma
dezamăgitului	dezamăgita	Gender
mucoasă	mucos	Gender
cronic	cronici	Gender
obținuseră	obținuserăm	Person
încercaseră	încercase	Person
înjurați	înjura	Person
veștejesc	veștejește	Person
olandezilor	dubli	lemma
alotropic	alotropici	Gender
liliecii	gramatica	lemma
înviorează	înviorăm	Person
gravitate	caviar	lemma
dumnezeieștilor	dumnezeieștii	Gender
subțirelui	subțirea	Gender
prăjiți	prăjește	Person
bat	bate	Person
nivelaserăți	nivelase	Person
colaboratorul	colaboratoarea	Gender
macabrii	macabrei	Gender
plăceai	plăceați	Number
descinseseră	descinsesem	Person
intempestiv	intempestivă	Gender
enorma	enormilor	Gender
zemos	zemoase	Gender
folositoare	folositor	Gender
lâncedei	lâncedul	Gender
isteți	dungați	lemma
solar	solari	Gender
plata	platului	Gender
roșiilor	roșului	Gender
puținului	fluvialului	lemma
viul	viilor	Gender
încălzesc	încălzești	Person
prăjite	stupide	lemma
țestoasă	țestos	Gender
chei	chel	Gender
adaugă	îngrașă	lemma
goliți	golește	Person
răceai	răceam	Person
afidelor	detaliilor	lemma
delicatului	delicata	Gender
ruptei	ruptului	Gender
arătau	arăta	Person
insidios	insidioase	Gender
umple	umpli	Person
iraționalul	iraționalii	Gender
deprinsei	deprinseră	Person
insultați	excitați	lemma
emoționalul	emoționala	Gender
plin	plini	Gender
vârtoasă	vârtos	Gender
cărnosul	cărnoșii	Gender
structurală	structural	Gender
compuseserăți	compusese	Person
conjugase	conjugasem	Person
specific	specifică	Gender
despuneți	despune	Person
școlari	școlare	Gender
adeveresc	adeverim	Number
capitaliste	capitaliști	Gender
leneșului	leneșilor	Gender
păcătuiserăți	bârfiserăți	lemma
păsărească	conformitate	lemma
poștal	binefăcător	lemma
ieși	ieșiți	Number
amarilor	amara	Gender
australianul	australianule	Gender
beatului	beții	Gender
majorat	deism	lemma
vizitează	vizitezi	Person
plicticoasa	plicticosul	Gender
șchiopului	șchiopilor	Gender
înfumuram	înfumurai	Person
tresăreau	tresărea	Person
polari	polare	Gender
blondul	blonzilor	Gender
atingi	atingem	Person
putuseră	putusem	Person
găoază	găoazelor	Number
dator	datori	Gender
destramă	destramară	Person
răgușiseși	răgușiserăm	Person
adunaserăți	curățaserăți	lemma
completează	completăm	Person
pierduserăm	încălțaserăm	lemma
inesteticilor	inestetica	Gender
mândră	mândri	Gender
intrasem	intraseși	Person
zgăuraserăm	zgăurasem	Number
interesantei	interesanții	Gender
lăsăm	las	Person
lucios	lucioase	Gender
componentă	componentelor	Number
săturase	săturaserăți	Person
filamentos	filamentoasă	Gender
agățate	fumurii	lemma
gălbuilor	gălbuia	Gender
distrugeați	distrugeai	Person
urcau	urcam	Person
jos	joase	Gender
încălaserăți	încălaseși	Person
îmbogățisem	îmbogățiseși	Person
căpătau	căpăta	Number
secundare	secundar	Gender
exterioara	exteriorii	Gender
continentală	continental	Gender
calde	cald	Gender
expediară	expedie	Person
voioasă	voioși	Gender
vidră	vidrelor	Number
fumuriul	fumuriii	Gender
zârnă	zârnelor	Number
iluzorii	iluzoriu	Gender
dependenți	dependentă	Gender
meritași	meritarăți	Person
sângeroșilor	sângeroasa	Gender
deprimată	deprimați	Gender
singuri	singure	Gender
oficialul	oficialei	Gender
abile	abili	Gender
vindecați	zdrobiți	lemma
hrăneau	hrănea	Number
transformam	explicam	lemma
beleam	beleau	Person
șchiopătam	șchiopăta	Person
adoptă	adoptați	Person
vaccinarăm	vaccinară	Person
soporificei	soporificilor	Gender
literatură	literaturilor	Number
înmulțiserăți	înmulțisem	Person
abililor	abilul	Gender
lămuresc	învechesc	lemma
viul	viei	Gender
indiferente	fierte	lemma
negaseși	negaserăți	Person
cuviosului	cuvioșii	Gender
împăturești	împăturiți	Person
foioșilor	foioasa	Gender
fericitei	fericitul	Gender
susținuse	susținuseră	Person
tandrei	tandrilor	Gender
pădure	pădurilor	Number
cuviosului	cuvioșilor	Gender
extind	extindem	Person
concentrate	concentrați	Gender
închidem	închideți	Person
sporește	sporiți	Person
udat	distrat	lemma
lăsate	amestecate	lemma
amăgește	amăgesc	Person
pragurilor	șoaptelor	lemma
aprinde	aprind	Number
structuralii	structuralul	Gender
terminație	terminațiilor	Number
harbuzule	harbujilor	Number
imposibilului	cehului	lemma
mistreții	mistrețului	Gender
țipă	țip	Person
grase	gras	Gender
gravitași	gravitarăm	Person
greu	grei	Gender
înfrunzise	înfrunziseră	Person
naștere	nașterilor	Number
mișcătoare	zgomotoase	lemma
muntoșii	muntosul	Gender
aerisise	aerisiseră	Number
scuipăm	scuipă	Person
judecată	judecat	Gender
forțaserăți	forțase	Person
râvniseră	râvniserăm	Person
pregătiși	împuțiși	lemma
înfunzi	înfundăm	Person
jignești	jignește	Person
slovenule	slovenilor	Gender
obligau	cutezau	lemma
junghiase	junghiaseși	Person
blondă	blonzi	Gender
structurat	structurată	Gender
opărite	opăriți	Gender
înnodași	înnodară	Person
spinoase	spinos	Gender
ironic	convențional	lemma
făuresc	făurim	Person
spirituală	spirituali	Gender
alergam	alergați	Person
albei	albul	Gender
necinstită	necinstit	Gender
pișaseră	declaraseră	lemma
tâmpitului	tâmpiților	Gender
stâng	stângi	Gender
nauruanilor	nauruanei	Gender
lichide	lichizi	Gender
masculinilor	masculinului	Gender
elimin	elimini	Person
spitalelor	înotătoarelor	lemma
zgomotos	zgomotoasă	Gender
jenase	jenaseră	Person
reparabile	cosmice	lemma
minereurilor	felurilor	lemma
unghie	unghiilor	Number
arhipelagule	arhipelagurilor	Number
acuzam	desmățam	lemma
arși	arsă	Gender
inseparabile	inseparabil	Gender
contagioasă	contagios	Gender
agățaților	agățatul	Gender
filantropicilor	filantropica	Gender
vindecaserăți	vindecasem	Person
legendară	legendar	Gender
plicule	plicurilor	Number
controlaseră	controlase	Person
toxice	toxic	Gender
înfulecă	înfulecăm	Person
franțuzească	franțuzești	Gender
uneau	depănau	lemma
refuză	refuzi	Person
pavai	pava	Person
plinii	plinului	Gender
ușuraticei	ușuraticului	Gender
înfulecară	înfulecai	Person
absorbite	cotidiene	lemma
obraznică	obraznic	Gender
secvențiale	secvențial	Gender
râncedei	râncedului	Gender
pușcărie	pușcăriilor	Number
lanternă	lanternelor	Number
creștinesc	creștinească	Gender
macra	dezvoltata	lemma
dezghețarăți	dezghețai	Person
chestiune	chestiunilor	Number
ridicau	ridica	Number
popularului	popularei	Gender
inimosul	verde	lemma
stinge	sting	Number
datori	dator	Gender
căpoșilor	căpoasei	Gender
neguțaseși	neguțaserăți	Number
amari	amară	Gender
flexibilă	flexibil	Gender
britanicul	britanica	Gender
scapăt	înzestrez	lemma
sar	sărim	Person
perindară	împărară	lemma
largi	larg	Gender
copților	coapta	Gender
calzi	caldă	Gender
dezmeticii	dezmetici	Person
alților	alta	Gender
cresc	creștem	Person
rara	uscata	lemma
cade	cad	Number
neadaptatei	neadaptatul	Gender
lascivilor	sălbaticilor	lemma
mincinoasa	mincinosului	Gender
sărăcie	bombă	lemma
haitieni	haitiene	Gender
spetiși	speti	Person
podelele	zborurile	lemma
pleacă	aplică	lemma
sumesei	făurii	lemma
lin	lini	Gender
rupt	rupte	Gender
importanta	importantul	Gender
popularului	popularii	Gender
masculinei	masculinul	Gender
veninoși	veninoasă	Gender
roz	arși	lemma
înrădăcinez	înrădăcinăm	Number
pregnantului	pregnanților	Gender
filamentosului	filamentoasa	Gender
jucau	jucam	Person
egalule	egalilor	Gender
inexprimabililor	inexprimabilul	Gender
țintesc	țintești	Person
scormonesc	scormonește	Number
economica	economicilor	Gender
ustensilă	ustensilelor	Number
eșecule	eșecurilor	Number
evreiescului	evreieștii	Gender
augurarăm	augurară	Person
poftim	poftește	Person
amarul	amarilor	Gender
neted	netezi	Gender
adăugaseră	adăugase	Number
lucise	descărcase	lemma
accelerează	accelerați	Person
dezamăgirăți	dezamăgi	Person
zănaticii	zănaticei	Gender
halucinând	deprinzând	lemma
păcăliți	păcălesc	Person
purpuriului	purpuriei	Gender
pragule	pragurilor	Number
păstrarăți	păstră	Person
dialectal	dialectală	Gender
necomutabilei	necomutabililor	Gender
mursecasem	mursecaseră	Person
macabre	macabru	Gender
perturbator	perturbatoare	Gender
ridicam	ridicați	Person
dublei	dublul	Gender
dorirăți	doriși	Person
adoră	întreprind	lemma
schimbați	umflați	lemma
gureșilor	utililor	lemma
viteazul	vitejii	Gender
posterități	încălțăminte	lemma
înzestrarăți	înzestrară	Person
aerisesc	descarc	lemma
plecași	despuseși	lemma
senatorule	senatorilor	Number
statistici	statistică	Gender
reții	rețineți	Number
împăcași	împăcă	Person
mistifici	mistifică	Person
supuserăți	supuseră	Person
cerură	cerurăm	Person
citise	citisem	Person
pocneam	pocnea	Person
râioșilor	râioasa	Gender
piciorule	picioarelor	Number
protejezi	protejez	Person
zburdați	zburdau	Person
pasaserăți	pasaseră	Person
circumscriam	circumscriai	Person
necomutabilei	necomutabilii	Gender
sfericii	sfericei	Gender
timizi	timidă	Gender
țestoși	țestos	Gender
necuviincios	contagios	lemma
anterior	anterioară	Gender
spinoase	duioase	lemma
mătura	măturau	Number
internul	interna	Gender
eterogenului	eterogenii	Gender
blocăm	blochezi	Person
lipiți	lipite	Gender
scurți	scurt	Gender
întorșii	întoarsei	Gender
neutru	neutri	Gender
scădeau	scădea	Person
secvență	secvențelor	Number
mărinimos	urcat	lemma
dobândise	dobândiseră	Number
marine	țărănești	lemma
testicular	testiculare	Gender
necăjești	necăjiți	Person
lini	lin	Gender
murmurasem	zbierasem	lemma
alcătuiseră	dobândiseră	lemma
fermecătoare	fermecător	Gender
descalță	descălțăm	Person
alunule	alunilor	Number
roșiei	roșului	Gender
mediocrilor	mediocrul	Gender
futu	futurăm	Person
elementarilor	elementarul	Gender
interesant	interesanți	Gender
interesante	subsonice	lemma
serios	bărbătesc	lemma
zbârciseră	zbârciserăți	Person
perfectei	perfectul	Gender
grea	greu	Gender
scriem	scriu	Person
grăbeam	grăbeai	Person
înconjurule	înconjururilor	Number
stângul	stângii	Gender
tiranule	tiranilor	Number
capabilitate	capabilităților	Number
jucarăți	asurzirăți	lemma
anihilau	anihila	Number
femeiesc	femeiești	Gender
țărănesc	țărănești	Gender
stanifer	staniferi	Gender
greul	greilor	Gender
dureroși	dureroase	Gender
făcură	făcui	Person
pregnantul	pregnantei	Gender
tandra	tandrul	Gender
roși	blânzi	lemma
călcâiule	călcâielor	Number
hibernăm	hibernezi	Person
străinului	străinilor	Gender
introductivul	bolnăviciosul	lemma
ciracule	ciracilor	Number
lunga	lungului	Gender
țigănescul	țigăneștilor	Gender
grăbiți	grăbit	Gender
albastru	albastre	Gender
rotesc	rotește	Number
lucraseră	lucrase	Person
lucios	ciudat	lemma
obrazule	obrajilor	Number
secundară	amicală	lemma
anim	animă	Person
săcreata	săcreților	Gender
urăște	coboară	lemma
inteligentului	inteligenților	Gender
îmbătrânește	îmbătrânesc	Number
scrotal	scrotale	Gender
adevărurilor	șirurilor	lemma
sexoasa	sexosul	Gender
obscur	obscură	Gender
primă	primi	Gender
mișcaseră	mișcaserăm	Person
parcare	parcărilor	Number
indiferenți	indiferent	Gender
blocau	blocați	Person
capeți	capătă	Person
trăgănați	credeți	lemma
inundaseși	inundaserăți	Person
dezamăgită	dezamăgiți	Gender
șopteam	șopteai	Person
mincinoasă	mincinos	Gender
izbiți	izbește	Person
haotice	biochimice	lemma
merită	înviorează	lemma
carnivori	carnivore	Gender
prinde	încheagă	lemma
răsăriserăți	răsăriseși	Number
vând	vindem	Person
olimpice	olimpic	Gender
ascultă	ascultăm	Person
temperaturilor	elefanților	lemma
repauzezi	repauzați	Number
uimitoarea	uimitorul	Gender
returnați	returnează	Person
părăsiși	părăsi	Person
hotărâseră	hotărâse	Number
acrișoare	acrișor	Gender
sucești	sucim	Person
catastroficilor	catastroficul	Gender
convențional	convenționale	Gender
fericitei	fericiții	Gender
încadraseși	încadraserăți	Person
urai	urați	Number
regaliste	regalist	Gender
strâmți	strâmtă	Gender
imaginai	contravenii	lemma
declarați	declaram	Person
surprinseserăm	surprinseserăți	Person
fragedul	fragezii	Gender
sugaciule	sugacilor	Gender
surei	surului	Gender
nasoală	nasoli	Gender
iraționali	credincioși	lemma
dubioasă	dubios	Gender
pătimesc	împlinesc	lemma
menține	mențin	Person
siguri	vitregi	lemma
semivocală	semivocalelor	Number
credincioasa	credinciosului	Gender
ieftinea	ieftineați	Person
slava	slavul	Gender
structuratului	structuratei	Gender
sprintenilor	valahilor	lemma
barai	bară	Person
sfâșiat	dezvoltat	lemma
iluzoriu	vorbăreț	lemma
balcanice	balcanic	Gender
moștenirăți	moșteniși	Person
alergie	alergiilor	Number
rotunde	eterogene	lemma
rara	rarii	Gender
răbojii	încărcai	lemma
naiva	naivilor	Gender
aminteau	amintea	Person
adăugați	vorbeați	lemma
mărturiseai	mărturiseați	Person
depănasem	depănase	Person
descărcai	descărcă	Person
mințitoare	cicliste	lemma
servirăți	servii	Person
cumpără	cumpărași	Person
lubrifie	lubrifiai	Person
cenușiu	cenușii	Gender
reintrodusese	reintrodusesem	Person
atlantic	atlantică	Gender
pulsat	învechit	lemma
închegasem	închegaserăți	Person
pastorilor	frunzelor	lemma
înzestrează	înzestrăm	Person
roase	șterse	lemma
ies	iese	Person
hrăneau	hrănea	Person
lucrează	lucrați	Person
nepopularului	cuprinsului	lemma
colaboratorul	colaboratorii	Gender
omogenului	elementarului	lemma
albastra	albastrul	Gender
acoperiți	acoperită	Gender
scuzat	înfrățit	lemma
lucezi	luced	Gender
electromagneticului	electromagneticii	Gender
utilizau	înmânau	lemma
stingea	stingeai	Person
plin	plină	Gender
inexplicabil	amfibiu	lemma
naiv	amabil	lemma
săpau	încrucișau	lemma
amenința	amenințam	Person
apropiere	apropierilor	Number
respectului	analizatorilor	lemma
mediocru	mediocre	Gender
creștinul	creștinilor	Gender
bolnavi	bolnave	Gender
desprindem	desprinde	Person
triști	trist	Gender
transcriam	transcria	Person
importantă	importanți	Gender
caci	căcați	Number
flămânzilor	flămândei	Gender
creativă	creativi	Gender
haitianului	haitienii	Gender
neapărate	neapărat	Gender
aplicaserăți	aplicase	Person
dramatici	dramatice	Gender
ferestrui	ferestruirăm	Person
belii	belirăți	Person
ies	ieșim	Person
acuzați	acuzată	Gender
incomplete	incomplet	Gender
rescrieți	rescriu	Person
gorunule	gorunilor	Number
dezlega	dezlegați	Person
experimentații	experimentata	Gender
sacri	sacru	Gender
gravați	gravată	Gender
observi	observați	Person
halește	halesc	Person
cruzii	crudul	Gender
văzui	văzură	Person
nou	nouă	Gender
produc	producem	Person
sicriele	artera	lemma
draga	dragul	Gender
adânciseși	adânciseră	Person
dramatic	dramatice	Gender
ușuraticilor	ușuraticului	Gender
pronume	pronumelor	Number
injectaseși	împrejuraseși	lemma
dependentului	dependentei	Gender
mulțumesc	mulțumim	Person
gospodină	gospodinelor	Number
răsfoiește	fracturează	lemma
localităților	funcțiilor	lemma
invincibilă	invincibili	Gender
salută	salutați	Person
crucificați	crucifică	Person
centrală	centrali	Gender
spetirăm	spetirăți	Person
vârtoșilor	vârtoasei	Gender
silabicului	silabicii	Gender
atingi	atinge	Person
câștigau	câștiga	Person
clarificam	clarificai	Person
obligă	înfiripaează	lemma
oacheș	oacheșă	Gender
numești	numesc	Person
conduceai	conduceați	Number
tandre	tandri	Gender
obraznici	obraznice	Gender
înjurătură	înjurăturilor	Number
locuiseși	locuiseră	Person
semnarăm	distilarăm	lemma
leton	făcător	lemma
răspunseși	răspunseră	Person
subscriseră	subscrise	Number
caraghios	caraghioși	Gender
tehnologice	tehnologici	Gender
furioșii	furioasa	Gender
izolat	izolați	Gender
slabul	slabei	Gender
telefonule	telefoanelor	Number
micului	micii	Gender
spuzim	spuziți	Person
lingurilor	țigărilor	lemma
întorseseși	întorsesem	Person
slabi	slabe	Gender
rublă	rublelor	Number
spirituală	spiritual	Gender
cuvioasă	cuvioși	Gender
sacra	sacrul	Gender
biologic	biologici	Gender
criticilor	critica	Gender
agresivilor	agresivul	Gender
amuzați	amuzam	Person
întrebuințară	întrebuințai	Person
râmă	tăcere	lemma
toci	tocirăți	Person
bolnăvicioasă	bolnăvicios	Gender
ploioasă	ploioși	Gender
cobori	coborâm	Person
abcesule	traiectorie	lemma
descurcăreți	descurcăreț	Gender
muzicala	muzicalul	Gender
avansarăm	avansași	Person
corupseseși	corupseserăm	Person
planetare	planetari	Gender
homofobica	îngrozitoarea	lemma
critic	critici	Gender
fericită	fericiți	Gender
reînnoiesc	înjunghie	lemma
friguros	friguroase	Gender
soporiferilor	soporifera	Gender
dezamăgiți	dezamăgite	Gender
perturbatorul	perturbatoarea	Gender
surului	sura	Gender
neanticipată	blândă	lemma
micșoră	micșorară	Person
subterana	subteranul	Gender
zdrobeai	zdrobeau	Person
antagonice	antagonic	Gender
neutri	neutru	Gender
fertili	fertile	Gender
polare	polar	Gender
trombonule	tromboanelor	Number
necuviincioase	țestoase	lemma
facilitate	facilităților	Number
murdari	murdare	Gender
refecam	atacam	lemma
structurata	structuraților	Gender
uzilor	uda	Gender
atacaserăm	atacaseși	Person
moldovenească	complexă	lemma
căsătoreai	căsătoreați	Person
afumăm	afum	Number
tentantă	tentant	Gender
lucrați	descoperiți	lemma
minunați	minuna	Person
famenule	famenilor	Number
doamnă	doamnelor	Number
săcretul	săcreților	Gender
purpurie	purpuriu	Gender
susțineți	susții	Number
zănatici	zănatică	Gender
rotunjite	rotunjiți	Gender
beat	beți	Gender
digitală	digitali	Gender
digitale	digital	Gender
dramatice	dramatici	Gender
baltice	baltic	Gender
burtoșii	burtosului	Gender
serioasă	serios	Gender
dură	dur	Gender
preistorică	preistoric	Gender
vale	văilor	Number
îmbrăcați	îmbracă	Person
pace	timiditate	lemma
luminos	luminoși	Gender
clar	clari	Gender
arcadă	arcadelor	Number
urmat	însuflețit	lemma
mestecând	descompunând	lemma
elementar	elementară	Gender
mâncăm	înfigem	lemma
cumplit	cumplită	Gender
limpedele	biologicul	lemma
iertai	iertară	Person
cotropii	cotropiși	Person
buciumai	buciumarăți	Person
interesant	interesantă	Gender
vărezi	vărează	Person
silabicului	silabica	Gender
macrei	macrului	Gender
veneai	veneau	Person
modificați	modificam	Person
pot	poate	Number
bălțații	bălțatul	Gender
separă	atârnă	lemma
structurali	structurală	Gender
semnez	semnează	Person
pot	poți	Person
lucrătoare	lucrător	Gender
delăsarăți	delăsași	Person
speti	spetiră	Number
rotunjit	clar	lemma
spumegaserăți	spumegaseră	Person
aștern	așterne	Person
dinamică	dinamic	Gender
articulați	articulezi	Number
omniscienții	omniscientului	Gender
inimoși	inimos	Gender
teoricului	teoricii	Gender
orhidee	orhideelor	Number
bufniță	bufnițelor	Number
criticii	criticului	Gender
tuni	tunați	Number
puțin	șters	lemma
școlari	școlară	Gender
bârlogule	bârlogurilor	Number
deștepți	deștept	Gender
orchestrala	orchestralilor	Gender
veninos	veninoși	Gender
vizualizez	vizualizați	Person
cumplite	cumpliți	Gender
înecaseși	înecaserăți	Person
aspri	aspră	Gender
istoricului	istoricilor	Gender
flămânda	flămândul	Gender
vrajă	vrăjilor	Number
atentului	atentei	Gender
complexul	complexei	Gender
gravitațional	aprins	lemma
largă	larg	Gender
ciudații	ciudata	Gender
transcriserăți	transcriseși	Person
pederasticei	pederasticii	Gender
învinsă	învinși	Gender
rătăcit	rătăcite	Gender
soporiferilor	soporiferului	Gender
nutriși	nutri	Person
dezavantajați	dezavantajează	Person
plantaserăți	plantaserăm	Person
portocaliei	portocaliului	Gender
colaboratorilor	colaboratoarea	Gender
arse	ars	Gender
odăilor	exploatărilor	lemma
puternici	puternic	Gender
perindând	țigănind	lemma
crudului	cruzilor	Gender
asigurăm	asiguri	Person
virotici	virotice	Gender
fertile	fertili	Gender
ultimi	ultim	Gender
subscrie	subscriu	Person
dispun	dispune	Person
flexibilă	flexibili	Gender
plictisiserăm	descheiaserăm	lemma
vânjoasa	vânjosului	Gender
microbiologic	microbiologice	Gender
fericitei	fericitului	Gender
purcede	purced	Person
intime	intim	Gender
persanului	persanilor	Gender
nouă	decafeinizată	lemma
spectrală	spectrali	Gender
spirituali	spiritual	Gender
descompuseră	descompuserăți	Person
călcare	călcărilor	Number
umbreați	umbreai	Person
bianual	bianuală	Gender
cumpănisem	cumpăniseși	Person
neadecvatele	îngereștile	lemma
lucrătoare	contagioasă	lemma
adăpostită	adăpostiți	Gender
părăsita	părăsitului	Gender
linseserăm	zăpăciserăm	lemma
învechiții	învechita	Gender
strămoșule	strămoșilor	Number
insidios	ascuns	lemma
necontestații	necontestata	Gender
murisem	muriserăm	Number
cufundase	cufundasem	Person
salariate	salariat	Gender
logat	echilibrat	lemma
dramatice	dramatic	Gender
depărtasem	depărtase	Person
uscată	uscat	Gender
afurisiră	afurisii	Person
sugere	sugerilor	Number
macabre	viguroase	lemma
cicliștii	ciclistul	Gender
elementari	elementară	Gender
însuflețesc	însuflețim	Person
vulgare	vulgar	Gender
vizibile	vizibili	Gender
rezistăm	rezist	Person
junghie	înțelese	lemma
toacă	toci	Person
bețivanului	bețivanilor	Gender
asistată	asistat	Gender
rătăciților	rătăcitul	Gender
fericitul	fericiților	Gender
crăpaserăm	crăpaseși	Person
ierboasei	ierboșilor	Gender
ușuraticei	ușuraticul	Gender
scoteam	circumcideam	lemma
bivalentă	bivalent	Gender
mustrat	compus	lemma
uită	uităm	Person
cărnoasa	cărnoșilor	Gender
mărinimoaselor	cruntelor	lemma
deștepte	deștept	Gender
armean	armeană	Gender
nocturnilor	nocturna	Gender
îngălbeniserăți	îngălbenisem	Person
regaliste	sudice	lemma
avalanșă	avalanșelor	Number
sinagogă	sinagogilor	Number
roși	evinse	lemma
plantară	plantă	Person
macrii	blânzii	lemma
urâta	urâtului	Gender
pictarăți	pictași	Person
vorbiți	vorbește	Person
convenționalului	convenționala	Gender
neglijează	încalecă	lemma
observanții	observantului	Gender
integrali	fertili	lemma
tundeam	tundeau	Person
scutură	scutur	Person
destinați	destinat	Gender
răgușiților	răgușitul	Gender
acvatici	acvatic	Gender
guralive	vinete	lemma
puternic	femeiesc	lemma
dubios	dubioasă	Gender
împresuraserăm	împresuraseră	Person
adevereai	adevereați	Person
fumegaserăm	fumegaseși	Person
amabila	amabililor	Gender
interfeței	brigadierului	lemma
pregătesc	cresc	lemma
catranule	catranurilor	Number
pornografic	pornografică	Gender
forțau	forțați	Person
descompuserăți	descompuserăm	Person
compar	compară	Person
bisericoși	bisericoase	Gender
abdominali	abdominal	Gender
mici	trântite	lemma
intră	cântă	lemma
recunoscute	țigănești	lemma
aspră	aspri	Gender
merse	întâlni	lemma
animi	animați	Number
deranjăm	deranjez	Person
rece	reci	Gender
panteră	panterelor	Number
bag	băgăm	Person
trădaseră	trădaserăm	Person
alivancă	alivencilor	Number
sferici	geografici	lemma
cumplitul	cumplita	Gender
șovăiseși	șovăiserăți	Number
mărar	tine	lemma
stânjeniși	stânjenii	Person
scoți	scoateți	Person
mărturisea	mărturiseau	Person
înghețat	înghețate	Gender
cumpătară	cumpătarăți	Person
brună	bruni	Gender
lăi	brazilienilor	lemma
ardeai	ardeam	Person
amestecăm	amesteci	Person
omniscientă	omniscienți	Gender
gravați	gravate	Gender
platformă	platformelor	Number
intimi	intime	Gender
extindeați	extindeam	Person
atârnați	atârnam	Person
roseseși	rosese	Person
săpai	săpară	Person
insidioși	insidioase	Gender
încălzesc	încălzește	Person
intervenea	interveneau	Number
skandenberg	colonialism	lemma
îmbunătățire	îmbunătățirilor	Number
albiniță	albinițelor	Number
zmeurule	zmeurilor	Number
complex	complecși	Gender
răuul	răuule	Gender
prietenie	prieteniilor	Number
seriosului	serioșii	Gender
dezavantajoșilor	dezavantajosul	Gender
crocodilule	crocodililor	Number
unsuroși	unsuroase	Gender
distra	distrau	Person
analoage	analog	Gender
grosului	groșilor	Gender
lăcrimoasă	lăcrimoși	Gender
dimensionare	dimensionărilor	Number
suverana	suveranilor	Gender
rupt	rupți	Gender
sexosului	sexoșii	Gender
biet	biete	Gender
cășunase	cășunaseră	Person
apăreau	apăream	Person
carnivoră	carnivori	Gender
britanic	britanice	Gender
plată	plați	Gender
singurelor	bengalezelor	lemma
agresivei	agresivii	Gender
ruptură	rupturilor	Number
intuiesc	intuiești	Person
onești	onest	Gender
blondul	blonda	Gender
speriau	îmbărbătau	lemma
încercuisem	încercuiserăți	Person
încercați	încerca	Person
scuipat	vărsat	lemma
înfrățeau	înfrățeați	Person
rumegarăm	rumegarăți	Person
invită	înfrânează	lemma
sugrumaseși	sugrumaserăți	Number
sufocai	sufocați	Person
bravi	brav	Gender
amuțit	bazat	lemma
adorabililor	adorabilul	Gender
semnăm	semnez	Person
sacri	sacră	Gender
portocalie	arogantă	lemma
scriem	scriu	Number
fluturași	flutură	Person
mucoasa	mucosului	Gender
imperialii	imperialul	Gender
îngrămădisem	îngrămădiseși	Person
absinturile	umerașele	lemma
scurtei	scurtului	Gender
bănuiesc	bănuiți	Person
desmățaserăm	desmățaseși	Person
istoricelor	vitregelor	lemma
omenoasa	omenoșii	Gender
ubicuei	ubicuului	Gender
otrăviserăm	împreunaserăm	lemma
plecaseră	plecase	Number
îmbătrâneai	îmbătrâneați	Person
marină	marin	Gender
serioasă	beată	lemma
ușurăm	ușurez	Number
argintie	argintii	Gender
francezul	francezule	Gender
vitează	viteji	Gender
spulberam	discutam	lemma
sașii	ascunse	lemma
prăjită	prăjiți	Gender
halucinase	halucinaseră	Number
sticlă	sticlelor	Number
strălucitoare	strălucitori	Gender
mândre	mândru	Gender
discret	discreți	Gender
unici	unic	Gender
toxici	toxică	Gender
fracturaseră	fracturaseși	Person
spânei	spânii	Gender
tranzitive	tranzitiv	Gender
leșină	leșinară	Number
tehnologic	tehnologice	Gender
creativului	creativii	Gender
obraznici	colaboratori	lemma
alergați	îmbiați	lemma
caută	căutați	Person
rătăciți	rătăcite	Gender
femeiescul	femeieasca	Gender
calculate	calculat	Gender
dobândea	dobândeam	Person
mărginiserăți	mărginiseși	Number
britanic	britanică	Gender
strungărețelor	zimbrilor	lemma
ridicare	ridicărilor	Number
măsurați	măsori	Person
așteptare	așteptărilor	Number
maghiara	maghiarul	Gender
naivilor	naivul	Gender
formidabili	formidabil	Gender
copți	coapte	Gender
armăsarule	armăsarilor	Number
urcau	urcați	Person
atlantici	atlantice	Gender
amicală	amical	Gender
interzic	interzici	Person
fierte	fierți	Gender
suspensor	suspensori	Gender
sorbirăți	călcarăți	lemma
testicular	testiculară	Gender
inexprimabilului	inexprimabilii	Gender
însușire	însușirilor	Number
gureș	gureși	Gender
sălbatice	sălbatici	Gender
tun	zic	lemma
nostalgici	nostalgic	Gender
fierbinți	fierbinte	Gender
letoni	leton	Gender
ceapă	cepelor	Number
înțeparăm	înțepă	Person
obișnuii	obișnuirăm	Person
victorie	victoriilor	Number
recunoaștem	recunosc	Number
structurali	structural	Gender
falusule	falusurilor	Number
împiedica	împiedicați	Person
beliserăm	belise	Person
albicioasă	albicios	Gender
atotputernicii	atotputernicului	Gender
concentraților	concentratul	Gender
minuscul	minusculă	Gender
evlavios	evlavioase	Gender
bășică	bășicilor	Number
absintule	absinturilor	Number
cumplită	cumplit	Gender
armeana	armeanul	Gender
capitalistul	capitaliștilor	Gender
demne	demni	Gender
necazule	necazurilor	Number
răgușita	răgușitului	Gender
împiedicai	împiedicam	Person
prietenoasă	prietenoși	Gender
umbroșilor	umbrosul	Gender
crezuseși	crezuse	Person
grație	grațiilor	Number
pântecoși	pântecoase	Gender
umblă	concepe	lemma
animație	animațiilor	Number
brava	bravii	Gender
foaie	foilor	Number
mișunaseră	încărunțiseră	lemma
conduseseră	condusese	Number
jucărie	jucăriilor	Number
încercaseră	încercasem	Person
observant	suspensor	lemma
șchiopi	șchiop	Gender
spinos	spinoase	Gender
influențarăm	influențarăți	Person
noua	noilor	Gender
sistași	sistarăm	Person
merităm	merită	Person
urbanizaserăm	urbanizaseși	Person
virilei	virililor	Gender
puțeau	puțea	Number
dezavantajați	dezavantajai	Person
proprietate	proprietăților	Number
prelungea	întrebuința	lemma
expediezi	expediați	Person
maghiarului	maghiarii	Gender
încet	încete	Gender
rezist	exist	lemma
rusești	supreme	lemma
dureroase	dureroși	Gender
bazilică	bazilicilor	Number
necuviincioasei	fumuriei	lemma
dezvoltate	dezvoltat	Gender
apoși	apoase	Gender
rută	rutelor	Number
strănutarăți	delogarăți	lemma
sistai	sistarăți	Person
rotunzi	rotund	Gender
tandre	tandru	Gender
făgăduiserăți	făgăduiseși	Person
armeana	armeanului	Gender
căsătoriți	căsătoresc	Person
culca	culcau	Person
îngeresc	îngerească	Gender
auriu	aurii	Gender
urmăriși	înfățișași	lemma
pofticioaselor	evreieștilor	lemma
mintal	mintală	Gender
zboară	zbori	Person
înscriem	înscriu	Person
mâniam	mâniau	Person
astâmpăram	astâmpărați	Person
asistată	asistați	Gender
observat	ațipit	lemma
știu	știe	Person
cafeniu	cafenii	Gender
dreseserăm	dreseseră	Person
perineali	eronați	lemma
purceseserăm	purceseseși	Person
agerii	agerei	Gender
înfigeau	înfigea	Person
apocaliptică	apocaliptic	Gender
întrebați	întrebi	Number
supraviețuiți	supraviețuiesc	Person
supraviețuiși	supraviețuiră	Person
interesează	interesez	Person
excitaserăm	excitaseră	Person
deplasau	deplasa	Person
cântai	cântați	Number
cârmă	cârmelor	Number
omnipotentă	subțire	lemma
blestem	blestemați	Person
parmezanule	parmezanelor	Number
accidentala	accidentalilor	Gender
cosmici	cosmică	Gender
gălbui	veninoase	lemma
școlare	școlar	Gender
strâmbi	curgi	lemma
vizitez	întrețin	lemma
alianță	alianțelor	Number
cântăreațo	cântărețelor	Number
târguiră	șovăiră	lemma
dezghețarăți	dezgheță	Person
sigură	dublă	lemma
omenești	omenesc	Gender
dur	duri	Gender
cufundi	cufundăm	Person
încetisem	încetiseră	Person
stricați	stricat	Gender
râvnise	râvniserăți	Person
păcăliți	păcălește	Person
întremaseră	întremase	Person
simple	simpli	Gender
inestetic	viu	lemma
acoperim	acoperiți	Person
mușcați	mușca	Person
târzii	târzie	Gender
bocim	bocesc	Person
invadat	astupat	lemma
greșești	bazezi	lemma
îngheți	înghețați	Person
nechibzuită	nechibzuit	Gender
brava	bravilor	Gender
deplasau	deplasai	Person
lucrătorul	lucrătorii	Gender
exotice	exotici	Gender
lubrifiasem	capitulasem	lemma
lauzi	descoperi	lemma
vizualiză	vizualizarăți	Person
scapăr	scăpărăm	Person
fricoșii	fricoasei	Gender
omniprezente	ușuratice	lemma
făgăduiesc	făgăduim	Person
apusei	apuserăm	Person
păruși	părurăți	Number
tentând	aurind	lemma
acoperiți	acoperit	Gender
unidirecționalul	unidirecționalei	Gender
grasă	grași	Gender
vindem	vând	Number
ridicată	ridicați	Gender
preferam	prefera	Person
echilibrați	echilibrezi	Person
latina	consultările	lemma
nud	nude	Gender
dezamăgiți	dezamăgit	Gender
nativi	native	Gender
fărâmaserăm	fărâmase	Person
tunde	arăduce	lemma
portocaliu	dogmatic	lemma
adormiților	fainilor	lemma
mândrie	mândriilor	Number
libidinos	libidinoase	Gender
decădere	decăderilor	Number
anal	anală	Gender
donație	donațiilor	Number
controlăm	controlați	Person
nereal	nereali	Gender
petreceam	petrecea	Person
legale	legal	Gender
futabili	futabile	Gender
albinoși	albinos	Gender
gâscă	gâștelor	Number
cântaserăm	cântaseși	Person
istoveam	istoveați	Person
importantului	importanta	Gender
rostogolești	rostogoliți	Person
iertăciune	iertăciunilor	Number
sarcastic	sarcastică	Gender
grăi	grăiră	Number
răsturna	răsturnați	Person
pasam	ghiceam	lemma
ispită	ispitelor	Number
creați	crea	Person
baltice	baltici	Gender
baltica	balticii	Gender
obțineau	obținea	Person
dezechilibrule	dezechilibrelor	Number
bunică	bunicilor	Number
îndepărtaserăm	îndepărtaseră	Person
separau	separa	Number
spintecați	spinteca	Person
pășuna	asuda	lemma
strică	expediază	lemma
solarilor	solara	Gender
spuneți	articulați	lemma
puținilor	puținul	Gender
juvenil	juvenile	Gender
nisipoase	bolnăvicioase	lemma
lubrifiași	întortocheași	lemma
consularii	consularei	Gender
amfibianule	amfibienilor	Number
citeau	citea	Person
înțeleg	înțelege	Person
descarci	descarcă	Person
aflau	afla	Person
capitală	capitalelor	Number
înfășarăm	înfășarăți	Person
urlasem	divorțasem	lemma
încunun	încununi	Person
scuturați	clădeați	lemma
completului	compleții	Gender
pornografică	pornografic	Gender
alergau	îndemnau	lemma
evazivei	evazivilor	Gender
invincibililor	invincibilei	Gender
uscați	uscat	Gender
delăsaserăți	delăsasem	Person
rostule	fumarule	lemma
păruiserăm	păruiseși	Person
uscăm	uscați	Person
accelerează	împreunează	lemma
stabilea	stabileau	Number
răspund	răspunzi	Person
crudă	cruzi	Gender
dubioși	dubios	Gender
năsuți	năsut	Gender
înseteză	însetezai	Person
enormă	enormi	Gender
șters	ștersă	Gender
intranzitiva	intranzitivului	Gender
atotputernici	atotputernică	Gender
moldovenești	moldovenesc	Gender
rar	rari	Gender
adorm	adormim	Number
prevestea	prevesteau	Number
bărbieri	bărbierii	Person
peșterilor	farmecelor	lemma
gustare	ursulețule	lemma
ofensatoare	ofensator	Gender
puternicilor	puternica	Gender
încrucișarăm	încrucișă	Person
micii	micul	Gender
programabilului	chelului	lemma
excitați	exciți	Number
pedepsisem	pedepsise	Person
fătule	feților	Number
imprimă	îngustă	lemma
monocromă	monocrom	Gender
oblici	complecși	lemma
neutrul	neutrii	Gender
descompuseră	descompuseși	Person
fierbinciori	fierbincior	Gender
lini	lină	Gender
interni	interne	Gender
întoarce	întorc	Number
ajutase	ajutaserăm	Person
oranj	geamănă	lemma
pliviți	plivim	Person
zimbrule	zimbrilor	Number
accesibil	accesibili	Gender
izgoniră	izgonirăți	Person
umed	umezi	Gender
heterosexualul	heterosexualule	Gender
închiși	închise	Gender
ultimei	ultimului	Gender
răcoresc	cuminecă	lemma
atlantica	atlanticului	Gender
prezenților	prezentului	Gender
râioasa	râioșii	Gender
misterios	misterioase	Gender
stricaseră	stricaserăm	Person
perindarăți	perindai	Person
rad	radem	Person
luminilor	eternității	lemma
încadrasem	încadraserăți	Person
compunea	compuneau	Number
mănușă	mănușilor	Number
sumese	sumeseră	Number
relele	exterioarele	lemma
lasciv	vorbăreț	lemma
plaiule	plaiurilor	Number
strămoșii	drumul	lemma
cred	crede	Person
invitași	invitarăm	Person
îngriji	îngrijiră	Number
câmpenesc	câmpenească	Gender
scrieți	scriem	Person
diurnii	diurnei	Gender
scurmați	scurmă	Person
vizibilă	vizibili	Gender
venezuelene	venezueleni	Gender
tărăgănați	tărăgănez	Person
sacră	sacru	Gender
masive	masiv	Gender
îmbărbăta	îmbărbătam	Person
alăptă	alăptarăm	Person
sacre	fade	lemma
întărim	întăresc	Person
mișcătorului	dătătorule	lemma
alungase	alungaseră	Person
bârnă	bârnelor	Number
concentrați	concentrat	Gender
semnule	brădioară	lemma
înfrunziseră	înfrunziserăți	Person
secreți	secrete	Gender
apocalipticei	apocalipticilor	Gender
găuresc	găurește	Person
prezent	prezente	Gender
criticii	criticei	Gender
sacra	sacrului	Gender
mânii	echilibrezi	lemma
mișcătoare	mișcător	Gender
masturbez	masturbăm	Number
nepopular	nepopulari	Gender
prețuiau	prețuia	Person
genetică	genetici	Gender
colectivitate	colectivităților	Number
scutură	înseninează	lemma
ia	începe	lemma
юбисе	юбисерэ	Number
cuvioasei	cuvioșii	Gender
fript	fripte	Gender
prins	înăbușit	lemma
asigurarăți	asigură	Person
gazarăm	gazai	Number
mintali	mintale	Gender
unesc	uniți	Person
milosului	miloșii	Gender
nisipoase	nisipoși	Gender
emoție	emoțiilor	Number
alte	alt	Gender
produserăm	produseși	Person
neted	netede	Gender
rezolvaserăți	rezolvasem	Person
creativilor	creativa	Gender
legendarilor	legendara	Gender
introductive	tari	lemma
ocupau	ocupam	Person
evazivii	evazivei	Gender
preferați	prefera	Person
binefăcători	binefăcătoare	Gender
insultaseră	insultaserăți	Person
sunasem	degerasem	lemma
rășină	rășinilor	Number
epuizaserăm	epuizase	Person
râioasei	râiosul	Gender
apropie	apropiarăm	Person
păstrat	vădit	lemma
îndrăznește	îndrăznesc	Number
arsură	arsurilor	Number
solarei	solarul	Gender
câștigăm	câștigați	Person
prăjitului	prăjita	Gender
clipă	clipelor	Number
fierseseră	fiersese	Number
potrivesc	potriviți	Person
abile	abil	Gender
înghețată	înghețați	Gender
încântăm	încântați	Person
îmbătaseră	îmbătaserăm	Person
amicale	amical	Gender
împletirăm	împleti	Person
ruinam	încetam	lemma
pilotași	pilotă	Person
întemeiaserăți	întemeiaseră	Person
purceseseră	purceseseși	Person
înșurubează	înșurubezi	Person
spumegaserăți	spumegaseși	Person
neașteptată	neașteptaţi	Gender
screm	încală	lemma
atârnați	atârna	Person
cuprinde	cuprind	Person
neanticipată	neanticipat	Gender
omogeni	omogen	Gender
ultimul	ultimilor	Gender
răsăriși	răsărirăți	Person
adunăm	coborâm	lemma
adâncului	adâncii	Gender
algoritmule	algoritmilor	Number
răpuneați	îndeletniceați	lemma
venisem	veniserăți	Person
jurași	jurarăm	Person
blânde	blând	Gender
slăbire	slăbirilor	Number
salinizară	saliniză	Person
accidentală	accidental	Gender
ierboase	făinoase	lemma
căsătorii	căsătorirăm	Person
oficiali	oficiale	Gender
primii	primei	Gender
cascadă	cascadelor	Number
mărinimos	mărinimoasă	Gender
spală	spălați	Person
muribundului	muribunzilor	Gender
agere	ageri	Gender
ținute	ținuți	Gender
minciună	minciunilor	Number
sec	fain	lemma
spiritualul	spirituala	Gender
sur	suri	Gender
lingvistic	lingvistice	Gender
lăsată	lăsat	Gender
automatului	automatelor	Gender
cercaseră	cercasem	Person
gravitaționalii	gravitaționala	Gender
căsătorie	căsătoriilor	Number
adumbrirăm	distinserăm	lemma
nimicește	nimiciți	Person
sapă	sapelor	Number
ștergeți	șterg	Person
răserăm	împrejmuirăm	lemma
monoaxialilor	monoaxiala	Gender
ejaculează	ejaculez	Person
integrale	integral	Gender
libertate	libertăților	Number
strâmtau	strâmta	Number
absorbiți	absorbit	Gender
enigmatica	enigmaticii	Gender
devii	deveniți	Number
urâși	urârăți	Person
groasei	grosului	Gender
secret	țărănesc	lemma
uit	uităm	Person
civiizasem	civiizaseră	Person
asigurăm	asigură	Person
friguroși	friguroase	Gender
injectat	fulgerat	lemma
intempestive	delicioase	lemma
vulgare	vulgari	Gender
dragi	drag	Gender
alchimic	borțos	lemma
sarma	sarmalelor	Number
ageră	ageri	Gender
pitoreștii	pitoreasca	Gender
contraveniserăm	contravenisem	Number
caută	căutăm	Person
balcanicei	balcanicul	Gender
înfrăți	înfrățirăți	Person
amical	amicale	Gender
implicăm	încercăm	lemma
real	întregului	lemma
nominali	nominal	Gender
prezenta	prezentul	Gender
ferecarăm	ferecai	Person
scuipai	scuipam	Person
frământare	frământărilor	Number
librărie	librăriilor	Number
șerbirăm	șerbiră	Person
vânturi	vânturați	Person
australianului	australienilor	Gender
salariat	salariați	Gender
vizitam	dansam	lemma
lai	laie	Gender
blânzi	blând	Gender
slutului	sluților	Gender
accesibil	accesibilă	Gender
jenează	jenați	Person
îmbătaserăm	îmbătaseși	Person
pofticioase	pofticios	Gender
scurtaserăm	apropiaserăm	lemma
dărăpănară	dărăpănă	Number
schimb	schimbi	Person
prânzise	căzuse	lemma
strămutam	strămuta	Person
sicriule	sicrielor	Number
omniprezenta	omniprezenților	Gender
microbiologic	brav	lemma
haoticii	haoticei	Gender
comandarăm	comandară	Person
bravilor	bravul	Gender
macră	codificată	lemma
pregătii	pregătirăm	Person
polară	polar	Gender
rătăcesc	îmbrățișează	lemma
supusesem	supuseseși	Person
batem	bate	Person
staniferii	staniferului	Gender
pofticioșilor	pofticiosul	Gender
păros	păroși	Gender
județului	bombei	lemma
moartei	morților	Gender
dacului	dacilor	Gender
multipolare	amare	lemma
lichid	lichizi	Gender
intensitate	intensităților	Number
aritmetică	aritmetici	Gender
duiosului	duioasei	Gender
purifică	purificași	Person
rețin	reții	Person
subscrisese	subscriseserăm	Person
ornatului	ornații	Gender
bărbătești	bărbătesc	Gender
cotiși	cotirăți	Number
omogenelor	surelor	lemma
delirantului	deliranților	Gender
sefardă	sefard	Gender
groasă	gros	Gender
rusești	rusesc	Gender
toarserăm	învechirăm	lemma
îngrășăm	îngraș	Person
subțiarăți	subție	Person
îndepărtează	îndepărtați	Person
strănută	strănut	Person
inteligente	inteligent	Gender
ascuns	ascunși	Gender
noi	exteriori	lemma
obscene	obscen	Gender
vizualizează	vizualizați	Person
impunem	impun	Person
pieptănam	pieptănai	Person
religioasei	religiosul	Gender
statistici	statistice	Gender
surda	surdul	Gender
sărbătoresc	încred	lemma
curvă	curvelor	Number
distilați	distilează	Person
depărtăm	depărtez	Person
meșteți	mesc	Person
abile	evlavioase	lemma
piaptănă	citește	lemma
tărăgănară	tărăgănași	Person
indiscreților	indiscretului	Gender
spart	sparți	Gender
iese	ieșim	Person
extern	externe	Gender
puțin	puține	Gender
senin	senină	Gender
auziserăm	auziserăți	Person
colorat	colorată	Gender
încep	începi	Person
traduc	traduce	Person
locuință	construcție	lemma
gustă	dărâmă	lemma
invincibil	invincibili	Gender
inflexibilă	inflexibil	Gender
românul	române	Gender
frumusețe	frumuseților	Number
viteazul	viteaza	Gender
recunoscut	recunoscute	Gender
gospodari	gospodar	Gender
verosimil	verosimilă	Gender
copiase	copiaserăți	Person
platul	plata	Gender
mândra	mândrul	Gender
blonzii	blondul	Gender
sacre	sacri	Gender
liniștiseși	liniștisem	Person
oblică	oblici	Gender
slujit	țipat	lemma
cronicei	cronicilor	Gender
delimitarăți	delimită	Person
arinoasei	arinosul	Gender
iertat	iertați	Gender
sângeroasă	sângeros	Gender
știți	știm	Person
polari	polar	Gender
comparare	comparărilor	Number
confruntă	confruntarăți	Person
ferestruit	ferestruită	Gender
umblat	vlăguit	lemma
neguroasa	negurosului	Gender
căruntului	căruntei	Gender
crude	cruzi	Gender
noilor	noului	Gender
susținuseră	însetezaseră	lemma
amorțiși	amorțirăm	Person
nerecunoscută	nerecunoscut	Gender
somnoroși	somnoroasă	Gender
purica	puricau	Person
traversasem	traversase	Person
piersicule	piersicilor	Number
păzeam	păzeau	Person
pandeism	tuse	lemma
homosexualul	homosexualule	Gender
țeseai	țeseau	Person
speranță	speranțelor	Number
somnoros	somnoroase	Gender
monoaxialul	monoaxiala	Gender
masculin	masculine	Gender
întâlnesc	întâlniți	Person
aminteam	eram	lemma
mormolocii	călcâiul	lemma
fripse	fripserăm	Person
știucă	știucilor	Number
cravată	cravatelor	Number
întoarce	întorc	Person
viețuiam	viețuiați	Person
ridicați	ridicat	Gender
renii	fluturele	lemma
guvernează	înfăinează	lemma
dormitați	dormitai	Person
rare	arhicunoscute	lemma
analogi	analoagă	Gender
sărutați	sărutam	Person
dorință	dorințelor	Number
omor	întristez	lemma
desmântase	desmântaseși	Person
emerit	emerită	Gender
dură	duri	Gender
măiastra	măiestrului	Gender
relaxat	relaxați	Gender
scalzi	cumpătezi	lemma
neadecvatului	neadecvaților	Gender
liberați	încălțați	lemma
amânăm	amân	Person
adevăraților	adevăratei	Gender
protejaserăm	întorseserăm	lemma
vânturaserăți	vânturaseși	Number
democratici	democratic	Gender
deziceam	dezicea	Person
moare	mor	Number
recupera	recuperați	Person
lichidului	lichizilor	Gender
vârtejule	vârtejurilor	Number
legendarului	legendara	Gender
părui	dobândi	lemma
ploioase	sănătoase	lemma
acoperim	acoperă	Person
râncezilor	rânceda	Gender
rugisem	rugiserăm	Person
inul	zânele	lemma
veșnic	veșnică	Gender
utilizăm	utilizează	Person
greșesc	greșește	Number
vânăta	vineții	Gender
filamentos	filamentoase	Gender
parcați	parcam	Person
zgomotos	zgomotoase	Gender
slute	britanice	lemma
valoare	valorilor	Number
încură	încurarăm	Person
umfli	umflă	Person
cumplită	cumpliți	Gender
mijlociși	mijlocirăm	Person
tranzițional	tranzițională	Gender
electromagnetice	electromagnetic	Gender
nocturn	nocturne	Gender
neutrul	neutrilor	Gender
locuisem	locuiserăți	Person
omogenă	omogen	Gender
mânăstire	mânăstirilor	Number
copleșitori	copleșitor	Gender
binefăcător	binefăcători	Gender
cotidiană	cotidian	Gender
cooperare	cooperărilor	Number
adorați	adori	Number
acuzarăți	acuzași	Number
sfâșie	sfâșiați	Person
modificam	țipam	lemma
poate	poți	Person
prevestiserăți	prevestisem	Person
poartă	porților	Number
germană	germani	Gender
tunzi	învălurezi	lemma
ferestruitei	ferestruitului	Gender
asigură	asigurară	Number
lună	lunilor	Number
vino	disecă	lemma
vopsește	vopsesc	Person
cerșirăți	cerșiși	Person
tată	taților	Number
carpelă	carpelelor	Number
vădoasa	vădosului	Gender
dramatica	dramaticul	Gender
intempestiv	intempestive	Gender
supravegheați	împăduriți	lemma
sorg	atrofie	lemma
bengalezilor	bengaleza	Gender
mâniase	mâniaserăți	Person
armenei	armenilor	Gender
măreață	măreț	Gender
inutilă	inutili	Gender
canicularului	caniculara	Gender
mirandeze	ghimber	lemma
rescriseră	rescriseși	Person
молдовенескул	молдовенештий	Gender
salutăm	salută	Person
celebrai	celebram	Person
supărați	supăra	Person
sigură	siguri	Gender
baltă	bălților	Number
cronici	cronic	Gender
iert	sunt	lemma
sefarde	vorbărețe	lemma
vânjoșii	vânjosului	Gender
scuipă	scuipăm	Person
furtună	furtunilor	Number
alt	alți	Gender
arogantă	arogant	Gender
măcinăm	dezlipim	lemma
cădeai	cădeau	Person
arși	ars	Gender
rupți	rupte	Gender
soporifici	soporifice	Gender
tipărește	tipăresc	Number
scrotali	scrotal	Gender
spirituale	spiritual	Gender
utilizezi	utilizăm	Person
neașteptată	bălțată	lemma
celebraseră	celebraseși	Person
lungii	lungului	Gender
recunoscută	recunoscut	Gender
accelerație	accelerațiilor	Number
decizi	decide	Person
aduceau	aduceai	Person
schimba	depunea	lemma
documentezi	documentați	Person
oblici	oblice	Gender
masculine	amestecate	lemma
viteji	viteaz	Gender
rezistai	rezistași	Person
emoționase	emoționaseși	Person
năframa	valsul	lemma
prima	vulgara	lemma
măreață	măreți	Gender
tipărește	înfrunzește	lemma
stânjeniră	stânjenirăm	Person
riscat	deplasat	lemma
înfipse	înfipseră	Number
ușă	ușilor	Number
anglican	anglicană	Gender
ură	urilor	Number
nevăzută	episcopală	lemma
prețuiește	prețuiesc	Number
programule	programelor	Number
milos	dialectal	lemma
sistează	deșteaptă	lemma
surprindeai	surprindeau	Person
democraticii	democraticului	Gender
baltic	baltici	Gender
cântaseși	cântaseră	Person
consular	consulară	Gender
nodosului	nodoșilor	Gender
imprimă	destramă	lemma
sexosului	sexoasei	Gender
par	încoronează	lemma
arsei	arșii	Gender
miscibilitate	încredere	lemma
sărează	înfoacă	lemma
susceptibile	susceptibil	Gender
magistrul	amicele	lemma
urdinară	urdinași	Person
olimpice	olimpici	Gender
pornea	îngropa	lemma
joase	joși	Gender
speriaților	căzuților	lemma
ocup	ocupă	Person
reflectat	reflectați	Gender
etimologie	etimologiilor	Number
histologicei	ciclistei	lemma
aromânescul	aromâneștii	Gender
dictezi	dictați	Person
satisfăcea	satisfăceau	Number
ruginise	ruginiseră	Person
pederastice	pederastic	Gender
suverane	suverani	Gender
pregetăm	pregeți	Person
intervin	intervenim	Number
arătase	arătaseră	Person
asemănați	asemănai	Number
castaniului	castaniilor	Gender
futuserăți	futuseră	Person
blestem	blestemă	Person
socotește	socotesc	Number
rațional	rațională	Gender
desculțului	desculții	Gender
cehule	cehilor	Gender
folosise	folosiseră	Number
îndemnați	îndemn	Person
spânzura	spânzurau	Person
digitale	digitali	Gender
abandonabilului	bețivanule	lemma
rezolvaserăți	batjocoriserăți	lemma
psihoză	psihozelor	Number
satisface	satisfac	Person
există	exiști	Person
geamănul	geamăna	Gender
mândrii	mândrul	Gender
sufocase	sufocaseră	Number
murdar	murdară	Gender
subțiri	subțire	Gender
cald	caldă	Gender
jenați	ascuțiți	lemma
încetiserăm	încetiserăți	Person
tehnologic	tehnologici	Gender
incomplete	blege	lemma
rade	convinge	lemma
legendarii	legendarului	Gender
scăpaserăți	scăpaseși	Number
catedrală	catedralelor	Number
inteligentul	formidabilul	lemma
afurisiși	afurisii	Person
strâmți	strâmt	Gender
invit	invităm	Person
făcător	făcătoare	Gender
răbdaseși	răbdaserăți	Number
prăjiți	prăjit	Gender
omniscienți	omnipotent	Gender
lega	legați	Person
briciule	bricelor	Number
omniscientă	deprimată	lemma
lume	lumilor	Number
asigurași	asigură	Person
dialectal	dialectali	Gender
stabilesc	stabilim	Person
mediocre	mediocri	Gender
prietene	prietenilor	Number
acvaticului	acvaticei	Gender
emeriților	emeritei	Gender
prioritate	priorităților	Number
valahul	valahilor	Gender
ponegream	capsulam	lemma
amari	amare	Gender
blonzi	blond	Gender
lipseai	lipsea	Person
cosmic	cosmică	Gender
delicaților	delicatului	Gender
stricat	stricate	Gender
zdrobeați	zdrobeau	Person
ghidăm	ghidați	Person
trântita	trântitul	Gender
prinserăți	ferecarăți	lemma
intoxicaserăți	intoxicaserăm	Person
omniprezent	omniprezentă	Gender
acumulaserăm	crescuserăm	lemma
viteaz	viteji	Gender
creau	creați	Person
catârule	catârilor	Number
discutăm	discută	Person
ploaie	ploilor	Number
opiu	engleză	lemma
nominali	nominale	Gender
îngrijorau	îngrijorați	Person
tereștri	terestră	Gender
scurge	scurgeți	Person
ferestruitei	ferestruitul	Gender
bărbăteștii	bărbătescul	Gender
cheamă	chemăm	Person
nenorociseră	nenorociserăți	Person
remușcare	remușcărilor	Number
reciclată	reciclați	Gender
îmbunătățești	îmbunătățiți	Number
balcanic	balcanici	Gender
înjunghiai	înjunghiară	Person
solară	bolnavă	lemma
reținuseră	reținuse	Person
scumpei	scumpului	Gender
vădoasa	vădoșii	Gender
româneștii	româneasca	Gender
rezolvând	împingând	lemma
terapie	terapiilor	Number
multipolarii	multipolara	Gender
recii	recelui	Gender
împlântau	împlânta	Person
gălbui	gălbuie	Gender
armeancă	armencelor	Number
inflexibilelor	enigmaticelor	lemma
acvaticii	acvaticei	Gender
iertate	gata	lemma
oniric	onirică	Gender
orientau	orienta	Person
mătușă	mătușilor	Number
prăpădesc	prăpădiți	Person
puțini	danezilor	lemma
inflamabilul	inflamabilii	Gender
utilizasem	utilizaserăm	Number
întorceau	întorcea	Number
insidioasă	insidioși	Gender
împrumuta	împrumutam	Person
împăraseși	împărase	Person
ofensatoare	fermecătoare	lemma
nemascată	nemascați	Gender
nimerii	nimeriși	Person
scot	scoți	Person
uitați	uităm	Person
lichida	dureroasa	lemma
lebădă	lebedelor	Number
auriei	auriii	Gender
limbă	limbilor	Number
nodoși	dogmatici	lemma
haoticilor	haoticului	Gender
mâhniseși	mâhniserăți	Number
mărinimoși	mărinimoasă	Gender
producând	înveninând	lemma
invadează	îmbată	lemma
arătați	arăți	Number
șubrezii	șubreda	Gender
biologică	biologici	Gender
accesibilitate	umiditate	lemma
păroși	păroase	Gender
fermă	fermelor	Number
ocroteai	ocroteați	Person
lingușeau	îndurerau	lemma
indiferentele	dururoasele	lemma
pierise	distilase	lemma
obscur	obscuri	Gender
veștejiseră	îngustaseră	lemma
fug	fugiți	Person
narcotizează	cearcă	lemma
cinstește	cinstiți	Person
dezvoltatului	dezvoltata	Gender
orbii	orbirăm	Person
instantul	instanta	Gender
săriră	sări	Number
transcriai	transcriam	Person
nereale	nereal	Gender
nălucă	nălucilor	Number
încoronați	încoronez	Person
suie	sui	Person
inutili	inutil	Gender
descompuserăți	descompuseși	Person
perturbator	perturbatori	Gender
dărăpănaseră	dărăpănasem	Person
blocaseră	blocase	Number
tărăgănași	tărăgănă	Person
plivesc	plivești	Person
speriai	speriau	Person
istoric	istorică	Gender
isteți	istețe	Gender
vulgarii	vulgara	Gender
planetar	planetari	Gender
albanezei	albanezului	Gender
profunzi	catalanilor	lemma
înălțime	înălțimilor	Number
susțineau	înnodau	lemma
apocaliptice	apocaliptici	Gender
disponibililor	disponibila	Gender
îndemnai	îndemnarăm	Number
adevărații	adevăratei	Gender
animam	animau	Person
prinsul	asistatul	lemma
inutil	inutile	Gender
încălțaserăți	încălțase	Person
grăbiții	grăbitului	Gender
sămânță	semințelor	Number
modalitate	modalităților	Number
scapăt	scapătă	Person
puterilor	cerbilor	lemma
râzi	râdeți	Person
contagioșii	contagiosul	Gender
verdele	verde	Gender
pulosul	puloșilor	Gender
prinși	prinsă	Gender
colaboratorii	colaboratoarea	Gender
olandeză	ambianță	lemma
brazilianului	brazilienilor	Gender
țintiți	țintim	Person
atacați	atacăm	Person
alcătuiserăm	alcătuiseră	Person
înnoptai	înnoptarăți	Person
tridimensional	tridimensionali	Gender
salvarăți	salvarăm	Person
ciclista	ciclistului	Gender
verosimilul	verosimililor	Gender
ananasule	ananașilor	Number
dezamăgită	dezamăgit	Gender
toxici	toxic	Gender
obținură	obținu	Person
sigur	siguri	Gender
secreți	secretă	Gender
omenească	omenești	Gender
lâncedului	eroticului	lemma
albastre	albaștri	Gender
perfectul	perfecta	Gender
săturai	săturau	Person
împăunăm	împăunez	Number
limpedea	formidabila	lemma
zdrobesc	zdrobiți	Person
hulit	hulită	Gender
urcate	urcați	Gender
musculoasă	bivalentă	lemma
arșinicule	arșinicilor	Number
ștergătorule	ștergătoarelor	Number
instantă	brumărie	lemma
oră	orelor	Number
înlocuim	înlocuiește	Person
guduram	evingeam	lemma
încăpățânați	încăpățânată	Gender
violeți	violetă	Gender
separați	separi	Number
grecul	atacul	lemma
simetrici	simetrice	Gender
urbanizare	urbanizărilor	Number
trădase	trădaseră	Number
călătorul	călătorule	Gender
inseparabila	inseparabilului	Gender
vamali	vamal	Gender
fac	faci	Person
frecă	frecași	Person
sfulgera	sfulgerai	Person
învăluraserăți	învăluraseși	Person
medicului	medicilor	Gender
miram	mira	Person
rublelor	cimpanzeilor	lemma
satisfac	satisface	Person
inutilă	inutil	Gender
îngrijorai	îngrijorau	Person
caldei	calzii	Gender
versatilei	versatililor	Gender
fertil	fertili	Gender
parazitar	parazitare	Gender
verosimililor	verosimilului	Gender
clarilor	clarul	Gender
stabilirăm	stabilirăți	Person
rusesc	rusești	Gender
specifici	specific	Gender
misterios	misterioși	Gender
mira	clarifica	lemma
îmblânziserăți	îmblânziseși	Number
fumegaseră	fumegaserăm	Person
mistreț	mistreți	Gender
strâmt	susceptibil	lemma
sărbătoriți	încorporați	lemma
rotii	crestai	lemma
continuei	continuul	Gender
îndopau	îndopa	Person
admiră	admir	Person
tehnologică	tehnologic	Gender
păziți	gemeți	lemma
enormei	enormul	Gender
bestiale	bestial	Gender
portocalii	virtuoase	lemma
juvenila	juvenilii	Gender
plac	placi	Person
codificat	codificați	Gender
rezistență	rezistențelor	Number
lungului	dumnezeiescului	lemma
tânărului	tinerilor	Gender
mutase	mutaseși	Person
guvernamentali	guvernamental	Gender
zburdam	zburdau	Person
vizitați	vizitezi	Person
obraznică	obraznici	Gender
acvatică	acvatic	Gender
empirici	empiric	Gender
gâdilă	cunună	lemma
plantară	asimilară	lemma
faci	faceți	Person
port	porți	Person
principala	principalul	Gender
ude	ud	Gender
integrabile	integrabil	Gender
studiez	studiază	Person
turbarăți	turbași	Number
născuse	născuseși	Person
somnoros	somnoroși	Gender
leagă	zbate	lemma
răsufli	răsuflu	Person
fijiană	fijian	Gender
necuviinciosului	necuviincioasei	Gender
spumarăți	spumară	Person
grei	greu	Gender
parazitar	bleu-ului	lemma
pedepsiseși	pedepsisem	Person
știți	știe	Person
alchimică	colorată	lemma
împănaseră	împănaserăm	Person
planta	plantau	Number
inimoșii	inimoasa	Gender
bengalezii	bengaleza	Gender
cuprinsului	cuprinsa	Gender
irlandezii	vânjoasele	lemma
necunoscutei	necunoscutul	Gender
sosule	sosurilor	Number
întoarse	întorși	Gender
sfătuind	auzind	lemma
insulă	insulelor	Number
tincturași	tincturarăți	Number
inexplicabilă	friptă	lemma
săgeată	săgeților	Number
iluzoriului	iluzoria	Gender
lămâie	lămâilor	Number
dansaserăm	dansaserăți	Person
repeziseși	repezise	Person
înjunghii	înjunghiem	Number
economica	economicului	Gender
eră	erelor	Number
adulmecasem	adulmecase	Person
redundante	redundant	Gender
dezbinase	dezbinaseră	Person
cloceam	cloceau	Person
ascuțiți	ascute	Person
asimilau	asimila	Person
îngereasca	îngereștilor	Gender
spinosul	spinoasei	Gender
specificului	specificii	Gender
zbier	zbierați	Person
bieți	biete	Gender
desziceți	deszici	Number
salariaților	salariatului	Gender
plictisirăm	plictisiră	Person
scornești	cari	lemma
delimitaseși	delimitaserăți	Number
tincturaserăm	tincturaseră	Person
ofensatoarea	alta	lemma
înveninați	înveninează	Person
îngrijesc	îngrijește	Number
urâți	urât	Gender
cucerești	cucerim	Person
rătăcitul	rătăciții	Gender
uscat	uscată	Gender
simplei	simplii	Gender
botezaților	botezatul	Gender
pingeliserăm	pingelisem	Number
stimulați	stimula	Person
lungul	lungii	Gender
părăsite	unidirecționale	lemma
afină	afinelor	Number
prăpădeam	prăpădea	Person
părăsiți	părăsite	Gender
apocaliptici	apocaliptic	Gender
oprește	dejugă	lemma
distra	distram	Person
surda	surzii	Gender
judeci	judecați	Number
spaniolul	spaniolule	Gender
enigmatic	enigmatică	Gender
sașii	sașiu	Gender
temelie	temeliilor	Number
inseparabili	inseparabil	Gender
prăjitul	prăjitei	Gender
prostește	îndeletnicește	lemma
maghiarului	maghiara	Gender
nemiloasă	nemiloși	Gender
delirantului	deliranții	Gender
descurcăreț	descurcăreață	Gender
timizii	timidei	Gender
casă	caselor	Number
neprietenoșilor	șterșilor	lemma
singurul	singurei	Gender
valahi	valah	Gender
strâmbă	strâmbați	Person
aleg	alege	Number
simfonie	simfoniilor	Number
muzicala	muzicalului	Gender
bază	bazai	Person
prescriu	prescrie	Number
scurta	scurtului	Gender
fluieră	fluier	Person
buiastra	buieștrilor	Gender
iertarăm	compuserăm	lemma
abilitatea	biotitul	lemma
sporește	sporim	Person
tentaserăm	tentaserăți	Person
carnivora	carnivorilor	Gender
uscatei	uscatului	Gender
noi	geografice	lemma
albicios	albicioși	Gender
inexprimabililor	inexprimabilei	Gender
mândrei	mândrul	Gender
salamandră	salamandrelor	Number
conduserăm	conduseși	Person
îngâmfa	îngâmfam	Person
vizitare	vizitărilor	Number
nenorocim	nenorocesc	Person
domnie	domniilor	Number
exagerase	exageraserăți	Person
stupizilor	stupidul	Gender
burtoasă	burtoși	Gender
integralului	integralilor	Gender
sulfuros	sulfuroase	Gender
poate	puteți	Person
jalnice	молдовенешть	lemma
digital	digitale	Gender
lâncede	electromagnetice	lemma
prezentă	zemoasă	lemma
homofobica	homofobicii	Gender
dezamăgit	dezamăgite	Gender
pierim	pieriți	Person
românesc	exotic	lemma
aciuaserăm	întremaserăm	lemma
nemiloasă	nemilos	Gender
rănești	forțezi	lemma
alungi	alungăm	Person
binari	binar	Gender
minusculi	minuscule	Gender
sistară	sistarăți	Person
induserăți	induseși	Number
introduseră	dreseră	lemma
emoțional	emoționali	Gender
îngropați	îngropăm	Person
spectrala	diurna	lemma
integralii	caraghioșii	lemma
oblic	oblică	Gender
justiții	vegetarianism	lemma
încăpățânată	încăpățânați	Gender
baie	băilor	Number
albicioase	albicioși	Gender
râm	dublez	lemma
adânciseși	adânciserăm	Person
morți	mort	Gender
ultimului	ultimilor	Gender
împreunaserăm	împreunase	Person
emeritului	emerita	Gender
naivi	naive	Gender
refuzăm	refuzi	Person
senina	seninului	Gender
șterse	șters	Gender
acuzați	așterneți	lemma
venerăm	venerează	Person
voioasă	voios	Gender
veninoasă	veninoși	Gender
rasă	ras	Gender
indiscrete	indiscret	Gender
mărunt	mărunte	Gender
roșii	roasa	Gender
fluvial	fluviale	Gender
orbeam	orbeai	Person
aprigi	aprige	Gender
iertate	iertat	Gender
haitienii	haitienei	Gender
dumicam	dumicau	Person
amfibiu	amfibii	Gender
lipiserăm	lipisem	Person
recunoaște	recunoașteți	Person
scoatem	scot	Person
nelucrații	nelucratului	Gender
spartul	sparta	Gender
credincioasa	credincioșilor	Gender
vesel	veselă	Gender
ții	ține	Person
făgăduiseră	făgăduiseși	Person
stângă	stângi	Gender
șterși	șterse	Gender
storc	despart	lemma
putred	putredă	Gender
mințitoare	mințitori	Gender
ciudat	ciudați	Gender
convinge	convingi	Person
osoși	osoase	Gender
eternitate	eternităților	Number
oștile	usturoii	lemma
simplului	simplei	Gender
violetă	violeți	Gender
antropoidule	antropoizilor	Number
prânzesc	prânzim	Person
smuls	chițcăit	lemma
simplificai	simplificam	Person
nativ	nativă	Gender
geamăn	gemene	Gender
abundență	îmbătrânire	lemma
cerbule	cerbilor	Number
circumcizie	circumciziilor	Number
îmbărbătați	îmbărbăta	Person
cicliștii	ciclista	Gender
sminteau	sminteam	Person
scumpi	scumpă	Gender
lesbian	lesbieni	Gender
mangustă	mangustelor	Number
unilateral	unilaterale	Gender
intervenim	intervin	Person
secundari	secundare	Gender
jugarii	suspensoarele	lemma
împrăștie	împrăștiași	Person
întregului	întregilor	Gender
introductiv	introductive	Gender
stric	stricăm	Number
glumiți	glumești	Number
cuvios	cuvioasă	Gender
jurasem	juraserăți	Person
credincios	credincioase	Gender
invincibilitate	foame	lemma
rămâi	încercuiește	lemma
chimici	chimică	Gender
roșu	roșii	Gender
parcarăm	desenarăm	lemma
luminoase	erotice	lemma
scufundate	criticabile	lemma
citești	citește	Person
locuiesc	aplic	lemma
mustrași	mustrarăți	Person
dezvoltați	dezvoltat	Gender
răgușiților	răgușitului	Gender
absorbiși	absorbi	Person
implici	implică	Person
silabă	silabelor	Number
castanie	castaniu	Gender
lăsați	lăsat	Gender
singura	avutul	lemma
admiraseră	admiraserăm	Person
olimpic	veninos	lemma
otrăvind	distrugând	lemma
răsunaserăm	răsunasem	Person
cufureați	cufuream	Person
conteniși	contenii	Person
acrișorului	acrișorilor	Gender
societate	societăților	Number
cinetic	cinetică	Gender
găinarii	fosta	lemma
analogica	analogicilor	Gender
native	nativi	Gender
subteran	subterani	Gender
hazlii	utili	lemma
scăldaserăm	scăldaserăți	Person
treziți	trezești	Number
scufundatul	scufundații	Gender
nearticulat	uimitor	lemma
carnivorul	carnivorei	Gender
românescul	româneasca	Gender
verișoară	verișoarelor	Number
tranzientului	tranzienta	Gender
amfibie	amfibiu	Gender
lugubră	lugubru	Gender
traduc	traducem	Number
puținii	puținul	Gender
scuturi	comporți	lemma
vie	viu	Gender
puternicilor	puternicei	Gender
tatua	tatuau	Number
funcționam	funcționai	Person
puteți	poți	Person
reușești	reușesc	Person
binari	binară	Gender
soporifici	soporifică	Gender
îmbunătățiseră	îmbunătățisem	Person
relaxat	relaxate	Gender
zonă	zonelor	Number
înfășurase	înfășuraseră	Number
prăpădiseră	prăpădise	Number
trimiseseră	trimisese	Person
sefarda	sefarzii	Gender
doriră	doriși	Person
femeie	femeilor	Number
aplică	aplic	Person
sparții	spartului	Gender
limpezi	limpede	Gender
încăpățânat	încăpățânați	Gender
umple	umpleți	Person
supreme	supremi	Gender
slugăriți	slugăresc	Person
afumaseși	afumaseră	Person
activitățile	cronometrarea	lemma
trăsnise	înviorase	lemma
dezlegă	dezlegarăți	Person
genetica	geneticul	Gender
desenarăți	desenarăm	Person
chemați	chemăm	Person
aroganții	arogantei	Gender
ilegali	urâți	lemma
greul	toxicul	lemma
macrii	macrului	Gender
morfologie	înțelepciune	lemma
augurași	augurarăm	Person
razi	rad	Person
sfericilor	sferica	Gender
lanurilor	globalizării	lemma
lutoasei	lutoșilor	Gender
însoțiserăm	însoțiseră	Person
necontestate	necontestat	Gender
nefertilizați	nefertilizat	Gender
colorată	colorat	Gender
intenționau	intenționa	Person
neutra	neutrilor	Gender
plăcintă	plăcintelor	Number
băuților	băutul	Gender
ridica	ridicați	Person
abili	abil	Gender
pavaseși	cuveniseși	lemma
mămică	mămicilor	Number
sigure	amicale	lemma
masturbez	masturbează	Person
biologică	biologic	Gender
insurmontabila	insurmontabililor	Gender
putere	puterilor	Number
completează	completezi	Person
rostea	rosteau	Number
geograficilor	geografica	Gender
ținut	ținuți	Gender
surzilor	surdul	Gender
naiva	naivului	Gender
desena	desenau	Number
lingvistică	lingvistic	Gender
gras	grasă	Gender
hazliu	hazlie	Gender
prepuțialii	filamentoșii	lemma
ilegale	ilegali	Gender
rotundă	rotunzi	Gender
respect	zoologii	lemma
tresărit	împroprietărit	lemma
tăios	tăioși	Gender
afumaseși	afumaserăți	Person
canicularii	canicularului	Gender
aram	arai	Person
reparabil	reparabilă	Gender
scărmănăm	atacăm	lemma
atotputernicei	atotputernicii	Gender
alee	aleilor	Number
măturat	întărit	lemma
preistorice	strălucitoare	lemma
șubredă	șubred	Gender
intern	interne	Gender
castelule	castelelor	Number
intervine	intervin	Person
astroidă	astroidelor	Number
ascunse	ascunși	Gender
acumulează	îndeasă	lemma
economica	economicii	Gender
intactă	intact	Gender
lucrători	blonzi	lemma
mucede	străvechi	lemma
șterge	ștergeți	Person
integrali	integrală	Gender
sutimile	botroșul	lemma
susurați	susurai	Person
tușiserăți	tușise	Person
păros	păroasă	Gender
apăraserăm	apăraseră	Person
artistică	artistici	Gender
coborâți	coborât	Gender
terminați	ziceți	lemma
onirici	oniric	Gender
pumnalul	vidra	lemma
arogant	arogantă	Gender
desculțe	desculț	Gender
vindecăm	vindecați	Person
slab	slabă	Gender
tincturase	descheiase	lemma
legendari	legendar	Gender
scuturase	scuturaserăți	Person
fulgeraseși	fulgeraserăți	Number
agerilor	agerei	Gender
mărunțit	aprins	lemma
clociți	clocesc	Person
hazlii	bestiale	lemma
crezuseră	crezuse	Number
căzuse	căzuseră	Number
sapă	sap	Person
umbrelă	umbrelelor	Number
încurați	încuram	Person
observă	știe	lemma
tinse	tinsei	Person
credință	credințelor	Number
stufule	stufurilor	Number
terapeutica	terapeuticilor	Gender
speriate	speriat	Gender
învechiților	învechitului	Gender
murdar	alt	lemma
roșiilor	roșul	Gender
iritam	iritai	Person
îndeasă	îndesați	Person
mucos	vărgat	lemma
sărbătorea	sărbătoreau	Number
patrie	patriilor	Number
indiscreta	indiscretului	Gender
atotputernica	atotputernicului	Gender
subterani	subterane	Gender
violet	violeți	Gender
vacă	vacilor	Number
grăbite	terestre	lemma
dormit	dormităm	Person
groasa	groșilor	Gender
puțini	puține	Gender
scoapseserăți	fundaserăți	lemma
ziceai	ziceau	Person
jupoaie	întortochează	lemma
beat	bete	Gender
antagonicilor	antagonicul	Gender
heterosexualitate	ubicuitate	lemma
intranzitiv	intranzitive	Gender
bălăise	bălăiseră	Person
pavați	pavezi	Person
săgetase	săgetaseși	Person
răsturnați	răsturnai	Person
impuseseră	impusese	Person
cornută	cornut	Gender
invincibila	invincibilul	Gender
pace	caisă	lemma
ocupaseră	forfotiseră	lemma
grăbirăm	grăbiși	Person
legendarilor	legendarului	Gender
râvniseră	întrezăriseră	lemma
moașă	moașelor	Number
persanului	tridimensional	lemma
supărat	șerbit	lemma
moarta	morții	Gender
cineticilor	cinetica	Gender
putință	fală	lemma
înmormântai	înmormânta	Person
înțelesului	înțelesurilor	Gender
publicitate	antimaterie	lemma
urmezi	urmează	Person
ușurai	ușuram	Person
intempestiva	intempestivii	Gender
experimentați	experimentată	Gender
cunoscut	cunoscute	Gender
dumnezeiescului	dumnezeieștii	Gender
inesteticului	dezavantajosului	lemma
desenăm	desenați	Person
tăioase	tăioși	Gender
răsuflaserăți	învioraserăți	lemma
pregăteați	pregăteau	Person
nechibzuiții	nechibzuita	Gender
azotoși	azotoasă	Gender
naivilor	străvechilor	lemma
oneste	onești	Gender
putrede	putrezi	Gender
tridimensionalei	tridimensionalii	Gender
circulai	circulau	Person
călcăm	călcați	Person
omnipotență	geologie	lemma
apucaserăți	apucaserăm	Person
echipajule	echipajelor	Number
descoperi	descoperii	Person
veselă	veseli	Gender
germanul	germana	Gender
părâng	colastră	lemma
amfibie	amfibii	Gender
geneticii	genetica	Gender
secvențialei	secvențialilor	Gender
muistelor	dozărilor	lemma
suceați	suceai	Person
impuneți	impune	Person
pregnante	umbroase	lemma
geografici	geografic	Gender
susceptibil	susceptibile	Gender
ieșire	ieșirilor	Number
monoaxialei	monoaxialului	Gender
chei	cheală	Gender
argilosul	argiloșii	Gender
stăpâniți	completați	lemma
evreică	evreicelor	Number
mișca	cernea	lemma
întors	întoarse	Gender
graniță	granițelor	Number
spurcat	spurcată	Gender
borâseră	borâsem	Person
învățaseși	învățase	Person
venericului	venericii	Gender
tremuram	tremurau	Person
completăm	completați	Person
bravilor	bravului	Gender
împresurai	împresurarăți	Person
găină	găinilor	Number
prezentei	prezentul	Gender
lipiciule	lipiciurilor	Number
dorește	doresc	Number
pasat	încruntat	lemma
veșnicei	veșnicii	Gender
propunea	propuneau	Person
agresive	amare	lemma
înfrățiți	înfrățește	Person
blocau	bloca	Person
greșea	funcționa	lemma
risca	înlătura	lemma
degeră	degerași	Person
opărita	opăritul	Gender
eronat	eronate	Gender
mărită	țese	lemma
acnee	gnosticism	lemma
violeți	violet	Gender
sălbatica	sălbaticilor	Gender
sefarda	sefarzilor	Gender
dulcilor	dulcea	Gender
oule	ouălor	Number
căzuți	căzute	Gender
exotici	exotice	Gender
strigoiule	strigoilor	Number
mediocră	mediocri	Gender
dubioși	dubioase	Gender
timidă	timizi	Gender
sărbătoriți	sărbătoresc	Person
profunzi	profundă	Gender
saluți	salută	Person
muiați	muia	Person
binefăcătorul	binefăcătorii	Gender
brune	bruni	Gender
plumburiu	vârtos	lemma
saturează	cântă	lemma
inteligent	sântului	lemma
venezueleană	venezueleni	Gender
anticului	anticilor	Gender
național	flămând	lemma
cruda	crudul	Gender
ortopedie	uniformitate	lemma
tehnologicii	tehnologicei	Gender
răgușită	răgușit	Gender
colaboratorului	colaboratorii	Gender
politizare	colțunule	lemma
abandonau	abandona	Number
mureau	murea	Person
sclavă	sclavelor	Number
bivalenții	bivalentului	Gender
răsturnați	răstorn	Person
păpară	păpă	Number
stana	apărarea	lemma
mori	moare	Person
intacți	intactă	Gender
stabilității	vigilenței	lemma
fierții	fiarta	Gender
distrugeați	distrugeam	Person
rumeg	rumegăm	Number
măreței	mărețul	Gender
binar	binari	Gender
străvăzuse	străvăzuseră	Person
umpli	umpleți	Person
pisară	pisarăm	Person
cotidianului	cotidienei	Gender
gravitau	gravita	Person
plăcere	plăcerilor	Number
veniți	vii	Person
vântoasa	vântoșii	Gender
alintați	alintai	Person
înlocuiați	înlocuiau	Person
ultimii	ultimul	Gender
nelucraților	nelucratul	Gender
pictez	pictează	Person
voioși	voios	Gender
sperie	sperii	Person
portocaliu	portocalii	Gender
răsuciseși	azvârliseși	lemma
fijienii	fijianul	Gender
rozelor	genunchilor	lemma
ilegal	ilegală	Gender
asurzi	asurziși	Person
actriță	actrițelor	Number
lucrător	lucrătoare	Gender
scăpără	scăpărară	Person
nerecunoscute	nerecunoscut	Gender
trăncănii	trăncănirăți	Person
lungă	lungi	Gender
terapeutici	terapeutic	Gender
plăcut	toxic	lemma
căzut	căzute	Gender
credincioasa	credinciosul	Gender
istorici	cotidieni	lemma
invitaserăm	invitaseși	Person
mamuților	tuburilor	lemma
intempestiv	șubred	lemma
plicticos	capitalist	lemma
prevestirăm	ferecarăm	lemma
reflectaților	reflectata	Gender
uzi	udă	Gender
acuzații	acuzatul	Gender
părăsită	șchioapă	lemma
spuserăm	spuse	Person
amânăm	amână	Person
porți	poartă	Person
bleaga	blegii	Gender
pregnanților	digitalilor	lemma
maghiare	furioase	lemma
mincinoasă	mincinoși	Gender
depunem	depun	Person
istoricul	istoricei	Gender
aurii	auriu	Gender
ușuratica	ușuraticului	Gender
râse	râseră	Person
sătulei	sătulul	Gender
interziseră	interzise	Number
nevăzutului	nevăzuţilor	Gender
slăbi	slăbiși	Person
râdeau	râdea	Number
atlantici	atlantic	Gender
culegeau	culegeam	Person
mistreților	mistrețului	Gender
aciuaseră	aciuaseși	Person
logodeai	logodeați	Number
omenii	tenacități	lemma
monocrome	monocrom	Gender
gătesc	gătește	Person
evoluție	evoluțiilor	Number
slăbiserăți	dezmățaserăți	lemma
urmăriți	urmărești	Person
serveau	servea	Person
clădire	clădirilor	Number
naționalul	naționalii	Gender
legat	întrerupt	lemma
râncede	bulgărești	lemma
învechiseși	învechiserăți	Person
neurobiologie	cană	lemma
monocromă	dulce	lemma
refeca	învălura	lemma
albastrului	albaștrilor	Gender
amestecat	amestecați	Gender
regaliste	regaliști	Gender
opăritele	văduvii	lemma
nechibzuite	terții	lemma
speteai	speteați	Number
maghiar	maghiari	Gender
apărară	apărai	Person
curățați	curăți	Number
afundarăm	afundai	Person
obscurului	obscura	Gender
recuperează	recuperez	Person
demna	demnul	Gender
criticabilii	criticabilul	Gender
exterioară	exterior	Gender
dăpărarăți	dăpărarăm	Person
brunii	bruna	Gender
principală	principal	Gender
capitalist	capitalistă	Gender
nenumărabilă	nenumărabil	Gender
simțea	simțeau	Person
încurajează	încurajați	Person
admirași	admiră	Person
aloe	aloelor	Number
scarpină	aplică	lemma
inflexibili	inflexibil	Gender
puturos	puturoasă	Gender
ghici	ghiciră	Person
creativa	creativul	Gender
repedele	repezilor	Gender
creați	creezi	Number
săpași	cântași	lemma
spăl	înnegurez	lemma
rumegași	rumegarăm	Person
mincinoasa	mincinoșilor	Gender
spetisem	spetiserăm	Number
aninasem	aninase	Person
deșteptul	deștepții	Gender
asimilau	asimila	Number
albinos	albinoasă	Gender
sănătosul	sănătoasei	Gender
nucșoară	nucșoarelor	Number
concepea	concepeau	Number
nostalgic	nostalgice	Gender
mestecași	mestecarăți	Person
copleșitoarei	copleșitorului	Gender
locuință	locuințelor	Number
plăcută	plăcuți	Gender
răscoapseseși	explicaseși	lemma
netezim	neteziți	Person
dependenți	dependent	Gender
amenințare	amenințărilor	Number
geamule	geamurilor	Number
scăzurăm	scăzui	Person
reali	real	Gender
calzi	cald	Gender
borcanule	borcanelor	Number
raționalizabil	raționalizabili	Gender
domesticire	domesticirilor	Number
rusă	deism	lemma
aleatoriului	aleatoriei	Gender
iluzoria	iluzoriilor	Gender
reduseși	reduseră	Person
ațipiserăm	ațipiseși	Person
stânjeneați	stânjeneam	Person
simetric	simetrică	Gender
părintescului	părinteasca	Gender
obligă	obligai	Person
merită	meriți	Person
rog	rugăm	Number
orbului	orbilor	Gender
vedea	ara	lemma
maiestate	berbecule	lemma
franțuzesc	franțuzești	Gender
nisipoase	nisipos	Gender
pingeliserăți	bazaserăți	lemma
strecuraserăm	înveliserăm	lemma
anterior	anteriori	Gender
scânteie	copie	lemma
induseră	induserăm	Person
țintiți	țintești	Person
sălbatici	sălbatică	Gender
terapeutica	terapeuticul	Gender
culeserăm	culeseră	Person
oprii	opri	Person
străbătând	comportând	lemma
halucinarăm	halucinași	Person
digitalilor	digitalul	Gender
intelectule	configurare	lemma
preajmă	antropologie	lemma
profundă	bej	lemma
coapsei	coapse	Person
concentrați	concentrate	Gender
fug	fugi	Person
aleatoriu	aleatorii	Gender
despădurire	despăduririlor	Number
prună	prunelor	Number
visau	visa	Person
fixam	fixați	Person
omniprezenți	omniprezentă	Gender
bolnavi	bolnav	Gender
conving	convingi	Person
uitarăm	dobândirăm	lemma
încrunt	încruntă	Person
diurni	diurnă	Gender
trompetă	trompetelor	Number
pictați	pictat	Gender
real	reală	Gender
tare	tari	Gender
suveran	suverani	Gender
atent	atentă	Gender
ofileați	ofileam	Person
scumpiși	scumpirăți	Person
tăietură	tăieturilor	Number
popularei	popularii	Gender
călătorului	călătorilor	Gender
refecaseși	încercaseși	lemma
roși	roasă	Gender
pitorești	cumplite	lemma
catargule	catargelor	Number
dăpărarăți	dăpărași	Person
scaperi	scapăr	Person
revoluție	revoluțiilor	Number
atenți	atentă	Gender
violeții	violetei	Gender
crescut	crescute	Gender
ghicesc	ghicește	Person
planetarei	planetarului	Gender
redundant	amical	lemma
deprimat	deprimați	Gender
șeasa	șeșilor	Gender
disponibili	disponibil	Gender
important	importantă	Gender
pedeapsă	pedepselor	Number
necontestatul	necontestata	Gender
știrb	știrbi	Gender
sferic	terestru	lemma
porno	britanice	lemma
judecații	judecatului	Gender
ilegal	ilegale	Gender
ușuratic	ușuratică	Gender
terestră	tereștri	Gender
neregali	neregale	Gender
insult	insultați	Person
speriate	speriați	Gender
grea	castanie	lemma
slabului	slaba	Gender
principal	principală	Gender
semnați	semnează	Person
rădăcină	rădăcinilor	Number
criticului	critica	Gender
haitiana	diastolica	lemma
dezvoltatul	dezvoltații	Gender
relaxată	relaxat	Gender
abdicau	făceau	lemma
podișule	podișurilor	Number
reduseși	reduse	Person
acoperite	coapte	lemma
câmpenești	câmpenesc	Gender
îndobitocii	îndobitocirăm	Person
scremuseși	înghesuiseși	lemma
răsfață	dispune	lemma
cercetează	cercetez	Person
strălucitori	strălucitoare	Gender
cunoscute	cunoscut	Gender
rescrieți	rescrie	Person
asistate	asistați	Gender
surprins	înghețat	lemma
distingeați	distingeam	Person
grotă	grotelor	Number
colaboratorului	colaboratorilor	Gender
tărăgănați	tărăgănam	Person
copți	copt	Gender
arbore	arborilor	Number
meduză	meduzelor	Number
copleșiți	copleșește	Person
onirici	onirice	Gender
inimă	inimilor	Number
sună	sun	Person
laia	lăilor	Gender
fierte	fiert	Gender
vulgar	vulgare	Gender
azotoasa	azotosul	Gender
convingători	convingătoare	Gender
președinte	președinților	Number
pornea	porneau	Number
purpuriu	focos	lemma
evazive	evaziv	Gender
asiguri	asigurați	Number
făleai	fălea	Person
zdrobim	zdrobesc	Number
scăpaserăți	îmbucaserăți	lemma
curate	curați	Gender
circumscriu	circumscrie	Number
dărăceau	dărăceați	Person
legal	legali	Gender
moarta	morților	Gender
amabili	amabil	Gender
ruptul	bravul	lemma
făceai	făceam	Person
transpir	transpiri	Person
juisez	juisezi	Person
otrăveam	otrăvea	Person
tranzitiva	tranzitivii	Gender
fricoasa	fricosul	Gender
eterogenii	eterogenul	Gender
eliberați	eliberezi	Number
proporțională	proporțional	Gender
turbai	turbarăm	Person
dezrădăcinezi	dezrădăcinați	Number
lăsați	las	Person
brumăriului	brumăriei	Gender
anusule	anusurilor	Number
împlântați	împlântă	Person
surdul	surzii	Gender
viteji	vitează	Gender
suverani	suveran	Gender
borî	borâră	Number
forțaseră	forțase	Person
pietate	sud	lemma
avantajule	avantajelor	Number
părinte	părinților	Number
adăstăm	ferim	lemma
slăbiserăți	slăbiseși	Number
dialectali	dialectal	Gender
sfinxului	eventualității	lemma
rulați	rulăm	Person
comportați	comportăm	Person
rețin	reține	Person
părusem	păruseși	Person
apropii	apropiem	Person
stăpânule	stăpânilor	Number
înfăptuim	înfăptuiți	Person
histologice	histologici	Gender
simetrie	simetriilor	Number
dumnezeule	dumnezeilor	Number
zăpăceală	zăpăcelilor	Number
abnegații	atrofii	lemma
pescoasei	pescoșii	Gender
udaserăm	udasem	Number
carboxilic	carboxilici	Gender
înclinarăți	înclinași	Person
jur	jură	Person
dezgroparăți	dezgropași	Person
călcaseși	călcaserăm	Person
cultură	culturilor	Number
desfirasem	desfiraseși	Person
albastrul	albaștrilor	Gender
slavei	bucureștenilor	lemma
capră	caprelor	Number
viguros	viguroase	Gender
sorbeam	sorbeai	Person
acoperite	acoperiți	Gender
adormiți	adormită	Gender
renovaserăți	renovase	Person
mărunți	mărunte	Gender
gură	gurilor	Number
răspândiți	răspândește	Person
investitorului	craniului	lemma
religioșii	religiosul	Gender
umflam	înduram	lemma
băgară	băgă	Number
eliminați	eliminam	Person
tovărășeștilor	tovărășescul	Gender
urmărire	urmăririlor	Number
pictarăm	pictară	Person
muntoasă	muntoși	Gender
limpezi	bulgărești	lemma
ieftin	ieftine	Gender
planetare	cărnoase	lemma
țesură	țesu	Person
preistoric	argintiu	lemma
faci	fac	Person
eprubetă	eprubetelor	Number
retează	încarcă	lemma
castanie	castanii	Gender
știm	știu	Person
ginere	ginerilor	Number
coapsă	coapselor	Number
rumegaseră	îngâmfaseră	lemma
nimerim	nimerești	Person
groși	gros	Gender
neprietenos	neprietenoasă	Gender
țigănească	țigănești	Gender
aprigi	aprig	Gender
atent	atenți	Gender
miști	mișcați	Person
tereștri	terestre	Gender
brutali	brutale	Gender
tânjesc	tânjește	Number
delicați	delicat	Gender
modificam	modificau	Person
urzea	ferea	lemma
admiră	admiri	Person
alba	albului	Gender
critice	critici	Gender
soporificei	soporificii	Gender
rescrie	cuprinde	lemma
adormit	adormiți	Gender
vitregi	vitrege	Gender
chel	cheală	Gender
pregnanți	pregnante	Gender
intima	dura	lemma
lutră	lutrelor	Number
sefarde	sefard	Gender
jucași	vărsași	lemma
murdare	murdar	Gender
obscena	centrala	lemma
bucurosul	bucuroșii	Gender
strâmbă	strâmbi	Person
contraziceau	contrazicea	Person
îmbunătățim	îmbunătățești	Person
vitează	viteaz	Gender
suverană	suverani	Gender
slabului	slabei	Gender
grapă	grapelor	Number
kidnapping	creștinism	lemma
scărmănarăm	scărmănarăți	Person
topește	topești	Person
borăsc	borâm	Number
munte	munților	Number
haotice	haotici	Gender
umblați	civiizați	lemma
dogmatic	dogmatici	Gender
lăudaserăm	lăudaseși	Person
sparserăți	gazarăți	lemma
unicei	unicul	Gender
scumpul	frățescul	lemma
bisericoasei	bisericosul	Gender
străbate	curmă	lemma
inflexibil	inflexibili	Gender
saturez	descalec	lemma
cornut	cornute	Gender
nivelară	nivelași	Person
delimitare	delimitărilor	Number
analogie	analogiilor	Number
simțiserăți	băuserăți	lemma
continentali	continentale	Gender
șchioapei	șchiopul	Gender
iernau	înfățișau	lemma
judecații	judecata	Gender
turtiseși	turtise	Person
menții	caci	lemma
veseli	vesele	Gender
pătrundeau	pătrundea	Person
transatlanticilor	transatlanticei	Gender
slava	slavilor	Gender
lină	lini	Gender
fumuriei	fumuriii	Gender
coceau	coceam	Person
orgasmicul	zemosul	lemma
școlar	școlară	Gender
șterși	șters	Gender
criticii	criticul	Gender
crescut	crescuți	Gender
feminini	feminine	Gender
adorabilului	adorabililor	Gender
raționalizabil	raționalizabilă	Gender
perinealilor	perinealului	Gender
înjurați	înjurau	Person
arogantei	arogantului	Gender
intenționară	dictară	lemma
nevestelor	arinilor	lemma
relaxate	franțuzești	lemma
adormit	adormite	Gender
scormonesc	scormonim	Person
scufundași	scufundai	Person
planetarul	planetara	Gender
elementar	elementari	Gender
necuviinciosului	necuviincioșii	Gender
abandonează	abandonăm	Person
înghesuie	înghesuiți	Person
obezului	obezii	Gender
mâzgălim	descuiem	lemma
înfuriași	înfuriarăți	Number
abdominale	abdominali	Gender
judecat	judecați	Gender
trăgănaseră	coapseseră	lemma
legalii	legala	Gender
criticul	criticei	Gender
luminoasă	luminos	Gender
albicios	cartezian	lemma
scrieți	scriu	Person
japonezilor	carnivori	lemma
luptăm	lupt	Number
albanezul	albanezilor	Gender
importantului	importantei	Gender
viteazul	vitejilor	Gender
căutau	căutai	Person
aplecă	aplecară	Person
amestecat	amestecate	Gender
stricarăm	întristarăm	lemma
milimetric	milimetrice	Gender
dialectali	dialectală	Gender
românescul	cenușiul	lemma
lucrători	lucrător	Gender
scurm	scurmăm	Number
botezaserăți	botezasem	Person
ținutul	ținuta	Gender
speriați	speriată	Gender
actrițelor	violurilor	lemma
cunoscuții	cunoscutul	Gender
specialitate	specialităților	Number
viteze	viteaz	Gender
naționalul	naționalei	Gender
hibernează	hibernăm	Person
răbojirăți	distilarăți	lemma
gospodarului	gospodarilor	Gender
netede	viteze	lemma
mâncase	mâncaseră	Number
conjuncție	conjuncțiilor	Number
dureros	dureroase	Gender
corcesc	corciți	Person
bietului	bieții	Gender
elementara	elementarul	Gender
greu	grele	Gender
împinseseră	împinseseși	Person
mistificarăți	mistificai	Person
supune	desfată	lemma
pricep	înrâuresc	lemma
virotic	virotici	Gender
muntos	muntoasă	Gender
dezgheață	dezghețăm	Person
redundante	exotice	lemma
însuflețeam	însuflețeai	Person
amanetă	amanetarăm	Person
fumuriu	fumurii	Gender
mărginiserăm	mărginiseși	Person
naivă	naivi	Gender
buiestre	buieștri	Gender
tristă	triști	Gender
haotici	haotic	Gender
prevestisem	prevestiseră	Person
moșierule	moșierilor	Number
urâții	urâtul	Gender
sătui	sătul	Gender
copleșitoarei	copleșitorilor	Gender
neguroșilor	negurosul	Gender
canoni	canoniră	Number
nudism	cubism	lemma
poștalilor	poștalei	Gender
amentule	amenților	Number
ferestruitei	ferestruiților	Gender
aprig	aprigă	Gender
sferică	sferic	Gender
simțiserăm	simțiserăți	Person
nocturnul	nocturna	Gender
întindem	întind	Number
subscriu	flămânzesc	lemma
pișam	descuiam	lemma
incompleți	incompletă	Gender
macabrii	macabrul	Gender
asturianule	asturienilor	Gender
pârghie	pârghiilor	Number
parazitare	dezgustătoare	lemma
neașteptatului	cosmicului	lemma
acvatice	dungate	lemma
copleșeai	copleșeau	Person
cooperaserăți	cooperaseși	Number
haoticii	haotica	Gender
primii	primului	Gender
spurcai	spurcarăți	Person
lingușit	controlat	lemma
răscoceau	răscocea	Person
enigmaticului	enigmatica	Gender
avortezi	avortează	Person
intim	intimi	Gender
veștejești	veștejește	Person
sexuali	sexuală	Gender
artisticul	artisticei	Gender
descoperiseră	descoperiserăm	Person
dublă	dublu	Gender
sparge	sparg	Number
macabrului	macabra	Gender
încurajaseră	încurajaseși	Person
folositori	folositor	Gender
primilor	primului	Gender
revistă	revistelor	Number
răbdai	răbdam	Person
prezenți	prezente	Gender
groșii	groasei	Gender
polisierule	polisierelor	Number
urcată	urcat	Gender
botezate	botezat	Gender
mișcaseși	desfăcuseși	lemma
întrebare	întrebărilor	Number
lipsește	fumegă	lemma
slugărirăm	slugărirăți	Person
finlandezul	finlandezule	Gender
roasei	roșilor	Gender
îmbătaseră	îmbătaseși	Person
floare	florilor	Number
adorabil	adorabili	Gender
puținii	puțina	Gender
lin	lină	Gender
mouse-ule	mouse-urilor	Number
disponibilii	disponibilei	Gender
vizualizează	documentează	lemma
scurta	ezita	lemma
nerezervată	fragedă	lemma
scrotali	scrotale	Gender
digital	digitală	Gender
continuu	continuă	Gender
sumeteți	dedați	lemma
trepădasem	trepădase	Person
aduceau	aduceam	Person
legătură	legăturilor	Number
neuitabilul	neuitabila	Gender
dezmierdaserăți	dezmierdaseși	Person
crucificasem	crucificaseră	Person
imaturitate	biologie	lemma
vasule	vaselor	Number
înlocuiți	înlocuiește	Person
cumințea	cumințeai	Person
fericită	fericit	Gender
epuiză	epuizară	Number
concentratului	concentratei	Gender
conjugarăți	conjugă	Person
jignesc	jignește	Number
rugase	fusese	lemma
viguroase	viguroși	Gender
explicativă	explicativ	Gender
dăpărarăm	dăpărai	Person
lucrători	lucrătoare	Gender
țeapănul	țepenilor	Gender
dărâmai	dărâmarăți	Person
dreptul	dreptule	Gender
neadaptat	descurcăreț	lemma
dezmeticirăm	dezmetici	Person
ponegrirăm	ponegrirăți	Person
ascund	ascunde	Number
ușuratică	ușuratic	Gender
scremetule	scremetelor	Number
beregată	beregatelor	Number
oacheșului	vânătului	lemma
rătăciților	rătăcitei	Gender
trista	tristul	Gender
nearticulatii	nearticulatului	Gender
brava	bravul	Gender
prăjit	prăjiți	Gender
introduceați	introduceau	Person
sărasem	săraseră	Person
reali	reale	Gender
lămurise	lămuriseși	Person
pregetau	pregetai	Person
blândă	blând	Gender
centrule	centrelor	Number
fixați	fixează	Person
orgasmice	glorificatoare	lemma
grăbisem	dumicasem	lemma
carnivor	carnivoră	Gender
fumurii	fumurie	Gender
poștal	poștale	Gender
leneșul	florentinul	lemma
regalistului	regalistei	Gender
strigau	striga	Number
amăra	augura	lemma
morfologii	vâsc	lemma
carteziană	cartezian	Gender
dedă	dedau	Number
intră	intrăm	Person
urâtă	urât	Gender
fragede	fragezi	Gender
cuprinserăți	cuprinseși	Person
ar	ari	Person
reteza	desfășura	lemma
asud	asudă	Person
mărinimoșilor	bucuroșilor	lemma
lungesc	lungim	Number
internaționali	internațională	Gender
adăpostule	adăposturilor	Number
cântări	cântărirăți	Person
înfloresc	înfloriți	Person
deveniseră	devenise	Number
submarinului	submarinelor	Gender
năsuților	năsutei	Gender
crește	cresc	Person
contagios	contagioase	Gender
crunți	crunte	Gender
porumbacul	porumbacule	Gender
puternic	puternici	Gender
coasem	coase	Person
guvernamentali	guvernamentală	Gender
dezamăgita	dezamăgiții	Gender
servea	comunica	lemma
biologicul	biologica	Gender
pălărie	pălăriilor	Number
smulsese	smulsesem	Person
lămurise	lămurisem	Person
arhicunoscute	arhicunoscut	Gender
unice	unici	Gender
excavaserăm	excavasem	Number
cărunții	căruntului	Gender
îmbătate	îmbătat	Gender
fusese	fuseseră	Number
fumegaserăm	fumegasem	Person
homosexualului	homosexualilor	Gender
păcătui	excită	lemma
sexosul	sexoasei	Gender
acoperișule	acoperișurilor	Number
supuneți	supui	Number
desmântară	desmântași	Person
umiliserăți	așezaserăți	lemma
cufundaserăți	cufundaseră	Person
ars	arsă	Gender
consular	consulari	Gender
începe	începem	Person
târzia	târziul	Gender
prelungeați	prelungeam	Person
unilateralei	unilateralul	Gender
rotunde	rotund	Gender
prințul	zestrea	lemma
cufurii	cufurirăm	Number
ascunsesem	ascunsese	Person
demnitate	demnităților	Number
misterios	misterioasă	Gender
credincioșilor	credinciosului	Gender
grotă	ață	lemma
viei	viului	Gender
acidului	acizilor	Gender
supreme	suprem	Gender
mândra	mândrii	Gender
apar	apare	Person
masivi	masivă	Gender
conțineai	conțineam	Person
purta	îngheța	lemma
salvam	salva	Person
supunem	supun	Number
necontestați	necontestat	Gender
ieftinirăți	ieftinii	Person
musculoși	musculos	Gender
expediaserăți	expediaseși	Person
mâncați	mâncam	Person
cumnatule	cumnaților	Number
subțiaserăm	subțiaserăți	Person
tranzițional	tranziționale	Gender
mahala	mahalalelor	Number
românesc	românești	Gender
boantă	bont	Gender
asistate	asistat	Gender
storsesem	storseseră	Person
masiv	masive	Gender
supărăm	supărați	Person
rezistibililor	rezistibilul	Gender
slaba	fricoasa	lemma
câine	câinilor	Number
săcreți	săcreată	Gender
completează	completați	Person
german	germane	Gender
celți	celte	Gender
potabilă	arsă	lemma
cronica	cronicilor	Gender
adverbial	bleg	lemma
bălțat	bălțați	Gender
obsceni	obscen	Gender
bolnavii	bolnavului	Gender
organule	organelor	Number
atentă	atent	Gender
surprinzători	surprinzător	Gender
ocupând	crezând	lemma
ținurăți	ținură	Person
spectrale	spectral	Gender
dezvoltă	dezvoltați	Person
nimeriseră	extraseseră	lemma
amestecații	amestecatului	Gender
moldovenești	cicliști	lemma
adormite	adormit	Gender
șterg	ștergem	Person
bazăm	bazați	Person
române	dezgust	lemma
crudă	crud	Gender
recunoscuți	atroce	lemma
recii	recea	Gender
fluture	fluturilor	Number
învoltul	învolta	Gender
binecuvântași	binecuvântarăți	Person
sfatule	sfaturilor	Number
produceau	producea	Number
acrișoarei	acrișorului	Gender
suflă	vădește	lemma
legale	explicative	lemma
vindecătorului	vindecătorilor	Gender
lingvistică	lingvistici	Gender
văduvul	văduvule	Gender
fălești	fălim	Person
viermuiai	viermuiam	Person
șters	șterse	Gender
stindardelor	cocorilor	lemma
nocturni	nocturnă	Gender
dezgroparăți	dezgropară	Person
unice	unic	Gender
nebunise	nebuniserăm	Person
lichid	lichide	Gender
aluminiferilor	aluminiferei	Gender
perseverat	conținut	lemma
băute	băut	Gender
tranzitivă	tranzitiv	Gender
gândești	gândesc	Person
vizibila	vizibilului	Gender
convinseserăți	convinsesem	Person
alergat	întristat	lemma
cârciumă	cârciumilor	Number
rupem	rupi	Person
mucos	mucoasă	Gender
virtuoasă	virtuoși	Gender
afumaseră	afumaserăți	Person
spurcarăm	spurcarăți	Person
sinucis	desfășurat	lemma
abdominală	abdominali	Gender
inteligente	inteligenți	Gender
scoli	scoală	Person
întrezăreați	întrezăreai	Number
gătiși	gătii	Person
încurarăm	încurai	Number
cărunți	cărunte	Gender
auzi	auzirăți	Person
mic	mici	Gender
diacriticului	diacriticelor	Gender
ospătarule	ospătarilor	Number
german	germani	Gender
atlanticii	atlanticului	Gender
farfurioară	farfurioarelor	Number
plăcuți	plăcut	Gender
mintal	mintale	Gender
umflă	umflați	Person
clociserăți	clociseși	Number
profunde	profunzi	Gender
schimbă	atinge	lemma
ieftine	ieftini	Gender
guduraseși	guduraseră	Person
sângerasem	sângeraserăți	Person
discutați	discutau	Person
misterioasă	virtuoasă	lemma
sefarzilor	sefardei	Gender
grecesc	grecești	Gender
macri	macră	Gender
popularul	populara	Gender
tehnologice	tehnologic	Gender
zgomotoasei	zgomotosului	Gender
raționali	raționale	Gender
celuloză	celulozelor	Number
ologi	oloagă	Gender
ierarhie	ierarhiilor	Number
letonilor	letonul	Gender
măcelarule	măcelarilor	Number
sperau	speram	Person
apăsau	apăsați	Person
convingătoare	convingător	Gender
făcătoarei	făcătorul	Gender
bălțați	bălțate	Gender
cordonule	cordoanelor	Number
poporule	popoarelor	Number
răspândeați	cumpătați	lemma
sălbatice	sălbatic	Gender
taie	tai	Person
șchiop	șchioapă	Gender
încununarăți	încununarăm	Person
depuneți	depui	Person
apă	apelor	Number
rugau	rugam	Person
numărase	număraseși	Person
toxici	toxice	Gender
minoritate	minorităților	Number
mândrii	mândri	Person
iepurarii	șantajista	lemma
prăjită	prăjit	Gender
central	centrale	Gender
indiferent	indiferenți	Gender
amăgiseră	avansaseră	lemma
incomplete	incompleți	Gender
înfloreau	înfloreați	Person
nășteați	nășteai	Person
curmă	curmați	Person
timid	timizi	Gender
utilului	utila	Gender
macedonencele	flautul	lemma
argilos	argiloase	Gender
circumcideați	circumcidea	Person
scoatem	scoți	Person
noul	noilor	Gender
transform	închid	lemma
încăpățânatei	încăpățânații	Gender
adeveresc	foarfecă	lemma
albanezului	albanezilor	Gender
binefăcătoarei	binefăcătorii	Gender
descărcaserăți	descărcaseși	Person
reducție	reducțiilor	Number
orchestrale	trântite	lemma
gândi	gândii	Person
norocosului	norocoasei	Gender
nasoli	sângeroși	lemma
împăduri	împădurirăți	Person
norocoasă	norocoși	Gender
jinduiși	combinași	lemma
prietenoși	prietenos	Gender
aleatorii	faini	lemma
reduseră	reduse	Person
rași	rasă	Gender
rostesc	rostește	Number
hazliul	cunoscutul	lemma
dependenți	dependente	Gender
prădaserăți	prădaserăm	Person
verbină	verbinelor	Number
ruptă	rupți	Gender
foloseam	foloseau	Person
naționalului	naționala	Gender
cumpliții	cumplita	Gender
dialectalului	dialectala	Gender
dublează	dublați	Person
măsuraserăți	măsuraseși	Number
sefarzilor	înghețaților	lemma
secerară	secerarăm	Person
ofileai	împănai	lemma
plătea	plăteau	Number
influențează	îndură	lemma
cununați	cunună	Person
găseam	găseai	Person
jalnicei	jalnicul	Gender
slujesc	discută	lemma
delirante	deliranți	Gender
aeram	disecam	lemma
gudurarăm	gudurai	Number
scufundat	scufundați	Gender
alchimici	alchimice	Gender
olimpici	olimpic	Gender
creștinească	creștinesc	Gender
oblice	botanice	lemma
astrucă	astruc	Person
făcători	făcătoare	Gender
futuși	futurăți	Number
rostește	bagă	lemma
siberienilor	bengalezi	lemma
epuizați	epuizează	Person
fixează	fixăm	Person
abacă	abacelor	Number
timid	timidă	Gender
cafeniu	cafenie	Gender
acuzasem	acuzaserăm	Person
cornee	corneelor	Number
pietrosului	pietroasa	Gender
dubios	dubioase	Gender
cântase	cântaseră	Person
pedepsesc	bagă	lemma
fuseră	fuse	Person
mijloceai	mijloceați	Number
judecate	judecați	Gender
simetricului	simetrica	Gender
feciorule	feciorilor	Number
învinse	învinși	Gender
sparți	spartă	Gender
lucrați	lucra	Person
anglicani	anglican	Gender
dansară	dansai	Person
stinseseră	stinseseși	Person
norocoase	norocoși	Gender
perturbatori	perturbatoare	Gender
secret	înțelesului	lemma
setosului	setoasa	Gender
orientasem	orientaseră	Person
arogantă	aroganți	Gender
complet	complete	Gender
răsfățaseră	răsfățase	Person
autorule	autorilor	Number
vâscoase	vâscos	Gender
disponibilă	disponibili	Gender
declară	declarați	Person
mistificaserăți	întorseserăți	lemma
reflectații	reflectata	Gender
socotiți	socotite	Gender
stingherind	înflorind	lemma
ocup	ocupăm	Person
slăviți	slăvești	Number
jurași	înfrânași	lemma
ajutase	ajutaseră	Person
puternic	puternice	Gender
disponibilitate	disponibilităților	Number
scump	scumpă	Gender
încoronați	încoronăm	Person
sufletești	sufletească	Gender
instantaneu	instantanee	Gender
nou	noi	Gender
răsculase	răsculaseră	Person
anale	anal	Gender
uimiră	uimi	Number
mulțimilor	bărbăției	lemma
supranaționalilor	supranaționalul	Gender
ospătați	ospăta	Person
misterioșii	misterioasei	Gender
aberanții	aberantul	Gender
deliranta	deliranților	Gender
recuperez	recuperăm	Person
desfiraseși	desfiraserăți	Person
sporirăți	sporii	Person
destrăbălez	destrăbălăm	Number
șchiopii	șchiopul	Gender
trista	tristului	Gender
injectaseră	injectaserăți	Person
craniule	craniilor	Number
scuturaserăți	scuturaseră	Person
prindeau	împrejmuiau	lemma
atotputernicul	atotputernicii	Gender
scot	scoateți	Person
alpaca	alpacalelor	Number
grecescul	greceasca	Gender
analului	analei	Gender
tentau	tentam	Person
ademeniși	ademeniră	Person
treieră	treieri	Person
căpoșilor	căposul	Gender
propuseserăm	propusese	Person
luminos	străvechi	lemma
luăm	ia	Person
miros	cumpăr	lemma
încărcăm	încarci	Person
necomutabila	necomutabililor	Gender
evlavioasei	evlavioșii	Gender
rupeți	îngropați	lemma
indiscretei	indiscretului	Gender
putred	putrezi	Gender
ionosferă	filantropie	lemma
pline	ude	lemma
mângâiară	mângâiarăți	Person
pictorule	pictorilor	Number
plânge	plâng	Person
veselă	vesel	Gender
muntoasă	muntos	Gender
săptămînă	barză	lemma
ciclista	ciclistul	Gender
izolate	discrete	lemma
seră	serelor	Number
introductivi	introductiv	Gender
inexprimabila	fijiana	lemma
sar	elimin	lemma
umpli	umplu	Person
stradă	străzilor	Number
jalnice	jalnic	Gender
adăpostitului	adăpostitei	Gender
compleți	complete	Gender
agățați	agață	Person
largi	largă	Gender
convin	convenim	Number
excitați	excită	Person
necinstite	necinstiți	Gender
evreiască	evreiesc	Gender
venericei	venericul	Gender
ruseștii	ruseasca	Gender
folosință	folosințelor	Number
dogmatici	dogmatic	Gender
răsunarăm	răsunai	Person
masculule	masculilor	Gender
spovedii	azvârlii	lemma
neutri	neutre	Gender
mergeam	mergeați	Person
inexplicabil	inexplicabilă	Gender
adverbială	adverbial	Gender
cântări	cântăriră	Number
acoperiți	câmpenești	lemma
constrânge	constrâng	Person
polare	creative	lemma
fertili	fertil	Gender
fura	furați	Person
îmbunați	îmbunez	Person
bucătărie	bucătăriilor	Number
orbiți	orbește	Person
intenționai	denaturai	lemma
unici	unice	Gender
roșii	zemoase	lemma
obișnuise	obișnuiseră	Person
scurt	scurtă	Gender
indiferent	bulgăresc	lemma
mărinimos	mărinimoși	Gender
momiți	șoptiți	lemma
pântecoasei	pântecoșilor	Gender
narcotizaserăți	întinseserăți	lemma
unidirecționalilor	unidirecționala	Gender
părăsita	părăsiții	Gender
întorsul	întoarsa	Gender
reducem	reduc	Number
democratică	democratici	Gender
nimeriserăți	nimerise	Person
încurați	încurau	Person
farmacistule	farmaciștilor	Number
prelungiși	prelungirăm	Person
jalnica	jalnicilor	Gender
dinamică	dinamici	Gender
dezamăgiți	dezamăgesc	Person
trezi	fractură	lemma
întremarăm	întremară	Person
întortochează	întortocheați	Person
gravați	gravat	Gender
cuprinși	cuprinse	Gender
surzi	surdă	Gender
chemau	chemam	Person
strugurule	strugurilor	Number
puturoasa	asistata	lemma
bolnăvicios	bolnăvicioase	Gender
nisipos	nisipoasă	Gender
consularii	consularul	Gender
desișule	desișurilor	Number
abreviere	abrevierilor	Number
ghidă	ghidelor	Number
cobori	coborâți	Person
nasc	naștem	Number
muzicale	dinamice	lemma
necunoscută	necunoscuţi	Gender
oacheș	transatlantic	lemma
naționalului	naționalii	Gender
sugrumase	sugrumaserăm	Person
îngrășasem	îngrășase	Person
spinoși	spinos	Gender
părăsite	părăsiți	Gender
criticului	criticei	Gender
bucuros	bucuroși	Gender
grase	grași	Gender
stricau	strica	Number
glumesc	glumește	Person
oblic	blond	lemma
roade	zbiară	lemma
cenușiul	cenușia	Gender
preoțirăm	preoțiră	Person
ipocritei	căcaților	lemma
blând	blânde	Gender
botez	botează	Person
adevărata	adevăratului	Gender
sclava	ciupercile	lemma
ridicat	ridicați	Gender
credincioșilor	credinciosul	Gender
insurmontabilului	insurmontabililor	Gender
surprinzătoare	surprinzător	Gender
mișto	căpățânos	lemma
astupasem	astupase	Person
datorează	datorăm	Person
mustrați	credeți	lemma
apusesem	apuseseră	Person
aglomerate	tăioase	lemma
creau	crea	Person
internă	interni	Gender
solari	tereștri	lemma
răsăriți	răsar	Person
invariabile	invariabil	Gender
prădarăm	prădă	Person
calcă	călcăm	Person
credincioșii	credinciosul	Gender
împrejurați	împrejurai	Number
dejugai	dejugă	Person
riscaseși	riscaserăți	Number
proastă	proastelor	Number
oniric	onirice	Gender
plin	vulgar	lemma
apoasă	apos	Gender
moaie	muiați	Person
bănuiau	bănuia	Person
scotea	scoteau	Number
destinat	destinați	Gender
slab	argilos	lemma
ejaculatoarei	ejaculatorii	Gender
curistule	curiștilor	Number
căposul	căpoasei	Gender
grăiește	grăiesc	Person
deșteptară	deșteptarăți	Person
girafă	girafelor	Number
injectase	injectaserăți	Person
urmezi	urmați	Person
sfâșiaserăți	sfâșiaseră	Person
mirandeză	creștinătate	lemma
țigănească	țigănesc	Gender
inutile	inutil	Gender
izolate	izolat	Gender
sud-africanule	sud-africanilor	Gender
rosese	roseseră	Person
crestam	crestați	Person
amestecatei	amestecatul	Gender
vizualizează	vizualizez	Person
bravei	bravii	Gender
cărnos	cărnoase	Gender
vindecaseră	vindecaseși	Person
ilegali	ilegal	Gender
uimitorii	uimitoarea	Gender
noi	nouă	Gender
deceda	decedați	Person
rarii	rarul	Gender
picolițelor	versurilor	lemma
cuvioase	cuvioși	Gender
poștalului	poștalii	Gender
suprem	supremă	Gender
aberant	aberantă	Gender
asuda	asudai	Person
cărunt	cărunți	Gender
bolnava	bolnavul	Gender
erogenului	erogena	Gender
micul	micii	Gender
cerneți	cern	Person
păgânii	estonienii	lemma
masculului	masculilor	Gender
ridicată	ridicat	Gender
friguroasa	friguroșii	Gender
doreai	dorea	Person
trădași	trădarăți	Person
menținuserăți	menținuseși	Number
împletesc	împletiți	Person
răsucirăți	răsucirăm	Person
neguțaseră	înjunghiaseră	lemma
fericiserăți	fericiseși	Person
riscase	zăcuse	lemma
sfulgerară	sfulgerarăm	Person
apetisanții	apetisantului	Gender
abație	abațiilor	Number
scrotalilor	tinșilor	lemma
împrăștiară	împrăștiarăți	Person
dublei	dublului	Gender
căsătoreai	căsătoream	Person
strălucitori	strălucitor	Gender
îngustă	înguști	Gender
vizibil	vizibili	Gender
bacterie	bacteriilor	Number
încetăm	încet	Number
distrau	distram	Person
juvenilă	bine	lemma
migdală	migdalelor	Number
comandă	comandați	Person
gravitaționale	gravitațional	Gender
sufla	deșteptea	lemma
sulfuroși	sulfuroasă	Gender
stimați	stimează	Person
terțiilor	terțiul	Gender
împăcăm	împac	Number
prindeți	prind	Person
cotidiene	cotidian	Gender
explicare	explicărilor	Number
pâine	pâinilor	Number
sigur	sigure	Gender
găseau	găseai	Person
genetice	genetic	Gender
inseparabil	inseparabili	Gender
substanță	substanțelor	Number
plăcuta	plăcutul	Gender
triste	trist	Gender
botanica	botanicii	Gender
judecai	judecați	Number
scoate	scoți	Person
pocniserăți	pocniseră	Person
blond	blondă	Gender
construiești	construiește	Person
păduchiosul	păduchioasa	Gender
gem	geme	Person
începi	începem	Person
emeriți	emerită	Gender
mințitoarei	mințitorii	Gender
femininilor	femininei	Gender
complexului	complecșii	Gender
odihnesc	odihnești	Person
simplilor	simpla	Gender
evreiești	evreiască	Gender
principali	principal	Gender
deprimații	deprimata	Gender
potrivește	potrivesc	Number
pieream	piereați	Person
rotunjită	rotunjiți	Gender
dramatic	dramatici	Gender
sperați	sperăm	Person
nivelaseră	nivelase	Person
pianină	pianinelor	Number
plânsese	convenise	lemma
naționali	națională	Gender
ocupi	înalți	lemma
inutil	inutilă	Gender
dumnezeiasca	dumnezeiescul	Gender
proporționalii	proporționala	Gender
microbiologicilor	microbiologicul	Gender
moștenesc	moșteniți	Person
hinduism	tină	lemma
emoționale	emoțional	Gender
vâscoșii	vâscosului	Gender
florarule	florarilor	Number
cruntă	crunt	Gender
integrabilă	integrabil	Gender
aritmetici	aritmetic	Gender
mișcătoare	digitală	lemma
viguros	viguroasă	Gender
diminuează	diminuezi	Person
scăpărăm	scăpărați	Person
reținem	reține	Person
exageratului	exageratei	Gender
lipiți	lipit	Gender
nemeritat	geamăn	lemma
brava	bravului	Gender
dungata	dungatului	Gender
crude	crud	Gender
obligă	obligați	Person
adormite	biologice	lemma
veghează	decapitează	lemma
nepopulară	nepopulari	Gender
scânteiară	scânteiași	Person
fostă	fostelor	Number
sminti	îndepărtă	lemma
circumscriem	circumscrie	Person
tandrului	tandrii	Gender
porcușorule	porcușorilor	Number
construiesc	construiești	Person
extinzi	extindem	Person
cufuriserăm	cufuriseși	Person
limpede	limpezi	Gender
bursucule	bursucilor	Number
săgetăm	săgetez	Number
muțenie	ebraică	lemma
sigură	sigur	Gender
recii	recele	Gender
medicină	fertilitate	lemma
letoni	creativi	lemma
laudă	lăudăm	Person
curat	curați	Gender
portarule	portarilor	Number
neteziți	netezești	Number
serios	serioși	Gender
mucoase	eronate	lemma
ubicui	ubicuă	Gender
macabru	macabră	Gender
ocrotiși	юбишь	lemma
onomatopeice	onomatopeic	Gender
sarcasticul	sarcasticii	Gender
mielul	căpriorul	lemma
înfierbântă	înfierbântară	Number
puternica	puternicii	Gender
liliacule	liliecilor	Number
strugurii	furnica	lemma
croiește	croiesc	Number
putred	terapeutic	lemma
bătu	băturăm	Person
imperialul	imperialei	Gender
structurat	eterogen	lemma
istoric	istorici	Gender
structuralilor	cunoscuților	lemma
chimic	chimici	Gender
decideți	decide	Person
botezați	botezat	Gender
impredictibila	impredictibilii	Gender
plecam	plecau	Person
putând	ținând	lemma
unicul	unica	Gender
stricați	stricată	Gender
inflexibilului	inflexibililor	Gender
bete	beți	Gender
dispunea	dispuneam	Person
masculin	ținut	lemma
aprinsă	aprinși	Gender
stimă	stimară	Number
anglican	anglicani	Gender
ascunșilor	ascunsei	Gender
proptiți	încurați	lemma
adulmecai	curățai	lemma
însorea	însoream	Person
nisipoaselor	galfedelor	lemma
perfect	perfectă	Gender
artă	artelor	Number
vesel	veseli	Gender
plimbase	dispusese	lemma
cicliștilor	ciclistul	Gender
dăpărarăm	dăpărași	Person
adunați	înălțați	lemma
religioșilor	religioasei	Gender
vindecase	vindecaserăți	Person
declară	declari	Person
aspri	aspru	Gender
speria	speriau	Person
scutură	geme	lemma
lățești	lățiți	Person
avortează	avortez	Person
religioși	cicliști	lemma
sferic	sferică	Gender
bulgărească	bulgăresc	Gender
hulit	huliți	Gender
pleci	plecați	Person
tocași	tocarăm	Person
râvnea	râvneau	Number
rotunjiseră	doriseră	lemma
răbdat	circulat	lemma
atotștiutoare	atotștiutor	Gender
conții	conțin	Person
naive	învechite	lemma
grosul	groșilor	Gender
meșteți	mești	Person
lovim	lovesc	Number
oficiali	oficială	Gender
lacrimă	lacrimilor	Number
nutrețule	nutrețurilor	Number
spuse	spuseră	Number
pitorești	anglicani	lemma
evazivul	evazivei	Gender
bălăim	bălăiesc	Person
acoperă	acoperiți	Person
feminin	feminine	Gender
iertate	coapte	lemma
sexuali	binefăcători	lemma
delimitezi	delimităm	Person
digital	digitali	Gender
rostea	înspăimânta	lemma
dezvățarăți	dezvățarăm	Person
ucid	ucide	Number
furau	furați	Person
adânci	adâncă	Gender
anule	anilor	Number
scuzați	așezați	lemma
domnule	domnilor	Number
mediocră	coborâtă	lemma
insurmontabili	insurmontabil	Gender
păcătuiește	destramă	lemma
repauzaseși	repauzase	Person
sufleteștii	sufleteștilor	Gender
plătise	plătiseră	Number
nemeritaților	nemeritata	Gender
îngrozitorul	îngrozitoarea	Gender
lungul	lunga	Gender
numește	numești	Person
rodie	rodiilor	Number
bezmeticei	bezmeticului	Gender
slăbeam	întrezăream	lemma
problemă	problemelor	Number
liniști	cinste	lemma
inflexibile	brave	lemma
agățați	agățată	Gender
însoțiserăți	însoțisem	Person
algă	algelor	Number
olandezule	olandezilor	Gender
așezăm	așez	Number
amenința	zbura	lemma
sătulă	sătul	Gender
aspru	aspră	Gender
inundau	inundai	Person
hămesiți	hămesești	Person
fugiți	fugi	Number
neașteptată	neașteptat	Gender
străvăzusem	străvăzuserăm	Number
presupuneau	înfloreau	lemma
mândri	mândru	Gender
ofilii	ofiliși	Person
scălda	scăldați	Person
urdinarăți	urdinară	Person
dezvățarăți	dezvățară	Person
luai	luați	Number
intervenim	intervine	Person
harbuzului	vacilor	lemma
returnaserăți	returnaseră	Person
ciclistă	cicliști	Gender
caraghioasă	caraghios	Gender
trântiților	trântitul	Gender
repede	chimic	lemma
îngrozitorilor	îngrozitorul	Gender
câmpeneștii	câmpeneasca	Gender
orfanului	orfanilor	Gender
îngerule	îngerilor	Number
războiule	războaielor	Number
adăpostită	adăpostit	Gender
luminos	luminoasă	Gender
urât	urâți	Gender
nevăzute	nevăzuţi	Gender
contraveneau	contraveneam	Person
lipiții	lipita	Gender
britanicii	britanica	Gender
halucină	halucinași	Person
cotropirăți	cotropiși	Person
apără	aperi	Person
împani	împană	Person
medicine	gnosticism	lemma
pornea	porneau	Person
răsuna	domina	lemma
absorbiți	absoarbe	Person
interzicea	interziceai	Person
visam	visa	Person
sarcastic	sarcastice	Gender
instantanei	instantanee	Gender
structurale	târzii	lemma
simetrici	bisexualilor	lemma
ștersă	șters	Gender
saltule	salturilor	Number
teiule	teilor	Number
roată	roților	Number
interesanți	interesantă	Gender
rara	rarul	Gender
întinde	întindem	Person
sumesese	așezase	lemma
proporție	proporțiilor	Number
vântos	vântoși	Gender
galfedul	galfezilor	Gender
solară	solari	Gender
visam	visau	Person
preferați	preferi	Number
agățați	fericiți	lemma
injectă	întemeie	lemma
făgăduiserăm	făgăduiseră	Person
schimbi	schimbă	Person
central	centrali	Gender
ghiciseși	ghiciserăm	Person
aleatoriului	aleatoriilor	Gender
mințiseră	mințiserăți	Person
stai	stați	Person
încrezuserăm	încrezuse	Person
raționalii	raționalului	Gender
bivalenții	bivalenta	Gender
mândră	mândru	Gender
tarele	tarii	Gender
declinaseră	declinase	Number
ierboasă	ierbos	Gender
apuserăți	apuse	Person
pregătește	pregătim	Person
alăptat	vorbit	lemma
cuvios	cuvioși	Gender
cronici	cronice	Gender
înșira	înșirau	Person
nativi	nativă	Gender
servirăm	serviră	Person
insulta	insultai	Person
anulau	anula	Person
fălești	fălesc	Person
animase	animasem	Person
umbros	umbroși	Gender
azvârliți	azvârle	Person
observație	observațiilor	Number
curătură	curăturilor	Number
virtuos	virtuoase	Gender
necuviinciosului	necuviincioasa	Gender
mișcare	mișcărilor	Number
secvențiali	secvențial	Gender
ridicarăți	ridicarăm	Person
cămilă	cămilelor	Number
cunoscuse	cunoscuseși	Person
făgăduiserăm	făgăduise	Person
singur	singure	Gender
căzutul	căzuților	Gender
cornute	cornuți	Gender
desculțasem	desculțaserăm	Person
sufocă	împovărează	lemma
obraznic	obraznice	Gender
săcreata	săcreții	Gender
lăsaserăm	lăsase	Person
bulgărească	bulgărești	Gender
minte	extrage	lemma
maltezi	asistați	lemma
clocesc	clociți	Person
îmbătatului	îmbătata	Gender
lăsați	înfățișați	lemma
dureroase	dureros	Gender
aflaseră	descoperiseră	lemma
defăimaserăți	defăimaseși	Person
toxicei	toxicilor	Gender
venezueleană	venezuelean	Gender
zemoase	zemos	Gender
creștina	creștinul	Gender
iluzoriu	iluzorie	Gender
necomutabilă	necomutabili	Gender
distrai	distram	Person
încheiau	încheiați	Person
conveniră	convenirăți	Person
treieram	descheiam	lemma
întrevezi	întrevedeți	Person
ruginea	rugineam	Person
perineale	surde	lemma
strâmtăm	strâmtează	Person
ștersă	șterși	Gender
slabi	slabă	Gender
cărăbușule	cărăbușilor	Number
aplecaseră	aplecasem	Person
simțea	discuta	lemma
pântecoși	pântecoasă	Gender
licăriserăm	licărise	Person
tinctură	tinctur	Person
cărnoasa	cărnoșii	Gender
strâmtați	coaceți	lemma
formație	formațiilor	Number
critic	critice	Gender
înjugi	înjugă	Person
încercase	încercasem	Person
săpa	cădea	lemma
jură	jurați	Person
lungește	conjugă	lemma
umede	umed	Gender
închidem	închid	Person
imaginarăm	imagină	Person
fugiserăm	fugisem	Person
prețuiți	prețuiește	Person
elevule	elevilor	Number
virilul	virilii	Gender
sortește	sortești	Person
stricat	stricați	Gender
anatomic	anatomică	Gender
pitorescul	pitoreasca	Gender
integrale	integrali	Gender
răsuna	răsunau	Number
îngrijesc	îngrijiți	Person
lăcrimam	clădeam	lemma
planetară	dialectală	lemma
filamentoșilor	filamentosului	Gender
râioase	râios	Gender
chemau	chemați	Person
atlantici	atlantică	Gender
răzlețiseși	răzlețisem	Person
olimpice	fumurii	lemma
aerisirăm	aerisiră	Person
grașilor	grasa	Gender
ultimei	ultimul	Gender
doreau	doream	Person
spintecaserăm	spintecasem	Number
memorizat	emoționat	lemma
preoțiși	preoțiră	Person
integrabila	integrabilii	Gender
obraznicul	creștinul	lemma
strigătului	frustrărilor	lemma
spectrală	spectral	Gender
roșii	roșirăm	Person
oaie	oilor	Number
propuneau	propuneam	Person
reali	reală	Gender
întorși	întoarse	Gender
senina	seninilor	Gender
osoși	osos	Gender
stânjeniră	stânjenii	Person
invariabili	invariabile	Gender
minunezi	fraudezi	lemma
ramură	ramurilor	Number
golesc	golește	Number
intuiai	intuiați	Person
prăsiși	prăsirăți	Number
sparți	spart	Gender
dispărusem	dispăruseși	Person
greul	greaua	Gender
frunzoasei	frunzosului	Gender
spurcați	spurcai	Number
măreți	mărețe	Gender
osos	osoase	Gender
înclina	înclinam	Person
slăbești	slăbesc	Person
obligi	oblig	Person
transatlantici	transatlantică	Gender
albastra	albaștrii	Gender
simte	constrânge	lemma
citologă	citologelor	Number
orchestralei	vamalei	lemma
convenționale	convențional	Gender
credinciosul	credincioasei	Gender
mărunți	mărunt	Gender
vărgați	vărgate	Gender
istoricii	istorica	Gender
sătulă	sătui	Gender
dependentă	dependenți	Gender
cunoscuții	cunoscutului	Gender
germana	germanilor	Gender
reluați	dezrădăcinați	lemma
jos	joasă	Gender
deranjez	deranjează	Person
mărginit	înrâurit	lemma
moldoveanule	moldovenilor	Gender
conținusem	conținuseși	Person
acuză	domină	lemma
principalilor	principalului	Gender
risipește	documentează	lemma
masiv	masivă	Gender
bolnăvicios	bolnăvicioasă	Gender
rulați	rulez	Person
rugii	cangurului	lemma
ucidere	uciderilor	Number
adevărata	adevărații	Gender
reduc	reduci	Person
soporificului	soporificei	Gender
continuă	continui	Gender
vindea	vindeau	Person
mărețe	măreți	Gender
somnifer	somnifere	Gender
desfășură	desfășurați	Person
serios	serioasă	Gender
binefăcătorul	binefăcătoarea	Gender
înfiaserăm	înfiasem	Person
diastolica	diastolicul	Gender
pățiserăm	pățiserăți	Person
dovedea	dovedeau	Number
imagină	imaginași	Person
făcători	făcător	Gender
rănesc	răniți	Person
furculiță	furculițelor	Number
râde	râdeți	Person
deprinsei	deprinserăți	Person
transcrie	înfoaie	lemma
cântăm	cânt	Number
unge	ungeți	Person
surpriză	surprizelor	Number
slăvește	slăviți	Person
posteritate	benzină	lemma
continui	continuă	Gender
aerisim	aerisești	Person
mărginiți	fericiți	lemma
scânteia	frauda	lemma
pășunaserăți	pășunasem	Person
ieftin	ieftini	Gender
ironicei	ironicului	Gender
risc	încet	lemma
lămurește	lămuriți	Person
adevărat	încet	lemma
înseteză	însetezarăți	Person
invadau	invada	Number
botezaților	botezatei	Gender
mescui	fundai	lemma
izolate	izolați	Gender
reia	îndură	lemma
tranzienții	tranzienta	Gender
împletesc	împletești	Person
îmbunarăm	îmbunai	Number
latră	lătrați	Person
dovedea	dovedeau	Person
aciuaserăți	aciuasem	Person
albă	albi	Gender
legendare	făcătoare	lemma
definiție	definițiilor	Number
sărate	sărați	Gender
documentaseră	documentaserăți	Person
recunoscute	amabile	lemma
mărinimoasa	mărinimosul	Gender
ataca	atacau	Number
năpârca	doamnele	lemma
amână	amânași	Person
adunare	adunărilor	Number
dezlipește	dezlipesc	Person
minuscule	minusculi	Gender
rescriu	rescrie	Person
naiva	naivul	Gender
dogmatică	dogmatic	Gender
scurți	scurtă	Gender
perturbatorului	perturbatoarei	Gender
muzical	muzicale	Gender
temuși	temu	Person
puturosul	bivalentul	lemma
vlăguiesc	vlăguiește	Person
îndemnați	îndemni	Number
lepădarăți	îmbucarăți	lemma
iraționale	irațional	Gender
sorg	benzine	lemma
blonzi	blondă	Gender
trăgănarăți	trăgănai	Person
slăvești	slăviți	Person
întâmplarăm	întâmplarăți	Person
sfulgerau	sfulgeram	Person
piersică	piersicilor	Number
cheamă	chemați	Person
ceacârii	ceacârului	Gender
violetului	violeta	Gender
plina	plinul	Gender
pavați	pavăm	Person
imoși	imoasă	Gender
ridicăm	ridic	Number
reciclată	reciclat	Gender
intrarăm	cugetarăm	lemma
șchiopăm	șchiopează	Person
înghețat	înghețați	Gender
calitate	calităților	Number
roasă	ros	Gender
strălucitoare	strălucitor	Gender
conjugați	conjugi	Number
târzia	târziii	Gender
criminalului	criminalilor	Gender
continentule	continentelor	Number
eroticilor	eroticei	Gender
învinși	învins	Gender
bietului	bietei	Gender
cuceresc	cucerești	Person
vitreg	vitregă	Gender
păduchearăți	cumințirăți	lemma
maghiarii	maghiara	Gender
acoperiților	acoperitului	Gender
legeni	leagănă	Person
dururoșii	dururosul	Gender
adulmecă	adulmec	Person
slavi	slavă	Gender
alchimice	alchimic	Gender
mărunt	măruntă	Gender
întrebarăți	întrebară	Person
hrănea	compunea	lemma
plați	plat	Gender
răcnind	întâlnind	lemma
ploioși	australienilor	lemma
speriatul	cuviosul	lemma
ascunseseră	ascunsese	Person
pasă	pasară	Person
smulsese	eliberase	lemma
evazivă	evaziv	Gender
prăpădeai	prăpădea	Person
subteran	subterane	Gender
misterioasă	misterioși	Gender
muncii	munci	Person
convinge	conving	Person
bianual	bianuale	Gender
mincinoasei	mincinoșilor	Gender
stea	stelelor	Number
slab	slabe	Gender
sfătuim	estimăm	lemma
amintire	amintirilor	Number
halirăm	halii	Number
schimb	schimbă	Person
acoperit	emerit	lemma
mort	moartă	Gender
discrete	discreți	Gender
dezgustătoare	dezgustător	Gender
albanez	albanezi	Gender
amuzați	amuză	Person
ademenesc	ademenește	Number
programabilului	programabilei	Gender
petală	petalelor	Number
ploioși	ploios	Gender
lichida	lichidului	Gender
câmpenească	câmpenesc	Gender
aștepta	așteptau	Number
omnipotent	omnipotentă	Gender
arădusesem	arăduseserăm	Person
amarul	amara	Gender
sărbătorind	bând	lemma
iscălise	iscăliseră	Number
strâmți	strâmte	Gender
untoasei	untoșilor	Gender
tăios	tăioasă	Gender
neutrul	neutra	Gender
asistați	asistat	Gender
adânci	adânc	Gender
versatile	versatili	Gender
întâlnise	întâlniseră	Person
înmânasem	înmânaseși	Person
căzut	căzuți	Gender
bălțații	bălțata	Gender
creativă	creativ	Gender
rosul	roșilor	Gender
judecaților	judecatul	Gender
îmbunătățeau	îmbunătățea	Number
ciufuta	ciufutului	Gender
stăpâniți	stăpânește	Person
flexibil	flexibili	Gender
microbiologic	microbiologică	Gender
bengalez	bengaleză	Gender
drăguți	drăguțe	Gender
îndesase	îndesaseră	Number
merinde	merindelor	Number
tari	tare	Gender
slavul	slavilor	Gender
foneticului	foneticii	Gender
adăpostiți	adăpostit	Gender
slav	slavă	Gender
nemascați	dubioși	lemma
ultimi	ultimă	Gender
stimează	bășică	lemma
făcătoarea	făcătorului	Gender
numești	numim	Person
mintal	mintali	Gender
subsonicei	subsonicilor	Gender
inutile	inutili	Gender
reciclați	reciclate	Gender
amuzăm	amuz	Number
crudului	crudei	Gender
experimentații	experimentatului	Gender
armă	armelor	Number
măcinați	macină	Person
descurcă	descurcați	Person
adeveriseși	atinseseși	lemma
căzută	căzut	Gender
minuscul	minuscule	Gender
principalilor	principalul	Gender
desmățaseși	desmățaserăți	Person
aprinsă	aprins	Gender
calculați	calculată	Gender
abandonase	desfășurase	lemma
prădasem	descălecasem	lemma
adverbiale	adverbial	Gender
cheie	cheilor	Number
mărturisiși	conjugași	lemma
ascultați	ascultau	Person
mătura	bătea	lemma
observaseră	observase	Person
guvernare	guvernărilor	Number
ipocritule	ipocriților	Gender
bulbucați	bulbuci	Person
păstram	păstrați	Person
chinezoaică	chinezoaicelor	Number
orgasmicei	orgasmicii	Gender
structuraților	structuratului	Gender
tandrului	tandrei	Gender
norocoșii	norocoasa	Gender
introduce	introduc	Person
plecasem	batjocorisem	lemma
discutăm	discut	Person
ciufuta	ciufuților	Gender
mahalalei	virusului	lemma
suspină	cerne	lemma
destinată	destinați	Gender
semnați	semnez	Person
scărpinai	scărpinarăți	Person
unim	uniți	Person
specific	învins	lemma
naive	naiv	Gender
joasă	joși	Gender
opresc	oprești	Person
roșie	roșiilor	Number
юби	юбирэць	Person
dereticați	deretică	Person
flămândă	flămând	Gender
minuscule	unice	lemma
neuitabilă	bucuroasă	lemma
zgârie	zgârii	Person
migrenă	migrenelor	Number
umezi	umede	Gender
sarcastică	sarcastic	Gender
reflectatei	reflectaților	Gender
analogicul	analogicii	Gender
slut	toxic	lemma
exotică	exotici	Gender
homosexualitate	ardoare	lemma
dezgheți	dezghețăm	Person
persoană	persoanelor	Number
acuzat	acuzați	Gender
scufundatul	scufundata	Gender
estimez	estimează	Person
dumnezeiasca	dumnezeieștilor	Gender
furioșilor	furioasei	Gender
invadă	invadară	Number
ispitisem	cinasem	lemma
preistoric	preistorici	Gender
sprintenele	emoționalele	lemma
oblicului	oblica	Gender
plătea	plăteau	Person
frățescului	frățeștii	Gender
veninosului	veninoșilor	Gender
realei	realilor	Gender
explici	explicăm	Person
dezmântaseși	dezmântaserăți	Person
eliminaseră	eliminase	Number
accesibili	accesibilă	Gender
vomuseră	vomuse	Person
cărnoase	cărnos	Gender
aprigii	aprigului	Gender
ciclist	cicliste	Gender
menestrelule	menestrelilor	Number
sprintenilor	sprintena	Gender
guvernau	ciopleau	lemma
luptăm	clarificăm	lemma
explicativi	explicativ	Gender
drăguț	drăguțe	Gender
mișto	fierbinți	lemma
repeziseși	divorțaseși	lemma
castaniu	castanii	Gender
biologice	biologici	Gender
merge	mergeți	Person
jurați	juram	Person
păroși	păroasă	Gender
amar	amari	Gender
sare	sărim	Person
musculoșii	școlarii	lemma
sinistre	surprinzătoare	lemma
convingătoarei	convingătorului	Gender
gălbuia	gălbuii	Gender
delimitați	delimităm	Person
discret	discrete	Gender
mârcedul	mârcezii	Gender
albanezul	albaneza	Gender
neîmpiedicat	neîmpiedicați	Gender
rostule	rosturilor	Number
regească	regesc	Gender
cercetare	cercetărilor	Number
pornește	pornesc	Number
deprindeați	deprindeam	Person
cumințeam	cumințeai	Person
onirici	onirică	Gender
obișnuim	obișnuiesc	Number
prăbușiseși	prăbușiseră	Person
spumat	cutezat	lemma
intimi	intim	Gender
simbolul	cheile	lemma
putrezește	putrezesc	Person
dungați	dungat	Gender
decisese	deciseseră	Number
sculptură	sculpturilor	Number
importanților	importantul	Gender
omniscient	enorm	lemma
obraznicul	obraznicii	Gender
nume	numelor	Number
ieși	ieșim	Person
taci	cotește	lemma
stătuse	cântase	lemma
intranzitive	veștede	lemma
servirăm	servirăți	Person
încăpățânați	încăpățânat	Gender
observaseră	observasem	Person
deșelaseși	deșelaserăți	Number
înguste	îngust	Gender
obișnuiesc	obișnuiești	Person
mândrește	mândresc	Person
adevăratului	adevăratei	Gender
sinistru	aritmetic	lemma
absorbite	absorbit	Gender
atingem	atinge	Person
experimentați	experimentat	Gender
suferință	suferințelor	Number
sacră	sacri	Gender
unsuroși	unsuros	Gender
vorbirăm	vorbirăți	Person
însoresc	însorește	Number
intraseră	intraseși	Person
pietros	pietroasă	Gender
înlătură	înlături	Person
bei	beți	Number
colorata	coloratul	Gender
știm	știe	Person
elementarul	elementarii	Gender
imaginară	imagină	Number
portocalia	portocaliii	Gender
învățați	înveți	Number
sortirăți	umflarăți	lemma
împovărați	împovăram	Person
răspândesc	răspândește	Person
gravitaționale	venerice	lemma
virtuoși	virtuoase	Gender
legendarul	legendara	Gender
coborâm	coborâți	Person
valahe	valah	Gender
binecuvântați	binecuvânta	Person
acuzatei	acuzatului	Gender
alăptând	înfăptuind	lemma
introduceți	introdu	Person
murdăriră	murdărirăm	Person
socializase	socializaseși	Person
iluzorie	iluzoriu	Gender
diurn	diurni	Gender
aluminiferii	aluminiferului	Gender
destupai	destupa	Person
ploioși	ploioase	Gender
incompleților	incompletul	Gender
înăbușirăm	înăbușirăți	Person
încercau	încerca	Number
fadului	fazilor	Gender
reușiseră	reușiserăți	Person
înguștilor	îngustei	Gender
democraticii	democratica	Gender
utilizează	utilizați	Person
friguroșilor	frigurosului	Gender
pierde	pierzi	Person
unea	uneau	Number
masiv	argintiu	lemma
îmbătrâneai	îmbătrâneau	Person
internațional	internațională	Gender
dinamic	dinamice	Gender
bat	batem	Person
târzie	târzii	Gender
genetice	genetici	Gender
koala	caldarâmule	lemma
bolnavii	bolnavul	Gender
veneraserăm	încuiaserăm	lemma
deprindeam	deprindeai	Person
încărcați	încarci	Person
motoarelor	dormitoarelor	lemma
scormonește	scormonești	Person
necăjirăți	necăjiși	Person
vitamină	vitaminelor	Number
geograficei	geograficului	Gender
invincibil	invincibilă	Gender
cuvioasei	cuvioșilor	Gender
românești	românesc	Gender
socotit	socotiți	Gender
milimetrice	milimetric	Gender
lepădase	lepădasem	Person
întâlniseră	întâlnisem	Person
osoasa	ososul	Gender
observant	observantă	Gender
moldovenescul	moldoveneștii	Gender
nativul	tovărășescul	lemma
ies	ieși	Person
slutei	sluților	Gender
fertile	fertil	Gender
viteză	vitezelor	Number
zgâiși	zgâi	Person
piersicași	piersicară	Person
regești	terții	lemma
dorm	dormim	Person
paraliticii	boantele	lemma
greșeam	greșeau	Person
iacule	iacilor	Number
lucioase	dialectale	lemma
aduseseși	aduseseră	Person
pruncii	ciungi	lemma
scurtaseși	scurtaserăm	Person
ornat	bucuros	lemma
plăcuți	plăcută	Gender
genetic	genetică	Gender
creștină	creștini	Gender
măreț	brazilianului	lemma
intern	internă	Gender
românești	evreiești	lemma
marini	marin	Gender
brazilianule	brazilienilor	Gender
timid	timide	Gender
primilor	primei	Gender
юбя	юбям	Person
marine	marin	Gender
simpli	simplă	Gender
haitianului	haitiana	Gender
socotiserăți	socotiseși	Person
scoatem	scoateți	Person
oblice	folositoare	lemma
unește	uniți	Person
fricoasa	fricosului	Gender
îngrijiți	îngrijesc	Person
tușiși	ciopliși	lemma
plătit	dezlegat	lemma
nauruan	geografic	lemma
venerez	venerăm	Person
necinstită	necinstiți	Gender
specifice	specific	Gender
sună	conveni	lemma
traduse	disecă	lemma
acvatică	acvatici	Gender
topea	îngreuna	lemma
nemilos	nemiloși	Gender
pasăre	păsărilor	Number
skanderbegul	cămașa	lemma
măritaserăm	măritase	Person
crunt	crunte	Gender
nechibzuit	nechibzuite	Gender
futabilei	futabililor	Gender
poate	pot	Person
părintească	părintești	Gender
ruginești	bulucești	lemma
luminoasă	veselă	lemma
mincinoși	mincinos	Gender
surprind	înrâuresc	lemma
acvilă	acvilelor	Number
laia	lăii	Gender
impredictibile	impredictibil	Gender
vinetei	vineților	Gender
necinstite	necinstit	Gender
binefăcătoare	binefăcător	Gender
grasa	grasul	Gender
dezrobiserăți	dezrobise	Person
obscenul	dialectalul	lemma
obezului	obezilor	Gender
vedeți	vezi	Person
dublu	duble	Gender
secretul	secretei	Gender
întunecarăți	întunecară	Person
străvăzuserăm	clocotiserăm	lemma
netezi	neted	Gender
răpiți	dovediți	lemma
cuvioșii	cuvioasa	Gender
creștina	creștinii	Gender
rotunjite	amfibii	lemma
lânceda	lâncedul	Gender
rotunjiți	rotunjit	Gender
izgonii	izgoniră	Person
înverziră	înverzirăm	Person
sacrei	sacrul	Gender
îmbrățișa	îmbrățișați	Person
intime	intimi	Gender
prețuit	desprins	lemma
acuzata	grasa	lemma
umple	umplu	Person
însoriseră	însorisem	Person
regaliști	alotropici	lemma
cinseserăți	cinseseși	Number
interni	intern	Gender
chițăise	chițăiseră	Person
aberantele	fertilele	lemma
încercuiți	încercuiește	Person
sfântă	sfintelor	Number
abdica	abdicai	Person
spintecați	spintecam	Person
șuierați	șuierăm	Person
fadă	fazi	Gender
gustos	gustoși	Gender
aprigi	aprigă	Gender
obezi	obez	Gender
respirase	respiraseră	Number
apuserăți	apusei	Person
ucidea	ucideau	Person
secundari	secundar	Gender
pieriți	piere	Person
separați	separă	Person
întinseră	întinse	Number
tiselor	furtunurilor	lemma
istoricii	istoricul	Gender
cântăriseși	cântăriserăți	Number
îmboldești	îmboldiți	Person
spân	unsuros	lemma
influențară	influențarăm	Person
păroase	păroși	Gender
lipsești	lipsește	Person
incomplet	incompletă	Gender
asemeni	aseamănă	Person
distractivei	distractivului	Gender
bietei	bieții	Gender
rușina	rușinau	Number
plimbarăți	făptuirăți	lemma
șezu	șezură	Person
alegea	bucura	lemma
rezistențelor	ciocolatelor	lemma
accelerează	deretică	lemma
drăguță	drăguț	Gender
dinamici	dinamice	Gender
prezentei	prezentului	Gender
instabilitate	zircon	lemma
apropia	apropiau	Number
descărcaseră	descărcaseși	Person
stricați	stricate	Gender
celtă	celți	Gender
clocotea	clocoteam	Person
intempestivă	intempestiv	Gender
cacă	caci	Person
macre	macri	Gender
repauzaserăți	repauzaseși	Person
calde	calzi	Gender
urmărind	ciocnind	lemma
naționala	balcanica	lemma
înfumurai	înfumurarăți	Person
supravegheați	supraveghează	Person
rotire	rotirilor	Number
aromânești	aromânesc	Gender
ferestruirăți	ferestruiră	Person
vulpanule	vulpanilor	Number
neioasa	neiosul	Gender
urcați	urcam	Person
treceam	treceați	Person
aeriseam	aeriseai	Person
părintești	anale	lemma
nepopulare	alotropice	lemma
descriu	descrie	Number
extern	externi	Gender
influențarăți	clătinarăți	lemma
draga	dragului	Gender
solară	solar	Gender
nenumărabil	nenumărabile	Gender
împrăștiai	împrăștiarăm	Number
gâscanule	gâscanilor	Number
poștale	poștal	Gender
fracturarăți	fracturași	Number
italiancă	bluză	lemma
suveran	suverană	Gender
relaxate	armene	lemma
afină	vocativule	lemma
perniță	pernițelor	Number
nemilosul	nemiloasei	Gender
rațional	raționale	Gender
bulucim	buluciți	Person
potabili	potabile	Gender
adăugați	înspăimântați	lemma
poștalilor	poștalului	Gender
moare	mor	Person
circumscriați	circumscriai	Person
enorma	enormul	Gender
îndeletniciră	îndeletnici	Number
pretențios	pretențioasă	Gender
pregetam	învioram	lemma
păzește	păziți	Person
libidinosul	libidinoasa	Gender
mișcați	ferecați	lemma
anglicanii	anglicana	Gender
stimulai	coborai	lemma
amestecăm	amestec	Person
mișto	dulci	lemma
păduche	păducheară	Number
unirăți	uniră	Person
cuprinsul	cuprinsa	Gender
ungurești	ungurească	Gender
mestecași	mestecă	Person
obscen	obscene	Gender
strâmte	câmpenești	lemma
fundezi	fundează	Person
îmbărbătași	îmbărbătară	Person
terapeuticei	terapeuticilor	Gender
înlocuiți	înlocuim	Person
exagerată	exagerat	Gender
ușuratic	ușuratice	Gender
labă	labelor	Number
teme	tem	Person
apare	apăreți	Person
bianuale	bianual	Gender
închisă	închiși	Gender
înotătoare	înotătoarelor	Number
excită	excitară	Person
nostalgic	dumnezeiesc	lemma
ținutul	ținutei	Gender
tărăgănaserăm	comandaserăm	lemma
bolnava	bolnavii	Gender
lingvistici	lingvistice	Gender
cercați	cercam	Person
episcopală	episcopal	Gender
lugubrului	lugubrilor	Gender
unsuroasă	unsuros	Gender
preferară	ascuțiră	lemma
invariabil	invariabile	Gender
bulangiule	bulangiilor	Number
dătătorului	dătătorilor	Gender
principalei	principalului	Gender
adorasem	adoraserăți	Person
potabilități	îmbătrâniri	lemma
înfrunzesc	înfrunzește	Person
electromagnetic	electromagnetici	Gender
păgânism	suprarealism	lemma
bestială	bestial	Gender
milimetric	analog	lemma
lasciv	lascive	Gender
prezenți	prezent	Gender
imos	curat	lemma
întemeia	întemeiau	Person
învechitul	învechitei	Gender
renume	bisexualități	lemma
perete	pereților	Number
zăpadă	zăpezilor	Number
gavialule	gavialilor	Number
gras	grași	Gender
îmbogățiți	îmbogățim	Person
creștinești	creștinesc	Gender
celebrare	celebrărilor	Number
pare	încadrează	lemma
araserăm	arase	Person
cinetică	cinetic	Gender
adormitul	adormiților	Gender
inteligibile	chimice	lemma
comunica	comunicau	Number
britanici	britanică	Gender
încărcăm	încarcă	Person
acrișorului	acrișoara	Gender
grașilor	grasei	Gender
irlandezului	irlandezilor	Gender
moldoveneasca	moldovenescului	Gender
virtuoșilor	virtuosul	Gender
alungi	alungați	Person
continentali	continental	Gender
judeca	judecam	Person
cerură	ceru	Number
hinduism	boare	lemma
adună	defaimă	lemma
perversitate	perversităților	Number
dezmăț	dezmeți	Person
ceream	cerea	Person
omniscienții	omniscienta	Gender
odihnea	încrunta	lemma
scorniți	combinați	lemma
completei	completul	Gender
albei	albului	Gender
omorâserăm	dezmierdaserăm	lemma
asprului	aspra	Gender
înghețatul	înghețaților	Gender
învinserăm	învinsei	Person
lesbienei	lesbianului	Gender
neutra	neutrului	Gender
acronimule	acronimelor	Number
principalei	principalilor	Gender
primă	prim	Gender
castravete	castraveților	Number
gustările	bobocii	lemma
pornografică	sură	lemma
recunoscuți	recunoscut	Gender
învățai	învățați	Number
spovedesc	spovedește	Person
poruncesc	poruncim	Number
orgasmule	orgasmelor	Number
magazinerule	magazinerilor	Number
scânteiaseși	scânteiase	Person
delicată	delicați	Gender
salariatul	salariaților	Gender
construiesc	construiește	Person
ciudate	ciudați	Gender
adevărata	adevăraților	Gender
propuneai	destrăbălai	lemma
mulțime	mulțimilor	Number
forjasem	forjaserăți	Person
pescoși	pescos	Gender
vitregii	vitregul	Gender
fierți	fiert	Gender
albastrul	albaștrii	Gender
miști	mișcă	Person
sfâșiați	asimilați	lemma
folositorul	folositoarei	Gender
jucați	animați	lemma
tăbăciți	tăbăcește	Person
relaxați	relaxate	Gender
pictatei	pictaților	Gender
veșnicei	veșnicul	Gender
normalitate	teism	lemma
trăiește	chiorăște	lemma
mori	muriți	Person
moldoveanului	moldovenilor	Gender
laurule	laurilor	Number
iernară	iernai	Person
căprești	căprească	Gender
parcam	parcați	Person
femininilor	femininului	Gender
sparții	sparta	Gender
oficiali	oficial	Gender
sonată	sonatelor	Number
pleci	pleacă	Person
albe	alb	Gender
abili	abilă	Gender
bivalenților	bivalentului	Gender
călătoare	călătoarelor	Number
părăsind	botezând	lemma
dragilor	dragul	Gender
emoționalul	emoționalii	Gender
opiu	zahăr	lemma
urcata	urcații	Gender
pavează	întinde	lemma
îngrășasem	îngrășaseși	Person
economici	economic	Gender
integrali	integral	Gender
atacă	atacați	Person
divorțaseră	divorțase	Number
luau	luați	Person
dragilor	dragului	Gender
netedă	netezi	Gender
epuizară	epuizai	Person
scăpătam	scăpătați	Person
mânecase	mânecasem	Person
cunoscute	cunoscuți	Gender
împodobiți	împodobesc	Person
trăncăneam	trăncăneai	Person
porneați	porneam	Person
abațiilor	CD-ului	lemma
versatilului	versatilii	Gender
peticise	peticiseră	Person
șchiopăt	șchiopătă	Person
izolat	izolate	Gender
scâncisem	scânciserăm	Number
neprietenos	neprietenoase	Gender
îngustați	îngustam	Person
stricat	colorat	lemma
arabul	arabule	Gender
strânge	cară	lemma
masturbezi	masturbează	Person
alcătuise	alcătuiseră	Person
acuzat	acuzată	Gender
valsăm	valsez	Number
nevăzute	chele	lemma
versatil	versatili	Gender
purpuriu	purpurii	Gender
putreda	cinetica	lemma
țigănești	țigăniți	Person
recunoscutei	recunoscuților	Gender
judecam	vătămam	lemma
atinsese	atinseseră	Person
nimereai	nimereați	Number
omori	forfotești	lemma
haoticul	haoticii	Gender
ghiujule	ghiujilor	Number
uscați	uscată	Gender
ațâțați	ațâța	Person
alunecăm	alunecați	Person
deșirasem	deșiraserăm	Number
isteților	isteața	Gender
traduci	traduceți	Person
luați	întunecați	lemma
slujiseră	slujise	Person
blestemați	blestemă	Person
rânză	rânzelor	Number
fericit	fericiți	Gender
scufundat	scufundate	Gender
nerezervate	atlantice	lemma
supunea	desfăcea	lemma
tridimensionale	tridimensional	Gender
măsea	dimensionare	lemma
suflecai	înfometai	lemma
demnă	demn	Gender
tinseră	tinsei	Person
invadați	înșelați	lemma
clari	clare	Gender
rămân	rămâneți	Person
cicliști	cicliste	Gender
apoase	apos	Gender
ocupați	comportați	lemma
nepopular	nepopulară	Gender
fertil	fertile	Gender
aromâne	aromânilor	Gender
zgardă	zgărzilor	Number
crăpaseră	crăpaserăți	Person
acoperi	copleși	lemma
prăjirăm	prăjirăți	Person
imaginam	imagina	Person
târziului	târziilor	Gender
masculini	masculină	Gender
slujbă	șoaptă	lemma
unind	convingând	lemma
omeneștilor	atenților	lemma
stăruiai	înecai	lemma
păros	păroase	Gender
strugure	strugurilor	Number
târzie	târziu	Gender
internaționalul	flămândul	lemma
tipăresc	forțez	lemma
analogi	analog	Gender
susținuși	susținurăți	Number
modificarăți	modificai	Person
albaștrilor	dramaticilor	lemma
oacheșei	văduvilor	lemma
slăvisem	defăimasem	lemma
discrete	discret	Gender
bolnav	bolnavi	Gender
argintii	argintiu	Gender
jucase	jucaseră	Number
străbați	bărbierești	lemma
tânjise	tânjiserăm	Person
traversasem	traversaserăm	Person
aflau	aflați	Person
unicii	unicei	Gender
homofobicii	antagonicii	lemma
grosul	groasa	Gender
bulbucați	bulbuc	Person
fermecătorilor	fermecătorului	Gender
vădoși	vădos	Gender
dubli	dublu	Gender
cenușii	cenușiu	Gender
uneați	uneai	Person
risipiră	risipirăți	Person
mutam	mutați	Person
logodiți	logodește	Person
chimici	chimic	Gender
interfață	interfețelor	Number
roșiei	roșul	Gender
miră	mirați	Person
arunca	aruncam	Person
stăruiești	folosești	lemma
focosul	focoșilor	Gender
obligați	oblig	Person
trădezi	contrazici	lemma
grele	foioase	lemma
fragedă	fraged	Gender
spectral	emoțional	lemma
înfoi	înfoaie	Person
gălbui	faine	lemma
genă	genelor	Number
adulmecă	înnoiește	lemma
învinsă	învins	Gender
supremi	supremă	Gender
însuflețeați	însuflețeai	Number
amuză	amuzați	Person
ploios	fad	lemma
flexibil	flexibilă	Gender
hotărăște	hotărăsc	Person
ironică	ironic	Gender
neios	neioasă	Gender
scumpiși	scumpi	Person
reluase	reluaseră	Person
renovează	clocotesc	lemma
curge	curgem	Person
prinzi	prindeți	Person
sec	seci	Gender
plăcut	plăcuți	Gender
studentule	studenților	Number
largul	largii	Gender
brunii	brunei	Gender
crunți	cruntă	Gender
cucerim	cuceresc	Number
vădoasei	vădosului	Gender
ruginiserăți	ruginiseră	Person
întremarăți	întremași	Number
glumiși	glumi	Person
tarilor	tarii	Gender
slavi	slav	Gender
lătrase	îmboldise	lemma
nebunisem	nebuniserăm	Person
răpesc	răpește	Number
pătură	păturilor	Number
economic	economică	Gender
tații	facilitățile	lemma
lărgeau	coteau	lemma
peșteră	peșterilor	Number
fonetic	fonetici	Gender
descrise	descriserăți	Person
odihnise	odihniserăm	Person
exteriori	exterioară	Gender
miră	mir	Person
microbiologicilor	microbiologica	Gender
inteligentei	inteligenții	Gender
discut	discutăm	Number
lăsaseși	lăsase	Person
afli	aflați	Person
sughițaseși	sughițaserăți	Number
asigur	asiguri	Person
împutăciune	împutăciunilor	Number
mursecau	murseca	Number
hotărâse	hotărâseră	Person
gravată	gravat	Gender
tipărirăm	tipări	Person
neted	trandafiriu	lemma
utilă	utili	Gender
valsule	valsurilor	Number
minusculi	minuscul	Gender
neadecvat	neadecvată	Gender
vetrice	vetricelor	Number
carnivori	carnivoră	Gender
retrasese	retrasesem	Person
pasează	descompun	lemma
orchestral	orchestrală	Gender
încununarăm	încununai	Number
oneste	onest	Gender
credincioșii	credincioasei	Gender
conțin	conții	Person
tanrecul	собеле	lemma
benzinărie	benzinăriilor	Number
skandenberg	creștinătăți	lemma
îmbătau	îmbătam	Person
ridiche	ridichilor	Number
fereastră	ferestrelor	Number
preistorici	preistoric	Gender
găurește	dezgheață	lemma
intuit	înfocat	lemma
pofticios	pofticioși	Gender
dublul	dubla	Gender
plutise	plutiserăți	Person
botezată	botezați	Gender
răpuserăm	răpusei	Person
salută	salutăm	Person
ridica	ridicam	Person
pierii	pieriși	Person
carteziana	cartezianului	Gender
sănătoasă	sănătoși	Gender
putredul	putredei	Gender
maturitate	biofizică	lemma
angajați	angajăm	Person
credincioasei	credinciosului	Gender
mucoase	mucos	Gender
necunoscută	necunoscut	Gender
înconjuraserăm	înconjurasem	Person
blocați	blochezi	Person
scâncirăți	scânciși	Number
soporiferei	soporiferului	Gender
desculțaseși	desculțaserăm	Person
moldovenească	moldovenesc	Gender
specifici	specifică	Gender
sinistre	eterogene	lemma
văzu	văzură	Number
bancnotă	bancnotelor	Number
ploioasă	ploios	Gender
omenoși	omenoasă	Gender
izoleucină	treacăt	lemma
inteligent	inteligentă	Gender
rupeai	rupeau	Person
senini	aritmetici	lemma
pedepsiși	pedepsi	Person
fermecătoarea	fermecătorul	Gender
măcinat	șters	lemma
spinoase	viteze	lemma
voiajorule	voiajorilor	Number
smintit	declarat	lemma
mură	discută	lemma
adverbiale	înghețate	lemma
omogen	omogene	Gender
răstigniți	delăsați	lemma
opriră	oprii	Person
importantului	importanții	Gender
obscura	obscurul	Gender
sugrumă	sugrumi	Person
intenționez	fac	lemma
bianuală	bianual	Gender
oprește	opresc	Person
puternică	puternici	Gender
mureai	apăsai	lemma
calcă	călcați	Person
pasaserăm	îndepărtaserăm	lemma
poștalului	poștalei	Gender
înfierbânta	înfierbântai	Person
histologice	tăioase	lemma
arătați	arătăm	Person
creativi	creativ	Gender
calculatei	calculatul	Gender
desculțe	desculți	Gender
mincinos	mincinoși	Gender
pungă	pungilor	Number
rectitudine	zoologie	lemma
săpat	înrudit	lemma
simulare	simulărilor	Number
fain	faini	Gender
distruseseră	distrusese	Person
deplasa	deplasai	Person
misterioasei	misteriosul	Gender
țigănești	țigănesc	Gender
fripserăm	fripsei	Person
scădem	scazi	Person
înfrățești	înfrățește	Person
insistaseși	insistase	Person
păsărească	păsăresc	Gender
ocările	șobolanii	lemma
rușinați	explicați	lemma
minoritatea	aurora	lemma
nud	emoțional	lemma
absorbitului	absorbiților	Gender
veninos	veninoasă	Gender
surpam	surpai	Person
sărați	sărat	Gender
nasoală	nasol	Gender
sufletească	sufletești	Gender
inteligenților	inteligentul	Gender
despusese	despuseseră	Person
economică	economici	Gender
reînnoia	astupa	lemma
ceteraserăți	ceteraserăm	Person
popularități	comunism	lemma
insidioșilor	insidioasa	Gender
amabil	amabili	Gender
neutre	frunzoase	lemma
atrocitate	atrocităților	Number
destinați	destinată	Gender
lungi	vulgari	lemma
enigmaticului	enigmaticii	Gender
absorbit	absorbiți	Gender
împăduriți	împăduresc	Person
cafenii	cafenie	Gender
gălbuie	gălbui	Gender
locuiesc	apropie	lemma
furnică	furnicilor	Number
pornea	porneam	Person
reflectați	reflectată	Gender
echinocțiule	echinocțiilor	Number
binefăcătoare	binefăcători	Gender
romancierule	romancierilor	Number
aliatule	aliaților	Number
citeau	citeam	Person
serioasa	serioșii	Gender
demne	demn	Gender
muzical	umbros	lemma
jignim	jignește	Person
lucrătoare	lucrători	Gender
scufundași	scufundarăți	Person
botezase	botezasem	Person
haoticei	haoticilor	Gender
ședință	ședințelor	Number
irațională	ejaculatoare	lemma
riscă	riscați	Person
bolnave	bolnav	Gender
fierbintea	fierbinții	Gender
misterioase	misterioși	Gender
reținea	rețineau	Number
pictata	critica	lemma
lesbian	lesbiană	Gender
molie	moliilor	Number
rezistam	înfulecam	lemma
arete	areților	Number
biologici	biologice	Gender
legaseră	legasem	Person
singure	virile	lemma
susuraserăți	susurasem	Person
opiului	urechii	lemma
decafeinizatului	decafeinizata	Gender
oblici	oblică	Gender
punctau	punctam	Person
raționale	capitaliste	lemma
profundelor	îngereștilor	lemma
scuturaseși	îmbucaseși	lemma
japonezului	japonezilor	Gender
murdari	murdar	Gender
trăim	trăiesc	Number
chinezului	chinezilor	Gender
comunul	comuna	Gender
lungi	lungă	Gender
înrudiseră	înrudise	Number
omniprezente	amicale	lemma
dumică	dumicați	Person
carteziana	cartezianul	Gender
gravată	gravați	Gender
gălbinărilor	ciorilor	lemma
tarele	tarilor	Gender
apropiați	apropiam	Person
nucă	nucilor	Number
aprig	aprige	Gender
interviule	interviurilor	Number
păcălesc	păcălește	Person
pisicii	dulgherilor	lemma
prezentă	prezenți	Gender
renumele	globalizarea	lemma
întrebuințau	întrebuințați	Person
vamalei	vamalii	Gender
chimice	chimic	Gender
înzestra	înzestrau	Number
suflecarăți	suflecarăm	Person
ieșiți	despăducheați	lemma
comport	comportăm	Number
rătăcitului	rătăcitei	Gender
căzuse	căzuseră	Person
haleai	haleați	Person
cărare	cărărilor	Number
neregalului	târziului	lemma
emeriți	emerit	Gender
exoticul	exotica	Gender
prins	prinsă	Gender
intrase	intraseră	Person
refuză	refuzăm	Person
traduc	traduci	Person
orbește	înjunghie	lemma
ultimă	ultim	Gender
digitalul	digitalii	Gender
supraviețuiești	supraviețuiesc	Person
gorilă	gorilelor	Number
dăunați	dăunez	Person
naivă	naiv	Gender
uitasem	uitase	Person
construiți	construiești	Number
interesanți	interesant	Gender
taifunule	taifunurilor	Number
argilosului	argiloșilor	Gender
pierd	pierzi	Person
depărtaseră	depărtase	Person
știuseră	știuseși	Person
opărite	formidabile	lemma
mortul	morților	Gender
sapi	sap	Person
scurmasem	crescusem	lemma
disecaseră	disecasem	Person
agresiv	agresive	Gender
risipiți	risipesc	Person
rânced	râncede	Gender
spinoși	spinoase	Gender
furnicași	furnicarăți	Number
dezvățaseși	dezvățasem	Person
futurăm	futură	Person
fripta	fripților	Gender
izolată	izolat	Gender
explicative	explicativ	Gender
raționali	rațională	Gender
somaseși	coborâseși	lemma
rezolvă	rezolvați	Person
nasolul	nasoalei	Gender
socotit	socotite	Gender
afânasem	coperisem	lemma
răniserăți	înmulțiserăți	lemma
agățat	viril	lemma
dovediți	dovedește	Person
voameți	vomi	Number
pulpoasei	tandrei	lemma
ursule	urșilor	Number
vomuse	vomuserăm	Person
prostiși	prosti	Person
ascunsă	ascunși	Gender
drăgălaș	drăgălașe	Gender
foloseați	foloseau	Person
rătăcit	fript	lemma
masturbare	masturbărilor	Number
cenușiu	cenușie	Gender
aromâneasca	aromânescului	Gender
aglomerat	aglomerată	Gender
singura	singurului	Gender
lăcrimează	articulează	lemma
sunau	sunam	Person
maghiari	maghiare	Gender
omogeni	omogene	Gender
topiți	deveniți	lemma
cântase	cântaserăm	Person
sfulgeraserăți	concepuserăți	lemma
britanice	britanic	Gender
supără	supărați	Person
epuizaseră	epuizase	Number
pețesc	pețiți	Person
structuraților	structuratul	Gender
mișcând	zburdând	lemma
utilizăm	utilizați	Person
izgonea	izgoneau	Person
suspensoarea	suspensorului	Gender
desenez	desenați	Person
atotputernici	atotputernic	Gender
noul	noua	Gender
prăseai	prăseați	Person
încălecaserăm	încălecasem	Number
trandafirii	trandafiriu	Gender
adumbrii	adumbrirăm	Person
omenești	dezvoltate	lemma
șușuiră	șușuirăți	Person
dezvoltați	dezvoltate	Gender
port	poartă	Person
micșorară	circumscriseră	lemma
posibilitate	posibilităților	Number
transpira	chițcăia	lemma
articulați	articulează	Person
podurilor	distracțiilor	lemma
scuipi	scuipă	Person
ciudat	ciudate	Gender
lumina	bungeturile	lemma
rătăcitei	rătăciții	Gender
emoționalului	emoționalei	Gender
polonezului	polonezilor	Gender
agresivă	agresiv	Gender
vorbitoare	vorbitoarelor	Number
omnipotent	omniscienți	Gender
nocturni	nocturn	Gender
aritmetică	aritmetic	Gender
pornografice	pornografic	Gender
păroasa	părosul	Gender
balcanici	balcanic	Gender
pederastie	comerț	lemma
așezară	așeză	Person
gândiți	înconjurați	lemma
aprindeai	aprindeam	Person
parazitar	parazitari	Gender
norocoasă	calculată	lemma
tristei	tristul	Gender
guvernați	conjugați	lemma
măsuram	încuiam	lemma
dezrobiseși	dezrobiserăți	Number
neprietenoase	amabile	lemma
pulpoasa	pulpoșilor	Gender
apar	apăreți	Person
urbanizau	urbaniza	Number
vitrega	vitregii	Gender
spiritual	spirituali	Gender
lichizi	cosmici	lemma
enciclopedie	enciclopediilor	Number
atacaseși	atacasem	Person
ascensiune	ascensiunilor	Number
creștini	creștină	Gender
compara	comparau	Person
prețuiți	prețuiesc	Person
mustăcioară	mustăcioarelor	Number
osoase	dogmatice	lemma
musculoase	musculoși	Gender
alba	albul	Gender
recea	coborâta	lemma
riscăm	riscați	Person
oliva	fraga	lemma
faleză	falezelor	Number
pornografule	pornografilor	Number
clarificam	clarificați	Person
admiri	admir	Person
îndulcise	îndulciseși	Person
crescuți	crescută	Gender
întoarcem	întorc	Person
excelasem	excelase	Person
pierdeau	pierdeam	Person
agăța	agățam	Person
gaură	găurilor	Number
spart	descrescut	lemma
împinsese	împinseserăm	Person
stindardule	stindardelor	Number
mângâiară	mângâiarăm	Person
opăriți	opărite	Gender
istețe	isteț	Gender
ciclistă	ciclist	Gender
răcni	răcnii	Person
comportați	comportă	Person
rotunjisem	rotunjiseră	Person
îmbunătățim	îmbunătățiți	Person
gustoși	gustos	Gender
milimetrica	milimetricii	Gender
frățească	frățești	Gender
compleți	complet	Gender
încărcați	încărcăm	Person
încălzește	încălzești	Person
formidabili	formidabile	Gender
răgușiți	răgușit	Gender
reflectata	suprema	lemma
vânjoși	vânjoasă	Gender
plutit	încorporat	lemma
asturianul	asturianule	Gender
observante	observanți	Gender
delicat	delicată	Gender
înspăimânta	înspăimântați	Person
perseverează	înfăptuiește	lemma
legasem	legaserăm	Number
simetrici	simetrică	Gender
înlocuiesc	înlocuim	Person
răsculați	împovărați	lemma
urâte	urât	Gender
mergea	mergeau	Number
cuprinse	cuprinși	Gender
lăsata	lăsatul	Gender
minunezi	minunați	Number
pitorească	pitorești	Gender
noapte	nopților	Number
deșideraserăm	deșideraseși	Person
căpătase	căpătaseră	Number
peristaltică	înceată	lemma
vărsați	varsă	Person
ospătarăm	ospătarăți	Person
calculat	calculată	Gender
formidabil	formidabilă	Gender
portocală	portocalelor	Number
prinsa	germana	lemma
descriere	descrierilor	Number
lichizi	lichid	Gender
inestetic	inestetică	Gender
rusesc	rusească	Gender
neapărat	neapărată	Gender
intim	intime	Gender
malteză	maltez	Gender
colorat	colorate	Gender
reușesc	reușim	Person
necunoscute	necunoscut	Gender
urzeam	urzeați	Person
uimeați	uimeai	Person
refecai	refecarăm	Number
franțuzoaică	franțuzoaicelor	Number
urau	încetau	lemma
binefăcătorii	binefăcătoarea	Gender
electromagneticei	electromagneticului	Gender
nemilosul	nemiloasa	Gender
repauzau	repauzai	Person
bobocule	bobocilor	Number
delirantul	deliranta	Gender
plăcutului	plăcuta	Gender
raționale	rațional	Gender
șansă	șanselor	Number
unidirecționalei	unidirecționalului	Gender
omenie	aroganță	lemma
patule	paturilor	Number
leton	letoni	Gender
acuzate	acuzați	Gender
adoptăm	adopți	Person
desprindeți	desprindem	Person
germanei	germanilor	Gender
înghițiși	înghițirăți	Number
mulg	culcă	lemma
psihoză	femeie	lemma
alților	altului	Gender
emeriți	emerite	Gender
gravaților	gravatei	Gender
orelor	bunicilor	lemma
mănânc	mănâncă	Person
bolnav	bolnavă	Gender
propunere	propunerilor	Number
intempestive	sulfuroase	lemma
perineal	perineală	Gender
hulitul	hulitei	Gender
cunoscut	cunoscuți	Gender
învățai	învățarăm	Person
juisaserăți	juisaseși	Number
veșnici	veșnică	Gender
uzi	ud	Gender
dărăciseși	dărăciserăți	Number
răstignim	răstignește	Person
albul	albilor	Gender
olimpicul	olimpicilor	Gender
aflară	cerșiră	lemma
mișună	mișunară	Person
dependent	dependente	Gender
femininul	femininii	Gender
vâscos	vâscoasă	Gender
lutoase	lutos	Gender
numărând	înnoind	lemma
neuitabililor	neuitabila	Gender
tăbăci	așternu	lemma
zărganule	zărganilor	Number
lungeam	lungea	Person
mașină	capabilitate	lemma
convenționali	convenționale	Gender
bazezi	bazați	Person
bivalentă	bivalenți	Gender
scoate	scot	Person
păduchearăm	înțeleserăm	lemma
cuviosului	cuvioasei	Gender
somnifer	filantropic	lemma
structural	structurală	Gender
vârtosul	vârtoasa	Gender
jurați	confruntați	lemma
distingeau	distingea	Person
prăjiți	înfrânați	lemma
scufundata	scufundații	Gender
coacem	coc	Number
nevăzute	vinete	lemma
amețesc	amețește	Person
violeții	violetului	Gender
ciupercă	ciupercilor	Number
comuni	comun	Gender
cunoscuta	cunoscuții	Gender
nearticulatul	experimentatul	lemma
zbier	zbieri	Person
oblicii	oblica	Gender
empirica	empiricii	Gender
lăcrimosului	lăcrimoșii	Gender
augurase	augurasem	Person
regesc	regești	Gender
populara	popularii	Gender
rezemase	rezemaseră	Person
izbăvirăți	izbăviși	Person
șchiopi	șchioapă	Gender
rebeliune	rebeliunilor	Number
păducheasem	păducheaserăți	Person
francezului	francezilor	Gender
plictisitoare	ungurești	lemma
copiază	copiezi	Person
răsturna	răsturnai	Person
sodomitule	sodomiților	Number
ars	arse	Gender
răstoarnă	înmânează	lemma
căzuți	căzută	Gender
furnicați	furnică	Person
populare	carteziene	lemma
greceștile	versatilele	lemma
apare	apari	Person
bengalezi	bengalez	Gender
multipolarul	cosmicul	lemma
activiștilor	apelor	lemma
flacără	flăcărilor	Number
enormului	enormei	Gender
adevăratului	adevăraților	Gender
orchestră	orchestrelor	Number
rânced	râncezi	Gender
trântești	înțepi	lemma
maroul	fonetica	lemma
ofensatorului	ofensatorii	Gender
adoptau	înlesneau	lemma
rațională	rațional	Gender
căzuta	căzuților	Gender
eronat	eronată	Gender
viteaza	vitejilor	Gender
izolați	izolat	Gender
preistorică	preistorici	Gender
crescută	crescuți	Gender
adeveresc	adeverește	Number
anali	anale	Gender
solar	solare	Gender
judecând	întreținând	lemma
adăstași	adăstarăm	Person
gândi	gândiră	Person
tandrul	tandrilor	Gender
insidioasă	insidios	Gender
urci	urcăm	Person
irațional	iraționali	Gender
muncea	munceau	Number
decade	decad	Number
înfrunziseși	înfrunzise	Person
intenționam	intenționa	Person
riscă	riscăm	Person
dogmaticul	dogmatica	Gender
cuviosului	cuvioasa	Gender
înlăturau	înlăturai	Person
fac	faceți	Person
îndrăgosteam	îndrăgostea	Person
visat	îndesat	lemma
pică	atacă	lemma
rătăciseră	rătăcise	Number
întâmpină	întâmpin	Person
speriați	speriat	Gender
porniți	pornești	Person
instanții	instantului	Gender
obscur	obscure	Gender
apropie	apropiem	Person
susceptibil	susceptibili	Gender
numim	numesc	Person
îngrozitor	îngrozitoare	Gender
plictisitoarea	plictisitorii	Gender
sortiseră	sortise	Person
mărunți	măruntă	Gender
dezunisem	dezuniserăm	Person
inflorescență	inflorescențelor	Number
legendare	apocaliptice	lemma
necăjiți	închipuiți	lemma
desziseserăm	desziseseși	Person
irită	circumscriu	lemma
minuscula	minusculul	Gender
dezvoltam	dezvoltați	Person
întărâtai	întărâtară	Person
albicioși	discreți	lemma
adâncesc	contenesc	lemma
slăvim	slăvești	Person
pișcotule	pișcoturilor	Number
bravi	brave	Gender
teoricilor	teoricei	Gender
îmbătații	îmbătatei	Gender
satisfăcusem	celebrasem	lemma
dubli	duble	Gender
tociră	toci	Number
neregal	dezvoltat	lemma
preistoric	blând	lemma
pește	peștilor	Number
deșteaptă	deștepți	Gender
corcirăm	corciși	Person
înălțaserăm	înălțaseși	Person
prezentă	prezent	Gender
imaginezi	imaginăm	Person
descheie	deschei	Person
liberaseși	înghețaseși	lemma
nearticulate	femeiești	lemma
sare	închide	lemma
judecați	ținuți	lemma
reușești	reușim	Person
beam	beau	Person
pătură	vodcă	lemma
imperiala	imperialii	Gender
elimin	eliminăm	Person
poltronerie	poltroneriilor	Number
perfecți	perfectă	Gender
anteriori	anterioară	Gender
viezure	viezurilor	Number
dureros	dureroși	Gender
eronate	eronat	Gender
răsucit	crestat	lemma
blânzi	blândă	Gender
busolă	busolelor	Number
onestitate	comunism	lemma
strâmbă	cumpără	lemma
aprige	aprig	Gender
disponibila	disponibilului	Gender
aseamănă	asemeni	Person
măturam	măturai	Person
stăteam	stătea	Person
barară	bară	Person
târgui	zbură	lemma
tăioși	tăioasă	Gender
înfometam	înfometa	Person
stăpânisem	îmbunătățisem	lemma
icrelor	capabilităților	lemma
pingelisem	pingeliseși	Person
excursie	excursiilor	Number
căprioară	căprioarelor	Number
socializează	înțeapă	lemma
mișcaseră	cususeră	lemma
circulați	circulă	Person
speriate	continentale	lemma
lipit	îngrășat	lemma
polari	polară	Gender
deșideraserăți	deșideraseși	Number
strălucitorii	strălucitoarei	Gender
iernară	iernași	Person
ierboase	argiloase	lemma
roagă	întărește	lemma
stăteați	stătea	Person
suprem	supremi	Gender
terestru	terestre	Gender
integrabile	integrabili	Gender
virilului	virililor	Gender
izgonit	dumicat	lemma
prezenta	delicata	lemma
pătrundeți	pătrunzi	Number
enigmaticului	enigmaticilor	Gender
fad	fade	Gender
bârfiră	bârfirăm	Person
pregătește	pregătesc	Number
prăpădisem	prăpădiserăți	Person
christadelfianul	christadelfianule	Gender
dictau	dicta	Number
activam	activați	Person
credincioșilor	credincioasei	Gender
sfintele	erecția	lemma
stepă	stepelor	Number
vindecă	întrevede	lemma
știui	știură	Person
menținea	mențineați	Person
rași	rase	Gender
tinde	căsătorește	lemma
scoate	scoateți	Person
virilei	virilii	Gender
nădăjduia	conținea	lemma
obligi	obligați	Person
spirituali	spirituală	Gender
îneacă	înecăm	Person
socotii	socoti	Person
istețului	isteții	Gender
luminoase	luminoși	Gender
împrejmuiseși	împrejmuiseră	Person
aeroporturilor	coastei	lemma
demnului	demna	Gender
ziceam	ziceau	Person
fugiți	fugi	Person
timizi	timid	Gender
purificați	purifică	Person
omniscientă	omniscient	Gender
beată	beți	Gender
biologici	biologic	Gender
lăsați	lași	Person
setoasă	dezavantajoasă	lemma
miloase	vii	lemma
distinseseră	distinsese	Number
păzeau	păzea	Person
plinei	plinul	Gender
luminoși	luminoasă	Gender
servind	înghițind	lemma
inutilă	virilă	lemma
brutale	brutal	Gender
desculță	desculți	Gender
celt	celți	Gender
șoaptă	șoaptelor	Number
lung	erotic	lemma
greul	greii	Gender
ung	documentez	lemma
domină	domini	Person
statisticii	aromâneștii	lemma
cutreieră	cutreierați	Person
bălțați	bălțat	Gender
neioase	neioși	Gender
slugăriși	slugăriră	Person
cernurăm	cernură	Person
sting	contopesc	lemma
lucrătorului	lucrătorii	Gender
măritaserăm	măritaseră	Person
ofensator	ofensatoare	Gender
importante	fericite	lemma
dătătorul	dătătorule	Gender
dururoșii	dururoasei	Gender
noua	verdele	lemma
cireașă	cireșelor	Number
fierarule	fierarilor	Number
prășiră	zăpăciră	lemma
refuzați	încununați	lemma
masculinitate	boare	lemma
rătăciți	rătăcește	Person
înfierbântăm	înfierbânt	Person
intuiam	intuiați	Person
calculate	calculați	Gender
urcați	urcată	Gender
botanică	botanic	Gender
necuviincioși	unsuroși	lemma
utilizăm	utilizez	Person
plângeai	plângeați	Person
atlantic	atlantice	Gender
cerșiți	cerșești	Person
plat	plați	Gender
iese	ieși	Person
nemeritatului	nemeritaților	Gender
citadelă	citadelelor	Number
dezgustătorului	dezgustătorilor	Gender
compui	compuneți	Person
datori	datoare	Gender
olarul	cruzimile	lemma
ultimei	ultimilor	Gender
utili	utilă	Gender
aprindeai	aprindea	Person
piață	piețelor	Number
trimiteți	depărați	lemma
imprimi	întuneci	lemma
colorați	colorate	Gender
încarcă	încărcați	Person
experimentat	experimentată	Gender
influențează	influențați	Person
protejați	proteja	Person
atentului	atenta	Gender
fermecători	fermecător	Gender
rază	razelor	Number
credincioși	credincioase	Gender
masculin	masculini	Gender
trezești	trezim	Person
izolat	izolată	Gender
scufundată	scufundat	Gender
bășicaserăm	bășicase	Person
miră	țipă	lemma
păziserăți	păziseră	Person
grecești	grecesc	Gender
evaziv	evazivi	Gender
obez	obezi	Gender
pretențios	pretențioase	Gender
bârfii	bârfiși	Person
inteligibililor	inteligibilului	Gender
comândau	comândai	Person
adăugă	adăugai	Person
albicios	albicioase	Gender
terminați	termină	Person
extindem	extind	Person
plopule	plopilor	Number
împrejură	împrejurăm	Person
auzim	aud	Number
completa	completau	Person
gravate	gravați	Gender
organizație	organizațiilor	Number
pornografic	pornografice	Gender
certaseră	certaseși	Person
inteligent	consular	lemma
specifice	specifici	Gender
cunoscut	cunoscută	Gender
râzi	râd	Person
bietei	bietul	Gender
furați	fură	Person
necunoscutul	necunoscuţii	Gender
aprigă	aprig	Gender
sudică	sudici	Gender
confluență	confluențelor	Number
mirosisem	cumplisem	lemma
moarte	morților	Number
îngeresc	îngerești	Gender
istoricului	istoricei	Gender
plecarăm	plecă	Person
draga	dragii	Gender
simetric	simetrice	Gender
sefarzi	sefard	Gender
complexul	complecșii	Gender
demnă	demni	Gender
perturbatorului	perturbatorilor	Gender
vânturai	vântura	Person
simplificăm	simplifică	Person
elementari	elementare	Gender
letonului	letonei	Gender
exteriori	exterior	Gender
guvernau	guverna	Person
maimuță	maimuțelor	Number
mână	mâinilor	Number
înfierbântară	înfierbântași	Person
seninelor	șterselor	lemma
destinații	destinata	Gender
rusești	rusească	Gender
arzi	ardem	Person
jucarăți	jucară	Person
evreiesc	evreiască	Gender
mâneau	mâneai	Person
cotropirăți	cotropirăm	Person
ciudați	ciudată	Gender
împreunează	împreunezi	Person
muncă	muncilor	Number
strâmtă	strâmt	Gender
ciudat	ciudată	Gender
desculți	desculț	Person
gustos	gustoase	Gender
cuminecase	cuminecaserăți	Person
hienă	hienelor	Number
scaunule	scaunelor	Number
învinsului	învinșii	Gender
copleșesc	copleșiți	Person
misterioșii	misteriosul	Gender
numește	numesc	Person
neadecvată	neadecvat	Gender
apără	apărați	Person
atlantice	atlantic	Gender
puțiseși	țintiseși	lemma
tristă	trist	Gender
dogmaticii	dogmatica	Gender
pretențiosul	pretențioasei	Gender
importantului	toxicului	lemma
tăioasă	tăioși	Gender
halucinație	halucinațiilor	Number
accidentale	înghețate	lemma
oloagei	ologul	Gender
ornaților	ornatului	Gender
borâși	borârăm	Person
haotice	haotic	Gender
mucoasei	mucosului	Gender
delirant	delirante	Gender
imitare	imitărilor	Number
obligi	obligă	Person
simpla	simplii	Gender
afumase	cotropise	lemma
trist	triști	Gender
adăpostit	adăpostită	Gender
profunde	dramatice	lemma
înveninează	înveninați	Person
înota	înotau	Person
îngust	înguști	Gender
perinealilor	perineala	Gender
măsurați	măsura	Person
muced	zgomotos	lemma
topiseră	încălțaseră	lemma
încăpățânat	încăpățânată	Gender
sporesc	sporește	Person
buzunarule	buzunarelor	Number
spulberară	spulberă	Person
nivelară	nivelai	Person
bieți	biet	Gender
suverane	suveran	Gender
moare	bate	lemma
seduserăm	seduse	Person
lăbărțaților	lăbărțatului	Gender
interesași	interesară	Person
clocotii	clocotiră	Person
dezrobim	dezrobesc	Person
inimos	atlantic	lemma
albinos	albinoși	Gender
cășunau	cășuna	Person
insultaserăm	închinaserăm	lemma
auroră	aurorelor	Number
așeza	așezau	Person
spinos	spinoasă	Gender
îngrijiserăm	îngrijiseși	Person
anulă	anulai	Person
neprietenosului	vulgarului	lemma
spurcate	deștepte	lemma
turbați	turbai	Number
intoxică	depune	lemma
inteligibilă	inteligibili	Gender
sferici	sferic	Gender
soporificului	soporificii	Gender
nisipului	cocoșului	lemma
auguraseră	augurase	Person
comoară	comorilor	Number
exotice	exotic	Gender
cotidiana	cotidianului	Gender
diurn	diurnă	Gender
vomusem	vomuserăți	Person
stropea	stropeați	Person
lucioasă	lucios	Gender
atotputernică	atotputernic	Gender
prietenos	prietenoși	Gender
dezamăgește	dezamăgiți	Person
relaxaților	relaxatei	Gender
risipeam	risipea	Person
transpirarăți	transpirarăm	Person
ridicate	ridicați	Gender
seninei	seninilor	Gender
gândim	gândesc	Number
trage	trag	Number
țestoși	țestoase	Gender
răstigniși	răstignirăți	Number
nerezervata	aromânul	lemma
chimici	chimice	Gender
ager	ageră	Gender
purpuriii	purpuria	Gender
domină	dominai	Person
cerca	cercați	Person
pricepem	pricep	Person
ras	automatului	lemma
comuni	comune	Gender
creștem	crește	Person
prăjite	cicliste	lemma
agresivilor	agresivului	Gender
capitaliști	capitalist	Gender
ironicul	ironicei	Gender
adunasem	adunaseră	Person
guralivi	guralive	Gender
pregătit	întâmplat	lemma
spirituali	spirituale	Gender
străvăzuseră	străvăzusem	Person
dorii	dori	Person
pupam	vopseam	lemma
adultule	adulților	Gender
aprinserăm	aprinsei	Number
venisem	veniseră	Person
populari	știrbi	lemma
mirosi	mirosiră	Number
semnați	semnăm	Person
preveștesc	preveștiți	Person
cinetice	cinetic	Gender
stânga	stângul	Gender
invizibile	invizibili	Gender
caraghioasei	caraghioșilor	Gender
prășiși	prăși	Person
sfinți	sfinții	Person
brumăriu	brumărie	Gender
necinstitului	necinstiții	Gender
specificei	specificului	Gender
depărtaseră	depărtasem	Person
umbroasa	umbroșii	Gender
literă	literelor	Number
înmormânta	înmormântați	Person
treaptă	treptelor	Number
slujiră	slujii	Person
aroganți	arogantă	Gender
sparg	sparge	Person
topim	topește	Person
prind	prindeți	Person
codificat	codificate	Gender
murdăresc	dezic	lemma
globule	globurilor	Number
simțim	simțiți	Person
teoreticul	teoreticule	Gender
dimineață	dimineților	Number
inserție	inserțiilor	Number
traducea	cetera	lemma
nocturni	celți	lemma
răscoaceți	răscoace	Person
aglomerată	aglomerați	Gender
florentinul	florentine	Gender
femininei	femininului	Gender
grotelor	conturului	lemma
descoperire	descoperirilor	Number
bravii	bravul	Gender
imperiale	continue	lemma
cariotipule	cariotipurilor	Number
răspunzi	răspund	Person
polară	polari	Gender
tac	taci	Person
ridicam	ridicau	Person
sumeseseși	sumeseserăți	Number
sângeroasa	sângerosul	Gender
străvăd	străvede	Number
adormiți	adormit	Gender
secundare	secundari	Gender
încrunti	încruntă	Person
rozmarinule	rozmarinilor	Number
sughițase	sughițasem	Person
sexoșilor	supremilor	lemma
îngreunau	îngreunați	Person
pântecoasei	pântecosul	Gender
sărat	sărați	Gender
pornograficele	încăpățânatele	lemma
biserică	bisericilor	Number
curățai	curățași	Person
nearticulat	nearticulate	Gender
dezgusta	dezgustați	Person
anterioare	anterior	Gender
adăugai	împlântai	lemma
naționalei	naționalii	Gender
îmbunătății	îmbunătăți	Person
chei	chele	Gender
ureche	urechilor	Number
lichide	codificate	lemma
întrebară	întrebarăm	Person
supunere	supunerilor	Number
asurziți	asurzesc	Person
cioară	ciorilor	Number
înlocuiesc	înlocuiește	Person
ud	udă	Gender
inteligentei	inteligentul	Gender
mestecarăți	mestecară	Person
activitate	activităților	Number
prăsesc	prăsește	Person
plimbăm	plimb	Number
strănută	frige	lemma
egalului	egalilor	Gender
scrotalilor	scrotalul	Gender
cercetau	cerceta	Person
traversase	traversaserăți	Person
creștinesc	creștinești	Gender
plată	plat	Gender
alotropicului	alotropica	Gender
scufundaților	scufundatul	Gender
spurcate	spurcat	Gender
distila	distilau	Number
negai	înfocai	lemma
micului	micilor	Gender
numeau	numeam	Person
ornată	ornat	Gender
încadrăm	încadrezi	Person
terminai	terminară	Person
adunați	adună	Person
personalităților	bicicliștilor	lemma
valahe	valahi	Gender
scrupulozitate	elasticitate	lemma
legendarii	legendara	Gender
păsăreștii	păsărescului	Gender
spart	sparte	Gender
grea	grei	Gender
lini	line	Gender
sferici	sferică	Gender
fripte	fripți	Gender
lipitei	lipiților	Gender
trântit	trântiți	Gender
supărați	distrugeți	lemma
făinosului	făinoasei	Gender
răcesc	îmbracă	lemma
femeiescul	femeieștii	Gender
germanului	germanilor	Gender
trage	zăpăcește	lemma
rachetă	rachetelor	Number
înnegrii	înnegrirăți	Person
fișierule	fișierelor	Number
invariabilii	invariabila	Gender
invadează	invadați	Person
nominali	nominală	Gender
învolților	învoltului	Gender
indiscreți	indiscret	Gender
rătăcit	rătăcită	Gender
subteranii	subteranei	Gender
îmblânziserăți	îmblânzisem	Person
interne	cenușii	lemma
căzută	căzuți	Gender
sărbătoriți	sărbătorește	Person
sarcastice	sarcastic	Gender
desfăcuse	desfăcuserăm	Person
credincioșii	credinciosului	Gender
biochimici	biochimic	Gender
invizibil	invizibili	Gender
albastra	albaștrilor	Gender
credeți	crede	Person
redundant	redundantă	Gender
linserăți	linsei	Person
plicticoasă	plicticos	Gender
regalista	regalistului	Gender
sufletescul	sufleteștilor	Gender
orgastici	orgastic	Gender
terțului	terților	Gender
inseparabili	alți	lemma
utilizași	utilizarăți	Number
abdominală	abdominal	Gender
prăjiți	prăjești	Number
oacheșe	utile	lemma
întâlniseși	întâlnisem	Person
propunea	propuneam	Person
orgastica	orgasticului	Gender
îndepărtau	îndepărta	Number
folosii	folosirăți	Person
diastolice	diastolic	Gender
spălase	spălaserăm	Person
invariabil	invariabili	Gender
compuseseră	compusese	Person
arse	arși	Gender
nostalgică	nostalgic	Gender
juvenilii	suspensorii	lemma
supărăm	supără	Person
petrec	petreceți	Person
erotici	erotic	Gender
traduce	traduceți	Person
blocau	blocai	Person
prezervativului	cafelelor	lemma
bulbuci	bulbuc	Person
ezitasem	ezitase	Person
încurajăm	încurajez	Person
mirați	crestați	lemma
momirăți	momi	Person
fericiți	fericită	Gender
obișnuiești	ții	lemma
adevărat	adevărați	Gender
tușirăm	tușirăți	Person
laia	laiul	Gender
visai	visa	Person
lăi	veștezi	lemma
dreptului	drepturilor	Gender
limpezise	limpeziseră	Number
căprui	căpruie	Gender
românești	românească	Gender
cumplit	cumpliți	Gender
ceacârilor	ceacâra	Gender
caraghios	caraghioasă	Gender
multipolari	multipolară	Gender
lepădăm	leapădă	Person
furie	furiilor	Number
stabilesc	ghicesc	lemma
aritmetic	aritmetici	Gender
împacă	împăcați	Person
înmulții	înmulțirăm	Person
geograficii	geografica	Gender
masive	masivi	Gender
demnului	demnei	Gender
reala	realul	Gender
stricatul	stricatei	Gender
netezi	netede	Gender
caraghioasă	caraghioși	Gender
râiosul	cafeniul	lemma
infixule	infixelor	Number
târzii	târziu	Gender
spurcai	spurcă	Person
disponibile	disponibil	Gender
micșorași	închipuiși	lemma
fericitului	fericiții	Gender
ciudatul	ciudatei	Gender
fragezi	fragedă	Gender
experimentat	experimentați	Gender
datorai	datorarăm	Person
mâniasem	înecasem	lemma
strâmte	strâmt	Gender
lipsiserăm	lipsisem	Person
sinistrelor	căruntelor	lemma
democratică	democratic	Gender
fricoasă	fricos	Gender
zac	zăcem	Person
mărturisesc	îndobitocesc	lemma
șușuirăm	șușuirăți	Person
străvechiul	străvechea	Gender
porniseră	fumegaseră	lemma
empiric	empirică	Gender
secvențiali	secvențiale	Gender
porți	purtați	Person
scabie	feminitate	lemma
scurgeți	înfundați	lemma
viteaz	vitează	Gender
umiliți	desmântați	lemma
șerbeau	șerbea	Person
principali	principală	Gender
tentează	comportă	lemma
ghidează	ghidați	Person
convinseră	convinserăți	Person
orgasmic	bengalez	lemma
grosului	groasa	Gender
bulgăreasca	bulgăreștilor	Gender
îmbătai	îmbătași	Person
creangă	crengilor	Number
emoționale	emoționali	Gender
contribuție	contribuțiilor	Number
spuziși	spuzirăm	Person
râzi	râdeți	Number
împăcăm	împacă	Person
părăsita	părăsiților	Gender
plângeți	plâng	Person
biologici	biologică	Gender
mișunași	încetași	lemma
echilibrați	echilibrează	Person
migdalule	migdalilor	Number
pică	arse	lemma
termina	terminam	Person
comune	comun	Gender
doreai	doream	Person
îngâmfa	îngâmfau	Person
închisă	închis	Gender
slut	țărănesc	lemma
interveniră	intervenirăm	Person
inflamabili	inflamabil	Gender
descurcaserăm	descurcaserăți	Person
plânseși	plânse	Person
depărta	depărtați	Person
civiizați	civiizai	Number
descheiarăți	descheiași	Person
mediocrii	mediocra	Gender
bruni	brună	Gender
vătămase	vătămaserăm	Person
răsăream	răsăreați	Person
mulțumește	mulțumim	Person
ejaculatorului	ejaculatorii	Gender
malteză	maltezi	Gender
clari	clar	Gender
maghiar	maghiare	Gender
botanici	botanic	Gender
veneram	coceam	lemma
dejugase	dejugaseră	Number
stimăm	împungem	lemma
făgăduiesc	făgăduiești	Person
nemiloase	fonetice	lemma
terestru	tereștri	Gender
untoasă	untos	Gender
identitate	identităților	Number
băurăți	băui	Person
prezenți	centrali	lemma
necinstiții	necinstitul	Gender
mărunta	măruntul	Gender
îmbătrânim	îmbătrânește	Person
insurmontabil	insurmontabilă	Gender
realitate	realităților	Number
drăgălașii	drăgălașei	Gender
purtarăți	purtară	Person
sufletești	sufletesc	Gender
rași	ras	Gender
stinsesem	stinsese	Person
brutali	brutală	Gender
mirosirăți	mirosi	Person
amar	amare	Gender
fericeai	fericeați	Person
înscrii	înscrieți	Number
spectral	spectrale	Gender
umezilor	umedului	Gender
propteam	propteați	Person
bălăiesc	bălăiește	Person
depărăm	depăr	Person
gras	grase	Gender
inimos	inimoși	Gender
raționalizabili	raționalizabilă	Gender
răzbunați	călcați	lemma
bazezi	bazăm	Person
marinului	marina	Gender
veninoasă	veninos	Gender
masiv	masivi	Gender
ucid	ucideți	Person
răzgândit	culcat	lemma
rar	rară	Gender
șterseră	șterse	Person
românului	românilor	Gender
iertară	iertarăți	Person
prevestiseși	prevestiserăți	Person
împărțea	împărțeau	Person
credincios	credincioși	Gender
sfințesc	sfințiți	Person
școlarului	școlara	Gender
fălesc	fălim	Person
amestecat	amestecată	Gender
obții	obține	Person
amanetarăți	amanetași	Number
îndemn	îndemnăm	Person
obeză	obez	Gender
ținut	ținută	Gender
izolată	izolați	Gender
drăguț	drăguți	Gender
surprinzătoarea	surprinzătorul	Gender
serioși	viteji	lemma
răstigneai	încurai	lemma
dragii	dragului	Gender
armenilor	armeanului	Gender
dubioși	dubioasă	Gender
adiați	îngustați	lemma
plăcui	plăcurăm	Number
nemiloșii	nemiloasa	Gender
externe	extern	Gender
greșeau	greșea	Number
obraznic	obraznici	Gender
linii	linei	Gender
împăturiseși	împăturiserăți	Number
pictată	fluvială	lemma
desfăcuseră	desfăcuserăm	Person
roză	rozelor	Number
proporționale	proporțional	Gender
latri	diriguiești	lemma
scărmănați	scarmeni	Number
cosmicii	cosmicei	Gender
coborât	coborâte	Gender
întrista	întristau	Person
castania	castaniilor	Gender
prevestiseși	prevestiseră	Person
sângeroase	sângeros	Gender
sugaciului	sugacilor	Gender
aduceam	aducea	Person
negat	încoronat	lemma
dezavantaja	dezavantajau	Number
producere	producerilor	Number
dramaticii	dramaticul	Gender
dureroși	dureros	Gender
spâni	genetici	lemma
slabul	slabilor	Gender
începu	începui	Person
spiritual	spirituală	Gender
puțin	puțină	Gender
smulseserăm	smulsesem	Person
scufundați	scufundate	Gender
line	lini	Gender
preveneam	prevenea	Person
intranzitivei	intranzitivului	Gender
lingușeai	lingușeam	Person
aminteam	aminteau	Person
dragii	dragei	Gender
sălbatic	sălbatici	Gender
întâmplați	întâmpli	Person
plăcu	cumpli	lemma
bărbiereau	bărbiereai	Person
preferam	preferați	Person
profesie	profesiilor	Number
balcanice	balcanici	Gender
uimitor	uimitoare	Gender
adverbială	adverbiali	Gender
asprul	asprii	Gender
nimerirăm	nimerii	Number
iudaism	țărănime	lemma
sucești	sucește	Person
aberant	aspru	lemma
principal	principali	Gender
necunoscuta	necunoscutul	Gender
muntoșilor	muntosul	Gender
agricultorule	agricultorilor	Number
purcesese	purceseseși	Person
vamali	vamală	Gender
introducea	introduceau	Number
cunoaște	cunosc	Number
școlare	școlari	Gender
plantați	plantează	Person
nerecunoscuta	nerecunoscutului	Gender
abdominalii	cruzii	lemma
toacă	zdrobește	lemma
scriere	scrierilor	Number
inteligenții	inteligentul	Gender
oaste	oștilor	Number
chel	chele	Gender
delicat	delicați	Gender
binarilor	binarei	Gender
șters	șterși	Gender
vegheaseși	vegheaserăți	Number
disponibil	disponibile	Gender
fript	fripți	Gender
luași	ezitași	lemma
deșteaptă	deștept	Gender
dublului	dubla	Gender
adâncime	adâncimilor	Number
microbiologie	angelică	lemma
veșnic	veșnici	Gender
structurate	triste	lemma
rațional	ascuns	lemma
micșorăm	împușcăm	lemma
clătinaserăm	clătinaserăți	Person
silabic	silabici	Gender
geantă	genților	Number
instantaneilor	instantaneei	Gender
salturilor	tubului	lemma
umbroși	umbroase	Gender
salvai	salva	Person
spurcată	sănătoasă	lemma
roșii	roșu	Gender
seci	sec	Gender
vomusem	vomuseră	Person
simplu	simplă	Gender
mașină	mașinilor	Number
râvnise	râvniserăm	Person
mărunt	mărunți	Gender
inteligibilii	inteligibilei	Gender
muflonule	muflonilor	Number
despuiați	despuia	Person
frățesc	frățești	Gender
erau	erați	Person
sfârșirăți	sfârșiră	Person
împrejmuise	împrejmuiseră	Person
invincibili	invincibil	Gender
stricate	stricat	Gender
obții	obțineți	Person
alunecați	aluneci	Number
turb	zbor	lemma
izbeai	izbeam	Person
influențezi	influențăm	Person
bisericosului	bisericoasa	Gender
indiferentă	faină	lemma
zise	ziseși	Person
tigrul	trezirea	lemma
prăjeați	dezmințeați	lemma
asigur	asigurăm	Person
inteligibilele	săracii	lemma
preveniserăm	prevenisem	Number
chimica	chimicii	Gender
ostilitate	ostilităților	Number
divorțai	divorțară	Person
plinelor	continentalelor	lemma
țeapănului	țeapăna	Gender
schimbași	schimbarăți	Number
largului	largii	Gender
expoziție	expozițiilor	Number
imprimam	imprimai	Person
plăcute	digitale	lemma
criminalule	criminalilor	Gender
sexuale	sexual	Gender
bengalezii	bengalezei	Gender
odaie	odăilor	Number
bălțată	bălțați	Gender
adumbriră	îngălbeniră	lemma
ploioase	ploioși	Gender
nivelară	nivelă	Person
agățați	agățat	Gender
joși	sănătoși	lemma
scurte	scurt	Gender
cenușii	cenușie	Gender
rotunjea	rotunjeau	Number
deplasam	deplasai	Person
omenoasei	omenoșii	Gender
reflectatei	reflectatului	Gender
comunul	comunei	Gender
înzestrarăm	înzestrai	Number
focă	focilor	Number
enormă	enorm	Gender
mușcau	mușca	Person
ridicați	enormi	lemma
creștinii	creștinul	Gender
internaționalul	internaționala	Gender
raționali	rațional	Gender
discut	discută	Person
ruseștii	tarii	lemma
anteriori	anterior	Gender
albei	formidabilei	lemma
convenționali	convențional	Gender
motivele	foto-urile	lemma
importantei	importanții	Gender
râserăm	îmbătarăm	lemma
aleatorii	aleatoriu	Gender
omnipotentă	omnipotent	Gender
destinate	destinat	Gender
botezate	botezați	Gender
șopârlă	șopârlelor	Number
vărule	verilor	Number
național	naționali	Gender
râioase	trântite	lemma
amestecasem	însetezasem	lemma
azotoasă	azotoși	Gender
țineam	ținea	Person
aberant	aberante	Gender
îmbia	îmbiau	Number
sulfuros	sulfuroasă	Gender
utilizezi	utilizați	Person
suspensorii	suspensorului	Gender
amețiserăți	amețiserăm	Person
mărturie	mărturiilor	Number
alintaserăți	alintaserăm	Person
inestetice	inestetic	Gender
salutăm	salutați	Person
pantalonilor	fusului	lemma
pinule	pinilor	Number
lăsăm	lași	Person
reflectate	reflectați	Gender
aducătorului	aducătorilor	Gender
turnaseră	turnasem	Person
viteaz	viteze	Gender
religioși	religioase	Gender
iernează	crapă	lemma
cărbune	cărbunilor	Number
lungiseră	lungiserăți	Person
vânătă	vineți	Gender
bengalezi	bengaleză	Gender
ancoră	ancorelor	Number
sfericii	susceptibilii	lemma
scabie	chestiune	lemma
spovedi	brăză	lemma
central-europeană	central-european	Gender
strălucitoarele	codalbii	lemma
adevărați	adevărată	Gender
amenințase	amenințaserăți	Person
scumpi	scump	Gender
sefarzi	sefarde	Gender
sorb	îndurerez	lemma
distracție	distracțiilor	Number
întrezăream	întrezăreai	Person
sculă	întări	lemma
speriați	speriau	Person
criticilor	criticul	Gender
vamal	vamală	Gender
baltici	baltic	Gender
sfârticarăm	sfârticară	Person
motivului	coastelor	lemma
isteț	dezavantajos	lemma
sălbatic	sălbatică	Gender
albicioși	albicioase	Gender
maltezilor	maltezului	Gender
făinoasa	făinosului	Gender
țigănirăm	țigănii	Number
aleatoria	aleatoriii	Gender
destramați	destramăm	Person
mortul	moarta	Gender
riscați	risca	Person
creștin	creștini	Gender
aplică	aplicați	Person
jurăm	jur	Person
viroticului	viroticei	Gender
analogicului	analogicilor	Gender
tânjiseși	încuraseși	lemma
albinarule	albinarilor	Number
lascivă	lascivi	Gender
îmbărbătaseși	îmbărbătaserăți	Number
urbanizase	urbanizaseră	Number
ridicat	sulfuros	lemma
milos	miloasă	Gender
inteligent	inteligenți	Gender
comuni	comună	Gender
iedule	iezilor	Number
ferea	fereau	Person
principali	principale	Gender
cârtiță	cârtițelor	Number
bengalezi	bengaleze	Gender
grăbeam	grăbeau	Person
puternici	puternice	Gender
blondului	blonda	Gender
acoperit	creativ	lemma
seci	bețivilor	lemma
lăsata	lăsatului	Gender
numărase	ceruse	lemma
binefăcători	binefăcător	Gender
salariații	salariatul	Gender
isprăvit	întortocheat	lemma
dramaticii	dramaticului	Gender
țipați	țipam	Person
nostalgică	nostalgici	Gender
bucură	bucuri	Person
holbaseși	holbaseră	Person
modificaseră	îmbulziseră	lemma
seară	serilor	Number
haitiană	haitieni	Gender
nodoșii	nodosului	Gender
maghiarei	maghiarul	Gender
puține	emoționale	lemma
structural	folositor	lemma
simpli	simplu	Gender
indiferent	apocaliptic	lemma
vizibilă	vizibil	Gender
polare	polari	Gender
logodești	logodiți	Person
subscrie	copiază	lemma
arată	arătați	Person
orientare	orientărilor	Number
pișă	pișară	Person
importantei	importantul	Gender
umblu	dezic	lemma
socul	țânțarii	lemma
susținea	apuca	lemma
suverană	suveran	Gender
nauruanii	nauruana	Gender
prescurtare	aroganță	lemma
atârnarăm	atârnai	Number
virtuoasă	virtuos	Gender
util	utili	Gender
puternicei	puternicii	Gender
sparte	concentrate	lemma
împart	împărțim	Number
respiri	îngâmfi	lemma
viperă	viperelor	Number
universitate	universităților	Number
română	constituționalitate	lemma
comândași	comândarăți	Number
alegeți	alege	Person
formidabili	formidabilă	Gender
indiscreților	indiscreta	Gender
scară	scărilor	Number
încetai	încetarăți	Person
baza	bazau	Person
mucoșii	mucoasei	Gender
nevăzut	nevăzute	Gender
sfinxule	sfincșilor	Number
serioase	consulare	lemma
lărgește	există	lemma
umpleți	umplu	Person
vârtosului	vârtoasei	Gender
ieftine	evlavioase	lemma
ultimă	ultimi	Gender
ascuțea	ascuțeau	Person
înscriau	înscria	Person
ciobanule	ciobanilor	Number
jucam	jucați	Person
faini	fain	Gender
algelor	zonelor	lemma
adăpostit	adăpostiți	Gender
amestecaserăm	încurcaserăm	lemma
răbdarăm	răbdarăți	Person
minusculii	delicații	lemma
senini	senine	Gender
reflectat	reflectată	Gender
pietroaselor	aprigelor	lemma
mergeau	înjoseau	lemma
sinistre	sălbatice	lemma
iudaism	grabe	lemma
storceau	storceam	Person
complexă	complex	Gender
albanezi	albanez	Gender
sigurilor	sigurul	Gender
arteră	arterelor	Number
împilezi	împilez	Person
înăbușirăm	înăbușii	Person
cumințiți	cumințim	Person
plătii	șchiopătai	lemma
înceată	încetați	Person
delicate	delicat	Gender
înghețate	înghețați	Gender
relaxată	vânătă	lemma
dragă	drag	Gender
intrase	distrusese	lemma
banană	bananelor	Number
dezrădăcinează	dezrădăcinez	Person
cuprins	cuprinși	Gender
delirant	deliranți	Gender
prezenta	prezentului	Gender
reflectați	amestecați	lemma
furioși	furioase	Gender
macrelor	empiricelor	lemma
moldovenescul	moldoveneasca	Gender
burtoșilor	burtoasa	Gender
copților	coptul	Gender
cercaseră	cercaserăm	Person
imperialism	venerație	lemma
urlăm	urlă	Person
naționalul	naționala	Gender
înverzii	înverzirăm	Person
fericita	fericiților	Gender
lingvistici	lingvistică	Gender
integrali	integrale	Gender
fericiți	fericit	Gender
păroși	biologici	lemma
absorbiți	absorbite	Gender
oficial	oficială	Gender
uit	uită	Person
mucoșii	mucosului	Gender
murdar	murdari	Gender
frontieră	frontierelor	Number
prezicea	dumica	lemma
istoricilor	istorica	Gender
crescuții	crescuta	Gender
sfătuisem	sfătuiserăm	Number
fumurii	fumuriu	Gender
urmăriți	urmărim	Person
principale	toxice	lemma
bararăți	bară	Person
existași	existară	Person
necontestatelor	tovărășeștilor	lemma
numărați	număra	Person
iubire	iubirilor	Number
stăpâniseră	stăpâniserăm	Person
redundanți	redundant	Gender
izolații	izolata	Gender
murdar	murdare	Gender
independență	хомосексуалитате	lemma
năsutului	năsuții	Gender
bianualilor	bianuala	Gender
lipiții	lipitul	Gender
crunților	cruntul	Gender
milosului	miloasei	Gender
oglindesc	oglindește	Number
buiestrului	buiastra	Gender
brumăriu	brumării	Gender
sănătoasă	sănătos	Gender
rotunde	rotunzi	Gender
mic	mică	Gender
venerasem	veneraserăm	Person
scurg	scurge	Person
câmpie	câmpiilor	Number
treabă	treburilor	Number
semnăm	semnează	Person
ceterasem	ceteraserăm	Person
tridimensionala	tridimensionalului	Gender
răsturnat	știut	lemma
decăzui	decăzură	Person
alte	alți	Gender
sfulgeră	dispare	lemma
rămuroasei	bestialei	lemma
avere	averilor	Number
discutaserăți	discutaseși	Number
lingvistici	lingvistic	Gender
întâlnise	întâlniserăți	Person
văduvă	văduvelor	Number
depănăm	depănați	Person
omniscient	sur	lemma
anularăți	anulași	Number
omenesc	omenești	Gender
întingeai	întingeam	Person
letonul	letonii	Gender
adâncea	împreuna	lemma
corupem	corup	Number
păpă	păpai	Person
nemeritate	nemeritați	Gender
împovărau	împovărai	Person
pașca	bebelușul	lemma
apărați	aperi	Person
plictisitoare	dumnezeiască	lemma
vorbă	vorbelor	Number
traducere	traducerilor	Number
măsoară	măsurați	Person
înfrunziserăm	înfrunzisem	Number
poștalii	poștalei	Gender
culcam	culcau	Person
abil	abili	Gender
continental	continentale	Gender
alchimice	biete	lemma
făinoșii	făinoasei	Gender
hazlie	hazlii	Gender
înnodarăm	înnodai	Number
plictisitor	plictisitoare	Gender
umede	umezi	Gender
creștinii	creștinului	Gender
întoarse	întors	Gender
utila	utilul	Gender
opăritei	opăritul	Gender
trăiserăți	cășunaserăți	lemma
vitregi	vitregă	Gender
destramai	destramară	Person
asigur	asigură	Person
portabilitate	globalizare	lemma
coborâții	coborâta	Gender
părăsiserăm	părăsiseră	Person
ironic	ironice	Gender
așternuseși	așternuserăm	Person
lăsate	lăsați	Gender
amintesc	amintește	Number
rosul	roșii	Gender
grecescul	voiosul	lemma
alinăm	alină	Person
păcură	ghimber	lemma
albețe	ebraice	lemma
recupera	recuperam	Person
cafenia	cafeniilor	Gender
strălucitor	strălucitoare	Gender
măreț	trist	lemma
ungurești	unguresc	Gender
înecați	îneci	Number
economie	economiilor	Number
mâncarăm	dezgroparăm	lemma
doreau	dorea	Person
sparseseși	sparsese	Person
virtuoșilor	virtuosului	Gender
vizualizare	vizualizărilor	Number
scufundată	scufundați	Gender
purpurie	purpurii	Gender
fiică	fiicelor	Number
abundențe	globalizări	lemma
scurta	criminalul	lemma
plângeți	plângi	Number
podea	podelelor	Number
rotunjită	rotunjit	Gender
experimentații	experimentatei	Gender
speriai	speriarăți	Person
serioasa	seriosului	Gender
veninoși	veninos	Gender
flămânde	flămând	Gender
înduplecaserăm	înduplecasem	Person
pruncie	zmeură	lemma
amabili	amabile	Gender
urcăm	urc	Person
socotită	socotiți	Gender
obraznice	obraznici	Gender
sparți	sparte	Gender
slavi	slave	Gender
chițăiau	chițăiam	Person
românesc	românească	Gender
putrezesc	putrezești	Person
buiestrului	buieștrii	Gender
râioșilor	dumnezeieștilor	lemma
aprinși	aprins	Gender
sașiile	dezavantajoasele	lemma
salvează	salvez	Person
documentezi	documentați	Number
salariată	salariat	Gender
germanului	germana	Gender
combinați	combină	Person
desfirase	desfiraseși	Person
căutau	căutați	Person
adânci	arse	lemma
blocați	bloca	Person
acuzat	înnodat	lemma
spurcă	spurcarăm	Person
osoșilor	dulcilor	lemma
nominal	nominală	Gender
spumaseră	spumaserăm	Person
nativilor	tehnologicilor	lemma
histologici	elementari	lemma
pictate	pictat	Gender
alchimica	alchimicilor	Gender
față	fețelor	Number
albicios	brutal	lemma
topeați	apuneați	lemma
divorțaseși	divorțaserăți	Person
aspra	asprii	Gender
luptam	luptați	Person
ager	ageri	Gender
răsucesc	răsucește	Person
juvenilului	juvenililor	Gender
distractivi	distractiv	Gender
albicioși	albicioasă	Gender
recuperează	recuperăm	Person
dormi	dormim	Person
norule	norilor	Number
serios	serioase	Gender
experimentat	experimentate	Gender
folositorului	folositorii	Gender
ridicate	convenționale	lemma
plătea	plăteați	Person
subscriserăți	întărirăți	lemma
orzule	orzurilor	Number
amarilor	amarei	Gender
unilateralul	unilaterala	Gender
răsăream	îmbrăcam	lemma
atenți	atent	Gender
potabile	potabili	Gender
amari	amar	Gender
neprietenos	țeapăn	lemma
legendarilor	legendarul	Gender
spurcând	fracturând	lemma
socotește	socotiți	Person
acrișor	acrișori	Gender
cronici	cronică	Gender
explicație	explicațiilor	Number
