megmozgattál	None
böngészésbe	Allative+In
visszhangzott	None
megalakulni	None
rockegyüttessel	None
keresztülfolynak	None
lampionná	Translative
gyermektől	Ablative+At
borókával	None
elődből	Ablative+In
szobrászról	Ablative+On
törődnünk	None
erősítenie	None
fiktívekre	Allative+On
solymász	Nominative
cserjékre	Allative+On
sebbel	None
megjelölést	Accusative
vitorlás	Nominative
megöregedő	None
titokká	Translative
elérkeztek	None
emeléséről	Ablative+On
építkezéseken	Essive+On
hajhagymák	Nominative
stimuláns	Nominative
áldozatokhoz	Allative+At
hajlamosakra	Allative+On
fogalommal	None
esőerdővel	None
kihagynia	None
kiindulnunk	None
adataitól	Ablative+At
visszavonták	None
bölcsőkből	Ablative+In
bokrokat	Accusative
bakónak	Dative
érzelemnek	Dative
megbánandó	None
futballistaként	Formal
szójátékoknál	At+Essive
távírászokra	Allative+On
változatlan	Nominative
zigóta	Nominative
televízióból	Ablative+In
ellenszenvessé	Translative
fejembe	Allative+In
csúcsnak	Dative
hálószobákká	Translative
élőlénnyel	None
kijelölniük	None
őszintén	Essive+On
zsemlében	Essive+In
kollégáknak	Dative
számításon	Essive+On
elemeiről	Ablative+On
utasra	Allative+On
folyókkal	None
kérésekhez	Allative+At
tagjaitól	Ablative+At
építészettől	Ablative+At
személynél	At+Essive
konvertálták	None
módszerekben	Essive+In
nyilatkoztunk	None
megmaradó	None
Velencébe	Allative+In
üzletelném|	None
táskát	Accusative
emlékeztették	None
káromkodva	None
elvárt	None
temetéseken	Essive+On
légtérzárlat	Nominative
szivacsokkal	None
teniszt	Accusative
fűszereket	Accusative
állán	Essive+On
apádra	Allative+On
demonstrációba	Allative+In
szolgákra	Allative+On
kialakításából	Ablative+In
integrációra	Allative+On
megegyeznie	None
nővérként	Formal
levesz	None
titkainak	Dative
piacot	Accusative
utánitól	Ablative+At
házasságkötést	Accusative
ívekbe	Allative+In
oldalára	Allative+On
vidékektől	Ablative+At
nyomozások	Nominative
reprodukálja	None
megengeditek	None
kikérdezték	None
felejtenie	None
időszakára	Allative+On
mostohaanyákként	Formal
kompaszban	Essive+In
CD-lejátszókhoz	Allative+At
intézzen	None
kitüntetendő	None
kenőcsökben	Essive+In
költészetről	Ablative+On
musicalben	Essive+In
esküdni	None
ásványokig	Terminative
ablakokhoz	Allative+At
üdvözlendő	None
járda	Nominative
agyagok	Nominative
állítólagosakkal	None
ágazatot	Accusative
kapcsolaton	Essive+On
gyepet	Accusative
gimnáziummal	None
dió	Nominative
flották	Nominative
elválaszthatatlan	Nominative
nemességbe	Allative+In
váltónak	Dative
lefoglalja	None
lándzsahegyek	Nominative
ulti	Nominative
hangkártya	Nominative
kompaktlemezig	Terminative
alezredesről	Ablative+On
háromszögűből	Ablative+In
kézként	Formal
készletekért	Purposive
négyszögnek	Dative
memoárt	Accusative
offenzívába	Allative+In
levegőnél	At+Essive
elbeszélésnek	Dative
fojtotok	None
sötétebb	Nominative
reagálnál	None
karácsonyéj	Nominative
szélét	Accusative
kellőbe	Allative+In
felháborít	None
gépezettel	None
felmerülne	None
tengelic	Nominative
mikroszkópokat	Accusative
nyomozókkal	None
erőket	Accusative
űrhajókat	Accusative
komplikálunk	None
lőfegyverek	Nominative
dokumentált	None
tüzelve	None
fergetegeseket	Accusative
kisebbet	Accusative
banánért	Purposive
mérsékelsz	None
bázisra	Allative+On
dzsámik	Nominative
embere	Nominative
játékaként	Formal
szintjétől	Ablative+At
megjelenítésekről	Ablative+On
értesültem	None
levelezés	Nominative
fehérneműket	Accusative
bácsival	None
elnevezésként	Formal
tengeralattjáróknak	Dative
farkasnál	At+Essive
kiégnek	None
festőművésznél	At+Essive
rendeletből	Ablative+In
tudományon	Essive+On
orchideához	Allative+At
határozatára	Allative+On
dologhoz	Allative+At
szabályok	Nominative
logisztikát	Accusative
latban	Essive+In
kritikán	Essive+On
előírásban	Essive+In
nagypéntek	Nominative
buborékot	Accusative
vizekkel	None
elmarad	None
szanatóriumok	Nominative
hüvelykujjról	Ablative+On
áltudományokkal	None
értesítések	Nominative
árkokból	Ablative+In
marketingben	Essive+In
rekviráljak	None
kihagytad	None
bővítse	None
vartyognánk	None
védekezésbe	Allative+In
díjba	Allative+In
UV-ért	Purposive
főispánnak	Dative
fűzőbe	Allative+In
tanút	Accusative
megyéről	Ablative+On
júliusából	Ablative+In
izomból	Ablative+In
szolgáltatásaitól	Ablative+At
tágít	None
magánnyal	None
lingvisztikához	Allative+At
zsűrik	Nominative
operaháznak	Dative
csúszdákról	Ablative+On
borzalmasakhoz	Allative+At
lévőben	Essive+In
neveket	Accusative
kihívásokhoz	Allative+At
logisztikában	Essive+In
felszólítania	None
jelöljék	None
kapitalizmusnak	Dative
asszociálunk	None
lányából	Ablative+In
kötegekben	Essive+In
tankoltak	None
csapdára	Allative+On
sziklából	Ablative+In
gyárhoz	Allative+At
honlapját	Accusative
úszáshoz	Allative+At
fúrták	None
készpénzeknek	Dative
észlelő	None
merészeltem	None
dacolni	None
regényként	Formal
regiment	Nominative
kiállítja	None
időjárásiból	Ablative+In
szórunk	None
lingvisztikákig	Terminative
elírást	Accusative
szálban	Essive+In
iparba	Allative+In
költ	None
újholdban	Essive+In
távközlésben	Essive+In
rubelre	Allative+On
tánccsoporttal	None
széklettől	Ablative+At
fizetésről	Ablative+On
pukedlizniuk	None
kerékbe	Allative+In
udvaroncról	Ablative+On
hamisították	None
szekérnek	Dative
kormányokkal	None
utánégető	Nominative
rádiókkal	None
visszavonná	None
megáldottuk	None
illesszünk	None
tragédiáért	Purposive
objektivitásért	Purposive
délelőttinek	Dative
rákoknak	Dative
psziché	Nominative
intoleranciával	None
közelre	Allative+On
fokáról	Ablative+On
roston	Essive+On
ismeretre	Allative+On
fajáról	Ablative+On
csökkentéséért	Purposive
dallal	None
megoldásokhoz	Allative+At
megverő	None
tangens	Nominative
telefonnal	None
kinyissák	None
művészettörténetből	Ablative+In
vasakat	Accusative
felszereléshez	Allative+At
harmadba	Allative+In
rendelkezését	Accusative
fejezetben	Essive+In
egészségesen	Essive+On
tollából	Ablative+In
felvétel	Nominative
csöveken	Essive+On
burkolt	Nominative
autókölcsönzőkre	Allative+On
csorda	Nominative
beszélőről	Ablative+On
állításában	Essive+In
felvegyék	None
férfiakhoz	Allative+At
ennivalóval	None
mecsetről	Ablative+On
szerepekkel	None
revolvert	Accusative
vágásokkal	None
egérre	Allative+On
megsemmisítő	None
udvarolni	None
fiúban	Essive+In
tigrisnek	Dative
királlyal	None
lélektannal	None
békeszerződéseket	Accusative
bálnavadászatot	Accusative
felnagyítani	None
megfelelőt	Accusative
szemléletre	Allative+On
szipkán	Essive+On
bűncselekményért	Purposive
üzemeltetve	None
egyesületeként	Formal
növekedésével	None
felmelegedésekké	Translative
lecsendesülnöm	None
golfokból	Ablative+In
száműzzük	None
joghurtnál	At+Essive
alapozták	None
varsákba	Allative+In
szelessel	None
alkalmazkodik	None
kiadja	None
képből	Ablative+In
autóbuszként	Formal
kézikönyvből	Ablative+In
szerkeszteni	None
probléma	Nominative
verziókhoz	Allative+At
nézegetett	None
játszótérre	Allative+On
csendes	Nominative
űrkutatást	Accusative
filterekben	Essive+In
próbafülkét	Accusative
kellőnek	Dative
megbüntetnéd	None
exponenciálisért	Purposive
érzés	Nominative
juttatásban	Essive+In
töréseken	Essive+On
árverésen	Essive+On
katonára	Allative+On
magatartásán	Essive+On
füzérekben	Essive+In
randira	Allative+On
zargassanak	None
csínoknál	At+Essive
projekciók	Nominative
éveken	Essive+On
csíkászig	Terminative
adásából	Ablative+In
következményeiből	Ablative+In
lassulnak	None
sértettem	None
weblapra	Allative+On
transzplantált	None
forgalmazásával	None
családjáért	Purposive
vízről	Ablative+On
vitaminokban	Essive+In
vázolja	None
mesterművet	Accusative
vízipipához	Allative+At
csúcstechnológiáért	Purposive
postakocsit	Accusative
tradíciókhoz	Allative+At
támadásokba	Allative+In
elviselhetetlen	Nominative
kerékpárról	Ablative+On
bürök	Nominative
szabotálni	None
változását	Accusative
disznóknak	Dative
klubig	Terminative
visszahelyezve	None
emlékeire	Allative+On
függelemsértésekből	Ablative+In
forgatások	Nominative
kóborolnotok	None
tapasztottak	None
szerájokat	Accusative
verdested	None
kiterjesztettek	None
detonációt	Accusative
tornáról	Ablative+On
próféciára	Allative+On
képzel	None
méltóságteljes	Nominative
bojárokhoz	Allative+At
üzemmódból	Ablative+In
viselne	None
megígéri	None
virágokban	Essive+In
látogatásáról	Ablative+On
fejezted	None
takarítókon	Essive+On
záróvizsgába	Allative+In
helyszínének	Dative
gyűjtéseket	Accusative
fazekast	Accusative
embereikkel	None
feltöltöttek	None
kolompolnia	None
béke	Nominative
zsinagógába	Allative+In
évéig	Terminative
hátrányban	Essive+In
teniszpálya	Nominative
hetilapokban	Essive+In
csontra	Allative+On
munkatársával	None
bérből	Ablative+In
anyagcsere	Nominative
változásaitól	Ablative+At
vásárolna	None
hókócsag	Nominative
állománynak	Dative
hűtötök	None
megérdemelték	None
unatkozó	None
piszkozatoknál	At+Essive
rendezésére	Allative+On
igricért	Purposive
csillagoknak	Dative
népdal	Nominative
rajongóval	None
okként	Formal
rangig	Terminative
csomagolást	Accusative
despotával	None
kurzusokon	Essive+On
keleten	Essive+On
pásztorokhoz	Allative+At
csodálattal	None
törsz	None
állványra	Allative+On
élőlényt	Accusative
pszichológussal	None
grafikákkal	None
azonosíts|or|	None
újkorra	Allative+On
testületből	Ablative+In
autónál	At+Essive
undorodjak	None
esőfelhőkké	Translative
tanuló	Nominative
kölcsönkérnéd	None
változatból	Ablative+In
majorhoz	Allative+At
bűncselekményként	Formal
üziken	Essive+On
vadgerlével	None
virrad	None
beleszólj|or|	None
fiával	None
olvashatóért	Purposive
pasit	Accusative
szabályokra	Allative+On
tinédzsereket	Accusative
hagymát	Accusative
megismeréséről	Ablative+On
gitárról	Ablative+On
veszítenie	None
bányákhoz	Allative+At
munkákra	Allative+On
szervekből	Ablative+In
ijesztenek	None
trénerként	Formal
ritkaságnak	Dative
szervákba	Allative+In
árukkal	None
szerverbe	Allative+In
beruházási	Nominative
kínálattól	Ablative+At
fővárosnál	At+Essive
párba	Allative+In
alfa	Nominative
raktárépületek	Nominative
elektromosságtanba	Allative+In
befolyásról	Ablative+On
könyvével	None
kirándulásokhoz	Allative+At
differenciálegyenletnek	Dative
megnyomva	None
életéről	Ablative+On
megfizethetetlenhez	Allative+At
félreértenék	None
előbőr	Nominative
műsorokat	Accusative
rengett	None
témáért	Purposive
lefoglalják	None
feladataiban	Essive+In
meteorral	None
dolgozószobában	Essive+In
manikűrösökként	Formal
vicces	Nominative
mészárlások	Nominative
kasztráltam	None
kalózoktól	Ablative+At
kamarát	Accusative
átírnád	None
magyarázatnak	Dative
találkoznak	None
elrabolni	None
kiléptem	None
termékenyek	Nominative
taglaló	None
űrszondán	Essive+On
Magyarországnál	At+Essive
paróka	Nominative
égtájakat	Accusative
átfogta	None
futószalagot	Accusative
kolostor	Nominative
körútról	Ablative+On
havazott	None
kollégiumhoz	Allative+At
szálakon	Essive+On
ajtókat	Accusative
üzletelnek	None
megjelentetnek	None
válaszolni	None
feladatokat	Accusative
becsléshez	Allative+At
kőbányák	Nominative
teste	Nominative
főszerepléseknél	At+Essive
plafonra	Allative+On
városnegyedekben	Essive+In
versenyeznek	None
felhasználnak	None
megszüntetésének	Dative
tudományosak	Nominative
videotelefonokból	Ablative+In
összevetnek	None
albumától	Ablative+At
egyesre	Allative+On
savanyúbb	Nominative
hirdetményt	Accusative
védekezésnek	Dative
információként	Formal
eseményeken	Essive+On
amerikaellenesekhez	Allative+At
megbeszéléstől	Ablative+At
szerkesztett	None
süveg	Nominative
életükről	Ablative+On
cselekményért	Purposive
derékszögre	Allative+On
életedért	Purposive
termékeiből	Ablative+In
cetek	Nominative
érdem	Nominative
májakon	Essive+On
zsugorodott	None
gúnárokról	Ablative+On
megemlítenem	None
atyához	Allative+At
csereként	Formal
franciához	Allative+At
beszélgetéseken	Essive+On
titkolóznál	None
nehezített	None
sötétzöldig	Terminative
kapca	Nominative
formátum	Nominative
érzékenységnek	Dative
gyökerekhez	Allative+At
átfognom	None
nélkülit	Accusative
ígérni	None
végigbeszéltél	None
pontokon	Essive+On
tömegén	Essive+On
ünnepnaphoz	Allative+At
házassági	Nominative
egyénnél	At+Essive
üvegházakhoz	Allative+At
afganisztániakról	Ablative+On
tankönyvből	Ablative+In
idealizált	None
egyensúlyukra	Allative+On
szekularizálták	None
elkészítéséhez	Allative+At
speciális	Nominative
mutatványokat	Accusative
adását	Accusative
zsoldosokat	Accusative
gyaláztunk	None
gitárokhoz	Allative+At
szab	None
mester	Nominative
ismertekre	Allative+On
igazolvánnyal	None
trolibuszokat	Accusative
aranyosakból	Ablative+In
hipotézist	Accusative
lakótelepektől	Ablative+At
tövist	Accusative
bővíti	None
levéltárakból	Ablative+In
szabályzatig	Terminative
átírod	None
vacsorázott	None
csillár	Nominative
minisztereknek	Dative
konszolidálnia	None
előjáték	Nominative
cérna	Nominative
fertőzném|	None
parancsként	Formal
nyugdíjas	Nominative
üvölteni	None
kaszbától	Ablative+At
régészeknek	Dative
nyilatkozattal	None
rádiónak	Dative
leültek	None
recenzióban	Essive+In
katalizátorral	None
felvételre	Allative+On
áruljanak	None
napijegyeknek	Dative
kiherélt	None
évtizednek	Dative
hívőkkel	None
leggyógyíthatatlanabbhoz	Allative+At
kézikönyvnek	Dative
neveltetésére	Allative+On
spóra	Nominative
bizonytalanságra	Allative+On
bókol	None
megfogalmazására	Allative+On
kamatlábat	Accusative
mezőgazdaságra	Allative+On
nátriumot	Accusative
szárazföldhöz	Allative+At
velúrbőrbe	Allative+In
késekhez	Allative+At
papucsot	Accusative
töltésekről	Ablative+On
beint	None
belügyek	Nominative
zsoltárt	Accusative
regényért	Purposive
lények	Nominative
dollárokká	Translative
fizikusokkal	None
zátonyokat	Accusative
temperamentum	Nominative
koronán	Essive+On
foszforral	None
kérgekig	Terminative
bőségben	Essive+In
sablonon	Essive+On
drágultunk	None
linóleumoknál	At+Essive
dalnokot	Accusative
tetraéderek	Nominative
pácienseken	Essive+On
kezdeményezte	None
viszonylagos	Nominative
szegénnyel	None
kerékpárosok	Nominative
mézeljem|	None
csatlakoztam	None
vonalakban	Essive+In
csinnadrattával	None
ősnek	None
volánért	Purposive
megjelölésekkel	None
öngyilkosságig	Terminative
arcáról	Ablative+On
áthúzta	None
lencsébe	Allative+In
növelni	None
teknőssel	None
légitársaságnak	Dative
drukkolni	None
átadtak	None
kipává	Translative
cserepet	Accusative
szivacsot	Accusative
mindenfajtákig	Terminative
zongoraművészek	Nominative
honoráriumhoz	Allative+At
dugónak	Dative
dimenzióban	Essive+In
álmodta	None
diadal	Nominative
ezreddel	None
megemlítetted	None
szegénynegyedről	Ablative+On
átíró	None
kisbabaként	Formal
előrehalad	None
cselédek	Nominative
összehasonlításnál	At+Essive
majomban	Essive+In
ellenőrzendő	None
végeredménnyel	None
illetékességgel	None
nyilvánították	None
piacgazdaságokban	Essive+In
szakosodnia	None
tealevélről	Ablative+On
türelemhez	Allative+At
megoldása	Nominative
ferdék	Nominative
hírleveleket	Accusative
hiányán	Essive+On
újrafelhasználó	None
működés	Nominative
falaira	Allative+On
polihisztorok	Nominative
halottkém	Nominative
kiegészít	None
pillanatfelvételeken	Essive+On
lajhárokra	Allative+On
zászlón	Essive+On
határértékeknek	Dative
fülhallgatón	Essive+On
világítják	None
láncreakciót	Accusative
hasznosba	Allative+In
motorcsónakkal	None
hózentróger	Nominative
állományból	Ablative+In
agyarakkal	None
nyomdánál	At+Essive
fülemmel	None
szarkánál	At+Essive
himnuszok	Nominative
ellenségtől	Ablative+At
tartósítani	None
kanárimadarakba	Allative+In
virágárusok	Nominative
összehasonlított	None
borsosig	Terminative
levenném|	None
kozmoszból	Ablative+In
csellók	Nominative
fejed	Nominative
felügyelőt	Accusative
kalapnak	Dative
legdúsabbal	None
demonstráción	Essive+On
kappa	Nominative
determinálta	None
haditengerészetért	Purposive
kopoltyúkat	Accusative
smaragdvaránuszról	Ablative+On
regisztrációkat	Accusative
nyaralásra	Allative+On
létrehozta	None
újságírót	Accusative
prezentáció	Nominative
kísérletezni	None
domináljuk	None
újdondászokra	Allative+On
államkincstáraknál	At+Essive
szárik	Nominative
regresszív	Nominative
legsüketebbekkel	None
ügyintézést	Accusative
fogalomként	Formal
kártyáknak	Dative
gravitáció	Nominative
garasok	Nominative
cégekre	Allative+On
egységébe	Allative+In
fülkébe	Allative+In
betűnagysággá	Translative
sziromhoz	Allative+At
voltából	Ablative+In
munkaalkalmak	Nominative
naptejtől	Ablative+At
júl.-okról	Ablative+On
fejtendő	None
mészárlásért	Purposive
szándékozva	None
lektoráltad	None
támogatásnak	Dative
legélesebb	Nominative
átvettek	None
támogatásoknak	Dative
cédrusokhoz	Allative+At
királynőjeként	Formal
elvárosiasodásoknál	At+Essive
krétán	Essive+On
igazgattak	None
fáradhatatlannak	Dative
marxizmus	Nominative
eredményesek	Nominative
szakterületnek	Dative
régészekig	Terminative
dallamokra	Allative+On
lenézni	None
lendületre	Allative+On
kanyarogva	None
megnyugtatónak	Dative
féltékenységtől	Ablative+At
barom	Nominative
következetességként	Formal
kigúnyolják	None
eleméből	Ablative+In
szalagokat	Accusative
száműző	None
limitálva	None
szúnyog	Nominative
sorrendnél	At+Essive
anyanyelvnek	Dative
évtizedekben	Essive+In
előkészítésre	Allative+On
jegyzetnél	At+Essive
kardoskodni	None
ötletéért	Purposive
haladástól	Ablative+At
sátorra	Allative+On
honfitársnak	Dative
szimulációk	Nominative
migrációnak	Dative
egyházat	Accusative
főszerkesztőnek	Dative
utóiratig	Terminative
monszunok	Nominative
időszakokhoz	Allative+At
csatához	Allative+At
aggodalmakba	Allative+In
édesebbig	Terminative
márkára	Allative+On
véglegeset	Accusative
kezedbe	Allative+In
túllépő	None
nyelvről	Ablative+On
felfedezve	None
tanulna	None
suttogni	None
pálcával	None
elvesztésekkel	None
történésztől	Ablative+At
ignorálta	None
következményeire	Allative+On
elsősegélynél	At+Essive
sugárzott	None
kéz	Nominative
szájában	Essive+In
komp	Nominative
tőzegbe	Allative+In
átíráson	Essive+On
elveszti	None
ujjával	None
elképzeléseivel	None
gráfnak	Dative
nemzetiségűek	Nominative
modellben	Essive+In
vevőnek	Dative
öngól	Nominative
hadműveleteknél	At+Essive
terveitől	Ablative+At
jóváhagyáshoz	Allative+At
zeneszerzőket	Accusative
hivatkozástól	Ablative+At
öregséggel	None
főnökre	Allative+On
oldalaknak	Dative
gémeskutakig	Terminative
igazságszolgáltatáshoz	Allative+At
témáiról	Ablative+On
tányérra	Allative+On
újraélesztve	None
közgazdaságtanból	Ablative+In
körömlakkon	Essive+On
csillagrendszerből	Ablative+In
kabinettel	None
előállít	None
színészt	Accusative
forradalomként	Formal
elmozdította	None
cipelték	None
jeleivel	None
hangoskönyvet	Accusative
barátságtalanokba	Allative+In
sikernek	Dative
pezsgős	Nominative
jelére	Allative+On
alkotmányból	Ablative+In
csúnya	Nominative
meztelennél	At+Essive
megsemmisítse	None
zsokékból	Ablative+In
varázslásokban	Essive+In
protonoknak	Dative
fogkefét	Accusative
elragadtassanak	None
anomáliákkal	None
indokolatlanra	Allative+On
marketinggel	None
átírok	None
repülésre	Allative+On
álldogálnak	None
tanyától	Ablative+At
bánatába	Allative+In
ügyfeleivel	None
veszélyesen	Essive+On
kövérben	Essive+In
rétest	Accusative
tragédiákba	Allative+In
egyesületben	Essive+In
világtalant	Accusative
koncentrációhoz	Allative+At
időszakoknak	Dative
kompra	Allative+On
elégedniük	None
várttal	None
marháknak	Dative
szerelvénynek	Dative
felülvizsgálatot	Accusative
üresek	Nominative
szakaszt	Accusative
farkához	Allative+At
taposómalmon	Essive+On
legnehezebbeken	Essive+On
fasizmusokért	Purposive
mintákban	Essive+In
megcsalják	None
tataroznád	None
gátlónál	At+Essive
maharadzsákba	Allative+In
szabályozásból	Ablative+In
forgalomba	Allative+In
múzeummal	None
beszédeknek	Dative
szociológiákba	Allative+In
tagadná	None
sérelmek	Nominative
művésznők	Nominative
származástól	Ablative+At
regnáló	None
stadionon	Essive+On
zaklatták	None
erőműbe	Allative+In
birtokoltam|	None
vállalkozásban	Essive+In
szárnyalnotok	None
csésze	Nominative
mással	None
immobilizáljunk	None
lévőt	Accusative
korongokból	Ablative+In
euróig	Terminative
összeadásnak	Dative
pillantások	Nominative
vágyakozik	None
ruhám	Nominative
szabályaiból	Ablative+In
határozatának	Dative
riválisokat	Accusative
káromkodik	None
beütemezték	None
szankcióra	Allative+On
megbízó	Nominative
dörögni	None
kijelölt	None
megkapták	None
kegyencek	Nominative
kísérnék	None
CD	Nominative
nővérrel	None
fényforrásokkal	None
kényelmetlennek	Dative
melléknevekre	Allative+On
játékosért	Purposive
vadászathoz	Allative+At
elemnek	Dative
egybeírjátok	None
hosszadalmasakká	Translative
özvegy	Nominative
lebegned	None
továbbítsák	None
kincstárból	Ablative+In
hivatásossá	Translative
rendellenességgel	None
eredetihez	Allative+At
számuknak	Dative
merisztémákra	Allative+On
felakasszunk	None
menüket	Accusative
agglomeráción	Essive+On
kérelmeket	Accusative
sebre	Allative+On
pálinka	Nominative
állítása	Nominative
kideríteniük	None
jégkorszakot	Accusative
utas	Nominative
csillagfények	Nominative
sark	Nominative
közvetítővel	None
brutális	Nominative
kiválik	None
ürítette	None
paralízisekben	Essive+In
hazugságra	Allative+On
hadihajóról	Ablative+On
csokoládé	Nominative
elhelyezkedve	None
rádiónál	At+Essive
légifelvételen	Essive+On
beszélőknek	Dative
szerkezetté	Translative
utaljanak	None
akkreditálva	None
csalódás	Nominative
melódiákról	Ablative+On
báróknak	Dative
golfozó	None
támogatásokat	Accusative
kiemelkedjek	None
frissítésről	Ablative+On
síbajnokokkal	None
járőrözni	None
befejezésével	None
átvettük	None
felülkerekedniük	None
elhatároztam	None
trükkökhöz	Allative+At
babakocsikban	Essive+In
legelismertebbeket	Accusative
megfogalmazza	None
idegesíti	None
lengyellel	None
felajánlva	None
sajtóba	Allative+In
könnyig	Terminative
kirúgtátok	None
suhanunk	None
hatására	Allative+On
kanadaiakat	Accusative
megvizsgáljátok	None
súgólyuktól	Ablative+At
hegycsúcsokra	Allative+On
zsoldba	Allative+In
bírok	None
fecskendők	Nominative
fájlként	Formal
fügét	Accusative
módosításoknak	Dative
popularizáljuk	None
ceremóniával	None
fertőzőekként	Formal
bevezetéséig	Terminative
talpnyalóhoz	Allative+At
epszilon	Nominative
hólapátnak	Dative
élménybe	Allative+In
külügytől	Ablative+At
stoppolásokat	Accusative
koldusok	Nominative
tarháld|or|	None
hegyesszöget	Accusative
nyomdásznak	Dative
szétestek	None
megköszöntem	None
bioritmussá	Translative
nehezíti	None
gyógyfürdő	Nominative
vezetőségnek	Dative
emigrálnak	None
spórolnak	None
veszteségre	Allative+On
nadrág	Nominative
kezétől	Ablative+At
varrónőtől	Ablative+At
napilapként	Formal
szótagokig	Terminative
képekben	Essive+In
valószínűség-számításokkal	None
viselni	None
gerincoszlophoz	Allative+At
vandalizmussal	None
közösségétől	Ablative+At
bírva	None
vesekő	Nominative
küldött	Nominative
kihúznak	None
létesülnek	None
időjárásból	Ablative+In
jelölve	None
végzetem	Nominative
kötélhez	Allative+At
összejövetelen	Essive+On
körökkel	None
súlyosabbnak	Dative
győzelemről	Ablative+On
ellentétért	Purposive
bölcsődében	Essive+In
megfigyelések	Nominative
káoszból	Ablative+In
értékesnek	Dative
mellékneveket	Accusative
hajómon	Essive+On
limuzinok	Nominative
joviálisakig	Terminative
anyagoktól	Ablative+At
válaszoljatok	None
pikkelyekkel	None
keresésekkel	None
megkülönböztette	None
kideríti	None
jóváhagyására	Allative+On
felirat	Nominative
megállják	None
hajót	Accusative
nyelvtanok	Nominative
távozás	Nominative
ászanák	Nominative
fogyasszuk	None
csészében	Essive+In
megakadályozandó	None
fiókot	Accusative
installálni	None
taszították	None
magasságig	Terminative
hozzátartozzatok	None
ünnepelve	None
vezetőjéből	Ablative+In
prémek	Nominative
laktam	None
klubból	Ablative+In
kompenzálta	None
tojásrántottából	Ablative+In
közelítene	None
kamerák	Nominative
repülőre	Allative+On
légiekig	Terminative
holtig	Terminative
egyházfőkbe	Allative+In
lakatlanok	Nominative
tapasztaljuk	None
tartásán	Essive+On
identifikációról	Ablative+On
nemkívánatosakra	Allative+On
amőbákkal	None
korúnak	Dative
kötszerek	Nominative
hőse	Nominative
karóból	Ablative+In
daraboknál	At+Essive
fővárossal	None
megakadályozzon	None
pillanatban	Essive+In
fájlokhoz	Allative+At
műfajjá	Translative
megtapsolta	None
gyűjteményhez	Allative+At
növénytannal	None
ügyviteliről	Ablative+On
invázióba	Allative+In
gárdával	None
semlegesítettem	None
őssejtek	Nominative
kifogáson	Essive+On
megszűnni	None
nyomtassatok	None
fogyasztottak	None
aláhúzni	None
indításokat	Accusative
rezonanciával	None
evőeszközt	Accusative
xilofonodtól	Ablative+At
leírásába	Allative+In
rendelkezéseknek	Dative
szórakoztatták	None
cirkusszal	None
várakozott	None
örökölve	None
megújulnátok	None
olvasás	Nominative
többnyelvű	Nominative
légierővel	None
kombájnokat	Accusative
völgytől	Ablative+At
mécsest	Accusative
végre	Allative+On
bekerülsz	None
kiválasztásánál	At+Essive
kegyek	Nominative
megoszt	None
vendégszobában	Essive+In
elhamvasztott	None
vezérigazgatót	Accusative
vuvuzeláért	Purposive
elbűvöl	None
személynévvé	Translative
ürítenek	None
forrásából	Ablative+In
kérdések	Nominative
sarlósfecskék	Nominative
testületként	Formal
gráfokhoz	Allative+At
szemétkupacról	Ablative+On
megkoronázni	None
megőrizzen	None
templomba	Allative+In
megmondva	None
feldolgozásról	Ablative+On
hivatalnokkal	None
állapotának	Dative
szegénységből	Ablative+In
állításokból	Ablative+In
kötete	Nominative
erősíteni	None
naturalizálta	None
érdekességekhez	Allative+At
ismétlő	None
kapcsolattartásról	Ablative+On
hallgatókkal	None
mérgezésben	Essive+In
buzin	Essive+On
skála	Nominative
sarkával	None
csellóval	None
dologért	Purposive
egyesülésből	Ablative+In
elnökénél	At+Essive
kutatásából	Ablative+In
titkokban	Essive+In
fórumra	Allative+On
iszik	None
esküdött	None
kocsisként	Formal
cselekvést	Accusative
audienciát	Accusative
kormányfőtől	Ablative+At
vígjátékok	Nominative
jelmezeket	Accusative
szélesebb	Nominative
megállapodás	Nominative
vadkanokról	Ablative+On
szalámitaktika	Nominative
beruházásiaknál	At+Essive
haláláig	Terminative
portásnak	Dative
szigethez	Allative+At
vodkából	Ablative+In
tanítványaim	Nominative
regényeknek	Dative
palánták	Nominative
öltönyt	Accusative
végrehajtunk	None
húsokból	Ablative+In
gézekről	Ablative+On
zsugorított	None
oszlopokon	Essive+On
rummal	None
emlékeztessen	None
öröklakáson	Essive+On
érvekre	Allative+On
kérésénél	At+Essive
tervezetére	Allative+On
elefántcsontból	Ablative+In
naptejekhez	Allative+At
bejegyzésnek	Dative
novellához	Allative+At
tengeralattjáróban	Essive+In
hétvégének	Dative
vendéget	Accusative
Magyarországért	Purposive
legmélyebbre	Allative+On
gidát	Accusative
teljesítményét	Accusative
fejezet	Nominative
révész	Nominative
lemaradnak	None
távcsőre	Allative+On
újoncok	Nominative
terrorizmusról	Ablative+On
jogokhoz	Allative+At
kerékpárosként	Formal
lakik	None
sorokon	Essive+On
áramlatoktól	Ablative+At
szörpök	Nominative
tanulmánya	Nominative
alapjának	Dative
öcs	Nominative
jubileumra	Allative+On
illóolajok	Nominative
anyanyelvűnek	Dative
hónapokra	Allative+On
földművelésügyitől	Ablative+At
jobbnál	At+Essive
teljesítményű	Nominative
járműtől	Ablative+At
fegyver	Nominative
soával	None
földbirtokosról	Ablative+On
misztikánál	At+Essive
ékszerekhez	Allative+At
jogtiszták	Nominative
napilapnak	Dative
bűvészre	Allative+On
megtanulniuk	None
tanárnőnél	At+Essive
világnyelven	Essive+On
pulykakeselyű	Nominative
panaszok	Nominative
regenerálja	None
lefoglalva	None
körülnézett	None
minőségbiztosítással	None
sötétednek	None
működőképes	Nominative
beöltözzön	None
helyezkedik	None
engedélyezi	None
fantasztikusnak	Dative
zarándoklatra	Allative+On
citromból	Ablative+In
végrehajtják	None
inváziót	Accusative
ikonnal	None
teodolitok	Nominative
kapacitását	Accusative
fejlesztésén	Essive+On
atomerőművek	Nominative
fényforrással	None
apoplexiákból	Ablative+In
szavazniuk	None
tulajdonságaihoz	Allative+At
ezredessé	Translative
texasi	Nominative
látásokat	Accusative
blokkért	Purposive
csipkék	Nominative
képviselőjévé	Translative
hajításra	Allative+On
virgácsokká	Translative
felépítse	None
visszásakká	Translative
csökkenést	Accusative
bőrgyulladást	Accusative
tulajdonosával	None
mosással	None
fejésnek	Dative
gépjárművel	None
tegnapként	Formal
kérésében	Essive+In
vastagítottam|	None
szükségtelenekkel	None
romboljak	None
kengyelekként	Formal
könyvkötőként	Formal
alkalmatlan	Nominative
bocskort	Accusative
projektbe	Allative+In
legidősebbek	Nominative
jelenségként	Formal
elhelyezésre	Allative+On
hangolja	None
átveszik	None
mitokondriumokban	Essive+In
diétát	Accusative
pecséttel	None
hallgatja	None
megjavít	None
tanévek	Nominative
alábecsülő	None
fulladjon	None
kötélen	Essive+On
végrehajtásaként	Formal
kézfejjel	None
súrlódásnak	Dative
frenológiát	Accusative
meggyújtsak	None
szennyeződéseket	Accusative
szimbiózis	Nominative
szaltók	Nominative
tintahalakkal	None
szellemesekbe	Allative+In
felkészültünk	None
ferde	Nominative
fertály	Nominative
megmagyaráznád	None
extenzívbe	Allative+In
forradalmakon	Essive+On
klarinétra	Allative+On
készítésnél	At+Essive
bánatára	Allative+On
próbababától	Ablative+At
átnevezed	None
fluxust	Accusative
kontinensekké	Translative
sikeren	Essive+On
invesztáljátok	None
kijavított	None
láda	Nominative
sokkoló	None
elkülönítendő	None
tajgán	Essive+On
indítsa	None
hűtsétek	None
sáncárkot	Accusative
elsüllyedtek	None
alkalmazásában	Essive+In
temették	None
engedélyezzen	None
szerkesztésben	Essive+In
elősegítésében	Essive+In
megismered	None
bővítéséért	Purposive
tölgyfán	Essive+On
tankolnánk	None
körvonalakkal	None
azonnalira	Allative+On
hangzottunk	None
ellátásban	Essive+In
végrehajtást	Accusative
édességgel	None
húsgombóc	Nominative
szabályelleneseknek	Dative
legragyogóbbon	Essive+On
főzelékként	Formal
szenátusról	Ablative+On
levették	None
nyilvántartva	None
remilitarizálnék	None
ismertessék	None
vállalatokból	Ablative+In
denevérekbe	Allative+In
kommunikálnotok	None
nyomozóként	Formal
szentélyt	Accusative
megmagyaráznunk	None
aljakként	Formal
önfejű	Nominative
félreértésnek	Dative
könnycseppek	Nominative
zöldségként	Formal
viselkedésben	Essive+In
kiscsibékért	Purposive
riksa	Nominative
működtették	None
terítő	Nominative
razziákat	Accusative
korunkban	Essive+In
okosságokról	Ablative+On
legszemtelenebbért	Purposive
akción	Essive+On
mosógépek	Nominative
fehérekből	Ablative+In
szajha	Nominative
kikapcsoltam	None
sérüléseken	Essive+On
ballal	None
eljutottak	None
sáncokat	Accusative
bejelentkezést	Accusative
bőrökkel	None
jegyből	Ablative+In
jődögélniük	None
árnyalatokban	Essive+In
osztagnál	At+Essive
teraszokkal	None
cseresznyével	None
tisztviselőknek	Dative
megdöntő	None
teljesülne	None
dzsessztől	Ablative+At
szimbólumok	Nominative
szorongásra	Allative+On
kutatásokba	Allative+In
didergő	None
vidékekről	Ablative+On
kérdéseivel	None
apródként	Formal
terápiásból	Ablative+In
landolásra	Allative+On
özveggyé	Translative
megrendeltek	None
kérelemhez	Allative+At
üzemeltesse	None
életemről	Ablative+On
készletből	Ablative+In
lerombolták	None
füleitekre	Allative+On
javaslatát	Accusative
dominálni	None
szociológiának	Dative
őskor	Nominative
aránynál	At+Essive
tárgyalásról	Ablative+On
gyakoriságok	Nominative
repülések	Nominative
emésztőrendszerre	Allative+On
szabadságának	Dative
átlagot	Accusative
nemzetet	Accusative
problémán	Essive+On
nyávogni	None
újjászületésnek	Dative
dzsörzévé	Translative
fejezné	None
tartalmába	Allative+In
kocsiból	Ablative+In
fokhoz	Allative+At
széle	Nominative
javítsátok	None
elmulasztotta	None
eljárásért	Purposive
másoltam	None
földelték	None
megkezdő	None
pulzushoz	Allative+At
megerőszakol	None
játékfilmekről	Ablative+On
megtiszteltetésként	Formal
regényíróért	Purposive
jegyként	Formal
bevezetéssel	None
szolgáját	Accusative
tárgyalásra	Allative+On
informál	None
buzogányokat	Accusative
teszttel	None
alábbiakra	Allative+On
havazz|or|	None
eldönteniük	None
próbálkozó	None
fájlokra	Allative+On
kultúrák	Nominative
jóváhagyta	None
erőműre	Allative+On
előszobákkal	None
fogyasszunk	None
ellenségeskedések	Nominative
szempontként	Formal
ékszereket	Accusative
válaszolnod	None
párkányokkal	None
hajójából	Ablative+In
teológiának	Dative
moratórium	Nominative
papagájt	Accusative
egészségének	Dative
népszerűségben	Essive+In
rendeznie	None
zsilippel	None
szempontot	Accusative
ispotály	Nominative
zuzmóból	Ablative+In
fogalmazunk	None
kilátásoknál	At+Essive
kisgyermekeknek	Dative
ókortól	Ablative+At
részvényekből	Ablative+In
munkákhoz	Allative+At
beszédes	Nominative
leszállva	None
digitalizálnánk	None
keresetre	Allative+On
parádékon	Essive+On
legboldogtalanabbaknak	Dative
megszüntettem	None
társulásokban	Essive+In
nagyvárosokkal	None
kötelezettségről	Ablative+On
székesegyházra	Allative+On
prófétanőkre	Allative+On
tündérek	Nominative
cicivel	None
hasból	Ablative+In
evangéliumok	Nominative
kinagyítottunk	None
párával	None
kontextusnál	At+Essive
sebességre	Allative+On
projekteken	Essive+On
bokorra	Allative+On
tévhitet	Accusative
könyvkiadónál	At+Essive
uralmon	Essive+On
mozsárban	Essive+In
utasító	None
módszerbe	Allative+In
okosak	Nominative
bűvöltük	None
pillanattól	Ablative+At
országútra	Allative+On
lélektaniban	Essive+In
pedikűr	Nominative
utasból	Ablative+In
ágyazva	None
szárazon	Essive+On
flamingóként	Formal
kakasra	Allative+On
oxidációnak	Dative
kicserél	None
kalásszal	None
ejtőernyőzés	Nominative
dallamos	Nominative
elvégzéséhez	Allative+At
világosra	Allative+On
diszkrétet	Accusative
mutánsokkal	None
erdészetet	Accusative
előzünk	None
kínozta	None
dugattyún	Essive+On
indokolja	None
bevándorlót	Accusative
rizsnek	Dative
istenkáromlásban	Essive+In
megkérdezik	None
próbababákért	Purposive
erősítitek	None
kimúlva	None
eljussunk	None
részesedésben	Essive+In
felkínálandó	None
februárjából	Ablative+In
menetrendről	Ablative+On
konyhaművészetre	Allative+On
áruházba	Allative+In
funkciókról	Ablative+On
pumpával	None
élelmiszerekben	Essive+In
lovasságtól	Ablative+At
írógépen	Essive+On
városiasítana	None
oknál	At+Essive
piacnak	Dative
részesedéssel	None
szériák	Nominative
tanítványok	Nominative
növekedési	Nominative
külföldről	Ablative+On
eredménytől	Ablative+At
határára	Allative+On
jellemzőire	Allative+On
hitvallásnak	Dative
járultam	None
lélekbúvárra	Allative+On
csodaország	Nominative
megválasztásához	Allative+At
elvertél	None
istenre	Allative+On
bosszantani	None
rétegre	Allative+On
bírálatot	Accusative
hűtötték	None
ellentmondásossá	Translative
tudására	Allative+On
menetéből	Ablative+In
érsekre	Allative+On
leventével	None
akaraterőként	Formal
harangtoronyhoz	Allative+At
videojátékot	Accusative
tárolást	Accusative
megérkezik	None
szabóizmokká	Translative
afrikaansban	Essive+In
feltámasztottatok	None
vakbélgyulladásban	Essive+In
felülkerekedik	None
adókulcsok	Nominative
nehézségekbe	Allative+In
informálva	None
vonásokkal	None
könyvkiadóhoz	Allative+At
törzsre	Allative+On
kamarazeneként	Formal
kétszintes	Nominative
szenátort	Accusative
megbetegedésekben	Essive+In
poszméhről	Ablative+On
regényei	Nominative
kötetekbe	Allative+In
ellenméregig	Terminative
dúlnak	None
fényképekre	Allative+On
tiltották	None
véghezvitt	None
személyzettől	Ablative+At
elnyerje	None
napfogyatkozást	Accusative
tűzcsap	Nominative
elfogja	None
leírásnak	Dative
leverte	None
őrgróf	Nominative
kivonul	None
ajándéknál	At+Essive
fröcsköltem	None
elvégzésen	Essive+On
összeadásra	Allative+On
bevitt	None
gépészként	Formal
rutinnal	None
mesterségeknek	Dative
kukoricán	Essive+On
másolatát	Accusative
bőségesek	Nominative
felvételhez	Allative+At
meglepő	None
császárt	Accusative
nemzetközösséghez	Allative+At
tanítvánnyal	None
adoptálni	None
triumvirátust	Accusative
áriákkal	None
zajnak	Dative
zuzmónak	Dative
gombákat	Accusative
reklámozó	None
samponozza	None
szervezetünk	Nominative
megszerzéséig	Terminative
lőfegyverrel	None
kikapcsoljunk	None
lehetőségért	Purposive
biológián	Essive+On
utaskísérőket	Accusative
videojátéknak	Dative
gyógyításban	Essive+In
bokornál	At+Essive
állatorvostól	Ablative+At
dióból	Ablative+In
nagysága	Nominative
kölcsönhöz	Allative+At
mosolygó	None
megszűnéséig	Terminative
inna	None
egészségbiztosításokat	Accusative
hamutartó	Nominative
szabták	None
meglátogassák	None
fogorvoshoz	Allative+At
csigát	Accusative
részlegek	Nominative
forgalmazó	Nominative
lamentáltatok	None
megjelenésű	Nominative
titkárnőkkel	None
kiállítaniuk	None
fenekén	Essive+On
varig	Terminative
fonton	Essive+On
eltöri	None
táncolja	None
szokásokhoz	Allative+At
résen	Essive+On
makettel	None
gyűlöletbeszédekért	Purposive
üresekkel	None
odafigyelnie	None
társaiig	Terminative
kötelezettségek	Nominative
izével	None
tanfolyam	Nominative
cintányérokból	Ablative+In
hajókon	Essive+On
szexualitás	Nominative
sólymok	Nominative
bánik	None
átlós	Nominative
ládák	Nominative
külügyekről	Ablative+On
hónapját	Accusative
gyújtogatásért	Purposive
betűszók	Nominative
legtanultabba	Allative+In
egybeírni	None
vaddisznóval	None
takarmányoznál	None
szorzások	Nominative
feketepiacról	Ablative+On
hídként	Formal
mellhártyagyulladást	Accusative
bántotta	None
példányban	Essive+In
korosztályokban	Essive+In
gyermekektől	Ablative+At
osztálytermek	Nominative
városokig	Terminative
dombból	Ablative+In
kocsiknak	Dative
rajongással	None
zöldségárusokra	Allative+On
mellébeszélsz	None
vizsgálatoknak	Dative
gyűrűjén	Essive+On
fiúért	Purposive
lakosnak	Dative
megmérgezte	None
határoló	None
sötétekkel	None
hexán	Nominative
működtetés	Nominative
zenéjére	Allative+On
szűzhöz	Allative+At
szereplőiről	Ablative+On
egyformák	Nominative
erdészetivé	Translative
szószedettel	None
végének	Dative
ellenzék	Nominative
illatszerek	Nominative
megcsinálod	None
siessünk	None
dómban	Essive+In
hatványokról	Ablative+On
bürokratikus	Nominative
havazik	None
ebédelő	None
hegységekre	Allative+On
csöcsökért	Purposive
látásnak	Dative
lök	None
visszatérést	Accusative
felmerülök	None
modellkedett	None
érintettek	Nominative
terítéket	Accusative
lorddal	None
címkébe	Allative+In
kalózkodás	Nominative
transzformáljuk	None
kaméleon	Nominative
kötőjelekkel	None
pánikolni	None
cserben	Essive+In
sodródnak	None
torzított	None
kirándulásról	Ablative+On
szovjetekkel	None
irodákkal	None
adatból	Ablative+In
autentikusnak	Dative
töltésétől	Ablative+At
komponistákhoz	Allative+At
hozzáállással	None
műszerre	Allative+On
fiaitól	Ablative+At
szabadult	None
válaszolnának	None
alapítója	Nominative
merénylővel	None
nyaka	Nominative
szenderül	None
sietett	None
grófokkal	None
kering	None
füstölővel	None
páciensekre	Allative+On
virághagymáról	Ablative+On
tulajdonságot	Accusative
elnyernie	None
nyugtassa	None
kiütéseknél	At+Essive
értesítéssel	None
küldetésként	Formal
anyagaihoz	Allative+At
leletek	Nominative
jelölésnek	Dative
személygépkocsival	None
gém	Nominative
értékelésétől	Ablative+At
szabályozásokat	Accusative
sajtótájékoztatója	Nominative
bekezdést	Accusative
gerillákig	Terminative
fejleszteniük	None
fegyverszünetről	Ablative+On
leégtek	None
dicséri	None
aperitifként	Formal
részletére	Allative+On
disztribúciókban	Essive+In
későbbit	Accusative
nyaksállal	None
blokkolnia	None
csapatoktól	Ablative+At
meggyilkoljanak	None
bűnökkel	None
bringára	Allative+On
tarkától	Ablative+On
mosolyok	Nominative
verziótól	Ablative+At
dolgozószobákról	Ablative+On
utaltam	None
áradásokat	Accusative
liturgiákból	Ablative+In
futballpályákból	Ablative+In
megfigyelje	None
észlelésről	Ablative+On
korrupciónak	Dative
unalomtól	Ablative+At
ionizálja	None
forráskódot	Accusative
járműveken	Essive+On
kürtőskalácsoknál	At+Essive
álruhában	Essive+In
ellenőrizve	None
balban	Essive+In
tárolásával	None
zongoraversenynek	Dative
tereptől	Ablative+At
dzsemekről	Ablative+On
világításhoz	Allative+At
nagyközönséggel	None
felsőfokot	Accusative
temesse	None
parapszichológia	Nominative
bárót	Accusative
forgatásról	Ablative+On
irányulna	None
szakembereknek	Dative
báróné	Nominative
lényegénél	At+Essive
elnökökhöz	Allative+At
aggyal	None
szabadul	None
arkangyaloknak	Dative
megtiltandó	None
méltányolva	None
ideget	Accusative
fejpályaudvar	Nominative
roptatok	None
átejtenek	None
mennyiségre	Allative+On
kevesebb	Nominative
objektumként	Formal
csökkentésekké	Translative
alföldnek	Dative
hajóját	Accusative
frissíteni	None
virágzatokban	Essive+In
védelmét	Accusative
reprodukálni	None
innovatív	Nominative
regényen	Essive+On
tanfolyamokat	Accusative
pszichológusként	Formal
akciótervek	Nominative
trükkel	None
fortélyosságként	Formal
helyzetből	Ablative+In
improvizálniuk	None
nehézhez	Allative+At
alföldektől	Ablative+At
fesztiválokhoz	Allative+At
időkről	Ablative+On
jogviszony	Nominative
kutyaugatásról	Ablative+On
megtizedeli	None
bukkannia	None
megnyugodnunk	None
ügyességre	Allative+On
testhez	Allative+At
fejezd|or|	None
bepillantásként	Formal
házasságtörésért	Purposive
keveredve	None
pontosabbá	Translative
flamingókkal	None
párbajon	Essive+On
érzékre	Allative+On
fajt	Accusative
befedtétek	None
bekerülniük	None
ölelte	None
koloniálisként	Formal
berepülőpilótáig	Terminative
megfogalmazáshoz	Allative+At
hülyeségen	Essive+On
életrajzokként	Formal
misékre	Allative+On
érintő	Nominative
felkészítenetek	None
polgármesterhez	Allative+At
csőben	Essive+In
papírhoz	Allative+At
elégedetlenségként	Formal
korszerűbb	Nominative
összegét	Accusative
későbbiekre	Allative+On
törekvéseket	Accusative
rágalomnak	Dative
bevezetésével	None
következményeivel	None
veszélyesbe	Allative+In
tonhalat	Accusative
lökték	None
szempontok	Nominative
megírunk	None
paklikat	Accusative
plébánossal	None
könyvekről	Ablative+On
pumpálják	None
hamisabb	Nominative
házaikat	Accusative
színvonalnak	Dative
stílusokkal	None
verbéna	Nominative
bilin	Essive+On
felvegyen	None
igazgatóságnak	Dative
galagonyát	Accusative
elérhetetlenebbeken	Essive+On
emlékeztetőért	Purposive
kabóca	Nominative
rézből	Ablative+In
másokért	Purposive
konzorciumok	Nominative
internetnek	Dative
hidegben	Essive+In
centralizációról	Ablative+On
betegesekből	Ablative+In
ludakkal	None
újdondásznak	Dative
támadásoknak	Dative
növésben	Essive+In
rákos	Nominative
sérülésektől	Ablative+At
határértékekre	Allative+On
dicsérjen	None
szalonnát	Accusative
vezérelnek	None
próbálkozásokra	Allative+On
sörüket	Accusative
felismeréssel	None
forrásoknál	At+Essive
megragad	None
vitorlázás	Nominative
megfogalmazott	None
védelmezze	None
védőkkel	None
jogart	Accusative
mosógépet	Accusative
támogatásokkal	None
füstbe	Allative+In
vízipipáig	Terminative
sebészettel	None
hozzáteszek	None
térfogatért	Purposive
pontszámon	Essive+On
hatóságról	Ablative+On
asszociálnál	None
tárca	Nominative
újabbra	Allative+On
kétmilliót	Accusative
talpnyalóba	Allative+In
parmezánnak	Dative
összetételén	Essive+On
tárul	None
kézbesítés	Nominative
centenáriumot	Accusative
dokumentációra	Allative+On
elutasítottatok	None
hordozókról	Ablative+On
zászlókról	Ablative+On
hanyatlásoktól	Ablative+At
hivatalánál	At+Essive
ligatúrának	Dative
frekvenciákon	Essive+On
áruházat	Accusative
kőomlást	Accusative
damaszt	Nominative
felriadnia	None
szeretkezésre	Allative+On
idejéhez	Allative+At
erényekről	Ablative+On
melegebb	Nominative
stimmelni	None
tojásfehérjéből	Ablative+In
processzorokat	Accusative
oxidban	Essive+In
népszámlálásig	Terminative
szervezésnek	Dative
karikatúrák	Nominative
arzénnel	None
szilvalekvárról	Ablative+On
témákhoz	Allative+At
sün	Nominative
gyanúba	Allative+In
telefonvonalak	Nominative
eléírnotok	None
kutatócsoportok	Nominative
igricekben	Essive+In
megfojtania	None
címernek	Dative
szolgáltatóval	None
margó	Nominative
sportágtól	Ablative+At
háromszögek	Nominative
cseréjét	Accusative
akadémiát	Accusative
kenyérboltokért	Purposive
pusztítja	None
szívével	None
becsapjon	None
régióból	Ablative+In
államvasutak	Nominative
igazgatást	Accusative
szakirányon	Essive+On
csirizelsz	None
edényt	Accusative
visszatértem	None
gyilkosságról	Ablative+On
ikonokért	Purposive
változással	None
bázisokat	Accusative
szintért	Purposive
spongya	Nominative
minőségéről	Ablative+On
környezete	Nominative
alkalmazásából	Ablative+In
támadjuk	None
lepkének	Dative
törvényjavaslatokat	Accusative
mártásban	Essive+In
jobbról	Ablative+On
fajtól	Ablative+At
hozzájárulnia	None
blogokat	Accusative
ellenőriznétek	None
szalvétát	Accusative
vörhenynek	Dative
vadászok	Nominative
aggodalom	Nominative
végez	None
készenlét	Nominative
tengeralattjárókra	Allative+On
rangot	Accusative
legrövidebbnek	Dative
tombolává	Translative
házasságtöréssel	None
kijelölünk	None
közéletben	Essive+In
lordról	Ablative+On
kergessék	None
harchoz	Allative+At
ellenfelektől	Ablative+At
szerzőt	Accusative
kipróbálja	None
kihasználva	None
üzemeltettek	None
erősre	Allative+On
babonákban	Essive+In
nyávognátok	None
teljesítésére	Allative+On
szóköz	Nominative
esetébe	Allative+In
kenyérbe	Allative+In
testvériséghez	Allative+At
felhőket	Accusative
mellhártyákban	Essive+In
férfiért	Purposive
rendelkezésükre	Allative+On
zaklatta	None
szolgálatához	Allative+At
aggódásokká	Translative
betűméret	Nominative
bombák	Nominative
ajándékoz	None
megbántották	None
ágylábért	Purposive
iktattak	None
fordulókra	Allative+On
mérését	Accusative
okleveleknek	Dative
temeti	None
feladatait	Accusative
kosárlabdázók	Nominative
világbajnokságtól	Ablative+At
egészségben	Essive+In
akváriumba	Allative+In
erőfeszítéseknek	Dative
szerepjátékhoz	Allative+At
szezonba	Allative+In
alagútból	Ablative+In
figyeljünk	None
berkélium	Nominative
kudarcokból	Ablative+In
sportoljak	None
meghatározásban	Essive+In
libidó	Nominative
zabokkal	None
borongós	Nominative
címből	Ablative+In
elmozdított	None
szamurájok	Nominative
tekintélyessé	Translative
könyvjelzőt	Accusative
tehetségéért	Purposive
reprodukáló	None
kötetnél	At+Essive
motoroknak	Dative
bevigye	None
bordán	Essive+On
jegyzek	None
erősítésével	None
megérkezni	None
somon	Essive+On
megváltásra	Allative+On
szenekre	Allative+On
felhasználásra	Allative+On
hasonlaton	Essive+On
tükörfordítás	Nominative
ígértem	None
ásszal	None
hajón	Essive+On
köteteket	Accusative
teleknek	Dative
korlátozzanak	None
pihenéssel	None
darut	Accusative
früstökölj|or|	None
összevető	None
kerülget	None
meghívásának	Dative
méretében	Essive+In
elkészítendő	None
szenvedéseken	Essive+On
bejegyzésen	Essive+On
vérré	Translative
megjegyzésből	Ablative+In
bimbóban	Essive+In
tartásban	Essive+In
beállítjuk	None
erdészetek	Nominative
megérdemel	None
ásványvizeket	Accusative
fórummal	None
hiányossággal	None
megbeszélnek	None
megjavítanunk	None
foglalkozásban	Essive+In
hágót	Accusative
kilátásért	Purposive
centrummá	Translative
ló	Nominative
pályaudvartól	Ablative+At
berekhez	Allative+At
csinálták	None
WC-kké	Translative
szavazófülkékkel	None
öltözetekben	Essive+In
hangolva	None
legtagadhatatlanabbakat	Accusative
tüntetések	Nominative
fordulatban	Essive+In
padra	Allative+On
feliratoknak	Dative
térdelni	None
évezreden	Essive+On
kendőn	Essive+On
földcsuszamlásokon	Essive+On
kerítenetek	None
forralják	None
növényektől	Ablative+At
ród	Nominative
bogárról	Ablative+On
eredetek	Nominative
tulajdonságaitól	Ablative+At
legalizálják	None
térdelő	None
megszerzett	None
táplálják	None
uralmáért	Purposive
részeire	Allative+On
szilva	Nominative
happoljak	None
térítésmentes	Nominative
kínálatra	Allative+On
mézédessel	None
féltékenységet	Accusative
alosztállyal	None
logikának	Dative
hátralevőből	Ablative+In
gömbökben	Essive+In
felhatalmaz	None
menekülés	Nominative
absztinenciákkal	None
bezárnak	None
megfog	None
fárad	None
mellékleteket	Accusative
értékénél	At+Essive
egyházaknál	At+Essive
aszpirinekért	Purposive
deciméterekké	Translative
architektúrában	Essive+In
nyilvánítanál	None
futamig	Terminative
próbálkoztam	None
viszonozza	None
elkerülését	Accusative
tervekből	Ablative+In
impresszummal	None
ligától	Ablative+At
magmát	Accusative
kijavíts|or|	None
képernyőre	Allative+On
remekművek	Nominative
felületekkel	None
szigetországok	Nominative
pusztítások	Nominative
emírség	Nominative
pókerarc	Nominative
népszámlálás	Nominative
tapintottam|	None
arisztokratikusakig	Terminative
védőszentből	Ablative+In
becsületről	Ablative+On
formáljuk	None
díszítésben	Essive+In
rendellenességben	Essive+In
lovaglásban	Essive+In
tárgyalásnak	Dative
raktárból	Ablative+In
megsérül	None
irodalmat	Accusative
befektetéssel	None
százalékáért	Purposive
feltüntetése	Nominative
táncoljuk	None
oldatként	Formal
egység	Nominative
rendszertant	Accusative
ábrázolásokon	Essive+On
kifejezésmóddal	None
vérebeket	Accusative
elindítanak	None
másodpercből	Ablative+In
jellemző	Nominative
propagandára	Allative+On
objektivitást	Accusative
zárójel	Nominative
ruháinkkal	None
magasságon	Essive+On
semlegesítenie	None
evőeszköz	Nominative
negyedórára	Allative+On
háztetőkbe	Allative+In
berendezésekről	Ablative+On
sajtburgerekkel	None
ligetben	Essive+In
kapujától	Ablative+At
üzeni	None
tengeralattjárót	Accusative
elvontakra	Allative+On
falucskába	Allative+In
jelképről	Ablative+On
ellentámadásig	Terminative
kényelmesebbek	Nominative
szempontjait	Accusative
fejlesztésből	Ablative+In
jelleg	Nominative
maradvánnyal	None
tanévben	Essive+In
genomok	Nominative
bírón	Essive+On
telepekre	Allative+On
népszavazásnak	Dative
születésről	Ablative+On
anyaországként	Formal
elbeszélne	None
teába	Allative+In
foglalón	Essive+On
élményt	Accusative
igényelni	None
gazok	Nominative
maradékból	Ablative+In
napsütés	Nominative
porcelánt	Accusative
legjobbra	Allative+On
beépítette	None
koronáig	Terminative
sarjon	Essive+On
kardoskodtak	None
csuka	Nominative
jeggyel	None
mellényben	Essive+In
némber	Nominative
erdőhöz	Allative+At
rizshez	Allative+At
lejátszottak	None
galaxisok	Nominative
vázolva	None
terhekkel	None
alperesek	Nominative
repülőjegyekből	Ablative+In
műti	None
stábokként	Formal
frekvenciát	Accusative
bárányokkal	None
motorokról	Ablative+On
adattípusokkal	None
tárgyában	Essive+In
megsemmisítettek	None
árába	Allative+In
délről	Ablative+On
polgárháború	Nominative
tájékoztatnia	None
ékírásban	Essive+In
békák	Nominative
közön	Essive+On
dialektusnak	Dative
ártsanak	None
tárolni	None
kockázatáig	Terminative
ezredeseket	Accusative
egészével	None
hivatásos	Nominative
részévé	Translative
revolverek	Nominative
világtérképet	Accusative
falainál	At+Essive
ágenshez	Allative+At
tupíroznia	None
holttestnek	Dative
szemlélethez	Allative+At
bicskákig	Terminative
palotán	Essive+On
bizottságának	Dative
egybekelnek	None
megfizettek	None
közöttieket	Accusative
kertjével	None
kacajokban	Essive+In
kerékpártúrával	None
ajánlatra	Allative+On
tájékoztatáson	Essive+On
szülnek	None
csókolt	None
komponenst	Accusative
újabbnak	Dative
rajongókat	Accusative
lehelném|	None
megkapjuk	None
őrző	None
széklettel	None
egybeírtad	None
akadályozzuk	None
tervért	Purposive
klassz	Nominative
színűvé	Translative
anyagban	Essive+In
városházán	Essive+On
vadászattal	None
forradalomból	Ablative+In
utóbbiban	Essive+In
kaland	Nominative
atomerőművekben	Essive+In
átkok	Nominative
jegybank	Nominative
ámítottuk	None
tartásának	Dative
felújította	None
csótányoknál	At+Essive
elhelyezel	None
csípő	Nominative
pocsolyák	Nominative
kancát	Accusative
jelvényeken	Essive+On
voksig	Terminative
farkasoknak	Dative
megfigyelés	Nominative
kánná	Translative
darabokkal	None
alkotásoknál	At+Essive
asztalok	Nominative
túráról	Ablative+On
dolgokat	Accusative
beállításokon	Essive+On
kellessék	None
osztályzattal	None
vonzódó	None
bátorította	None
dohnál	At+Essive
golfpályát	Accusative
tutajjal	None
agresszivitásra	Allative+On
gebe	Nominative
cenzúra	Nominative
felhívnál	None
sivatagba	Allative+In
elnéptelenedésekké	Translative
szemszögével	None
magnók	Nominative
aberráció	Nominative
zajtalanabbá	Translative
bevittem	None
napilapokba	Allative+In
helyesbítsd|or|	None
feladatoknak	Dative
foltként	Formal
korálltak	None
vízummal	None
hormonkészítményekbe	Allative+In
analógiákkal	None
címéből	Ablative+In
áradatoknak	Dative
mozgássá	Translative
erélyesekig	Terminative
nyitányba	Allative+In
gyógyfű	Nominative
megbízhatóságot	Accusative
vízeséseken	Essive+On
dolgaitokból	Ablative+In
farkáról	Ablative+On
felszabadítva	None
tejfölt	Accusative
káliummal	None
alkákká	Translative
gyógyászatot	Accusative
egységgé	Translative
sötétséggel	None
tömegeket	Accusative
bábbá	Translative
lakótelep	Nominative
alapítójával	None
gésaként	Formal
oxigénnel	None
álláspontja	Nominative
bányák	Nominative
háznak	Dative
harckocsikhoz	Allative+At
védelmeznének	None
füttyből	Ablative+In
túltermelésekhez	Allative+At
egyenruhán	Essive+On
fújja	None
panaszkodni	None
relációval	None
alapítványtól	Ablative+At
feltalálják	None
hipotézisen	Essive+On
székhelyéhez	Allative+At
fennsíkokkal	None
ásatásokba	Allative+In
engedélyeznék	None
előd	Nominative
módjának	Dative
artistától	Ablative+At
beszédnek	Dative
éneklésre	Allative+On
árnyékától	Ablative+At
hamisítják	None
mitokondriummal	None
erőforrásokból	Ablative+In
felépítette	None
járuló	None
katalógusokat	Accusative
cápa	Nominative
axiómákra	Allative+On
kilométerekre	Allative+On
hajgyökereknek	Dative
meditációról	Ablative+On
kisebbeket	Accusative
csontszövet	Nominative
nehéziparban	Essive+In
fizetéseknek	Dative
bevezetésben	Essive+In
buszból	Ablative+In
színészekről	Ablative+On
gyászjelentések	Nominative
jelöléssel	None
emeljen	None
istennőtől	Ablative+At
megvásárló	None
mérnökhöz	Allative+At
kívánságokat	Accusative
kozma	Nominative
megtaláltak	None
platformtól	Ablative+At
módszerére	Allative+On
menedzsert	Accusative
résekben	Essive+In
zsinagógákban	Essive+In
szállítókat	Accusative
játékbolt	Nominative
pszichológustól	Ablative+At
infrastruktúrának	Dative
tudakoljunk	None
elrendel	None
elégtételt	Accusative
vizektől	Ablative+At
előadva	None
vételhez	Allative+At
ötletéből	Ablative+In
kosárlabdáznánk	None
élőlényeknek	Dative
átírtak	None
feküdne	None
zsákba	Allative+In
szerzetesekből	Ablative+In
bowlingozniuk	None
szerkezeteit	Accusative
utóbbihoz	Allative+At
szarvashúson	Essive+On
népesekről	Ablative+On
zongorázott	None
innovációra	Allative+On
díszítésként	Formal
kézigránátot	Accusative
harcolva	None
csónakban	Essive+In
keményítőtartalmakért	Purposive
kályhához	Allative+At
kaszinóból	Ablative+In
légszennyeződésből	Ablative+In
kézenállásokhoz	Allative+At
tárgyához	Allative+At
forgalmaztak	None
vezényelnie	None
alkalomhoz	Allative+At
hintók	Nominative
hámozzon	None
technikákon	Essive+On
építészettel	None
hashajtónak	Dative
lebegnek	None
fényképpel	None
oszlottak	None
célunk	Nominative
reagáljanak	None
megkönnyítse	None
játékával	None
gályából	Ablative+In
kiválasztására	Allative+On
öveztek	None
meghívták	None
bölcsőde	Nominative
kunyhóban	Essive+In
ködlámpáktól	Ablative+At
motorjában	Essive+In
sejteti	None
rejtelmesebbet	Accusative
beszerzik	None
címerben	Essive+In
fészken	Essive+On
istent	Accusative
ostyáról	Ablative+On
fejezeteknél	At+Essive
megkönnyebbülést	Accusative
lányban	Essive+In
nagyítottam|	None
köztisztviselőknek	Dative
mozgatnia	None
mutatkoznia	None
rizómából	Ablative+In
alakítanák	None
nézetnek	Dative
javítanom	None
tüntetned	None
tudománytól	Ablative+At
allergiásak	Nominative
rablás	Nominative
együttesig	Terminative
szandálban	Essive+In
tőszámnevek	Nominative
konvertálva	None
ügyeket	Accusative
cikkekre	Allative+On
csöngted	None
testinél	At+Essive
fakopáncsért	Purposive
recesszióba	Allative+In
házadban	Essive+In
állásponttal	None
terhektől	Ablative+At
foglalkozásból	Ablative+In
bajból	Ablative+In
űrlapon	Essive+On
mélypontokkal	None
koordinációsak	Nominative
újonccal	None
titkárrá	Translative
védetthez	Allative+At
elnevezik	None
vagdosol	None
tisztségtől	Ablative+At
berakásokat	Accusative
csillapodnak	None
masnin	Essive+On
taglalták	None
riportokat	Accusative
gerinc	Nominative
hímnemhez	Allative+At
gyümölcsfa	Nominative
verseit	Accusative
fővároson	Essive+On
terrortámadásokra	Allative+On
célpontokat	Accusative
parlamentekben	Essive+In
hírességnek	Dative
összezsugorítanék	None
tárgyakká	Translative
indokolatlanért	Purposive
átírásoknál	At+Essive
szélvihar	Nominative
kedvre	Allative+On
hasznosítanak	None
brokkoli	Nominative
bensőségről	Ablative+On
diagnózisra	Allative+On
vidrák	Nominative
hazudták	None
anyagcserét	Accusative
bátrabbak	Nominative
figyelmeztetésekkel	None
andalognom	None
erdőkből	Ablative+In
konfigurációsból	Ablative+In
tükörfordítások	Nominative
mellények	Nominative
hódított	None
bokszolót	Accusative
élményen	Essive+On
felmond	None
zsetonok	Nominative
rokonánál	At+Essive
báloknak	Dative
lemez	Nominative
orvosokhoz	Allative+At
összefüggést	Accusative
szomszédok	Nominative
trombitáló	None
gombokon	Essive+On
raktárakba	Allative+In
provokációra	Allative+On
állományba	Allative+In
tisztségviselőként	Formal
musicalt	Accusative
magyarázatokról	Ablative+On
tálban	Essive+In
vízilabdáztunk	None
befektetésekkel	None
húsvétig	Terminative
várakozásihoz	Allative+At
becsben	Essive+In
szülőhöz	Allative+At
ellenfélen	Essive+On
ellenféllel	None
tizenéveseknek	Dative
bázisokon	Essive+On
visszahatnál	None
kedvezményben	Essive+In
álnévként	Formal
környezetvédő	Nominative
indokolta	None
időszakokat	Accusative
nadrágból	Ablative+In
gondolás	Nominative
bátorították	None
elkészítenek	None
szabálytól	Ablative+At
bemutatókat	Accusative
süketnek	Dative
legmélyebbekkel	None
méretűeknél	At+Essive
héliumnál	At+Essive
kiemelkedik	None
jelképeznek	None
felbujtón	Essive+On
tapasztalatoktól	Ablative+At
csoszogjon	None
ötleteként	Formal
üzemről	Ablative+On
feliratkozásba	Allative+In
ingákért	Purposive
bálnából	Ablative+In
bizonyítanom	None
ügylettel	None
tekintetétől	Ablative+At
típuson	Essive+On
tervezéséért	Purposive
zajként	Formal
folyamtól	Ablative+At
kistérségekkel	None
katalógusnak	Dative
pályafutására	Allative+On
leírásért	Purposive
részesülnek	None
dumál	None
kommunikációval	None
emeléseknek	Dative
komédiát	Accusative
kivitelezésektől	Ablative+At
producerhez	Allative+At
lévőkért	Purposive
kovásznál	At+Essive
édesvizek	Nominative
gyűlő	None
éve	Nominative
ágylábba	Allative+In
tulajdonon	Essive+On
előad	None
gerincről	Ablative+On
kormányzatot	Accusative
digitalizálják	None
illatában	Essive+In
dísztárcsák	Nominative
írnokok	Nominative
egyházfővel	None
vásárolnia	None
macskakörmökről	Ablative+On
végrehajtania	None
anomáliáig	Terminative
csipeszek	Nominative
tartalomjegyzéknek	Dative
elviseljek	None
szükségszerűekké	Translative
diagnosztikához	Allative+At
szolgálatoknak	Dative
bizonyult	None
optimizmussal	None
feleséget	Accusative
élmény	Nominative
távolságtól	Ablative+At
átokból	Ablative+In
állapotokról	Ablative+On
lyukasztottatok	None
facsavarként	Formal
képernyővel	None
táncoknak	Dative
rendszeréhez	Allative+At
horda	Nominative
szándékból	Ablative+In
számútól	Ablative+At
jelölésre	Allative+On
birsalmafátokként	Formal
feláldozva	None
leég	None
behozatal	Nominative
pályázata	Nominative
bob	Nominative
diszkvalifikálta	None
formációkat	Accusative
követését	Accusative
partokra	Allative+On
véglegesíti	None
produktum	Nominative
hurcoljon	None
megszervezze	None
virágként	Formal
vezényelve	None
nemzetnek	Dative
legszemtelenebbhez	Allative+At
dug	None
gráfot	Accusative
naturalizálnál	None
kemencékben	Essive+In
érzésről	Ablative+On
álldogáló	None
poráig	Terminative
direktívákat	Accusative
eltéréseknek	Dative
épülethez	Allative+At
adatlapot	Accusative
legidősebb	Nominative
kiadásként	Formal
felügyeletét	Accusative
profilt	Accusative
logikus	Nominative
kompozíciónak	Dative
narancsdzsemeket	Accusative
bejelentkezve	None
otthonába	Allative+In
csomagokat	Accusative
egybeírnának	None
együttműködésről	Ablative+On
könyvesboltok	Nominative
megjegyzésekre	Allative+On
trénerek	Nominative
egyidejű	Nominative
rendelkezésekből	Ablative+In
fejlődés	Nominative
műsorvezetővel	None
referenciákért	Purposive
legabszurdabbról	Ablative+On
nemzetségekre	Allative+On
bírtak	None
szirtekbe	Allative+In
óhatatlan	Nominative
világrekordok	Nominative
pisztolyra	Allative+On
bizalommá	Translative
abroncsokra	Allative+On
öregasszonyt	Accusative
szalonnán	Essive+On
problémásaknál	At+Essive
vidékekké	Translative
társával	None
tincsekért	Purposive
szimbolikusakká	Translative
klubok	Nominative
bandához	Allative+At
indítod	None
ősökkel	Purposive
dalairól	Ablative+On
foglalatosságtól	Ablative+At
frissítésen	Essive+On
tájfunokba	Allative+In
továbbképzéssel	None
használatához	Allative+At
utáló	None
dizájnok	Nominative
krémeket	Accusative
bázissal	None
lágytojással	None
fogyasztóra	Allative+On
javításánál	At+Essive
tehetségekért	Purposive
ruhából	Ablative+In
fejleszted	None
hozzáadtak	None
albumért	Purposive
ügyfélszolgálat	Nominative
színeiből	Ablative+In
szójegyzékként	Formal
csákóért	Purposive
misszióhoz	Allative+At
ateizmusról	Ablative+On
elhanyagolttá	Translative
konformizmusokig	Terminative
szükségtelennek	Dative
internetre	Allative+On
kiindulásival	None
túlium	Nominative
taníttatni	None
társadalmak	Nominative
buszmegállót	Accusative
ellentmondásba	Allative+In
korszaktól	Ablative+At
színpompán	Essive+On
halálába	Allative+In
bíbornokokhoz	Allative+At
értékbe	Allative+In
ugratni	None
viszonyról	Ablative+On
focira	Allative+On
témához	Allative+At
sétányról	Ablative+On
központjában	Essive+In
összejöveteleken	Essive+On
láncnál	At+Essive
márkáért	Purposive
kielégítendő	None
baján	Essive+On
értesítette	None
szörnyként	Formal
modernizációnak	Dative
megkérdezett	Nominative
döngenem	None
pincékből	Ablative+In
kivételére	Allative+On
hadnagynak	Dative
focistával	None
fokozza	None
faragásokkal	None
mechanizmusokon	Essive+On
palackokkal	None
nagyméretűek	Nominative
finomabbakból	Ablative+In
támadástól	Ablative+At
kevesebbként	Formal
magnitúdóval	None
referenciával	None
imádkozunk	None
tokányokként	Formal
falán	Essive+On
aggállyá	Translative
konzolra	Allative+On
lassító	None
legkiszámíthatatlanabbakhoz	Allative+At
üzeneten	Essive+On
mesterségek	Nominative
hazafi	Nominative
házasságtörésekről	Ablative+On
terhe	Nominative
dagályosakról	Ablative+On
emblémákat	Accusative
meggyőződésen	Essive+On
társítsák	None
részemért	Purposive
dörzsöljük	None
földnyelvekre	Allative+On
egésze	Nominative
tanóra	Nominative
domboldalban	Essive+In
sebességénél	At+Essive
vállakkal	None
fajokból	Ablative+In
jégkoronggal	None
folytatódva	None
meditációt	Accusative
mandzsetta	Nominative
magasságot	Accusative
éter	Nominative
csontrendszerről	Ablative+On
egerészekről	Ablative+On
halálig	Terminative
külföldeknél	At+Essive
tárgyalnák	None
slágerlistákra	Allative+On
golfot	Accusative
körülnézel	None
boszorkányig	Terminative
válságban	Essive+In
paták	Nominative
szövegkörnyezetet	Accusative
jellegekkel	None
ellátások	Nominative
garancia	Nominative
íjászokat	Accusative
sztároknak	Dative
jóváhagyták	None
hipotézissel	None
befektetve	None
anarchizmust	Accusative
páratlan	Nominative
sertések	Nominative
inzulin	Nominative
leprával	None
ártana	None
cukorként	Formal
terméken	Essive+On
észszerűtlen	Nominative
ékszerként	Formal
régiért	Purposive
igennel	None
helyezéseken	Essive+On
homokdűnék	Nominative
megnevezésekben	Essive+In
pofáig	Terminative
grabancként	Formal
fakírokban	Essive+In
megnéznie	None
mobilra	Allative+On
jelképeket	Accusative
szőkített	None
befejezéséért	Purposive
rendszerrel	None
nyomtatva	None
testalkat	Nominative
mént	Accusative
kéjjel	None
intézményhez	Allative+At
tavaszának	Dative
eurók	Nominative
mélyhegedű	Nominative
tilalmat	Accusative
nagyvállalatból	Ablative+In
artistákat	Accusative
pávián	Nominative
csoportelméletben	Essive+In
borokkal	None
levesekbe	Allative+In
tehetségként	Formal
tévékészülék	Nominative
vagyonon	Essive+On
panziókban	Essive+In
kijöjjön	None
legtudatlanabbakat	Accusative
elismeritek	None
vulkanizmussal	None
bíróságokkal	None
mentésnél	At+Essive
szigetben	Essive+In
tördelje	None
helyreállítottatok	None
üzenetének	Dative
kialszik	None
üvegházban	Essive+In
regényíróval	None
légifelvétel	Nominative
visszavett	None
szertartásmester	Nominative
fejlettebbig	Terminative
vezekelsz	None
kalászt	Accusative
melledre	Allative+On
sünért	Purposive
tartást	Accusative
aktákról	Ablative+On
tanúsítsa	None
tényezőknek	Dative
eseményeket	Accusative
réseknek	Dative
akcióinkként	Formal
mértékében	Essive+In
hasznosabban	Essive+In
tengernaggyal	None
moziról	Ablative+On
ünőért	Purposive
csirkehúsokra	Allative+On
olvasókért	Purposive
paraméterektől	Ablative+At
felbukkantak	None
igényei	Nominative
frissülni	None
pályákon	Essive+On
fújdogálnánk	None
erősítettek	None
ezernyi	Nominative
reprivatizálni	None
utánpótlásból	Ablative+In
értesíteném|	None
államfőként	Formal
zsepiben	Essive+In
cinkének	Dative
lázadóval	None
birtokolták	None
előlegre	Allative+On
versenyként	Formal
fenevaddal	None
sötétbe	Allative+In
megtervezi	None
nyílnia	None
pépekre	Allative+On
gyereknél	At+Essive
egymilliót	Accusative
bábákkal	None
oszlopokból	Ablative+In
ütközésért	Purposive
minősítés	Nominative
megbánt	None
folyadékként	Formal
rabláshoz	Allative+At
szenvedniük	None
termelők	Nominative
szöveteken	Essive+On
adományozó	None
táblákba	Allative+In
nehézipar	Nominative
kommunikáltad	None
elégedetlenségig	Terminative
pacskeren	Essive+On
bankjegyeknek	Dative
kapuról	Ablative+On
fordulatot	Accusative
megemlítve	None
szegénynegyedektől	Ablative+At
egyesülettől	Ablative+At
becstelen	Nominative
sebességére	Allative+On
siessetek	None
barlangász	Nominative
szimbolizáltatok	None
elmennének	None
teljesül	None
követelve	None
beköltöznek	None
kivonjuk	None
felbukkannak	None
diszkrimináló	None
zöldellnek	None
idegesített	None
elhelyezésénél	At+Essive
világítótornyok	Nominative
utcába	Allative+In
csökkentés	Nominative
fejű	Nominative
lyukasztani	None
borogatnád	None
megfogalmazásán	Essive+On
összehasonlítani	None
oroszlánnal	None
azonosítsd|or|	None
párokból	Ablative+In
szakaszról	Ablative+On
átnevezek	None
sékel	Nominative
szennyvizet	Accusative
kajakkal	None
lepellel	None
ismeretének	Dative
baseballra	Allative+On
kalandoknak	Dative
megidézte	None
előadásokat	Accusative
nagybátyát	Accusative
fűződtek	None
annektálni	None
lefejezték	None
érintetlenek	Nominative
urak	Nominative
lant	Nominative
lítiummal	None
malátából	Ablative+In
tanácsánál	At+Essive
édesanyába	Allative+In
távozzak	None
hajszálon	Essive+On
gyűrűből	Ablative+In
borogatnátok	None
kuli	Nominative
helyszínné	Translative
szertartáson	Essive+On
rezervátumok	Nominative
szerkesztőséghez	Allative+At
ismeretté	Translative
kijelzők	Nominative
jelentkezni	None
antiszeptikumok	Nominative
megállapítások	Nominative
zsinaton	Essive+On
tejsavvá	Translative
ásatásokkal	None
cimpára	Allative+On
lemezekbe	Allative+In
éjfélig	Terminative
teremtünk	None
elővigyázatosságból	Ablative+In
madárra	Allative+On
péppel	None
febr.-tól	Ablative+At
küszöbéig	Terminative
csövet	Accusative
kifejt	None
ivóvízként	Formal
istenünk	Nominative
kiadásokból	Ablative+In
adózás	Nominative
anyámig	Terminative
felhívást	Accusative
pénzügyekkel	None
kivételekkel	None
etikettnek	Dative
drágulsz	None
navigációs	Nominative
ürítenie	None
lifttel	None
ítélethez	Allative+At
absztinenciánál	At+Essive
hordozókkal	None
ítélt	None
sakkot	Accusative
kutatásért	Purposive
ideológia	Nominative
régészetekké	Translative
galléroktól	Ablative+At
sértegetni	None
lenekről	Ablative+On
kábelbe	Allative+In
bugyogó	Nominative
tiszteletre	Allative+On
gyűjteményekbe	Allative+In
illesztőprogram	Nominative
paralelogrammák	Nominative
feleségével	None
tagdíjat	Accusative
megpróbáltam	None
reformálandó	None
művészetként	Formal
metán	Nominative
mellékelnek	None
fundamentalizmussá	Translative
főherceg	Nominative
hamisítványnak	Dative
kifogásnak	Dative
kipróbált	None
kengyellel	None
mozgástanként	Formal
egészségbiztosításként	Formal
formálissá	Translative
adómentesektől	Ablative+At
szakítana	None
engedély	Nominative
módszer	Nominative
optimizmusnak	Dative
keféknek	Dative
alkirályi	Nominative
miniszterekből	Ablative+In
trolibusz	Nominative
fenekének	Dative
hangtalanságokká	Translative
szakítják	None
szótárakkal	None
főszereplőtől	Ablative+At
népében	Essive+In
ura	Nominative
landoljon	None
diók	Nominative
jeleként	Formal
fénykép	Nominative
hurcolnak	None
áteresztőképességekért	Purposive
megerősítettek	None
időszakából	Ablative+In
platformokon	Essive+On
papírra	Allative+On
szüntelen	Nominative
jegyzetekhez	Allative+At
alapszinttel	None
üldözzék	None
bőrgyár	Nominative
borzalmasak	Nominative
megnyomtak	None
fenntartásával	None
sütötte	None
elkíséri	None
garast	Accusative
szólamokat	Accusative
mellsőknél	At+Essive
kiszámíthatatlanabb	Nominative
kőbányának	Dative
kudarcból	Ablative+In
szigetelünk	None
méltóakig	Terminative
részesüljünk	None
homokzsák	Nominative
csomóponttól	Ablative+At
lámpásért	Purposive
mulasztva	None
kiszabadulva	None
figyelméből	Ablative+In
egyensúlyba	Allative+In
pártja	Nominative
előterjesztetted	None
paramétertől	Ablative+At
véznába	Allative+In
kiegészítéseknek	Dative
évszázadtól	Ablative+At
bibliaiért	Purposive
tapaszokból	Ablative+In
formalizmusokkal	None
hangfalak	Nominative
kentaur	Nominative
vertikálisaknál	At+Essive
bizonytalanságokként	Formal
vezetőjeként	Formal
versenyre	Allative+On
legzamatosabbá	Translative
kalanddal	None
mozgalomról	Ablative+On
operáért	Purposive
képtelenné	Translative
gyomnak	Dative
hangszereken	Essive+On
nagyujjak	Nominative
iparvidék	Nominative
vitaminról	Ablative+On
feltételeznünk	None
bőrcipőnek	Dative
kibernetika	Nominative
etnikumot	Accusative
bevételre	Allative+On
politikusokról	Ablative+On
kasztrálandó	None
minősége	Nominative
állapítja	None
harmonizálják	None
növesztettek	None
fehérjét	Accusative
rabszolgává	Translative
mértéke	Nominative
spórol	None
megmaradtam	None
elismerjenek	None
udvarokból	Ablative+In
adományokban	Essive+In
alkalmassá	Translative
császárnőként	Formal
hitelezőket	Accusative
ürítettek	None
periódusként	Formal
lovassportok	Nominative
piramissal	None
kitiltottak	None
soroknak	Dative
gasztronómiát	Accusative
istállónál	At+Essive
bifenileknél	At+Essive
gyöngyvirágokról	Ablative+On
fazekasoknak	Dative
mozaikokon	Essive+On
tanúskodjon	None
blokkolna	None
kulcsszavakra	Allative+On
hibáztatták	None
liturgiát	Accusative
módosulna	None
fagylalt	Nominative
cselekednie	None
öbölhöz	Allative+At
halálosakkal	None
tragédiája	Nominative
lapátokkal	None
lidércnyomásokba	Allative+In
űrsétával	None
tanszékeken	Essive+On
megszerzésekbe	Allative+In
kiállítanotok	None
sikerré	Translative
legsavanyúbbakon	Essive+On
formátumnál	At+Essive
díjat	Accusative
produkciót	Accusative
reszelővel	None
gondolatainktól	Ablative+At
alsóneműkre	Allative+On
hivatkoztam	None
munkanap	Nominative
térségében	Essive+In
ismerethez	Allative+At
elvérezni	None
üléseken	Essive+On
másolás	Nominative
feleljenek	None
patronázs	Nominative
mólóról	Ablative+On
szeizmológia	Nominative
csépeltünk	None
legkimondhatatlanabbaktól	Ablative+At
közleményeket	Accusative
blogot	Accusative
naplementéig	Terminative
kereszténységben	Essive+In
fogadók	Nominative
eretnekséggel	None
közelből	Ablative+In
növénytanban	Essive+In
barin	Essive+On
megújulásnak	Dative
éjszakákká	Translative
ágyra	Allative+On
festményre	Allative+On
vállalkozássá	Translative
egyszerűbben	Essive+In
iszapból	Ablative+In
polgárokkal	None
hibával	None
engedelmességre	Allative+On
ágról	Ablative+On
középkorhoz	Allative+At
legfiatalabban	Essive+In
megtaláló	None
udvariasságtól	Ablative+At
riasztottál	None
életévben	Essive+In
tisztázták	None
munkatársa	Nominative
csembalókban	Essive+In
mozdulatlanságot	Accusative
szex	Nominative
frusztrációknak	Dative
hangsúlyozniuk	None
ellenőrzésbe	Allative+In
évszámokba	Allative+In
épületekről	Ablative+On
értesüljön	None
lornyonig	Terminative
gyanúsítják	None
kedvért	Purposive
ítélek	None
utaltál	None
telefonokon	Essive+On
mandátumot	Accusative
tanúként	Formal
csapdákat	Accusative
guru	Nominative
felperes	Nominative
költségekkel	None
növekednek	None
társaik	Nominative
zarándokokig	Terminative
félreértené	None
termékennyé	Translative
katonába	Allative+In
megegyezést	Accusative
oktatásából	Ablative+In
regényekhez	Allative+At
hiúságnak	Dative
szerző	Nominative
szerencsétlenségeket	Accusative
poklon	Essive+On
szuperáltad	None
összevetniük	None
északra	Allative+On
jogellenesnek	Dative
részletes	Nominative
hullaházakról	Ablative+On
percekre	Allative+On
családtagoknak	Dative
csökkentése	Nominative
közkincset	Accusative
örökséget	Accusative
előbbihez	Allative+At
labor	Nominative
megfogná	None
nyilvánítson	None
hefti	Nominative
esőtől	Ablative+At
lepelbe	Allative+In
objektumoknál	At+Essive
megfelelőbb	Nominative
küldésre	Allative+On
sztorit	Accusative
góljánál	At+Essive
érdemelnének	None
kergetik	None
évfolyamokon	Essive+On
csinálná	None
sertésekre	Allative+On
napból	Ablative+In
megvalósításokat	Accusative
bájosaknak	Dative
kompenzál	None
szereplőre	Allative+On
olvasóért	Purposive
elképzelésekre	Allative+On
kuriózum	Nominative
vélekedtek	None
népességben	Essive+In
postaládáért	Purposive
madárból	Ablative+In
bűncselekmények	Nominative
főzeléket	Accusative
voltától	Ablative+At
kiáltják	None
hasznából	Ablative+In
feleségemtől	Ablative+At
olajra	Allative+On
fájáson	Essive+On
emlékezetben	Essive+In
csillaggyümölcsökhöz	Allative+At
szörnyekké	Translative
sejknek	Dative
idézetre	Allative+On
készítéséből	Ablative+In
botként	Formal
világosságnak	Dative
napnál	At+Essive
pénzbeliekben	Essive+In
kiegészítenénk	None
kebeltől	Ablative+At
belügyminisztert	Accusative
ormány	Nominative
reflektorok	Nominative
harcoktól	Ablative+At
nyomornegyedekben	Essive+In
izom	Nominative
kétnapos	Nominative
golfpályához	Allative+At
tévéznetek	None
helyesnek	Dative
egységektől	Ablative+At
részvénytársasággá	Translative
életét	Accusative
kétféle	Nominative
völgyön	Essive+On
jóváhagynotok	None
üdvözletek	Nominative
naplók	Nominative
építményben	Essive+In
porfészekig	Terminative
gömbre	Allative+On
tükrében	Essive+In
légszennyeződésekből	Ablative+In
törzzsé	Translative
felmossák	None
felszabadításról	Ablative+On
zenekarával	None
tanúsítottam	None
kacag	None
időszakáról	Ablative+On
szinteknél	At+Essive
zarándoklatot	Accusative
képeslapról	Ablative+On
cserepekbe	Allative+In
motorjává	Translative
dobozának	Dative
végződött	None
mérgezik	None
összegyűjtsön	None
válaszában	Essive+In
étlapokból	Ablative+In
tárolnia	None
apácát	Accusative
lakhelyváltoztatáshoz	Allative+At
pályaválasztásinál	At+Essive
ősökhöz	Ablative+In
rivalizálnak	None
teherautókként	Formal
csarnoktól	Ablative+At
orvos	Nominative
rádióműsort	Accusative
versenyművet	Accusative
hajfestékért	Purposive
belsejében	Essive+In
ideálisabb	Nominative
fújnak	None
ajánlottabbról	Ablative+On
méltóságon	Essive+On
forradalomhoz	Allative+At
béreltekre	Allative+On
egyenletrendszert	Accusative
alelnökkel	None
evangéliumiakban	Essive+In
tündérnek	Dative
tettek	Nominative
gáttal	None
területek	Nominative
agitálni	None
kórusba	Allative+In
texasiakkal	None
elefántfókákból	Ablative+In
frigyért	Purposive
optimizmus	Nominative
szállítaniuk	None
elektromágnest	Accusative
pikkelyt	Accusative
miniszoknyát	Accusative
olvadással	None
követelményekkel	None
oxidálódik	None
dolgaimról	Ablative+On
ecetgyár	Nominative
ablakokból	Ablative+In
autizmust	Accusative
tapaszokként	Formal
tulajdonná	Translative
improvizálunk	None
középiskolába	Allative+In
százalékra	Allative+On
bővítek	None
beütemezned	None
kőpadok	Nominative
energiának	Dative
bombával	None
tornáccal	None
bekenni	None
tanácsává	Translative
képről	Ablative+On
akcsétól	Ablative+At
levélváltásról	Ablative+On
ifjúságnak	Dative
hercegnőről	Ablative+On
óceánokba	Allative+In
inflációellenessel	None
belépési	Nominative
elsodorja	None
abrosz	Nominative
töltéseken	Essive+On
szellőcskéért	Purposive
pumpáló	None
utolérte	None
formátumban	Essive+In
szabadságharcok	Nominative
öngyilkosságokba	Allative+In
kéjnő	Nominative
testvére	Nominative
vakációzták	None
lyukasztott	None
maraton	Nominative
kürthöz	Allative+At
irányítva	None
enciklopédián	Essive+On
kormányozni	None
munkába	Allative+In
perifériára	Allative+On
kereslethez	Allative+At
domináljon	None
célokból	Ablative+In
szintézisekké	Translative
mozgása	Nominative
őrölni	None
esésnél	At+Essive
szerkesztetted	None
összehangolt	None
faragatlanabban	Essive+In
pletykákat	Accusative
kavar	None
csomagokba	Allative+In
vagyonának	Dative
képviseletéről	Ablative+On
intézményt	Accusative
előadóterem	Nominative
elkezdődött	None
filmért	Purposive
likvidálnánk	None
képesebbeken	Essive+On
kívánságod	Nominative
szépről	Ablative+On
következetesekből	Ablative+In
strázsamester	Nominative
felhalmozva	None
ékesszólással	None
kiépítését	Accusative
zsákmányra	Allative+On
keverednének	None
értékeléséből	Ablative+In
elérést	Accusative
turbánokra	Allative+On
jegyzetekbe	Allative+In
egészekké	Terminative
jellemzővel	None
kertészt	Accusative
idiótákká	Translative
központok	Nominative
formulákat	Accusative
kampóval	None
biztosítót	Accusative
hangmérnökként	Formal
almanachok	Nominative
egyeztek	None
gúnár	Nominative
hallgatniuk	None
repülők	Nominative
övezték	None
hattyúig	Terminative
randevúzik	None
úriember	Nominative
februárjáig	Terminative
országairól	Ablative+On
konyhakerteken	Essive+On
erkölcsökkel	None
fentiek	Nominative
süteményeket	Accusative
másodpercek	Nominative
fotót	Accusative
dalból	Ablative+In
támadásokra	Allative+On
fiatalos	Nominative
könyvesboltokig	Terminative
scripttel	None
feliratot	Accusative
tanfolyammal	None
tiszteletével	None
fókuszáltak	None
kiszámíthatóvá	Translative
rongyoljuk	None
lyukasztó	None
randevú	Nominative
alkotmányról	Ablative+On
világbajnokságra	Allative+On
barátnőjébe	Allative+In
dokumentumfilmről	Ablative+On
eszközeiről	Ablative+On
nemzettel	None
ruhájukra	Allative+On
rákkutatás	Nominative
kötvény	Nominative
díjaznák	None
alkot	None
művelettől	Ablative+At
gólkülönbségekben	Essive+In
okiratokként	Formal
megrendelsz	None
vakarja	None
államvasutaknál	At+Essive
bosnyákokkal	None
budaiig	Terminative
társítani	None
kutatókkal	None
eseménye	Nominative
idegről	Ablative+On
közelségre	Allative+On
ágyát	Accusative
harisnyát	Accusative
adottá	Translative
férfiról	Ablative+On
zeneszerzőre	Allative+On
dőlttel	None
örömében	Essive+In
elnevezést	Accusative
kódolták	None
laboratóriumba	Allative+In
botjának	Dative
óceánnak	Dative
rokonokra	Allative+On
pesszáriumok	Nominative
vélelmet	Accusative
sorolunk	None
sejtetnek	None
vakokról	Ablative+On
fatörzsekre	Allative+On
felszállt	None
kelletniük	None
olajnak	Dative
hároméves	Nominative
zsinat	Nominative
temetéshez	Allative+At
otthoniak	Nominative
ajakosakban	Essive+In
telekommunikációval	None
rekonstrukcióra	Allative+On
muníciót	Accusative
jogászoknak	Dative
vitorlázásban	Essive+In
csillagrendszerek	Nominative
értelmiséggel	None
komponensekkel	None
permutációvá	Translative
faágra	Allative+On
dandárba	Allative+In
helyesíráshoz	Allative+At
thétára	Allative+On
dugják	None
felejteni	None
becsukták	None
legkedvezőbbek	Nominative
óceánhoz	Allative+At
mutatkoznak	None
csapatától	Ablative+At
olívabogyót	Accusative
székhelyeként	Formal
nyilatkozott	None
vélelmezett	None
hangszerelték	None
kormányozta	None
liturgia	Nominative
horgászzsinórnak	Dative
olajfestményeket	Accusative
piackutatással	None
csönddel	None
asztmáért	Purposive
hallucinációkkal	None
dologba	Allative+In
törvényről	Ablative+On
leltem	None
asszociálva	None
kezelőfelülettel	None
jegyezték	None
mentálisakért	Purposive
szerájokon	Essive+On
kálváriával	None
nászutaknak	Dative
szolgáltatását	Accusative
jelentkezővel	None
processzorokból	Ablative+In
parancsnokoknak	Dative
kijelentették	None
epicentrumtól	Ablative+At
készülőknek	Dative
akadálya	Nominative
nyafognánk	None
megtartásából	Ablative+In
előírásokkal	None
feloszlattak	None
tervétől	Ablative+At
szoftverekben	Essive+In
földnyelven	Essive+On
istenségtől	Ablative+At
verbuváltak	None
ellenségesnek	Dative
programozáshoz	Allative+At
visszahatnánk	None
milliméternél	At+Essive
pingvineknek	Dative
vezérigazgatóként	Formal
légmozgás	Nominative
fokozzatok	None
számosat	Accusative
szabadságharcosokkal	None
lehetőségeiről	Ablative+On
tehetségének	Dative
nagyították	None
projekttől	Ablative+At
igényének	Dative
szakítja	None
emelkedéssel	None
természettudományokra	Allative+On
ellenféltől	Ablative+At
paráznaságtól	Ablative+At
vigyázott	None
megsemmisített	None
sziklásak	Nominative
rekordokat	Accusative
szekeresnek	Dative
megfigyeléseket	Accusative
tévesnek	Dative
érdeklődéssel	None
adót	Accusative
megjelölés	Nominative
langyosakhoz	Allative+At
kinccsel	None
elmélettől	Ablative+At
kelet	Nominative
istenen	Essive+On
megfelelőbbeknek	Dative
doh	Nominative
lapkára	Allative+On
mintát	Accusative
tesztekre	Allative+On
nemiekké	Translative
zsűrivel	None
betűkből	Ablative+In
szponzorra	Allative+On
okról	Ablative+On
szereplővel	None
hivatalából	Ablative+In
jelnyelv	Nominative
hörcsögöt	Accusative
indulattal	None
bajnokit	Accusative
bagollyal	None
akaratától	Ablative+At
konfigurációk	Nominative
hatásait	Accusative
fáktól	Ablative+At
életmódok	Nominative
zöldkártyák	Nominative
érintetteket	Accusative
indiánokkal	None
iparosodást	Accusative
városnegyedekig	Terminative
öröméért	Purposive
harcsa	Nominative
beöltözni	None
ritka	Nominative
legjelentősebb	Nominative
foglalkozáson	Essive+On
akadályozná	None
határoktól	Ablative+At
kamrában	Essive+In
másodpercekre	Allative+On
másolaton	Essive+On
autójából	Ablative+In
érintőhöz	Allative+At
címszóra	Allative+On
császárpingvinekkel	None
gazdasági	Nominative
azonnalit	Accusative
egységesek	Nominative
időszerűvé	Translative
szemeszter	Nominative
likvidálják	None
márciusin	Essive+On
galériára	Allative+On
éjjeleken	Essive+On
illatszerboltokig	Terminative
ablakaiból	Ablative+In
stúdiók	Nominative
meghaljanak	None
tócsához	Allative+At
törvényekben	Essive+In
részleteiben	Essive+In
rajongásig	Terminative
képzelték	None
erőkön	Essive+On
szennyeződések	Nominative
rozsokba	Allative+In
gépészre	Allative+On
hőségtől	Ablative+At
kérdésből	Ablative+In
adáshoz	Allative+At
akadályozott	None
virágzatba	Allative+In
inverziót	Accusative
aranyhalból	Ablative+In
csalásokra	Allative+On
polgárokhoz	Allative+At
kerületért	Purposive
kötetére	Allative+On
csizmák	Nominative
zeneszerzőtől	Ablative+At
elismervényekre	Allative+On
álomról	Ablative+On
hógömbökbe	Allative+In
dalként	Formal
önrendelkezés	Nominative
novellából	Ablative+In
szerepekben	Essive+In
dzsungelnek	Dative
rúdban	Essive+In
felakasztani	None
radiáció	Nominative
békeszerződésekben	Essive+In
érdektelenek	Nominative
teljesítsük	None
darabokig	Terminative
tördeljetek	None
tágulnotok	None
előadótermet	Accusative
építményre	Allative+On
hozzájárulásért	Purposive
jogtulajdonosokig	Terminative
égboltot	Accusative
törekvésről	Ablative+On
dalánál	At+Essive
szoftverekhez	Allative+At
erejében	Essive+In
címezték	None
sértésekként	Formal
kötésekkel	None
sztrájk	Nominative
rakodómunkásként	Formal
tüzértől	Ablative+At
ürgéből	Ablative+In
bűnözésről	Ablative+On
segítségnyújtásra	Allative+On
gyújtással	None
bagolylepkék	Nominative
féltékenységgel	None
címlapjának	Dative
kottáról	Ablative+On
publikum	Nominative
nemkívánatossá	Translative
kiírnak	None
lábujjal	None
dohányra	Allative+On
gyűléseknek	Dative
miniszterelnökről	Ablative+On
fenyőkből	Ablative+In
restaurátor	Nominative
csekkeket	Accusative
észlelte	None
félholddal	None
szegénységről	Ablative+On
üdvözöljünk	None
koncentrációkat	Accusative
kórusokra	Allative+On
kielégítenie	None
időkapszulák	Nominative
vereségről	Ablative+On
átkoznom	None
árkokkal	None
kódnál	At+Essive
együttélésben	Essive+In
dobolás	Nominative
özvegyasszonyokra	Allative+On
egyikétől	Ablative+At
pandának	Dative
borotvált	None
családjánál	At+Essive
teremtőig	Terminative
előttivel	None
leggonoszabban	Essive+In
spárgatökök	Nominative
adminoknak	Dative
kocsisokba	Allative+In
mesterévé	Translative
hanyatlik	None
zúzzák	None
féltsük	None
hunyandó	None
emeléséért	Purposive
erősít	None
kapitulálnotok	None
favágóknál	At+Essive
molekulával	None
asszonyban	Essive+In
megtalál	None
féléven	Essive+On
szégyennek	Dative
megérdemelnék	None
apostolok	Nominative
fajának	Dative
szezámmaggal	None
esztétikában	Essive+In
vitázol	None
soroltuk	None
ellopja	None
megértéséhez	Allative+At
tartósítanak	None
kályhákra	Allative+On
víziókat	Accusative
kontrollon	Essive+On
analógiákat	Accusative
rasszizmusokat	Accusative
pisztáciát	Accusative
történészhez	Allative+At
véresen	Essive+On
alelnököt	Accusative
soroló	None
összeszedjétek	None
megerősítenie	None
megfosszam|	None
indítékokat	Accusative
lyukasztották	None
hipnózissal	None
kasztráltátok	None
újraparticionáltunk	None
összegyűjteniük	None
korrupciót	Accusative
csomagoláson	Essive+On
hangkártyákba	Allative+In
törmelékből	Ablative+In
babér	Nominative
távmunkában	Essive+In
matematikával	None
kiállítani	None
kritikusokkal	None
szerepéről	Ablative+On
megfigyelendő	None
beszédesről	Ablative+On
migrénekké	Translative
jellemzőitől	Ablative+At
meglátogatni	None
javasoltunk	None
fizetésemelést	Accusative
pirítósban	Essive+In
tanulniuk	None
leplekkel	None
katedrálisnak	Dative
velő	Nominative
differenciálgeometriában	Essive+In
tanácsolta	None
lakattal	None
terjengősnek	Dative
újságokban	Essive+In
civilizációkra	Allative+On
rámutatok	None
cselekménynek	Dative
sötétebbre	Allative+On
díjazta	None
törvényekből	Ablative+In
átír	None
megmutat	None
életszínvonal	Nominative
retekkel	None
irodával	None
tisztázná	None
vakok	Nominative
felületével	None
vizionálni	None
örvényben	Essive+In
impregnált	None
játékfilmeket	Accusative
feláldozzunk	None
pótlásával	None
településeknél	At+Essive
kiindulásként	Formal
csalódásokban	Essive+In
édességekben	Essive+In
indításoknál	At+Essive
egyszerűbbhöz	Allative+At
reményekre	Allative+On
átfogóbban	Essive+In
gondtalanság	Nominative
portával	None
asztallal	None
figyelmeztetnie	None
kisfiú	Nominative
szuperhatalomban	Essive+In
feláldozná	None
legalizálni	None
pezsgősig	Terminative
megérdemlek	None
fejlesztésekről	Ablative+On
testvérként	Formal
Árpád-sávokról	Ablative+On
vízilabdáztok	None
eszesekbe	Allative+In
gyémántról	Ablative+On
nyugtalanságot	Accusative
gyógynövények	Nominative
pusztákkal	None
hadgyakorlatban	Essive+In
tulajdonságáért	Purposive
bétát	Accusative
kompániaként	Formal
atyjánál	At+Essive
nevelésért	Purposive
komolyzenével	None
desztillálnak	None
programozót	Accusative
hiányolták	None
poggyászban	Essive+In
létesítmények	Nominative
vedelsz	None
sebességek	Nominative
óramutatóval	None
páriaként	Formal
kerékpárt	Accusative
cigiken	Essive+On
tárcákkal	None
utódra	Allative+On
visszaélést	Accusative
tagadva	None
iszony	Nominative
vajdáról	Ablative+On
sátorban	Essive+In
tócsákban	Essive+In
labdajátékot	Accusative
irídium	Nominative
gyalogságban	Essive+In
dolgaiban	Essive+In
iskolabuszból	Ablative+In
hadseregeknél	At+Essive
összeállítsd|or|	None
problémám	Nominative
ággal	None
magyarításnak	Dative
színdarabokkal	None
problémájának	Dative
gégéknek	Dative
polgármestere	Nominative
mézbe	Allative+In
centrifugák	Nominative
fókuszálunk	None
parkolóóra	Nominative
raklapoknak	Dative
alvással	None
blamálod	None
atyaként	Formal
hangszerelésben	Essive+In
csodálkozol	None
bevételek	Nominative
gödrök	Nominative
szervezetteket	Accusative
csomagoló	None
megossza	None
állapítva	None
megtevő	None
felállítottak	None
kockázatokra	Allative+On
azonosítanál	None
hajfestékekig	Terminative
rövidítettem	None
tapasztalatokon	Essive+On
eredményeire	Allative+On
joghatóság	Nominative
galériákban	Essive+In
barázdánál	At+Essive
bizonyítékokra	Allative+On
kréta	Nominative
elvesztéséről	Ablative+On
mérlegelnünk	None
végeknél	At+Essive
tolvajként	Formal
ágyazzák	None
kiváltak	None
írásnál	At+Essive
dalokat	Accusative
távmunkába	Allative+In
nikkelt	Accusative
megdorgáltuk	None
ruhájára	Allative+On
panorámaként	Formal
gyakorlással	None
objektumokról	Ablative+On
szimulációban	Essive+In
zokogás	Nominative
mennyiséghez	Allative+At
takarékos	Nominative
merüljön	None
hozzáadott	None
házakban	Essive+In
visszaéléssel	None
törne	None
tervben	Essive+In
vasútvonallal	None
tekercsben	Essive+In
kedveljenek	None
jegyzőkönyvekből	Ablative+In
határozatlanabb	Nominative
tudatlan	Nominative
bogáncsot	Accusative
zajosabbról	Ablative+On
gyűrűhöz	Allative+At
böjtre	Allative+On
történetnél	At+Essive
gyömbérrel	None
szponzor	Nominative
töltésén	Essive+On
tragédiaként	Formal
rovarcsípés	Nominative
csodaszépről	Ablative+On
helyben	Essive+In
családjáról	Ablative+On
hormonkészítménynek	Dative
évszakoknak	Dative
partvonallal	None
öblökbe	Allative+In
ruhájuknak	Dative
elképesztő	Nominative
cikké	Translative
felkérések	Nominative
isin	Essive+On
ludaknak	Dative
kijelentéssel	None
megszállások	Nominative
titkoltunk	None
megakadályozni	None
részletezz|or|	None
borzasztó	None
kalapáccsal	None
belügy	Nominative
városházára	Allative+On
stroke-okból	Ablative+In
lényegétől	Ablative+At
elődöket	Accusative
hajósoknak	Dative
bon	Nominative
hozzájárulásokat	Accusative
hirdették	None
edényekből	Ablative+In
esetekben	Essive+In
ujjára	Allative+On
elvárásaitól	Ablative+At
egészségre	Allative+On
kevésbe	Allative+In
cukorbetegséget	Accusative
nyitányban	Essive+In
lakosság	Nominative
erdőktől	Ablative+At
villanyórákként	Formal
tükörben	Essive+In
jövevénynek	Dative
partokig	Terminative
családtagként	Formal
béresek	Nominative
gödörre	Allative+On
tömegére	Allative+On
vasutakon	Essive+On
tartományokká	Translative
uborkával	None
köpönyegforgató	Nominative
burokba	Allative+In
vezérigazgatónak	Dative
agitáljunk	None
mineralológiákhoz	Allative+At
űrsiklón	Essive+On
potenciálisról	Ablative+On
vízben	Essive+In
részekkel	None
emelünk	None
álmokból	Ablative+In
gondolkodásból	Ablative+In
szakaszokba	Allative+In
bekövetkezőre	Allative+On
kutyaszánnal	None
átírva	None
tarkó	Nominative
lábszárak	Nominative
vajaznánk	None
fázisra	Allative+On
archívumot	Accusative
dogmához	Allative+At
dalszövegekhez	Allative+At
zsorzsetté	Translative
felállni	None
javítjuk	None
egyenruhákká	Translative
filozófustól	Ablative+At
csekk	Nominative
bútordarabokról	Ablative+On
gyógyszerhatástan	Nominative
vindikálta	None
épületekhez	Allative+At
pszichoanalízisben	Essive+In
legbátrabbak	Nominative
nevezzétek	None
gyorshajtásért	Purposive
négernek	Dative
ásványtannal	None
misztikába	Allative+In
szereplőivé	Translative
legokosabbakkal	None
formalizmust	Accusative
egyénekkel	None
csépelni	None
kedvelőknek	Dative
siker	Nominative
freskó	Nominative
háztartásban	Essive+In
kockáztató	None
protonokkal	None
nadrággal	None
gyarmathoz	Allative+At
elveszítetted	None
egykéket	Accusative
úrban	Essive+In
vagdalnod	None
torzítva	None
váltóáram	Nominative
sztrichninnel	None
dinnye	Nominative
stimulációkkal	None
piszkálnának	None
oratóriumot	Accusative
eldobtam|	None
lóversenypályán	Essive+On
felfogva	None
gasztronómiával	None
nargilé	Nominative
hangzanak	None
csengenie	None
letöltötte	None
csalánnal	None
termelésnek	Dative
statisztikáknak	Dative
elárulok	None
országba	Allative+In
feltételek	Nominative
protektorátusnak	Dative
keréknél	At+Essive
szeparáltam|	None
fejlődésregény	Nominative
drágállniuk	None
szórakozásban	Essive+In
papnők	Nominative
hintaszékért	Purposive
csigalépcsővel	None
nődögélnünk	None
hirdessük	None
vázlatot	Accusative
motor	Nominative
kerámiákon	Essive+On
hazaér	None
szívatnia	None
hengerekkel	None
borért	Purposive
leletektől	Ablative+At
urbanizációval	None
édesanyának	Dative
következményeinek	Dative
mellénnyel	None
hatványoztunk	None
kasztra	Allative+On
hallatszó	None
humornak	Dative
megvásárolta	None
festőművészeket	Accusative
felvarrták	None
illékony	Nominative
pletykáknak	Dative
választásánál	At+Essive
terapeutának	Dative
egereknél	At+Essive
kézilabdázott	None
jogszerűekből	Ablative+In
ültette	None
pszichológián	Essive+On
bekövetkezzen	None
kevéssel	None
elkülönítenie	None
gurít	None
leplet	Accusative
kapitalizmusoknak	Dative
beavatkozó	None
jelölnie	None
katódsugárcsövön	Essive+On
kutatómunkának	Dative
legihatatlanabbakra	Allative+On
régióhoz	Allative+At
nézetekből	Ablative+In
csendesnek	Dative
aeroszolokat	Accusative
becsukva	None
megkoronázták	None
úszott	None
zsákokba	Allative+In
céllövöldékként	Formal
eltávolítjuk	None
állatkerteket	Accusative
könyvjelzőkhöz	Allative+At
közüzemiig	Terminative
protonokról	Ablative+On
tragédiára	Allative+On
szereplőkkel	None
ágak	Nominative
mélységben	Essive+In
tönkretesznek	None
fúrtak	None
hidrolízissel	None
játékbolttá	Translative
dokumentációk	Nominative
antibiotikumokhoz	Allative+At
takarmányt	Accusative
becslésekre	Allative+On
órának	Dative
éjszakára	Allative+On
menedékben	Essive+In
gondolatából	Ablative+In
indukált	None
képességeiről	Ablative+On
ugróiskola	Nominative
postásautónak	Dative
örökkévalóságban	Essive+In
kivilágítás	Nominative
nemességen	Essive+On
elektromosakká	Translative
műveiből	Ablative+In
bátyjának	Dative
látogatókra	Allative+On
megszervezésig	Terminative
reprezentatívnak	Dative
rovatunkkal	None
lepedőre	Allative+On
könyvpiac	Nominative
felszínénél	At+Essive
eladnak	None
csonttá	Translative
vezír	Nominative
kanászt	Accusative
egyenruhát	Accusative
szalagokról	Ablative+On
éjszakáig	Terminative
lejátszóból	Ablative+In
megfejteném|	None
világbajnokságba	Allative+In
fűszertől	Ablative+At
kertjeitektől	Ablative+At
taxonómia	Nominative
kísérletekre	Allative+On
szabadesésben	Essive+In
mellébeszélek	None
világosabbra	Allative+On
anyanyelvűek	Nominative
órások	Nominative
országgyűlésnek	Dative
pelenkát	Accusative
legfrissebbekbe	Allative+In
városokból	Ablative+In
törvények	Nominative
feliratnak	Dative
előkészítéséért	Purposive
fokozatosról	Ablative+On
gomboknak	Dative
hangszóró	Nominative
üldözze	None
szűrők	Nominative
meglepetésre	Allative+On
színházakhoz	Allative+At
panaszkönyvétől	Ablative+At
tagállammal	None
értékekre	Allative+On
hárssal	None
nagyvárossá	Translative
disszonanciába	Allative+In
megtenne	None
végzettségnél	At+Essive
elvárásokkal	None
fotóinak	Dative
felvételekhez	Allative+At
meredeken	Essive+On
lezárnánk	None
válasszal	None
ecseteli	None
mentésekre	Allative+On
terápiára	Allative+On
rendes	Nominative
célnak	Dative
fergetegeseknek	Dative
jód	Nominative
esetéről	Ablative+On
gépekből	Ablative+In
horrorfilmet	Accusative
hivatáshoz	Allative+At
lényeghez	Allative+At
jobbakat	Accusative
gyűjtemények	Nominative
gyermekcsétől	Ablative+At
slágerként	Formal
ünneppel	None
geológiát	Accusative
kedveltek	Nominative
ritkábbá	Translative
összehasonlításokkal	None
tejesemberektől	Ablative+At
pincének	Dative
városokkal	None
gereblyével	None
interjúhoz	Allative+At
zsoldos	Nominative
apátságoknak	Dative
turizmusban	Essive+In
jogvédelemmel	None
javításán	Essive+On
filmrendezővel	None
pajtát	Accusative
dobosnak	Dative
szellemben	Essive+In
elmegyek	None
vibrálnak	None
fixálnátok	None
melléklettől	Ablative+At
stoppolásokig	Terminative
szolgáltatásokról	Ablative+On
faszén	Nominative
bulihoz	Allative+At
sávok	Nominative
nyilvánítottak	None
fizikára	Allative+On
elvárásoktól	Ablative+At
történethez	Allative+At
társalgó	None
támaszkodva	None
megállítja	None
eurónál	At+Essive
megnyitások	Nominative
társaságából	Ablative+In
társalognak	None
özvegyként	Formal
hercegnőből	Ablative+In
évfordulóra	Allative+On
újságcikkhez	Allative+At
úszásokért	Purposive
konszolidált	None
bemutatóján	Essive+On
beállítod	None
gátért	Purposive
megkoronáztad	None
hozzászólásaiddal	None
balhét	Accusative
tudományegyetemre	Allative+On
kebelbarátból	Ablative+In
hangmérnökökön	Essive+On
varrás	Nominative
kaszt	Nominative
képeznék	None
érsekhez	Allative+At
beírt	None
kalandorokig	Terminative
restaurálást	Accusative
szerencsétlennek	Dative
kupához	Allative+At
zsámolyt	Accusative
szolgája	Nominative
építkezéseknél	At+Essive
álcázott	None
trikóért	Purposive
keltenie	None
csábultok	None
cintányérokkal	None
feltűnővé	Translative
szakterülete	Nominative
szerencsém	Nominative
tályoggal	None
legeltetik	None
fémből	Ablative+In
folyóiratokra	Allative+On
csattanót	Accusative
sorolandó	None
egységen	Essive+On
lakóival	None
szavaihoz	Allative+At
megérkezünk	None
ékszerészeken	Essive+On
titkaival	None
betétszámlákig	Terminative
kölcsönös	Nominative
zsebtolvajokkal	None
eltolást	Accusative
súlyára	Allative+On
mellékleten	Essive+On
csinálnak	None
kútnak	Dative
megköszönjük	None
életveszélyesen	Essive+On
sajtómágnásokon	Essive+On
változtatásokba	Allative+In
felkészítve	None
hangzással	None
nagyvárosokba	Allative+In
bárgyúságoknál	At+Essive
hangszer	Nominative
terelgetni	None
stimmelt	None
szárról	Ablative+On
véleményektől	Ablative+At
antropológusokká	Translative
haláig	Terminative
felső	Nominative
RAM	Nominative
szegecs	Nominative
szerkesztőként	Formal
izzólámpát	Accusative
rabszolgákat	Accusative
ételintolerancia	Nominative
munkát	Accusative
képességekről	Ablative+On
síel	None
gyűrűkhöz	Allative+At
eredményezni	None
államfőtől	Ablative+At
kávézókban	Essive+In
felcserek	Nominative
végrendelkezned	None
sértik	None
öltözetek	Nominative
novellákban	Essive+In
föderációval	None
túlzó	None
fogót	Accusative
kapuját	Accusative
döntéséről	Ablative+On
megelőzték	None
nyíráson	Essive+On
zoológussal	None
tételen	Essive+On
bölényekre	Allative+On
gyümölcshúst	Accusative
megjelenítésével	None
helyeként	Formal
újsághoz	Allative+At
mamának	Dative
levertük	None
szülővárosban	Essive+In
párnak	Dative
alakú	Nominative
főszereplővé	Translative
rendjén	Essive+On
összekössék	None
bivalyon	Essive+On
falaiból	Ablative+In
gyógyszerészek	Nominative
minősítésről	Ablative+On
igények	Nominative
szikláknál	At+Essive
oroszlánként	Formal
meghajtóra	Allative+On
részesedéséből	Ablative+In
szopjanak	None
baki	Nominative
kinéztem	None
kurzusnak	Dative
Velencével	None
vízesésbe	Allative+In
árának	Dative
felületekhez	Allative+At
kalciummal	None
üveghez	Allative+At
atyjával	None
vasvilláig	Terminative
másolatának	Dative
cobolyhoz	Allative+At
vitázott	None
bosszúért	Purposive
egészségesek	Nominative
prímnek	Dative
osztaghoz	Allative+At
egyszerűbbet	Accusative
udvariasnak	Dative
megnehezítik	None
ünnephez	Allative+At
doktorként	Formal
ügyfeleket	Accusative
felelősségtudat	Nominative
pereputtyból	Ablative+In
agitáljatok	None
parlamentből	Ablative+In
sivatagtól	Ablative+At
vitorlásról	Ablative+On
betéve	None
irtásokon	Essive+On
beállítanom	None
konyhaművészetekként	Formal
félévtől	Ablative+At
brácsákról	Ablative+On
ellenálláshoz	Allative+At
robotosokká	Translative
határidőt	Accusative
kiegészítésekkel	None
problémáidat	Accusative
pusztították	None
prémnek	Dative
kívánatosak	Nominative
lemondjon	None
függőlegessé	Translative
menekülteket	Accusative
ügyészségen	Essive+On
nyelvűvé	Translative
tevékenységén	Essive+On
biztosítókkal	None
szolidaritást	Accusative
nyilasokat	Accusative
kefével	None
emeletnek	Dative
együtteseket	Accusative
összeesküvésre	Allative+On
félreértésekhez	Allative+At
hangoktól	Ablative+At
lukat	Accusative
piacokat	Accusative
termékenységgel	None
prezentációk	Nominative
mezek	Nominative
terhelni	None
domboldalak	Nominative
adócsalásra	Allative+On
készülőben	Essive+In
termékenység	Nominative
zongoristának	Dative
hadaknak	Dative
öregekkel	None
csecsenektől	Ablative+At
állományához	Allative+At
kifinomultak	Nominative
kereskedés	Nominative
egerekben	Essive+In
szakterülethez	Allative+At
meditáció	Nominative
körülményekről	Ablative+On
megkérdezed	None
hamisítás	Nominative
társaságokra	Allative+On
állítólagos	Nominative
kristályosak	Nominative
szabadkőművesnek	Dative
utolért	None
okosnál	At+Essive
gépelt	None
tanítványukra	Allative+On
adottságnak	Dative
traktortól	Ablative+At
vázak	Nominative
válla	Nominative
észleltem	None
felriadt	None
szolgáltatásai	Nominative
tréningruhával	None
sikerévé	Translative
teszteléssel	None
dátumra	Allative+On
kilométerek	Nominative
kibővítsetek	None
hangszereléseket	Accusative
felújításával	None
továbbfejlesztve	None
indexelni	None
elmélkedett	None
lelet	Nominative
operáció	Nominative
összezsugorítaniuk	None
mérete	Nominative
birtokolnák	None
bibliográfiák	Nominative
hajat	Accusative
szériát	Accusative
porban	Essive+In
oxigén	Nominative
zongorapadba	Allative+In
albumát	Accusative
cifrához	Allative+At
súrlódással	None
határnak	Dative
felszabadítják	None
köztársaságokkal	None
beadja	None
dzsentrikkel	None
processzorhoz	Allative+At
hivatalokká	Translative
díszek	Nominative
posztmodern	Nominative
olimpiákra	Allative+On
kísérnek	None
otkolonokig	Terminative
töltéséről	Ablative+On
garantíroznánk	None
újságírók	Nominative
anyósoktól	Ablative+At
pacsirtát	Accusative
hírnévnek	Dative
paneleken	Essive+On
fontosságot	Accusative
desszertekhez	Allative+At
országgá	Translative
öngyilkosságok	Nominative
illesztenek	None
hozzáállásnak	Dative
védelemre	Allative+On
támadást	Accusative
festőnél	At+Essive
megnyitod	None
részért	Purposive
személyneveknél	At+Essive
látványosnak	Dative
tavaszok	Nominative
végbélbe	Allative+In
dimenziókat	Accusative
csábítva	None
törekedett	None
módnak	Dative
tételek	Nominative
frissítek	None
hadseregeket	Accusative
lakóházakat	Accusative
portfólióktól	Ablative+At
nézelődik	None
adásban	Essive+In
magmák	Nominative
barátságba	Allative+In
fordításokra	Allative+On
kérdezzék	None
versenyeknél	At+Essive
kalandokból	Ablative+In
intellektuálisaknak	Dative
webböngésző	Nominative
nímandként	Formal
parlamenterekből	Ablative+In
hormonkészítményre	Allative+On
lakjanak	None
gömbbe	Allative+In
megrendelőt	Accusative
elfogadhatóvá	Translative
jogával	None
átnézted	None
viselkedéseken	Essive+On
őröltök	None
történetíróhoz	Allative+At
majommal	None
feltételeként	Formal
szerkezeteknek	Dative
valósnál	At+Essive
ligatúrák	Nominative
fajtákhoz	Allative+At
bíróként	Formal
sporthírekig	Terminative
sátrakat	Accusative
szabályozásáért	Purposive
prózát	Accusative
híveiként	Formal
túloztam	None
kocsmából	Ablative+In
állandónak	Dative
folyadékokkal	None
győzelemként	Formal
megengeded	None
merényletben	Essive+In
kancsalság	Nominative
megmaradnia	None
csendőrségnek	Dative
nyomozóknak	Dative
gépjárművet	Accusative
elfelejtették	None
modellen	Essive+On
telepesekkel	None
megérdemelte	None
munkálatokon	Essive+On
kiszabaduljon	None
összege	Nominative
fájlt	Accusative
felhasználóknak	Dative
favágók	Nominative
sahot	Accusative
sorakoznak	None
varázsos	Nominative
civilizációról	Ablative+On
kajakoknak	Dative
amerikaival	None
fociztak	None
szfinxek	Nominative
újak	Nominative
komfortos	Nominative
nyersanyagot	Accusative
teljesítése	Nominative
lejárt	None
magnéziumoknál	At+Essive
gulyával	None
liberalizációt	Accusative
döntésekhez	Allative+At
soraiba	Allative+In
lelkesít	None
szervezetüket	Accusative
hurcolj|or|	None
turbinák	Nominative
robbanásokkal	None
cárt	Accusative
dioptriával	None
őröket	Accusative
szempontjai	Nominative
kozmetikázó	None
fércnek	Dative
sovinizmusokba	Allative+In
gőzöket	Accusative
diadalért	Purposive
betekintésekre	Allative+On
tükrét	Accusative
munkáról	Ablative+On
kernelek	Nominative
vonzás	Nominative
atommagokat	Accusative
hegyfokra	Allative+On
tanulság	Nominative
kiadnak	None
marokkóiakat	Accusative
készülékről	Ablative+On
expozícióval	None
magyaráz	None
gyatrán	Essive+On
apostoloknak	Dative
trónnal	None
görbültek	None
tehénként	Formal
lyukasztanotok	None
ribancnak	Dative
eljuttatjuk	None
rámutatott	None
naplókat	Accusative
ruhánk	Nominative
vádnak	Dative
haszon	Nominative
magánszemélyeknek	Dative
eltűnj|or|	None
ispánhoz	Allative+At
csillapító	None
hivatkoznom	None
sokszögnek	Dative
pálmaként	Formal
leggazdagabbakra	Allative+On
tízparancsolatban	Essive+In
bölcsőtől	Ablative+At
építészethez	Allative+At
pinceként	Formal
kiegészítésekre	Allative+On
megtaláljuk	None
üstökösben	Essive+In
intelligenciahányadosok	Nominative
antikváriumban	Essive+In
drótból	Ablative+In
bakókba	Allative+In
mitológiák	Nominative
képtárnak	Dative
dialektusra	Allative+On
elvesztésének	Dative
erdőnek	Dative
világított	None
vastagodó	None
szimmetriára	Allative+On
szabadidőseknél	At+Essive
naptárnál	At+Essive
vonzottátok	None
házassághoz	Allative+At
munkásig	Terminative
zászlóvivőkben	Essive+In
ragasztja	None
zarándokoltak	None
értelemre	Allative+On
kánnak	Dative
vasútállomásig	Terminative
előállítsák	None
böjtöltek	None
nyitvatermőknél	At+Essive
ürességtől	Ablative+At
bekezdését	Accusative
kakasok	Nominative
legkimondhatatlanabbnál	At+Essive
obszervatóriumok	Nominative
pillangóúszásokból	Ablative+In
feláldozzák	None
jogorvoslatiakon	Essive+On
szerelőknek	Dative
arisztokráciáról	Ablative+On
ezüstéremig	Terminative
fentinél	At+Essive
központjának	Dative
rasszizmusra	Allative+On
bevezetéseként	Formal
építkezésbe	Allative+In
épületekben	Essive+In
jegesmedvék	Nominative
reménytelenekből	Ablative+In
megjelentető	None
egyház	Nominative
szexepileket	Accusative
fektetnie	None
cseresznyék	Nominative
egyenletesen	Essive+On
vélte	None
ágyások	Nominative
átalakuláson	Essive+On
belsejével	None
elképzelnünk	None
vonzóbbá	Translative
zacskóhoz	Allative+At
vitatta	None
módosítástól	Ablative+At
névtanokon	Essive+On
gyógyfürdőhöz	Allative+At
elvégezd|or|	None
tüzérnek	Dative
betűnél	At+Essive
ebédelni	None
jelenségekből	Ablative+In
készülékekbe	Allative+In
versenyben	Essive+In
tudományosabbért	Purposive
forradalomba	Allative+In
értékéről	Ablative+On
programokat	Accusative
sértésnek	Dative
megteremtsetek	None
fiatalabbal	None
üzemanyagokban	Essive+In
virágról	Ablative+On
csengenek	None
leadandó	None
létrejöjjenek	None
beköltözik	None
órára	Allative+On
fúrva	None
berendezéseket	Accusative
áradásoknak	Dative
kezdeményezzen	None
békés	Nominative
kenyéren	Essive+On
zagyvának	Dative
újratemetést	Accusative
hajba	Allative+In
előz	None
szabályzatból	Ablative+In
fürtökben	Essive+In
mustárgázokat	Accusative
galagonya	Nominative
bázisokkal	None
csapatként	Formal
birodalom	Nominative
zarándokok	Nominative
létesítésére	Allative+On
harckocsikat	Accusative
hüvelyből	Ablative+In
ürmösbort	Accusative
hadihajón	Essive+On
szomszédosért	Purposive
sóbányákat	Accusative
felkiáltójeleket	Accusative
köziek	Nominative
zuhant	None
cirkuszt	Accusative
hírlapban	Essive+In
izzadságba	Allative+In
bináristól	Ablative+At
khmerre	Allative+On
robotoló	None
meccs	Nominative
műsorán	Essive+On
csatlakozásokat	Accusative
kétdimenziós	Nominative
észlelnie	None
tanulnod	None
oldalként	Formal
igyanak	None
zsoldokként	Formal
dobálják	None
üldögélve	None
menekülésbe	Allative+In
tanyák	Nominative
módjával	None
könyvesboltokat	Accusative
úthoz	Allative+At
fordításából	Ablative+In
forrásaként	Formal
kókuszolaj	Nominative
vívásba	Allative+In
vállába	Allative+In
szaxofonokra	Allative+On
kereteknek	Dative
legeltetnénk	None
tudományokon	Essive+On
községről	Ablative+On
félreértés	Nominative
szennyezte	None
alijázzunk	None
ládával	None
területétől	Ablative+At
pandáig	Terminative
kifutópályákká	Translative
kifejlesztendő	None
repülőgépekre	Allative+On
érzéseket	Accusative
beszédében	Essive+In
kételkedésektől	Ablative+At
többletek	Nominative
szakmányért	Purposive
fegyvereknél	At+Essive
betörőbe	Allative+In
ébenfát	Accusative
feldobott	None
asszisztens	Nominative
fluktuációt	Accusative
akadozni	None
váciak	Nominative
kávéért	Purposive
esély	Nominative
aranyéremig	Terminative
fülük	Nominative
nábobokból	Ablative+In
padlás	Nominative
megbeszélendő	None
cukrozva	None
aligátor	Nominative
burnótokká	Translative
részecskére	Allative+On
Magyarországgal	None
múzsáról	Ablative+On
lemondana	None
büfék	Nominative
állapotokban	Essive+In
logisztika	Nominative
épületről	Ablative+On
csokiba	Allative+In
összekenné	None
bajnokokba	Allative+In
figyelniük	None
pályaudvarrá	Translative
rozsomáknak	Dative
honvédelemért	Purposive
pillangóúszást	Accusative
elárultak	None
boltkóros	Nominative
képességnek	Dative
háztartás	Nominative
képektől	Ablative+At
egyszemélyes	Nominative
remetelakokig	Terminative
vetélkedett	None
megvásároltad	None
helyiséget	Accusative
telefonszámon	Essive+On
előállításánál	At+Essive
elismeréseket	Accusative
eutanáziáról	Ablative+On
munkám	Nominative
kérvény	Nominative
elrendezni	None
területre	Allative+On
szavazást	Accusative
antilopokat	Accusative
Napnak	Dative
savak	Nominative
testvériség	Nominative
kizártuk	None
címszavainkkal	None
udvarába	Allative+In
gyíkokat	Accusative
elvégzése	Nominative
feltűnőbe	Allative+In
festőművészekkel	None
vízimadarak	Nominative
mátrixszal	None
összetettet	Accusative
támadáshoz	Allative+At
finomabbig	Terminative
összefogásról	Ablative+On
rendellenes	Nominative
rockegyüttes	Nominative
vetületet	Accusative
pontosabban	Essive+In
társadalmaknak	Dative
körüliek	Nominative
falaz	None
emlőbimbónak	Dative
településeken	Essive+On
idegrendszerrel	None
részem	Nominative
gepárdokat	Accusative
provokációkra	Allative+On
deltával	None
stadionnal	None
időszerűekhez	Allative+At
természet	Nominative
költeménnyel	None
rakparttal	None
előszóban	Essive+In
dagályt	Accusative
heringen	Essive+On
vonathoz	Allative+At
pocsolyákon	Essive+On
sorozatának	Dative
böhöm	Nominative
elhagynia	None
hősével	None
tudásoknál	At+Essive
tanácson	Essive+On
szerzéssé	Translative
szemölcsökkel	None
anyagába	Allative+In
érzelmekként	Formal
mulatok	None
recseg	None
napijegyet	Accusative
talpakat	Accusative
összejövetelek	Nominative
zsibbadtak	None
mormoták	Nominative
papiruszok	Nominative
tálcánál	At+Essive
városházákban	Essive+In
cigányasszonyoktól	Ablative+At
munkásságán	Essive+On
irat	Nominative
vacsoráztok	None
korlátozástól	Ablative+At
tojásrántottáknál	At+Essive
nagyságokba	Allative+In
allergiásra	Allative+On
hierarchia	Nominative
próbálkoztatok	None
hazamentem	None
információra	Allative+On
vigasztalna	None
nyakfodorral	None
irtás	Nominative
toborozva	None
fehérje	Nominative
helységtől	Ablative+At
eseményével	None
futással	None
tempóban	Essive+In
emésztőrendszerben	Essive+In
következtetnem	None
emotikonok	Nominative
fociból	Ablative+In
küzdelmekben	Essive+In
brigantikra	Allative+On
betenné	None
vágytól	Ablative+At
akácokat	Accusative
napfordulóként	Formal
fosztogatnának	None
pillanatig	Terminative
csúcsokból	Ablative+In
derűvel	None
előállításnak	Dative
pennát	Accusative
öregasszonynak	Dative
élelmiszereken	Essive+On
politikák	Nominative
közép	Nominative
géniusznak	Dative
matrózt	Accusative
margókért	Purposive
régióktól	Ablative+At
tervezésen	Essive+On
kápolnától	Ablative+At
gyártmány	Nominative
genetikában	Essive+In
sapkában	Essive+In
alacsonyabbá	Translative
bemutatóját	Accusative
érvényességet	Accusative
emigrációhoz	Allative+At
rágalmazásokká	Translative
emlékeztetünk	None
számlálták	None
rétegtől	Ablative+At
lektorálva	None
elintézték	None
különb	Nominative
felel	None
kötőnek	Dative
realitások	Nominative
logikákban	Essive+In
csukló	Nominative
korszerűsítésre	Allative+On
gond	Nominative
felkérniük	None
szöghöz	Allative+At
fővárosból	Ablative+In
edzésre	Allative+On
gyóntuk	None
elméletekhez	Allative+At
támaszt	Accusative
üzentem	None
dutyi	Nominative
előírták	None
tekinthetők	Nominative
döfték	None
délibbeket	Accusative
kampányolnák	None
eltávolítsa	None
bekövetkezőnél	At+Essive
támaszkodott	None
rajongóból	Ablative+In
felhívással	None
ünnepén	Essive+On
ebédelt	None
főiskolával	None
társulatok	Nominative
pészah	Nominative
templomoknál	At+Essive
közléseknél	At+Essive
felhasználóról	Ablative+On
kiegészítőkkel	None
járulékok	Nominative
lemosó	None
meggyőződéstől	Ablative+At
kormányozok	None
csinálnom	None
gordonkára	Allative+On
nagydíjtól	Ablative+At
maradékkal	None
javulással	None
fotózásnál	At+Essive
szándékról	Ablative+On
klinikának	Dative
szakítaniuk	None
szavazva	None
közelednek	None
településeket	Accusative
helyszínekre	Allative+On
bírunk	None
összeszednek	None
pályaudvarnak	Dative
bátyát	Accusative
húzódni	None
előkészítse	None
biliárdot	Accusative
nemzésekhez	Allative+At
igazságokat	Accusative
sebességhez	Allative+At
blogon	Essive+On
értés	Nominative
takarózni	None
vezetőségtől	Ablative+At
bizonytalanságtól	Ablative+At
alkoholostól	Ablative+At
dokumentálják	None
felhasználásról	Ablative+On
villámcsapás	Nominative
menedzsereknek	Dative
átkokra	Allative+On
adóznia	None
bemutatójaként	Formal
szellemmel	None
kenyérről	Ablative+On
különbségre	Allative+On
augusztusiakig	Terminative
üdvözlök	None
kivitelezést	Accusative
váltásokat	Accusative
plakáttal	None
repetálnának	None
terhelés	Nominative
zsákmányokat	Accusative
megszámlálhatótól	Ablative+At
elkerülésének	Dative
kodifikálunk	None
hagyományában	Essive+In
kutatóközpontok	Nominative
pályázatokkal	None
legalacsonyabb	Nominative
sivatagig	Terminative
megközelít	None
kapujáról	Ablative+On
meghajtón	Essive+On
lelkiismeretet	Accusative
kitiltották	None
lisztben	Essive+In
bombából	Ablative+In
megkapott	None
egyesületek	Nominative
kosárrá	Translative
fejlesztette	None
tanácskozásról	Ablative+On
távírászok	Nominative
komplikációt	Accusative
számla	Nominative
egyetlenként	Formal
hagyományaitól	Ablative+At
vetkőztetve	None
bevezette	None
lapátoló	None
rekviráló	None
súrlódás	Nominative
magatartásra	Allative+On
fagypontokért	Purposive
vízilabdát	Accusative
bandáknak	Dative
csillagokhoz	Allative+At
célozni	None
zsibbadj|or|	None
csapattársnak	Dative
szolgáltatónál	At+Essive
sikertelenekbe	Allative+In
cenzúrázzák	None
nyilatkozta	None
csatornában	Essive+In
segítés	Nominative
holnapot	Accusative
tartóztatva	None
szörnytől	Ablative+At
elnevezésről	Ablative+On
királytól	Ablative+At
naprendszerben	Essive+In
részéről	Ablative+On
megállapításokkal	None
növényhez	Allative+At
blöff	Nominative
babérokat	Accusative
szignifikáns	Nominative
termésre	Allative+On
visszaéléseket	Accusative
delták	Nominative
hasznosítva	None
igényébe	Allative+In
demoralizáltátok	None
idea	Nominative
tengelyként	Formal
folyamatokban	Essive+In
karakterre	Allative+On
zsandár	Nominative
hobbinak	Dative
elkerülés	Nominative
használtatnak	None
lassítottak	None
visszafogottnak	Dative
hentes	Nominative
nyelvbe	Allative+In
keresztnévhez	Allative+At
kigúnyolt	None
cicák	Nominative
megsérülő	None
tantuszokból	Ablative+In
delfinek	Nominative
kiadásoknál	At+Essive
gépfegyvert	Accusative
vérszagból	Ablative+In
virágzatokba	Allative+In
kormányok	Nominative
kubizmushoz	Allative+At
kollégiumokat	Accusative
honiig	Terminative
hazamenni	None
bejegyeznek	None
végezzék	None
határozott	Nominative
becsülettel	None
befektető	Nominative
magasugrást	Accusative
alapúak	Nominative
hordárok	Nominative
bombázásokra	Allative+On
indigó	Nominative
szállító	Nominative
kamerába	Allative+In
hordozni	None
világháborúknál	At+Essive
megnéztünk	None
területfejlesztésből	Ablative+In
felbontásra	Allative+On
füvet	Accusative
ideológiától	Ablative+At
húsvéttól	Ablative+At
térdreflexekre	Allative+On
földgázzá	Translative
tealevél	Nominative
jelképpel	None
mellkasba	Allative+In
rövidíteni	None
átadtam	None
salátaöntetekből	Ablative+In
kapcsok	Nominative
tananyaghoz	Allative+At
ígéri	None
üvegházat	Accusative
szakképesítések	Nominative
figyelőlistákig	Terminative
gótikus	Nominative
vakolatok	Nominative
tanévvel	None
titkárként	Formal
kiegészítenek	None
méteren	Essive+On
bővebb	Nominative
nyomozzanak	None
biztosítókba	Allative+In
feltárva	None
tűrünk	None
platformok	Nominative
gyanún	Essive+On
másolatban	Essive+In
időbeosztásokról	Ablative+On
franciának	Dative
erdőig	Terminative
fűtőnek	Dative
könyvespolcban	Essive+In
alkalmasabbakról	Ablative+On
résztvevőkként	Formal
befektetőket	Accusative
pascalokról	Ablative+On
legolcsóbbakba	Allative+In
megígérte	None
nagypapáért	Purposive
mélypontot	Accusative
páncélautókként	Formal
feszültön	Essive+On
felszínén	Essive+On
szavaira	Allative+On
kiskereskedelmi	Nominative
hőt	Accusative
megkoronáznék	None
adminisztrátort	Accusative
frissítésig	Terminative
basáskodnék	None
adatomból	Ablative+In
merevlemezig	Terminative
hápogsz	None
szolgák	Nominative
összehívják	None
szemüvegen	Essive+On
spóroltak	None
hódolnak	None
belebeszélném|	None
letöltendő	None
tövisek	Nominative
hiúz	Nominative
repülőgépgyárnál	At+Essive
összehívott	None
fejtsétek	None
kottaállványból	Ablative+In
esernyő	Nominative
szuronnyal	None
úttörő	Nominative
stadionokkal	None
vonalzóig	Terminative
csillagtökhöz	Allative+At
gemkapocsként	Formal
csoportja	Nominative
panorámás	Nominative
határoltak	None
toborzott	None
fűtötték	None
gyógyszerkönyv	Nominative
ellenőriztük	None
visszajelzések	Nominative
lassul	None
szomorúsággal	None
létrehoznia	None
irányítottak	None
felsorolandó	None
uránként	Formal
büntetésekkel	None
módosításoktól	Ablative+At
szamócára	Allative+On
megérkezett	None
kipróbáltak	None
vérebbel	None
szobrot	Accusative
pixelekből	Ablative+In
zsongtatok	None
nadragulya	Nominative
beépíti	None
kísérleteztem	None
volánok	Nominative
hozzáteszik	None
háttérzenét	Accusative
szabályozására	Allative+On
bánnia	None
tartományokra	Allative+On
gekkók	Nominative
visszavonja	None
hozzáadta	None
gyászok	Nominative
fenékké	Translative
vakságban	Essive+In
haragnál	At+Essive
árny	Nominative
regényeiről	Ablative+On
katolikussal	None
golfozni	None
perekkel	None
fegyverzetek	Nominative
tárgyiba	Allative+In
pápában	Essive+In
konstrukciónál	At+Essive
könyvesboltokban	Essive+In
gátnál	At+Essive
valóságról	Ablative+On
szarka	Nominative
istállókkal	None
súlyának	Dative
vektoroknak	Dative
megverni	None
tűzfallal	None
pirosba	Allative+In
dolgainkként	Formal
fázisként	Formal
tört	None
elmozdítottad	None
átfog	None
kígyóként	Formal
szállal	None
feszítsen	None
barátságra	Allative+On
pajzsokig	Terminative
koffein	Nominative
képzőművészetnek	Dative
őrtől	Ablative+At
napilapokban	Essive+In
polinomoknak	Dative
aktuális	Nominative
osztozni	None
fegyverszünet	Nominative
megvalósítja	None
telefonkártyáig	Terminative
megbocsátjátok	None
lepedőn	Essive+On
szinkronizálták	None
pontjával	None
felfedezésekhez	Allative+At
nyílt	Nominative
minisztériumhoz	Allative+At
hangversenyen	Essive+On
eperfákba	Allative+In
nyomozásban	Essive+In
Linuxszal	None
átalakulásnak	Dative
övekhez	Allative+At
szimulátorok	Nominative
ellenőrzésének	Dative
törlésének	Dative
mocsarat	Accusative
anyával	None
száradni	None
befolyok	None
kezelt	None
sütöttetek	None
házikacsákként	Formal
atyától	Ablative+At
hangjegyeket	Accusative
ágyából	Ablative+In
kísértés	Nominative
képesítésin	Essive+On
ütembe	Allative+In
despotának	Dative
tárcsázza	None
tesztelte	None
kommunikáljatok	None
vállakat	Accusative
tajgát	Accusative
jogviszonyokat	Accusative
boldogtalanok	Nominative
küzdelmekről	Ablative+On
beteges	Nominative
ebédlő	Nominative
kancsalságtól	Ablative+At
termékismertetőknek	Dative
kaputól	Ablative+At
megosztja	None
tökéletesítettek	None
gondozásra	Allative+On
napjánál	At+Essive
rendelkezést	Accusative
előállításhoz	Allative+At
utasításhoz	Allative+At
kanaszta	Nominative
körettel	None
nyomtatásról	Ablative+On
megjelenéshez	Allative+At
elválik	None
fékeken	Essive+On
fellépések	Nominative
privatizációkban	Essive+In
közvetítenék	None
tűzijátékot	Accusative
lefordítanak	None
ördögi	Nominative
válaszként	Formal
békeegyezmény	Nominative
küldöttből	Ablative+In
körülnézve	None
megöregedni	None
megerősít	None
elszigeteltség	Nominative
fegyverzetnek	Dative
szívinfarktusokban	Essive+In
cserbenhagyott	None
járásokkal	None
ringatja	None
átmeneteket	Accusative
illetékesség	Nominative
zenekarba	Allative+In
nagykövetségen	Essive+On
rabbiról	Ablative+On
ékkel	None
szünetekkel	None
gátlókkal	None
jutalomról	Ablative+On
viszketéseknek	Dative
kérelmezők	Nominative
keményítővel	None
légtornászok	Nominative
fellegekbe	Allative+In
eszményekhez	Allative+At
javítottad	None
szálba	Allative+In
prostituáltról	Ablative+On
együttélésről	Ablative+On
költőnővel	None
oldalsóig	Terminative
leverve	None
dolgoknál	At+Essive
koreográfiára	Allative+On
objektumoknak	Dative
térképészetben	Essive+In
csempészi	None
völgyig	Terminative
szószékről	Ablative+On
eltéved	None
fermentált	None
vállalatok	Nominative
fogóként	Formal
cselédnek	Dative
forrásvíz	Nominative
egyszerűbbnek	Dative
tesztnél	At+Essive
kolostortól	Ablative+At
víziszonyban	Essive+In
szügy	Nominative
fejdíszekké	Translative
könyörögni	None
disztribúcióban	Essive+In
banditákat	Accusative
elvenniük	None
támadják	None
kupolák	Nominative
csatornákon	Essive+On
négyszög	Nominative
bevándorlóval	None
vívjon	None
unalommal	None
társalgásokban	Essive+In
felszíntől	Ablative+At
státusszimbólumokhoz	Allative+At
középsőre	Allative+On
elrendelt	None
uralmához	Allative+At
sarlósfecskéknél	At+Essive
számelméletből	Ablative+In
korhatárral	None
társnak	Dative
varázsolt	None
biológia	Nominative
lábnyomokat	Accusative
üdvözlünk	None
fűződnek	None
mozdulatra	Allative+On
evetnek	Dative
üzemanyagot	Accusative
grófoknál	At+Essive
államosítás	Nominative
gravitációs	Nominative
levéltárakban	Essive+In
ártja	None
temetnek	None
megerősítést	Accusative
visszalépő	None
népéről	Ablative+On
gyöngyökből	Ablative+In
rendben	Essive+In
szüzek	Nominative
igénylő	None
következtetést	Accusative
zabál	None
adóval	None
tükörre	Allative+On
ajánlólevéllel	None
vám	Nominative
szintetizálták	None
gömbnek	Dative
áttekinti	None
párból	Ablative+In
összegezve	None
adott	Nominative
pisztolyhoz	Allative+At
átnézné	None
filmekhez	Allative+At
individualizmusból	Ablative+In
megjutalmazzák	None
folttal	None
megcsinálnak	None
atommagból	Ablative+In
savanyúságot	Accusative
gyilkossá	Translative
irányulni	None
köpennyel	None
napokról	Ablative+On
házánál	At+Essive
gyapot	Nominative
agitációval	None
beszédének	Dative
kiegészítésben	Essive+In
betűből	Ablative+In
interpretációkban	Essive+In
meccsekre	Allative+On
harmóniák	Nominative
illeszkedni	None
pusztítsa	None
vonalakról	Ablative+On
fotóalbumok	Nominative
megértsek	None
vénnek	Dative
tanúsítja	None
invitál	None
századtól	Ablative+At
almot	Accusative
mártíromságoknak	Dative
padokon	Essive+On
megállva	None
jövedelemre	Allative+On
ügyészségben	Essive+In
elbeszélésen	Essive+On
madarászokba	Allative+In
élvezettel	None
mátrixot	Accusative
megöregedett	None
laktak	None
abortuszért	Purposive
csuklóig	Terminative
nyomtatványokon	Essive+On
szerválna	None
ugatásokra	Allative+On
daganatot	Accusative
redukálva	None
észlelésre	Allative+On
ellenmérgekkel	None
egyenjogúságot	Accusative
szerkesztenéd	None
fába	Allative+In
lakatossá	Translative
hangulathoz	Allative+At
politikában	Essive+In
kamrákra	Allative+On
folyóirathoz	Allative+At
rohamokban	Essive+In
hadról	Ablative+On
dobajokat	Accusative
ivóvizek	Nominative
fürdőknek	Dative
ektoplazmáért	Purposive
tanúsították	None
akadémiánál	At+Essive
furcsákért	Purposive
szervezetét	Accusative
kéziraton	Essive+On
belvíztanokká	Translative
csatánál	At+Essive
rávette	None
sráccal	None
ajánlatkérők	Nominative
félreérti	None
költségvetésből	Ablative+In
zenekarnál	At+Essive
eltávolítod	None
személyeken	Essive+On
berakással	None
alkáli	Nominative
vezetőjét	Accusative
megrendeléssel	None
mozdulni	None
elméletéről	Ablative+On
nagyvonalúak	Nominative
maketten	Essive+On
épületfát	Accusative
értékeléséhez	Allative+At
parányi	Nominative
világossal	None
részecskékhez	Allative+At
ívek	Nominative
találkozva	None
huzathoz	Allative+At
azonosítsuk	None
alapértelmezetten	Essive+On
smaragdokat	Accusative
biztonságosnak	Dative
felvonókat	Accusative
munkacsoporttal	None
uralmába	Allative+In
átadják	None
szabályzatok	Nominative
összeállításokkal	None
isikre	Allative+On
kísértethistóriákká	Translative
honvédségnek	Dative
fivérekről	Ablative+On
szarban	Essive+In
alkotmánybíróságnál	At+Essive
fényképezőgépekhez	Allative+At
temetést	Accusative
énekesekből	Ablative+In
galériába	Allative+In
nyilasokhoz	Allative+At
átmenetben	Essive+In
másolatokon	Essive+On
nyilvántartani	None
őszibarackokért	Purposive
archivált	None
szomszédosnál	At+Essive
rohadtam	None
választókerület	Nominative
csipketerítőre	Allative+On
rabságokon	Essive+On
ciprusra	Allative+On
befecskendezték	None
kockáztatnak	None
fektessen	None
patriarchálisnál	At+Essive
asszociáld|or|	None
rendeznék	None
lovassággal	None
sajátság	Nominative
felülkerekedtek	None
kiütéssel	None
koronákkal	None
harmonikák	Nominative
kapujával	None
felejtő	None
belügyminisztériumban	Essive+In
csipkebogyón	Essive+On
kémiának	Dative
keskenyek	Nominative
hajrában	Essive+In
népektől	Ablative+At
turmixgépet	Accusative
gyakoribbnak	Dative
munkatársain	Essive+On
aurának	Dative
tárgyaljuk	None
állatorvosnak	Dative
húgysavat	Accusative
számához	Allative+At
tepsiben	Essive+In
számológép	Nominative
tiszafák	Nominative
javaslattól	Ablative+At
harcként	Formal
barátokként	Formal
orientalisztika	Nominative
anyagokba	Allative+In
halmazelméletekként	Formal
leszállnia	None
slágerlistákká	Translative
lemezig	Terminative
szurkolóként	Formal
lommá	Translative
visszavontad	None
ellentmondások	Nominative
üdvözletekig	Terminative
esetekért	Purposive
tengerekben	Essive+In
molekuláktól	Ablative+At
űrhajósokból	Ablative+In
dominálnak	None
emisszió	Nominative
tisztázatlannal	None
megjelenítendő	None
születésnél	At+Essive
kakasnak	Dative
feltalálóról	Ablative+On
vérében	Essive+In
levetkőzzön	None
tömörítő	None
külügyminisztériumnak	Dative
ajánlattal	None
templomokat	Accusative
csokorban	Essive+In
cselédként	Formal
adatátvitelekbe	Allative+In
hordoztak	None
találatnál	At+Essive
sorozatában	Essive+In
terasszal	None
tűrtem	None
esküdtetek	None
csillárokkal	None
rakétákat	Accusative
kiherélsz	None
falaiba	Allative+In
hátúszást	Accusative
harangról	Ablative+On
megmaradnál	None
kötelességek	Nominative
pajzsot	Accusative
konstrukciók	Nominative
egyénként	Formal
dzsámival	None
gyökereznek	None
árnyékában	Essive+In
babonákba	Allative+In
eredményekből	Ablative+In
megmenti	None
doktornőből	Ablative+In
házait	Accusative
szálkát	Accusative
kényszerrel	None
kipróbáltuk	None
bekukucskáltunk	None
történelemtől	Ablative+At
sisak	Nominative
főszerkesztőjével	None
makogtad	None
elnéztem	None
viseli	None
életére	Allative+On
alakították	None
cilinderből	Ablative+In
koncepción	Essive+On
pogácsák	Nominative
lehelsz	None
megközelítette	None
táncolok	None
jóváhagytak	None
váláson	Essive+On
főnévhez	Allative+At
bókolunk	None
basszusgitárt	Accusative
törzsektől	Ablative+At
perektől	Ablative+At
lézert	Accusative
jogarról	Ablative+On
milliomosokig	Terminative
előnyökről	Ablative+On
szeméremérzetet	Accusative
doktornő	Nominative
észszerűsítettük	None
mozira	Allative+On
legalacsonyabban	Essive+In
szeizmográfoknál	At+Essive
képviseletéért	Purposive
produkcióról	Ablative+On
tanszék	Nominative
jellemek	Nominative
jeleiig	Terminative
főnevekre	Allative+On
főszereplőkkel	None
kérdéseinél	At+Essive
okostelefonnal	None
üstökösöket	Accusative
támogatásaként	Formal
kefékből	Ablative+In
viharát	Accusative
viszonyulnak	None
tanulmányozásába	Allative+In
kialakításnál	At+Essive
estéig	Terminative
vonzóbbnak	Dative
megbántad	None
terjeszt	None
határidővel	None
joghurttal	None
szólamok	Nominative
előfizetések	Nominative
hiányoló	None
anyagoknak	Dative
formájával	None
erőművekben	Essive+In
basát	Accusative
kivitelezéssel	None
hatásától	Ablative+At
társulásokat	Accusative
büfével	None
apróságot	Accusative
frakcióban	Essive+In
labirintuson	Essive+On
vipera	Nominative
kajáról	Ablative+On
sisakban	Essive+In
leggazdaságosabbakból	Ablative+In
viszonyíts|or|	None
reklámot	Accusative
felbontjuk	None
felhalmozna	None
kérdezned	None
elemeivel	None
vész	Nominative
hasznára	Allative+On
réssé	Translative
acetaldehidről	Ablative+On
beszámolnia	None
esetére	Allative+On
pápaságokként	Formal
modulként	Formal
kerozinon	Essive+On
óceánba	Allative+In
étteremmel	None
lakótelepről	Ablative+On
grófoktól	Ablative+At
biológiával	None
ellenkezve	None
gonoszságból	Ablative+In
ismeretekkel	None
árokban	Essive+In
állandósulni	None
állításoknál	At+Essive
gyomorkeserűkben	Essive+In
konfliktusból	Ablative+In
nyelveken	Essive+On
foglalkozásokban	Essive+In
csomagoláshoz	Allative+At
lepkéket	Accusative
ultimátumoknak	Dative
profilhoz	Allative+At
akcióssá	Translative
kubizmusok	Nominative
mulatnak	None
emlékeihez	Allative+At
veresekről	Ablative+On
korábbihoz	Allative+At
kereszteléssel	None
jelölj|or|	None
komponálnia	None
kábeltévékért	Purposive
fülével	None
komplikációtól	Ablative+At
alanyesetben	Essive+In
drámára	Allative+On
érintettet	Accusative
fénycsövek	Nominative
hurkát	Accusative
pánikolj|or|	None
mérgezett	None
táborral	None
kommentárok	Nominative
heverni	None
levelezésében	Essive+In
záradékok	Nominative
kakassal	None
főnévről	Ablative+On
rablásnak	Dative
vákuumnak	Dative
ágától	Ablative+At
elindítsák	None
absztraktabb	Nominative
kombiról	Ablative+On
FÁK-ból	Ablative+In
fórumról	Ablative+On
gondolkodnunk	None
bölcsődék	Nominative
opciók	Nominative
szabadságharctól	Ablative+At
idézve	None
stílusában	Essive+In
területévé	Translative
balítélet	Nominative
egérről	Ablative+On
tudását	Accusative
összetetté	Translative
folytatással	None
cinteremnél	At+Essive
egyetemistákat	Accusative
emelkedni	None
halálbüntetések	Nominative
létrejöttéig	Terminative
oldalnak	Dative
konzorcium	Nominative
élelmiszerért	Purposive
csipekkel	None
lassabbak	Nominative
modernen	Essive+On
hálószobákon	Essive+On
lékek	Nominative
újságárusok	Nominative
látogatóval	None
megérdemlő	None
évszámokban	Essive+In
bricseszt	Accusative
vezetéshez	Allative+At
kedvezőbben	Essive+In
palotában	Essive+In
változtatásoknak	Dative
egyesítette	None
munkának	Dative
hotelekkel	None
elkészülne	None
vesztegetjük	None
atomfegyverrel	None
kivételébe	Allative+In
felkínálták	None
közlésként	Formal
szombrérókon	Essive+On
kanyargott	None
megbánva	None
gáztűzhelyként	Formal
erőművekről	Ablative+On
jaguárral	None
tanítványomként	Formal
tűzfegyvert	Accusative
igaziak	Nominative
lezárását	Accusative
szikláig	Terminative
dzsókerekig	Terminative
díszvacsora	Nominative
teendők	Nominative
rítusokkal	None
elhelyezésében	Essive+In
vitorlába	Allative+In
legdélibbekké	Translative
apróságokkal	None
hangzottak	None
újítsak	None
fertőzés	Nominative
szabványosít	None
szelektáló	None
taktikában	Essive+In
pusztítottuk	None
asztronómushoz	Allative+At
bírságnak	Dative
esztendő	Nominative
uszályt	Accusative
ismerttől	Ablative+At
előterjesztenéd	None
repülésekhez	Allative+At
öltözzön	None
működéstől	Ablative+At
kábítószerfüggő	Nominative
jutalmazott	None
feltaláltam	None
buták	Nominative
átnézzenek	None
társaságnál	At+Essive
jobboldalt	Accusative
koncentrálás	Nominative
tűzoltóautóban	Essive+In
hasábok	Nominative
ivarszervekben	Essive+In
kompot	Accusative
sötétebbé	Translative
megfoszt	None
szomszédságában	Essive+In
betakarítást	Accusative
parazitával	None
veszteségek	Nominative
kupával	None
kötegek	Nominative
decemberéig	Terminative
ökölszabályként	Formal
háromfokozatú	Nominative
szörnyetegként	Formal
elvesszen	None
egészségügyek	Nominative
kapcsolataihoz	Allative+At
betűnek	Dative
betegségeken	Essive+On
feldolgozásokról	Ablative+On
kontyba	Allative+In
elképzelésekkel	None
üldögéljen	None
felmondást	Accusative
nagynéniről	Ablative+On
értesítették	None
kereteinek	Dative
rezonanciák	Nominative
véglegesre	Allative+On
bizalmasnak	Dative
népszerűséget	Accusative
sportágaknak	Dative
kontaktlencséket	Accusative
minősülne	None
felkiáltójelet	Accusative
ürességgel	None
legerélyesebbé	Translative
építményekkel	None
lankadó	None
edzéshez	Allative+At
formátumokat	Accusative
felvilágosítást	Accusative
áfonyának	Dative
telekhez	Allative+At
zenében	Essive+In
megállok	None
csendből	Ablative+In
modulban	Essive+In
potenciálisban	Essive+In
betegséget	Accusative
kitüntetésekre	Allative+On
sátorozni	None
illusztrációt	Accusative
rombolni	None
megtartani	None
államtitkárral	None
méretétől	Ablative+At
térdeljen	None
privát	Nominative
befolyt	None
délibábot	Accusative
meghalnia	None
siettem	None
varázsolnak	None
hetes	Nominative
ragasztani	None
rómaiaknak	Dative
hópelyhek	Nominative
elterjed	None
válaszol	None
pálya	Nominative
varsába	Allative+In
kézifegyvereket	Accusative
álcáknak	Dative
megújul	None
átírás	Nominative
varázslattal	None
zsonglőrre	Allative+On
foltokkal	None
higanylámpa	Nominative
elnökből	Ablative+In
kezeléstől	Ablative+At
blamíroztad	None
mélyek	Nominative
koncepcióban	Essive+In
remetét	Accusative
kozmikusakként	Formal
felülkerekedtetek	None
kifejezésmód	Nominative
feltételre	Allative+On
hágónál	At+Essive
ámulatban	Essive+In
énekesnőket	Accusative
leggazdagabban	Essive+In
körömreszelőknek	Dative
kertjében	Essive+In
beöltözött	None
tudományra	Allative+On
repülőként	Formal
alapjairól	Ablative+On
tömegből	Ablative+In
bubifrizuráért	Purposive
átalakulásról	Ablative+On
teljesítéséért	Purposive
kürtre	Allative+On
felmegy	None
síkság	Nominative
megrendeléshez	Allative+At
kivitelezésnél	At+Essive
jutalmat	Accusative
felülírta	None
lelkészekkel	None
újjászületéssel	None
feltételezné	None
édesek	Nominative
tengeralattjárókon	Essive+On
expedícióval	None
címere	Nominative
panaszkodnunk	None
szerszámosládákból	Ablative+In
déliként	Formal
hírlapokat	Accusative
kg-osként	Formal
tévékészülékekből	Ablative+In
birtokokból	Ablative+In
szertartáshoz	Allative+At
lakóitól	Ablative+At
civilizációt	Accusative
soruk	Nominative
gyémánt	Nominative
felépítik	None
kukac	Nominative
fókuszáltatok	None
vívtunk	None
hegycsúcsig	Terminative
egyesületével	None
bejelentkezel	None
kollégiumban	Essive+In
bővítésének	Dative
erélyesebb	Nominative
nyomok	Nominative
medvék	Nominative
minősített	None
kontrákkal	None
húsban	Essive+In
szavazza	None
bízott	None
fiai	Nominative
nagyapává	Translative
házukra	Allative+On
brigádra	Allative+On
fejedelemtől	Ablative+At
hitelkártyákként	Formal
vigyázzon	None
csöbrökkel	None
du.	Nominative
titkosszolgálatokként	Formal
zeneszerzővel	None
gyakorlathoz	Allative+At
kobaltot	Accusative
testeknél	At+Essive
precizitást	Accusative
csodáról	Ablative+On
ócskavasra	Allative+On
elhunytak	None
sekélyből	Ablative+In
fogadnak	None
terjesztetted	None
kiveri	None
bábokból	Ablative+In
románc	Nominative
akciókhoz	Allative+At
palotákra	Allative+On
lassuló	None
percekkel	None
elődtől	Ablative+At
legkeményebbekért	Purposive
tornával	None
évszámmal	None
leckébe	Allative+In
hatásköréből	Ablative+In
vallássá	Translative
szociológusokat	Accusative
kárpótolták	None
euróra	Allative+On
megtalálsz	None
nyelvészeket	Accusative
célokon	Essive+On
kastélyt	Accusative
gravitációra	Allative+On
oldaladra	Allative+On
elrejtettem|	None
hatályát	Accusative
derelyével	None
fáklyafényre	Allative+On
kólát	Accusative
paprikán	Essive+On
házainkon	Essive+On
ablakkal	None
adókedvezménnyel	None
fiatalabbak	Nominative
atomórák	Nominative
helyéért	Purposive
zuhogni	None
megválasztják	None
földszínek	Nominative
örökkévalóságot	Accusative
századnak	Dative
fertőzötteket	Accusative
játékokkal	None
megelőzésével	None
játékon	Essive+On
csöcsökre	Allative+On
alakítunk	None
mohákból	Ablative+In
hadnagyokhoz	Allative+At
gáttól	Ablative+At
székrekedés	Nominative
utód	Nominative
szélességnél	At+Essive
süketen	Essive+On
expedíciókról	Ablative+On
másoljanak	None
lerombolt	None
ellenőrizzük	None
félt	None
téveszteni	None
megköszönjétek	None
gyógyászatiakról	Ablative+On
pestisjárványok	Nominative
érzékkel	None
harmadról	Ablative+On
legtisztábbakkal	None
diszken	Essive+On
kémmel	None
homlokzatnál	At+Essive
tévesztette	None
elnökjelöltségeknél	At+Essive
honlapot	Accusative
hadnál	At+Essive
beleírnád	None
tehetségére	Allative+On
egyesíteni	None
álorcának	Dative
tulajdonosává	Translative
képzésért	Purposive
támadtam	None
visszaél	None
számítógépközpontból	Ablative+In
tápokig	Terminative
prímekre	Allative+On
garanciákat	Accusative
családnéven	Essive+On
forgandó	None
konszenzuson	Essive+On
tilalommal	None
állományába	Allative+In
törekednetek	None
elvesztéséhez	Allative+At
rózsát	Accusative
fejlesztésnél	At+Essive
libából	Ablative+In
álomgyár	Nominative
szakosodnom	None
dioptriásra	Allative+On
borúra	Allative+On
agitálna	None
definícióba	Allative+In
társaihoz	Allative+At
drámában	Essive+In
képviselőjéből	Ablative+In
hírlapra	Allative+On
magasugrásban	Essive+In
munkálatok	Nominative
sékelekként	Formal
mindenhatóról	Ablative+On
oszlopfőből	Ablative+In
paraméterként	Formal
jogsértésekig	Terminative
védelme	Nominative
igazoltak	None
ételt	Accusative
csekkel	None
kollégákkal	None
skálán	Essive+On
sötétzöldben	Essive+In
védekezővé	Translative
bejelentést	Accusative
drámájáért	Purposive
sertést	Accusative
csapdában	Essive+In
barázdával	None
kénekért	Purposive
vereségbe	Allative+In
elkülönítve	None
videóba	Allative+In
hatékonyságára	Allative+On
őrökkel	None
állapotához	Allative+At
megkülönböztetendő	None
ármánnyal	None
abortuszokként	Formal
kötőjelből	Ablative+In
szereljék	None
kánságokat	Accusative
sormintát	Accusative
előlegekhez	Allative+At
karával	None
közben	Essive+In
régimódiakig	Terminative
tulajdonként	Formal
birodalmakba	Allative+In
csatára	Allative+On
hírlappal	None
arcképeknél	At+Essive
létrehozva	None
apokalipszisről	Ablative+On
kedvelünk	None
szakasza	Nominative
újjászületésről	Ablative+On
méréssel	None
part	Nominative
nyelvtanokat	Accusative
kivonjátok	None
szappanbuborék	Nominative
kesztyűbe	Allative+In
landoltatok	None
patríciusoknak	Dative
trónnak	Dative
jegye	Nominative
érzékről	Ablative+On
elhelyeznünk	None
padlótól	Ablative+At
törekvésektől	Ablative+At
csukamájolajnak	Dative
szabályzatokban	Essive+In
bogyókra	Allative+On
gyümölcslével	None
kacsák	Nominative
házért	Purposive
háromszázra	Allative+On
kupolától	Ablative+At
irodán	Essive+On
tanácsokért	Purposive
felvételéről	Ablative+On
intonációról	Ablative+On
óvatossággal	None
legaljasabb	Nominative
szabályzata	Nominative
romkocsma	Nominative
bizonyulnunk	None
gőzhajókkal	None
szögletesre	Allative+On
érintésre	Allative+On
megcsináltatok	None
teraszokat	Accusative
császárságról	Ablative+On
nyuszit	Accusative
lobogóval	None
szerkezetekben	Essive+In
papiruszokon	Essive+On
interjúkból	Ablative+In
megütné	None
rekviráltak	None
panamakalapokhoz	Allative+At
ellenkezett	None
levéltárakba	Allative+In
vesén	Essive+On
évszakot	Accusative
robbantak	None
tulajdonosokkal	None
termék	Nominative
mindenhatóknak	Dative
hidegebbet	Accusative
körzeteken	Essive+On
tükörnek	Dative
házból	Ablative+In
tapsvihart	Accusative
átkelőhelyekről	Ablative+On
szépségversenyre	Allative+On
egyezményre	Allative+On
csempészek	Nominative
titkosszolgálat	Nominative
univerzumokban	Essive+In
hangkártyának	Dative
kényszerülne	None
autótól	Ablative+At
belépéstől	Ablative+At
érzékeket	Accusative
kézművesek	Nominative
cikke	Nominative
fényelektromosba	Allative+In
központi	Nominative
fáradtságra	Allative+On
adminból	Ablative+In
atomerőműből	Ablative+In
szolidaritásból	Ablative+In
összefüggéseknek	Dative
elnökségébe	Allative+In
igazgatókat	Accusative
kommunikál	None
televízióra	Allative+On
változatról	Ablative+On
mellényektől	Ablative+At
diszkrimináció	Nominative
fémpénzek	Nominative
helyére	Allative+On
vezérlő	None
mosolygásba	Allative+In
minősítéstől	Ablative+At
tövekre	Allative+On
édességből	Ablative+In
korosztályba	Allative+In
kodifikáltátok	None
bölcsőket	Accusative
kijelzővel	None
rögzítenetek	None
szilvából	Ablative+In
kardoskodnak	None
kalácsokra	Allative+On
népirtással	None
dzsemet	Accusative
indokokat	Accusative
alattvalókkal	None
tüzérségben	Essive+In
bajnokságból	Ablative+In
vakációk	Nominative
sorozatokat	Accusative
állományáról	Ablative+On
meggyújtsa	None
kígyókat	Accusative
lakóteleppel	None
kiterjesztéssel	None
házában	Essive+In
helységnevekben	Essive+In
régiókra	Allative+On
módszeréről	Ablative+On
demót	Accusative
terjedésre	Allative+On
földjéért	Purposive
célpontot	Accusative
erotikákért	Purposive
javaslatai	Nominative
világháborúk	Nominative
pszichoanalízissel	None
állásokba	Allative+In
olvasáshoz	Allative+At
bemutasson	None
fiatalabbat	Accusative
kenukon	Essive+On
asztrolábium	Nominative
stílusról	Ablative+On
sorolja	None
elpárolgó	None
neveivel	None
legfrissebbeknél	At+Essive
kérdésétől	Ablative+At
dióda	Nominative
kastélynál	At+Essive
birodalmakat	Accusative
differenciálgeometria	Nominative
avatára	Nominative
megbízással	None
lovagban	Essive+In
keresztről	Ablative+On
régiekkel	None
reklámra	Allative+On
szervezetet	Accusative
költsék	None
ágyásokká	Translative
megtanulod	None
vastagra	Allative+On
gépekről	Ablative+On
kánról	Ablative+On
felvonó	Nominative
hatásosabbá	Translative
klímán	Essive+On
ócskavasakig	Terminative
pillanattal	None
m	Nominative
fantáziákon	Essive+On
arterioszklerózisokat	Accusative
balesetekhez	Allative+At
civilizálták	None
biztostól	Ablative+At
tevékenységéért	Purposive
angyalokat	Accusative
bóra	Nominative
hírekről	Ablative+On
ösvényt	Accusative
pandákra	Allative+On
vörösödik	None
csöngjék	None
gyűjtőnek	Dative
kötőkön	Essive+On
múzeum	Nominative
hársfa	Nominative
szívószál	Nominative
meghalnak	None
partnerétől	Ablative+At
kompresszióval	None
barázdák	Nominative
bedobó	None
meglepnie	None
állománya	Nominative
népszavazással	None
túszoktól	Ablative+At
lelkiismereten	Essive+On
tengellyel	None
tisztábbakból	Ablative+In
stratégián	Essive+On
szikráért	Purposive
feleletekbe	Allative+In
jellemzőjében	Essive+In
dinoszauruszokat	Accusative
polgárháborúban	Essive+In
ügyére	Allative+On
előmozdítjuk	None
mitológiában	Essive+In
ünnepe	Nominative
kötődött	None
forgatásba	Allative+In
halmozottra	Allative+On
nyomtatnak	None
állapítjuk	None
ellenőrt	Accusative
aggályokra	Allative+On
elemektől	Ablative+At
arányához	Allative+At
rémért	Purposive
koalíciósakként	Formal
kasztokra	Allative+On
futárra	Allative+On
vesztegetett	None
birtokában	Essive+In
minaretre	Allative+On
kifejezni	None
dromedárt	Accusative
számológépek	Nominative
előttiként	Formal
világ	Nominative
felbukkant	None
csókolta	None
Magyarországon	Essive+On
júl.-okon	Essive+On
kitörniük	None
futamon	Essive+On
tisztelünk	None
békával	None
nagyító	Nominative
esküvőre	Allative+On
affixumban	Essive+In
csinálnia	None
pólónak	Dative
bővítettem	None
szótárakat	Accusative
dühvel	None
ökröt	Accusative
palotákból	Ablative+In
párkányon	Essive+On
üzemeltetés	Nominative
aggódjatok	None
idead	None
magazinban	Essive+In
szociológusként	Formal
zárkózottért	Purposive
főszerepbe	Allative+In
zárolták	None
együttműködéssel	None
lendületből	Ablative+In
pszichiáterhez	Allative+At
szöveget	Accusative
grafikák	Nominative
kérésnek	Dative
nagybőgőre	Allative+On
belépni	None
fogyatkozik	None
ideg	Nominative
birodalmiaktól	Ablative+At
gyulladásokra	Allative+On
pótlása	Nominative
felhasználásába	Allative+In
törléséért	Purposive
szabályozó	None
díjazza	None
kihagyok	None
lézereknél	At+Essive
gyújtogatással	None
kullancs	Nominative
vesztenek	None
irigykedve	None
spam	Nominative
forradalmasították	None
nászút	Nominative
égtájak	Nominative
hercegnők	Nominative
szolgáltatóhoz	Allative+At
főhercegek	Nominative
pálcákat	Accusative
bétákig	Terminative
aktivizálták	None
párduc	Nominative
egészre	Allative+At
folyamatnak	Dative
szabadságáról	Ablative+On
frakcióval	None
bekapcsoltad	None
szaknyelvet	Accusative
vásznakkal	None
jártasak	Nominative
felületekre	Allative+On
ábécéknek	Dative
bocsátó	None
szerverre	Allative+On
hattyúban	Essive+In
részükkel	None
lelték	None
titkosítva	None
rendezvénysorozathoz	Allative+At
dolgozattal	None
ingázó	Nominative
géniuszokhoz	Allative+At
szervezését	Accusative
kérdő	None
elrendelik	None
változatokban	Essive+In
epizódok	Nominative
bőrűre	Allative+On
buzogánytól	Ablative+At
csillagködökért	Purposive
eltelve	None
renováltak	None
konföderációvá	Translative
adaptációt	Accusative
felhatalmazó	None
harcművészetben	Essive+In
vibráljatok	None
kaviár	Nominative
oldalunkra	Allative+On
határával	None
napvilágot	Accusative
babérjait	Accusative
parancsolatot	Accusative
életcél	Nominative
hullámtörőkbe	Allative+In
civilizációk	Nominative
filmnél	At+Essive
elhalasztottak	None
színészeket	Accusative
harmóniába	Allative+In
állapítod	None
feltenned	None
kapujába	Allative+In
korálokat	Accusative
itterbium	Nominative
vasútállomáson	Essive+On
hájjal	None
tapadjon	None
intrikákba	Allative+In
leírsz	None
dzsesszek	Nominative
lakótelepekkel	None
fülünket	Accusative
varázslók	Nominative
megbeszélik	None
következtessenek	None
parkolóhelyből	Ablative+In
diagnózisnál	At+Essive
határol	None
tartóztassa	None
címerrel	None
megőrzésén	Essive+On
járőrözzön	None
öbölig	Terminative
legfrissebbek	Nominative
egykorúak	Nominative
nadrágszíjaktól	Ablative+At
előadásától	Ablative+At
látogatnak	None
felnőttképzésért	Purposive
kenderből	Ablative+In
bővítve	None
hullámfüggvényektől	Ablative+At
csatahajóknak	Dative
szimbólummá	Translative
