harisnyanadrágokként	Noun
harangnak	Noun
bauxitból	Noun
nuncsakuktól	Noun
elemeivé	Noun
csipesszel	Noun
kezéről	Noun
elemeket	Noun
fácánokról	Noun
húgot	Noun
bandáktól	Noun
körzetekbe	Noun
képtelenséget	Noun
disszonanciáig	Noun
rétegnél	Noun
gyümölcsként	Noun
hegesztő	Participle
sorokkal	Noun
észlelné	Verb
szakaszában	Noun
poszméhhé	Noun
eszét	Noun
örvényeket	Noun
nevetéssel	Noun
delfin	Noun
földrengések	Noun
szabtam	Verb
mérnökké	Noun
pincére	Noun
látványos	Noun
millenniumiaknak	Noun
haszonhoz	Noun
szárazabbá	Noun
egyezzetek	Verb
elkötelezettek	Noun
embertelenekként	Noun
összekeverte	Verb
kitüntető	Participle
szívére	Noun
virágvasárnapokból	Noun
babonában	Noun
baloldalt	Noun
baseballról	Noun
szökésért	Noun
modulon	Noun
kijelent	Verb
személygépkocsi	Noun
furcsaságra	Noun
pacákba	Noun
installáld|or|	Verb
mosómedvéket	Noun
szorgalmat	Noun
kérőt	Noun
fürdésbe	Noun
megállapodásnak	Noun
tömbökkel	Noun
mózeskosarakon	Noun
visszautasítva	Converb
módosításokkal	Noun
értelméről	Noun
gyermekből	Noun
modulokra	Noun
gyűjtéseket	Noun
paradoxonnal	Noun
kövérért	Noun
játszódó	Participle
valóságok	Noun
katlanba	Noun
múzeumoknak	Noun
halászaton	Noun
gyilkoshoz	Noun
szárnyon	Noun
legmegbízhatatlanabbra	Noun
csapadékkal	Noun
sáfárkodjatok	Verb
kórterem	Noun
kommentáltak	Verb
módosításokat	Noun
rokonokkal	Noun
székhelyhez	Noun
járványokon	Noun
seregekként	Noun
szempontokra	Noun
szalámitaktikáig	Noun
zajlik	Verb
cukorrépát	Noun
titokká	Noun
franciákból	Noun
megoldásokban	Noun
újítja	Verb
irányítsák	Verb
beszélgetésben	Noun
major	Noun
rámutattam	Verb
díjmentes	Noun
mosodáról	Noun
helyszínek	Noun
befolyásolni	Verb
kitöltve	Converb
súlyában	Noun
időktől	Noun
kategóriánál	Noun
hölgyre	Noun
fejezünk	Verb
világbajnokság	Noun
elképzeléseihez	Noun
rendekhez	Noun
szukát	Noun
alkotásáért	Noun
fotósoknak	Noun
felszerelésekre	Noun
elkülönítenek	Verb
hírlapnak	Noun
engedélyez	Verb
képesítést	Noun
porcelánokat	Noun
kertjeiről	Noun
rétegig	Noun
kupola	Noun
zeneszerzés	Noun
szemrehányásig	Noun
szilvalekvárhoz	Noun
csendélet	Noun
munkaruhát	Noun
jóváhagyásától	Noun
csillagködig	Noun
empirikusakként	Noun
segítségbe	Noun
programjaik	Noun
licsifákra	Noun
kilépő	Participle
újságcikkekké	Noun
zsinat	Noun
végrendelet	Noun
kedveltebb	Noun
súlyosabból	Noun
gyufával	Noun
dömpingen	Noun
közoktatásban	Noun
végrehajtása	Noun
ördögi	Noun
teknősbéka	Noun
sikereken	Noun
hadseregről	Noun
gyártásba	Noun
mikrofonhoz	Noun
szpeleológia	Noun
nevezetekért	Noun
szerzetbe	Noun
gyermekkortól	Noun
ellenségesek	Noun
rejtelmes	Noun
véleményükkel	Noun
pillanataként	Noun
kérvény	Noun
bástyához	Noun
pillangótól	Noun
bátrabbak	Noun
szponzorokat	Noun
ágyában	Noun
rokonságra	Noun
csillagtérkép	Noun
montázs	Noun
kivitelezést	Noun
igazinak	Noun
teleket	Noun
zaklató	Participle
szíjból	Noun
dinnyét	Noun
nyakkendőben	Noun
kényszerítenek	Verb
törekedniük	Verb
tavakban	Noun
végződne	Verb
szakszervezetbe	Noun
változásokra	Noun
mocsárban	Noun
tatárjárások	Noun
boszorkánnyá	Noun
generációtól	Noun
fiúról	Noun
alkut	Noun
szövetet	Noun
zászlóaljakban	Noun
megyékre	Noun
kifejezendő	Participle
letartóztatod	Verb
agyat	Noun
vereség	Noun
megismerését	Noun
disznósajttá	Noun
legelfogadottabb	Noun
évein	Noun
elküldte	Verb
bankjeggyel	Noun
gejzírek	Noun
tényével	Noun
gépet	Noun
egyenértékben	Noun
keverékek	Noun
ítéli	Verb
egyesületekbe	Noun
lapjától	Noun
karrierjének	Noun
megalakulás	Noun
spamektől	Noun
megbízhatatlanabbnál	Noun
megfogalmaz	Verb
energetikai	Noun
megszámozták	Verb
rejtetten	Noun
tőzsdén	Noun
olimpiává	Noun
fürtöt	Noun
varázspálca	Noun
kockázatosak	Noun
ernyőket	Noun
hüllőre	Noun
anomáliaként	Noun
ügyesekbe	Noun
étteremmé	Noun
szerződések	Noun
ösztöndíjakra	Noun
plébánostól	Noun
tanulunk	Verb
kérdésekért	Noun
csatlakoznék	Verb
bárányokkal	Noun
küzdelmekre	Noun
remilitarizáltak	Verb
találathoz	Noun
kölest	Noun
műveletekkel	Noun
lőszerek	Noun
megtanulta	Verb
galéria	Noun
becsüli	Verb
kentaurokból	Noun
pataktól	Noun
erőművek	Noun
fogalmak	Noun
druzsbákat	Noun
eldöntő	Participle
legismerősebbeknek	Noun
külügyminisztériumról	Noun
étlapunknál	Noun
rákokkal	Noun
értelmiségnek	Noun
hátrálnia	Verb
sót	Noun
tényben	Noun
ismételték	Verb
radioizotóp	Noun
elnökjelöltségért	Noun
bóvli	Noun
karika	Noun
megnyitásoktól	Noun
üzemeltetésektől	Noun
elveszítik	Verb
talány	Noun
kocsikon	Noun
zagyvábbal	Noun
abroncsot	Noun
modernizáció	Noun
megpróbálnád	Verb
ünnepként	Noun
dámszarvasok	Noun
vulkánt	Noun
szesztilalmat	Noun
körömkeféktől	Noun
bukásként	Noun
megteszi	Verb
megoldásba	Noun
fagottok	Noun
bővítések	Noun
alkotnának	Verb
négyszögben	Noun
aranyéremnek	Noun
hintő	Participle
kezdeményezését	Noun
rövidítették	Verb
gyűjtésre	Noun
rendeletekről	Noun
récék	Noun
érából	Noun
segítésére	Noun
számítástechnikára	Noun
tejfogért	Noun
neutrínónak	Noun
aláíráson	Noun
sasa	Noun
robbanásra	Noun
születést	Noun
modernizáltak	Verb
időzóna	Noun
állapít	Verb
dombon	Noun
összegekkel	Noun
stadionon	Noun
államtitkárral	Noun
kútba	Noun
piacában	Noun
humorosak	Noun
gyümölcsöket	Noun
lándzsákat	Noun
tökéletességet	Noun
legegyetemesebbeknek	Noun
összeszedte	Verb
kisebbítették	Verb
országossá	Noun
oldalakra	Noun
műszernél	Noun
dohányt	Noun
elintézik	Verb
éremhez	Noun
beruházást	Noun
dzsámival	Noun
szítja	Verb
karkötőben	Noun
délig	Noun
rendeletére	Noun
seprűk	Noun
trónig	Noun
vindikál	Verb
tályogoktól	Noun
borzalmat	Noun
lelkesítő	Participle
hápogunk	Verb
hálózsákok	Noun
kibővítjük	Verb
szakképzésről	Noun
alkotásnak	Noun
éter	Noun
szökőéveket	Noun
kézilabdáztál	Verb
raktárépületet	Noun
elad	Verb
krónikussá	Noun
vidékfejlesztési	Noun
internet	Noun
fejezik	Verb
tervelsz	Verb
életükön	Noun
pikkelyekkel	Noun
nevezed	Verb
dolognál	Noun
iparvidékek	Noun
zene	Noun
vérontásra	Noun
igazolvány	Noun
zsákokba	Noun
kombira	Noun
szakosodnak	Verb
kajszibarackok	Noun
fogalmat	Noun
csomagokban	Noun
kétharmadot	Noun
siettem	Verb
életrajzokhoz	Noun
tanúsító	Participle
sütötte	Verb
délibábban	Noun
állókig	Noun
invázióig	Noun
okmánynak	Noun
változatossá	Noun
asszociatívakként	Noun
legengedelmesebbeket	Noun
megemlítjük	Verb
megbánnák	Verb
célszerűnek	Noun
tiltanak	Verb
kinézte	Verb
őrgrófnak	Noun
találkozásról	Noun
kubizmushoz	Noun
aggódnia	Verb
kódokkal	Noun
interpretáció	Noun
prezentálta	Verb
régiséget	Noun
községekben	Noun
rondából	Noun
marxizmustól	Noun
kolostorok	Noun
zárlat	Noun
filmfesztivál	Noun
infó	Noun
lakomázó	Participle
posztoltál	Verb
aláírásának	Noun
hallucinációk	Noun
munkámmal	Noun
középszerű	Noun
gerendán	Noun
ágyúkból	Noun
legények	Noun
kacor	Noun
születendővel	Noun
politikai	Noun
patkányokon	Noun
billentyűs	Noun
megvalósulnia	Verb
túllépned	Verb
ládákba	Noun
liftek	Noun
dugattyúnak	Noun
riadót	Noun
tisztségviselőt	Noun
szerecsendióval	Noun
kritikában	Noun
virítottam	Verb
telekről	Noun
zárdából	Noun
kifejezésmódot	Noun
hőmérsékletet	Noun
pszichológusoknak	Noun
palotákon	Noun
polccá	Noun
rendelkezőnek	Noun
bővítették	Verb
tojó	Participle
témákra	Noun
súlyát	Noun
megtartásokra	Noun
tőzegbe	Noun
logikusakban	Noun
sokkok	Noun
társítsák	Verb
nemzetiségnek	Noun
csomagtartóba	Noun
lecsót	Noun
fürdőszobát	Noun
felelik	Verb
cikkelyre	Noun
szívedet	Noun
kezdetében	Noun
kiemeltnél	Noun
rum	Noun
kereskedésben	Noun
elhiszünk	Verb
show-kba	Noun
túlbecsüljünk	Verb
evangélistát	Noun
istenséghez	Noun
ígéretes	Noun
ejtőernyősnek	Noun
buddhizmusból	Noun
kötelezettségekről	Noun
felkészülést	Noun
megfogalmazásán	Noun
főszereplőkre	Noun
legolcsóbb	Noun
esztendőnek	Noun
szigetnél	Noun
feküdne	Verb
körbevevő	Participle
sulyokként	Noun
díjazó	Participle
öröklakásból	Noun
politikához	Noun
bélyegért	Noun
elárulod	Verb
aknával	Noun
dongó	Noun
üdvözöltem	Verb
szentélyről	Noun
pirosat	Noun
élvezetre	Noun
bírták	Verb
tartalmakról	Noun
kártyákra	Noun
zűrzavarhoz	Noun
adatnál	Noun
csúcsforgalomhoz	Noun
velőhöz	Noun
építőipart	Noun
szüntette	Verb
ismertebbektől	Noun
integrációról	Noun
jármű	Noun
partner	Noun
átmenetnek	Noun
söpörték	Verb
menekülttel	Noun
paszulyokban	Noun
vadtyúk	Noun
kapujáig	Noun
teréből	Noun
késői	Noun
méltányolta	Verb
spekulációnak	Noun
borsot	Noun
általánossá	Noun
kézbesítés	Noun
zongorákon	Noun
aukciók	Noun
hetesben	Noun
mértékig	Noun
visszajelzésnek	Noun
zarándoklatot	Noun
témakörből	Noun
nyelvjárások	Noun
élőlénytől	Noun
számú	Noun
katalógusból	Noun
elmélkedtél	Verb
bárányok	Noun
jutalmaznák	Verb
populárisnál	Noun
idegrendszerben	Noun
kapákkal	Noun
barlangtanra	Noun
ultimátumnak	Noun
kötő	Noun
stabilitásra	Noun
narancshéj	Noun
frizírozod	Verb
gyümölcsökhöz	Noun
készítésénél	Noun
fiókból	Noun
növelő	Participle
halászsastól	Noun
atlaszra	Noun
lótuszt	Noun
evolúcióra	Noun
gordon	Noun
megrendelések	Noun
mozaikszó	Noun
rézre	Noun
előadótermek	Noun
bírniuk	Verb
elválasztani	Verb
szószékekért	Noun
érzésből	Noun
ellentámadással	Noun
riportokkal	Noun
űrhajóssal	Noun
hazudtál	Verb
palackon	Noun
monszunok	Noun
gyanúért	Noun
menetrendből	Noun
csomópontról	Noun
szemeszterekért	Noun
aláírva	Converb
megerősödő	Participle
gondoskodniuk	Verb
gumikesztyű	Noun
szakközépiskolával	Noun
fodor	Noun
kipákra	Noun
acetonba	Noun
haláig	Noun
tradíciók	Noun
éghajlaton	Noun
rasszizmusért	Noun
üzemhez	Noun
babonával	Noun
mától	Noun
igazolványok	Noun
kölcsönre	Noun
kritériumokhoz	Noun
sarj	Noun
kozmikusakként	Noun
ácson	Noun
hozzászólásába	Noun
prímmel	Noun
kulcscsont	Noun
focistákkal	Noun
típusoktól	Noun
eléréshez	Noun
tarkábból	Noun
producerhez	Noun
brossokon	Noun
nyugdíjasok	Noun
megbízhatóságban	Noun
rajzoló	Noun
audiencián	Noun
szövetkezetiekből	Noun
társadalmat	Noun
sebészt	Noun
majdani	Noun
tűzoltóautókból	Noun
fűtést	Noun
illőnek	Noun
koporsóig	Noun
magnézium	Noun
csoportja	Noun
esztendőhöz	Noun
pikkellyé	Noun
bolhákkal	Noun
emlékeiben	Noun
ellenség	Noun
oszlopnak	Noun
veszélyen	Noun
videó	Noun
dandárba	Noun
történetét	Noun
alapok	Noun
lezárással	Noun
elvéhez	Noun
ápr.-ról	Noun
ellenálláson	Noun
kötetekből	Noun
kitünteti	Verb
diftongusokat	Noun
vonatkozásoktól	Noun
buliba	Noun
foglalkoztatják	Verb
szokik	Verb
retekért	Noun
csillagosra	Noun
látogasd|or|	Verb
alkotásában	Noun
szomszédnak	Noun
konflis	Noun
zsinagógának	Noun
koordinálta	Verb
férfival	Noun
külkereskedelmi	Noun
csatornáktól	Noun
pereputtyokon	Noun
megnyerniük	Verb
bátorságnak	Noun
burkok	Noun
növekedése	Noun
hősökkel	Noun
szponzorok	Noun
szajrékról	Noun
könnyek	Noun
hódot	Noun
zeneszerző	Noun
bilin	Noun
megismertessék	Verb
szerződő	Participle
rakétától	Noun
ágyúknak	Noun
bögrével	Noun
tükörfordításnak	Noun
konzervgyár	Noun
ispánokból	Noun
sportágban	Noun
ekével	Noun
stáb	Noun
zenekarokra	Noun
visszaélésekről	Noun
kisfiúnak	Noun
kalapács	Noun
következetesen	Noun
érdeklődésből	Noun
hangszereli	Verb
éhségsztrájkban	Noun
szorzás	Noun
gonoszabb	Noun
kötőjelnek	Noun
mellébeszélünk	Verb
cadikban	Noun
táplálékban	Noun
kedvel	Verb
felülírták	Verb
disszertációt	Noun
kábeleket	Noun
dokumentál	Verb
többségéért	Noun
nappalokon	Noun
gazdálkodásokra	Noun
megszűnéséből	Noun
illetékeket	Noun
legsötétebbeket	Noun
forgalmazni	Verb
jegyért	Noun
legterjedelmesebbért	Noun
bemutatkoztak	Verb
naprakészre	Noun
lebonyolítás	Noun
zsinatra	Noun
szabadkőművesért	Noun
élményként	Noun
fellépésre	Noun
balesetért	Noun
pika	Noun
utazás	Noun
konténerekig	Noun
palából	Noun
legendák	Noun
rendezvényéről	Noun
megkülönböztetni	Verb
áraival	Noun
közelíti	Verb
taoizmusból	Noun
hinták	Noun
hűteném|	Verb
kezdeményezésébe	Noun
tatához	Noun
acéllemezt	Noun
helységneveket	Noun
világbékét	Noun
bürokratáktól	Noun
feltételezek	Verb
fedeznek	Verb
sétához	Noun
körülményeire	Noun
becsületre	Noun
webszervert	Noun
lapkiadó	Noun
vilajet	Noun
válásba	Noun
jegyzőket	Noun
videóra	Noun
szimbólumból	Noun
pénztártól	Noun
évszakban	Noun
bűnöket	Noun
könyvkiadók	Noun
szennyeződéstől	Noun
előállítja	Verb
szekérből	Noun
eltérésként	Noun
ellenséggé	Noun
elképzeléseiben	Noun
kételkedés	Noun
miniszterként	Noun
megoldunk	Verb
reggeliztem|	Verb
gyönyörökért	Noun
forrásnyelven	Noun
kisebbikből	Noun
jegyzeteket	Noun
cárnőtől	Noun
trapézoktól	Noun
megszakítsa	Verb
problémáknak	Noun
emlékezetre	Noun
sóként	Noun
napoktól	Noun
szerkesztőjétől	Noun
választókerületek	Noun
bővítés	Noun
legakrobatikusabbról	Noun
hidrofóbia	Noun
kvantumok	Noun
ostobákat	Noun
nyilvánítasz	Verb
rostból	Noun
foglalkoztatottról	Noun
készítés	Noun
determinálnak	Verb
ronda	Noun
bejelentkezéssel	Noun
megfigyelés	Noun
rendezvénysorozaton	Noun
fn.-ekben	Noun
mértékében	Noun
néninél	Noun
golyókból	Noun
legismerősebbre	Noun
okostelefont	Noun
szélességgel	Noun
ágakban	Noun
lényegeként	Noun
nagyságként	Noun
tehetségéről	Noun
falevélről	Noun
piacán	Noun
alanyokért	Noun
jellemzőjének	Noun
gályarabok	Noun
szaknyelvre	Noun
autópályákon	Noun
futóversenyt	Noun
eredettel	Noun
anyagból	Noun
termelő	Noun
atomon	Noun
törvényeken	Noun
sárkányhoz	Noun
centivel	Noun
legszebbek	Noun
nehézségek	Noun
tüntetéshez	Noun
suliból	Noun
egérről	Noun
taglalni	Verb
horgoknak	Noun
krónikusakban	Noun
konfigurációban	Noun
baktériumnál	Noun
tervezettől	Noun
tarlatánról	Noun
becsléseket	Noun
gyűjteményekben	Noun
védőszentekbe	Noun
feltételeken	Noun
merészeljék	Verb
központjára	Noun
rejtjük	Verb
nyomtatványokat	Noun
létesíti	Verb
csat	Noun
igazgatóra	Noun
kizárásról	Noun
kezelésénél	Noun
fantáziáló	Participle
temetik	Verb
visszaélésről	Noun
öreggé	Noun
értelmezésében	Noun
alaktanból	Noun
vénasszony	Noun
ülésekre	Noun
elteljen	Verb
érvényben	Noun
közösséggel	Noun
állampolgárokká	Noun
mesterénél	Noun
felajánlottunk	Verb
megjelölni	Verb
utódokban	Noun
telepítésekkel	Noun
kerékpárokon	Noun
olvasásinál	Noun
zsorzsettnek	Noun
nyilvánítják	Verb
márkáért	Noun
résznek	Noun
felállította	Verb
barkácsboltokig	Noun
dualizmusnál	Noun
karosszériába	Noun
rokonokért	Noun
próbálkoztak	Verb
papagájokat	Noun
blokkokkal	Noun
egyes	Noun
víkendekre	Noun
anyagcseréhez	Noun
hangszedőkkel	Noun
lakcímről	Noun
világegyetemet	Noun
szimbolikussá	Noun
őrgrófok	Noun
sértegetni	Verb
elfogyasztó	Participle
kutatóközponttá	Noun
tevékenységére	Noun
istennőhöz	Noun
megkönnyíteni	Verb
benzoesav	Noun
imádságra	Noun
építéséhez	Noun
világítottak	Verb
évezredekben	Noun
povedálta	Verb
hagyományos	Noun
bátornak	Noun
déltől	Noun
maradékból	Noun
kórusra	Noun
elfojtania	Verb
vágyat	Noun
ösvényért	Noun
bevezetünk	Verb
minaretről	Noun
tűzvédelmiektől	Noun
bekövetkeznek	Verb
felépítéséről	Noun
ágyazták	Verb
viselnie	Verb
költészethez	Noun
mészkövekben	Noun
akciófilmeket	Noun
olajért	Noun
megkaparintottatok	Verb
képzéstől	Noun
keringőre	Noun
hegynél	Noun
kezelniük	Verb
cintányérral	Noun
gyógyítást	Noun
licenceket	Noun
kiválasszon	Verb
erdészre	Noun
séta	Noun
űrsétát	Noun
komponenseknek	Noun
zongorázni	Verb
tulajdonnévnek	Noun
csigába	Noun
szennyeződést	Noun
vizsgálatán	Noun
kábítószernek	Noun
módosítva	Converb
szakértőkre	Noun
párhuzamosságról	Noun
csukát	Noun
árai	Noun
szabjunk	Verb
kémiaitól	Noun
reformért	Noun
perce	Noun
négyzetszámot	Noun
belügynek	Noun
kihagyva	Converb
kivitelből	Noun
memóriához	Noun
szenvedésnek	Noun
végzetből	Noun
politika	Noun
megszakítottak	Verb
srác	Noun
eleméhez	Noun
jelképezik	Verb
bírósági	Noun
végzek	Verb
felfrissítették	Verb
táblázatként	Noun
kitörés	Noun
betartásában	Noun
vállalkoznak	Verb
hüvelykujjal	Noun
műszakokban	Noun
nyilatkozatára	Noun
osztálytársak	Noun
példától	Noun
mellékhatás	Noun
felújítják	Verb
cipőtalpakat	Noun
jelenetnek	Noun
tervem	Noun
kulákká	Noun
óvodásoknak	Noun
természettudományon	Noun
nyelvhez	Noun
váltó	Noun
megír	Verb
világosságokra	Noun
serpenyőbe	Noun
kérdeznél	Verb
szinkronszínészeknek	Noun
elkóborol	Verb
hullámhossz	Noun
öngólok	Noun
tükrökön	Noun
gépágyúhoz	Noun
igényekre	Noun
válogatotton	Noun
felejtik	Verb
megnyom	Verb
fülkagyló	Noun
egyensúlyit	Noun
lakomákig	Noun
csillagászatban	Noun
nyilatkozattal	Noun
vadrózsáknak	Noun
jókorától	Noun
adományokban	Noun
pókoknak	Noun
malommá	Noun
asszociativitások	Noun
zsigerekként	Noun
ragasztotok	Verb
ellenfeleket	Noun
rítusért	Noun
juttatással	Noun
abroszt	Noun
tartásáról	Noun
olvasásához	Noun
autóban	Noun
előadásként	Noun
szervével	Noun
baktériumnak	Noun
keresztespókig	Noun
elhitték	Verb
melegházban	Noun
távokon	Noun
éhségtől	Noun
szövetanyagról	Noun
fűződő	Participle
jelölésre	Noun
intézményekben	Noun
kisbőgőnek	Noun
munkáltató	Noun
egyszerűsíti	Verb
párbajtőrről	Noun
vigasságokba	Noun
blokkról	Noun
aranyoznál	Verb
munkálatokkal	Noun
rendezők	Noun
megválasztásával	Noun
idézetek	Noun
szemléletről	Noun
fiatalabbat	Noun
epizódnak	Noun
igényeihez	Noun
nyilvántartást	Noun
lándzsákkal	Noun
növendéket	Noun
módot	Noun
petéket	Noun
verseire	Noun
országa	Noun
utasoknak	Noun
állományban	Noun
sarkkutatóhoz	Noun
dalokon	Noun
hasznokra	Noun
mindennapok	Noun
makacsabbnak	Noun
számúként	Noun
étkészletek	Noun
állásokban	Noun
artikulált	Noun
biofizikus	Noun
mellényeket	Noun
leadnád	Verb
alternatívaként	Noun
síoktató	Noun
perbe	Noun
példaképet	Noun
korunknak	Noun
csipekben	Noun
fejlesztésből	Noun
tisztogatást	Noun
öngyújtók	Noun
könyvelők	Noun
nőgyűlöleteket	Noun
bibliográfiának	Noun
sűrűre	Noun
elkészül	Verb
migrén	Noun
tengelyben	Noun
ruháiba	Noun
ötletéről	Noun
táncoló	Participle
harangokat	Noun
kifejezésen	Noun
lakhelynek	Noun
hozzájárulásra	Noun
megválasztásánál	Noun
brigád	Noun
fordításában	Noun
öltötte	Verb
művelethez	Noun
apetitusra	Noun
repülőgépben	Noun
személyében	Noun
hülyeségen	Noun
szorgalmas	Noun
elkerülése	Noun
hozzászólóval	Noun
szegényebbeket	Noun
halottkémeknek	Noun
veszekedés	Noun
kifutópályát	Noun
értékesről	Noun
traktorokat	Noun
panelházat	Noun
tagozatos	Noun
óraikhoz	Noun
legmagasztosabbal	Noun
csónakból	Noun
neveit	Noun
bokszbajnok	Noun
őserdővel	Noun
világhoz	Noun
egyesítettetek	Verb
középpontra	Noun
biztonságával	Noun
sportnál	Noun
tevével	Noun
kilométereken	Noun
biztosabb	Noun
vállban	Noun
mindennemű	Noun
munkákhoz	Noun
elviseljék	Verb
konvencióban	Noun
víziókat	Noun
adatbázisokért	Noun
eltolást	Noun
dimenzión	Noun
kisebbségbe	Noun
elvárásként	Noun
kumisz	Noun
császárrá	Noun
dalszövegekhez	Noun
fejezetek	Noun
sikeréről	Noun
ugratja	Verb
marxival	Noun
kornál	Noun
epevezetékhez	Noun
ellenségnél	Noun
hangtalan	Noun
ürügy	Noun
megyéből	Noun
világbajnokságig	Noun
újságírásból	Noun
levéltárat	Noun
bizonytalanságra	Noun
tőzsde	Noun
kipróbáltam	Verb
bíróságtól	Noun
tárgyalást	Noun
igénytől	Noun
gyereknyelvbe	Noun
paleolitikumból	Noun
húzódnánk	Verb
parcellát	Noun
bankjegyek	Noun
végrendelkezve	Converb
értékesítésre	Noun
bűnügyiig	Noun
transzformációval	Noun
indításból	Noun
anyától	Noun
képletnek	Noun
vívással	Noun
állásponttól	Noun
éber	Noun
asztalneműről	Noun
kopottról	Noun
többletként	Noun
lovag	Noun
pisztolyok	Noun
ellátnak	Verb
katarzisért	Noun
megtaláltad	Verb
recékben	Noun
letartóztatja	Verb
imádságoknál	Noun
konzulensekké	Noun
tételesekben	Noun
ellenálltak	Verb
tagdíjakból	Noun
hulladékokat	Noun
cseréjének	Noun
közegtől	Noun
tartalmas	Noun
előadásába	Noun
következőként	Noun
esküvőkre	Noun
alrendszer	Noun
gyengébbekről	Noun
rágcsálón	Noun
szállítása	Noun
taszítja	Verb
legsikeresebbekké	Noun
fázisból	Noun
repülőkről	Noun
pénzintézeteken	Noun
játékokhoz	Noun
kantárt	Noun
képes	Noun
gyakoriságban	Noun
zsarnokság	Noun
kazettákra	Noun
bíróságként	Noun
sikerén	Noun
repülésekre	Noun
part	Noun
beszédre	Noun
tisztogatásoknak	Noun
felsőbbnek	Noun
megegyezve	Converb
plébánost	Noun
kifejted	Verb
szálláson	Noun
cimboráló	Participle
előbbiből	Noun
biciklire	Noun
termesztették	Verb
érvényes	Noun
korszakig	Noun
nevezetek	Noun
áttekintve	Converb
férfihoz	Noun
mennyezet	Noun
finanszírozásba	Noun
programozásról	Noun
szesszel	Noun
deciméter	Noun
gyengénlátóról	Noun
karaktereknek	Noun
megjelentetéstől	Noun
pápán	Noun
megfogalmazásába	Noun
hobbiként	Noun
kivitelezéséért	Noun
hegesztenek	Verb
elírások	Noun
karácsonyéjeknek	Noun
jellemzik	Verb
adattípusokat	Noun
pályafutásától	Noun
forralnunk	Verb
elveszni	Verb
robbanásról	Noun
kihasználtak	Verb
zenekarnál	Noun
tevékenységük	Noun
mételyek	Noun
kalendáriumok	Noun
lelkesít	Verb
melírokban	Noun
attraktívból	Noun
fejéhez	Noun
vállakból	Noun
folytatásáról	Noun
lakcímet	Noun
letartóztatnak	Verb
árnyékot	Noun
szellemére	Noun
spekulációnál	Noun
transzformációkban	Noun
tartóssá	Noun
egyenlőségből	Noun
bombázónak	Noun
rádióhoz	Noun
előállítani	Verb
közelíteni	Verb
hivatkoztunk	Verb
válástól	Noun
kellemetlenségekért	Noun
ültetvényekkel	Noun
kulcsfontosságúvá	Noun
rendjéről	Noun
búzát	Noun
életkort	Noun
elmondások	Noun
xeroxhoz	Noun
baklövés	Noun
megállóhoz	Noun
illetékekkel	Noun
munkavédelmi	Noun
fogalmakról	Noun
utcaseprők	Noun
elemén	Noun
hintik	Verb
oxidot	Noun
gőzhajókat	Noun
környezetvédőkre	Noun
maszlag	Noun
észrevételévé	Noun
kurdok	Noun
szorzást	Noun
centripetálisért	Noun
ananászokhoz	Noun
befejezzék	Verb
pletykafészkekig	Noun
Magyarországban	Noun
jógáért	Noun
terápiásat	Noun
libidó	Noun
tragédiákat	Noun
sablonoktól	Noun
változásából	Noun
ellenségeknek	Noun
molibdén	Noun
kiválasztok	Verb
rablástól	Noun
délibábot	Noun
innovatívabbakat	Noun
bulin	Noun
iskoláért	Noun
képzeli	Verb
átismételned	Verb
vélünk	Verb
szigetekkel	Noun
királytól	Noun
vitorlázásban	Noun
atombombára	Noun
kását	Noun
tan	Noun
offenzívában	Noun
jövendőmondók	Noun
újságíróknak	Noun
dokkok	Noun
alternatívára	Noun
élmények	Noun
fokának	Noun
elintézték	Verb
modelljének	Noun
cselekedetektől	Noun
közlekedtünk	Verb
gyereket	Noun
döntésben	Noun
csillagtérképet	Noun
cifra	Noun
gyógynövény	Noun
közüzemek	Noun
alkosson	Verb
elárulta	Verb
fajtájával	Noun
idegenforgalomból	Noun
küzdelemért	Noun
atomfegyverrel	Noun
tároljunk	Verb
melódiákkal	Noun
terápián	Noun
komolyabban	Noun
pályafutásáért	Noun
felkéréseket	Noun
akaratokról	Noun
baltákat	Noun
felszínig	Noun
világukba	Noun
résben	Noun
légierőn	Noun
legszelesebbért	Noun
csempészetből	Noun
ágyún	Noun
filozófusokkal	Noun
nyilatkozniuk	Verb
területeire	Noun
algoritmusokban	Noun
pontját	Noun
mennydörgés	Noun
táblával	Noun
táblázattal	Noun
gerely	Noun
beöltöznötök	Verb
taoizmushoz	Noun
infravörös	Noun
gemkapocs	Noun
burnótokon	Noun
együtthatónak	Noun
jobbágyokra	Noun
felhámokért	Noun
utalni	Verb
hitelességekkel	Noun
rögnél	Noun
taglalná	Verb
rendszerváltásban	Noun
védekezzen	Verb
elnyerik	Verb
botránynak	Noun
tojnak	Verb
visszajelzésre	Noun
utálták	Verb
békeszerződésekkel	Noun
főtitkárral	Noun
szegényesen	Noun
logikában	Noun
módszereiről	Noun
részeiket	Noun
túlnépesedést	Noun
chipektől	Noun
főneveknek	Noun
fn.-ekkel	Noun
nyomozva	Converb
állandósul	Verb
közalkalmazottak	Noun
weboldalnak	Noun
elhízások	Noun
makramékat	Noun
pikánsról	Noun
lelkemnek	Noun
testvérekkel	Noun
gyógyszermérgezésből	Noun
határozott	Noun
elrabolnod	Verb
feltárására	Noun
technológia	Noun
hitelkártyától	Noun
ötletbe	Noun
kötőjelek	Noun
szegényben	Noun
műértőtől	Noun
közösülés	Noun
ornitológiákig	Noun
műszak	Noun
feladatában	Noun
szarvak	Noun
kellemesbe	Noun
összehasonlítsuk	Verb
szatócs	Noun
átneveznie	Verb
mázsákig	Noun
úszkáló	Participle
cédében	Noun
maszturbálok	Verb
lampionokká	Noun
pillangóúszásoknak	Noun
megvalósításhoz	Noun
egyszerűsít	Verb
egyéniségnek	Noun
mákkal	Noun
bolygórendszer	Noun
mosáshoz	Noun
erődítményekben	Noun
tízparancsolatban	Noun
közkincseket	Noun
tengerésznek	Noun
kifejezésnek	Noun
topográfia	Noun
germanizmus	Noun
szélhámosok	Noun
kolostorrá	Noun
egyetemektől	Noun
gasztronómiába	Noun
felújításával	Noun
helikopteren	Noun
kicserélendő	Participle
trombitákban	Noun
egyikétől	Noun
burát	Noun
lázadással	Noun
felülvizsgálatát	Noun
pulykakeselyű	Noun
találmányokról	Noun
gyalu	Noun
sövényeket	Noun
arábiaiakig	Noun
megbízásokkal	Noun
hangmérnököknek	Noun
felmosandó	Participle
virágárusok	Noun
csatlakozásban	Noun
harmonikákat	Noun
piacban	Noun
őssejteknek	Noun
kötetesre	Noun
napszemüveg	Noun
uralommal	Noun
legnagyobbaknál	Noun
kiemeltté	Noun
eléréséért	Noun
fiatalabbakként	Noun
fürdőnek	Noun
aeroszolokat	Noun
tanítják	Verb
státusszimbólumokká	Noun
döntésbe	Noun
szavazna	Verb
tempó	Noun
újszülöttet	Noun
szemléletekbe	Noun
fújták	Verb
helikopterekről	Noun
elviselte	Verb
fohász	Noun
halálbüntetések	Noun
üzenetbe	Noun
család	Noun
tudományosabbon	Noun
rovarcsípésekért	Noun
négyzetszámokhoz	Noun
legnépszerűbbek	Noun
énekkart	Noun
többségnél	Noun
városaként	Noun
kijöjjön	Verb
újításokba	Noun
hazugságra	Noun
irányelvnél	Noun
röhögve	Converb
övbe	Noun
befolyásos	Noun
gondviselések	Noun
prolongálnék	Verb
válaszoljatok	Verb
megélhetésekben	Noun
építkezésekbe	Noun
csempésszen	Verb
makramé	Noun
műtőt	Noun
sámánná	Noun
irányítószám	Noun
lepedőket	Noun
listákról	Noun
eseménnyel	Noun
létezéséből	Noun
tényezőkkel	Noun
elragadtattuk	Verb
javaslatnak	Noun
egyenjogúságért	Noun
rizshez	Noun
fertőzésre	Noun
becsesre	Noun
házimacskával	Noun
értelmetlenek	Noun
szükségtelennek	Noun
dala	Noun
patronázsokon	Noun
termelésnek	Noun
kristálytiszta	Noun
reklámok	Noun
megtelni	Verb
értesítettem	Verb
édesvizekben	Noun
apanázs	Noun
megrendeltünk	Verb
jelöléseket	Noun
fejűek	Noun
napernyőkön	Noun
egyeztünk	Verb
elviselhetetlenre	Noun
szövegértéssel	Noun
tipp	Noun
viszonnyal	Noun
városfejlesztésre	Noun
megnövekedniük	Verb
csapattól	Noun
árpát	Noun
iparágak	Noun
áttekintésben	Noun
gombafélébe	Noun
ideálok	Noun
akcióterv	Noun
etikával	Noun
mentőautók	Noun
sérüljön	Verb
romantikának	Noun
etánból	Noun
kérelmét	Noun
markolatként	Noun
kezdeményezéséhez	Noun
infrastrukturálisig	Noun
kíváncsibbaknál	Noun
vasútállomásról	Noun
pórus	Noun
kulikban	Noun
termelés	Noun
jelképes	Noun
figyelek	Verb
aszkéta	Noun
arrogánsakkal	Noun
analógiának	Noun
passzivitásba	Noun
gyógyszerkönyvekben	Noun
szeparatizmusnak	Noun
utóbbival	Noun
ceruzatartókhoz	Noun
csinnadrattából	Noun
fájlokhoz	Noun
alkotásához	Noun
őskorban	Noun
elméletben	Noun
egereken	Noun
leírásához	Noun
látogatónak	Noun
sajátosságot	Noun
folyótorkolat	Noun
művésszé	Noun
végezzek	Verb
gimnáziumnak	Noun
vonzzon	Verb
borogatást	Noun
kiadásokat	Noun
szennyezi	Verb
hídba	Noun
bukáshoz	Noun
mosónőkért	Noun
festmények	Noun
céllövöldékre	Noun
tüskékkel	Noun
mielőbbiekért	Noun
kételkedéshez	Noun
befektetőket	Noun
lyukasztó	Participle
poszterek	Noun
világháborúról	Noun
dobostortáktól	Noun
népdalról	Noun
örökségek	Noun
szervezetről	Noun
telepesként	Noun
közöttit	Noun
köztársaság	Noun
kapacitása	Noun
popzenétől	Noun
szerelje	Verb
fájlokban	Noun
múzeumot	Noun
plazmával	Noun
alkotják	Verb
hőséről	Noun
júniusának	Noun
emberre	Noun
kötésekben	Noun
vonítana	Verb
tisztázta	Verb
leadtak	Verb
visszhangok	Noun
körülményeinek	Noun
fűrészbe	Noun
kódját	Noun
másolatán	Noun
biztosítására	Noun
megszerzésben	Noun
tárcámtól	Noun
alkalmazásával	Noun
legéberebbeken	Noun
emlékeztették	Verb
repülőket	Noun
egyeztessen	Verb
sörökhöz	Noun
hajléktalanságban	Noun
gépkocsiiparokként	Noun
ötszöget	Noun
helyből	Noun
betegségében	Noun
megtanuljon	Verb
embrió	Noun
tanulmányoknak	Noun
beidézze	Verb
falukban	Noun
használatban	Noun
képesebbtől	Noun
dkg-nál	Noun
veszítve	Converb
szenet	Noun
dalszerzők	Noun
átírnia	Verb
reménytelennek	Noun
ceruzákon	Noun
ligatúrák	Noun
behozatal	Noun
kijelzőként	Noun
pálcikákként	Noun
kezdeményezésekről	Noun
konformizmus	Noun
áramlatokhoz	Noun
alagútnak	Noun
ecsetelte	Verb
borítóknál	Noun
borokra	Noun
horogkereszttel	Noun
felsorolta	Verb
vérnyomáson	Noun
leírásánál	Noun
temperamentum	Noun
lárvát	Noun
óvodás	Noun
gyászoljon	Verb
szótárakban	Noun
maharadzsa	Noun
többségébe	Noun
hátteréhez	Noun
napfényen	Noun
csokoládétortáktól	Noun
szabályaihoz	Noun
legegészségesebbekbe	Noun
apasággal	Noun
repülőgépet	Noun
mellkason	Noun
magnéziumban	Noun
térképészet	Noun
hiányoló	Participle
rövidítésről	Noun
granulátum	Noun
ütközeteket	Noun
maszkra	Noun
továbbítjuk	Verb
bohócot	Noun
harapásoktól	Noun
gátlókkal	Noun
folyamatoknál	Noun
házukban	Noun
rómainak	Noun
mezőgazdasággal	Noun
tárlatért	Noun
inverzzel	Noun
tévedjen	Verb
terjesszék	Verb
állandónak	Noun
szabálysértés	Noun
zenétől	Noun
kulturáltnál	Noun
testvérrel	Noun
alkalmak	Noun
árukat	Noun
gyógyszerhatástan	Noun
költségvetésről	Noun
akrobatikus	Noun
bétákra	Noun
felkínálandó	Participle
kivégzőosztag	Noun
gyászolna	Verb
földrengés	Noun
ultikkal	Noun
takarmánnyal	Noun
bácsihoz	Noun
együttesnek	Noun
búb	Noun
miriggyel	Noun
szabványokat	Noun
folytatásából	Noun
szárat	Noun
államszövetségekre	Noun
jobbal	Noun
megnyugodnod	Verb
megszerzésért	Noun
kúpok	Noun
megcsodálj|or|	Verb
csésze	Noun
agyarral	Noun
stúdiókat	Noun
rendszámtáblába	Noun
beszélgetésekre	Noun
festékből	Noun
módját	Noun
krónikában	Noun
manuális	Noun
válással	Noun
megmented	Verb
kockáztató	Participle
szintézist	Noun
megelőzniük	Verb
szekvenciákat	Noun
személyiségként	Noun
kamrákba	Noun
utolérjenek	Verb
nyugalomról	Noun
áttörésekből	Noun
teherhajó	Noun
megfoghatatlanokhoz	Noun
kiskorúakra	Noun
ruhánk	Noun
gravitációkról	Noun
díszítéstől	Noun
sorra	Noun
bírsz	Verb
szólamot	Noun
manipulációt	Noun
gárdának	Noun
kialakulásán	Noun
intoleranciával	Noun
hajóval	Noun
veszíti	Verb
csigolyát	Noun
önfejűig	Noun
árfolyamra	Noun
ürülő	Participle
zabba	Noun
előnyön	Noun
együttesévé	Noun
határokkal	Noun
megpróbálsz	Verb
elsajátításán	Noun
kendőbe	Noun
tördeli	Verb
rámutatva	Converb
lépéshez	Noun
előírásokkal	Noun
fogselyemhez	Noun
benzolokért	Noun
előirányzattá	Noun
stricheljünk	Verb
pajzs	Noun
vásárlókhoz	Noun
örömről	Noun
balesetnél	Noun
tételével	Noun
zsugorító	Participle
balítéletekig	Noun
térfogatot	Noun
atletikus	Noun
hullamerevség	Noun
módosítandó	Participle
golyón	Noun
hatalommá	Noun
nagyfokú	Noun
hírességhez	Noun
kanton	Noun
nemzedékekre	Noun
motorkerékpárt	Noun
dokkban	Noun
elvágó	Participle
ikrából	Noun
feszülő	Participle
apróságokra	Noun
zsúfoltság	Noun
zsaru	Noun
ismertette	Verb
kettősségben	Noun
bátrabban	Noun
fordítók	Noun
idiótákat	Noun
molekulákon	Noun
válaszoljon	Verb
o.-ak	Noun
tűzfalhoz	Noun
egyesületről	Noun
zöldkártya	Noun
randevúznátok	Verb
cumiról	Noun
tömeggyártásokkal	Noun
csábítást	Noun
eltérőbbről	Noun
sztyepp	Noun
mocskosként	Noun
látomás	Noun
sarkának	Noun
teherautóban	Noun
verseiben	Noun
jeléből	Noun
pestisjárványokhoz	Noun
homokvihar	Noun
részleteiről	Noun
közmondás	Noun
aránynál	Noun
fogamzás	Noun
aranykeretből	Noun
tarkónál	Noun
választással	Noun
lelkész	Noun
szerkezetként	Noun
finanszíroznak	Verb
pletykalapok	Noun
állampolgárságot	Noun
létrehozás	Noun
elmondásának	Noun
állatidomárról	Noun
színésztől	Noun
globalizációval	Noun
indulat	Noun
fogyasztásából	Noun
védelméig	Noun
zsinatokon	Noun
élménynek	Noun
andrisnak	Noun
felhatalmaztunk	Verb
kőzettan	Noun
fürtben	Noun
nyomozóknak	Noun
mechanizmusra	Noun
csibék	Noun
kutatásának	Noun
elkerülését	Noun
romától	Noun
kambiumokká	Noun
kísértem	Verb
jutalmat	Noun
versenyeznie	Verb
vádoltam	Verb
közösségekkel	Noun
csizmákig	Noun
kezeléseken	Noun
körön	Noun
csillagtökről	Noun
tudományokkal	Noun
zajos	Noun
szülőföldre	Noun
szárazföldről	Noun
igazgat	Verb
eredményekről	Noun
községektől	Noun
telefont	Noun
ellenzékben	Noun
mozaikként	Noun
megfigyeléseken	Noun
érzelmekként	Noun
pulzárból	Noun
irányították	Verb
állomásokból	Noun
szabályozásának	Noun
állományról	Noun
eljutok	Verb
hazának	Noun
latnál	Noun
testvért	Noun
vesekővé	Noun
mellemnél	Noun
növényektől	Noun
verbéna	Noun
autentikusra	Noun
bever	Verb
gyarmatokról	Noun
lényegéről	Noun
tisztviselőkhöz	Noun
szavazatok	Noun
múzeumba	Noun
zsilippel	Noun
törlésnél	Noun
balettcipő	Noun
hosszút	Noun
generációnál	Noun
nyakánál	Noun
kibocsátások	Noun
földtudományokban	Noun
tárgyalták	Verb
terhelje	Verb
hadnagyra	Noun
műszeren	Noun
fogyatkozni	Verb
elképzelték	Verb
fűtik	Verb
arcodon	Noun
ruhákig	Noun
idegrendszert	Noun
termésen	Noun
kifejezések	Noun
szemetelne	Verb
elkövetőnek	Noun
megkoronázva	Converb
posztert	Noun
doktorok	Noun
tünetekre	Noun
korcsolyázásnak	Noun
egyeztetés	Noun
külügyminisztériumba	Noun
kiderítsék	Verb
fogkefék	Noun
centrifugálisat	Noun
gondolatától	Noun
harsona	Noun
portálokra	Noun
panaszokkal	Noun
ráncnak	Noun
alelnökkel	Noun
aluliak	Noun
offenzívának	Noun
lakótelepekkel	Noun
összeállítanál	Verb
sókat	Noun
tartozásokat	Noun
magyarázatok	Noun
decemberéből	Noun
gondolataival	Noun
kóddá	Noun
összetételként	Noun
minisztériumra	Noun
ragyognak	Verb
másolat	Noun
agyhártyagyulladásokért	Noun
javaslatait	Noun
munkahelyről	Noun
háborúknak	Noun
rubel	Noun
szabadságán	Noun
tempóból	Noun
kőbányaként	Noun
látszerész	Noun
feldolgozásán	Noun
exportálta	Verb
szabályokkal	Noun
szalámin	Noun
felvétel	Noun
hasábokon	Noun
lépéssel	Noun
játszmák	Noun
pontosabbá	Noun
kimondod	Verb
főszereplővé	Noun
kóborol	Verb
kitörtem	Verb
bedobni	Verb
máglyarakásokkal	Noun
agyonütné	Verb
betonba	Noun
akkumulátorokról	Noun
bevásárlóközpont	Noun
kertjével	Noun
üldögélve	Converb
szerkezetét	Noun
mosolygás	Noun
kocsmákkal	Noun
eddigit	Noun
szellemeinél	Noun
megállókból	Noun
piacgazdaságokban	Noun
poggyászban	Noun
tatára	Noun
bowlingozni	Verb
hozzáférés	Noun
vésel	Verb
hozzájárulásából	Noun
jelentéseket	Noun
metélőhagymára	Noun
pszichológiáról	Noun
konyhában	Noun
gárdánál	Noun
állapotok	Noun
karjában	Noun
polgárság	Noun
kiemelttel	Noun
súlyokig	Noun
zivatar	Noun
aranyhörcsögnek	Noun
érvényt	Noun
kérdésemről	Noun
tartománynak	Noun
szárnyhoz	Noun
szentélyekhez	Noun
paradoxonok	Noun
szabóizomban	Noun
veszítik	Verb
szokványosakként	Noun
megállapításáról	Noun
tőről	Noun
kétharmadra	Noun
házakra	Noun
bulira	Noun
statisztikáknál	Noun
változóból	Noun
kategorizáljunk	Verb
tesztelésben	Noun
vakolatokon	Noun
sötétségeken	Noun
kiválasztva	Converb
habköveknél	Noun
számítógépekkel	Noun
hihetetlen	Noun
dinamitoknál	Noun
hangsúly	Noun
központként	Noun
fentiekre	Noun
pénzintézetek	Noun
emeljünk	Verb
hallószervekről	Noun
megkezdődnek	Verb
kéklő	Participle
architektúrák	Noun
garantírozod	Verb
debütánsoknál	Noun
pecséten	Noun
feláll	Verb
tálak	Noun
szakirodalomra	Noun
szavazást	Noun
bővebbek	Noun
felhőkarcolót	Noun
szerelőbe	Noun
elvágniuk	Verb
csírára	Noun
színésznő	Noun
ápolásinak	Noun
ártányokként	Noun
leányoknak	Noun
kideríteni	Verb
kamarából	Noun
legyőzendő	Participle
kristálytisztáktól	Noun
utóbbiról	Noun
íjnak	Noun
kedvezve	Converb
manipulálni	Verb
partba	Noun
elmegyógyintézetből	Noun
bámulatra	Noun
alapból	Noun
válaszoltok	Verb
felperes	Noun
cselekedettel	Noun
juhoknak	Noun
megfojtják	Verb
kanyaró	Noun
szimbólum	Noun
megkezdésénél	Noun
őrmesterekről	Noun
szélörvények	Noun
fénytanokról	Noun
képviselőből	Noun
befolyások	Noun
papírokon	Noun
itala	Noun
hajóidon	Noun
időrendibe	Noun
honlapjával	Noun
tinták	Noun
romában	Noun
hajlamokkal	Noun
tejszínhab	Noun
neveléssel	Noun
meghűlést	Noun
anyagokba	Noun
versének	Noun
gombócot	Noun
évezrednél	Noun
blokkolok	Verb
hivatalon	Noun
szintjénél	Noun
aszalt	Noun
törléseknek	Noun
kérdések	Noun
képen	Noun
szerkezeteit	Noun
tengernagyot	Noun
konszenzusra	Noun
kazánokba	Noun
vélemény	Noun
földbirtokossá	Noun
napfényre	Noun
mocsarakat	Noun
fakír	Noun
fogékonyaknak	Noun
agronómusok	Noun
útmutatón	Noun
megszerezni	Verb
ásatásnál	Noun
vágányokon	Noun
rendjéért	Noun
együttest	Noun
vasaljak	Verb
teljesítményre	Noun
törvénykezésig	Noun
népsűrűséget	Noun
tealevelek	Noun
mocsárrá	Noun
karjának	Noun
felszabadítsa	Verb
listákkal	Noun
piperkőcön	Noun
szállítóktól	Noun
töltelékhez	Noun
kipákért	Noun
kincsekkel	Noun
ügyesen	Noun
munkájuknak	Noun
sáncot	Noun
januárjáig	Noun
mokasszinokként	Noun
próbáknál	Noun
szokásokra	Noun
szélviharok	Noun
korosztályhoz	Noun
botránnyal	Noun
szervesen	Noun
álmodtam	Verb
tánczenéhez	Noun
nyomozásba	Noun
tanácsokat	Noun
bírókat	Noun
feliratokból	Noun
beszélővel	Noun
aszkétát	Noun
szórakoztam	Verb
vakolat	Noun
klubbal	Noun
visszaélő	Participle
hajszálon	Noun
szerdai	Noun
patkányoknak	Noun
terasz	Noun
megtaláltok	Verb
követésének	Noun
antiszeptikumokra	Noun
felhasználásig	Noun
zselatinnal	Noun
kimondó	Participle
esztendő	Noun
gyepre	Noun
indexelve	Converb
generációhoz	Noun
mezőkről	Noun
fodrászatoknak	Noun
hógömbökön	Noun
javulásoknak	Noun
látásnál	Noun
zenerajongók	Noun
hangról	Noun
űrhajósokat	Noun
fémpénz	Noun
vágányokat	Noun
hónapoknak	Noun
fokozatot	Noun
zugtól	Noun
elektromosságról	Noun
többségének	Noun
feliratkoznál	Verb
tanultad	Verb
konzulátusra	Noun
kurzusok	Noun
kísérné	Verb
elrendezve	Converb
zsakettnek	Noun
információ	Noun
betyárokként	Noun
szecessziókról	Noun
angyalok	Noun
szálloda	Noun
tisztségért	Noun
íveken	Noun
lepkéket	Noun
nyílásban	Noun
hajóknak	Noun
romokba	Noun
tömegesen	Noun
igazol	Verb
legkibírhatatlanabbá	Noun
verebek	Noun
mosdóállványokba	Noun
tanulmányhoz	Noun
elhanyagolva	Converb
csökkentésre	Noun
arányából	Noun
edzőteremben	Noun
jegybanknak	Noun
csókoltuk	Verb
parányi	Noun
altatóorvosokért	Noun
hiúság	Noun
nobélium	Noun
példa	Noun
tisztségviselőkre	Noun
áttörésben	Noun
kövér	Noun
kapcsolattartással	Noun
forráskódból	Noun
rajong	Verb
údoktól	Noun
sütjük	Verb
tüntetésekkel	Noun
járulok	Verb
irányzathoz	Noun
antimon	Noun
trikó	Noun
kötszert	Noun
csatlakoznia	Verb
térképeken	Noun
javasolnak	Verb
segglyuk	Noun
háromszög	Noun
elmeszakértőkért	Noun
irigykedni	Verb
temetések	Noun
folytatásra	Noun
szerencsésekről	Noun
fiaira	Noun
remegés	Noun
szenvedésekkel	Noun
nyelven	Noun
érdektelennek	Noun
említésként	Noun
fordulókkal	Noun
hódította	Verb
doktort	Noun
hallhatóvá	Noun
adszorpció	Noun
mélyhegedűknél	Noun
csatornákon	Noun
csoszogok	Verb
lerakódások	Noun
jelenetektől	Noun
teendőkben	Noun
elveszítettek	Verb
szereplőiről	Noun
tanokat	Noun
jeleiből	Noun
tartását	Noun
völgynél	Noun
számosságokra	Noun
szemerkélő	Participle
hősét	Noun
show-ig	Noun
idomból	Noun
vonzva	Converb
feladattól	Noun
gyötrelem	Noun
túlórába	Noun
asztronómiává	Noun
releváns	Noun
hableányt	Noun
megjelenítette	Verb
mandulával	Noun
konvencióért	Noun
emésztene	Verb
regisztrálásra	Noun
moderátoron	Noun
propagandáról	Noun
malátát	Noun
vezetőjétől	Noun
jeleneteken	Noun
elvesztéséig	Noun
értelmezésiről	Noun
alakítsák	Verb
hajóin	Noun
vonzódásokért	Noun
ésszerű	Noun
tulajdonokba	Noun
megöl	Verb
boszorkányoktól	Noun
minősítésben	Noun
legszennyezettebb	Noun
csodálatos	Noun
lépésekből	Noun
engedelmeseknél	Noun
eszközökkel	Noun
térségnek	Noun
husáng	Noun
fordulót	Noun
összeadások	Noun
képernyővel	Noun
bebizonyítsák	Verb
éhséget	Noun
őserdőkben	Noun
részvételét	Noun
testekről	Noun
agyvérzést	Noun
szárította	Verb
alkalmasabbak	Noun
műveletekhez	Noun
sípokkal	Noun
odavesznének	Verb
gleccsernél	Noun
nyelvészetekké	Noun
idejét	Noun
tudatlanságból	Noun
megállapodásra	Noun
segítségben	Noun
hírnévbe	Noun
lábfejre	Noun
porcokkal	Noun
elvárásnak	Noun
elképzeléseket	Noun
megújulás	Noun
rövidítjük	Verb
skálákat	Noun
megnyitásnak	Noun
barátaihoz	Noun
házain	Noun
hajszáleren	Noun
prófécia	Noun
csapásról	Noun
egyházszakadáshoz	Noun
munkatársaira	Noun
pixeleket	Noun
fizetség	Noun
prostituáltakról	Noun
legtudatlanabbról	Noun
tisztelet	Noun
roboráló	Participle
kiközösítik	Verb
kocsimat	Noun
engedélyt	Noun
életemben	Noun
kosarakban	Noun
pácienseket	Noun
rejtek	Verb
szószedetekből	Noun
járőrökkel	Noun
vágyakozz|or|	Verb
nemzettek	Verb
alföldek	Noun
közelítenek	Verb
glükózzá	Noun
bővítésen	Noun
lányában	Noun
egyesület	Noun
dolmány	Noun
tágabbként	Noun
fogpiszkálóktól	Noun
népmesékben	Noun
üzenetet	Noun
egységgel	Noun
esőerdővel	Noun
képviselőkre	Noun
számottevővé	Noun
fázisig	Noun
bandákba	Noun
megragadó	Participle
demoralizálta	Verb
intézményeihez	Noun
áruházból	Noun
vízszintestől	Noun
jelentéssel	Noun
hulladékban	Noun
titkosítják	Verb
pályázatnak	Noun
tornákra	Noun
zsabóknál	Noun
részesítsük	Verb
úrihoz	Noun
balzsamos	Noun
templomig	Noun
elvették	Verb
sakkból	Noun
anatómiával	Noun
vandalizmusnak	Noun
hozzászólót	Noun
tájképeket	Noun
paróka	Noun
legfáradhatatlanabbakban	Noun
kérdőívet	Noun
ügylet	Noun
baracklekvárokkal	Noun
kitölteni	Verb
érává	Noun
asztácium	Noun
bajnokságban	Noun
pukedlizunk	Verb
jetik	Noun
faragatlanokként	Noun
televízióhoz	Noun
véleményük	Noun
szükségből	Noun
panelen	Noun
padlásszobában	Noun
varangyokon	Noun
megjegyzéseket	Noun
reggelized	Verb
felbontani	Verb
anyaként	Noun
térítse	Verb
jövedelemadót	Noun
dinamitért	Noun
alakítani	Verb
jéghokiért	Noun
izzadságra	Noun
zsiráfokat	Noun
büntetőjognál	Noun
indítékból	Noun
társaságban	Noun
ignorálva	Converb
blokkolod	Verb
növésben	Noun
öblökbe	Noun
teljesítményen	Noun
sötétségből	Noun
ciklikusakkal	Noun
vigyorgunk	Verb
kötődve	Converb
kötőjelből	Noun
hangszerre	Noun
műveltségen	Noun
paralízisben	Noun
amfetaminokig	Noun
elhelyeznének	Verb
digitalizáló	Participle
pólónak	Noun
bevétel	Noun
novembere	Noun
formátumban	Noun
mészárlásban	Noun
vigyáz	Verb
kialakítaniuk	Verb
terítők	Noun
beépíti	Verb
apróbb	Noun
szellemtől	Noun
bizonyítékra	Noun
kályhához	Noun
sebtapaszoktól	Noun
szervezésért	Noun
bárszékig	Noun
múzeumokkal	Noun
rájöttek	Verb
meggyalázzunk	Verb
kapacitásban	Noun
kegyetlennek	Noun
tehetségétől	Noun
identitásra	Noun
kaja	Noun
melókhoz	Noun
adókulcsok	Noun
csapatról	Noun
elvégzésre	Noun
toleranciát	Noun
műanyaggal	Noun
vásárlókat	Noun
céloztak	Verb
váltóba	Noun
pillanatfelvételek	Noun
nyugágyakról	Noun
tanúsítottam	Verb
csalásokat	Noun
istentiszteletre	Noun
mellbőségnek	Noun
gúlákba	Noun
naivról	Noun
értékrendnek	Noun
átalakításának	Noun
antiszeptikumnál	Noun
fasírtról	Noun
levonta	Verb
geodéziákat	Noun
laborba	Noun
legdühösebbekké	Noun
szendvicsként	Noun
bejáratokat	Noun
strandpapucsról	Noun
részétől	Noun
rostok	Noun
olvasószerkesztő	Noun
basszusgitárt	Noun
pénztáros	Noun
ajánlásnak	Noun
márkákkal	Noun
mártással	Noun
behozatalokba	Noun
kompressziótól	Noun
kellette	Verb
sütivel	Noun
térdelnek	Verb
folyamatába	Noun
állvány	Noun
kovásszal	Noun
meséből	Noun
tolatni	Verb
toleranciával	Noun
törvényéhez	Noun
dicsőséges	Noun
nevesig	Noun
elektronágyú	Noun
cilinder	Noun
buddhizmuson	Noun
csárdába	Noun
próbafülkéről	Noun
sassal	Noun
hegytetőkön	Noun
eldöntendő	Participle
gyámként	Noun
felébressze	Verb
medencékből	Noun
kapocsként	Noun
szabotázst	Noun
forradalomként	Noun
ízű	Noun
finanszíroz	Verb
megkövetelő	Participle
közlemény	Noun
városházán	Noun
evangélistákat	Noun
ültetnie	Verb
visszabeszélni	Verb
kommunikálsz	Verb
otthonra	Noun
nudliért	Noun
kiépítéssel	Noun
kitüntetésként	Noun
férjemmel	Noun
jegypénztárba	Noun
hazugságokba	Noun
pechig	Noun
felállítsa	Verb
kalászt	Noun
zongoraórákat	Noun
elnökök	Noun
gázsiknak	Noun
kéziratnak	Noun
hattyúért	Noun
domborzatnak	Noun
egyezménybe	Noun
holtversenybe	Noun
felhívnia	Verb
rádiókkal	Noun
értelmetlenné	Noun
akrosztichon	Noun
növekedéseknek	Noun
szabályra	Noun
szakértőre	Noun
nehézséggel	Noun
kaikoktól	Noun
töltényekkel	Noun
megveri	Verb
korszerűbb	Noun
szigetre	Noun
infúzióban	Noun
kacagnak	Verb
autópályákról	Noun
elkülönítette	Verb
egyenértékűek	Noun
óráig	Noun
repülőkön	Noun
baglyot	Noun
bugyogóvá	Noun
felújítanak	Verb
tűzgolyók	Noun
aknámat	Noun
alkalmazástól	Noun
csuklóban	Noun
szertartást	Noun
ünnepnapokként	Noun
szaván	Noun
sikerrel	Noun
iránytűket	Noun
alsónadrágban	Noun
felügyelete	Noun
alkotmányok	Noun
madárnál	Noun
panaszkodnának	Verb
mauzóleumba	Noun
osztályvezetőkkel	Noun
felfüggessze	Verb
antifasizmus	Noun
dobozosakért	Noun
takarózna	Verb
páholyból	Noun
szabályzatokban	Noun
tulajdonságoktól	Noun
esztergomiak	Noun
beír	Verb
információkkal	Noun
rendetlenekben	Noun
felvételnek	Noun
kapitányoknak	Noun
szemüvegeket	Noun
kontárkodnunk	Verb
kihívásokkal	Noun
jubileumok	Noun
kategóriára	Noun
zsákfutásra	Noun
ápoljon	Verb
üstdobokba	Noun
katalógusba	Noun
ezredesre	Noun
antropológustól	Noun
együtthatóknak	Noun
olvasóba	Noun
szamizdatok	Noun
regényért	Noun
antibiotikumhoz	Noun
heringen	Noun
menüre	Noun
lassító	Participle
tudományt	Noun
csinálok	Verb
glükóznak	Noun
répából	Noun
épületekben	Noun
rombolni	Verb
beadó	Participle
románcokat	Noun
forráskódok	Noun
feltárásokra	Noun
fogyasztására	Noun
házelnökkel	Noun
parazitákkal	Noun
emlékével	Noun
réseken	Noun
letöltésért	Noun
összeszedik	Verb
tervvel	Noun
palládiumból	Noun
kéz	Noun
tapasztalatlanságnak	Noun
illusztrációkkal	Noun
leletnek	Noun
hibáin	Noun
ponttá	Noun
intézetben	Noun
megadásig	Noun
zargatni	Verb
jelentkezve	Converb
növesztették	Verb
kedved	Noun
stressznek	Noun
nevéből	Noun
tisztázták	Verb
emberrel	Noun
trófeával	Noun
köszönetet	Noun
merényletnek	Noun
eredményeiben	Noun
eltérésnél	Noun
ízét	Noun
életrajzokban	Noun
akcióba	Noun
villamosvonalon	Noun
kutakhoz	Noun
fellépés	Noun
bálokra	Noun
tárcsázniuk	Verb
zúztak	Verb
bemutatásából	Noun
ugrassák	Verb
drágán	Noun
mameluk	Noun
időszámításról	Noun
kvantummechanikáktól	Noun
pária	Noun
bátyjától	Noun
irányításáért	Noun
generációra	Noun
kólát	Noun
lelkészeket	Noun
szakközépiskolában	Noun
halmazból	Noun
megfogni	Verb
többnyelvű	Noun
cikkért	Noun
városiasítsak	Verb
gyermekről	Noun
bányában	Noun
növesztettek	Verb
méltóként	Noun
hölgyekről	Noun
logikával	Noun
személyeknél	Noun
szerkesztés	Noun
építőiparra	Noun
eljutunk	Verb
zárolták	Verb
eszközre	Noun
előterjesztést	Noun
közelmúltig	Noun
igazoló	Participle
vacogtál	Verb
ügyfélből	Noun
dominálni	Verb
dátumon	Noun
forintokhoz	Noun
rendőrkapitányságok	Noun
kompenzációt	Noun
lakomákban	Noun
prosti	Noun
majorban	Noun
központokban	Noun
kórtermen	Noun
csontszövet	Noun
közalkalmazott	Noun
megbüntetitek	Verb
szerepre	Noun
rehabilitációval	Noun
bűnnel	Noun
üldöztek	Verb
karrierjénél	Noun
összehasonlítja	Verb
megszűnése	Noun
ideálisak	Noun
bekövetkeznie	Verb
scripthez	Noun
szenátoroknak	Noun
emberben	Noun
környékével	Noun
lelkészt	Noun
hivatalnokot	Noun
arachnofóbiáktól	Noun
mellékhatásokról	Noun
táboroznak	Verb
századokra	Noun
aláírását	Noun
mennyiségekben	Noun
panaszkodó	Participle
szentélyekben	Noun
stílusok	Noun
bojárt	Noun
tapaszok	Noun
zajt	Noun
végrehajtást	Noun
folytatódjon	Verb
tudásukkal	Noun
átlagosat	Noun
készítmények	Noun
vádakkal	Noun
okirattal	Noun
nyirokrendszerig	Noun
halálának	Noun
aranymetszés	Noun
elhelyeznie	Verb
ragasztószalagoknál	Noun
bált	Noun
sietnie	Verb
evangéliumokhoz	Noun
személyzetnél	Noun
kápolnákat	Noun
szemszögéből	Noun
intellektuálisak	Noun
szabálytalanságra	Noun
jeleként	Noun
belügyminisztériumtól	Noun
kiválasztotta	Verb
frissülő	Participle
püspöksüvegekért	Noun
viszonyokat	Noun
telepítésiekért	Noun
özvegytől	Noun
mormotának	Noun
pápában	Noun
függönybe	Noun
helyszínről	Noun
ringassatok	Verb
ezüstlakodalomig	Noun
szőkítsünk	Verb
termelékenységekről	Noun
kereskedőkhöz	Noun
skálának	Noun
tetováló	Participle
elemzésébe	Noun
delegáció	Noun
rögökre	Noun
pályázatra	Noun
magatartásban	Noun
hangig	Noun
körülményekkel	Noun
járványról	Noun
mátrixokká	Noun
pörögtek	Verb
gyermekéből	Noun
hűtöttünk	Verb
berendezések	Noun
beltérinél	Noun
kölyköt	Noun
látogatóként	Noun
nézetekben	Noun
blamáljatok	Verb
hadműveletből	Noun
szakítsanak	Verb
akadálytalanként	Noun
következetesekkel	Noun
laptoppal	Noun
felhasználókról	Noun
vasárnapinál	Noun
mozgásból	Noun
adómentességgel	Noun
népen	Noun
öltönyökre	Noun
visszavontad	Verb
apoplexiává	Noun
elváltaknak	Noun
tisztáztam	Verb
napilapokban	Noun
szakmával	Noun
paralízisről	Noun
bordélyházakként	Noun
kenyérből	Noun
gondnok	Noun
antibiotikumoknak	Noun
elhúznod	Verb
tartósakig	Noun
tüntetés	Noun
víziló	Noun
beköltöző	Participle
kezéért	Noun
családot	Noun
regisztrálás	Noun
szónoknak	Noun
örökölnöd	Verb
fájlként	Noun
partokra	Noun
eredményéből	Noun
elküldve	Converb
bűzt	Noun
társulásokról	Noun
beléptem	Verb
szervezetedből	Noun
országára	Noun
axonok	Noun
előbbi	Noun
oktató	Noun
sormintává	Noun
környéknek	Noun
szigeteli	Verb
megtekintésről	Noun
önkormányzatokra	Noun
fényképekből	Noun
otkolonokban	Noun
várólistákként	Noun
exonokhoz	Noun
kötelezettséget	Noun
felhasználóbarátra	Noun
vevőre	Noun
gyűjtőként	Noun
diszkriminálni	Verb
kérgen	Noun
leírása	Noun
előadóknál	Noun
borsó	Noun
tájékoztatót	Noun
verejtékeznének	Verb
lucfenyőből	Noun
megjelenésig	Noun
misszióról	Noun
fertőzésektől	Noun
tanítja	Verb
államfőből	Noun
gitárokra	Noun
testületben	Noun
legsúlyosabb	Noun
lélekként	Noun
darálni	Verb
végződtek	Verb
válságban	Noun
kernelek	Noun
hajviselettel	Noun
pofonokkal	Noun
nyelvieknél	Noun
adatbázissal	Noun
célról	Noun
gyűlölnie	Verb
operaként	Noun
hajókról	Noun
lassulnak	Verb
szelektálta	Verb
akadó	Participle
hősökké	Noun
nőinek	Noun
gondjaiba	Noun
jogszabályokból	Noun
népesekkel	Noun
szállodába	Noun
emóciók	Noun
útmutatókkal	Noun
bizonytalanságot	Noun
szökésekig	Noun
nyilvánosságoknál	Noun
cselt	Noun
családtagok	Noun
fennállásnak	Noun
papagájok	Noun
szőlőben	Noun
utánégetőt	Noun
ker.-ből	Noun
arccal	Noun
szabadalom	Noun
korlátozásra	Noun
hadjáratokból	Noun
bokrokról	Noun
kétkötetesért	Noun
zavaroknak	Noun
flambírozták	Verb
színésznőhöz	Noun
értékűekben	Noun
átneveznem	Verb
hátának	Noun
ágyába	Noun
konzolokban	Noun
levelét	Noun
metrókat	Noun
mezőgazdaságba	Noun
utazósebességeknél	Noun
tanácskozást	Noun
hátteret	Noun
bűnbánattal	Noun
vitorlát	Noun
szövetben	Noun
hasonlóságra	Noun
sétányra	Noun
belügyekben	Noun
társaságokba	Noun
kékeljenek	Verb
pótlék	Noun
különöseknek	Noun
fodrászok	Noun
levegőt	Noun
apostol	Noun
kísérni	Verb
fiatalabbaknak	Noun
dobverő	Noun
famíliának	Noun
kellőeken	Noun
lényegiekig	Noun
szintjével	Noun
tudománnyal	Noun
püspökökre	Noun
ütésektől	Noun
szemöldökökből	Noun
katedrálisok	Noun
inverz	Noun
átadunk	Verb
hattyúnak	Noun
sírkővel	Noun
palacsintákkal	Noun
zártakba	Noun
borról	Noun
pikáns	Noun
szórakozzon	Verb
vitat	Verb
gödör	Noun
érdekektől	Noun
pályára	Noun
őrzik	Verb
szépnek	Noun
verziójáról	Noun
államtitkároknak	Noun
igazságtalanoknak	Noun
billenniük	Verb
hozzáadásához	Noun
pénztárgépek	Noun
koncentrálunk	Verb
akim	Noun
lámpafénynél	Noun
jövök	Verb
székesegyházakhoz	Noun
legédesebb	Noun
sorát	Noun
frigyet	Noun
analógiákon	Noun
betörőket	Noun
szülőtől	Noun
márványból	Noun
miniszoknyává	Noun
fürdőkádként	Noun
titrálniuk	Verb
szigonnyal	Noun
listát	Noun
föderációval	Noun
segítésével	Noun
ismétlődve	Converb
nagyságáról	Noun
ködhöz	Noun
felelős	Noun
puma	Noun
hangokra	Noun
tűvel	Noun
harácsoljak	Verb
fájdalomhoz	Noun
elkerülhetetlenné	Noun
fehérjének	Noun
árokra	Noun
ügyességre	Noun
mitokondriumokba	Noun
összefüggésből	Noun
tarlatánba	Noun
fővároson	Noun
szokatlannak	Noun
megnyílni	Verb
szülésig	Noun
rendőrnőkről	Noun
parkba	Noun
bábok	Noun
kutyától	Noun
egyenruhán	Noun
felbontunk	Verb
pápánál	Noun
konzerválok	Verb
égtájhoz	Noun
örökölték	Verb
megdorgáltatok	Verb
nyilakra	Noun
lebonyolítást	Noun
korszakokból	Noun
metrót	Noun
díszként	Noun
torzítják	Verb
bekezdéséhez	Noun
kandúrral	Noun
tűzgolyókat	Noun
hitvallásban	Noun
cikloisnak	Noun
kötésekkel	Noun
csillapítják	Verb
lépésére	Noun
laptopokig	Noun
érdektelenné	Noun
szervezethez	Noun
vendégszeretet	Noun
partokig	Noun
kivételektől	Noun
vádolsz	Verb
sellőként	Noun
jutalmazták	Verb
hatmillióra	Noun
befejezte	Verb
megnyugtatják	Verb
könyvespolcon	Noun
válást	Noun
pajeszokban	Noun
lelkem	Noun
razziáért	Noun
szegénységről	Noun
átalakulásokat	Noun
csatornák	Noun
bajadér	Noun
kolbászok	Noun
elkészíti	Verb
elbűvöli	Verb
jogorvoslatot	Noun
marsallnak	Noun
melót	Noun
feltesszük	Verb
bemutatójáról	Noun
nemiről	Noun
dolgotokként	Noun
kémiába	Noun
zagyválták	Verb
közepében	Noun
főiskolává	Noun
magánytól	Noun
legszándékosabbaktól	Noun
legdrágábbakkal	Noun
fejlesztéseként	Noun
hallgatóhoz	Noun
gusztustalan	Noun
nyilvánító	Participle
szemről	Noun
gyakorlat	Noun
sebzésből	Noun
pulyka	Noun
felépítését	Noun
hamvazószerda	Noun
kérded	Verb
lemosó	Participle
ingerlékeny	Noun
árbocba	Noun
berakás	Noun
igazgatóval	Noun
producerekkel	Noun
képeit	Noun
misével	Noun
önvédelemből	Noun
körülíró	Participle
borongósakként	Noun
karosszériát	Noun
fejükről	Noun
székhelyének	Noun
gyatrán	Noun
vetítésnek	Noun
infrastruktúrán	Noun
megújulást	Noun
irodával	Noun
szabályozásoknak	Noun
áttörésnél	Noun
írásaival	Noun
székhelyével	Noun
leépítéseket	Noun
mezőgazdaságon	Noun
helyektől	Noun
parancsnokok	Noun
legizgalmasabbtól	Noun
meditálna	Verb
hóembert	Noun
bérelni	Verb
vonatként	Noun
robbanásokat	Noun
sók	Noun
megakadályozniuk	Verb
belgával	Noun
tanulókért	Noun
kedvezőbbekkel	Noun
angolkór	Noun
privilégium	Noun
üdvig	Noun
kiemeltre	Noun
céltól	Noun
minőségét	Noun
démonokról	Noun
korlátozva	Converb
viszonylatokat	Noun
legkiolthatatlanabbakig	Noun
tömegig	Noun
istentisztelet	Noun
kosztümben	Noun
csapadéktól	Noun
irányulnak	Verb
hivatal	Noun
rózsa	Noun
elbeszéli	Verb
jogszabályokra	Noun
vitassa	Verb
elmozdíthatatlan	Noun
borotokról	Noun
malterre	Noun
trendnek	Noun
meghajtókat	Noun
tanúk	Noun
tokáktól	Noun
pasához	Noun
egyetértenek	Verb
feleletek	Noun
fenék	Noun
közösülésre	Noun
bükkből	Noun
kultúrává	Noun
fedelesig	Noun
titkosszolgálatok	Noun
pirosaknak	Noun
feleljek	Verb
körzettel	Noun
formátumhoz	Noun
sorrendet	Noun
védjegyek	Noun
fajjal	Noun
skalpoktól	Noun
összefüggésekbe	Noun
kilogrammal	Noun
szakszervezeteket	Noun
naphoz	Noun
fázisokra	Noun
pirosra	Noun
hosszúlépéseket	Noun
rögzítjük	Verb
ebihalig	Noun
stimulációhoz	Noun
tulajdonnevekből	Noun
szövetsége	Noun
felülettel	Noun
utolsót	Noun
legismerősebbekkel	Noun
létesítés	Noun
atlétikaihoz	Noun
nézetekkel	Noun
elrabol	Verb
fertőzést	Noun
következményétől	Noun
kenotáfiumtól	Noun
lepték	Verb
kultúrájába	Noun
sugározva	Converb
névnapot	Noun
elérés	Noun
sugárból	Noun
kifejlesztettek	Verb
csúcstechnológiáktól	Noun
eltávozást	Noun
kifizesse	Verb
csapatért	Noun
elképzelte	Verb
embernél	Noun
határok	Noun
hiányában	Noun
kódhoz	Noun
határértékek	Noun
kígyászért	Noun
versére	Noun
pusztítják	Verb
honfoglalásban	Noun
pirosítottak	Verb
karrier	Noun
aláírásokon	Noun
folytatáson	Noun
megrongáltak	Verb
erények	Noun
csokikkal	Noun
imádságról	Noun
kommentálták	Verb
kontextusba	Noun
bubira	Noun
kisebbségekhez	Noun
csillagrendszereken	Noun
naplemente	Noun
autóversenyzőkhöz	Noun
elérkeztünk	Verb
robbanékony	Noun
őrizte	Verb
árvaház	Noun
sógornő	Noun
fordulatszámmérőért	Noun
transzneműek	Noun
közoktatásba	Noun
ívekbe	Noun
feltámasztotta	Verb
megpróbáltál	Verb
pesszimizmusként	Noun
nyíltságoknak	Noun
kemenceként	Noun
poszméhekbe	Noun
kristályokba	Noun
kasztokhoz	Noun
majorokon	Noun
aszályok	Noun
borzokból	Noun
petróleumlámpákba	Noun
álarcosbálon	Noun
törődne	Verb
ismételve	Converb
weboldalakat	Noun
gyömbérrel	Noun
szállítónak	Noun
dokumentumoknak	Noun
viszonyában	Noun
fázisokon	Noun
oldalaihoz	Noun
vitára	Noun
tankönyveknek	Noun
inspekciókat	Noun
materializmussal	Noun
hajthatatlanhoz	Noun
szelencébe	Noun
népekre	Noun
szalonnával	Noun
vertikálisig	Noun
aperitif	Noun
kompenzálva	Converb
oltárral	Noun
összeadta	Verb
mandátumért	Noun
leheltétek	Verb
szolgáltatásokért	Noun
kiadójától	Noun
mustárt	Noun
belépésiekből	Noun
legkíváncsibban	Noun
hangkártyát	Noun
beszélgetéshez	Noun
kivégzésről	Noun
igazságszolgáltatásokhoz	Noun
tévék	Noun
aggódnál	Verb
részleteinek	Noun
határokhoz	Noun
vederbe	Noun
illusztrációként	Noun
toldottátok	Verb
irányít	Verb
gyümölcsfákat	Noun
szolidaritást	Noun
pénzekké	Noun
készülékeknek	Noun
kényelmesebb	Noun
fenyegetésekről	Noun
kijelentéseknek	Noun
nyomoznak	Verb
töltényt	Noun
üvegházzal	Noun
szabványosítottak	Verb
meghív	Verb
doménen	Noun
leülnek	Verb
géppuskákban	Noun
atavizmus	Noun
jobbá	Noun
felfogni	Verb
rektorrá	Noun
importálva	Converb
torykként	Noun
másolata	Noun
változatosabbá	Noun
csapágyért	Noun
nyűgnek	Noun
virágzó	Participle
visszamegy	Verb
titkosszolgálattól	Noun
kézikönyv	Noun
ismeretessé	Noun
idióta	Noun
ökörrel	Noun
ügynöknél	Noun
vasfüggönyt	Noun
délhez	Noun
nemzetiségeket	Noun
legbűvösebbeken	Noun
tájban	Noun
fednie	Verb
térképészek	Noun
előkészítésben	Noun
jelzéseknél	Noun
napjával	Noun
kánságokat	Noun
bilit	Noun
hamvába	Noun
teljesítménnyel	Noun
tárgyalok	Verb
végrendelkezek	Verb
velúroknak	Noun
imákban	Noun
abszorpciót	Noun
előrejelzésre	Noun
építésnek	Noun
hangyáért	Noun
ellenségeskedések	Noun
nitrogénné	Noun
reményeknek	Noun
hivatkozva	Converb
programnak	Noun
viszonyából	Noun
ablakait	Noun
kredittel	Noun
pénztárost	Noun
ostábla	Noun
dinoszauruszokkal	Noun
műsorvezetőket	Noun
atyaként	Noun
ciklorámáról	Noun
bizalmába	Noun
megegyezni	Verb
gyufásdobozért	Noun
bugyitól	Noun
foglalkozáshoz	Noun
asztronauta	Noun
társakra	Noun
szabadrúgásokat	Noun
porszívókból	Noun
beruházásból	Noun
társítja	Verb
sörről	Noun
vakációkban	Noun
fertőzöttként	Noun
versenyműveket	Noun
babonákba	Noun
erdőkről	Noun
hullámtörőt	Noun
vacogj|or|	Verb
kocsinak	Noun
használatának	Noun
csúcstechnológia	Noun
sapkánál	Noun
torzítja	Verb
képeiben	Noun
versében	Noun
aknászokig	Noun
feszültségen	Noun
ellenőrzéséhez	Noun
politikusokba	Noun
vonalzókhoz	Noun
redukálni	Verb
gyártásához	Noun
folyadékként	Noun
diófacincérig	Noun
fagyasztásoktól	Noun
szabadulna	Verb
ajakos	Noun
paprikán	Noun
sajátosság	Noun
dúlnál	Verb
konzorciumok	Noun
rozst	Noun
passzívakká	Noun
étkezőkocsit	Noun
filozófiától	Noun
vírussal	Noun
éveként	Noun
részéhez	Noun
nehezítjük	Verb
potenciálison	Noun
gyanakodtak	Verb
bársonyosakról	Noun
legnyíltabbon	Noun
műszerről	Noun
magasságokig	Noun
nyilatkozni	Verb
veszekedéseket	Noun
informatikusnak	Noun
bajonett	Noun
címszónál	Noun
rákokat	Noun
megfojtja	Verb
lelnek	Verb
váditól	Noun
apácákra	Noun
előszókba	Noun
fenevaddá	Noun
rőzsét	Noun
eredetitől	Noun
illesztenetek	Verb
baleseti	Noun
szemre	Noun
szörnyűségek	Noun
európiumokban	Noun
duó	Noun
születésig	Noun
idézetnek	Noun
tájékoztattak	Verb
szűkössé	Noun
csecsekbe	Noun
túlélni	Verb
vívókon	Noun
élelmiszerből	Noun
gyaur	Noun
vonatkozáson	Noun
terhelések	Noun
revideálna	Verb
parkolótól	Noun
menüpont	Noun
megerősítendő	Participle
gurít	Verb
mamának	Noun
ellenzékekként	Noun
húgysav	Noun
ammóniumokhoz	Noun
dobostortában	Noun
fehérjetartalomnál	Noun
babakocsit	Noun
exhumálásra	Noun
ügynökhöz	Noun
lépcsőnek	Noun
bástyával	Noun
öreget	Noun
hajóiból	Noun
jogsértések	Noun
vigyázunk	Verb
kedvelőket	Noun
nyávogandó	Participle
pszichékbe	Noun
érintettre	Noun
kellemetlenségért	Noun
hazudunk	Verb
szoktátok	Verb
alábbiakkal	Noun
szemlében	Noun
nehézipart	Noun
szőkítsétek	Verb
profilnak	Noun
stresszek	Noun
rasszizmusokért	Noun
tojásfehérje	Noun
bordélyházba	Noun
kötődjön	Verb
teológiákként	Noun
előadóktól	Noun
mamut	Noun
társaságokká	Noun
székletből	Noun
konvencióval	Noun
barátságon	Noun
elbocsátó	Participle
munkavállaló	Noun
feleségénél	Noun
medencében	Noun
szenzációt	Noun
szokásaiba	Noun
kiállításból	Noun
barackmagokon	Noun
ciklorámákká	Noun
hagyományaitól	Noun
közleményt	Noun
évfolyam	Noun
műszerekkel	Noun
gondolatnak	Noun
jégkorszak	Noun
hegységek	Noun
halálosakra	Noun
helyzetekbe	Noun
haszonélvezőtől	Noun
tapétákra	Noun
szertartásnak	Noun
ellenfeled	Noun
tornacipőnél	Noun
Magyarországból	Noun
oldalágak	Noun
álcáknak	Noun
világbajnokkal	Noun
sebességének	Noun
gyorsírás	Noun
lakodalmak	Noun
létezésére	Noun
fogyasztónak	Noun
kontextussal	Noun
földbirtokost	Noun
parázsba	Noun
élelmiszernek	Noun
híre	Noun
abszinthoz	Noun
anyagáról	Noun
reklámként	Noun
betűmérettel	Noun
kategóriáján	Noun
hálókocsi	Noun
alkirályt	Noun
övezetté	Noun
pedálnak	Noun
mikrofonnál	Noun
tagállamokról	Noun
beleszóljanak	Verb
rétegtől	Noun
ebihalakat	Noun
középpontjába	Noun
örömmel	Noun
atomban	Noun
karikára	Noun
szenvedne	Verb
közhelyekkel	Noun
azonosítják	Verb
szeszben	Noun
szabók	Noun
háborút	Noun
pisztrángokról	Noun
együttessel	Noun
szertartásokra	Noun
betegségnél	Noun
pontokkal	Noun
képletekről	Noun
hallgatásba	Noun
tárcát	Noun
gyűjteményeket	Noun
díjjal	Noun
stájszra	Noun
feleségekben	Noun
fájlokba	Noun
összegekről	Noun
gépkocsiból	Noun
utánoznak	Verb
porcukrokba	Noun
berkélium	Noun
keményítőből	Noun
űrszondán	Noun
őskorba	Noun
régión	Noun
előírta	Verb
családjától	Noun
leszállnék	Verb
fiait	Noun
ablaktalanokra	Noun
beleír	Verb
altatóorvosokból	Noun
ebédlővé	Noun
ládákban	Noun
cukorbetegségbe	Noun
joghatóságot	Noun
összeesküvésbe	Noun
főispánná	Noun
egészségesebb	Noun
ásatásokkal	Noun
fiúkból	Noun
felkérte	Verb
formáiról	Noun
keféket	Noun
hamuba	Noun
funkció	Noun
eleméről	Noun
kikapcsolni	Verb
levessel	Noun
megütik	Verb
kisebbítenünk	Verb
emírségekbe	Noun
hátrakötnéd	Verb
vállalkozók	Noun
elektromérnök	Noun
bórsavakról	Noun
tároláshoz	Noun
menüpontot	Noun
megold	Verb
fluorban	Noun
önkormányzatot	Noun
szenzációk	Noun
adata	Noun
kisvárosnak	Noun
virágcserepekért	Noun
stílushoz	Noun
cseresznyemagokat	Noun
hibáztassa	Verb
dolgainál	Noun
bérgyilkosként	Noun
epekő	Noun
tövéből	Noun
odavágó	Participle
lóra	Noun
megtárgyalok	Verb
főpap	Noun
tartozással	Noun
babonással	Noun
eredettől	Noun
megfigyeléshez	Noun
csúnyák	Noun
fentieknek	Noun
sportról	Noun
kozmát	Noun
bevezessük	Verb
tavaszáig	Noun
bukásokká	Noun
választásból	Noun
okosságok	Noun
kénekkel	Noun
cégnél	Noun
dinasztiáig	Noun
sütkérezni	Verb
vitáznék	Verb
kompot	Noun
tipró	Participle
tangensért	Noun
beindulni	Verb
megjelentető	Participle
területbe	Noun
kapuidhoz	Noun
halásznék	Verb
helyzete	Noun
szörpökként	Noun
boldogsággal	Noun
szentelve	Converb
kártyákat	Noun
tűnek	Noun
vasútállomássá	Noun
akadályává	Noun
díjnál	Noun
elmélete	Noun
számához	Noun
ásznak	Noun
anakronizmus	Noun
dalold|or|	Verb
útvonalak	Noun
otthonában	Noun
elválasszák	Verb
sütkérezne	Verb
űrhajósok	Noun
fodrászatban	Noun
lazára	Noun
filmezni	Verb
újrafelhasználsz	Verb
ker.-hez	Noun
legnehezebbnek	Noun
bevezette	Verb
átadással	Noun
vezetésével	Noun
levelezésében	Noun
körvonalakkal	Noun
vélelem	Noun
cigánysággá	Noun
adoptálta	Verb
kivilágításból	Noun
asszociatívra	Noun
megnyitniuk	Verb
baktériumokba	Noun
kiadásához	Noun
tavalyi	Noun
verbunkból	Noun
hatékonyabbak	Noun
modulokba	Noun
bárányfelhők	Noun
teszteljék	Verb
szintesből	Noun
ceremóniákra	Noun
uralmával	Noun
wagneriekből	Noun
zebrának	Noun
zajoljak	Verb
apróságtól	Noun
ellátásán	Noun
opciónak	Noun
tevékeny	Noun
kabátoktól	Noun
kabinetet	Noun
templomról	Noun
böjttel	Noun
emulzió	Noun
árvizet	Noun
alkatrészekkel	Noun
örömkönnyekként	Noun
felfedezésnek	Noun
fart	Noun
egészségesebből	Noun
romokon	Noun
órának	Noun
rostokban	Noun
támogatásért	Noun
felelet	Noun
ellenfelek	Noun
szanatóriumként	Noun
újságcikkek	Noun
hordárrá	Noun
kistérségekről	Noun
bútordarabokból	Noun
tenyereknek	Noun
legkésőbben	Noun
vívóért	Noun
karakterekhez	Noun
vizsgáltak	Verb
prelúdium	Noun
tintahalat	Noun
városra	Noun
utánpótláshoz	Noun
madárként	Noun
tartósnak	Noun
mintánál	Noun
zsidóságon	Noun
kiállításban	Noun
részekből	Noun
főszerepet	Noun
pihék	Noun
tilinkó	Noun
ágazatiaknak	Noun
ráadnának	Verb
emelésével	Noun
bivalyokról	Noun
lefordítsák	Verb
telep	Noun
jósnőktől	Noun
beszerzésre	Noun
hadseregekben	Noun
gépgyárat	Noun
csomagja	Noun
koronából	Noun
mező	Noun
beküldjem|	Verb
tanulniuk	Verb
órákba	Noun
megfizeti	Verb
sárkányokra	Noun
gyatra	Noun
szakterület	Noun
színvonalon	Noun
előnyei	Noun
katonaságnak	Noun
valkűrök	Noun
kaszt	Noun
trolibuszt	Noun
vartyognál	Verb
fenyeget	Verb
gnoszticizmusnak	Noun
raktárépületbe	Noun
járműből	Noun
narancsokként	Noun
békeszerződésre	Noun
őskortól	Noun
paradigmaváltások	Noun
méltányolták	Verb
világháborúval	Noun
sportágaknál	Noun
szabályozták	Verb
futóról	Noun
film	Noun
farral	Noun
külvilágot	Noun
részecskéken	Noun
láncreakció	Noun
nevezés	Noun
fókuszálták	Verb
áráról	Noun
holnapig	Noun
kondíciókról	Noun
megerőszakolnak	Verb
fémekkel	Noun
ódát	Noun
középpontban	Noun
műveltebb	Noun
anyagaira	Noun
labdarúgáson	Noun
spamet	Noun
légszennyeződésekké	Noun
szemlélik	Verb
ideálisabbat	Noun
árulót	Noun
apjával	Noun
káposzta	Noun
hangszerelve	Converb
fordítóról	Noun
pánikokról	Noun
gyertyatartót	Noun
összefogjon	Verb
izében	Noun
takarnak	Verb
kapcsolattartásban	Noun
migrénként	Noun
tényezővé	Noun
hallgatóságra	Noun
jurták	Noun
legszegényesebbeknél	Noun
profitból	Noun
fertőzések	Noun
egészségnél	Noun
markolattal	Noun
tanulmányokra	Noun
töretlen	Noun
megteremtek	Verb
oszloptól	Noun
ellenőrizned	Verb
eltérések	Noun
szentimentalizmusról	Noun
áttekintettem	Verb
trónusra	Noun
jutalomként	Noun
du.-on	Noun
igazadban	Noun
vegyesben	Noun
években	Noun
verifikáltunk	Verb
válaszoló	Participle
figyelmetlenek	Noun
büdös	Noun
egészségessé	Noun
élesebb	Noun
tanszékre	Noun
járőröznünk	Verb
ízlést	Noun
rítusokhoz	Noun
királynék	Noun
eldobva	Converb
elfogtak	Verb
világűrt	Noun
áruháznak	Noun
purgatóriumban	Noun
alakokhoz	Noun
tőrtől	Noun
gyilkosságokra	Noun
szünet	Noun
szüli	Verb
skálához	Noun
ügyfeleket	Noun
kígyókhoz	Noun
regényíróként	Noun
emészt	Verb
tápláltam|	Verb
gépfegyver	Noun
autonóm	Noun
irányával	Noun
innovációknak	Noun
dózsékból	Noun
újkorban	Noun
vívmányoknál	Noun
segítségről	Noun
jegyzetelni	Verb
információelméletben	Noun
gyermekkor	Noun
végig	Noun
alábbiakat	Noun
beírnád	Verb
személyét	Noun
kilométernél	Noun
lévőknek	Noun
lélektannal	Noun
párnákat	Noun
szervekről	Noun
folt	Noun
képességein	Noun
végezzen	Verb
eldugnia	Verb
regényeiért	Noun
gyermekvédelmek	Noun
tekintetből	Noun
szervezetekbe	Noun
pillangón	Noun
jelölendő	Participle
szezámmagért	Noun
tompaszöget	Noun
állagban	Noun
kockázatmentesben	Noun
kódig	Noun
átkeresztelte	Verb
lámpalázban	Noun
bőröndök	Noun
tisztázni	Verb
elraboltak	Verb
élőlényekhez	Noun
nárcisz	Noun
leggazdaságosabbakat	Noun
körülírták	Verb
számlaként	Noun
frissítettem	Verb
hírügynökségnél	Noun
helye	Noun
szenvednek	Verb
tippnek	Noun
informatikáért	Noun
hazaérve	Converb
alagútba	Noun
jogtulajdonossal	Noun
sajtóval	Noun
citológiákkal	Noun
vezetőjének	Noun
szobrászok	Noun
elszenvedték	Verb
kertészetekben	Noun
túlélnie	Verb
értelmesebbekben	Noun
ablakában	Noun
irányát	Noun
olvashatókkal|	Noun
portékákra	Noun
orchideákról	Noun
szöveteknek	Noun
üdvözölj|or|	Verb
máglyára	Noun
feltüntetné	Verb
használatához	Noun
jóváhagyását	Noun
akadémiákat	Noun
újdonságként	Noun
referencia	Noun
laptól	Noun
fogadalmon	Noun
ideg	Noun
egyetemlegesebbig	Noun
ülésében	Noun
adoptálni	Verb
pestisben	Noun
operál	Verb
mozdulatlanságot	Noun
rumot	Noun
fordulója	Noun
alapodért	Noun
franciákra	Noun
megvalósításokat	Noun
létrehoznunk	Verb
vámpírra	Noun
államosításokat	Noun
intézmények	Noun
géppuskával	Noun
repce	Noun
ebédeket	Noun
utalod	Verb
epilepsziára	Noun
kéziratokat	Noun
dízel	Noun
májusiak	Noun
nemzetköziesítés	Noun
bevezetni	Verb
lemezbe	Noun
árnyalatban	Noun
kedvezményekből	Noun
inspekcióknál	Noun
pokolból	Noun
komlót	Noun
kernelben	Noun
bolsevizmus	Noun
tanóráért	Noun
idegkórtannal	Noun
formátumról	Noun
ügyét	Noun
protonra	Noun
pecsenyékről	Noun
békében	Noun
színűeket	Noun
regénynek	Noun
diffúzióval	Noun
rabbit	Noun
centralizmusig	Noun
testéből	Noun
esteken	Noun
évszámoknak	Noun
fogadóba	Noun
fürdőszobába	Noun
ürgék	Noun
veszélyeztette	Verb
chipbe	Noun
papírról	Noun
megszerzésében	Noun
évért	Noun
levelezések	Noun
kvíz	Noun
butaságokkal	Noun
papucsodba	Noun
észlelsz	Verb
barakkból	Noun
emlékművel	Noun
scripteknek	Noun
alkotásokból	Noun
fogyasztóvédelmekbe	Noun
művére	Noun
bejön	Verb
hozzászólnék	Verb
mennyiségében	Noun
hozzájárulásáról	Noun
legjobbjában	Noun
elvégezzen	Verb
találkozzunk	Verb
xenont	Noun
mocsár	Noun
mondával	Noun
vésve	Converb
ecsetelendő	Participle
példákon	Noun
teázó	Participle
dézsmát	Noun
programokkal	Noun
weboldalba	Noun
udvarokhoz	Noun
tárgyalunk	Verb
tizedek	Noun
hibátlan	Noun
keletkeznék	Verb
végeredményeket	Noun
építésű	Noun
politikára	Noun
piramisokban	Noun
paprikát	Noun
területekért	Noun
pingvinnek	Noun
utóbbiakon	Noun
termékek	Noun
úrról	Noun
földje	Noun
misztériumnak	Noun
állatvilágnak	Noun
koldusnak	Noun
foghatót	Noun
eredetet	Noun
majommá	Noun
égtájakat	Noun
okaira	Noun
tantermet	Noun
renováltak	Verb
szegénységgel	Noun
szekérrel	Noun
lúddal	Noun
oldalszámot	Noun
magatartásról	Noun
fájdalomból	Noun
útvonalakról	Noun
hidrológiákká	Noun
képviselőjévé	Noun
átlagosakhoz	Noun
szóvivőjét	Noun
tagadások	Noun
csillagképeknek	Noun
ruháikat	Noun
fellebbez	Verb
ötszázat	Noun
költészet	Noun
járásokról	Noun
állományok	Noun
főszereplőket	Noun
becslést	Noun
elméletéért	Noun
cukibbak	Noun
irodalmakat	Noun
bajnokot	Noun
gyepekkel	Noun
sanzonok	Noun
torzítva	Converb
vizionálni	Verb
kitöri	Verb
népszerűnek	Noun
hozományon	Noun
címlapján	Noun
hőségtől	Noun
operációnak	Noun
meccsért	Noun
jachtot	Noun
földekről	Noun
rózsát	Noun
családoknál	Noun
hegedűre	Noun
szónok	Noun
gördeszkával	Noun
babérlevelektől	Noun
ruháinknál	Noun
őrizni	Verb
telekkel	Noun
effektus	Noun
előrehaladva	Converb
megkülönböztetik	Verb
forrásává	Noun
góljára	Noun
magasztos	Noun
hasonlóság	Noun
hónokhoz	Noun
moly	Noun
nemzedékre	Noun
inkvizíciót	Noun
bátorítani	Verb
radioaktivitást	Noun
decigrammra	Noun
civilizáltak	Verb
főzelékből	Noun
lángszóróval	Noun
reformálta	Verb
gazdaságok	Noun
feltételeiben	Noun
sikátorban	Noun
gyökerek	Noun
elnéptelenedésekként	Noun
honfoglalásig	Noun
apátnők	Noun
lepve	Converb
óramutatókként	Noun
tűzoltóautón	Noun
karácsonyon	Noun
kártyákon	Noun
férjre	Noun
menyétekre	Noun
akkordokra	Noun
kérdéseket	Noun
oldható	Noun
vonzódás	Noun
oktatókat	Noun
pisztolyra	Noun
hivatkozásra	Noun
szamarakkal	Noun
vasútvonalakra	Noun
oktatásért	Noun
elírni	Verb
gyűjteményekbe	Noun
hegyet	Noun
megrendezésre	Noun
kompatibilitás	Noun
hangszórók	Noun
gésákhoz	Noun
hímzést	Noun
hibátlanná	Noun
fajtának	Noun
oldalánál	Noun
tévednétek	Verb
bombasztikusakkal	Noun
párbajon	Noun
pontosat	Noun
baromfitenyésztésből	Noun
asztalért	Noun
tudásszomjaktól	Noun
feszesre	Noun
felújításán	Noun
eltávolítunk	Verb
kisfiúkat	Noun
fordulótól	Noun
nagykövetségeknek	Noun
jelöltél	Verb
kasszát	Noun
szájpadlástól	Noun
kerületnél	Noun
unalomtól	Noun
feltámasztja	Verb
korbácsból	Noun
adminból	Noun
hamisítványt	Noun
arcról	Noun
évtizedének	Noun
edzőteremig	Noun
részt	Noun
álmon	Noun
vitákba	Noun
kidolgozással	Noun
petróleumlámpa	Noun
kamerának	Noun
vételhez	Noun
kéjnő	Noun
szakékról	Noun
panelház	Noun
árkokkal	Noun
kultúrákkal	Noun
következtetni	Verb
olajkutak	Noun
versenyekből	Noun
kerítenek	Verb
sajttal	Noun
zargassák	Verb
kutatáshoz	Noun
hárfa	Noun
májusában	Noun
nyilatkoztak	Verb
vermut	Noun
szervezetekről	Noun
regényt	Noun
vívtak	Verb
öngóllal	Noun
logóról	Noun
pszichésnél	Noun
lányban	Noun
gerlével	Noun
felkérni	Verb
fővárosból	Noun
elindítanak	Verb
vályúkért	Noun
filterekben	Noun
ellenállásokon	Noun
idézve	Converb
városról	Noun
duzzad	Verb
elterjedjenek	Verb
félelmekkel	Noun
kinyitják	Verb
nézetekre	Noun
világvégéről	Noun
sztálinizmussal	Noun
filiszteusokkal	Noun
kézenállásig	Noun
attribútummal	Noun
spenóthoz	Noun
levéltárból	Noun
fehérként	Noun
ETO-k	Noun
nagydíjból	Noun
szabályzata	Noun
lapkán	Noun
urbanizációig	Noun
szándéka	Noun
fényszóróból	Noun
oldalra	Noun
sampon	Noun
véleményen	Noun
klarinétra	Noun
strázsamester	Noun
vetekednek	Verb
hajfonattól	Noun
fizikusok	Noun
pajtát	Noun
viszonyultak	Verb
szigorúak	Noun
megfojtották	Verb
telepedő	Participle
kaptárak	Noun
kajakban	Noun
aligátorokon	Noun
horgokkal	Noun
képességétől	Noun
halottkémbe	Noun
képzőművészetben	Noun
nadrágokból	Noun
titánokat	Noun
megbetegedések	Noun
megbeszélje	Verb
borokat	Noun
egybeírunk	Verb
lótól	Noun
rekonstrukciónak	Noun
égzengésre	Noun
privatizációért	Noun
nyitányok	Noun
felperesben	Noun
barátjának	Noun
műanyagokból	Noun
élelmiszerbe	Noun
életén	Noun
árokból	Noun
modellje	Noun
szökésből	Noun
kigúnyolva	Converb
aluliakat	Noun
apród	Noun
hivatásosakhoz	Noun
kocsiknál	Noun
jachtokká	Noun
könyvelést	Noun
színdarabbal	Noun
megosztaniuk	Verb
ideírtam	Verb
house	Noun
méltón	Noun
ginzeng	Noun
végzetté	Noun
öngólnak	Noun
másolást	Noun
bűnözéstől	Noun
hazaiak	Noun
legmagasztosabb	Noun
alapos	Noun
pinától	Noun
medvékhez	Noun
abronccsal	Noun
nevetségekig	Noun
cukrászdák	Noun
egyenlőségért	Noun
melódiákként	Noun
kiáltották	Verb
duzzadó	Participle
szekvencia	Noun
kiadványoknak	Noun
focilabdával	Noun
korcsolyázó	Participle
ág	Noun
kilépnie	Verb
ligából	Noun
szerkesztésétől	Noun
levélre	Noun
zacskó	Noun
legdúsabbakban	Noun
osztagok	Noun
ebbe	Noun
mérkőzésért	Noun
ciklont	Noun
kijelzőhöz	Noun
tárgyúból	Noun
mérgezésről	Noun
gyógyszerkönyv	Noun
táplálékhoz	Noun
telefonban	Noun
megállapodást	Noun
fogyatkozó	Participle
májusától	Noun
havaztál	Verb
évtizednél	Noun
szezonokban	Noun
pontyot	Noun
egységmátrixokként	Noun
szabványosakkal	Noun
szolgálatból	Noun
hangversenyekért	Noun
sikátorba	Noun
stadionnál	Noun
bélyeggyűjtéseken	Noun
lábjegyzetből	Noun
fejenállásnál	Noun
küllők	Noun
viszonyok	Noun
faluhoz	Noun
filmeket	Noun
muzsikában	Noun
elviselnek	Verb
dámszarvas	Noun
alapjába	Noun
várólistát	Noun
dobozba	Noun
kegyenccé	Noun
felkeress|or|	Verb
szemceruzák	Noun
kampányoló	Participle
nemességre	Noun
vállalatokká	Noun
legboldogtalanabbnál	Noun
tanítványukban	Noun
átejtsem|	Verb
számelmélet	Noun
karvalybaglyokhoz	Noun
dioptriásokban	Noun
igazgatásra	Noun
hajóknál	Noun
útjukra	Noun
kvantum	Noun
banálisnak	Noun
vezetékeket	Noun
iktató	Participle
nyakához	Noun
leírásnak	Noun
kecskékből	Noun
válaszolnának	Verb
kaputokká	Noun
felülírtam	Verb
egyházszakadás	Noun
hely	Noun
életveszélyesebbekről	Noun
osztaggal	Noun
dizőz	Noun
hanghullámokkal	Noun
teaszűrőkkel	Noun
uralmának	Noun
levelezéséről	Noun
dühtől	Noun
legrégibbek	Noun
jellemzi	Verb
vadászaton	Noun
enciklopédiába	Noun
hullámtörő	Noun
elmélkedést	Noun
kantonokkal	Noun
partitúra	Noun
primernél	Noun
keze	Noun
akadályt	Noun
konfigurációval	Noun
zajtalanabbakon	Noun
réssel	Noun
vadkecske	Noun
farkasig	Noun
alagutakba	Noun
aljat	Noun
többnyelvűség	Noun
alkaron	Noun
vezetőjével	Noun
szkennerek	Noun
szemeknél	Noun
exhumálunk	Verb
álló	Noun
transzformáció	Noun
könyvből	Noun
csavarokat	Noun
krónikához	Noun
hirdetések	Noun
fordítására	Noun
gerlékbe	Noun
legelégedettebbekbe	Noun
létesítményen	Noun
szankciónak	Noun
strandról	Noun
aranykereteknél	Noun
hírszerzésnél	Noun
vállalatokról	Noun
felügyelőket	Noun
feleségként	Noun
csipet	Noun
kezéből	Noun
szubkultúrához	Noun
bográccsá	Noun
formáiba	Noun
hőmérsékletre	Noun
tanulmányoztam	Verb
ápr.-ként	Noun
kapujához	Noun
lenéznek	Verb
vérszegénységekig	Noun
zöldpaprikát	Noun
stadionba	Noun
hajszálerekben	Noun
cukorból	Noun
időkapszula	Noun
vállalkozásoknak	Noun
indítékként	Noun
bikaviadalokért	Noun
kerámiákig	Noun
radikálisként	Noun
védőszent	Noun
nagyvállalatnál	Noun
bányásznappá	Noun
robbanékonynak	Noun
újraválasztva	Converb
feltételeiről	Noun
forgalmazzak	Verb
gyógyszerészetben	Noun
tájékoztatáson	Noun
gyilkosságok	Noun
tankönyvekbe	Noun
fényképezőgépre	Noun
house-okig	Noun
megtárgyalta	Verb
irányzatokkal	Noun
díjakat	Noun
gimnasztika	Noun
brigantiért	Noun
szegycsonttól	Noun
udvariasabb	Noun
úszósapkához	Noun
furcsák	Noun
dokumentumfilmmel	Noun
latyakokért	Noun
meggyilkolták	Verb
felnéznek	Verb
pályához	Noun
koncentrációkban	Noun
ellenkezzek	Verb
idézőjelekbe	Noun
kórokozótól	Noun
szóköz	Noun
szomorúság	Noun
bankban	Noun
tenyészt	Verb
célponttal	Noun
szentesítsen	Verb
követésében	Noun
misszionáriusok	Noun
pszichoterápiát	Noun
hajórajhoz	Noun
érintőknél	Noun
megállapításokkal	Noun
fújdogálna	Verb
tölgyfákat	Noun
gázlámpáért	Noun
papírzsebkendőkkel	Noun
suhanó	Participle
tőkéhez	Noun
főpolgármesterről	Noun
kitöltsd|or|	Verb
kompetenciánál	Noun
utazásnak	Noun
városállamban	Noun
tükrén	Noun
javításától	Noun
rendezvényét	Noun
repülőkre	Noun
szimbiózist	Noun
tökéletesítenéd	Verb
elengedhetetlenné	Noun
frontokon	Noun
előadásával	Noun
fájások	Noun
molesztáltál	Verb
elbújnak	Verb
dramaturgiák	Noun
berkeken	Noun
gerincvelőért	Noun
tengelynél	Noun
ablakcsáért	Noun
estélyeken	Noun
jelmezben	Noun
áruházak	Noun
gabonával	Noun
családjává	Noun
lejtő	Noun
szavaztuk	Verb
értelméhez	Noun
anekdotának	Noun
vízesésig	Noun
egységektől	Noun
tűzőkapcsoktól	Noun
cikkével	Noun
virultunk	Verb
adásokat	Noun
hidegben	Noun
szépségszalon	Noun
külügyminiszterhez	Noun
mindennapokért	Noun
fedélzetet	Noun
mágiák	Noun
szavaztok	Verb
urává	Noun
indukálod	Verb
meglepni	Verb
körömmel	Noun
klikkel	Noun
belügyminiszterré	Noun
kalamajkát	Noun
végtől	Noun
szívinfarktust	Noun
tévedtünk	Verb
elkísérő	Participle
meghatározások	Noun
lencsékből	Noun
használhatóvá	Noun
pletykafészekké	Noun
illeszkednek	Verb
csomagolással	Noun
bizottságnál	Noun
szervezőnek	Noun
garasról	Noun
kórt	Noun
elnöknek	Noun
írásairól	Noun
jaguárral	Noun
előzőn	Noun
fjordba	Noun
védelmet	Noun
legjelentősebbek	Noun
szabadságharcos	Noun
színvonalától	Noun
szótagnál	Noun
közlekedő	Participle
változatosság	Noun
kócsag	Noun
fedezettel	Noun
tárolása	Noun
nevelőszülővé	Noun
császárságtól	Noun
foglalkozási	Noun
övezeteknek	Noun
polinomoknál	Noun
kurdokkal	Noun
egzotikus	Noun
gyermekgyógyászat	Noun
lemezekre	Noun
énekesként	Noun
legbecsületesebbekben	Noun
áltudományt	Noun
éveseket	Noun
ellenérvbe	Noun
döntéseként	Noun
bobok	Noun
szívedre	Noun
lisztekből	Noun
jobbággyal	Noun
képviselőjének	Noun
kölesből	Noun
parkolóházból	Noun
bátorságának	Noun
bosszúnak	Noun
állomány	Noun
mérgezték	Verb
körzettől	Noun
középkoron	Noun
kellet	Verb
csokorra	Noun
réteget	Noun
szórok	Verb
munkahelyre	Noun
szigetekként	Noun
konszenzusról	Noun
annektálnál	Verb
bölcsődében	Noun
tételnek	Noun
ventilátoroknak	Noun
ültető	Participle
hangszedőről	Noun
friggyel	Noun
emléknapon	Noun
vendéglőkként	Noun
rettenetesnek	Noun
fogadásra	Noun
államcsíny	Noun
apoplexiát	Noun
gondnokokra	Noun
munkaviszony	Noun
fedéllel	Noun
fogyasztásától	Noun
kommunizmusba	Noun
komponensként	Noun
kapornak	Noun
futamnál	Noun
maratont	Noun
frissítésként	Noun
főispántól	Noun
létfontosságút	Noun
kistérséget	Noun
erősítetted	Verb
hátára	Noun
tevékenységükhöz	Noun
pajzsról	Noun
deriválttal	Noun
jogosulttá	Noun
eszesebbé	Noun
lépésében	Noun
székhelyeként	Noun
fordulóról	Noun
mérsékeli	Verb
címszóról	Noun
katonatisztet	Noun
andrisokba	Noun
meglátogatva	Converb
legsavanyúbbat	Noun
viharra	Noun
foglalkoztatta	Verb
ugrás	Noun
szkandiumokig	Noun
évestől	Noun
csinálta	Verb
légifelvételről	Noun
pálmától	Noun
megkülönböztetésnek	Noun
nyakszirttel	Noun
fújni	Verb
csúcstalálkozónál	Noun
programoknál	Noun
segédigéket	Noun
nélkülieket	Noun
sarjakat	Noun
pajeszhoz	Noun
örökségtől	Noun
kandúrnak	Noun
orvosnő	Noun
fenyegessék	Verb
védelmezni	Verb
ribizliket	Noun
teljesül	Verb
kísértethistóriákká	Noun
ötletemet	Noun
konzultációért	Noun
környezettan	Noun
logisztika	Noun
fejlesztette	Verb
lövedéknek	Noun
konzervnyitókra	Noun
középiskolán	Noun
sorolva	Converb
régészbe	Noun
filmsztárok	Noun
megálljanak	Verb
gépekben	Noun
programokat	Noun
találmányért	Noun
memóriának	Noun
foszfornak	Noun
adóra	Noun
edzésnek	Noun
főispánnal	Noun
utcához	Noun
fundamentalizmus	Noun
megtörténjetek	Verb
módjának	Noun
cselekménnyel	Noun
ápolás	Noun
szoftverben	Noun
szektornak	Noun
megszállásoktól	Noun
ezüstlakodalom	Noun
politikusoknál	Noun
végeredménynél	Noun
előzetesek	Noun
fejlesztésnek	Noun
gyümölcsízűvé	Noun
tejesemberekből	Noun
húghoz	Noun
vezérigazgatóját	Noun
sebészeteket	Noun
hangszerekről	Noun
átfognak	Verb
háremben	Noun
darázsfészkekért	Noun
kalauzoltak	Verb
azonosítja	Verb
univerzumok	Noun
nagyoknál	Noun
kezdőlapot	Noun
készítőjévé	Noun
tanulókból	Noun
tragédián	Noun
írásváltozat	Noun
helikopterekig	Noun
antropológussal	Noun
ideológiákat	Noun
tartóztatva	Converb
elveszítették	Verb
utasításból	Noun
kibővítettem	Verb
köröket	Noun
keményítővel	Noun
lazacot	Noun
befektetéseknek	Noun
jellegénél	Noun
dézsmákat	Noun
vegyészet	Noun
sajtótájékoztatókat	Noun
kockáztatja	Verb
húsvétiért	Noun
megtekintjük	Verb
kenderből	Noun
mélyekkel	Noun
csökkenése	Noun
sövényként	Noun
névnél	Noun
lándzsára	Noun
létezéséhez	Noun
szolgáltatót	Noun
célcsoporthoz	Noun
véljék	Verb
befogadni	Verb
bandának	Noun
elvontig	Noun
bombákból	Noun
leírásának	Noun
belépnie	Verb
bilincsben	Noun
irodalomról	Noun
árfolyamot	Noun
vérontásból	Noun
megtanulok	Verb
fedni	Verb
kasszákba	Noun
betonoznak	Verb
februárjából	Noun
versenyekbe	Noun
cserben	Noun
bárónőt	Noun
fiúkon	Noun
tárgyaknak	Noun
felépítésről	Noun
proteinből	Noun
csatán	Noun
elkövetné	Verb
restellünk	Verb
hárfákat	Noun
szexualitásra	Noun
birodalmakra	Noun
királyságról	Noun
gondozzunk	Verb
partnerként	Noun
diplomácia	Noun
befecskendezéssel	Noun
tavat	Noun
lakhely	Noun
hatásában	Noun
tájékoztatások	Noun
túrót	Noun
gólyaláb	Noun
emlékművekkel	Noun
bánnunk	Verb
ruhájában	Noun
béklyót	Noun
millenárisokra	Noun
patríciusokról	Noun
rosszabbá	Noun
elküldené	Verb
formán	Noun
gyász	Noun
kialakítani	Verb
megismeréssel	Noun
ügynökként	Noun
csúcsára	Noun
tevékenységnek	Noun
nevelésekként	Noun
összecsukható	Noun
cukorgyárba	Noun
pusztítást	Noun
aknákra	Noun
unalomig	Noun
publikációt	Noun
szférára	Noun
pechektől	Noun
libéria	Noun
megvegyék	Verb
nyelvészről	Noun
szeletelve	Converb
dolgozatoknak	Noun
kapcsolatához	Noun
föderációhoz	Noun
telepesen	Noun
fogalma	Noun
hájakon	Noun
lemond	Verb
úszkálnak	Verb
polipokat	Noun
elnökségével	Noun
karcolva	Converb
kiindulni	Verb
értékekről	Noun
munkatársait	Noun
csúszdák	Noun
freskók	Noun
papiruszok	Noun
beltériről	Noun
öleb	Noun
repülésként	Noun
fajához	Noun
embereként	Noun
okban	Noun
megbüntet	Verb
nyomába	Noun
publicistával	Noun
szolgálatánál	Noun
levelezésével	Noun
költségvetésen	Noun
étvágy	Noun
meccsből	Noun
históriák	Noun
elnevezéseken	Noun
gyártmány	Noun
lakosokkal	Noun
família	Noun
énekessé	Noun
bélyeggyűjtő	Noun
országát	Noun
útra	Noun
végére	Noun
kassza	Noun
vulkanológust	Noun
történetéért	Noun
esztergályos	Noun
milliomosokká	Noun
háborúvá	Noun
temet	Verb
irányzatról	Noun
zsenit	Noun
fejlődést	Noun
telefonszámmal	Noun
törekvések	Noun
adódnának	Verb
lovakon	Noun
boldogtalanokat	Noun
hónapokban	Noun
zenészeknél	Noun
pályázata	Noun
hátterét	Noun
fülemülékre	Noun
ismeretéhez	Noun
fújdogálunk	Verb
agronómusoktól	Noun
szinkópa	Noun
szereplője	Noun
laptopról	Noun
elevenekig	Noun
járásokból	Noun
ívekre	Noun
megváltás	Noun
teljesítésének	Noun
lét	Noun
csirkehúst	Noun
bevezetnek	Verb
csodálatosaknál	Noun
bürkökhöz	Noun
végeredményen	Noun
fókákra	Noun
kutatóközpontban	Noun
macskabaglyok	Noun
törmeléket	Noun
fórumok	Noun
kovácsolni	Verb
margókba	Noun
spinekbe	Noun
esős	Noun
könny	Noun
ligáról	Noun
kezdeményez	Verb
igazgatótanácsnak	Noun
ködlámpákba	Noun
felhőt	Noun
titkárnőket	Noun
esküben	Noun
zrt.-kben	Noun
nemzeteket	Noun
megkérdezték	Verb
állásokba	Noun
hangulatától	Noun
produkciókkal	Noun
dietilamidra	Noun
lelkekbe	Noun
kolosszust	Noun
szépek	Noun
kifizette	Verb
eseményeiről	Noun
ajándékozásra	Noun
fordításoknál	Noun
ágára	Noun
vádolnak	Verb
következtették	Verb
ügyletre	Noun
rögzítse	Verb
véleményről	Noun
tarháló	Participle
óriáskígyókról	Noun
nevére	Noun
tökéletesség	Noun
találkoznánk	Verb
jelentkezzenek	Verb
kategorizálni	Verb
hőséget	Noun
dicsőségről	Noun
megjelölő	Participle
hátrányával	Noun
altatódalokra	Noun
járdán	Noun
rendelkezéseiről	Noun
felvételbe	Noun
teáskanálban	Noun
diktátorról	Noun
otthonként	Noun
helységekről	Noun
futóversenyeken	Noun
céllövölde	Noun
háromszögben	Noun
megértésben	Noun
együtteseként	Noun
reformot	Noun
felakasztva	Converb
évtizedeknek	Noun
különlegesen	Noun
infóért	Noun
krokodilra	Noun
tankoltak	Verb
elvárásoknak	Noun
mozgásában	Noun
napellenzőkbe	Noun
árbócnál	Noun
figyelnünk	Verb
erőteljesnek	Noun
áldoztunk	Verb
feltárásánál	Noun
süvegek	Noun
édesvízbe	Noun
befolyásolták	Verb
borrá	Noun
vérévé	Noun
tópart	Noun
férjet	Noun
professzornál	Noun
letartóztató	Participle
happoltam	Verb
szélmalmokat	Noun
felismeréseken	Noun
népmeséket	Noun
cukorkák	Noun
béltől	Noun
ortopédiáknál	Noun
elfogadásának	Noun
törés	Noun
bimbózni	Verb
fulladó	Participle
megnyitni	Verb
választójoghoz	Noun
korcsolyázni	Verb
kertelnénk	Verb
génektől	Noun
templomokként	Noun
kirúgta	Verb
zabból	Noun
ellátásáról	Noun
fenyegető	Participle
vízitormákkal	Noun
galagonya	Noun
szikláktól	Noun
bárónőtől	Noun
riportereivel	Noun
kijavítjuk	Verb
Magyarország	Noun
lelkes	Noun
hegyről	Noun
cserét	Noun
hétvégéket	Noun
közreműködésében	Noun
természeteshez	Noun
kaktuszokat	Noun
fénybe	Noun
maláta	Noun
vádoltál	Verb
dinamit	Noun
csontból	Noun
rajongjon	Verb
kriptonra	Noun
zsoltárokat	Noun
teremtőt	Noun
világnyelveken	Noun
csörgőkígyó	Noun
meghajtóba	Noun
pillanatától	Noun
házakon	Noun
elnökéről	Noun
vírusoknak	Noun
tanoncnak	Noun
homlokzatokon	Noun
csorda	Noun
munkatársként	Noun
bordára	Noun
irányelvből	Noun
évszakokat	Noun
szolgáltatónak	Noun
megértjük	Verb
hagyományokról	Noun
vízzé	Noun
kommunikálnia	Verb
fagyal	Noun
karnisként	Noun
rezisztencia	Noun
felhasználóval	Noun
küszöbén	Noun
közkincsként	Noun
századfordulóig	Noun
részekért	Noun
birodalomig	Noun
dimenziót	Noun
rövidítés	Noun
címűt	Noun
prostitúcióban	Noun
elválasztotta	Verb
óvatosságból	Noun
horrorfilmjétől	Noun
professzora	Noun
fajokként	Noun
mogyorók	Noun
generáció	Noun
demókkal	Noun
magatartásához	Noun
gazellákért	Noun
megoldásánál	Noun
mobilban	Noun
lapjához	Noun
dzsihádra	Noun
vonatkozás	Noun
javasoltál	Verb
történeteket	Noun
jéghegyen	Noun
nagyvállalattá	Noun
műholdként	Noun
néptáncokat	Noun
szentélyeket	Noun
csőcselékekig	Noun
távolságnak	Noun
ítéletben	Noun
testté	Noun
műcsarnok	Noun
székhelynek	Noun
vasútállomásig	Noun
ábécékkel	Noun
intrikákba	Noun
sokaságok	Noun
etnikumokat	Noun
hibákhoz	Noun
alapjával	Noun
hivatalokra	Noun
futóműnek	Noun
kielégítik	Verb
egyetemen	Noun
rajongónak	Noun
eredményesekről	Noun
naszádokat	Noun
megbeszélést	Noun
invesztálsz	Verb
teherhajók	Noun
emberében	Noun
biciklin	Noun
könyvénél	Noun
kanyarognom	Verb
neutronnal	Noun
vendégszobát	Noun
dívány	Noun
raktárosba	Noun
jogos	Noun
párbajra	Noun
orsóra	Noun
etánokhoz	Noun
sűrűséggel	Noun
nemzetiségnél	Noun
hangyák	Noun
édesanyádig	Noun
gyógyfürdőben	Noun
kategóriához	Noun
reményteleneken	Noun
örömhöz	Noun
zselét	Noun
pályaudvarhoz	Noun
testvérre	Noun
definícióból	Noun
tanyából	Noun
gyorsúszást	Noun
tellúrról	Noun
fennsíkkal	Noun
mélységekbe	Noun
antibiotikumig	Noun
fejedelemre	Noun
sakk-készleteken	Noun
fogalommá	Noun
gárda	Noun
pehelyfelhőkre	Noun
változtatásoknál	Noun
haszontalanabbra	Noun
effektuson	Noun
papírral	Noun
poémáig	Noun
jegyzetre	Noun
meghajoljon	Verb
igazságokat	Noun
sebezhetetlen	Noun
tömegtől	Noun
államháztartásért	Noun
lőfegyver	Noun
delírium	Noun
tárgyilagossághoz	Noun
tüdőnek	Noun
függönyökből	Noun
összeállítva	Converb
elejébe	Noun
bővítéseket	Noun
ábrázolásnak	Noun
szaváért	Noun
masina	Noun
vírusról	Noun
pentánoktól	Noun
gabonákat	Noun
városért	Noun
paszulyra	Noun
zagyva	Noun
protokollal	Noun
felhalmozva	Converb
címerré	Noun
cirkuszokhoz	Noun
tehernek	Noun
gondolkodtunk	Verb
ideje	Noun
dallam	Noun
kukoricakeményítőnél	Noun
tisztáztuk	Verb
hatóságoktól	Noun
leletre	Noun
érettség	Noun
ezüstbe	Noun
célcsoporttá	Noun
sekélyen	Noun
kapitalizmusokból	Noun
legyőzzék	Verb
borzok	Noun
cseréjét	Noun
zsákmányként	Noun
állattant	Noun
tányérokat	Noun
deklarációban	Noun
alkotmányra	Noun
élelmiszerekből	Noun
fürdésre	Noun
kedvezzen	Verb
ellátásáért	Noun
túlbecsüljetek	Verb
menedzserek	Noun
végbélgyulladásról	Noun
eljuttatja	Verb
elismerték	Verb
viharoktól	Noun
kötényből	Noun
kancába	Noun
dzsungelen	Noun
alsóba	Noun
felépítéseknél	Noun
javulást	Noun
báltermet	Noun
ijedtségig	Noun
jellege	Noun
mázlikhoz	Noun
masnival	Noun
forogniuk	Verb
apróságok	Noun
társította	Verb
müzlin	Noun
járásokhoz	Noun
másra	Noun
használatért	Noun
egészítettek	Verb
családnevek	Noun
udvaronc	Noun
targoncákkal	Noun
zabáló	Participle
vendége	Noun
márkik	Noun
valósul	Verb
hiányára	Noun
lábbeli	Noun
rókákat	Noun
repülőgépgyárak	Noun
zászlóaljjá	Noun
megtiszteltetésként	Noun
billenjek	Verb
szivárványt	Noun
vállalkozókkal	Noun
személyek	Noun
tornácról	Noun
botjával	Noun
szolgáltatásaihoz	Noun
megbetegedésekhez	Noun
reptereken	Noun
szimbólumként	Noun
középiskolaiakhoz	Noun
hattyú	Noun
bűnözést	Noun
valódiságoknak	Noun
megjavítsák	Verb
hússal	Noun
jelenségekről	Noun
sörényt	Noun
elméletiekért	Noun
időszakáig	Noun
köteles	Noun
fordítása	Noun
negyedórákkal	Noun
programjaiba	Noun
zászlómként	Noun
harcoltak	Verb
cselekvésekre	Noun
csipre	Noun
jelmezt	Noun
anyanyelvűnek	Noun
elírtam	Verb
fejlődéséről	Noun
rendetlen	Noun
provokációként	Noun
üzletemberré	Noun
gerillaháborúba	Noun
mérkőzés	Noun
környezetekkel	Noun
jogosultság	Noun
főnévhez	Noun
összegeket	Noun
elválaszthatatlan	Noun
komplibogaraknál	Noun
változást	Noun
makroökonómiát	Noun
külügyminisztériumhoz	Noun
alakban	Noun
pénzügyekkel	Noun
makkokat	Noun
colosakra	Noun
kereskedéshez	Noun
merészeljétek	Verb
környezetet	Noun
találatokkal	Noun
veszítenetek	Verb
tréningruhákig	Noun
vállalkozónak	Noun
bekenve	Converb
féltékenységtől	Noun
tankönyvvé	Noun
kéziratként	Noun
fantáziákból	Noun
festőművészt	Noun
szerencsét	Noun
felbukkan	Verb
régiekkel	Noun
istennőként	Noun
masamód	Noun
hivatala	Noun
rítusoknak	Noun
zavar	Noun
dumáltatok	Verb
érintetteknek	Noun
féltékenyről	Noun
klubbá	Noun
fentihez	Noun
trendek	Noun
rájössz	Verb
tévénél	Noun
vigasság	Noun
hibáinak	Noun
kényszerűséggel	Noun
letöltést	Noun
lantok	Noun
bukásoknak	Noun
üzenettel	Noun
műszerfalon	Noun
folyosóról	Noun
együttműködéstől	Noun
gólkülönbség	Noun
céljaihoz	Noun
fogolycseréhez	Noun
folytatásába	Noun
tollaslabda	Noun
fordítóhoz	Noun
belgáknál	Noun
cimpák	Noun
bőgünk	Verb
cselekedet	Noun
telepeket	Noun
automatikussá	Noun
bokszolónak	Noun
elfogyassza	Verb
dámák	Noun
lidércekkel	Noun
testőrt	Noun
kártyajáték	Noun
megszüntetendő	Participle
karcol	Verb
húgyhólyag	Noun
emlékezetek	Noun
gnúnak	Noun
piaca	Noun
életrajzokról	Noun
sikerednetek	Verb
nyal	Verb
környékben	Noun
meredek	Noun
hosszúakra	Noun
megtudtuk	Verb
profanizáltam	Verb
csatornánál	Noun
évszázadig	Noun
barlangkutatók	Noun
oligarcha	Noun
dalszerzőnek	Noun
nézővé	Noun
ferdének	Noun
energiára	Noun
kempingszékben	Noun
bemutatásával	Noun
szolgálatoknak	Noun
bankárban	Noun
dalokat	Noun
bangladesi	Noun
rádiót	Noun
babának	Noun
hívásra	Noun
szankciókat	Noun
bekapcsolnod	Verb
romba	Noun
érsekeknek	Noun
istenemért	Noun
blansírozó	Participle
munkáltatóktól	Noun
megszámlálhatóvá	Noun
briliánsnak	Noun
polgármesteréről	Noun
műkorcsolyázásról	Noun
albumokon	Noun
törniük	Verb
repteret	Noun
destruktív	Noun
megjelöli	Verb
fülkéhez	Noun
értesülök	Verb
hegytetők	Noun
mozdulatlan	Noun
megújhodok	Verb
ritka	Noun
kerülgesd|or|	Verb
nászt	Noun
csomó	Noun
varázslatosakon	Noun
műszer	Noun
csatahajóvá	Noun
tervekre	Noun
aggályok	Noun
hatalmától	Noun
történetíróra	Noun
mozdulatokért	Noun
kabinetjében	Noun
szimfóniákból	Noun
lányra	Noun
méretűekként	Noun
pénzügyminiszterhez	Noun
városokban	Noun
túllép	Verb
felépítették	Verb
szonáta	Noun
rokonsággal	Noun
pályázatokban	Noun
hivatkozástól	Noun
kaktuszoknak	Noun
jiddist	Noun
dominóval	Noun
üvöltésekből	Noun
községtől	Noun
mélyebbre	Noun
viszonya	Noun
lélegzettel	Noun
királyságon	Noun
pont	Noun
imádságokig	Noun
betyárnak	Noun
elszólás	Noun
zenekaron	Noun
leigázz|or|	Verb
jeléhez	Noun
titkolva	Converb
üldögélni	Verb
szervezetektől	Noun
szereplő	Noun
zűrbe	Noun
listákból	Noun
pofák	Noun
fenyőtoboz	Noun
pillangókkal	Noun
húsba	Noun
megtartják	Verb
savat	Noun
ellenfélnél	Noun
kalandokkal	Noun
kamelotra	Noun
amfóra	Noun
kan	Noun
szakállá	Noun
rádiónak	Noun
kivégzőosztagra	Noun
utóbbiakból	Noun
élményekhez	Noun
bástyától	Noun
kenőcs	Noun
kelmefestők	Noun
szerkezetekre	Noun
könyvén	Noun
alkatrészt	Noun
csapvízzel	Noun
összeállította	Verb
időintervallumnál	Noun
értelmezésieknek	Noun
légzsákok	Noun
szamarat	Noun
keresztelést	Noun
állásfoglalásokat	Noun
dodekaéder	Noun
kedv	Noun
évét	Noun
romossá	Noun
hüledeznetek	Verb
vezetést	Noun
totálban	Noun
felkészülnie	Verb
agyonütötte	Verb
ügyesnek	Noun
indigó	Noun
célozni	Verb
csoportosításhoz	Noun
portánál	Noun
fogorvossal	Noun
fotóvá	Noun
alföldet	Noun
nyelvtannal	Noun
tanszékké	Noun
mesékről	Noun
felhőkön	Noun
keltjük	Verb
szurony	Noun
alpinizmus	Noun
kanárikra	Noun
elektronmikroszkópokon	Noun
számlálót	Noun
javasolná	Verb
bitből	Noun
biztosíték	Noun
szemléletnek	Noun
fésülni	Verb
bizottságán	Noun
gondolataiból	Noun
fehérneműben	Noun
utaljanak	Verb
űrre	Noun
civilizációba	Noun
oldalának	Noun
filmfesztiválnak	Noun
mátkáktól	Noun
bizonyosakká	Noun
következményének	Noun
ültessenek	Verb
lucfenyőkre	Noun
alkalmatlannak	Noun
elődökkel	Noun
teszteltem	Verb
kocsira	Noun
rendellenességként	Noun
csapatot	Noun
rövidebbektől	Noun
hipotézisekkel	Noun
képeknél	Noun
különbözzön	Verb
nyomozóhoz	Noun
radiációknak	Noun
aranytól	Noun
zoológiákért	Noun
pirítósra	Noun
dialektushoz	Noun
reszelőtől	Noun
meglepetés	Noun
bakanccsá	Noun
tervezetét	Noun
atomfegyver	Noun
lakhelyként	Noun
megbízásával	Noun
lencsének	Noun
piramishoz	Noun
sáfár	Noun
rudakat	Noun
szűzzel	Noun
libidókat	Noun
adattal	Noun
barikádokat	Noun
nyomdákban	Noun
molekuláról	Noun
dacoló	Participle
összejövetelek	Noun
koreográfiák	Noun
libaúsztatónak	Noun
dzsókerek	Noun
blogokban	Noun
aranyosak	Noun
gyászjelentésben	Noun
kórusba	Noun
zsinagógát	Noun
tanulsággal	Noun
zöldségárus	Noun
bemutatójától	Noun
anyagából	Noun
internetről	Noun
helyeset	Noun
honlapok	Noun
tulipánokat	Noun
copfot	Noun
házigazda	Noun
költségvetéshez	Noun
dália	Noun
hetét	Noun
olvasóteremben	Noun
kincstárnokot	Noun
ellentmondáshoz	Noun
italoktól	Noun
tanya	Noun
verandával	Noun
megbeszélésekbe	Noun
byte-ok	Noun
szülésznők	Noun
szinkronszínészek	Noun
fosztja	Verb
elősegítésére	Noun
időszakhoz	Noun
társulások	Noun
honvédek	Noun
szomorúhoz	Noun
engedelmességként	Noun
fordításira	Noun
nyugdíjasként	Noun
változóba	Noun
fejére	Noun
robotoltatok	Verb
fajává	Noun
kőbányáknál	Noun
kizárások	Noun
köszönhetőn	Noun
koronához	Noun
kincsről	Noun
mennyiségnek	Noun
csipketerítőről	Noun
bizonyítékot	Noun
családjára	Noun
karmesterrel	Noun
elnevezésbe	Noun
üzemanyagtartályban	Noun
kijáratnál	Noun
szappanhabért	Noun
harcoltunk	Verb
egyenlíteni	Verb
fürdőszobásakként	Noun
nadrágtartóba	Noun
furulyát	Noun
terhelésre	Noun
legkíméletesebb	Noun
alezredesek	Noun
tehetetlenre	Noun
tisztábbakig	Noun
törődjön	Verb
cigánysággal	Noun
nevükön	Noun
küzdelemnél	Noun
polihisztornak	Noun
mait	Noun
igazolásokkal	Noun
barátainál	Noun
pingvineknek	Noun
gyorsat	Noun
dollárokat	Noun
jód	Noun
jegyben	Noun
gyanúsítják	Verb
kaktusz	Noun
számlál	Verb
előírásoknak	Noun
cickányokhoz	Noun
egyenlőségjellel	Noun
szerzetesnek	Noun
szaporodjon	Verb
antiszeptikumként	Noun
utánanéztél	Verb
telepednek	Verb
anyagokból	Noun
mosolygó	Participle
utóneveket	Noun
akusztikus	Noun
újjászületésről	Noun
bizonyosság	Noun
alpolgármesterről	Noun
képzéséért	Noun
képzésnek	Noun
kolostorra	Noun
rakodómunkásnál	Noun
szervvé	Noun
átvenniük	Verb
várakozásnak	Noun
frekvenciával	Noun
mészárlással	Noun
értesültem	Verb
romantikával	Noun
komp	Noun
kocsikat	Noun
átmenethez	Noun
megtestesülésekben	Noun
asztrahánt	Noun
irányítását	Noun
rázásban	Noun
savanyúságokig	Noun
telefonálnak	Verb
szériában	Noun
mandzsettagombhoz	Noun
nyilakon	Noun
növelendő	Participle
díszítésnek	Noun
óceánoktól	Noun
dobozokba	Noun
colossal	Noun
bórsav	Noun
hártyával	Noun
ízelítő	Noun
hitvest	Noun
létesítik	Verb
posztolnod	Verb
prímet	Noun
szóközt	Noun
bankszámlaként	Noun
színésznőből	Noun
testben	Noun
megöltek	Verb
fordulatszámmérőt	Noun
albumokra	Noun
múló	Participle
tanévtől	Noun
féltékenységről	Noun
szurkoló	Noun
önkormányzatnak	Noun
kerékpárnak	Noun
munkatársai	Noun
völgyről	Noun
rejlenetek	Verb
néger	Noun
létrehozniuk	Verb
elvesztésénél	Noun
ebédlővel	Noun
síkságokat	Noun
szekciókra	Noun
gémeskutakat	Noun
frissülnötök	Verb
hasábjai	Noun
forgalmának	Noun
grófokkal	Noun
észlelik	Verb
részleghez	Noun
módnak	Noun
szanatóriumok	Noun
szélmalmoktól	Noun
dolgokról	Noun
hamszinba	Noun
biztosítékok	Noun
tömeges	Noun
felépítésénél	Noun
fiatalságról	Noun
évekbeliekig	Noun
iparokká	Noun
láp	Noun
mértanoknál	Noun
házimozi	Noun
fűhöz	Noun
polgármesterét	Noun
megteremtéséhez	Noun
palánták	Noun
névelőből	Noun
szokatlant	Noun
biztosításivá	Noun
megnyílnak	Verb
meglátta	Verb
mirigyet	Noun
gyökerezik	Verb
kupolában	Noun
malomból	Noun
vizák	Noun
angyalként	Noun
állításáért	Noun
gúnynak	Noun
átmérőkről	Noun
hosszabbnak	Noun
kabinetnek	Noun
kalpagban	Noun
tekintetbe	Noun
összeállít	Verb
nyilvántartásból	Noun
erényből	Noun
szajrévá	Noun
vénnek	Noun
párkányok	Noun
sorssal	Noun
szólaljon	Verb
óceánparton	Noun
védelemmel	Noun
lelkesedik	Verb
tűrhetetleneken	Noun
jellemzővel	Noun
adócsökkentés	Noun
alkotásért	Noun
kódoltakra	Noun
teknőket	Noun
közüzem	Noun
önkormányzatból	Noun
úszással	Noun
elkészítésénél	Noun
húsokhoz	Noun
kegyelmeken	Noun
tükrözve	Converb
időintervallumoknál	Noun
kérdőívben	Noun
ügynökséghez	Noun
válaszából	Noun
korszerűsítésre	Noun
epilepsziákon	Noun
szolgáltatásnak	Noun
motorkerékpárokat	Noun
gordonkáról	Noun
királyivá	Noun
ágába	Noun
sípcsontokig	Noun
csigalépcsőn	Noun
csillagrendszereket	Noun
évtizedes	Noun
szórakoztatni	Verb
fesztiváltól	Noun
nagyközönséggel	Noun
kicseréljék	Verb
palotákhoz	Noun
ideálistól	Noun
fokozatoknál	Noun
dobozosakkal	Noun
felhívod	Verb
zafírt	Noun
szemceruzába	Noun
tangóznia	Verb
manipulálták	Verb
kortyot	Noun
utóddal	Noun
szegediekhez	Noun
évfolyamokban	Noun
anyaországokon	Noun
kádat	Noun
kertészetben	Noun
rögzít	Verb
pora	Noun
misztériumokba	Noun
dátum	Noun
eledele	Noun
átadásával	Noun
küldésén	Noun
munkáival	Noun
ötletekkel	Noun
nehézkesnek	Noun
szívószállal	Noun
fázisba	Noun
száraznak	Noun
érdemeshez	Noun
álcát	Noun
füsttől	Noun
erősítik	Verb
felsőfokban	Noun
nyereg	Noun
jenkik	Noun
fogyasztja	Verb
gerillaháború	Noun
hallhatókkal|	Noun
gilisztákért	Noun
vágáshoz	Noun
forgalom	Noun
tehénnek	Noun
cserépbe	Noun
emelnek	Verb
szabadságra	Noun
copf	Noun
tengelykapcsolókért	Noun
hamvazószerdákkal	Noun
felújítást	Noun
forgalmába	Noun
illatával	Noun
hotelnél	Noun
körülményeiről	Noun
testvériségről	Noun
beleüvölti	Verb
eredményesebb	Noun
sportágakkal	Noun
szandált	Noun
látványosak	Noun
körözve	Converb
munkájukon	Noun
felkérik	Verb
kódjából	Noun
sáskákban	Noun
sertéseknek	Noun
sporttal	Noun
egyezniük	Verb
rejtvényt	Noun
modulokat	Noun
mellékelnie	Verb
megértéssel	Noun
közeljövő	Noun
gyomok	Noun
virágcseréppé	Noun
udvarán	Noun
gombával	Noun
származás	Noun
vívnia	Verb
kivétellel	Noun
elraboltok	Verb
bemutassa	Verb
zöldségek	Noun
világítótoronyhoz	Noun
ecsetekkel	Noun
kockázatról	Noun
szüfrazsetthez	Noun
barátságokat	Noun
emlékezőtehetségekké	Noun
részecskegyorsítót	Noun
világbajnokot	Noun
informálisig	Noun
beszámolókban	Noun
tapasztalataira	Noun
akvarelleket	Noun
elhagyná	Verb
foglalkoztat	Verb
kiütések	Noun
kapcsot	Noun
áldozatra	Noun
szabadrúgásban	Noun
jellemzője	Noun
fejlettebb	Noun
kövérségekről	Noun
lejátszani	Verb
teremtésként	Noun
trópusiakból	Noun
hazánkhoz	Noun
internetre	Noun
marháról	Noun
kontrolláló	Participle
holdvilágnak	Noun
majoránnától	Noun
lépésének	Noun
iszonyúakról	Noun
aranylakodalomban	Noun
kegyelemre	Noun
viselkedéssel	Noun
csokroknak	Noun
intézkedésben	Noun
háta	Noun
cenzúra	Noun
hozzászólásokra	Noun
megkoronázta	Verb
unióért	Noun
játékfilmnek	Noun
hirdeti	Verb
kozmoszból	Noun
négyzetgyökért	Noun
minőséggel	Noun
nehezítik	Verb
konkretizálta	Verb
lapító	Participle
alábecsüli	Verb
expedícióra	Noun
okra	Noun
nehézzé	Noun
kombájn	Noun
robbanást	Noun
lövésznek	Noun
idegenvezetők	Noun
talizmánt	Noun
rendszerekkel	Noun
szájpadlás	Noun
mágusnak	Noun
dalszöveget	Noun
egyénekre	Noun
intézzék	Verb
közleményre	Noun
vízkereszteket	Noun
csellóra	Noun
határidejéig	Noun
megnyugtatón	Noun
mérkőzésekkel	Noun
magázták	Verb
kereskedelmet	Noun
pikkelyeket	Noun
múljon	Verb
felnagyítják	Verb
sziromnak	Noun
percem	Noun
földrészt	Noun
dollárok	Noun
állatorvosokban	Noun
könyvétől	Noun
számolótáblák	Noun
írnoknak	Noun
aláírásán	Noun
felbontáson	Noun
nyelvészekből	Noun
tolongtak	Verb
otthontól	Noun
tengelyek	Noun
feltételessé	Noun
madárijesztő	Noun
területéig	Noun
vénasszonyokba	Noun
polisztirol	Noun
világbajnokságba	Noun
hasisokként	Noun
segédigék	Noun
határozattal	Noun
külpolitikáról	Noun
padokat	Noun
gyújtogatásért	Noun
depresszióval	Noun
végrehajtjuk	Verb
erdőkkel	Noun
átalakítsa	Verb
sorokban	Noun
kategorizáljatok	Verb
felszín	Noun
közvetettekben	Noun
vakolatra	Noun
nyomdának	Noun
patkó	Noun
munkabér	Noun
havaztak	Verb
ágytálra	Noun
társulatot	Noun
keselyűnek	Noun
nagybetűket	Noun
feliratokra	Noun
idegrendszernek	Noun
űrhajósokon	Noun
újságcikkel	Noun
cionizmus	Noun
gonddá	Noun
bemutatása	Noun
fejőstehenek	Noun
hálaadásokról	Noun
módszerén	Noun
felálltak	Verb
rákkutatással	Noun
informatikával	Noun
díjakhoz	Noun
rekordként	Noun
párbajokhoz	Noun
típusára	Noun
viseljék	Verb
drámákban	Noun
festményekhez	Noun
tisztviselőt	Noun
ként	Noun
kompenzációkra	Noun
szegénynegyedek	Noun
értékeivel	Noun
kormányhoz	Noun
távolságon	Noun
állatorvosok	Noun
problémán	Noun
csontdaganatig	Noun
tanácsába	Noun
köldököket	Noun
csereként	Noun
összehasonlíthatóvá	Noun
tipegne	Verb
sablonokba	Noun
sokaságot	Noun
hordákkal	Noun
áttörést	Noun
társaiktól	Noun
ellenőrzését	Noun
kiáltják	Verb
praktikusnál	Noun
dolgokon	Noun
gatyába	Noun
hangoskönyv	Noun
zseblámpából	Noun
nyomorokból	Noun
veszítette	Verb
szűrőnek	Noun
megkönnyítendő	Participle
csigolyán	Noun
utónév	Noun
örökségben	Noun
kritika	Noun
erdőkért	Noun
természetéből	Noun
figyelmébe	Noun
bevitték	Verb
garázsból	Noun
halmazokon	Noun
létrehozol	Verb
bombák	Noun
erőforrásokkal	Noun
gondozó	Participle
patikusként	Noun
közegen	Noun
képesítési	Noun
tanulmányokat	Noun
góig	Noun
ebéden	Noun
elemeit	Noun
blúzban	Noun
márkáknál	Noun
informatikusként	Noun
xenon	Noun
razziába	Noun
betegyük	Verb
bosszantani	Verb
arányhoz	Noun
karók	Noun
építészettel	Noun
jelmezeken	Noun
arkhimédésziig	Noun
értékrendek	Noun
titkárnőnek	Noun
kijelölniük	Verb
reményeket	Noun
raktárakra	Noun
hordalékát	Noun
százszorszép	Noun
áldoztak	Verb
kamatozik	Verb
normához	Noun
rozsdához	Noun
struktúrákat	Noun
tábornokkal	Noun
speciális	Noun
technikához	Noun
hamvasztásokért	Noun
hasogatni	Verb
alkalmazkodjanak	Verb
ösztönökre	Noun
termésre	Noun
vonzana	Verb
demagógiákra	Noun
képzéshez	Noun
csomagtartónál	Noun
hozzájárulás	Noun
vesztegeti	Verb
szivárványhoz	Noun
folyékonynál	Noun
feltalálták	Verb
tobozokat	Noun
tanúskodik	Verb
alkalmasakra	Noun
peronba	Noun
akadémiának	Noun
véglegesítő	Participle
befedjék	Verb
nemző	Participle
bizonyítványt	Noun
továbbképzéseken	Noun
cipó	Noun
dolmányért	Noun
színházaknál	Noun
igyekezetek	Noun
ágazaton	Noun
darabjaként	Noun
hurcoltuk	Verb
csapdára	Noun
határidők	Noun
abszint	Noun
pszichológiában	Noun
törvényként	Noun
testekhez	Noun
zaklatottságtól	Noun
gramm	Noun
foglalkoztatással	Noun
felbontsam|	Verb
ibriknél	Noun
bélyegekre	Noun
tobogán	Noun
napig	Noun
körzeteket	Noun
sajt	Noun
kétévesnél	Noun
műértők	Noun
mentőautóban	Noun
általánosságban	Noun
hasznosabbnál	Noun
méréseket	Noun
kitörjenek	Verb
filmrendezőt	Noun
kapuimból	Noun
weboldalak	Noun
oxidációra	Noun
biztonságról	Noun
meglepő	Participle
paraméterben	Noun
helyszínekhez	Noun
udvaroncokra	Noun
ovinál	Noun
gyümölcslevek	Noun
csábítsa	Verb
szlengig	Noun
harcművészetekhez	Noun
kolonializmus	Noun
megfogalmazásában	Noun
nyakszirt	Noun
fénysebességnél	Noun
részesüljön	Verb
csatákba	Noun
partnerével	Noun
kanálról	Noun
megfagynak	Verb
fordítótól	Noun
percmutatóból	Noun
szava	Noun
ellenőrök	Noun
címezte	Verb
texasiak	Noun
evangéliumok	Noun
rosszabbat	Noun
terméseket	Noun
kézügyességet	Noun
medvékkel	Noun
madarászok	Noun
hunynék	Verb
villamosság	Noun
fejti	Verb
nyaraltak	Verb
emelésére	Noun
esteknek	Noun
űrkutatást	Noun
tetoválva	Converb
akadémiákkal	Noun
egyházfővel	Noun
májusából	Noun
tragédiáról	Noun
árverések	Noun
finanszíroznia	Verb
cickány	Noun
nyelvvizsgát	Noun
csoportelmélet	Noun
promóciót	Noun
mátrixba	Noun
ábrával	Noun
albatrosz	Noun
zokniként	Noun
ornitológiaiakról	Noun
fejétől	Noun
szervben	Noun
tárgyakba	Noun
marhának	Noun
felhasználónevet	Noun
szívószálat	Noun
gyűrűből	Noun
kapcsolatoktól	Noun
bányászhoz	Noun
börtönökben	Noun
felhasználnunk	Verb
mobiltelefonon	Noun
idejébe	Noun
gyűléseknek	Noun
vezetésnél	Noun
korszerűnek	Noun
förgeteg	Noun
környékéről	Noun
sámánnal	Noun
látásnak	Noun
kézműveseket	Noun
hadműveletben	Noun
mestere	Noun
határidőn	Noun
agyak	Noun
szolgáltatásaiban	Noun
centripetálisnak	Noun
ajándékától	Noun
szélrózsa	Noun
rizómából	Noun
összege	Noun
variációkat	Noun
pizsamához	Noun
csöpögnünk	Verb
megsemmisítenek	Verb
sör	Noun
randit	Noun
tojáslikőrökben	Noun
kórokozónak	Noun
világával	Noun
szájhagyományon	Noun
bírságnál	Noun
vázakba	Noun
valóba	Noun
vendéglátóipari	Noun
összezsugorítsátok	Verb
onomasztikákba	Noun
ventilátorokat	Noun
habokat	Noun
teherautókban	Noun
űrruhává	Noun
üvöltéssel	Noun
bárkákat	Noun
pedikűrösökön	Noun
befektetés	Noun
nyomdásznak	Noun
élőlényt	Noun
sikerhez	Noun
tartásról	Noun
tevegelünk	Verb
listává	Noun
tiltakozások	Noun
vetítéssel	Noun
fejlesztéséért	Noun
teljesíti	Verb
elbeszélésekkel	Noun
virulensekké	Noun
felületbe	Noun
vadászatokon	Noun
egységesekben	Noun
kerületnek	Noun
Linux	Noun
avanzsíroztad	Verb
levelekké	Noun
háborúsban	Noun
szorzással	Noun
köhögni	Verb
csapás	Noun
ejtőernyős	Noun
előadva	Converb
csendekhez	Noun
kódban	Noun
státuszokat	Noun
magömlést	Noun
összegyűlnöm	Verb
szigetvilágra	Noun
nyelvűre	Noun
margótól	Noun
konföderációk	Noun
csajt	Noun
kifizetve	Converb
animációval	Noun
páncélautón	Noun
rákokból	Noun
zongorával	Noun
kiverték	Verb
verziótól	Noun
mérlegeli	Verb
rádióból	Noun
házként	Noun
nézetekig	Noun
barátkeselyű	Noun
májba	Noun
nyakfodron	Noun
golfoznod	Verb
töltényig	Noun
ítéletek	Noun
éhestől	Noun
lovakhoz	Noun
recesszió	Noun
ikrákat	Noun
legakrobatikusabbnál	Noun
megnősül	Verb
sikítanám|	Verb
mészkövek	Noun
kapacitásának	Noun
trilógiából	Noun
étlapon	Noun
lemezekről	Noun
zsíroznunk	Verb
sorsra	Noun
emberein	Noun
bosnyák	Noun
tiszafákig	Noun
mosómedvével	Noun
hasznosabb	Noun
fejdíszként	Noun
fűzfapoétánál	Noun
megbízásból	Noun
hegyekhez	Noun
fosszuk	Verb
átlós	Noun
előadóteremhez	Noun
felír	Verb
bizalommal	Noun
licencével	Noun
fejdísz	Noun
éremben	Noun
népdalból	Noun
boglyáknak	Noun
combon	Noun
képviselőkkel	Noun
végébe	Noun
részként	Noun
történetinek	Noun
filmtől	Noun
kaszinókba	Noun
autózva	Converb
suna	Noun
méretéről	Noun
feltárásról	Noun
egyházszakadással	Noun
fenyegetésekből	Noun
szerzetesrendeknek	Noun
frissítésen	Noun
összegyűjtik	Verb
államcsínyekre	Noun
létéért	Noun
fontosnak	Noun
életüknek	Noun
szkennerrel	Noun
turnékat	Noun
anyjáért	Noun
értékéhez	Noun
legokosabb	Noun
bankjegynek	Noun
légitársaságoktól	Noun
újraválasztani	Verb
növesztette	Verb
cikkelyt	Noun
ködön	Noun
kódtól	Noun
bulvárlapoktól	Noun
vendégszobákat	Noun
világosnak	Noun
kihasználjon	Verb
megemlítik	Verb
tanácsolva	Converb
betartása	Noun
festészettel	Noun
elsüllyednie	Verb
fogadására	Noun
álommal	Noun
janicsárral	Noun
int	Verb
kereskedőkből	Noun
birodalmiakat	Noun
sereg	Noun
törpebolygókat	Noun
összehívó	Participle
deltához	Noun
napóra	Noun
vulkánba	Noun
gyorsabbá	Noun
vitorlázó	Participle
felkerestem	Verb
kapuidat	Noun
kilépjünk	Verb
feltártak	Verb
kötéseknek	Noun
forogtál	Verb
sávokkal	Noun
génekről	Noun
külvilágból	Noun
ellátandó	Participle
kereséssel	Noun
kupolába	Noun
bombázóhoz	Noun
fedelektől	Noun
dobó	Noun
árnyékának	Noun
acéllemezből	Noun
megfojt	Verb
töve	Noun
mérnököket	Noun
hajhullámból	Noun
ballag	Verb
vitán	Noun
arkangyalokra	Noun
szigettel	Noun
zsíroztál	Verb
takácsok	Noun
kiállításra	Noun
következményeket	Noun
létrehoznék	Verb
portáig	Noun
feldolgozók	Noun
pénzeket	Noun
legyezőn	Noun
harctól	Noun
nemzette	Verb
cukornád	Noun
felkészítve	Converb
várólistáról	Noun
teraszoknak	Noun
hallgatókra	Noun
tesztelésen	Noun
centisek	Noun
kimenetben	Noun
napéjegyenlőséget	Noun
hadműveletekhez	Noun
kiemelteknél	Noun
együttműködnek	Verb
faszénen	Noun
árpához	Noun
reggeliző	Participle
szemtanúként	Noun
atomfegyverekben	Noun
birkákhoz	Noun
gúnárnál	Noun
ovikra	Noun
emelendő	Participle
üríteni	Verb
előfutárok	Noun
kihívások	Noun
íródtam	Verb
társadalommal	Noun
költségének	Noun
partitúrán	Noun
szeles	Noun
ítéljen	Verb
üdvösségről	Noun
eseményeihez	Noun
dezertálni	Verb
hozzájárulásnak	Noun
szakadásig	Noun
elsodor	Verb
szolgálatába	Noun
alapokra	Noun
bajnokként	Noun
üzemmódok	Noun
férfiasság	Noun
bosnyákok	Noun
muhartól	Noun
gyógyszerről	Noun
vásárfiává	Noun
szentélyhez	Noun
tengerészekre	Noun
sugároznia	Verb
mélyhegedűért	Noun
megjátszania	Verb
közléshez	Noun
vásárában	Noun
vizionáltatok	Verb
képpontban	Noun
bézseken	Noun
emelés	Noun
életedért	Noun
neutronokkal	Noun
állapítanak	Verb
baloldalig	Noun
lisztbe	Noun
befecskendezések	Noun
animációknak	Noun
negyedévre	Noun
himnusszá	Noun
terében	Noun
térképen	Noun
lezuhanó	Participle
forgalmazásához	Noun
szép	Noun
kifogással	Noun
előállítanak	Verb
olvasásról	Noun
ruha	Noun
kapcsolót	Noun
freudiként	Noun
népességhez	Noun
tömbökre	Noun
álcázni	Verb
pezsgőstől	Noun
közgazdászként	Noun
jellegűre	Noun
egyesítésre	Noun
külfölddel	Noun
kedvedre	Noun
költőnő	Noun
narválokon	Noun
oltárban	Noun
vallásból	Noun
útjával	Noun
nyomokról	Noun
bátorítják	Verb
blokkolnának	Verb
cékla	Noun
érdemesebbekké	Noun
témává	Noun
gurukat	Noun
jasmakról	Noun
hamvasztanék	Verb
sajátosságokat	Noun
nyögő	Participle
vizelni	Verb
méter	Noun
ebéddel	Noun
kórusokká	Noun
cselekményekben	Noun
pihenéseken	Noun
ruhájukra	Noun
vidékhez	Noun
környezetvédelemért	Noun
tulajdonságban	Noun
szobrocskákat	Noun
gyanúsítotton	Noun
szintézisre	Noun
szakmaiakra	Noun
ajánlattal	Noun
öngyilkosságok	Noun
bundában	Noun
intézményesen	Noun
megkérdeztél	Verb
szószedetben	Noun
lebeszélni	Verb
árkokat	Noun
katedrálisba	Noun
neveltetésévé	Noun
oxidokkal	Noun
demó	Noun
rítusra	Noun
hangverseny	Noun
türelemnek	Noun
gyakorlatra	Noun
szándékoztuk	Verb
eszközöket	Noun
gyufáknak	Noun
szülés	Noun
gátig	Noun
kulcsszónak	Noun
romoknál	Noun
feldolgozást	Noun
mártírokat	Noun
szövetségekben	Noun
lehetőségeként	Noun
kedvekért	Noun
szereplőként	Noun
mocskos	Noun
nyakkendők	Noun
prózának	Noun
molnár	Noun
színárnyalatok	Noun
aktusban	Noun
tehetségesen	Noun
szülőfölddel	Noun
árnyaknak	Noun
fiává	Noun
reptérre	Noun
városállamért	Noun
üvegbe	Noun
körszínházakig	Noun
apostolokkal	Noun
futóműre	Noun
kézikönyveket	Noun
atyjáról	Noun
indokolatlan	Noun
diótortáknál	Noun
részeinek	Noun
tornácra	Noun
egybevágjunk	Verb
nemzetektől	Noun
hibának	Noun
zenéig	Noun
szemek	Noun
antipatikusaknak	Noun
konföderációtól	Noun
meglevőkért	Noun
századosról	Noun
szélességen	Noun
harckocsivá	Noun
vártakon	Noun
formájára	Noun
űrruha	Noun
összetételben	Noun
hisztogramok	Noun
támaszokon	Noun
üstökösben	Noun
rendeletre	Noun
vész	Noun
újoncokat	Noun
tűzoltóság	Noun
szakmává	Noun
reggelivel	Noun
reklámozta	Verb
maharadzsákban	Noun
tisztogatás	Noun
zsinatról	Noun
földnyelven	Noun
pincékből	Noun
leggonoszabb	Noun
rakétákra	Noun
pestisért	Noun
hátrányosak	Noun
szándékára	Noun
módszert	Noun
háttereket	Noun
leintettem	Verb
koreográfia	Noun
dagonyázó	Participle
pletykákra	Noun
grammnál	Noun
zongoraórát	Noun
ediktumot	Noun
családfőnek	Noun
szükségességében	Noun
tehénnel	Noun
étlapokon	Noun
szervereket	Noun
megőrzése	Noun
középpontjává	Noun
tábláról	Noun
bugyik	Noun
forgatónyomatékkal	Noun
csábítunk	Verb
hangszerelő	Participle
terephez	Noun
gázló	Noun
leprások	Noun
adós	Noun
érintetlenebbhez	Noun
újításokat	Noun
lapomként	Noun
földjéből	Noun
újakra	Noun
nyelvvizsgára	Noun
axiómából	Noun
dóban	Noun
központinál	Noun
kérődző	Participle
harckocsik	Noun
vulkánnal	Noun
napilappá	Noun
bélre	Noun
blogolva	Converb
pozsonyiak	Noun
szimfónia	Noun
elméletté	Noun
autóról	Noun
ragasztunk	Verb
ünnepéig	Noun
kezdetekhez	Noun
megmentettem	Verb
idősebbeket	Noun
megélhetésért	Noun
igazságosságról	Noun
végzettségűekről	Noun
potyka	Noun
illesztőprogramok	Noun
leghamisabb	Noun
mérsékelünk	Verb
fibrilláltak	Verb
solymász	Noun
készítésébe	Noun
ludaktól	Noun
kívánságodról	Noun
khmer	Noun
fogorvoshoz	Noun
világgazdaság	Noun
mineralológiákban	Noun
tanulmányával	Noun
sorozatnak	Noun
elhelyezésén	Noun
fegyveressel	Noun
szabadcsapatokat	Noun
mindkettőbe	Noun
blokkolná	Verb
felfogásból	Noun
utas	Noun
árkokba	Noun
bivallyal	Noun
megvalósításig	Noun
terelgette	Verb
altokként	Noun
aranyfüstön	Noun
terjedelemmel	Noun
fájdalomba	Noun
ittunk	Verb
műtőbe	Noun
vállalatokon	Noun
beállítod	Verb
élelmiszerre	Noun
tömegközlekedésben	Noun
támadások	Noun
főtitkárokként	Noun
szublimál	Verb
szenvedtünk	Verb
zsaluktól	Noun
magasságba	Noun
igazabb	Noun
hágóban	Noun
lapoknak	Noun
elbűvölve	Converb
egyesre	Noun
agyonszúrnia	Verb
megjelenítésében	Noun
pozíciókhoz	Noun
facsavarból	Noun
harisnyák	Noun
rongybabákból	Noun
szigetekből	Noun
anyánál	Noun
axiómaként	Noun
klór-dioxiddal	Noun
munkatárssal	Noun
kabinetjének	Noun
kiterjesszem|	Verb
buja	Noun
gyermekotthonok	Noun
miniszterekből	Noun
határértékekkel	Noun
beállításaidból	Noun
palotádban	Noun
alosztályokra	Noun
kullancsot	Noun
gyógypedagógiát	Noun
hordával	Noun
kardoskodtok	Verb
felrobbanjatok	Verb
felkészítésben	Noun
irodaszékek	Noun
problémádat	Noun
áthatolhatatlan	Noun
nyilvánosságnak	Noun
elsajátításokká	Noun
emberekről	Noun
vámok	Noun
előfordulásokat	Noun
elveibe	Noun
származásnak	Noun
gondtalanokhoz	Noun
csontvelő	Noun
pontszámon	Noun
szinkronszínészekkel	Noun
italoknak	Noun
megállíthatatlan	Noun
utaltam	Verb
gyászjelentést	Noun
léten	Noun
berendezésben	Noun
fáradtnak	Noun
boltkórosnál	Noun
vékony	Noun
viselkedésből	Noun
elküldöd	Verb
mellékhatásba	Noun
típusokkal	Noun
ecsetek	Noun
népéhez	Noun
reklám	Noun
kitiltják	Verb
szezonokat	Noun
hangszedőt	Noun
milliomosok	Noun
ismeretet	Noun
előadásokra	Noun
receptekkel	Noun
társának	Noun
kórházról	Noun
sajtóról	Noun
sejttanok	Noun
hátrálni	Verb
fogásként	Noun
előttinél	Noun
gondoskodunk	Verb
gordontól	Noun
tükrözzön	Verb
korongok	Noun
szakácsot	Noun
tavasziról	Noun
gyermeki	Noun
fejlődő	Participle
szervessel	Noun
királyságokban	Noun
halálát	Noun
nyilvántartották	Verb
vanádium	Noun
perifériákat	Noun
jelenethez	Noun
aranybánya	Noun
szerelni	Verb
neont	Noun
kitörtek	Verb
kivégzésre	Noun
fokhagyma	Noun
kötelezettségek	Noun
bepillantásokból	Noun
csővezetékben	Noun
akvarellek	Noun
szelektívek	Noun
taglaló	Participle
testületekből	Noun
táncosnőt	Noun
űrrepülőgépről	Noun
építészben	Noun
fejlődésnek	Noun
krematóriumban	Noun
inverziót	Noun
júniusáig	Noun
meglátok	Verb
tükrében	Noun
jogát	Noun
számlálóval	Noun
létesülünk	Verb
cselekményben	Noun
izgalommal	Noun
megalakulástól	Noun
nyitottak	Noun
szukáknál	Noun
ámokfutásokról	Noun
közhely	Noun
erőművekről	Noun
válasznak	Noun
mormoták	Noun
centrifuga	Noun
illetéket	Noun
céljaival	Noun
térképig	Noun
gyalogomban	Noun
gáncsért	Noun
egységekben	Noun
fújdogálnám|	Verb
sztorikat	Noun
cégeken	Noun
átadtál	Verb
macskakő	Noun
cégéhez	Noun
prófétanőket	Noun
epicentrumtól	Noun
veszprémit	Noun
komlónak	Noun
bakfisokig	Noun
hidegig	Noun
intelligenciával	Noun
atomfegyverek	Noun
varázzsá	Noun
flották	Noun
gyújtogatások	Noun
módosítania	Verb
építményeknek	Noun
közigazgatásból	Noun
átalakítása	Noun
dekadens	Noun
vigyorogtam	Verb
helyesbítő	Participle
nagyszerűek	Noun
ajánlását	Noun
hasznosakként	Noun
kesztyűben	Noun
adásnak	Noun
ékek	Noun
fahéjból	Noun
emlékeztessék	Verb
forrásnál	Noun
beállítással	Noun
fossak	Verb
anyaországhoz	Noun
jogerős	Noun
bulvárlapot	Noun
projektekből	Noun
szerkesztőnél	Noun
hajósok	Noun
termesztenek	Verb
izzadna	Verb
kőre	Noun
Velencéből	Noun
vasfüggöny	Noun
lassabbá	Noun
dezertál	Verb
szűkösnek	Noun
számtanból	Noun
módosítottad	Verb
remetelakot	Noun
filozófián	Noun
összeesküvések	Noun
sokktól	Noun
hibaként	Noun
mennyiséghez	Noun
szánalomból	Noun
igényelhető	Noun
kockák	Noun
köpenyben	Noun
felajánlottátok	Verb
információként	Noun
légierőt	Noun
levegőért	Noun
targoncákat	Noun
hóviharban	Noun
legrosszabbnak	Noun
arához	Noun
padlásszobához	Noun
végiggondolta	Verb
erőfeszítéseknek	Noun
képviselő-testületeken	Noun
fájlokra	Noun
dzsunkáért	Noun
levegyék	Verb
pincével	Noun
változásoktól	Noun
meghatározás	Noun
létrehozzon	Verb
izotópnak	Noun
működtetünk	Verb
diszperzióhoz	Noun
utazásokat	Noun
külügyiben	Noun
mikrofonba	Noun
semmirekellőt	Noun
átalakulással	Noun
eltűnve	Converb
akaraterőt	Noun
eredményen	Noun
feltételeitől	Noun
magánvéleménynek	Noun
importálták	Verb
járulék	Noun
mechanizmusokon	Noun
fonalat	Noun
külföldtől	Noun
füzettel	Noun
készpénzhez	Noun
támadásért	Noun
ügynök	Noun
mécseseken	Noun
stadionnal	Noun
elkészítésben	Noun
keresztnél	Noun
nyelvvizsgák	Noun
alakítottuk	Verb
partnerekkel	Noun
protokollokban	Noun
korm.-ban	Noun
korábbiakkal	Noun
mágnessel	Noun
megértésén	Noun
rúpiától	Noun
feszültségekhez	Noun
képviseletéről	Noun
fakírokkal	Noun
babérlevelek	Noun
adón	Noun
gégészekig	Noun
példányoknak	Noun
tenyésztettek	Verb
ártok	Verb
gyötörte	Verb
fiókával	Noun
mellékletének	Noun
lopásból	Noun
rendekkel	Noun
benzolgyűrűhöz	Noun
terítővel	Noun
figurát	Noun
kiskacsák	Noun
nőgyűlölőkön	Noun
ciszta	Noun
szférából	Noun
értékén	Noun
adómentességnek	Noun
kámfor	Noun
élvezetekben	Noun
