substituídas	None
acariciou	Third person Singular
misturadas	None
processassem	Third person Plural
socorro	First person Singular
fabrico	First person Singular
enganam	Third person Plural
intrometem	Third person Plural
degolas	Second person Singular
garantido	None
brindada	None
rejeitam	Third person Plural
inovados	None
roendo	None
simbolizadas	None
commeçai	Second person Plural
vazando	None
tens	Second person Singular
inundáveis	Second person Plural
governavam	Third person Plural
exacerbassem	Third person Plural
regenerou	Third person Singular
apoteotizadas	None
pões	Second person Singular
recomeçou	Third person Singular
desmaiando	None
seriaremos	First person Plural
atendessem	Third person Plural
enfurecido	None
curtindo	None
estatuo	First person Singular
assistido	None
filmavam	Third person Plural
rejeito	First person Singular
alistada	None
baixarias	Second person Singular
afectavam	Third person Plural
proveem	Third person Plural
entravasses	Second person Singular
extraditados	None
conferidos	None
implementáveis	Second person Plural
leras	Second person Singular
dilaceradas	None
atei	First person Singular
hospitalizado	None
incidirá	Third person Singular
sitiavam	Third person Plural
irritou	Third person Singular
ridicularizadas	None
rematadas	None
moverão	Third person Plural
inscrevêramos	First person Plural
restituiu	Third person Singular
assustavam	Third person Plural
saco	First person Singular
despercebidos	None
assegurassem	Third person Plural
tipáramos	First person Plural
pertencerão	Third person Plural
sabotaremos	First person Plural
mitigado	None
impulsionam	Third person Plural
tenderemos	First person Plural
atrasaremos	First person Plural
ordeno	First person Singular
tencionadas	None
consistíreis	Second person Plural
retraídos	None
engrenadas	None
atacado	None
apegamos	First person Plural
cozido	None
basto	First person Singular
empeçonhada	None
desembalaríamos	First person Plural
vocalizam	Third person Plural
pranteando	None
adquiridos	None
saras	Second person Singular
causo	First person Singular
apagarão	Third person Plural
tratamos	First person Plural
cumprimentavam	Third person Plural
expectorada	None
engraxassem	Third person Plural
acerbados	None
afetariam	Third person Plural
arquitetais	Second person Plural
panas	Second person Singular
traiu	Third person Singular
supro	First person Singular
espancados	None
pintará	Third person Singular
preservará	Third person Singular
implorarei	First person Singular
debruçarei	First person Singular
colherão	Third person Plural
chuto	First person Singular
bifurcado	None
hibernam	Third person Plural
corrigias	Second person Singular
açacalado	None
teorizávamos	First person Plural
apaixonadas	None
restabelecidos	None
empolgarás	Second person Singular
castro	First person Singular
cativas	Second person Singular
manobravam	Third person Plural
domestico	First person Singular
demandará	Third person Singular
pesquisará	Third person Singular
evocada	None
impugnado	None
desmarcou	Third person Singular
queixas	Second person Singular
ligavam	Third person Plural
esquiastes	Second person Plural
photographadas	None
elucidados	None
aceitavam	Third person Plural
tremulais	Second person Plural
aboliam	Third person Plural
abaixou	Third person Singular
especializadas	None
viemos	First person Plural
sintetizamos	First person Plural
salpicados	None
perseverado	None
enfurecem	Third person Plural
reestruturei	First person Singular
espumássemos	First person Plural
emparelham	Third person Plural
inutilizareis	Second person Plural
enfraqueceu	Third person Singular
reluto	First person Singular
citaremos	First person Plural
asai	Second person Plural
efectuai	Second person Plural
concordássemos	First person Plural
ripo	First person Singular
ridicularizado	None
enfeitavam	Third person Plural
identificamos	First person Plural
abrigarão	Third person Plural
reservou	Third person Singular
empatavam	Third person Plural
contestáveis	Second person Plural
poderíamos	First person Plural
estimulando	None
embasado	None
decantada	None
ladrados	None
publiquei	First person Singular
descarregou	Third person Singular
reclamariam	Third person Plural
ceceáreis	Second person Plural
dispersado	None
prefeririam	Third person Plural
pautas	Second person Singular
idealizavam	Third person Plural
decresciam	Third person Plural
fagulhas	Second person Singular
beiras	Second person Singular
integrarão	Third person Plural
descobertas	None
estabilizado	None
cabeceando	None
sabemos	First person Plural
amortecida	None
minas	Second person Singular
arrancavas	Second person Singular
derrapado	None
distinguidas	None
espoliados	None
manobrará	Third person Singular
alcunharíamos	First person Plural
estimásseis	Second person Plural
deserdada	None
reestruturadas	None
treinam	Third person Plural
acompanhará	Third person Singular
enchem	Third person Plural
abastecêsseis	Second person Plural
desoxigenásseis	Second person Plural
saluçados	None
prevaleceu	Third person Singular
anulo	First person Singular
abrirão	Third person Plural
perpetram	Third person Plural
alastrais	Second person Plural
despertando	None
debitasses	Second person Singular
estenografadas	None
dilapidássemos	First person Plural
arrumavam	Third person Plural
divido	First person Singular
espionavam	Third person Plural
fisgas	Second person Singular
importunaríeis	Second person Plural
traíras	Second person Singular
reavivada	None
significariam	Third person Plural
cooperam	Third person Plural
mascavando	None
susteve	Third person Singular
alocam	Third person Plural
engrossam	Third person Plural
gargarejo	First person Singular
disponibilizassem	Third person Plural
contestei	First person Singular
embrenhadas	None
pioradas	None
problematizado	None
sucedendo	None
sumis	Second person Plural
superassem	Third person Plural
cotovelando	None
regatado	None
cumprimentada	None
esticado	None
desempenhada	None
perdoará	Third person Singular
afivelado	None
mantende	Second person Plural
redimiu	Third person Singular
freqüentei	First person Singular
presidiu	Third person Singular
lográsseis	Second person Plural
recusam	Third person Plural
experimento	First person Singular
aproveitaríamos	First person Plural
embasam	Third person Plural
tramavam	Third person Plural
escurecidas	None
convidamos	First person Plural
combates	Second person Singular
reprisou	Third person Singular
vencidos	None
caçoados	None
denotaremos	First person Plural
fornecerá	Third person Singular
connectariam	Third person Plural
estuprou	Third person Singular
sincronizando	None
curaríeis	Second person Plural
replicou	Third person Singular
adaptado	None
requentavas	Second person Singular
interrompidas	None
vendando	None
exibindo	None
entorno	First person Singular
coas	Second person Singular
liberariam	Third person Plural
decretadas	None
anseio	First person Singular
estimou	Third person Singular
navegáveis	Second person Plural
paginaríamos	First person Plural
acederiam	Third person Plural
enlouquecerão	Third person Plural
sapeássemos	First person Plural
moldámos	First person Plural
apostrofarão	Third person Plural
apelavam	Third person Plural
direccionam	Third person Plural
entrelaçado	None
ideado	None
enfardadas	None
seguiu	Third person Singular
sincronizado	None
polidos	None
voou	Third person Singular
consagravam	Third person Plural
vigiados	None
arrastada	None
assumirá	Third person Singular
retorquidas	None
gestada	None
gelei	First person Singular
trabalharão	Third person Plural
unidas	None
designando	None
murchados	None
desaconselhadas	None
atrais	Second person Singular
investissem	Third person Plural
fosforilasses	Second person Singular
alongando	None
coloco	First person Singular
acrescentou	Third person Singular
presidida	None
desbloqueei	First person Singular
ofendiam	Third person Plural
abafou	Third person Singular
efetuado	None
estampado	None
mascateáreis	Second person Plural
invadiriam	Third person Plural
comportados	None
restaurada	None
tapam	Third person Plural
insistiríeis	Second person Plural
declinou	Third person Singular
aplaudo	First person Singular
desvalorizado	None
cindo	First person Singular
enfrentam	Third person Plural
incididos	None
destituiu	Third person Singular
cavalgou	Third person Singular
cancelamos	First person Plural
mandassem	Third person Plural
desaceleraste	Second person Singular
entusiasmado	None
conquistas	Second person Singular
desvinculou	Third person Singular
aluno	First person Singular
ambiguada	None
fermentavam	Third person Plural
surgissem	Third person Plural
assistiam	Third person Plural
confio	First person Singular
apurou	Third person Singular
querelas	Second person Singular
receberei	First person Singular
terdes	Second person Plural
trairão	Third person Plural
exijo	First person Singular
iro	First person Singular
surrupiareis	Second person Plural
ignorei	First person Singular
adjetivas	Second person Singular
choras	Second person Singular
aguardei	First person Singular
resultados	None
imiscuem	Third person Plural
reiniciam	Third person Plural
inventamos	First person Plural
tencionarei	First person Singular
transferiríamos	First person Plural
educou	Third person Singular
lançada	None
acendem	Third person Plural
amarei	First person Singular
machucariam	Third person Plural
inspecionadas	None
eximido	None
tremeu	Third person Singular
sintonizam	Third person Plural
esvoaçando	None
editas	Second person Singular
envernizadas	None
galopáveis	Second person Plural
quitaste	Second person Singular
wikifico	First person Singular
colocarei	First person Singular
querida	None
subvencionada	None
retificadas	None
namoram	Third person Plural
subsidiarias	Second person Singular
expirará	Third person Singular
comovendo	None
colonizarás	Second person Singular
precisaremos	First person Plural
ferias	Second person Singular
apelei	First person Singular
ligado	None
proporíamos	First person Plural
pensou	Third person Singular
atarefando	None
temperou	Third person Singular
injetam	Third person Plural
urtigas	Second person Singular
estacaríamos	First person Plural
espantavam	Third person Plural
fissurada	None
administrassem	Third person Plural
capturavam	Third person Plural
ofrecidas	None
afastou	Third person Singular
piscada	None
iniciai	Second person Plural
abarrotados	None
puniste	Second person Singular
amenizam	Third person Plural
exacerbando	None
ilegalizou	Third person Singular
colonizado	None
interpondo	None
telecomandamos	First person Plural
justificavam	Third person Plural
acrescentavam	Third person Plural
subirá	Third person Singular
festejando	None
sonharei	First person Singular
indiquei	First person Singular
relaxado	None
estruturas	Second person Singular
pretendem	Third person Plural
voam	Third person Plural
debuto	First person Singular
encorparão	Third person Plural
cobiçando	None
cifrou	Third person Singular
ensombrou	Third person Singular
alugada	None
ingeriu	Third person Singular
denunciada	None
irás	Second person Singular
abates	Second person Singular
reembolso	First person Singular
danificando	None
citaste	Second person Singular
jogavam	Third person Plural
driblando	None
forrando	None
usufruem	Third person Plural
gracitada	None
pronuncio	First person Singular
leu	Third person Singular
registrei	First person Singular
fraseassem	Third person Plural
amam	Third person Plural
sondada	None
podo	First person Singular
afectou	Third person Singular
denotado	None
jazida	None
aviventasses	Second person Singular
esgrimíeis	Second person Plural
ressoada	None
enchessem	Third person Plural
judiáreis	Second person Plural
facetados	None
arremessando	None
ajusto	First person Singular
equilibraremos	First person Plural
rebolaríeis	Second person Plural
foco	First person Singular
selecionassem	Third person Plural
adiou	Third person Singular
rescindindo	None
concatenavas	Second person Singular
pronunciariam	Third person Plural
adoecias	Second person Singular
desintegrada	None
multou	Third person Singular
reenviado	None
ousado	None
revelará	Third person Singular
ultimas	Second person Singular
parecessem	Third person Plural
resultam	Third person Plural
raspados	None
afagadas	None
russificarias	Second person Singular
largarias	Second person Singular
rolam	Third person Plural
focais	Second person Plural
debito	First person Singular
perambularemos	First person Plural
multadas	None
fascinam	Third person Plural
escavou	Third person Singular
legendarão	Third person Plural
assoreado	None
bastecerás	Second person Singular
ornado	None
desprotegerás	Second person Singular
tencionado	None
tracto	First person Singular
aquecidos	None
esquecem	Third person Plural
desarticulou	Third person Singular
cultuais	Second person Plural
mexi	First person Singular
tremeluzindo	None
decorados	None
prolongado	None
procedem	Third person Plural
pronunciamos	First person Plural
impedida	None
iludidos	None
iniciássemos	First person Plural
mijareis	Second person Plural
hesitou	Third person Singular
entrecortaremos	First person Plural
editáveis	Second person Plural
otimizados	None
graduássemos	First person Plural
concluiriam	Third person Plural
alcançavam	Third person Plural
cativou	Third person Singular
exportarei	First person Singular
esporo	First person Singular
corrompem	Third person Plural
treinará	Third person Singular
complicados	None
estrelas	Second person Singular
acabados	None
consolidariam	Third person Plural
vareando	None
excluo	First person Singular
desatarraxados	None
destacam	Third person Plural
esmagado	None
diminuída	None
travam	Third person Plural
vibravam	Third person Plural
inspirassem	Third person Plural
sobrevivi	First person Singular
acreditarão	Third person Plural
culminariam	Third person Plural
piscados	None
derrotou	Third person Singular
acostumassem	Third person Plural
traduzida	None
comprometem	Third person Plural
marqueteados	None
recoloco	First person Singular
canonizou	Third person Singular
demandou	Third person Singular
cato	First person Singular
telhais	Second person Plural
desabraçadas	None
ajustáveis	Second person Plural
acusamos	First person Plural
seguíssemos	First person Plural
hesito	First person Singular
benzida	None
dramatizadas	None
socou	Third person Singular
entitulando	None
redigidos	None
empacharíamos	First person Plural
brandiríeis	Second person Plural
beliscarei	First person Singular
engarrafado	None
arborizada	None
graduou	Third person Singular
rimam	Third person Plural
alimentados	None
debochada	None
multiplicou	Third person Singular
somariam	Third person Plural
eliminamos	First person Plural
excomungou	Third person Singular
consolidavam	Third person Plural
destinavam	Third person Plural
crucificou	Third person Singular
confiado	None
desflorestada	None
sobressaído	None
persistias	Second person Singular
fotocopiarás	Second person Singular
direcciono	First person Singular
procederíeis	Second person Plural
garantiremos	First person Plural
repetida	None
ensangüentada	None
frequentavam	Third person Plural
escondo	First person Singular
demitido	None
concruíeis	Second person Plural
desenrolavam	Third person Plural
amofinadas	None
regozijassem	Third person Plural
tuno	First person Singular
obceco	First person Singular
unctarei	First person Singular
reunísseis	Second person Plural
resumida	None
descascado	None
aluviando	None
afetam	Third person Plural
domas	Second person Singular
encompridando	None
reciclou	Third person Singular
conquistariam	Third person Plural
queimavam	Third person Plural
divididos	None
incriminou	Third person Singular
cumpres	Second person Singular
abstraem	Third person Plural
triunfados	None
debruçais	Second person Plural
enxadaremos	First person Plural
trancas	Second person Singular
assassinado	None
apreendida	None
queimaríamos	First person Plural
pintavam	Third person Plural
calculamos	First person Plural
intimidavam	Third person Plural
escapuliam	Third person Plural
maiusculas	Second person Singular
escrevestes	Second person Plural
conferissem	Third person Plural
furai	Second person Plural
integram	Third person Plural
estruturavam	Third person Plural
dramatizando	None
preditos	None
reuniu	Third person Singular
onerando	None
toleram	Third person Plural
capinas	Second person Singular
contenho	First person Singular
atribuindo	None
consolidassem	Third person Plural
pirateavas	Second person Singular
tico	First person Singular
postulam	Third person Plural
atarraxadas	None
avassalaríeis	Second person Plural
molhado	None
ranges	Second person Singular
ultrajadas	None
desarticulado	None
escurecido	None
minutais	Second person Plural
carimbássemos	First person Plural
transbordou	Third person Singular
araras	Second person Singular
anagramatizais	Second person Plural
articulou	Third person Singular
caracterizam	Third person Plural
picou	Third person Singular
sentirão	Third person Plural
descontam	Third person Plural
findassem	Third person Plural
habitamos	First person Plural
avistados	None
servindo	None
amplifiquei	First person Singular
tombada	None
estrumámos	First person Plural
machucou	Third person Singular
aprovou	Third person Singular
minuciaras	Second person Singular
criados	None
ronronam	Third person Plural
insistem	Third person Plural
percorro	First person Singular
peido	First person Singular
orneei	First person Singular
rebelo	First person Singular
encosto	First person Singular
teremos	First person Plural
sujeitadas	None
avistada	None
marino	First person Singular
iniciarei	First person Singular
laçou	Third person Singular
acharás	Second person Singular
socas	Second person Singular
encampei	First person Singular
bancada	None
aposento	First person Singular
freou	Third person Singular
pertenciam	Third person Plural
exploramos	First person Plural
ando	First person Singular
aflorais	Second person Plural
necessitas	Second person Singular
envergonharias	Second person Singular
tomariam	Third person Plural
desempenhassem	Third person Plural
mancarão	Third person Plural
sentavam	Third person Plural
adorariam	Third person Plural
é	Third person Singular
figurassem	Third person Plural
transliterados	None
confeccionou	Third person Singular
tratassem	Third person Plural
opinando	None
habitariam	Third person Plural
responsabilizei	First person Singular
acabada	None
ocultei	First person Singular
apoderou	Third person Singular
namorados	None
protraístes	Second person Plural
aproveitará	Third person Singular
profetizavam	Third person Plural
retratassem	Third person Plural
pousou	Third person Singular
vandalizáramos	First person Plural
escaneadas	None
apoiassem	Third person Plural
escapuliu	Third person Singular
estabeleceriam	Third person Plural
manuseio	First person Singular
atentam	Third person Plural
regozijo	First person Singular
clareiam	Third person Plural
encarcerada	None
deitarias	Second person Singular
podiam	Third person Plural
guarnecem	Third person Plural
moscou	Third person Singular
sentenciada	None
capitalizam	Third person Plural
atuado	None
apostado	None
massificou	Third person Singular
ensanguentada	None
desafogada	None
varas	Second person Singular
escorregas	Second person Singular
resolveriam	Third person Plural
descrendo	None
colherei	First person Singular
manufaturados	None
oxidando	None
desterrado	None
publico	First person Singular
saqueou	Third person Singular
perseguiu	Third person Singular
desfiadas	None
reconheço	First person Singular
consolado	None
brotas	Second person Singular
difundiam	Third person Plural
estivermos	First person Plural
acabaste	Second person Singular
implementou	Third person Singular
extinguida	None
optará	Third person Singular
obriguei	First person Singular
banhado	None
engessado	None
acabam	Third person Plural
segregadas	None
separariam	Third person Plural
redirecionavam	Third person Plural
cansou	Third person Singular
firmavam	Third person Plural
merecidos	None
qualificará	Third person Singular
aceitássemos	First person Plural
tocassem	Third person Plural
receberá	Third person Singular
desfiguráveis	Second person Plural
intercaladas	None
discordam	Third person Plural
boiaremos	First person Plural
prometo	First person Singular
incitam	Third person Plural
torram	Third person Plural
constarei	First person Singular
fisgada	None
concretizamos	First person Plural
questionas	Second person Singular
padecem	Third person Plural
distorcida	None
opinamos	First person Plural
patenteando	None
desligará	Third person Singular
movem	Third person Plural
possibilitará	Third person Singular
apadrinhados	None
situando	None
empatam	Third person Plural
destruirem	Third person Plural
liberado	None
cindísseis	Second person Plural
excelida	None
iludes	Second person Singular
aprendeu	Third person Singular
alivio	First person Singular
retraíramos	First person Plural
merecida	None
conduziam	Third person Plural
americanizam	Third person Plural
redigindo	None
trejeitamos	First person Plural
arrendássemos	First person Plural
prestados	None
praticavam	Third person Plural
recuado	None
ligaste	Second person Singular
focamos	First person Plural
alijadas	None
boxeou	Third person Singular
programou	Third person Singular
regressavam	Third person Plural
agravo	First person Singular
inventei	First person Singular
detonados	None
sarássemos	First person Plural
devastou	Third person Singular
paráramos	First person Plural
gerais	Second person Plural
convencionados	None
agarrou	Third person Singular
juntada	None
verificados	None
beijáramos	First person Plural
putrefazendo	None
debochou	Third person Singular
bombou	Third person Singular
contribuídas	None
preceituaras	Second person Singular
desapontou	Third person Singular
cromarão	Third person Plural
apressavam	Third person Plural
legitimará	Third person Singular
zunido	None
desconcertará	Third person Singular
ataco	First person Singular
perfilavam	Third person Plural
pertencem	Third person Plural
azulejados	None
achado	None
amurada	None
baixou	Third person Singular
facilitada	None
afectará	Third person Singular
proveio	Third person Singular
decapitando	None
trocarei	First person Singular
apóiam	Third person Plural
emmoldurásseis	Second person Plural
tinhas	Second person Singular
desabrochou	Third person Singular
stalkearíamos	First person Plural
evitarás	Second person Singular
segredou	Third person Singular
entendi	First person Singular
triunfam	Third person Plural
ocupamos	First person Plural
habitados	None
especificamos	First person Plural
afogam	Third person Plural
ilustramos	First person Plural
atendido	None
urbanizáveis	Second person Plural
clonada	None
atracadas	None
soariam	Third person Plural
decapitou	Third person Singular
recriarei	First person Singular
condimentada	None
sancionáveis	Second person Plural
encampo	First person Singular
solapou	Third person Singular
mandou	Third person Singular
estreariam	Third person Plural
refazerem	Third person Plural
capotásseis	Second person Plural
dizerem	Third person Plural
pecados	None
conversada	None
absolvem	Third person Plural
custará	Third person Singular
qualificam	Third person Plural
contraem	Third person Plural
sublimada	None
edificarei	First person Singular
mesclado	None
instituindo	None
esbanjavam	Third person Plural
expatriada	None
implantado	None
repasso	First person Singular
ameaçássemos	First person Plural
deglaçásseis	Second person Plural
apostou	Third person Singular
alunando	None
engordados	None
carpido	None
dissimulariam	Third person Plural
passámos	First person Plural
transmutará	Third person Singular
livramos	First person Plural
orientando	None
liderariam	Third person Plural
usou	Third person Singular
respiráveis	Second person Plural
dispensará	Third person Singular
afetado	None
podíamos	First person Plural
oleando	None
simbolizáreis	Second person Plural
recaíam	Third person Plural
faltavam	Third person Plural
rezou	Third person Singular
moderou	Third person Singular
seriamos	First person Plural
urdidos	None
resistirei	First person Singular
extirpadas	None
destrinchados	None
sujados	None
conjeturas	Second person Singular
redobrarás	Second person Singular
desvendou	Third person Singular
ancorado	None
pactadas	None
taxiasses	Second person Singular
certificam	Third person Plural
decepcionáveis	Second person Plural
popularizavam	Third person Plural
soltamos	First person Plural
levarias	Second person Singular
mordidas	None
qualificariam	Third person Plural
cultivassem	Third person Plural
maduras	Second person Singular
pelejou	Third person Singular
persistiu	Third person Singular
vestidas	None
modelaríeis	Second person Plural
xeretáveis	Second person Plural
encaracolaste	Second person Singular
sumiam	Third person Plural
reluzido	None
atormentou	Third person Singular
cambaleou	Third person Singular
vedam	Third person Plural
estanhadas	None
magnificarei	First person Singular
estimulou	Third person Singular
escolhestes	Second person Plural
estalo	First person Singular
reconciliadas	None
incentivou	Third person Singular
florestados	None
abusará	Third person Singular
desbloqueáveis	Second person Plural
metti	First person Singular
tarraxando	None
enxergamos	First person Plural
avançaste	Second person Singular
relacionáveis	Second person Plural
abortado	None
zumbido	None
poliríeis	Second person Plural
emanou	Third person Singular
usamos	First person Plural
pifado	None
converteriam	Third person Plural
protestada	None
assimilam	Third person Plural
receavam	Third person Plural
dedicamos	First person Plural
acharei	First person Singular
mudavam	Third person Plural
amostras	Second person Singular
perguntassem	Third person Plural
cavo	First person Singular
autorizo	First person Singular
disfarçou	Third person Singular
abusados	None
prestariam	Third person Plural
trauteavas	Second person Singular
irrompidos	None
traçamos	First person Plural
retrocedeu	Third person Singular
condenassem	Third person Plural
confrontam	Third person Plural
assoviando	None
mostrarão	Third person Plural
apertando	None
arrematado	None
dialogou	Third person Singular
casassem	Third person Plural
degenerou	Third person Singular
impregnam	Third person Plural
formulei	First person Singular
exploravam	Third person Plural
sujou	Third person Singular
solado	None
protegido	None
sanou	Third person Singular
vincas	Second person Singular
encefalizando	None
cercavam	Third person Plural
regras	Second person Singular
enrolou	Third person Singular
carimbando	None
encaçapadas	None
ratificassem	Third person Plural
subscreveu	Third person Singular
murmurou	Third person Singular
oponho	First person Singular
implicariam	Third person Plural
teimas	Second person Singular
castigado	None
engrandecendo	None
evitáreis	Second person Plural
anglicizávamos	First person Plural
embelezarei	First person Singular
disputariam	Third person Plural
negligenciáveis	Second person Plural
abordou	Third person Singular
agrafadas	None
desestabilizam	Third person Plural
apegados	None
movimento	First person Singular
rematou	Third person Singular
repousados	None
forradas	None
espio	First person Singular
pensará	Third person Singular
encenavam	Third person Plural
queres	Second person Singular
começou	Third person Singular
abando	First person Singular
caminho	First person Singular
desfiada	None
servem	Third person Plural
apresentas	Second person Singular
pacificados	None
ruborizado	None
afirmou	Third person Singular
harmonizadas	None
pecamos	First person Plural
apedrejados	None
explicassem	Third person Plural
voaras	Second person Singular
sondados	None
ministrou	Third person Singular
cristianizou	Third person Singular
sediam	Third person Plural
volvo	First person Singular
galgamos	First person Plural
ornam	Third person Plural
gravavam	Third person Plural
entoavam	Third person Plural
recorrido	None
suas	Second person Singular
corresponderiam	Third person Plural
acordei	First person Singular
implantada	None
alinho	First person Singular
declináveis	Second person Plural
cruzo	First person Singular
desjejuariam	Third person Plural
acordados	None
pecado	None
babujadas	None
fortificadas	None
transportará	Third person Singular
alarmámos	First person Plural
emoldurei	First person Singular
compostastes	Second person Plural
tendessem	Third person Plural
aportuguesou	Third person Singular
implico	First person Singular
desvinculam	Third person Plural
estenderá	Third person Singular
amostradas	None
preservassem	Third person Plural
reduzirão	Third person Plural
secam	Third person Plural
mordido	None
endurecida	None
papagueando	None
reconsiderassem	Third person Plural
emancipaste	Second person Singular
empoleiro	First person Singular
desintegrados	None
reclamam	Third person Plural
respiram	Third person Plural
imigravam	Third person Plural
demorarão	Third person Plural
pesando	None
desconsagraríeis	Second person Plural
debatem	Third person Plural
li	First person Singular
invadida	None
macadamizando	None
cronometrando	None
guindai	Second person Plural
sabida	None
parcelas	Second person Singular
envergonhou	Third person Singular
aquietastes	Second person Plural
contactam	Third person Plural
obcecamos	First person Plural
atrapalhados	None
encestadas	None
incham	Third person Plural
visam	Third person Plural
nocauteadas	None
confraternizando	None
aprenderão	Third person Plural
quicando	None
rarefeitos	None
mobilizáveis	Second person Plural
pediriam	Third person Plural
nutriu	Third person Singular
abusarias	Second person Singular
registram	Third person Plural
tampais	Second person Plural
esbanjam	Third person Plural
governadas	None
responsabilizavam	Third person Plural
remodelou	Third person Singular
falsificada	None
resolvida	None
sugeridas	None
expressas	Second person Singular
desagregou	Third person Singular
inovam	Third person Plural
predavam	Third person Plural
meadas	None
propagavam	Third person Plural
desproporcionastes	Second person Plural
encorajado	None
sentenciado	None
imposta	None
agrediu	Third person Singular
mergulhamos	First person Plural
demonstrou	Third person Singular
paguei	First person Singular
responsabilizado	None
polimerizadas	None
imobilizando	None
exponho	First person Singular
rendados	None
enriqueceu	Third person Singular
decolam	Third person Plural
passeado	None
assediavam	Third person Plural
lamentamos	First person Plural
derrubará	Third person Singular
protagonizada	None
traduzem	Third person Plural
cheirado	None
categorizou	Third person Singular
salvaguardas	Second person Singular
diversificareis	Second person Plural
sacoleados	None
adio	First person Singular
verbalizaríamos	First person Plural
motivando	None
apelo	First person Singular
orçado	None
titilando	None
clarificam	Third person Plural
encetadas	None
devias	Second person Singular
competem	Third person Plural
aguilhoamos	First person Plural
intimidado	None
visualizados	None
traficados	None
entrincheirados	None
legislasses	Second person Singular
habituada	None
governassem	Third person Plural
espalhariam	Third person Plural
neutralizando	None
prevíamos	First person Plural
descreveu	Third person Singular
chuviscarias	Second person Singular
procurarão	Third person Plural
ampliam	Third person Plural
restabelecerá	Third person Singular
graduadas	None
exorcizásseis	Second person Plural
assanharemos	First person Plural
ingeriam	Third person Plural
contemplando	None
despolarizados	None
desmanchada	None
recuperassem	Third person Plural
restauram	Third person Plural
baratearão	Third person Plural
duráveis	Second person Plural
grudada	None
reordenando	None
detalhou	Third person Singular
removiam	Third person Plural
preparassem	Third person Plural
teletransportou	Third person Singular
aspirou	Third person Singular
impusessem	Third person Plural
freiareis	Second person Plural
tomarão	Third person Plural
financiou	Third person Singular
esfregado	None
edificado	None
comentado	None
entretêm	Third person Plural
remontam	Third person Plural
causarão	Third person Plural
poderão	Third person Plural
angariados	None
violo	First person Singular
tresando	First person Singular
teleportou	Third person Singular
assustada	None
implantam	Third person Plural
consto	First person Singular
acreditavam	Third person Plural
manifestariam	Third person Plural
admiram	Third person Plural
vagam	Third person Plural
anglicizado	None
confundiriam	Third person Plural
refinamos	First person Plural
encarnando	None
brotámos	First person Plural
recuperei	First person Singular
rodavam	Third person Plural
catalizam	Third person Plural
sacoleai	Second person Plural
reconquistadas	None
desempenhará	Third person Singular
decepcionam	Third person Plural
aliam	Third person Plural
impressionáveis	Second person Plural
accusada	None
anulei	First person Singular
presididas	None
precederás	Second person Singular
previsto	None
subsistirá	Third person Singular
atuavam	Third person Plural
certificada	None
presencio	First person Singular
reduzissem	Third person Plural
despejou	Third person Singular
apontariam	Third person Plural
atada	None
dançamos	First person Plural
saltai	Second person Plural
tremo	First person Singular
alentarei	First person Singular
endeusado	None
bancarias	Second person Singular
cardadas	None
fumou	Third person Singular
comprendo	First person Singular
conhecidos	None
esvaziavam	Third person Plural
penando	None
mantêm	Third person Plural
rasgado	None
engajados	None
incisaríeis	Second person Plural
clareado	None
submergem	Third person Plural
barrou	Third person Singular
lembrou	Third person Singular
durassem	Third person Plural
guiada	None
solicitam	Third person Plural
inspecionou	Third person Singular
incitáreis	Second person Plural
retornará	Third person Singular
habitando	None
evaporados	None
predicados	None
exclamam	Third person Plural
extraídos	None
fantasiou	Third person Singular
pintalgado	None
pretendendo	None
chapinhas	Second person Singular
alistado	None
contraíam	Third person Plural
maltratavam	Third person Plural
redimistes	Second person Plural
fomentaríamos	First person Plural
versejaremos	First person Plural
debruçou	Third person Singular
protegi	First person Singular
referencio	First person Singular
ousou	Third person Singular
caducam	Third person Plural
palpitando	None
especializavam	Third person Plural
contribuirá	Third person Singular
inventando	None
arrebentou	Third person Singular
comicharíamos	First person Plural
brigo	First person Singular
alastrareis	Second person Plural
ativados	None
inaugurais	Second person Plural
terminado	None
expulsam	Third person Plural
fico	First person Singular
conservamos	First person Plural
emancipam	Third person Plural
transplantou	Third person Singular
admito	First person Singular
acuminas	Second person Singular
cometerei	First person Singular
cometo	First person Singular
convoco	First person Singular
plantas	Second person Singular
ornamentados	None
lograda	None
homenageados	None
fechamos	First person Plural
visitei	First person Singular
delindo	None
sujam	Third person Plural
tosadas	None
machuco	First person Singular
anualizando	None
almoço	First person Singular
coagulado	None
captado	None
acotovelariam	Third person Plural
ventilado	None
citei	First person Singular
apassamanada	None
provariam	Third person Plural
apunhalando	None
parando	None
embarcará	Third person Singular
ligarão	Third person Plural
invadirão	Third person Plural
pronunciando	None
viajamos	First person Plural
herdei	First person Singular
afino	First person Singular
enxado	First person Singular
transpõem	Third person Plural
barganhado	None
efectuadas	None
encerada	None
fermentando	None
prefabricadas	None
recolhessem	Third person Plural
concederiam	Third person Plural
conjecturou	Third person Singular
dissolves	Second person Singular
apontassem	Third person Plural
gravassem	Third person Plural
interpostos	None
consultavam	Third person Plural
diminuindo	None
distancias	Second person Singular
conservará	Third person Singular
enfileirou	Third person Singular
notificando	None
desprotegeu	Third person Singular
escreviam	Third person Plural
esquilo	First person Singular
olho	First person Singular
chocalho	First person Singular
ressurgirá	Third person Singular
refinou	Third person Singular
padeceu	Third person Singular
retraído	None
humilhássemos	First person Plural
editada	None
faxináramos	First person Plural
provocou	Third person Singular
atraíssem	Third person Plural
abdicam	Third person Plural
lastadas	None
analisamos	First person Plural
assoprado	None
levarei	First person Singular
pausados	None
conformou	Third person Singular
cassai	Second person Plural
enriquecidas	None
hackeando	None
ofereceu	Third person Singular
transam	Third person Plural
trituradas	None
instalam	Third person Plural
abusei	First person Singular
dancei	First person Singular
anacronizadas	None
deixaremos	First person Plural
arrasadas	None
descartou	Third person Singular
investigam	Third person Plural
concordei	First person Singular
enrugadas	None
cinzelarias	Second person Singular
convalescendo	None
obterão	Third person Plural
adiantando	None
pungueávamos	First person Plural
fugirá	Third person Singular
ligamos	First person Plural
destelhou	Third person Singular
contactados	None
livrado	None
caminhará	Third person Singular
apaguei	First person Singular
esfregou	Third person Singular
aventurado	None
azedas	Second person Singular
eletrolisadas	None
resultado	None
censuro	First person Singular
gasificada	None
abandonou	Third person Singular
enfarruscando	None
desabilitadas	None
cravado	None
datam	Third person Plural
notificou	Third person Singular
destacáveis	Second person Plural
empanaras	Second person Singular
acirradas	None
debilitado	None
hipnotizada	None
verificarão	Third person Plural
pagará	Third person Singular
escoltassem	Third person Plural
contentada	None
desenganadas	None
afiadas	None
caberiam	Third person Plural
afilas	Second person Singular
complexo	First person Singular
milhas	Second person Singular
pairo	First person Singular
declamado	None
realizei	First person Singular
capinastes	Second person Plural
controlará	Third person Singular
metralhou	Third person Singular
votaste	Second person Singular
reparto	First person Singular
reencontras	Second person Singular
concentrassem	Third person Plural
intercalavam	Third person Plural
afago	First person Singular
alçou	Third person Singular
subjugavam	Third person Plural
assediam	Third person Plural
brochado	None
cultivadas	None
zarpou	Third person Singular
regalo	First person Singular
cantarolada	None
intoxicados	None
despolarizado	None
ajustei	First person Singular
ladeávamos	First person Plural
desconsagrámos	First person Plural
resolviam	Third person Plural
proporcionais	Second person Plural
escreveríamos	First person Plural
arroubáramos	First person Plural
intercedem	Third person Plural
exportam	Third person Plural
encerrado	None
quero	First person Singular
atrapalhavam	Third person Plural
concedidas	None
encorajou	Third person Singular
inaláveis	Second person Plural
configurado	None
flexionássemos	First person Plural
arrumou	Third person Singular
consubstanciam	Third person Plural
vermelheai	Second person Plural
disputei	First person Singular
actuariam	Third person Plural
aluminizará	Third person Singular
reinou	Third person Singular
serves	Second person Singular
intervindo	None
abastecem	Third person Plural
regulou	Third person Singular
avalio	First person Singular
manteve	Third person Singular
energizados	None
trinam	Third person Plural
chatearas	Second person Singular
lavo	First person Singular
saberás	Second person Singular
estabilizassem	Third person Plural
expectorará	Third person Singular
erguida	None
divulgo	First person Singular
pilotadas	None
fantasiavam	Third person Plural
desaconselhariam	Third person Plural
suou	Third person Singular
lutará	Third person Singular
mugiríamos	First person Plural
suportavam	Third person Plural
abalroada	None
arroubaste	Second person Singular
transplantados	None
trocassem	Third person Plural
dispensáveis	Second person Plural
calibrou	Third person Singular
preenchendo	None
arrumei	First person Singular
afloram	Third person Plural
vitimando	None
carecem	Third person Plural
interdito	First person Singular
esmigalharás	Second person Singular
ancorada	None
julgariam	Third person Plural
capoto	First person Singular
afiáramos	First person Plural
retinida	None
homogeneizamos	First person Plural
percebo	First person Singular
engastado	None
apeamos	First person Plural
calai	Second person Plural
perderá	Third person Singular
prometi	First person Singular
ressalvamos	First person Plural
prendessem	Third person Plural
recorrerá	Third person Singular
entrincheirarei	First person Singular
agarram	Third person Plural
escravizavam	Third person Plural
adequada	None
implementassem	Third person Plural
estreitáveis	Second person Plural
questiono	First person Singular
mimetizam	Third person Plural
crucificadas	None
castrado	None
variou	Third person Singular
ocorrerão	Third person Plural
coíbes	Second person Singular
interessavam	Third person Plural
prosperassem	Third person Plural
alardeou	Third person Singular
tripuladas	None
franjas	Second person Singular
moldado	None
ecoada	None
reiteramos	First person Plural
renomeou	Third person Singular
corroem	Third person Plural
indultamos	First person Plural
partilhada	None
possibilitados	None
permeiam	Third person Plural
acontecem	Third person Plural
checavas	Second person Singular
tampados	None
frustrou	Third person Singular
carimbou	Third person Singular
checado	None
disseres	Second person Singular
extrairei	First person Singular
corneariam	Third person Plural
virou	Third person Singular
durariam	Third person Plural
atreverei	First person Singular
cotou	Third person Singular
reconvocou	Third person Singular
amurareis	Second person Plural
experiencias	Second person Singular
adquiriam	Third person Plural
dedicariam	Third person Plural
adequavam	Third person Plural
rateou	Third person Singular
pautam	Third person Plural
perdoado	None
abrirei	First person Singular
puniu	Third person Singular
abundou	Third person Singular
desafiassem	Third person Plural
ataviando	None
ablegais	Second person Plural
aviso	First person Singular
apadrinhou	Third person Singular
interpretassem	Third person Plural
injuriou	Third person Singular
seleto	First person Singular
rides	Second person Plural
enumerado	None
degradáveis	Second person Plural
ceada	None
batalhadas	None
distorcidos	None
emaranhada	None
escolhidos	None
entrincheiradas	None
satisfazerem	Third person Plural
azarado	None
alinhada	None
barganhas	Second person Singular
roeu	Third person Singular
imitavam	Third person Plural
consertando	None
rastejou	Third person Singular
soletradas	None
determinei	First person Singular
apontaste	Second person Singular
auxiliando	None
contará	Third person Singular
testáveis	Second person Plural
permitiriam	Third person Plural
abstivéramos	First person Plural
ativadas	None
folgas	Second person Singular
energizam	Third person Plural
circulassem	Third person Plural
cobras	Second person Singular
versificadas	None
sentei	First person Singular
aclamam	Third person Plural
cintilada	None
sufixado	None
desmoronou	Third person Singular
gargarejaremos	First person Plural
defendo	First person Singular
embelezam	Third person Plural
preparariam	Third person Plural
ancoram	Third person Plural
modelado	None
acabarei	First person Singular
encobriu	Third person Singular
delongam	Third person Plural
hesitam	Third person Plural
minutarão	Third person Plural
mordiam	Third person Plural
rotularíeis	Second person Plural
patinam	Third person Plural
equilibrou	Third person Singular
intimado	None
intimai	Second person Plural
personalizáveis	Second person Plural
gamo	First person Singular
editei	First person Singular
conspirando	None
revistos	None
enterravam	Third person Plural
orbitavam	Third person Plural
vago	First person Singular
casei	First person Singular
devotamos	First person Plural
personificaste	Second person Singular
rechaçam	Third person Plural
contribuirei	First person Singular
quicado	None
repugnada	None
fariam	Third person Plural
corroboro	First person Singular
conquistado	None
coexistem	Third person Plural
desoxidada	None
vitrificado	None
germinou	Third person Singular
rango	First person Singular
evangelizada	None
escalonáveis	Second person Plural
dominando	None
desabilitei	First person Singular
acerbadas	None
demoravam	Third person Plural
explicada	None
considero	First person Singular
ressentindo	None
elevo	First person Singular
ondulavam	Third person Plural
agourento	First person Singular
roçam	Third person Plural
providos	None
roubados	None
retocam	Third person Plural
pensarás	Second person Singular
suplemento	First person Singular
implementaríeis	Second person Plural
mirado	None
atrelados	None
reescrevessem	Third person Plural
baldearas	Second person Singular
amaciado	None
marcho	First person Singular
afugentada	None
serio	First person Singular
pigmento	First person Singular
ponderando	None
fiscalizam	Third person Plural
jardinadas	None
arrumado	None
difundiu	Third person Singular
extraíam	Third person Plural
falará	Third person Singular
encarregará	Third person Singular
acompanhavam	Third person Plural
calcinada	None
sucumbiu	Third person Singular
induziu	Third person Singular
reavivando	None
extrato	First person Singular
reclamados	None
recitou	Third person Singular
erradicados	None
embotado	None
mugido	None
devassando	None
multiplicavam	Third person Plural
contrariada	None
telecomandados	None
complexando	None
acostumam	Third person Plural
assassinariam	Third person Plural
saltavam	Third person Plural
gravitas	Second person Singular
saídos	None
piorados	None
preenchida	None
empolguei	First person Singular
perdoou	Third person Singular
enlaçariam	Third person Plural
aproveitado	None
estremecido	None
morassem	Third person Plural
penetráramos	First person Plural
contêm	Third person Plural
construindo	None
trarei	First person Singular
conduzida	None
emendou	Third person Singular
orquestrou	Third person Singular
pareceu	Third person Singular
domesticando	None
atravessado	None
encapsularíeis	Second person Plural
correspondida	None
estrelando	None
repartirão	Third person Plural
espero	First person Singular
verificaras	Second person Singular
tilintados	None
velejam	Third person Plural
ausentam	Third person Plural
lembras	Second person Singular
velejareis	Second person Plural
desprezam	Third person Plural
infirmado	None
agastado	None
oposta	None
vaiou	Third person Singular
practicam	Third person Plural
denunciado	None
expulsavam	Third person Plural
agitam	Third person Plural
sujeito	First person Singular
superados	None
bailados	None
abrido	None
padeciam	Third person Plural
divulgará	Third person Singular
crepitáramos	First person Plural
instigou	Third person Singular
jubilarão	Third person Plural
perseveraríeis	Second person Plural
precisas	Second person Singular
saltados	None
dublavam	Third person Plural
cortará	Third person Singular
alegrarão	Third person Plural
ricocheteareis	Second person Plural
chilreadas	None
nadai	Second person Plural
chiado	None
esfolou	Third person Singular
alcançarão	Third person Plural
estragavam	Third person Plural
detalhei	First person Singular
responderão	Third person Plural
posicionam	Third person Plural
tencionássemos	First person Plural
viverei	First person Singular
relvássemos	First person Plural
azotados	None
atêm	Third person Plural
flageladas	None
despedaçam	Third person Plural
fosforilo	First person Singular
aterrissam	Third person Plural
atando	None
submeteriam	Third person Plural
empregáveis	Second person Plural
desejo	First person Singular
pinando	None
juntassem	Third person Plural
estudassem	Third person Plural
evitamos	First person Plural
cavoucadas	None
mandará	Third person Singular
abriste	Second person Singular
passarinho	First person Singular
iniciais	Second person Plural
decorridas	None
zerou	Third person Singular
degeneradas	None
entortais	Second person Plural
somei	First person Singular
carregas	Second person Singular
transportavam	Third person Plural
achas	Second person Singular
contive	First person Singular
proporem	Third person Plural
burlas	Second person Singular
lajeadas	None
rectifiquei	First person Singular
enjoo	First person Singular
afinados	None
controlavam	Third person Plural
inventou	Third person Singular
retardo	First person Singular
minerado	None
datou	Third person Singular
freqüentado	None
volatilizado	None
quedarás	Second person Singular
contrapesado	None
terminará	Third person Singular
guindando	None
delimitado	None
comecei	First person Singular
derramadas	None
raspadas	None
construiriam	Third person Plural
subornados	None
empatado	None
vivíamos	First person Plural
broco	First person Singular
solucionáveis	Second person Plural
veio	Third person Singular
fisgou	Third person Singular
assado	None
pecam	Third person Plural
vereásseis	Second person Plural
revolto	First person Singular
abroquelassem	Third person Plural
mineralizadas	None
procuram	Third person Plural
provamos	First person Plural
moída	None
rezassem	Third person Plural
coibida	None
broto	First person Singular
sucumbem	Third person Plural
levas	Second person Singular
desaparecida	None
cumprimentam	Third person Plural
bastarão	Third person Plural
direccionando	None
livro	First person Singular
estralados	None
voariam	Third person Plural
desnudaríeis	Second person Plural
liberámos	First person Plural
ablegaríamos	First person Plural
ajustada	None
hortou	Third person Singular
anatematizados	None
contento	First person Singular
entenderemos	First person Plural
contraído	None
excluída	None
duvido	First person Singular
negociou	Third person Singular
comprariam	Third person Plural
armarias	Second person Singular
numeráveis	Second person Plural
moscadas	None
combinados	None
incriminados	None
encaminhados	None
pastorado	None
agridem	Third person Plural
apelidam	Third person Plural
cavoucarão	Third person Plural
rechaçou	Third person Singular
proclamavam	Third person Plural
licitadas	None
coletada	None
suporem	Third person Plural
matriculas	Second person Singular
cliquei	First person Singular
apiedou	Third person Singular
qualificando	None
produzísseis	Second person Plural
legou	Third person Singular
finalizada	None
anarquizamos	First person Plural
combalistes	Second person Plural
passai	Second person Plural
enlatas	Second person Singular
detestou	Third person Singular
dignou	Third person Singular
cobravam	Third person Plural
assolo	First person Singular
badalavas	Second person Singular
sedai	Second person Plural
redigem	Third person Plural
publicaremos	First person Plural
denominando	None
achou	Third person Singular
tomou	Third person Singular
condicionados	None
acortinadas	None
julgadas	None
retirarei	First person Singular
rivalizavam	Third person Plural
descoladas	None
salpicamos	First person Plural
manipulei	First person Singular
urinando	None
tornassem	Third person Plural
desviando	None
atestadas	None
reviam	Third person Plural
registei	First person Singular
ortigais	Second person Plural
acreditamos	First person Plural
ensinadas	None
retino	First person Singular
fumegai	Second person Plural
açoitadas	None
desvendado	None
sexo	First person Singular
dissipam	Third person Plural
estimada	None
retiro	First person Singular
pulinho	First person Singular
esvaziado	None
azulando	None
postulou	Third person Singular
mantermos	First person Plural
emancipando	None
bradou	Third person Singular
fertilizada	None
reiteravam	Third person Plural
batíamos	First person Plural
trinada	None
abraço	First person Singular
aperfeiçoou	Third person Singular
tomamos	First person Plural
puseste	Second person Singular
anexado	None
gritam	Third person Plural
lambeu	Third person Singular
acastelassem	Third person Plural
carpo	First person Singular
tossindo	None
soltando	None
esvaidos	None
introduzindo	None
viveriam	Third person Plural
rufai	Second person Plural
previstas	None
escreves	Second person Singular
homologando	None
pintalgam	Third person Plural
oram	Third person Plural
saudei	First person Singular
auguriadas	None
vestiam	Third person Plural
urges	Second person Singular
visto	First person Singular
esparramarás	Second person Singular
truncado	None
deliberásseis	Second person Plural
correndo	None
tomavam	Third person Plural
procedo	First person Singular
pavimentáreis	Second person Plural
procurou	Third person Singular
visitáveis	Second person Plural
fragmento	First person Singular
transcendem	Third person Plural
derramarias	Second person Singular
ensaiou	Third person Singular
confundiam	Third person Plural
gero	First person Singular
libero	First person Singular
vandalizarei	First person Singular
hipnotizando	None
predominavam	Third person Plural
proscrita	None
mudariam	Third person Plural
clamavam	Third person Plural
doirado	None
preferido	None
realçou	Third person Singular
compartilháramos	First person Plural
girará	Third person Singular
obliterou	Third person Singular
entrevistas	Second person Singular
deduzido	None
evitou	Third person Singular
publicará	Third person Singular
categorizadas	None
estudariam	Third person Plural
forram	Third person Plural
surradas	None
embaixaras	Second person Singular
arredaras	Second person Singular
riscou	Third person Singular
mesclam	Third person Plural
trajam	Third person Plural
transformaste	Second person Singular
oscilam	Third person Plural
enfatizada	None
emergiriam	Third person Plural
embarcando	None
mantinham	Third person Plural
aconteceriam	Third person Plural
surripiaríeis	Second person Plural
sacará	Third person Singular
substituíam	Third person Plural
retardariam	Third person Plural
esgotadas	None
compartilhado	None
transmutou	Third person Singular
aplicando	None
perpetuas	Second person Singular
circunscrevem	Third person Plural
recrutáveis	Second person Plural
dobravam	Third person Plural
respeitavam	Third person Plural
aparecidas	None
desfocada	None
atravessando	None
arquivou	Third person Singular
dragaríeis	Second person Plural
gozou	Third person Singular
acabrunhando	None
publicitou	Third person Singular
despolarizarei	First person Singular
solidificam	Third person Plural
imitou	Third person Singular
venderíeis	Second person Plural
interceptam	Third person Plural
bamboleado	None
racháveis	Second person Plural
rodam	Third person Plural
jurastes	Second person Plural
acionado	None
inserindo	None
reverenciavam	Third person Plural
oppostas	None
reiniciará	Third person Singular
encontraste	Second person Singular
pulsados	None
anglicizou	Third person Singular
associado	None
entregarei	First person Singular
abrindo	None
falámos	First person Plural
integrais	Second person Plural
torturou	Third person Singular
hospedou	Third person Singular
livrai	Second person Plural
compomos	First person Plural
expirou	Third person Singular
quebramos	First person Plural
acirrando	None
evolves	Second person Singular
dialogam	Third person Plural
sentando	None
encaminhará	Third person Singular
ocasionará	Third person Singular
redimidas	None
exiladas	None
dedicadas	None
saquei	First person Singular
ficas	Second person Singular
obtivermos	First person Plural
englobará	Third person Singular
sedimentam	Third person Plural
gorados	None
escapávamos	First person Plural
entintastes	Second person Plural
andassem	Third person Plural
encerando	None
subordinavam	Third person Plural
lembrará	Third person Singular
participando	None
cego	First person Singular
amorenadas	None
repolis	Second person Plural
milho	First person Singular
reparaste	Second person Singular
abocanharias	Second person Singular
inspirou	Third person Singular
desperdiçada	None
aliciadas	None
retratará	Third person Singular
obtermos	First person Plural
repassará	Third person Singular
arrasavam	Third person Plural
triplicou	Third person Singular
ferindo	None
utilizas	Second person Singular
condizem	Third person Plural
salvei	First person Singular
aeraste	Second person Singular
enriqueciam	Third person Plural
recordadas	None
custavam	Third person Plural
entretinham	Third person Plural
comportei	First person Singular
interpretou	Third person Singular
aplacadas	None
boicotada	None
aquaplanavas	Second person Singular
visualizáveis	Second person Plural
acasalam	Third person Plural
cismáramos	First person Plural
invades	Second person Singular
espalhou	Third person Singular
porei	First person Singular
moldados	None
prestam	Third person Plural
captou	Third person Singular
agravando	None
suam	Third person Plural
desferidas	None
determino	First person Singular
baixam	Third person Plural
nomeio	First person Singular
escapou	Third person Singular
guio	First person Singular
comovem	Third person Plural
fazermos	First person Plural
asado	None
cito	First person Singular
barateados	None
ansiou	Third person Singular
informado	None
feres	Second person Singular
transtorno	First person Singular
controlariam	Third person Plural
branqueando	None
utilizaremos	First person Plural
praticamos	First person Plural
tostas	Second person Singular
importassem	Third person Plural
empunhou	Third person Singular
atraíam	Third person Plural
enlatadas	None
elevarão	Third person Plural
votas	Second person Singular
aventavam	Third person Plural
iras	Second person Singular
veem	Third person Plural
comercializam	Third person Plural
azulejarão	Third person Plural
desasai	Second person Plural
identificáveis	Second person Plural
cortou	Third person Singular
resistiu	Third person Singular
existidas	None
negavas	Second person Singular
aperfeiçoando	None
gerenciando	None
dedicarão	Third person Plural
inculcados	None
esculpidos	None
mexericariam	Third person Plural
aproveito	First person Singular
apreciassem	Third person Plural
executadas	None
deterioradas	None
opunham	Third person Plural
impossibilitando	None
afastarão	Third person Plural
anagramatizados	None
unificados	None
zanzado	None
atingiríamos	First person Plural
nevasse	Third person Singular
guardarei	First person Singular
cumpririam	Third person Plural
fofocando	None
exercitou	Third person Singular
mixou	Third person Singular
manteremos	First person Plural
empestearás	Second person Singular
feita	None
surgiu	Third person Singular
arianizastes	Second person Plural
escamarão	Third person Plural
aperfeiçoavam	Third person Plural
abandareis	Second person Plural
abrigando	None
receitando	None
bajulam	Third person Plural
batizei	First person Singular
usarei	First person Singular
sobrevivido	None
mirro	First person Singular
posiciono	First person Singular
determinarão	Third person Plural
deprimem	Third person Plural
permeio	First person Singular
regulariam	Third person Plural
assumida	None
efetivo	First person Singular
extractada	None
regressará	Third person Singular
calandrariam	Third person Plural
situará	Third person Singular
solidificadas	None
hipotecou	Third person Singular
arqueias	Second person Singular
dais	Second person Plural
colidissem	Third person Plural
socorresses	Second person Singular
acautelado	None
respeitam	Third person Plural
acharemos	First person Plural
arrematou	Third person Singular
utilizavam	Third person Plural
acionados	None
alfabetizaras	Second person Singular
helenizados	None
reembolsou	Third person Singular
legada	None
fadigas	Second person Singular
cevada	None
atestado	None
mandarão	Third person Plural
toparas	Second person Singular
começará	Third person Singular
vaporizam	Third person Plural
sublinhando	None
contrarias	Second person Singular
pescou	Third person Singular
interceptou	Third person Singular
enformaras	Second person Singular
nado	First person Singular
encenou	Third person Singular
restabelecido	None
instaláveis	Second person Plural
centelhas	Second person Singular
supervisada	None
tocam	Third person Plural
favoreceu	Third person Singular
repassavam	Third person Plural
permitissem	Third person Plural
saluçada	None
abismaríeis	Second person Plural
exultassem	Third person Plural
ardiam	Third person Plural
custarão	Third person Plural
enjoado	None
parodiado	None
variassem	Third person Plural
dás	Second person Singular
contrariassem	Third person Plural
conserto	First person Singular
remontavam	Third person Plural
malhada	None
simulais	Second person Plural
supurados	None
excedeu	Third person Singular
concentrei	First person Singular
vibrado	None
aureolando	None
cunhou	Third person Singular
emergiam	Third person Plural
rectificados	None
fizéssemos	First person Plural
bloqueou	Third person Singular
suadas	None
enganavam	Third person Plural
serrando	None
tolerassem	Third person Plural
pastoreou	Third person Singular
abnegados	None
editou	Third person Singular
solo	First person Singular
ruídos	None
televisado	None
gozariam	Third person Plural
brotarão	Third person Plural
complicavam	Third person Plural
stalkeámos	First person Plural
reprovou	Third person Singular
derrogássemos	First person Plural
recrio	First person Singular
pareci	First person Singular
sustentariam	Third person Plural
alvorecida	None
expusessem	Third person Plural
bainhei	First person Singular
democratizado	None
perguntando	None
pontuais	Second person Plural
deitassem	Third person Plural
funcionariam	Third person Plural
desregulado	None
seletada	None
enfraqueciam	Third person Plural
arrumo	First person Singular
vocalizada	None
encaroçávamos	First person Plural
custam	Third person Plural
divididas	None
dotarão	Third person Plural
equipam	Third person Plural
cediam	Third person Plural
serdes	Second person Plural
refresco	First person Singular
enfrentamos	First person Plural
percebeu	Third person Singular
entrecortássemos	First person Plural
abobadarão	Third person Plural
emitiu	Third person Singular
importas	Second person Singular
alugavam	Third person Plural
emanciparias	Second person Singular
povoam	Third person Plural
adicionam	Third person Plural
encampasses	Second person Singular
trepáramos	First person Plural
enxergou	Third person Singular
aglutinadas	None
arseniaremos	First person Plural
vendadas	None
modificam	Third person Plural
esfregada	None
tentou	Third person Singular
pesquisamos	First person Plural
furam	Third person Plural
concatenada	None
approvadas	None
desarmadas	None
soassem	Third person Plural
transfiro	First person Singular
improvisado	None
depositam	Third person Plural
vararas	Second person Singular
resignou	Third person Singular
embarcadas	None
conseguiriam	Third person Plural
removerá	Third person Singular
desmembradas	None
desasareis	Second person Plural
preparando	None
acervadas	None
emmoldurando	None
sobrepujou	Third person Singular
liquefaz	Third person Singular
accordo	First person Singular
obstruiu	Third person Singular
teletransportam	Third person Plural
acabassem	Third person Plural
sublinho	First person Singular
floodados	None
amarelados	None
almejada	None
apossou	Third person Singular
registámos	First person Plural
encomendas	Second person Singular
apavorou	Third person Singular
ruo	First person Singular
otimizado	None
quebrei	First person Singular
lanço	First person Singular
descoroçoássemos	First person Plural
transportáveis	Second person Plural
ouvistes	Second person Plural
prospectada	None
tampaste	Second person Singular
teciam	Third person Plural
anistiou	Third person Singular
enfiaremos	First person Plural
marcarei	First person Singular
extinguem	Third person Plural
atrairão	Third person Plural
pincelam	Third person Plural
galgam	Third person Plural
iam	Third person Plural
regateáreis	Second person Plural
enumerou	Third person Singular
desativaríamos	First person Plural
referiu	Third person Singular
beneficio	First person Singular
desprezou	Third person Singular
apitada	None
concretizaste	Second person Singular
reoxidadas	None
incorporando	None
revisam	Third person Plural
provocado	None
enervado	None
acordou	Third person Singular
sacávamos	First person Plural
bisai	Second person Plural
listo	First person Singular
confiamos	First person Plural
ocultavam	Third person Plural
descascavam	Third person Plural
perguntei	First person Singular
amuralhada	None
ovulo	First person Singular
penetrassem	Third person Plural
ficarão	Third person Plural
perspectivaras	Second person Singular
remunerará	Third person Singular
falaremos	First person Plural
guardará	Third person Singular
aceitaríamos	First person Plural
intimas	Second person Singular
subornavam	Third person Plural
deitamos	First person Plural
incorporou	Third person Singular
estás	Second person Singular
perfilhado	None
tapados	None
britada	None
habitou	Third person Singular
indexados	None
acendêssemos	First person Plural
começamos	First person Plural
concordarei	First person Singular
encayxadas	None
rascásseis	Second person Plural
repetidas	None
reavivado	None
organizou	Third person Singular
regularizando	None
macerareis	Second person Plural
perecerias	Second person Singular
proviam	Third person Plural
comentam	Third person Plural
reagrupando	None
escapará	Third person Singular
recebido	None
matriculam	Third person Plural
golpearas	Second person Singular
raciocinam	Third person Plural
chamaste	Second person Singular
agrafando	None
arraigado	None
passada	None
almejamos	First person Plural
carimbais	Second person Plural
fez	Third person Singular
sossego	First person Singular
fruído	None
angustias	Second person Singular
combinavam	Third person Plural
trino	First person Singular
estrangulam	Third person Plural
arbitro	First person Singular
tentam	Third person Plural
degolassem	Third person Plural
acondicionado	None
quebro	First person Singular
comprendido	None
convocará	Third person Singular
variado	None
avergonháramos	First person Plural
cadastrais	Second person Plural
afirmei	First person Singular
vacilei	First person Singular
edito	First person Singular
desferiu	Third person Singular
distraíeis	Second person Plural
aproveitei	First person Singular
abarcáramos	First person Plural
concorrerão	Third person Plural
discreteastes	Second person Plural
comportará	Third person Singular
desfeito	None
ladeando	None
ponde	Second person Plural
edifico	First person Singular
redescobrem	Third person Plural
escuso	First person Singular
violada	None
pastavam	Third person Plural
achando	None
contando	None
desestabilizado	None
criticadas	None
empalhados	None
afetada	None
contas	Second person Singular
denuncio	First person Singular
honrará	Third person Singular
monologadas	None
gravou	Third person Singular
proporcionarão	Third person Plural
pulsada	None
seguido	None
anarquizavam	Third person Plural
santificadas	None
descrevessem	Third person Plural
estancou	Third person Singular
alavancada	None
telecomandou	Third person Singular
cambiou	Third person Singular
passavam	Third person Plural
lucram	Third person Plural
enquadro	First person Singular
desfarçada	None
desespero	First person Singular
postavam	Third person Plural
adicionavam	Third person Plural
acusavam	Third person Plural
telegrafo	First person Singular
asfixiasses	Second person Singular
qualificais	Second person Plural
alcatroados	None
gravo	First person Singular
verá	Third person Singular
tratas	Second person Singular
distanciavam	Third person Plural
quisermos	First person Plural
reputáveis	Second person Plural
cometteste	Second person Singular
derretidos	None
varada	None
superestimou	Third person Singular
perfuro	First person Singular
esquecerão	Third person Plural
descascadas	None
pagáveis	Second person Plural
acesso	First person Singular
malditos	None
efetivou	Third person Singular
articulavam	Third person Plural
modernizou	Third person Singular
derivam	Third person Plural
separo	First person Singular
invalidadas	None
discutissem	Third person Plural
estrumai	Second person Plural
intercetam	Third person Plural
troçáreis	Second person Plural
liderou	Third person Singular
preparará	Third person Singular
sujeitásseis	Second person Plural
abro	First person Singular
chantageiam	Third person Plural
desembarcariam	Third person Plural
rugiu	Third person Singular
cantou	Third person Singular
esmorecendo	None
almejando	None
arabizáreis	Second person Plural
gabavam	Third person Plural
interligou	Third person Singular
capitulo	First person Singular
outorgados	None
achai	Second person Plural
propões	Second person Singular
comparamos	First person Plural
pestanejaste	Second person Singular
comeras	Second person Singular
parecidos	None
mediu	Third person Singular
objetadas	None
bocejo	First person Singular
aponto	First person Singular
direccionou	Third person Singular
escolhes	Second person Singular
proporcionados	None
juntamos	First person Plural
perpetradas	None
erodiste	Second person Singular
vacinaras	Second person Singular
penetrou	Third person Singular
cantai	Second person Plural
auxiliam	Third person Plural
decides	Second person Singular
obliterando	None
sumidos	None
acinzentados	None
aventam	Third person Plural
inocentou	Third person Singular
taxo	First person Singular
geris	Second person Plural
devessem	Third person Plural
lutarei	First person Singular
cobrariam	Third person Plural
pôde	Third person Singular
terminou	Third person Singular
urticaremos	First person Plural
navegamos	First person Plural
catas	Second person Singular
calhou	Third person Singular
diminuiu	Third person Singular
conectam	Third person Plural
puxados	None
renovarão	Third person Plural
entendessem	Third person Plural
agastaras	Second person Singular
provarei	First person Singular
eletrocutaremos	First person Plural
coçado	None
exonerado	None
sobejassem	Third person Plural
sofismas	Second person Singular
antipatizadas	None
emmolduraste	Second person Singular
hackeou	Third person Singular
entediam	Third person Plural
rebaixando	None
andei	First person Singular
focou	Third person Singular
reincidíamos	First person Plural
penou	Third person Singular
pululai	Second person Plural
entrelaçadas	None
ajudai	Second person Plural
parou	Third person Singular
vegetais	Second person Plural
acenam	Third person Plural
aligeirou	Third person Singular
trucidado	None
contou	Third person Singular
desconfiando	None
deterá	Third person Singular
reproduzidas	None
tomei	First person Singular
acinzentada	None
retribuo	First person Singular
espiritualizado	None
alimentarão	Third person Plural
interpretará	Third person Singular
tresandadas	None
disponibilizada	None
despencam	Third person Plural
efetuaras	Second person Singular
exterminam	Third person Plural
dividissem	Third person Plural
picotaremos	First person Plural
escrito	None
atochásseis	Second person Plural
dispostas	None
concorriam	Third person Plural
formamos	First person Plural
reclamavam	Third person Plural
embalavas	Second person Singular
comprimiu	Third person Singular
sincronizaste	Second person Singular
descercaríeis	Second person Plural
vicejam	Third person Plural
torneados	None
topo	First person Singular
graduada	None
vivenciando	None
atendo	First person Singular
postarei	First person Singular
gerassem	Third person Plural
introduzida	None
envergonhadas	None
trazem	Third person Plural
zumbificados	None
acomodando	None
perturbásseis	Second person Plural
excomungada	None
tardais	Second person Plural
levantei	First person Singular
ausento	First person Singular
revisassem	Third person Plural
desmaiam	Third person Plural
rebentam	Third person Plural
desavergonhará	Third person Singular
pendeu	Third person Singular
escurecidos	None
apreendem	Third person Plural
graduo	First person Singular
aleijou	Third person Singular
engraxada	None
cometidos	None
detalhado	None
alocando	None
fartas	Second person Singular
atiçada	None
pirateadas	None
debatiam	Third person Plural
derivamos	First person Plural
reciclo	First person Singular
ecoou	Third person Singular
valorizada	None
assaltando	None
cercou	Third person Singular
perpetrou	Third person Singular
pranteado	None
efectuarás	Second person Singular
elevou	Third person Singular
percebeste	Second person Singular
cantaremos	First person Plural
evoluíssem	Third person Plural
alavancou	Third person Singular
liquidado	None
entusiasmáveis	Second person Plural
calcificados	None
secundam	Third person Plural
mumificadas	None
explodiriam	Third person Plural
aprontavam	Third person Plural
trepam	Third person Plural
algemou	Third person Singular
esmagada	None
acondicionadas	None
lerei	First person Singular
consistirá	Third person Singular
inspiradas	None
guardavam	Third person Plural
arroubadas	None
telecomandada	None
atermos	First person Plural
capotou	Third person Singular
convirá	Third person Singular
geras	Second person Singular
subidas	None
medido	None
fenais	Second person Plural
esquentados	None
outorgadas	None
agredido	None
inquiriu	Third person Singular
dificultando	None
disponibilizas	Second person Singular
coletei	First person Singular
ofegou	Third person Singular
elucido	First person Singular
maltarão	Third person Plural
arrazoado	None
ressentiu	Third person Singular
provei	First person Singular
botam	Third person Plural
inspiro	First person Singular
sobejada	None
prostrávamos	First person Plural
gorjeareis	Second person Plural
escoltando	None
evangelizará	Third person Singular
envolvi	First person Singular
enclausurados	None
fracionado	None
conflitado	None
cultuavam	Third person Plural
pediras	Second person Singular
decifram	Third person Plural
fodesses	Second person Singular
incorridos	None
escutáveis	Second person Plural
voei	First person Singular
ondulando	None
ajuntada	None
competiu	Third person Singular
absorvessem	Third person Plural
assopro	First person Singular
interpretamos	First person Plural
ameaçadas	None
molestam	Third person Plural
magnificado	None
aniquilam	Third person Plural
ocorreriam	Third person Plural
colavam	Third person Plural
concretada	None
imitando	None
representavam	Third person Plural
avaliadas	None
arruináveis	Second person Plural
conduzido	None
folheando	None
aderiam	Third person Plural
truncai	Second person Plural
relampejásseis	Second person Plural
forçando	None
irrigando	None
escusamos	First person Plural
assoreando	None
desintegrando	None
mancham	Third person Plural
vetado	None
decretais	Second person Plural
boicotou	Third person Singular
questionavam	Third person Plural
recalcitravam	Third person Plural
absorvíeis	Second person Plural
respeitaríamos	First person Plural
pregassem	Third person Plural
colam	Third person Plural
balançam	Third person Plural
retinis	Second person Plural
catalogo	First person Singular
altero	First person Singular
instruíam	Third person Plural
mergulho	First person Singular
trocarão	Third person Plural
assombrado	None
terminassem	Third person Plural
soletrassem	Third person Plural
serviriam	Third person Plural
encaminhavam	Third person Plural
averiguou	Third person Singular
ouvi	First person Singular
diversificados	None
negligenciado	None
coroas	Second person Singular
sediados	None
exclamarias	Second person Singular
bebei	Second person Plural
sugiro	First person Singular
evitam	Third person Plural
pigmentado	None
propusessem	Third person Plural
adivinhas	Second person Singular
chacoalhariam	Third person Plural
proporcionará	Third person Singular
pasto	First person Singular
adotariam	Third person Plural
embrenhou	Third person Singular
taixadas	None
insistidos	None
aborreci	First person Singular
saberem	Third person Plural
deglutidas	None
bisastes	Second person Plural
verificáveis	Second person Plural
reformou	Third person Singular
transbordo	First person Singular
ofegásseis	Second person Plural
ride	Second person Plural
empolgam	Third person Plural
argumentei	First person Singular
amputasses	Second person Singular
evangelizando	None
tencionou	Third person Singular
tratáveis	Second person Plural
girado	None
comprovavam	Third person Plural
resguardavam	Third person Plural
aqueci	First person Singular
suicidas	Second person Singular
azedam	Third person Plural
apimentam	Third person Plural
descansamos	First person Plural
admirado	None
sospeitados	None
respondessem	Third person Plural
rodeados	None
ocupariam	Third person Plural
comprei	First person Singular
capotas	Second person Singular
camuflando	None
esclarecem	Third person Plural
achassem	Third person Plural
brocham	Third person Plural
pré-comprasses	Second person Singular
enquadrariam	Third person Plural
buzinada	None
lacei	First person Singular
exasperada	None
regressado	None
prestassem	Third person Plural
cosi	First person Singular
especializávamos	First person Plural
limitará	Third person Singular
cacho	First person Singular
colidis	Second person Plural
armassem	Third person Plural
ousando	None
decotadas	None
priorizando	None
desconhecem	Third person Plural
justificando	None
osculáramos	First person Plural
suplicas	Second person Singular
gelais	Second person Plural
falseada	None
ateve	Third person Singular
possibilitado	None
escorreu	Third person Singular
homogeneizássemos	First person Plural
vendessem	Third person Plural
edificadas	None
apercebo	First person Singular
cifram	Third person Plural
perfurámos	First person Plural
improvisam	Third person Plural
endeusada	None
adsorvidos	None
encaixáveis	Second person Plural
canonizado	None
enchi	First person Singular
extinguido	None
fatigados	None
distais	Second person Plural
restabeleceremos	First person Plural
pronunciará	Third person Singular
envolvida	None
espanto	First person Singular
conjuradas	None
preocupavam	Third person Plural
acham	Third person Plural
construiremos	First person Plural
missai	Second person Plural
olháramos	First person Plural
nevado	None
queremos	First person Plural
igualassem	Third person Plural
iluminavam	Third person Plural
coassinados	None
crucificaríeis	Second person Plural
representou	Third person Singular
lotando	None
arrancais	Second person Plural
encriptarias	Second person Singular
encaminho	First person Singular
convidassem	Third person Plural
cadeados	None
vingassem	Third person Plural
clarificadas	None
sugai	Second person Plural
armazenadas	None
alastravam	Third person Plural
resenhada	None
entretido	None
retocando	None
estada	None
borbulhareis	Second person Plural
desobrigados	None
compareceu	Third person Singular
estendida	None
autentico	First person Singular
risco	First person Singular
avaliei	First person Singular
salvaguardadas	None
resplandeço	First person Singular
hospedados	None
acervariam	Third person Plural
surges	Second person Singular
oxigenado	None
elucidado	None
dispensamos	First person Plural
profetizais	Second person Plural
desditas	None
manaríamos	First person Plural
arrendam	Third person Plural
saltou	Third person Singular
presenteiam	Third person Plural
ousados	None
recuarei	First person Singular
evoladas	None
lesados	None
estralou	Third person Singular
possibilitadas	None
outorgam	Third person Plural
respondi	First person Singular
observáveis	Second person Plural
atapetei	First person Singular
plantei	First person Singular
voltas	Second person Singular
piscadas	None
insinuam	Third person Plural
valeriam	Third person Plural
randomizada	None
desertavam	Third person Plural
transformou	Third person Singular
rejuvenescido	None
reprimidos	None
atritáreis	Second person Plural
envelheceste	Second person Singular
prendeu	Third person Singular
criei	First person Singular
tutoravam	Third person Plural
devorando	None
cumulou	Third person Singular
embrulho	First person Singular
disposta	None
dependeras	Second person Singular
trazida	None
certifiquei	First person Singular
pastam	Third person Plural
apresso	First person Singular
tentas	Second person Singular
invocaste	Second person Singular
restou	Third person Singular
arraigou	Third person Singular
reconhecido	None
apreciado	None
adiciono	First person Singular
ofendendo	None
cairá	Third person Singular
modelavam	Third person Plural
difamou	Third person Singular
recurvado	None
evidenciando	None
esquecerá	Third person Singular
descobrirá	Third person Singular
jogarão	Third person Plural
nascessem	Third person Plural
empenho	First person Singular
fabricássemos	First person Plural
menosprezo	First person Singular
sospeytada	None
influenciará	Third person Singular
joeiradas	None
lampejaremos	First person Plural
encontrámos	First person Plural
pactaríeis	Second person Plural
mostrará	Third person Singular
brotou	Third person Singular
bailo	First person Singular
circuncidou	Third person Singular
discais	Second person Plural
sucedida	None
virará	Third person Singular
magoo	First person Singular
desidratam	Third person Plural
rodeiam	Third person Plural
aplaudidas	None
filias	Second person Singular
igualamos	First person Plural
negociáveis	Second person Plural
conservam	Third person Plural
somará	Third person Singular
afectásseis	Second person Plural
levanto	First person Singular
inverto	First person Singular
amalgamada	None
aprovarei	First person Singular
experimentais	Second person Plural
antipatizámos	First person Plural
brigou	Third person Singular
deslastrados	None
aguentam	Third person Plural
debugarei	First person Singular
bloqueavam	Third person Plural
extirpado	None
arrancámos	First person Plural
liquidou	Third person Singular
infestando	None
ignoram	Third person Plural
infectam	Third person Plural
uivam	Third person Plural
gravariam	Third person Plural
fiam	Third person Plural
declarados	None
comes	Second person Singular
alavancado	None
estenographei	First person Singular
desviei	First person Singular
escolherá	Third person Singular
adestradas	None
continuassem	Third person Plural
localizavam	Third person Plural
compensados	None
gazeteadas	None
constranges	Second person Singular
trabalhávamos	First person Plural
deixaríamos	First person Plural
procriam	Third person Plural
fabricou	Third person Singular
limado	None
miou	Third person Singular
empilham	Third person Plural
domesticado	None
africanizaras	Second person Singular
afiliou	Third person Singular
formará	Third person Singular
interessassem	Third person Plural
expulso	First person Singular
achei	First person Singular
complicado	None
inseriam	Third person Plural
epitomizariam	Third person Plural
invocam	Third person Plural
enfraquecendo	None
aliaras	Second person Singular
rasguei	First person Singular
unto	First person Singular
dedico	First person Singular
resolvessem	Third person Plural
contestou	Third person Singular
datarei	First person Singular
perfurada	None
meada	None
esperam	Third person Plural
remanescias	Second person Singular
integrei	First person Singular
sonhamos	First person Plural
proibiam	Third person Plural
balcanizados	None
libertam	Third person Plural
movessem	Third person Plural
sonambulada	None
cotados	None
arrenegada	None
devi	First person Singular
auxiliará	Third person Singular
enevoado	None
tangas	Second person Singular
aportuguesada	None
alai	Second person Plural
tramaríeis	Second person Plural
busquei	First person Singular
desencadeavam	Third person Plural
provêsseis	Second person Plural
afetarão	Third person Plural
pisadas	None
enquadrassem	Third person Plural
escarchariam	Third person Plural
luto	First person Singular
seqüestrado	None
apoderam	Third person Plural
propuserem	Third person Plural
recolhidos	None
enfronhavam	Third person Plural
expandiam	Third person Plural
salpicáramos	First person Plural
untadas	None
escorregam	Third person Plural
indicados	None
aventurados	None
ocultada	None
entrego	First person Singular
atochados	None
compôs	Third person Singular
removo	First person Singular
empresto	First person Singular
desmarcáveis	Second person Plural
abalroado	None
ofereceriam	Third person Plural
polistes	Second person Plural
esclarecessem	Third person Plural
rarefizéssemos	First person Plural
largando	None
cimento	First person Singular
auxiliavam	Third person Plural
redefiniu	Third person Singular
apatetados	None
encarregados	None
pescarias	Second person Singular
abordamos	First person Plural
intercambiam	Third person Plural
remoídas	None
ficam	Third person Plural
tremido	None
proibido	None
imolando	None
saberemos	First person Plural
mirrando	None
flutuou	Third person Singular
incidido	None
levassem	Third person Plural
sarassem	Third person Plural
quintuplicadas	None
desenhassem	Third person Plural
eclipsasses	Second person Singular
teletransportado	None
saturada	None
sulcam	Third person Plural
sobrecarregada	None
obvias	Second person Singular
flanqueavam	Third person Plural
constatada	None
fundariam	Third person Plural
envelhecem	Third person Plural
imitam	Third person Plural
acrescentariam	Third person Plural
forçavam	Third person Plural
animaste	Second person Singular
marinas	Second person Singular
levantavas	Second person Singular
sujas	Second person Singular
escrutinizados	None
cobrindo	None
troças	Second person Singular
cautelas	Second person Singular
atinaríeis	Second person Plural
assento	First person Singular
desobstruídos	None
acionáveis	Second person Plural
diferiam	Third person Plural
omitida	None
comportou	Third person Singular
frisariam	Third person Plural
pulsam	Third person Plural
recontarão	Third person Plural
forneciam	Third person Plural
fedem	Third person Plural
domino	First person Singular
desfazem	Third person Plural
desfiado	None
hidratada	None
massacram	Third person Plural
representados	None
impossibilitam	Third person Plural
libertas	Second person Singular
seguravam	Third person Plural
chego	First person Singular
invernais	Second person Plural
bordou	Third person Singular
causais	Second person Plural
abordará	Third person Singular
colonizavam	Third person Plural
cobraremos	First person Plural
publicitado	None
diminuirá	Third person Singular
timbrarias	Second person Singular
comendada	None
pareceriam	Third person Plural
déssemos	First person Plural
indultados	None
asam	Third person Plural
pregamos	First person Plural
lidando	None
capas	Second person Singular
botanizarei	First person Singular
devolvendo	None
motivadas	None
acertavam	Third person Plural
garantidas	None
obteriam	Third person Plural
arranháreis	Second person Plural
balanceio	First person Singular
manifestassem	Third person Plural
represento	First person Singular
modelam	Third person Plural
trajou	Third person Singular
excedendo	None
visualizam	Third person Plural
vagou	Third person Singular
janelas	Second person Singular
batido	None
veremos	First person Plural
esboço	First person Singular
firmassem	Third person Plural
sublimarei	First person Singular
assinalada	None
colmado	None
evolvo	First person Singular
beatificáreis	Second person Plural
fraudada	None
cozidos	None
entremeadas	None
reforçavam	Third person Plural
organizo	First person Singular
habitarei	First person Singular
naufragou	Third person Singular
conversei	First person Singular
testemunhas	Second person Singular
discutem	Third person Plural
iniciando	None
contestam	Third person Plural
aprovisionado	None
descendem	Third person Plural
pano	First person Singular
progridem	Third person Plural
bastavam	Third person Plural
ensinará	Third person Singular
solicito	First person Singular
boto	First person Singular
ordenharás	Second person Singular
mudarei	First person Singular
usará	Third person Singular
enviarão	Third person Plural
destrinchado	None
vaticinarei	First person Singular
pensarão	Third person Plural
estreiará	Third person Singular
acidificam	Third person Plural
dei	First person Singular
tripulamos	First person Plural
corro	First person Singular
penetrando	None
postei	First person Singular
domei	First person Singular
apreciou	Third person Singular
esterradas	None
transtornou	Third person Singular
colonizareis	Second person Plural
noticiáreis	Second person Plural
precisou	Third person Singular
atacou	Third person Singular
esculachada	None
calafetámos	First person Plural
delimitarás	Second person Singular
apercebi	First person Singular
deparamos	First person Plural
supões	Second person Singular
limpam	Third person Plural
vagavam	Third person Plural
aceitáveis	Second person Plural
guarneceu	Third person Singular
repartiam	Third person Plural
cursei	First person Singular
deferida	None
propomos	First person Plural
despertados	None
sobreporem	Third person Plural
manejo	First person Singular
esgueiram	Third person Plural
agirás	Second person Singular
almoçados	None
reuniriam	Third person Plural
sobretaxas	Second person Singular
careceu	Third person Singular
confortou	Third person Singular
descalças	Second person Singular
soletrou	Third person Singular
ajudaremos	First person Plural
deixarão	Third person Plural
alardeadas	None
gerariam	Third person Plural
desligaste	Second person Singular
navegou	Third person Singular
vitoriaremos	First person Plural
examinei	First person Singular
vedada	None
executamos	First person Plural
lotam	Third person Plural
consistidos	None
tornariam	Third person Plural
prometidos	None
humedecidas	None
mealhada	None
gesticulam	Third person Plural
prezou	Third person Singular
divorcio	First person Singular
forro	First person Singular
duchas	Second person Singular
selecionais	Second person Plural
acercam	Third person Plural
optamos	First person Plural
repensassem	Third person Plural
rescindiu	Third person Singular
reconquistam	Third person Plural
amplificam	Third person Plural
teleportado	None
coroavam	Third person Plural
aglutinados	None
prestarão	Third person Plural
colidiu	Third person Singular
escoados	None
filio	First person Singular
emaranhado	None
encolhida	None
aguada	None
atuamos	First person Plural
cadeadas	None
encontravam	Third person Plural
biotransformai	Second person Plural
ressalvou	Third person Singular
ocasionou	Third person Singular
desabrochavas	Second person Singular
prejudicam	Third person Plural
deslocavam	Third person Plural
arrematados	None
pertencendo	None
drenam	Third person Plural
contemplará	Third person Singular
comprovará	Third person Singular
divertido	None
interessei	First person Singular
desmentiam	Third person Plural
desfigurado	None
teorizam	Third person Plural
torneassem	Third person Plural
revogando	None
descerá	Third person Singular
inovando	None
pisam	Third person Plural
sondas	Second person Singular
alvejando	None
objeto	First person Singular
começariam	Third person Plural
caracterizariam	Third person Plural
anualizámos	First person Plural
marcavas	Second person Singular
desmentem	Third person Plural
enterrou	Third person Singular
evoluiriam	Third person Plural
reservam	Third person Plural
ladeáveis	Second person Plural
questionou	Third person Singular
doí	First person Singular
cuidarão	Third person Plural
confeccionam	Third person Plural
substituíssemos	First person Plural
pacificando	None
descanso	First person Singular
salientados	None
recalcitradas	None
registadas	None
recomendou	Third person Singular
assemelhou	Third person Singular
agonizou	Third person Singular
conjecturaste	Second person Singular
elevará	Third person Singular
conquistando	None
listará	Third person Singular
conjugado	None
ornamentam	Third person Plural
exportáveis	Second person Plural
fedidos	None
danas	Second person Singular
requere	Second person Singular
plainásseis	Second person Plural
louvarei	First person Singular
envenenado	None
abalam	Third person Plural
estampada	None
situados	None
afrancesadas	None
bates	Second person Singular
esquio	First person Singular
crescidos	None
escusada	None
amarram	Third person Plural
agiam	Third person Plural
catalogado	None
povoas	Second person Singular
torras	Second person Singular
ministravam	Third person Plural
carregavam	Third person Plural
pesquisáveis	Second person Plural
alcançadas	None
hesitando	None
emprestarias	Second person Singular
contratam	Third person Plural
berrados	None
emitirá	Third person Singular
estudavam	Third person Plural
escaneou	Third person Singular
desembaraçados	None
manipulavam	Third person Plural
aplicou	Third person Singular
compulsavam	Third person Plural
atiçado	None
beiro	First person Singular
sospeitado	None
pavonearas	Second person Singular
repensados	None
brandis	Second person Plural
equilibrados	None
aparafusaríamos	First person Plural
encadernada	None
adicionados	None
envergonhavam	Third person Plural
malharias	Second person Singular
decididas	None
caducas	Second person Singular
relembrareis	Second person Plural
enfileiráveis	Second person Plural
haviam	Third person Plural
ferrando	None
troas	Second person Singular
comunicará	Third person Singular
rascunhou	Third person Singular
rectificou	Third person Singular
tacho	First person Singular
custo	First person Singular
manuseavam	Third person Plural
magoada	None
compartilharão	Third person Plural
colocará	Third person Singular
despedaçou	Third person Singular
encobriam	Third person Plural
iluminastes	Second person Plural
descidos	None
redescobriu	Third person Singular
reproduziam	Third person Plural
rebatida	None
aportou	Third person Singular
dramatizou	Third person Singular
possuirá	Third person Singular
igualado	None
rematávamos	First person Plural
vigias	Second person Singular
distinguiu	Third person Singular
cancelavas	Second person Singular
artilharias	Second person Singular
lutas	Second person Singular
soprado	None
infestou	Third person Singular
estraçalhásseis	Second person Plural
supusermos	First person Plural
assinam	Third person Plural
apegam	Third person Plural
trombeteado	None
promulgamos	First person Plural
suspeitas	Second person Singular
falecem	Third person Plural
desvirginada	None
usaremos	First person Plural
pichada	None
atirado	None
anulamos	First person Plural
parasitam	Third person Plural
compactou	Third person Singular
explorassem	Third person Plural
obliterada	None
activas	Second person Singular
nanai	Second person Plural
restringiam	Third person Plural
solucionáreis	Second person Plural
agaloado	None
clamou	Third person Singular
degenerarás	Second person Singular
validadas	None
prognosticadas	None
procurando	None
rasgados	None
ligáveis	Second person Plural
compenetrada	None
mexeste	Second person Singular
vacas	Second person Singular
raiado	None
cessariam	Third person Plural
tutorados	None
balanceados	None
assegurará	Third person Singular
tirassem	Third person Plural
aguado	None
encarceraste	Second person Singular
saltando	None
inocentaste	Second person Singular
dissestes	Second person Plural
descambou	Third person Singular
providenciarei	First person Singular
latinizou	Third person Singular
passou	Third person Singular
intersectam	Third person Plural
separados	None
colheu	Third person Singular
remidos	None
forcei	First person Singular
checada	None
seguirei	First person Singular
sobrepondo	None
discutirei	First person Singular
passado	None
ofreceríamos	First person Plural
esboçavam	Third person Plural
emprestam	Third person Plural
deixamos	First person Plural
acreditas	Second person Singular
derrogou	Third person Singular
falhou	Third person Singular
apodizará	Third person Singular
contribuiriam	Third person Plural
amolados	None
reproduzidos	None
fascinou	Third person Singular
subornadas	None
montadas	None
hospedadas	None
passados	None
encaram	Third person Plural
aparecessem	Third person Plural
pautou	Third person Singular
sugerissem	Third person Plural
alistando	None
colocamos	First person Plural
gabo	First person Singular
mereceu	Third person Singular
sais	Second person Singular
mealharíamos	First person Plural
polindo	None
implantadas	None
levantassem	Third person Plural
representas	Second person Singular
iludem	Third person Plural
amáveis	Second person Plural
insistirei	First person Singular
reinicio	First person Singular
rubricas	Second person Singular
acometida	None
estremeceu	Third person Singular
damasquinaste	Second person Singular
apertavam	Third person Plural
salientei	First person Singular
analisou	Third person Singular
descenderão	Third person Plural
bacharelando	None
subordinam	Third person Plural
seduzido	None
emanavam	Third person Plural
tardariam	Third person Plural
reembolsado	None
rescaldou	Third person Singular
concordam	Third person Plural
amigáreis	Second person Plural
refogando	None
deslocamos	First person Plural
caçados	None
contavam	Third person Plural
inflam	Third person Plural
partissem	Third person Plural
estacas	Second person Singular
perdoam	Third person Plural
disputou	Third person Singular
apertam	Third person Plural
recolocai	Second person Plural
polinizados	None
derrocada	None
contrafeito	None
protestassem	Third person Plural
transbordada	None
comprometendo	None
enxerto	First person Singular
cristianizando	None
valsas	Second person Singular
assino	First person Singular
pendido	None
aplaudiam	Third person Plural
adotados	None
anunciará	Third person Singular
emprestando	None
telefonam	Third person Plural
recusamos	First person Plural
cobrado	None
recebestes	Second person Plural
monologo	First person Singular
cativo	First person Singular
escutam	Third person Plural
mergulhei	First person Singular
trissecada	None
nutrem	Third person Plural
enriquecendo	None
repreendeu	Third person Singular
tormento	First person Singular
posicionada	None
vingou	Third person Singular
torrou	Third person Singular
cisalhariam	Third person Plural
sujeitavam	Third person Plural
sintetizadas	None
despedidos	None
adquirirá	Third person Singular
absolutizando	None
poderemos	First person Plural
sobravam	Third person Plural
abstêm	Third person Plural
receiam	Third person Plural
coagidas	None
proporcionou	Third person Singular
bulhas	Second person Singular
reivindico	First person Singular
antecipo	First person Singular
brandindo	None
fenas	Second person Singular
rearranjados	None
dividiriam	Third person Plural
distinguidos	None
abominam	Third person Plural
oitavas	Second person Singular
aparafusadas	None
polimerizam	Third person Plural
resfolegadas	None
manco	First person Singular
terminei	First person Singular
interpretariam	Third person Plural
arruados	None
retratei	First person Singular
presidirá	Third person Singular
conflitou	Third person Singular
falseadas	None
personificou	Third person Singular
seguram	Third person Plural
apertadas	None
baleou	Third person Singular
dormidas	None
interditariam	Third person Plural
desterrada	None
propus	First person Singular
sabermos	First person Plural
atturará	Third person Singular
salgareis	Second person Plural
apego	First person Singular
aplicaremos	First person Plural
refugiassem	Third person Plural
sobrecarregado	None
varadas	None
pesou	Third person Singular
atreves	Second person Singular
tiraste	Second person Singular
jorravam	Third person Plural
aprovisionando	None
fecharás	Second person Singular
sucumbiam	Third person Plural
imprecavas	Second person Singular
arquivei	First person Singular
incrustado	None
bancou	Third person Singular
firmo	First person Singular
exagerou	Third person Singular
julgou	Third person Singular
cercará	Third person Singular
penhorámos	First person Plural
adsorvida	None
provida	None
acabei	First person Singular
coexistiu	Third person Singular
escuitou	Third person Singular
refrescadas	None
airasses	Second person Singular
eliminam	Third person Plural
prestará	Third person Singular
proliferado	None
entrelinhados	None
reinarão	Third person Plural
confrontavam	Third person Plural
maximizavam	Third person Plural
retinham	Third person Plural
valorado	None
quicássemos	First person Plural
nutrido	None
mentes	Second person Singular
duram	Third person Plural
começássemos	First person Plural
achamos	First person Plural
ilhas	Second person Singular
desferirias	Second person Singular
negai	Second person Plural
desconfortada	None
desandou	Third person Singular
descobrem	Third person Plural
aforando	None
secundo	First person Singular
desembalada	None
transmitiu	Third person Singular
reverto	First person Singular
usavam	Third person Plural
torro	First person Singular
cansado	None
citam	Third person Plural
vandalizou	Third person Singular
perspectivado	None
consigo	First person Singular
parodiavam	Third person Plural
detalhada	None
clonados	None
controlassem	Third person Plural
direi	First person Singular
polinizado	None
elaborados	None
predita	None
internacionalizei	First person Singular
lato	First person Singular
declarariam	Third person Plural
rebuscada	None
duplicados	None
argumentando	None
aborto	First person Singular
camufladas	None
esfaqueando	None
sussurrados	None
angulado	None
estranguladas	None
facilitamos	First person Plural
comentariam	Third person Plural
conservo	First person Singular
atrasassem	Third person Plural
castigou	Third person Singular
escoras	Second person Singular
chibatarão	Third person Plural
ocupei	First person Singular
redigidas	None
falhada	None
inaladas	None
desposais	Second person Plural
pegassem	Third person Plural
realizam	Third person Plural
conterão	Third person Plural
proferem	Third person Plural
acometidas	None
deixarás	Second person Singular
replicado	None
defenestrados	None
fornecidas	None
socorrem	Third person Plural
orientados	None
supero	First person Singular
registam	Third person Plural
estilizadas	None
rolas	Second person Singular
erramos	First person Plural
estampam	Third person Plural
babado	None
optados	None
reboco	First person Singular
escarro	First person Singular
partilhei	First person Singular
retiras	Second person Singular
vi	First person Singular
reiteradas	None
palpitadas	None
contratará	Third person Singular
deliberam	Third person Plural
encaramos	First person Plural
dividias	Second person Singular
aceitarei	First person Singular
agregavam	Third person Plural
designasses	Second person Singular
circulariam	Third person Plural
perdessem	Third person Plural
enamoraríeis	Second person Plural
jazem	Third person Plural
malhas	Second person Singular
congelados	None
cantassem	Third person Plural
aproximando	None
impressionam	Third person Plural
honrarias	Second person Singular
cruzamos	First person Plural
hidrogenada	None
assustou	Third person Singular
averbaste	Second person Singular
encolhem	Third person Plural
rogai	Second person Plural
vociferados	None
movimentam	Third person Plural
quebras	Second person Singular
traficada	None
encostavam	Third person Plural
levou	Third person Singular
ranqueados	None
acreditariam	Third person Plural
minou	Third person Singular
agoirado	None
afirmada	None
prendes	Second person Singular
elaborei	First person Singular
rebaixo	First person Singular
direcionavam	Third person Plural
rasgavam	Third person Plural
barririam	Third person Plural
aceitaremos	First person Plural
gerada	None
antropomorfizadas	None
acionam	Third person Plural
exercidos	None
inventadas	None
impelidos	None
amolentada	None
vadeaste	Second person Singular
rematado	None
regendo	None
expusemos	First person Plural
blefadas	None
choramingaras	Second person Singular
executado	None
desistiam	Third person Plural
juntas	Second person Singular
escondessem	Third person Plural
ouvissem	Third person Plural
dissecou	Third person Singular
configurados	None
aduzida	None
tiveste	Second person Singular
tapará	Third person Singular
abençoai	Second person Plural
fallo	First person Singular
compadecido	None
impelidas	None
reagrupais	Second person Plural
arai	Second person Plural
creci	First person Singular
triscada	None
definirá	Third person Singular
embarcou	Third person Singular
desistem	Third person Plural
danificam	Third person Plural
namorássemos	First person Plural
reparada	None
tentaste	Second person Singular
usarão	Third person Plural
obrigariam	Third person Plural
desenham	Third person Plural
atribuíam	Third person Plural
transbordado	None
escaparemos	First person Plural
usurpados	None
doiradas	None
disponibilizados	None
solucionam	Third person Plural
teci	First person Singular
utilizamos	First person Plural
jubilados	None
discerníssemos	First person Plural
suborno	First person Singular
processou	Third person Singular
metabolizando	None
derrotada	None
apresentou	Third person Singular
afluíam	Third person Plural
proferissem	Third person Plural
desmitificados	None
encurtam	Third person Plural
integráveis	Second person Plural
eclipsaras	Second person Singular
consentiste	Second person Singular
carreguei	First person Singular
resolvêssemos	First person Plural
divulgando	None
importavam	Third person Plural
botando	None
fraudando	None
decorrem	Third person Plural
projetavam	Third person Plural
invadindo	None
guisando	None
checáveis	Second person Plural
testamos	First person Plural
esmagam	Third person Plural
exasperados	None
colonizando	None
arrombando	None
identifiquei	First person Singular
artilhado	None
permaneceu	Third person Singular
freqüentásseis	Second person Plural
interpretáveis	Second person Plural
coletam	Third person Plural
desembarcando	None
detectavam	Third person Plural
photographarias	Second person Singular
assassinas	Second person Singular
cunhas	Second person Singular
cambiámos	First person Plural
actuarão	Third person Plural
evidenciam	Third person Plural
photographo	First person Singular
lamentou	Third person Singular
embuçadas	None
assinadas	None
brindou	Third person Singular
falo	First person Singular
ganhariam	Third person Plural
explicará	Third person Singular
esbanjadas	None
checando	None
vínhamos	First person Plural
bebiam	Third person Plural
reafirmou	Third person Singular
varro	First person Singular
cunhado	None
apetecido	None
construiu	Third person Singular
bombardeou	Third person Singular
ousam	Third person Plural
editados	None
rodas	Second person Singular
transportariam	Third person Plural
abundam	Third person Plural
distadas	None
desnudas	Second person Singular
tirarão	Third person Plural
oleáramos	First person Plural
relato	First person Singular
arrefecidas	None
protesto	First person Singular
africanizou	Third person Singular
oravam	Third person Plural
livras	Second person Singular
rebentado	None
resgataras	Second person Singular
desintegram	Third person Plural
decapitáreis	Second person Plural
sanáveis	Second person Plural
gamamos	First person Plural
turbas	Second person Singular
arremessavam	Third person Plural
desproporcionais	Second person Plural
avistou	Third person Singular
freando	None
perdoei	First person Singular
embotadas	None
ressentis	Second person Plural
reconhecerá	Third person Singular
eclipsados	None
estimulará	Third person Singular
cresciam	Third person Plural
atiçou	Third person Singular
coassinaremos	First person Plural
badalo	First person Singular
enterro	First person Singular
distraída	None
amasso	First person Singular
sobrepõem	Third person Plural
seguro	First person Singular
bendito	None
imobilizados	None
estimulados	None
piscam	Third person Plural
transformáveis	Second person Plural
amofinam	Third person Plural
esbanjaste	Second person Singular
furtei	First person Singular
confessei	First person Singular
informo	First person Singular
arrendando	None
esticou	Third person Singular
inspecionados	None
analizados	None
mixas	Second person Singular
vitrificados	None
resumes	Second person Singular
consolou	Third person Singular
alojada	None
alastrados	None
lesarão	Third person Plural
surgidas	None
maltratando	None
desempenhado	None
pertencessem	Third person Plural
conspurcada	None
pudessem	Third person Plural
saltitado	None
estigmatizarei	First person Singular
brilhassem	Third person Plural
comparecidos	None
dialoguei	First person Singular
odiassem	Third person Plural
desmoralizadas	None
sentirei	First person Singular
aniversariásseis	Second person Plural
reclamou	Third person Singular
apimentei	First person Singular
executarei	First person Singular
engrossado	None
quintais	Second person Plural
digitam	Third person Plural
arremedo	First person Singular
providenciavam	Third person Plural
estagnado	None
vinculo	First person Singular
fecharão	Third person Plural
estorvaríeis	Second person Plural
guardados	None
deves	Second person Singular
erradicou	Third person Singular
acordo	First person Singular
marcham	Third person Plural
borraras	Second person Singular
apaziguando	None
engraçado	None
proclamada	None
batei	Second person Plural
notará	Third person Singular
lamentado	None
travavam	Third person Plural
retiravam	Third person Plural
toleráveis	Second person Plural
satisfará	Third person Singular
trazido	None
esqueci	First person Singular
conflito	First person Singular
praticam	Third person Plural
embarquei	First person Singular
dissolveras	Second person Singular
arfas	Second person Singular
contestarei	First person Singular
incendiados	None
paginada	None
interpretei	First person Singular
aproximam	Third person Plural
colaboro	First person Singular
contaste	Second person Singular
herdado	None
colocou	Third person Singular
asseguradas	None
legitimam	Third person Plural
gerenciavam	Third person Plural
iniciastes	Second person Plural
apostemavam	Third person Plural
havias	Second person Singular
saídas	None
soubesses	Second person Singular
voltou	Third person Singular
conflitada	None
ouvindo	None
alcunhada	None
abandonaste	Second person Singular
culminavam	Third person Plural
quedou	Third person Singular
hesitei	First person Singular
apaziguados	None
erodidos	None
desiludindo	None
telando	None
acariciados	None
gostarei	First person Singular
vazavam	Third person Plural
vacarias	Second person Singular
direccionados	None
obedecerá	Third person Singular
zarpado	None
arredondo	First person Singular
equipado	None
alagam	Third person Plural
indicam	Third person Plural
iodado	None
retribuirá	Third person Singular
vendida	None
governou	Third person Singular
debutásseis	Second person Plural
intrometidas	None
afrontando	None
odiamos	First person Plural
descansado	None
paparicadas	None
substanciada	None
ficassem	Third person Plural
fingiam	Third person Plural
agitadas	None
esmurrada	None
formulou	Third person Singular
confiscou	Third person Singular
pregadas	None
finas	Second person Singular
guiso	First person Singular
deletamos	First person Plural
pregavam	Third person Plural
saluçarei	First person Singular
estressou	Third person Singular
beberá	Third person Singular
instigando	None
desinstalará	Third person Singular
examinassem	Third person Plural
facturas	Second person Singular
agrupavam	Third person Plural
arvorescido	None
achávamos	First person Plural
destruiriam	Third person Plural
pedido	None
actuam	Third person Plural
usufruíam	Third person Plural
predam	Third person Plural
ludibriando	None
sequestrou	Third person Singular
nanas	Second person Singular
retornada	None
fundiriam	Third person Plural
pudesses	Second person Singular
empesteadas	None
cutucavas	Second person Singular
intermedias	Second person Singular
exhalaras	Second person Singular
explanou	Third person Singular
esqueceste	Second person Singular
produzida	None
reterem	Third person Plural
acasalados	None
ladrilho	First person Singular
dignado	None
fritas	Second person Singular
sugeriu	Third person Singular
incomodei	First person Singular
encaminham	Third person Plural
beneficiariam	Third person Plural
desentranharas	Second person Singular
desafiaste	Second person Singular
sepultavam	Third person Plural
estimando	None
suspirado	None
modificavam	Third person Plural
riste	Second person Singular
rebentadas	None
vasculhou	Third person Singular
picada	None
finalizam	Third person Plural
dizíamos	First person Plural
demorariam	Third person Plural
galvanizou	Third person Singular
dificultados	None
visitas	Second person Singular
esterrados	None
indico	First person Singular
vagueavam	Third person Plural
atacariam	Third person Plural
incriminavam	Third person Plural
irradiarei	First person Singular
bradado	None
agravavam	Third person Plural
lesmamos	First person Plural
oitavado	None
azedarão	Third person Plural
experimentam	Third person Plural
pastorais	Second person Plural
enfrentei	First person Singular
agindo	None
empolgaríamos	First person Plural
condicionou	Third person Singular
raiando	None
renunciará	Third person Singular
cadeias	Second person Singular
influenciassem	Third person Plural
programei	First person Singular
incriminassem	Third person Plural
estreando	None
lembrassem	Third person Plural
confessam	Third person Plural
refazem	Third person Plural
calçássemos	First person Plural
duplicam	Third person Plural
respeitariam	Third person Plural
direccionasses	Second person Singular
embalou	Third person Singular
persistindo	None
vingam	Third person Plural
destoam	Third person Plural
propuseste	Second person Singular
esporando	None
tentada	None
implantais	Second person Plural
subsistem	Third person Plural
fermentáveis	Second person Plural
arvoresci	First person Singular
pecou	Third person Singular
apitados	None
beijamos	First person Plural
possibilitariam	Third person Plural
macaqueados	None
conversassem	Third person Plural
falsificado	None
obrigavam	Third person Plural
aparada	None
manifesto	First person Singular
impliquei	First person Singular
renomeio	First person Singular
marcando	None
afamado	None
pavimento	First person Singular
boiada	None
intermediadas	None
alunarei	First person Singular
demorei	First person Singular
verificam	Third person Plural
noticiais	Second person Plural
custeasses	Second person Singular
celebrariam	Third person Plural
serpenteariam	Third person Plural
sagrou	Third person Singular
arrumas	Second person Singular
estampásseis	Second person Plural
prosseguirão	Third person Plural
escalparei	First person Singular
levitas	Second person Singular
gerenciou	Third person Singular
animassem	Third person Plural
mergulham	Third person Plural
desgraças	Second person Singular
vinhas	Second person Singular
impedissem	Third person Plural
diferem	Third person Plural
cooperavam	Third person Plural
carimbo	First person Singular
reoxidada	None
movimentariam	Third person Plural
evitáveis	Second person Plural
calculavam	Third person Plural
cooperando	None
perfeitas	None
partiu	Third person Singular
refinarias	Second person Singular
alterariam	Third person Plural
movereis	Second person Plural
causou	Third person Singular
impactou	Third person Singular
aduláveis	Second person Plural
visitam	Third person Plural
recolhiam	Third person Plural
cristianizados	None
esfomeada	None
abaixada	None
detectam	Third person Plural
recriam	Third person Plural
remediarias	Second person Singular
premiou	Third person Singular
dependiam	Third person Plural
passasses	Second person Singular
vogado	None
adolescidas	None
disciplinados	None
oitavando	None
discriminam	Third person Plural
ronco	First person Singular
modernizadas	None
esganei	First person Singular
pressionassem	Third person Plural
satisfaz	Third person Singular
candidatarei	First person Singular
compactas	Second person Singular
estourada	None
anunciou	Third person Singular
erram	Third person Plural
acabas	Second person Singular
competido	None
remavam	Third person Plural
apostadas	None
auxiliados	None
decolavam	Third person Plural
boxeando	None
recontam	Third person Plural
iniciamos	First person Plural
saltado	None
selavas	Second person Singular
regados	None
agradeceu	Third person Singular
testou	Third person Singular
encorajam	Third person Plural
desenrolados	None
trouxerem	Third person Plural
moramos	First person Plural
apegadas	None
superestimando	None
reprimendas	Second person Singular
abalavam	Third person Plural
discutireis	Second person Plural
acelararemos	First person Plural
incidida	None
centralizam	Third person Plural
realizavam	Third person Plural
torneio	First person Singular
trapaceou	Third person Singular
homologado	None
sei	First person Singular
erravam	Third person Plural
apodreceu	Third person Singular
antedatam	Third person Plural
vomitado	None
constariam	Third person Plural
agrediam	Third person Plural
ajeito	First person Singular
capinam	Third person Plural
votariam	Third person Plural
presupondes	Second person Plural
separavam	Third person Plural
lamuriada	None
movimentavam	Third person Plural
alcançou	Third person Singular
indiciado	None
continham	Third person Plural
contracenado	None
emendei	First person Singular
atiro	First person Singular
recebei	Second person Plural
inflaste	Second person Singular
cumpriu	Third person Singular
reestruturados	None
fracionais	Second person Plural
especifico	First person Singular
ajudariam	Third person Plural
aproximará	Third person Singular
batizavam	Third person Plural
regatarás	Second person Singular
beberei	First person Singular
tumultuasses	Second person Singular
assoprada	None
germinavam	Third person Plural
ressurgidos	None
ajeitei	First person Singular
abirritando	None
toleramos	First person Plural
fotocopiados	None
ficamos	First person Plural
reiteravas	Second person Singular
alastrou	Third person Singular
impossibilitada	None
asilo	First person Singular
aderindo	None
circuncidando	None
reorganizam	Third person Plural
arrancará	Third person Singular
prendeis	Second person Plural
abasteciam	Third person Plural
mencionassem	Third person Plural
aglutinavam	Third person Plural
penetradas	None
ativará	Third person Singular
notificados	None
desconfiassem	Third person Plural
envergou	Third person Singular
libertariam	Third person Plural
ficávamos	First person Plural
orou	Third person Singular
revigorada	None
achareis	Second person Plural
cotejavam	Third person Plural
ajeitando	None
colidistes	Second person Plural
soldo	First person Singular
atalho	First person Singular
manchadas	None
pirada	None
emanando	None
velas	Second person Singular
mateadas	None
molesto	First person Singular
pondero	First person Singular
apanhou	Third person Singular
escusou	Third person Singular
volatilizarás	Second person Singular
equilibram	Third person Plural
efectivas	Second person Singular
arrebato	First person Singular
apregoam	Third person Plural
enriqueceis	Second person Plural
fixassem	Third person Plural
reprimiu	Third person Singular
exigiriam	Third person Plural
juravam	Third person Plural
localizada	None
apoderado	None
cago	First person Singular
amedrontada	None
gerará	Third person Singular
livravam	Third person Plural
computado	None
rodei	First person Singular
abandonariam	Third person Plural
recomeçado	None
aplacavas	Second person Singular
priorizavam	Third person Plural
condicionais	Second person Plural
predominam	Third person Plural
reivindicarei	First person Singular
oferecem	Third person Plural
observo	First person Singular
fiscalizadas	None
tunas	Second person Singular
executassem	Third person Plural
arrecadou	Third person Singular
veraneio	First person Singular
miro	First person Singular
pressurizadas	None
sofismadas	None
bisou	Third person Singular
banco	First person Singular
revisadas	None
dizimando	None
sustentou	Third person Singular
aliterada	None
guincho	First person Singular
poupará	Third person Singular
atiramos	First person Plural
errados	None
narrastes	Second person Plural
considerei	First person Singular
atordoando	None
apoucam	Third person Plural
anulam	Third person Plural
efetuados	None
reprovo	First person Singular
residirá	Third person Singular
embainhei	First person Singular
encolhi	First person Singular
endossado	None
latinizada	None
guindadas	None
cresci	First person Singular
prevalecessem	Third person Plural
apreciei	First person Singular
critico	First person Singular
transcorrem	Third person Plural
desconfortaras	Second person Singular
monitorizam	Third person Plural
ressentem	Third person Plural
ocupará	Third person Singular
questionada	None
vetam	Third person Plural
dizermos	First person Plural
divertem	Third person Plural
apresentavam	Third person Plural
miram	Third person Plural
talho	First person Singular
capacitará	Third person Singular
acampou	Third person Singular
abrigavam	Third person Plural
efectivaremos	First person Plural
depondo	None
assegurareis	Second person Plural
feno	First person Singular
utilizo	First person Singular
compartilham	Third person Plural
dormiam	Third person Plural
multiplicai	Second person Plural
sangram	Third person Plural
abstive	First person Singular
respondidos	None
adotavam	Third person Plural
precisaríamos	First person Plural
desarrazoadas	None
ficámos	First person Plural
antecediam	Third person Plural
sigo	First person Singular
durmo	First person Singular
contato	First person Singular
sobrou	Third person Singular
consagradas	None
prediziam	Third person Plural
ululados	None
fendidas	None
desafiavam	Third person Plural
excluiu	Third person Singular
destacavam	Third person Plural
interferem	Third person Plural
premiados	None
despedaçada	None
detectamos	First person Plural
tardado	None
predada	None
nomeou	Third person Singular
resignando	None
desistissem	Third person Plural
isolamos	First person Plural
pulará	Third person Singular
impetradas	None
encantásseis	Second person Plural
enxadas	Second person Singular
atrelou	Third person Singular
reescrevendo	None
negligenciam	Third person Plural
cozeu	Third person Singular
clorada	None
humedecido	None
opinam	Third person Plural
envolvidos	None
penhoras	Second person Singular
abismáveis	Second person Plural
clorado	None
poderás	Second person Singular
penhorado	None
ocupada	None
moverei	First person Singular
reprovam	Third person Plural
abuso	First person Singular
acertou	Third person Singular
espalhassem	Third person Plural
financiavam	Third person Plural
esbatei	First person Singular
demonstras	Second person Singular
duvidas	Second person Singular
carregamos	First person Plural
atingirá	Third person Singular
exprimem	Third person Plural
aniquilado	None
finalizando	None
encontrará	Third person Singular
concentram	Third person Plural
compreendes	Second person Singular
diremos	First person Plural
encerrariam	Third person Plural
acedem	Third person Plural
traçada	None
ascendessem	Third person Plural
inicias	Second person Singular
estranhei	First person Singular
discordei	First person Singular
convencionadas	None
arborescido	None
escorou	Third person Singular
suplicam	Third person Plural
esgarçando	None
moído	None
vingando	None
saberes	Second person Singular
vinculado	None
vergo	First person Singular
molestássemos	First person Plural
varriam	Third person Plural
adicionassem	Third person Plural
transferindo	None
zerados	None
seguramos	First person Plural
lutados	None
visamos	First person Plural
programam	Third person Plural
receadas	None
engabelado	None
desarmam	Third person Plural
efectivo	First person Singular
visitou	Third person Singular
cuydarão	Third person Plural
nocauteado	None
teclando	None
criarão	Third person Plural
executei	First person Singular
ambiguo	First person Singular
requer	Third person Singular
quebravam	Third person Plural
casquinariam	Third person Plural
falhados	None
adoecem	Third person Plural
gamou	Third person Singular
retardada	None
atrevi	First person Singular
apaixonavam	Third person Plural
seguissem	Third person Plural
congregai	Second person Plural
embalsamei	First person Singular
vergas	Second person Singular
salvam	Third person Plural
interporá	Third person Singular
apalpando	None
retinido	None
descoroçoando	None
bebemoraríamos	First person Plural
compusessem	Third person Plural
baseavam	Third person Plural
tampono	First person Singular
abnegado	None
taxaríamos	First person Plural
chegaremos	First person Plural
contraindicarão	Third person Plural
arranjavam	Third person Plural
airai	Second person Plural
tributam	Third person Plural
enriqueceremos	First person Plural
coito	First person Singular
secará	Third person Singular
alicio	First person Singular
retrocedíamos	First person Plural
precisei	First person Singular
embriagando	None
acumulariam	Third person Plural
passeiam	Third person Plural
escorrido	None
apreendendo	None
limitavam	Third person Plural
distribuiu	Third person Singular
destes	Second person Plural
abatido	None
cobrirá	Third person Singular
peregrinados	None
opinassem	Third person Plural
registrou	Third person Singular
pichou	Third person Singular
reformado	None
caracterizados	None
cruzassem	Third person Plural
pregaríamos	First person Plural
murchou	Third person Singular
reprovadas	None
facetas	Second person Singular
empregassem	Third person Plural
afiliadas	None
distinguindo	None
cheirariam	Third person Plural
escarneciam	Third person Plural
emergirá	Third person Singular
impôs	Third person Singular
fugiriam	Third person Plural
solicitamos	First person Plural
enxergados	None
pagamos	First person Plural
apropriávamos	First person Plural
punireis	Second person Plural
cavam	Third person Plural
subvencionado	None
classifiquei	First person Singular
sobrecarregou	Third person Singular
intercalados	None
falei	First person Singular
apossando	None
avariou	Third person Singular
desfragmentariam	Third person Plural
estimulam	Third person Plural
cozerei	First person Singular
englobado	None
irrigados	None
cacarejadas	None
colecionei	First person Singular
ocultou	Third person Singular
cerrado	None
escolherão	Third person Plural
descoloridos	None
avistavam	Third person Plural
desterro	First person Singular
equipo	First person Singular
verão	Third person Plural
incinerada	None
sujeitamos	First person Plural
voará	Third person Singular
tosei	First person Singular
espreitavas	Second person Singular
intimou	Third person Singular
reclamará	Third person Singular
escoado	None
conjurou	Third person Singular
falseáveis	Second person Plural
tencionavam	Third person Plural
traídos	None
aperfeiçoam	Third person Plural
alteráveis	Second person Plural
deixada	None
violassem	Third person Plural
expões	Second person Singular
incidem	Third person Plural
acrescentará	Third person Singular
engolem	Third person Plural
espancavam	Third person Plural
estouro	First person Singular
reinavam	Third person Plural
utilizarão	Third person Plural
flexionam	Third person Plural
redireccionados	None
desandados	None
mamo	First person Singular
vetou	Third person Singular
modificará	Third person Singular
alimentavam	Third person Plural
viverá	Third person Singular
integrassem	Third person Plural
lesmo	First person Singular
suportarão	Third person Plural
expõem	Third person Plural
pisavam	Third person Plural
juntavam	Third person Plural
incorrem	Third person Plural
escarafunchado	None
secretas	Second person Singular
calças	Second person Singular
dilatam	Third person Plural
facilitaras	Second person Singular
expressáveis	Second person Plural
porto	First person Singular
rotacionais	Second person Plural
commandado	None
pingo	First person Singular
contatasses	Second person Singular
mostrai	Second person Plural
maquinámos	First person Plural
buscado	None
cobrirão	Third person Plural
alimentassem	Third person Plural
toleraríeis	Second person Plural
reorganizou	Third person Singular
sobretaxado	None
sobrevivem	Third person Plural
levariam	Third person Plural
controláveis	Second person Plural
tampassem	Third person Plural
calado	None
ameigas	Second person Singular
garantias	Second person Singular
facultas	Second person Singular
elevam	Third person Plural
condicionariam	Third person Plural
usáveis	Second person Plural
cogito	First person Singular
estanhados	None
talhadas	None
soldas	Second person Singular
socorrei	Second person Plural
beneficiada	None
responsabilizou	Third person Singular
consignámos	First person Plural
teceu	Third person Singular
tomados	None
acobertai	Second person Plural
embirraríeis	Second person Plural
sobretaxadas	None
cometiam	Third person Plural
dependeriam	Third person Plural
accolherias	Second person Singular
surrado	None
devidas	None
esclareci	First person Singular
apuradas	None
degelavam	Third person Plural
visitarei	First person Singular
comutados	None
afeita	None
arreganhou	Third person Singular
absterei	First person Singular
dispensam	Third person Plural
predados	None
confinou	Third person Singular
masturbam	Third person Plural
privatizou	Third person Singular
cunhavam	Third person Plural
delimitadas	None
funccionará	Third person Singular
motivavam	Third person Plural
viramos	First person Plural
constituído	None
condimento	First person Singular
abortou	Third person Singular
morais	Second person Plural
ruborizadas	None
ordenavam	Third person Plural
tomassem	Third person Plural
acariciada	None
insultam	Third person Plural
cortejando	None
imbuiu	Third person Singular
desativam	Third person Plural
abalo	First person Singular
torcem	Third person Plural
difamada	None
impulsionados	None
crescei	Second person Plural
desaparecerão	Third person Plural
molhou	Third person Singular
desembarcavam	Third person Plural
confeccionados	None
calo	First person Singular
cafetinado	None
condenando	None
praticas	Second person Singular
plasmada	None
accolhendo	None
oporiam	Third person Plural
salmourará	Third person Singular
cisalho	First person Singular
atou	Third person Singular
emocionou	Third person Singular
roem	Third person Plural
corressem	Third person Plural
desmatadas	None
minuto	First person Singular
separará	Third person Singular
esgravatada	None
armados	None
enchida	None
desiludiu	Third person Singular
repassados	None
multiplicassem	Third person Plural
uniriam	Third person Plural
queimam	Third person Plural
aplicavam	Third person Plural
complexas	Second person Singular
formatada	None
acompanho	First person Singular
galgando	None
acupunturadas	None
experimentou	Third person Singular
assediáramos	First person Plural
conduzem	Third person Plural
gostariam	Third person Plural
adoptavam	Third person Plural
corrigida	None
resguardada	None
fendíamos	First person Plural
atolou	Third person Singular
estupradas	None
chumbou	Third person Singular
aplicarão	Third person Plural
derruiremos	First person Plural
recebeste	Second person Singular
comemorado	None
tabulas	Second person Singular
tentássemos	First person Plural
fundavam	Third person Plural
ocorressem	Third person Plural
trituram	Third person Plural
etiquetássemos	First person Plural
efetuam	Third person Plural
magoou	Third person Singular
pego	First person Singular
investigada	None
reestruturada	None
despacham	Third person Plural
portarias	Second person Singular
reputado	None
abateu	Third person Singular
ampliará	Third person Singular
celebravam	Third person Plural
cruzavam	Third person Plural
desafogo	First person Singular
atarás	Second person Singular
exterminou	Third person Singular
dependerá	Third person Singular
alfinetou	Third person Singular
desfrutassem	Third person Plural
sobro	First person Singular
facultou	Third person Singular
requererá	Third person Singular
alcunhasses	Second person Singular
conhecerá	Third person Singular
depositavam	Third person Plural
fiais	Second person Plural
desposou	Third person Singular
concretizou	Third person Singular
sacrificassem	Third person Plural
abarcada	None
batucadas	None
transformariam	Third person Plural
aguardará	Third person Singular
chantageado	None
apoteosaras	Second person Singular
escoavam	Third person Plural
comendados	None
monopolizassem	Third person Plural
caiada	None
omitidas	None
cegando	None
impomos	First person Plural
pontuarás	Second person Singular
fixo	First person Singular
privam	Third person Plural
tolerada	None
mobilizassem	Third person Plural
alertei	First person Singular
geriu	Third person Singular
excluíamos	First person Plural
admoestadas	None
cubas	Second person Singular
rendidos	None
sintetizam	Third person Plural
aloirado	None
unhada	None
soterrou	Third person Singular
bloqueada	None
depreciam	Third person Plural
findou	Third person Singular
aproximado	None
prediz	Third person Singular
marqueteará	Third person Singular
haverem	Third person Plural
tivermos	First person Plural
denomino	First person Singular
fartam	Third person Plural
introduziu	Third person Singular
estufou	Third person Singular
empesteámos	First person Plural
recobris	Second person Plural
apimentavam	Third person Plural
antecipam	Third person Plural
apologizou	Third person Singular
consumado	None
ensinou	Third person Singular
retaliada	None
derrotado	None
migrada	None
oferecidos	None
alterarei	First person Singular
efectuou	Third person Singular
soubestes	Second person Plural
apologizo	First person Singular
orientais	Second person Plural
entitulai	Second person Plural
apelado	None
ultimou	Third person Singular
levei	First person Singular
aprendeis	Second person Plural
sobressaída	None
desembrulhamos	First person Plural
feitos	None
pifada	None
practicados	None
cravam	Third person Plural
indexou	Third person Singular
libertará	Third person Singular
retornei	First person Singular
pernoutarei	First person Singular
adverbializastes	Second person Plural
derrocou	Third person Singular
abreviam	Third person Plural
assentis	Second person Plural
estipulam	Third person Plural
tumultuado	None
contrario	First person Singular
encarregariam	Third person Plural
abaixado	None
mirrastes	Second person Plural
acreditadas	None
solou	Third person Singular
sequestro	First person Singular
falaste	Second person Singular
envergonhados	None
bainhaste	Second person Singular
desenterrou	Third person Singular
demarcada	None
restringiu	Third person Singular
indicarão	Third person Plural
soltará	Third person Singular
bacharelará	Third person Singular
regatearíeis	Second person Plural
suportado	None
imaginavam	Third person Plural
encefalizadas	None
batalhado	None
prevalecerá	Third person Singular
encurtará	Third person Singular
desestabilizada	None
emendando	None
azuladas	None
trabalharemos	First person Plural
aproveitavam	Third person Plural
vadiados	None
arreigado	None
floreadas	None
reportou	Third person Singular
lascado	None
aconselhou	Third person Singular
abraçavam	Third person Plural
convalidado	None
desligam	Third person Plural
lapidando	None
fechas	Second person Singular
deitei	First person Singular
enfaixado	None
disseminado	None
atiçam	Third person Plural
engomados	None
contrastavam	Third person Plural
liberará	Third person Singular
fracionáveis	Second person Plural
batizassem	Third person Plural
escalados	None
trato	First person Singular
falando	None
tamparei	First person Singular
elucidam	Third person Plural
rebrilhados	None
auxiliei	First person Singular
paleará	Third person Singular
disparo	First person Singular
necessitariam	Third person Plural
decepcionassem	Third person Plural
tiravam	Third person Plural
estrelará	Third person Singular
escalpada	None
assoviado	None
conhecíamos	First person Plural
macerando	None
alada	None
passará	Third person Singular
arterializada	None
evacuados	None
encaminhei	First person Singular
retomasses	Second person Singular
organizará	Third person Singular
impediam	Third person Plural
enfatizo	First person Singular
manterá	Third person Singular
desconhecida	None
incomodassem	Third person Plural
mutilada	None
entusiasmam	Third person Plural
coincidiu	Third person Singular
passassem	Third person Plural
capitaneado	None
lampejados	None
navegadas	None
chefias	Second person Singular
regulamento	First person Singular
aquartelou	Third person Singular
tipificam	Third person Plural
desonrou	Third person Singular
encampassem	Third person Plural
configurariam	Third person Plural
pipetas	Second person Singular
autorizavam	Third person Plural
sondado	None
computou	Third person Singular
dedicam	Third person Plural
tramam	Third person Plural
perpetuadas	None
cacarejado	None
resgatando	None
sistematizam	Third person Plural
devaneados	None
repartíeis	Second person Plural
chiou	Third person Singular
assombro	First person Singular
contribuído	None
atrevo	First person Singular
ingerem	Third person Plural
aperfeiçoará	Third person Singular
denominavam	Third person Plural
gravas	Second person Singular
milhais	Second person Plural
singrariam	Third person Plural
combinareis	Second person Plural
mirei	First person Singular
pranteadas	None
peidados	None
costumamos	First person Plural
monopolizam	Third person Plural
produziriam	Third person Plural
virais	Second person Plural
brunidos	None
peregrino	First person Singular
constrangeu	Third person Singular
endurecem	Third person Plural
salmourado	None
taxado	None
fosfato	First person Singular
arbitrais	Second person Plural
registo	First person Singular
resenhado	None
trabalhavam	Third person Plural
regulo	First person Singular
propormos	First person Plural
quintuplicando	None
monitoro	First person Singular
desembrulhadas	None
acalentei	First person Singular
enferrujados	None
foges	Second person Singular
telo	First person Singular
tropecei	First person Singular
recicláveis	Second person Plural
alfabetizado	None
tenho	First person Singular
empoamos	First person Plural
desobrigáreis	Second person Plural
engrossou	Third person Singular
especulo	First person Singular
comendas	Second person Singular
terias	Second person Singular
porem	Third person Plural
comprovo	First person Singular
disponibilizei	First person Singular
anguladas	None
importou	Third person Singular
presumiam	Third person Plural
centradas	None
abortados	None
noticiados	None
precisásseis	Second person Plural
empenhavam	Third person Plural
rompidos	None
caraterizam	Third person Plural
interagiam	Third person Plural
liberais	Second person Plural
prescreviam	Third person Plural
complemento	First person Singular
parado	None
forjando	None
rateasses	Second person Singular
custando	None
amarradas	None
abobadas	Second person Singular
reformulou	Third person Singular
encobrindo	None
florescessem	Third person Plural
ficarás	Second person Singular
difamam	Third person Plural
blasfemadas	None
inclinando	None
amputada	None
tremidas	None
berçando	None
virada	None
mexericávamos	First person Plural
curvam	Third person Plural
revelou	Third person Singular
divertirei	First person Singular
banhas	Second person Singular
engravidados	None
atrapalhei	First person Singular
desviassem	Third person Plural
pedalastes	Second person Plural
comporão	Third person Plural
simpatizado	None
acalmados	None
vasculham	Third person Plural
enganei	First person Singular
imanado	None
sublinhei	First person Singular
guardam	Third person Plural
revigorando	None
dançassem	Third person Plural
reivindicavam	Third person Plural
baixáveis	Second person Plural
aprovará	Third person Singular
traduziam	Third person Plural
afogavam	Third person Plural
focalizam	Third person Plural
atapetáreis	Second person Plural
entumescendo	None
manjo	First person Singular
preparam	Third person Plural
encriptado	None
lerá	Third person Singular
logrados	None
faltarão	Third person Plural
fatio	First person Singular
moverá	Third person Singular
acabámos	First person Plural
otimizam	Third person Plural
jacto	First person Singular
candidatados	None
coassinando	None
amplificou	Third person Singular
cicatrizam	Third person Plural
esbraseado	None
falou	Third person Singular
dividirá	Third person Singular
entreguei	First person Singular
ralado	None
originarão	Third person Plural
mordiscadas	None
substantivarás	Second person Singular
cortejado	None
escravizada	None
esfriastes	Second person Plural
amamentaste	Second person Singular
expatriado	None
variará	Third person Singular
classificados	None
queixou	Third person Singular
imigram	Third person Plural
protegíeis	Second person Plural
aprisionaras	Second person Singular
recolheu	Third person Singular
maturaste	Second person Singular
comoveu	Third person Singular
favoreceriam	Third person Plural
flanqueando	None
povoando	None
ripadas	None
impugnei	First person Singular
fallada	None
desativados	None
desembarcou	Third person Singular
refugiarão	Third person Plural
florestadas	None
auxiliariam	Third person Plural
bocejando	None
levantarei	First person Singular
combatendo	None
observavam	Third person Plural
mantida	None
dissimulaste	Second person Singular
arrastavam	Third person Plural
aspiro	First person Singular
grasnasses	Second person Singular
envergas	Second person Singular
comei	Second person Plural
habitará	Third person Singular
traficadas	None
operarão	Third person Plural
retalháreis	Second person Plural
argentei	First person Singular
agredíramos	First person Plural
bastam	Third person Plural
arejados	None
esterilizados	None
torço	First person Singular
imploravam	Third person Plural
implicam	Third person Plural
movi	First person Singular
anglicizados	None
ouves	Second person Singular
cadastro	First person Singular
obliterados	None
concentramos	First person Plural
comutou	Third person Singular
absolvido	None
roubais	Second person Plural
gerados	None
nomeei	First person Singular
adquirem	Third person Plural
cardo	First person Singular
caídas	None
lampejamos	First person Plural
tampada	None
dilacerando	None
centelhásseis	Second person Plural
clorados	None
falariam	Third person Plural
executavam	Third person Plural
aceno	First person Singular
botamos	First person Plural
engolíamos	First person Plural
denominamos	First person Plural
libertavam	Third person Plural
remou	Third person Singular
casarão	Third person Plural
refugiariam	Third person Plural
amo	First person Singular
negariam	Third person Plural
colecionáveis	Second person Plural
massacro	First person Singular
desconsideramos	First person Plural
atuei	First person Singular
recontado	None
luzias	Second person Singular
teleportados	None
escusaríamos	First person Plural
refrigerando	None
chorarei	First person Singular
parecem	Third person Plural
oxigenada	None
componho	First person Singular
reagida	None
habituam	Third person Plural
misturou	Third person Singular
elucidou	Third person Singular
jejuou	Third person Singular
sobre-estimado	None
ultrapassam	Third person Plural
exercêsseis	Second person Plural
limpará	Third person Singular
dedicou	Third person Singular
implorando	None
apreciados	None
demoram	Third person Plural
atingido	None
cingiu	Third person Singular
revelei	First person Singular
dignam	Third person Plural
baralhas	Second person Singular
analisarei	First person Singular
vandalizam	Third person Plural
pautamos	First person Plural
solicitarei	First person Singular
pereceu	Third person Singular
lajeados	None
amortizamos	First person Plural
lutamos	First person Plural
reciclado	None
desenhastes	Second person Plural
restaurados	None
igualavam	Third person Plural
simplificados	None
transmutai	Second person Plural
evitado	None
articulados	None
ecoam	Third person Plural
importamos	First person Plural
desvairadas	None
vasto	First person Singular
especificavam	Third person Plural
implicada	None
admitissem	Third person Plural
chegaríamos	First person Plural
mencionaste	Second person Singular
aspirado	None
cedido	None
sibilas	Second person Singular
posicionarei	First person Singular
batalhados	None
navegavam	Third person Plural
ilham	Third person Plural
perfuram	Third person Plural
vigorado	None
pensaste	Second person Singular
posicionais	Second person Plural
acerado	None
decepcionada	None
desfigurou	Third person Singular
inciso	First person Singular
engendramos	First person Plural
vazado	None
chegássemos	First person Plural
revelavam	Third person Plural
esmero	First person Singular
culpam	Third person Plural
beijo	First person Singular
gerando	None
podado	None
inundou	Third person Singular
interligas	Second person Singular
superestimas	Second person Singular
pesquisasses	Second person Singular
estilhaçou	Third person Singular
hidrogenadas	None
descontando	None
inalou	Third person Singular
apocopáramos	First person Plural
ensejo	First person Singular
surraras	Second person Singular
pirateado	None
comiam	Third person Plural
gorámos	First person Plural
esmorecíamos	First person Plural
pactuando	None
visas	Second person Singular
tumultuam	Third person Plural
discorreriam	Third person Plural
fracionada	None
começo	First person Singular
interrogaríeis	Second person Plural
ampliamos	First person Plural
abandonadas	None
designareis	Second person Plural
freqüentou	Third person Singular
estreitas	Second person Singular
significou	Third person Singular
fomentadas	None
beneficiará	Third person Singular
descarrilhadas	None
renunciam	Third person Plural
implementará	Third person Singular
munida	None
resignado	None
abusado	None
estarrecêssemos	First person Plural
deportadas	None
torpedeada	None
estruturada	None
banho	First person Singular
pesquisada	None
estendi	First person Singular
penalizado	None
acabrunham	Third person Plural
conjugais	Second person Plural
dominassem	Third person Plural
ligas	Second person Singular
intersectarás	Second person Singular
umedecidos	None
perguntaste	Second person Singular
abasto	First person Singular
valsada	None
inferindo	None
desanimam	Third person Plural
coordenarão	Third person Plural
murcho	First person Singular
estreitam	Third person Plural
alquilaste	Second person Singular
lamentáveis	Second person Plural
brunes	Second person Singular
certificou	Third person Singular
dublando	None
detectada	None
emancipareis	Second person Plural
definissem	Third person Plural
calei	First person Singular
viajo	First person Singular
captei	First person Singular
relampejando	None
operas	Second person Singular
mandas	Second person Singular
enformámos	First person Plural
traçando	None
simulando	None
ajeitou	Third person Singular
entrariam	Third person Plural
prosseguiriam	Third person Plural
quiserem	Third person Plural
falcoareis	Second person Plural
conferiam	Third person Plural
rasgando	None
confeccionada	None
instituís	Second person Plural
reivindicam	Third person Plural
cambio	First person Singular
recomeçam	Third person Plural
afiliados	None
repetirei	First person Singular
sairá	Third person Singular
selecionada	None
invalidou	Third person Singular
fingem	Third person Plural
declarando	None
estourados	None
preservado	None
almoedados	None
patinando	None
comprando	None
estabelecêramos	First person Plural
duras	Second person Singular
bati	First person Singular
casou	Third person Singular
existem	Third person Plural
salpicadas	None
maiusculizada	None
isoláveis	Second person Plural
repartindo	None
poluídas	None
invocou	Third person Singular
dependo	First person Singular
nevando	None
recuam	Third person Plural
abreviavam	Third person Plural
desejado	None
coevoluindo	None
irritadas	None
consumada	None
estrangulado	None
aquentaríeis	Second person Plural
encareceu	Third person Singular
violento	First person Singular
depostas	None
actualizam	Third person Plural
aniquilada	None
verso	First person Singular
desci	First person Singular
afirmam	Third person Plural
estampavam	Third person Plural
numeram	Third person Plural
abarrotadas	None
desossará	Third person Singular
cristalizam	Third person Plural
concorrido	None
aninhas	Second person Singular
jurando	None
consertavas	Second person Singular
permeadas	None
granizo	First person Singular
absorvem	Third person Plural
propôs	Third person Singular
suplicando	None
abduziu	Third person Singular
escorrei	Second person Plural
obedecessem	Third person Plural
logram	Third person Plural
ages	Second person Singular
absterem	Third person Plural
salteado	None
difratados	None
vivida	None
narrou	Third person Singular
designamos	First person Plural
perfuradas	None
reservadas	None
pungueámos	First person Plural
regenerando	None
multiplicamos	First person Plural
alavancavas	Second person Singular
entregamos	First person Plural
melhorei	First person Singular
sucederão	Third person Plural
contribuíssem	Third person Plural
injungida	None
erotizaríeis	Second person Plural
apagamos	First person Plural
comboiado	None
opino	First person Singular
discordas	Second person Singular
construirão	Third person Plural
ampliou	Third person Singular
fuzilando	None
flanqueados	None
intercambiáveis	Second person Plural
apoiei	First person Singular
lembrados	None
projetou	Third person Singular
íamos	First person Plural
refrigeradas	None
anotadas	None
domesticam	Third person Plural
agucei	First person Singular
esfriaremos	First person Plural
terminadas	None
idealizados	None
beijada	None
misturastes	Second person Plural
identificassem	Third person Plural
gritei	First person Singular
entregas	Second person Singular
vindimasses	Second person Singular
minutas	Second person Singular
pechincharas	Second person Singular
refogariam	Third person Plural
protegerão	Third person Plural
devolveremos	First person Plural
fissionáveis	Second person Plural
flutuo	First person Singular
opprimíamos	First person Plural
quedadas	None
desmembrou	Third person Singular
engano	First person Singular
automatizam	Third person Plural
desposasses	Second person Singular
constituiu	Third person Singular
alagará	Third person Singular
calculará	Third person Singular
entreolhada	None
circunscrito	None
escamas	Second person Singular
calculam	Third person Plural
nhanhámos	First person Plural
guerreados	None
soubessem	Third person Plural
convidou	Third person Singular
desenhando	None
confundissem	Third person Plural
incidirão	Third person Plural
machucados	None
acionará	Third person Singular
inflamáveis	Second person Plural
silenciadas	None
analisará	Third person Singular
evolvida	None
alternavam	Third person Plural
explodes	Second person Singular
conservassem	Third person Plural
desencarnei	First person Singular
liguei	First person Singular
amaldiçoada	None
fermento	First person Singular
abluem	Third person Plural
fardo	First person Singular
arpejados	None
desmontaste	Second person Singular
recompensaríamos	First person Plural
vibrou	Third person Singular
desrespeitam	Third person Plural
trajo	First person Singular
salvaguardado	None
fomentando	None
envelheço	First person Singular
delatada	None
horto	First person Singular
sequestrando	None
secundarias	Second person Singular
congelado	None
desabavam	Third person Plural
coincidiam	Third person Plural
parecerá	Third person Singular
refizessem	Third person Plural
abrangiam	Third person Plural
acelerou	Third person Singular
atrapalhávamos	First person Plural
lotarias	Second person Singular
odorizado	None
destoavam	Third person Plural
evoluíam	Third person Plural
reembolsados	None
conformados	None
turvas	Second person Singular
impostas	None
cunham	Third person Plural
atentai	Second person Plural
agregado	None
desleixo	First person Singular
intersectamos	First person Plural
casadas	None
desarrumada	None
azulou	Third person Singular
diferenciarão	Third person Plural
pausado	None
cortassem	Third person Plural
realojado	None
cedes	Second person Singular
simpatizadas	None
ficai	Second person Plural
introduzissem	Third person Plural
efectivando	None
recompensam	Third person Plural
continuo	First person Singular
amávamos	First person Plural
loguei	First person Singular
incinerando	None
discordou	Third person Singular
ostentou	Third person Singular
obscurecida	None
ejaculavam	Third person Plural
substantivados	None
espanco	First person Singular
papagueasses	Second person Singular
mentida	None
agidas	None
adorai	Second person Plural
contagiada	None
modernizavam	Third person Plural
renderizados	None
batem	Third person Plural
munidos	None
disparassem	Third person Plural
bombando	None
codificavam	Third person Plural
conformo	First person Singular
distanciada	None
fundida	None
escutassem	Third person Plural
visualizada	None
ferviam	Third person Plural
aprumo	First person Singular
modificados	None
abaixo	First person Singular
raciocinastes	Second person Plural
perpassadas	None
tingiam	Third person Plural
juntariam	Third person Plural
pulo	First person Singular
oscilavam	Third person Plural
afetadas	None
lamentam	Third person Plural
adaptassem	Third person Plural
aviventado	None
concediam	Third person Plural
atrapalham	Third person Plural
migrados	None
vaiámos	First person Plural
somavam	Third person Plural
embaçados	None
condeno	First person Singular
magoam	Third person Plural
recobriu	Third person Singular
adotou	Third person Singular
destroem	Third person Plural
deformássemos	First person Plural
culpando	None
farás	Second person Singular
preenchi	First person Singular
nacionalizando	None
personalizarão	Third person Plural
desempoavas	Second person Singular
centrado	None
soprou	Third person Singular
alvejou	Third person Singular
discuto	First person Singular
dessem	Third person Plural
mixturáveis	Second person Plural
renegam	Third person Plural
divulgado	None
desmontavam	Third person Plural
nomeada	None
perfazem	Third person Plural
destroçado	None
guiando	None
identificariam	Third person Plural
buscam	Third person Plural
borrou	Third person Singular
apoucaste	Second person Singular
enraivecidas	None
retirando	None
peleado	None
arremato	First person Singular
impedem	Third person Plural
doará	Third person Singular
sobreviverá	Third person Singular
piou	Third person Singular
aderiu	Third person Singular
nasceriam	Third person Plural
encampáveis	Second person Plural
querem	Third person Plural
penalizarás	Second person Singular
aspiram	Third person Plural
airamos	First person Plural
embainhado	None
moveis	Second person Plural
malto	First person Singular
ousai	Second person Plural
emprestadas	None
pregou	Third person Singular
espaçaras	Second person Singular
cultivam	Third person Plural
aludiu	Third person Singular
apaixonado	None
interagindo	None
batizam	Third person Plural
administrada	None
estudarão	Third person Plural
sucederá	Third person Singular
botou	Third person Singular
isoladas	None
alucinado	None
amaldiçoado	None
maturas	Second person Singular
banalizáreis	Second person Plural
devido	None
deixo	First person Singular
desanimou	Third person Singular
sentiam	Third person Plural
autorizamos	First person Plural
afundidos	None
equilibro	First person Singular
intermediada	None
preferiu	Third person Singular
cotariam	Third person Plural
rodeadas	None
desfraldou	Third person Singular
chegaste	Second person Singular
doutrinou	Third person Singular
examinará	Third person Singular
lançou	Third person Singular
chacinou	Third person Singular
divinizo	First person Singular
chacinados	None
atuassem	Third person Plural
transcorrida	None
pronunciassem	Third person Plural
renderizando	None
graduam	Third person Plural
zico	First person Singular
focas	Second person Singular
ostentavam	Third person Plural
produzissem	Third person Plural
atrasou	Third person Singular
augurado	None
desafiadas	None
provisionais	Second person Plural
balbuciada	None
dispostos	None
cozendo	None
instituíssem	Third person Plural
desmatou	Third person Singular
conceituam	Third person Plural
janelada	None
pescadas	None
vieste	Second person Singular
arrependo	First person Singular
desleixasses	Second person Singular
maximizando	None
delineada	None
percebida	None
envio	First person Singular
comináreis	Second person Plural
reprimísseis	Second person Plural
zombam	Third person Plural
agarradas	None
machucado	None
vigorará	Third person Singular
comportarão	Third person Plural
nascerão	Third person Plural
lançavam	Third person Plural
jubilado	None
descolorareis	Second person Plural
fretada	None
deliberada	None
lapidado	None
escreveste	Second person Singular
descartavam	Third person Plural
enfardelando	None
guardarão	Third person Plural
cacarejados	None
caminhadas	None
guardas	Second person Singular
mudaste	Second person Singular
descolaríamos	First person Plural
quererem	Third person Plural
comparo	First person Singular
isolam	Third person Plural
ensejou	Third person Singular
alinham	Third person Plural
insultando	None
brisas	Second person Singular
diferenciais	Second person Plural
fechariam	Third person Plural
suplicamos	First person Plural
comprimindo	None
tiverem	Third person Plural
fugido	None
refugiavam	Third person Plural
aguentaste	Second person Singular
apelam	Third person Plural
decepcionei	First person Singular
trocará	Third person Singular
edificou	Third person Singular
interligará	Third person Singular
aproximavam	Third person Plural
desconfio	First person Singular
transmito	First person Singular
desatino	First person Singular
picotas	Second person Singular
reconhecerão	Third person Plural
graváveis	Second person Plural
deitada	None
confirmará	Third person Singular
penetravam	Third person Plural
ouvirá	Third person Singular
comprovassem	Third person Plural
parecida	None
agüentou	Third person Singular
falhamos	First person Plural
condicionado	None
deliciados	None
acampam	Third person Plural
chegaríeis	Second person Plural
antagonizam	Third person Plural
preservamos	First person Plural
desabado	None
soltassem	Third person Plural
confirmarei	First person Singular
arriscamos	First person Plural
alienando	None
amorenada	None
anularão	Third person Plural
conversando	None
sinalizavam	Third person Plural
qualificou	Third person Singular
dissolvessem	Third person Plural
costumavam	Third person Plural
remo	First person Singular
folgou	Third person Singular
casariam	Third person Plural
bifurcarias	Second person Singular
representamos	First person Plural
franzirias	Second person Singular
exibirá	Third person Singular
dinamitada	None
soluçai	Second person Plural
recarregando	None
ensejará	Third person Singular
enfraquecem	Third person Plural
saberei	First person Singular
refletiriam	Third person Plural
comportada	None
confirmam	Third person Plural
excellêsseis	Second person Plural
gemei	Second person Plural
checam	Third person Plural
tragáreis	Second person Plural
escutavam	Third person Plural
relampejaste	Second person Singular
deixavam	Third person Plural
pecas	Second person Singular
desencorajamos	First person Plural
marcai	Second person Plural
esfaqueadas	None
arrebanhou	Third person Singular
indicassem	Third person Plural
triplicáramos	First person Plural
colaborarão	Third person Plural
reunirão	Third person Plural
estivas	Second person Singular
venderiam	Third person Plural
dessulfurásseis	Second person Plural
inventastes	Second person Plural
instigavam	Third person Plural
esfregadas	None
disparada	None
apanham	Third person Plural
instruiu	Third person Singular
fuçaríamos	First person Plural
rezei	First person Singular
approvada	None
apito	First person Singular
navegada	None
receio	First person Singular
ladrilhada	None
reiniciei	First person Singular
metilei	First person Singular
dizimadas	None
derramada	None
inflou	Third person Singular
baixada	None
familiarizei	First person Singular
padecido	None
trajavam	Third person Plural
estão	Third person Plural
pontuou	Third person Singular
conheciam	Third person Plural
construo	First person Singular
commetido	None
entendo	First person Singular
frequentadas	None
postulai	Second person Plural
postulando	None
catalogou	Third person Singular
retifiquei	First person Singular
escolhem	Third person Plural
saturados	None
compilei	First person Singular
encurtávamos	First person Plural
mereceriam	Third person Plural
desgastavam	Third person Plural
padronizou	Third person Singular
recomendei	First person Singular
desenhei	First person Singular
plantamos	First person Plural
carpirás	Second person Singular
russificado	None
agradará	Third person Singular
aposentados	None
vendendo	None
funcionou	Third person Singular
diluiu	Third person Singular
lidavam	Third person Plural
encantam	Third person Plural
arranhados	None
confrontadas	None
escorados	None
descenderiam	Third person Plural
estripada	None
prendiam	Third person Plural
adjetivou	Third person Singular
danarás	Second person Singular
residiu	Third person Singular
aram	Third person Plural
evoluem	Third person Plural
aquecem	Third person Plural
participarei	First person Singular
arrepiou	Third person Singular
exibirão	Third person Plural
indulto	First person Singular
acuminadas	None
vermelheadas	None
estranhavam	Third person Plural
violentas	Second person Singular
regeneravam	Third person Plural
convalescido	None
fortaleceu	Third person Singular
partilham	Third person Plural
apoteosavas	Second person Singular
centralizáramos	First person Plural
sustado	None
pululam	Third person Plural
consentiu	Third person Singular
combinando	None
instalariam	Third person Plural
triangulará	Third person Singular
cambará	Third person Singular
desamarrando	None
bifurcam	Third person Plural
originariam	Third person Plural
mostrados	None
desacompanhadas	None
derrocadas	None
sarados	None
substantivas	Second person Singular
residirei	First person Singular
pedirá	Third person Singular
ralo	First person Singular
descreviam	Third person Plural
comandariam	Third person Plural
resultou	Third person Singular
dormitando	None
zoiada	None
comemorando	None
furtou	Third person Singular
extraem	Third person Plural
demonstrariam	Third person Plural
ornavam	Third person Plural
expressassem	Third person Plural
fotografado	None
mencionavam	Third person Plural
continuará	Third person Singular
proscreveu	Third person Singular
cavoucáveis	Second person Plural
confirmou	Third person Singular
censurando	None
vegeto	First person Singular
espoucados	None
reescreverão	Third person Plural
promoveu	Third person Singular
efetuarão	Third person Plural
sublinhou	Third person Singular
reencontrariam	Third person Plural
persuadiu	Third person Singular
rarefeita	None
mandam	Third person Plural
ressurgiu	Third person Singular
madrugastes	Second person Plural
enchido	None
caraterizados	None
verifiquei	First person Singular
travará	Third person Singular
invocassem	Third person Plural
locas	Second person Singular
rotuláreis	Second person Plural
emprenhássemos	First person Plural
transpusésseis	Second person Plural
eliminaremos	First person Plural
alo	First person Singular
desembarco	First person Singular
articulada	None
investindo	None
irrigam	Third person Plural
preciso	First person Singular
diagnosticado	None
protegidas	None
vencerás	Second person Singular
aromatizados	None
nublaremos	First person Plural
combinado	None
possibilitam	Third person Plural
drapejado	None
embrulhados	None
evoquei	First person Singular
resguardados	None
provocarão	Third person Plural
incitou	Third person Singular
reconheceriam	Third person Plural
sobre-estimavam	Third person Plural
orientavam	Third person Plural
observas	Second person Singular
tangarão	Third person Plural
ensejaremos	First person Plural
apontei	First person Singular
testemunham	Third person Plural
legásseis	Second person Plural
aposentam	Third person Plural
aproximarão	Third person Plural
reinventam	Third person Plural
sonhei	First person Singular
largará	Third person Singular
reconstruindo	None
comporá	Third person Singular
chegassem	Third person Plural
desbastarão	Third person Plural
emitiriam	Third person Plural
pilotará	Third person Singular
varam	Third person Plural
reenvio	First person Singular
optariam	Third person Plural
reencontrou	Third person Singular
maturado	None
conectados	None
fluoro	First person Singular
apresentariam	Third person Plural
passaste	Second person Singular
fosforescerão	Third person Plural
vacilou	Third person Singular
zeraste	Second person Singular
substantivo	First person Singular
pereceriam	Third person Plural
peleijado	None
candidatando	None
estariam	Third person Plural
abscindiríamos	First person Plural
guardamos	First person Plural
expressou	Third person Singular
palestrando	None
lotados	None
aterrada	None
degradado	None
ceifadas	None
perseverou	Third person Singular
apareço	First person Singular
mantivessem	Third person Plural
enroladas	None
cindido	None
alevantámos	First person Plural
ladro	First person Singular
acampavam	Third person Plural
desconsideravam	Third person Plural
abarrotado	None
alçados	None
empoleirados	None
branqueio	First person Singular
inteiram	Third person Plural
atendeu	Third person Singular
agradeço	First person Singular
participado	None
pranteada	None
vilipendiado	None
pelásseis	Second person Plural
desabilitando	None
acertados	None
abandada	None
marcado	None
personalizou	Third person Singular
aduzíssemos	First person Plural
patenteastes	Second person Plural
ararás	Second person Singular
enviuvando	None
tranquilizam	Third person Plural
mesclados	None
vazam	Third person Plural
associada	None
guiavam	Third person Plural
vigiou	Third person Singular
imitadas	None
reconquistas	Second person Singular
leste	Second person Singular
multas	Second person Singular
esfaqueada	None
programo	First person Singular
confiada	None
transcreveu	Third person Singular
aposentou	Third person Singular
franqueou	Third person Singular
desejávamos	First person Plural
preenchiam	Third person Plural
contorcendo	None
voarão	Third person Plural
contrapôs	Third person Singular
assemelharão	Third person Plural
amadureci	First person Singular
pergunto	First person Singular
consideras	Second person Singular
estimulada	None
encerrassem	Third person Plural
editamos	First person Plural
combinamos	First person Plural
participou	Third person Singular
vermelhejareis	Second person Plural
pospúnhamos	First person Plural
agendadas	None
estagiou	Third person Singular
visitado	None
evidenciei	First person Singular
cercassem	Third person Plural
expulsas	Second person Singular
reúnem	Third person Plural
criaremos	First person Plural
antipatizados	None
proclamou	Third person Singular
estipularíamos	First person Plural
admoestado	None
contorciam	Third person Plural
anodizado	None
renegadas	None
soltavam	Third person Plural
soou	Third person Singular
relutou	Third person Singular
azulejastes	Second person Plural
namorou	Third person Singular
apiedados	None
comungadas	None
obtemperadas	None
atempas	Second person Singular
colocas	Second person Singular
ouvíamos	First person Plural
acometidos	None
reciclei	First person Singular
capturados	None
varreu	Third person Singular
cintas	Second person Singular
fuziladas	None
planejei	First person Singular
choram	Third person Plural
martirizadas	None
comeu	Third person Singular
instigados	None
agourentados	None
povoassem	Third person Plural
silencio	First person Singular
transcrevo	First person Singular
rufáramos	First person Plural
confronto	First person Singular
reuniam	Third person Plural
jubilarei	First person Singular
secavam	Third person Plural
entenderão	Third person Plural
distraem	Third person Plural
ouviste	Second person Singular
sedimentaras	Second person Singular
escurecerás	Second person Singular
judias	Second person Singular
atravessará	Third person Singular
fraudados	None
discordamos	First person Plural
mostraste	Second person Singular
pactuou	Third person Singular
ganharão	Third person Plural
ferido	None
enredarias	Second person Singular
pajeávamos	First person Plural
paralizadas	None
legendavas	Second person Singular
assaltam	Third person Plural
dotais	Second person Plural
desabrochando	None
desapareciam	Third person Plural
remontou	Third person Singular
rocada	None
transmitissem	Third person Plural
rangadas	None
levam	Third person Plural
fermentarias	Second person Singular
melhoravam	Third person Plural
otimizadas	None
sedimentou	Third person Singular
furando	None
intercetais	Second person Plural
nivelando	None
candidatei	First person Singular
apodrecidos	None
reconstruíam	Third person Plural
solicitei	First person Singular
estavas	Second person Singular
atuareis	Second person Plural
recorressem	Third person Plural
pioram	Third person Plural
ornamentais	Second person Plural
emboscam	Third person Plural
orçadas	None
visariam	Third person Plural
queixavam	Third person Plural
lançáveis	Second person Plural
encetado	None
ajuntavam	Third person Plural
realçásseis	Second person Plural
colidirá	Third person Singular
complementam	Third person Plural
estagnados	None
encerrando	None
ficariam	Third person Plural
avariais	Second person Plural
prolongariam	Third person Plural
exaladas	None
aceitei	First person Singular
cantarei	First person Singular
empenhará	Third person Singular
arquivo	First person Singular
ativáreis	Second person Plural
tornamos	First person Plural
ganhassem	Third person Plural
gorjeado	None
muniríeis	Second person Plural
engoliu	Third person Singular
dispensou	Third person Singular
atribuídas	None
delineavam	Third person Plural
extinguirão	Third person Plural
contagias	Second person Singular
choramingo	First person Singular
grudou	Third person Singular
retêm	Third person Plural
relacionavam	Third person Plural
ligadas	None
apresento	First person Singular
destinassem	Third person Plural
impugno	First person Singular
adornada	None
espelho	First person Singular
golpeiam	Third person Plural
ondulam	Third person Plural
rumavam	Third person Plural
autuados	None
arroxeada	None
congregou	Third person Singular
bendigo	First person Singular
apimentaste	Second person Singular
meados	None
africanizáramos	First person Plural
invejaremos	First person Plural
reconciliassem	Third person Plural
governarão	Third person Plural
beiravam	Third person Plural
aumentarão	Third person Plural
reprisariam	Third person Plural
andam	Third person Plural
sopro	First person Singular
permanecerão	Third person Plural
zoada	None
pautado	None
cambaleei	First person Singular
desrespeitei	First person Singular
notificaríamos	First person Plural
justapondo	None
apaixonei	First person Singular
elogiam	Third person Plural
actuou	Third person Singular
despidas	None
estivéssemos	First person Plural
exportavam	Third person Plural
caluniou	Third person Singular
ralou	Third person Singular
esperou	Third person Singular
tocará	Third person Singular
sintonizou	Third person Singular
especificada	None
travo	First person Singular
girou	Third person Singular
antecipadas	None
apareceríeis	Second person Plural
concorreu	Third person Singular
executo	First person Singular
declinado	None
recomeçando	None
importuno	First person Singular
compreendidos	None
pintassem	Third person Plural
mencionas	Second person Singular
fissurando	None
parafraseados	None
negociais	Second person Plural
aguçada	None
revoltados	None
evacuou	Third person Singular
retomavam	Third person Plural
amainados	None
fundassem	Third person Plural
desprezavam	Third person Plural
lastamos	First person Plural
enfatizou	Third person Singular
citas	Second person Singular
adjudicou	Third person Singular
desconfortáveis	Second person Plural
solicitavam	Third person Plural
despedido	None
averiguei	First person Singular
souberam	Third person Plural
reconstituiu	Third person Singular
dispenso	First person Singular
abençoando	None
contentado	None
cimentou	Third person Singular
figuram	Third person Plural
referem	Third person Plural
estipulando	None
metiam	Third person Plural
alcançassem	Third person Plural
permeamos	First person Plural
atuarão	Third person Plural
louvado	None
olhei	First person Singular
expressados	None
abaixam	Third person Plural
danço	First person Singular
ressuscitarão	Third person Plural
descido	None
citarei	First person Singular
intervim	First person Singular
digito	First person Singular
concedeu	Third person Singular
resolvo	First person Singular
baralhada	None
vivi	First person Singular
sabotou	Third person Singular
recorreríeis	Second person Plural
inundarei	First person Singular
ressuscitará	Third person Singular
rematando	None
alçado	None
denunciam	Third person Plural
conseguirão	Third person Plural
carbonizados	None
desenvolvessem	Third person Plural
achatado	None
desejam	Third person Plural
assoreadas	None
ampliarão	Third person Plural
perturbada	None
cultivavas	Second person Singular
almejas	Second person Singular
parada	None
evitarão	Third person Plural
proibissem	Third person Plural
comettida	None
ponhou	Third person Singular
extinguiam	Third person Plural
oxigenáveis	Second person Plural
emendas	Second person Singular
angelizado	None
formarão	Third person Plural
partiam	Third person Plural
monitorado	None
achatam	Third person Plural
maturados	None
traziam	Third person Plural
elevas	Second person Singular
argumentados	None
deixassem	Third person Plural
aliciaras	Second person Singular
escolhiam	Third person Plural
grunhireis	Second person Plural
abocanhada	None
reiniciásseis	Second person Plural
caminhou	Third person Singular
espoucada	None
desfrutavam	Third person Plural
contribuíam	Third person Plural
vertida	None
excedessem	Third person Plural
montamos	First person Plural
encadernados	None
descansando	None
perfaziam	Third person Plural
consultáramos	First person Plural
saíssem	Third person Plural
remontassem	Third person Plural
entusiasmávamos	First person Plural
salientou	Third person Singular
torrando	None
precipitou	Third person Singular
recusei	First person Singular
reencontro	First person Singular
indicou	Third person Singular
lembro	First person Singular
cortejam	Third person Plural
aterrorizada	None
confessou	Third person Singular
criticados	None
evolvendo	None
publicitarias	Second person Singular
preso	None
repouso	First person Singular
prejudicavam	Third person Plural
interagiras	Second person Singular
manifestadas	None
inocentados	None
frustram	Third person Plural
anulou	Third person Singular
odiareis	Second person Plural
manifestará	Third person Singular
aguentou	Third person Singular
conduzirá	Third person Singular
exalam	Third person Plural
rebatem	Third person Plural
seqüestradas	None
alerto	First person Singular
reprováveis	Second person Plural
reforço	First person Singular
relaxados	None
aliviam	Third person Plural
regularizadas	None
esmerarão	Third person Plural
repousavam	Third person Plural
lidamos	First person Plural
idealizavas	Second person Singular
junjo	First person Singular
assenhoreou	Third person Singular
dirigiu	Third person Singular
voltai	Second person Plural
noticias	Second person Singular
confirmadas	None
analogizadas	None
revitalizada	None
decretamos	First person Plural
decepou	Third person Singular
dissuadiu	Third person Singular
beatificou	Third person Singular
berçados	None
torneadas	None
incorporará	Third person Singular
tripulou	Third person Singular
cismo	First person Singular
levaremos	First person Plural
dizimavam	Third person Plural
descontinuando	None
homologada	None
acompanhariam	Third person Plural
provada	None
entoando	None
sobrepostas	None
procederei	First person Singular
considerai	Second person Plural
intensificadas	None
jogado	None
louvou	Third person Singular
acoplamos	First person Plural
sobrará	Third person Singular
devolvessem	Third person Plural
evitei	First person Singular
vitimadas	None
oposto	None
legitimávamos	First person Plural
quinto	First person Singular
selectássemos	First person Plural
contactassem	Third person Plural
ressaltam	Third person Plural
brochadas	None
ostentarão	Third person Plural
assomados	None
contrariado	None
provirem	Third person Plural
rejeitariam	Third person Plural
ostentará	Third person Singular
albergavam	Third person Plural
ideou	Third person Singular
nomeassem	Third person Plural
zoo	First person Singular
patrocinam	Third person Plural
aborrecem	Third person Plural
observarão	Third person Plural
cobiço	First person Singular
subissem	Third person Plural
catalogam	Third person Plural
costumou	Third person Singular
humideciam	Third person Plural
aproveitam	Third person Plural
assassinam	Third person Plural
telefonou	Third person Singular
dispunham	Third person Plural
aguardo	First person Singular
tomará	Third person Singular
votei	First person Singular
predominou	Third person Singular
ancinho	First person Singular
convertiam	Third person Plural
significará	Third person Singular
enviado	None
engasgo	First person Singular
aterrorizavam	Third person Plural
estupravam	Third person Plural
orando	None
arreigando	None
precisássemos	First person Plural
interrompido	None
ajudarão	Third person Plural
miravam	Third person Plural
entristecido	None
pontuavam	Third person Plural
comprometeriam	Third person Plural
animo	First person Singular
reivindicou	Third person Singular
dividem	Third person Plural
charqueados	None
alojado	None
cozinhado	None
rolarás	Second person Singular
avaliavam	Third person Plural
pressentiam	Third person Plural
doídas	None
supriu	Third person Singular
dissecada	None
reforçam	Third person Plural
decolando	None
ultrapassaremos	First person Plural
aduziras	Second person Singular
detestam	Third person Plural
descongelada	None
monopolizavam	Third person Plural
exceptuados	None
acidificadas	None
perdoai	Second person Plural
significassem	Third person Plural
viriam	Third person Plural
agourentassem	Third person Plural
devassada	None
invejas	Second person Singular
transpostas	None
vivenciais	Second person Plural
assumissem	Third person Plural
lambiam	Third person Plural
memorizavam	Third person Plural
desculparíamos	First person Plural
descongelam	Third person Plural
mimida	None
avivaremos	First person Plural
brindam	Third person Plural
desencadeados	None
influenciadas	None
monopolizarias	Second person Singular
colas	Second person Singular
preferiam	Third person Plural
registou	Third person Singular
corrigirá	Third person Singular
espelham	Third person Plural
construirá	Third person Singular
digitei	First person Singular
cativado	None
respeitassem	Third person Plural
triturada	None
encerou	Third person Singular
lobrigando	None
cobiçou	Third person Singular
aras	Second person Singular
volverás	Second person Singular
confiam	Third person Plural
insinuou	Third person Singular
içou	Third person Singular
apresentadas	None
candidato	First person Singular
sufocam	Third person Plural
contendida	None
perdeu	Third person Singular
galgado	None
elaborou	Third person Singular
domo	First person Singular
maxixarias	Second person Singular
podereis	Second person Plural
esquivou	Third person Singular
minguando	None
amarrando	None
enxerguei	First person Singular
cumprimentando	None
declarou	Third person Singular
sobrepassareis	Second person Plural
ousariam	Third person Plural
requerem	Third person Plural
perguntas	Second person Singular
hospedando	None
presenciam	Third person Plural
classificassem	Third person Plural
definhou	Third person Singular
ponhando	None
insiro	First person Singular
aceleradas	None
apropriam	Third person Plural
revoltei	First person Singular
cumulariam	Third person Plural
justifiquei	First person Singular
vencendo	None
lembrásseis	Second person Plural
categorizo	First person Singular
rangi	First person Singular
solapando	None
destacado	None
ativei	First person Singular
embaraço	First person Singular
consolidou	Third person Singular
melo	First person Singular
avançamos	First person Plural
submeto	First person Singular
descompúnhamos	First person Plural
atrevida	None
clonou	Third person Singular
empreendeu	Third person Singular
registradas	None
permaneci	First person Singular
encantavam	Third person Plural
contribuindo	None
murchei	First person Singular
calculando	None
indenizariam	Third person Plural
clonais	Second person Plural
promovo	First person Singular
ensanguentados	None
minimizam	Third person Plural
pisei	First person Singular
gozei	First person Singular
adequando	None
prorroguei	First person Singular
rechaçado	None
espezinhados	None
sustentam	Third person Plural
anagramatizada	None
derrogadas	None
supunham	Third person Plural
sobejas	Second person Singular
ornando	None
envernizado	None
limitei	First person Singular
neguei	First person Singular
enlouquecido	None
discorrendo	None
contraída	None
causassem	Third person Plural
detestado	None
abordassem	Third person Plural
compunham	Third person Plural
arrebentando	None
filmariam	Third person Plural
impetrai	Second person Plural
abnegada	None
inventam	Third person Plural
resumiu	Third person Singular
entrecortado	None
homogeneizado	None
tachareis	Second person Plural
invoquei	First person Singular
rangassem	Third person Plural
preverão	Third person Plural
approvando	None
engasgada	None
detinham	Third person Plural
situaríeis	Second person Plural
transmitirão	Third person Plural
realizais	Second person Plural
quebrantada	None
publicas	Second person Singular
combatidas	None
cresceríeis	Second person Plural
loco	First person Singular
manteríamos	First person Plural
percorrerá	Third person Singular
espiado	None
fartou	Third person Singular
cabem	Third person Plural
regerá	Third person Singular
incendiou	Third person Singular
bateriam	Third person Plural
sobrando	None
rotulados	None
apagarei	First person Singular
constassem	Third person Plural
soletram	Third person Plural
evoluiu	Third person Singular
liquidadas	None
agrupou	Third person Singular
europeizamos	First person Plural
apontamos	First person Plural
cortariam	Third person Plural
apedrejando	None
rabiscarei	First person Singular
originais	Second person Plural
reafirmavam	Third person Plural
arraso	First person Singular
confraternizam	Third person Plural
abrigo	First person Singular
conjuraríeis	Second person Plural
apontarão	Third person Plural
instalará	Third person Singular
atacassem	Third person Plural
dosada	None
aglomeram	Third person Plural
adorados	None
faltado	None
intercalam	Third person Plural
optei	First person Singular
incriminada	None
zonaras	Second person Singular
refutada	None
auxiliou	Third person Singular
provaras	Second person Singular
mimando	None
marcarão	Third person Plural
regeneram	Third person Plural
descontinuo	First person Singular
acirrou	Third person Singular
conturbais	Second person Plural
refinada	None
enredando	None
xonou	Third person Singular
interessam	Third person Plural
assolou	Third person Singular
engordando	None
cumprissem	Third person Plural
consultamos	First person Plural
tosas	Second person Singular
pilas	Second person Singular
coradas	None
adicionada	None
supormos	First person Plural
fantasias	Second person Singular
encarnam	Third person Plural
avaliam	Third person Plural
rearranjará	Third person Singular
implantavam	Third person Plural
tiramos	First person Plural
empregavam	Third person Plural
amarravam	Third person Plural
ministram	Third person Plural
vomitada	None
funcionadas	None
civilizado	None
renunciou	Third person Singular
piaríeis	Second person Plural
debitado	None
teleporto	First person Singular
edificam	Third person Plural
franjada	None
empalhada	None
arranco	First person Singular
aureolada	None
embarcariam	Third person Plural
opôs	Third person Singular
rebelavam	Third person Plural
guglei	First person Singular
mendigaríeis	Second person Plural
inalando	None
engolido	None
desmembrei	First person Singular
escondeu	Third person Singular
recomendavam	Third person Plural
desabituaríamos	First person Plural
apelidou	Third person Singular
desempoadas	None
sugerem	Third person Plural
ausentou	Third person Singular
impeliu	Third person Singular
desconsagrada	None
usássemos	First person Plural
vomito	First person Singular
ejetados	None
deixadas	None
benditos	None
googleados	None
pilhavam	Third person Plural
joguei	First person Singular
convocam	Third person Plural
desferidos	None
vislumbravam	Third person Plural
insistes	Second person Singular
desviam	Third person Plural
posto	First person Singular
devisaste	Second person Singular
rogamos	First person Plural
aposentámos	First person Plural
afiado	None
deixas	Second person Singular
descarto	First person Singular
roncando	None
doído	None
banhou	Third person Singular
saboreada	None
respondiam	Third person Plural
mamou	Third person Singular
sofrerá	Third person Singular
informei	First person Singular
criticada	None
devassado	None
armazenará	Third person Singular
retardam	Third person Plural
gerarão	Third person Plural
mostradas	None
qualificados	None
concatenásseis	Second person Plural
suspeitassem	Third person Plural
lastimo	First person Singular
prospero	First person Singular
concordavam	Third person Plural
dessulfurando	None
convéns	Second person Singular
abdico	First person Singular
arrependidos	None
escalam	Third person Plural
gravadas	None
ensinassem	Third person Plural
fiáveis	Second person Plural
aprecio	First person Singular
sujeitado	None
aventou	Third person Singular
lambidas	None
escorado	None
zoiadas	None
calibro	First person Singular
acendiam	Third person Plural
compostada	None
embarcassem	Third person Plural
dissolvido	None
mancais	Second person Plural
especulassem	Third person Plural
relaxando	None
costumávamos	First person Plural
assumiam	Third person Plural
patrocinados	None
bacharelado	None
estandardizada	None
escapulíamos	First person Plural
zumbis	Second person Plural
concluiu	Third person Singular
estarmos	First person Plural
vacilamos	First person Plural
folgada	None
sacolearás	Second person Singular
jogamos	First person Plural
infecto	First person Singular
colmamos	First person Plural
votará	Third person Singular
resistido	None
auferiam	Third person Plural
xerocado	None
recrutou	Third person Singular
levantados	None
attentada	None
esvaiu	Third person Singular
escolho	First person Singular
içando	None
enrugavam	Third person Plural
contestando	None
ocorrido	None
cravariam	Third person Plural
aterrissados	None
ativou	Third person Singular
limpados	None
tirará	Third person Singular
desembarcassem	Third person Plural
abastecidos	None
constatei	First person Singular
envergam	Third person Plural
assestando	None
modernizados	None
consistindo	None
improvisando	None
comungam	Third person Plural
violam	Third person Plural
comutam	Third person Plural
vivendo	None
abandonei	First person Singular
brecará	Third person Singular
baldado	None
reservando	None
copiando	None
remontadas	None
merecerão	Third person Plural
simpatizam	Third person Plural
resgatariam	Third person Plural
aventuram	Third person Plural
palestro	First person Singular
avistareis	Second person Plural
falcoasses	Second person Singular
esboçando	None
revogou	Third person Singular
despertai	Second person Plural
erro	First person Singular
atuará	Third person Singular
trocada	None
assinou	Third person Singular
lerão	Third person Plural
cobririam	Third person Plural
vencerão	Third person Plural
ruíste	Second person Singular
locareis	Second person Plural
rolados	None
pilou	Third person Singular
friccionáreis	Second person Plural
cruzam	Third person Plural
terceirizadas	None
avaliamos	First person Plural
acusadas	None
divides	Second person Singular
succedidos	None
redefinem	Third person Plural
tremeluziríamos	First person Plural
levássemos	First person Plural
vierem	Third person Plural
mobilizada	None
voltassem	Third person Plural
falam	Third person Plural
insinuei	First person Singular
substituirão	Third person Plural
escalpelado	None
envenenam	Third person Plural
intrometêssemos	First person Plural
salientada	None
tolerará	Third person Singular
coalhastes	Second person Plural
invento	First person Singular
profanas	Second person Singular
grassitada	None
eximiu	Third person Singular
confirmariam	Third person Plural
estolando	None
repugnássemos	First person Plural
admiramos	First person Plural
entronizando	None
impressionavas	Second person Singular
inaugurados	None
casará	Third person Singular
