przewagą	Instrumental
podejrzewam	None
krawatek	Genitive
ekranizacjach	Essive
aria	Nominative
ginąc	None
kapelanom	Dative
czereśniach	Essive
chorągwiom	Dative
temperatura	Nominative
rajdowcami	Instrumental
krachami	Instrumental
herców	Genitive
krawata	Genitive
szarlatan	Nominative
odkrywał	None
gwintu	Genitive
grzywnę	Accusative
kobro	Vocative
cotygodniowymi	Instrumental
kosem	Instrumental
wielkościach	Essive
reszta	Nominative
okażą	None
cmentarzami	Instrumental
czipsach	Essive
glonem	Instrumental
szałwio	Vocative
chciana	None
wyjaśnią	None
kozą	Instrumental
grabem	Instrumental
cateringowi	Dative
pstrągiem	Instrumental
wykładnią	Instrumental
znajdowali	None
epilogowi	Dative
denerwuję	None
bibułach	Essive
pełzam	None
podpasek	Genitive
jabłuszkami	Instrumental
opisem	Instrumental
leczyć	None
ukrycie	None
prokuratorem	Instrumental
psuć	None
przechodniach	Essive
czarowi	Dative
większymi	Instrumental
ćwiczyłyście	None
wizję	Accusative
silnika	Genitive
nokautach	Essive
sufler	Nominative
pancerzach	Essive
apsydą	Instrumental
szparagów	Genitive
makom	Dative
sałatę	Accusative
cudzoziemiec	Nominative
grypę	Accusative
unikajmy	None
ładowarkę	Accusative
uraninitów	Genitive
czadyjscy	Nominative
życzmy	None
statków	Genitive
wielobokiem	Instrumental
miotu	Genitive
miałem	Instrumental
juliańska	Nominative
szef	Nominative
machać	None
kręciła	None
słuchałem	None
oceniły	None
błyskaliśmy	None
mieszajmy	None
ograniczająca	None
matematyką	Instrumental
nerwem	Instrumental
bandami	Instrumental
kuzynek	Genitive
pecetowi	Dative
talonowi	Dative
trójkąta	Genitive
podstawach	Essive
łask	Genitive
kół	Genitive
Irakijkę	Accusative
cewnikami	Instrumental
rodzi	None
schnęłaby	None
przeprowadzam	None
wywodom	Dative
sprzedażą	Instrumental
przerzutniom	Dative
zapasami	Instrumental
półfinałach	Essive
gwarem	Instrumental
kuzynką	Instrumental
pokrywać	None
kibicowali	None
chorzy	Nominative
naradek	Genitive
najwolniejsza	Nominative
bałkańscy	Nominative
pomagano	None
konfliktowi	Dative
usuwający	None
garbem	Instrumental
krewetek	Genitive
oceniłbym	None
workiem	Instrumental
uśpiła	None
chaus	Nominative
sprawdziłby	None
wyłudził	None
tlałabyś	None
czopowi	Dative
naprawa	Nominative
marynarkach	Essive
ładniejsi	Nominative
kogutem	Instrumental
biodrze	Essive
rózg	Genitive
analfabeta	Nominative
helikopterów	Genitive
owadożernymi	Instrumental
napierdalanka	Nominative
obułybyście	None
odpowiadaliśmy	None
opisujemy	None
wyniesiono	None
alkoholiczka	Nominative
odpowiedzialni	Nominative
owocami	Instrumental
prał	None
menorą	Instrumental
nożykom	Dative
dietetyczni	Nominative
przygodę	Accusative
mankietami	Instrumental
ateistę	Accusative
złupili	None
pytałem	None
grożący	None
bruzda	Nominative
blokadami	Instrumental
papużkach	Essive
lekcją	Instrumental
dziewczynami	Instrumental
widoczna	Nominative
aspektem	Instrumental
obserwator	Nominative
stylów	Genitive
wazonem	Instrumental
wujem	Instrumental
skurwysynem	Instrumental
dosłownymi	Instrumental
cudzysłowem	Instrumental
kierach	Essive
bisami	Instrumental
młodsi	Nominative
baniom	Dative
falang	Genitive
zerwała	None
znająca	None
zbiornikowi	Dative
spotami	Instrumental
harujący	None
jamajskimi	Instrumental
zmysłom	Dative
zapłacił	None
wąwozach	Essive
przyjmą	None
stracę	None
przywódco	Vocative
drukowanie	None
samorzutna	Nominative
przygodą	Instrumental
włością	Instrumental
prośbom	Dative
treściach	Essive
zamożna	Nominative
jonizacją	Instrumental
meneli	Genitive
spirodelą	Instrumental
wspominana	None
pocić	None
pułapka	Nominative
chanom	Dative
wskazywałoby	None
metamorficznymi	Instrumental
rowerzysty	Genitive
wyznaczył	None
zabijało	None
dotknęły	None
pamięciach	Essive
czytelniczkach	Essive
słownictwie	Essive
odważni	Nominative
semestrach	Essive
biciem	Instrumental
brzuszkiem	Instrumental
nękasz	None
zakładkach	Essive
dentystą	Instrumental
twórczymi	Instrumental
wybrał	None
dosraliby	None
relikwiarzy	Genitive
węzłem	Instrumental
refrenach	Essive
fotonom	Dative
goła	Nominative
korzystałam	None
pochodzenie	None
pożyczył	None
haczykowi	Dative
socjalistyczni	Nominative
nierównościach	Essive
najsprośniejsi	Nominative
destylację	Accusative
pulpetów	Genitive
produkowałam	None
słucham	None
dziwić	None
sprawdzenie	None
ocenach	Essive
igreków	Genitive
klanami	Instrumental
rybo	Vocative
żałowałbyś	None
utworowi	Dative
monologami	Instrumental
poczekają	None
szuka	None
zapałek	Genitive
znające	None
drukarniami	Instrumental
wspaniała	Nominative
kantatą	Instrumental
podkreślali	None
meczetach	Essive
rozważyłbym	None
marionetka	Nominative
układami	Instrumental
oddziałom	Dative
balustrado	Vocative
dziejąca	None
wrzosami	Instrumental
kiełbiowi	Dative
werando	Vocative
rozsadzałabym	None
duchem	Instrumental
cieląt	Genitive
zachować	None
rad	Genitive
zygotą	Instrumental
lekkimi	Instrumental
narodu	Genitive
biopaliwami	Instrumental
namawiają	None
zwojnic	Genitive
tworzyłyby	None
wskazująca	None
żydem	Instrumental
dżojstikiem	Instrumental
dyniowi	Nominative
niebezpieczeństwu	Dative
pokrywana	None
znają	None
malowidłach	Essive
dziwimy	None
stawiani	None
ucztę	Accusative
rozbieżnościami	Instrumental
modemem	Instrumental
najliczniejsza	Nominative
graniczyła	None
traktowałbym	None
kufli	Genitive
tonęłabym	None
prałatowi	Dative
niepewnymi	Instrumental
ceni	None
zauważyłeś	None
kalinę	Accusative
warci	Nominative
obaliły	None
zwarciem	Instrumental
kropeczka	Nominative
szukaj	None
obalałbyś	None
oblężeniach	Essive
zamachem	Instrumental
marko	Vocative
tolerowani	None
pojęciach	Essive
skrócono	None
ozdobę	Accusative
dystansu	Genitive
deuteru	Genitive
tkankami	Instrumental
kłamanie	None
burząca	None
rozważyła	None
wychowania	Genitive
rewersu	Genitive
płonął	None
lodowcami	Instrumental
bogaczowi	Dative
nanometrów	Genitive
prowizorko	Vocative
skrzydłach	Essive
nurkowałbyś	None
zadajmy	None
zdementowano	None
apetytach	Essive
doprowadzaniem	Instrumental
kipiałybyśmy	None
bransoletą	Instrumental
zerwały	None
kategoria	Nominative
homoseksualna	Nominative
organizmom	Dative
średnicą	Instrumental
bohaterkom	Dative
ignoruje	None
morelami	Instrumental
Macedończykowi	Dative
produkowania	Genitive
zostaw	None
galopuje	None
wybuchają	None
trudami	Instrumental
wesprzeć	None
błoniem	Instrumental
tolerowany	None
apopleksję	Accusative
ulotek	Genitive
wstrząsach	Essive
brzoskwiniowa	Nominative
peptydu	Genitive
testu	Genitive
uprzedziłem	None
przyjmowaliśmy	None
opatom	Dative
najznakomitsi	Nominative
chwilę	Accusative
wersjach	Essive
zdumiewająca	Nominative
włączające	None
górami	Instrumental
trzymane	None
czekałby	None
nawiedzona	Nominative
przyniosły	None
słabościach	Essive
stępa	Genitive
centrach	Essive
fruwałam	None
wyznaniami	Instrumental
męczy	None
wnętrznościach	Essive
błądzono	None
siedzibami	Instrumental
jeżozwierzowi	Dative
podróżnikowi	Dative
pieśniami	Instrumental
zakaże	None
goryczkę	Accusative
pogromami	Instrumental
namiętnościom	Dative
przypominałybyśmy	None
genom	Dative
opowiadałabyś	None
wzgórzach	Essive
kryzysami	Instrumental
minimalna	Nominative
przygotowałem	None
prostopadli	Nominative
sklepów	Genitive
dżelada	Nominative
pytałam	None
psychopatyczna	Nominative
wrzodom	Dative
portów	Genitive
czynnościami	Instrumental
przezimował	None
administrację	Accusative
złapalibyście	None
opiekun	Nominative
skręcić	None
cechowi	Dative
cofając	None
monsunem	Instrumental
oponami	Instrumental
zwrotnicą	Instrumental
patologiami	Instrumental
zbiegające	None
zachodzą	None
intrygą	Instrumental
pręcikom	Dative
pęknij	None
pomarańczach	Essive
znalazłem	None
przelecenie	None
umywalek	Genitive
połykano	None
izoleucyna	Nominative
tarczyca	Nominative
samotni	Nominative
ewentualnymi	Instrumental
lupami	Instrumental
strzykawek	Genitive
spółka	Nominative
dynią	Instrumental
rękopisowi	Dative
wzrostami	Instrumental
przysięgamy	None
przygotujcie	None
mierz	None
wszystka	Nominative
obserwował	None
kapitan	Nominative
poetka	Nominative
kacenjamera	Genitive
uderzyłem	None
tabelom	Dative
dorszem	Instrumental
zwyczajnymi	Instrumental
burd	Genitive
robiliby	None
uczta	Nominative
profesor	Nominative
wiązów	Genitive
pokonani	None
harmonogramów	Genitive
miligramami	Instrumental
kopalniach	Essive
wezmę	None
cnotliwi	Nominative
życzą	None
odwodnieniem	Instrumental
metę	Accusative
skracała	None
gadatliwa	Nominative
zburzono	None
eksperymentów	Genitive
Marsjanin	Nominative
mrozoodporna	Nominative
kolekcjonowaniem	Instrumental
chłodnymi	Instrumental
rozmyślałeś	None
szeregowi	Dative
najemnikom	Dative
pustaków	Genitive
glebami	Instrumental
uncjom	Dative
sumę	Accusative
znalazłaby	None
maska	Nominative
ingerencją	Instrumental
adwersarzem	Instrumental
płetwach	Essive
wyglądałby	None
duża	Nominative
lemur	Nominative
korzystanie	None
zbyła	None
bajko	Vocative
aktuariuszami	Instrumental
prośbą	Instrumental
eksperymentalnymi	Instrumental
dyskusję	Accusative
jasnozielona	Nominative
trwałoby	None
tłumacząc	None
sądowi	Dative
padał	None
uczestniczyłam	None
poważna	Nominative
sprośna	Nominative
sprawdziłbym	None
oddanie	None
kuchenkę	Accusative
hydraulikiem	Instrumental
kasztanowca	Genitive
lustrzanek	Genitive
kokosowi	Nominative
kąsać	None
deklami	Instrumental
grupach	Essive
anionem	Instrumental
spotkane	None
taksówka	Nominative
unicestwienie	None
szwowi	Dative
najsamotniejszymi	Instrumental
aspektom	Dative
septymą	Instrumental
zjełczali	Nominative
tętnicach	Essive
sił	Genitive
obozu	Genitive
szukałyśmy	None
zmian	Genitive
wronach	Essive
wynajmę	None
smokingom	Dative
fioletowawa	Nominative
wystarczałby	None
edyktowi	Dative
padając	None
fazanów	Genitive
podniesieni	None
wkurwiałaby	None
usunąć	None
patykach	Essive
zakażeniem	Instrumental
edytowałabyś	None
nalewa	None
nadzwyczajna	Nominative
ogrodzeniem	Instrumental
grzywkom	Dative
nośników	Genitive
dręczy	None
kominkami	Instrumental
utlenić	None
żywicach	Essive
jmie	None
strukturą	Instrumental
odebrana	None
jawić	None
nalewek	Genitive
rozrywkom	Dative
faktu	Genitive
samobójstwie	Essive
oknie	Essive
pizzo	Vocative
stratę	Accusative
motkom	Dative
grahamowi	Dative
aferą	Instrumental
miodowa	Nominative
chciałem	None
ludźmi	Instrumental
przyjęłam	None
świątyniom	Dative
gwizdałybyśmy	None
poniedziałkami	Instrumental
wyjaśnianiem	Instrumental
kością	Instrumental
pobranie	None
Ukraińcowi	Dative
pożyczono	None
win	Genitive
przyprawia	None
kwietniów	Genitive
posagów	Genitive
trzciną	Instrumental
faulach	Essive
szczoteczka	Nominative
wyświetlałbyś	None
arcydziełami	Instrumental
juma	Nominative
wulkanów	Genitive
filologię	Accusative
najsilniejsi	Nominative
babkach	Essive
grami	Instrumental
rozkładem	Instrumental
biernikami	Instrumental
palmę	Accusative
nieznanymi	Instrumental
składając	None
uranem	Instrumental
perfekcjach	Essive
najtragiczniejsi	Nominative
hrabstwach	Essive
indu	Genitive
tilakom	Dative
sterburtę	Accusative
cytatami	Instrumental
gnam	None
rektorowi	Dative
wyborami	Instrumental
listka	Genitive
wtórna	Nominative
sprawiałoby	None
przemówieniach	Essive
gdakanie	None
wazonami	Instrumental
przypominający	None
drogowskazami	Instrumental
drzemiące	None
numerowałby	None
kuźniami	Instrumental
korzystam	None
tulipanami	Instrumental
borowinę	Accusative
stanowią	None
grzebałby	None
śpieszmy	None
zabić	None
zapaleniami	Instrumental
demagogami	Instrumental
lemoniada	Nominative
wadami	Instrumental
znalazło	None
mknie	None
nosząc	None
bransoleta	Nominative
komentarzem	Instrumental
przyjęta	None
talerzy	Genitive
drapieżnikowi	Dative
kolarz	Nominative
grążela	Genitive
wspomniał	None
przeleciał	None
sernikach	Essive
tilako	Vocative
zaczną	None
skurczami	Instrumental
okupowi	Dative
śnieżkami	Instrumental
zegarkiem	Instrumental
oszukując	None
komód	Genitive
dochodzące	None
gospodarzowi	Dative
pocenie	None
dwunastnica	Nominative
schowaj	None
dziewczynkę	Accusative
uwielbiająca	None
pionowi	Nominative
wygrał	None
doceniałaby	None
postradano	None
duszono	None
ołówków	Genitive
rowerom	Dative
śpieszą	None
polaczkach	Essive
kusi	None
implozją	Instrumental
rozmywacie	None
żywic	Genitive
fryzurach	Essive
paw	Nominative
ptaszek	Nominative
odkrytymi	Instrumental
zaimportowałyśmy	None
zainteresowaniach	Essive
muchomorem	Instrumental
przeprowadzkę	Accusative
kostkę	Accusative
Amerykanką	Instrumental
głębszymi	Instrumental
mis	Genitive
ideałom	Dative
ambasadorkom	Dative
eksperymentalna	Nominative
gotycka	Nominative
burdach	Essive
warunkiem	Instrumental
etapowi	Dative
polecałbym	None
ograniczają	None
studiowała	None
podziwiane	None
fotkach	Essive
morałów	Genitive
rasistkach	Essive
alkinowi	Dative
bażantowi	Dative
pojmowali	None
kręć	None
makio	Vocative
ułamka	Genitive
dwuwargowa	Nominative
cateringami	Instrumental
bambusowa	Nominative
miesiącach	Essive
debiutami	Instrumental
notowało	None
bojaźniach	Essive
brytyjska	Nominative
mikroskopach	Essive
pojmowaliście	None
skarpetom	Dative
maliną	Instrumental
prześcieradle	Essive
biurwą	Instrumental
nieżonaci	Nominative
koreańskimi	Instrumental
szpieg	Nominative
bezkształtna	Nominative
lansowany	None
lojalko	Vocative
pijawkę	Accusative
kupka	Nominative
żurawiną	Instrumental
kompilować	None
żądamy	None
pioruna	Genitive
chlorków	Genitive
daktylowców	Genitive
niespodzianko	Vocative
tępa	Nominative
ratę	Accusative
uczestniczyły	None
dwuręczna	Nominative
gnić	None
ratowałam	None
osiedli	Genitive
wytryskiwałyśmy	None
wschodziliście	None
relacją	Instrumental
alegorią	Instrumental
piórnikach	Essive
trolejbusem	Instrumental
absorbowany	None
jesiennymi	Instrumental
drukowali	None
gospodach	Essive
planowano	None
gramofonach	Essive
wolniejszymi	Instrumental
antysemicka	Nominative
kupowali	None
jemiołach	Essive
socho	Vocative
obciążał	None
ginąłeś	None
strażakach	Essive
numeru	Genitive
wiatrom	Dative
siostrzenicą	Instrumental
rajtuzom	Dative
wierzy	None
napisałem	None
zabiłam	None
szyb	Genitive
oborach	Essive
sylab	Genitive
siedzibę	Accusative
terminom	Dative
teściowym	Dative
dolą	Instrumental
koszykiem	Instrumental
twarogowi	Dative
krynicach	Essive
car	Nominative
owadami	Instrumental
bekom	Dative
usunęli	None
włókien	Genitive
humoru	Genitive
przekonaniach	Essive
wiesiołka	Genitive
szóstka	Nominative
fragmentach	Essive
rozstajów	Genitive
Amerykaninem	Instrumental
borowikami	Instrumental
suszarkę	Accusative
uciekaj	None
cytatach	Essive
fioletów	Genitive
ćwiczą	None
normą	Instrumental
wylanie	None
serc	Genitive
dotyka	None
meteorolog	Nominative
Czeszek	Genitive
wymagany	None
żartują	None
przypominano	None
dudach	Essive
splądrowały	None
pieniężna	Nominative
umarła	None
kwaternionowi	Dative
zawodnikach	Essive
chronologiami	Instrumental
przegrana	None
leniwcom	Dative
atrakcyjnymi	Instrumental
uważa	None
brokułach	Essive
rytmami	Instrumental
krążowników	Genitive
polkami	Instrumental
obywatelstwem	Instrumental
czołgom	Dative
dupczyłbym	None
stroma	Nominative
marzy	None
ćwiczeni	None
toyot	Genitive
zwyczajom	Dative
kompiluje	None
pomp	Genitive
łzą	Instrumental
muza	Nominative
odmianach	Essive
ładowarek	Genitive
filaru	Genitive
dowodzimy	None
przedostatnia	Nominative
dbać	None
polska	Nominative
językoznawcom	Dative
trzmiel	Nominative
emir	Nominative
przynosiliśmy	None
szklankami	Instrumental
kaktusami	Instrumental
używająca	None
prawiczek	Nominative
nadużywający	None
kawiarnię	Accusative
przeziębieniem	Instrumental
epizodami	Instrumental
łagwiami	Instrumental
obciąża	None
melonika	Genitive
wierzono	None
bangla	None
namawiając	None
powodziach	Essive
schronieniem	Instrumental
murów	Genitive
straciliśmy	None
wystarcza	None
pnączami	Instrumental
finalista	Nominative
kolcowi	Dative
bandytę	Accusative
nurtów	Genitive
ortodoksyjni	Nominative
jeleń	Nominative
brzoskwinia	Nominative
obrzędów	Genitive
humusu	Genitive
rozmawiając	None
okazu	Genitive
obrabujcie	None
oślimi	Instrumental
plułyby	None
rozproszyła	None
umówiłabym	None
ocaliło	None
kardiologiczna	Nominative
wymagali	None
szabatów	Genitive
księżniczkę	Accusative
napisach	Essive
omamu	Genitive
ćwiczy	None
szablonami	Instrumental
uczęszczając	None
sznurami	Instrumental
krainom	Dative
robimy	None
bólowi	Dative
metrów	Genitive
tragediami	Instrumental
dodawać	None
podłogę	Accusative
potrzebowali	None
szantażował	None
pogrzebało	None
przekomarzały	None
esejem	Instrumental
ojczyzną	Instrumental
zaprosili	None
zbiegały	None
odbudowała	None
blazonowaniami	Instrumental
wspominające	None
żywicom	Dative
kłusowali	None
łamali	None
myślami	Instrumental
pleszczotka	Nominative
wymyślę	None
śruba	Nominative
bumerangowi	Dative
grupom	Dative
zjedzono	None
klasami	Instrumental
słyszymy	None
zmieni	None
mazgajom	Dative
długopisu	Genitive
wystarczałyśmy	None
zapominania	Genitive
pumo	Vocative
hutami	Instrumental
jął	None
domów	Genitive
odpowiadał	None
Czeszkach	Essive
andyjska	Nominative
zabawę	Accusative
kradziono	None
wyznaczona	None
mruczę	None
umowach	Essive
suszeni	None
pozycję	Accusative
posiada	None
kocowi	Dative
ukośnika	Genitive
właśni	Nominative
pamiętałem	None
odwzajemniła	None
lubiący	None
ośmiokątów	Genitive
rekin	Nominative
agatów	Genitive
zamknąłem	None
złapani	None
eposami	Instrumental
pojmuję	None
rozwiązał	None
egzaminował	None
bohaterkach	Essive
matkami	Instrumental
antropologicznymi	Instrumental
łat	Genitive
pytając	None
gitarami	Instrumental
uczelnią	Instrumental
mapom	Dative
ciec	None
pośmiertna	Nominative
polania	Genitive
najrozsądniejsza	Nominative
fregatom	Dative
gagauskimi	Instrumental
zwrotnikiem	Instrumental
zamówień	Genitive
próżnymi	Instrumental
brygami	Instrumental
narządach	Essive
truciznom	Dative
znikają	None
obiecywała	None
grobowi	Dative
optykach	Essive
stygną	None
cena	Nominative
otrzymania	Genitive
plansz	Genitive
kniaziem	Instrumental
glista	Nominative
powiek	Genitive
czarnowidztwem	Instrumental
występujący	None
karmił	None
otrzymałby	None
pretorowi	Dative
całować	None
nieukowi	Dative
pandemię	Accusative
podpierdolmy	None
jeżdżący	None
homoseksualnymi	Instrumental
wolą	Instrumental
sztandarach	Essive
maków	Genitive
dowodzić	None
kuchnią	Instrumental
panach	Essive
refrenów	Genitive
godzinach	Essive
bieguna	Genitive
bohaterach	Essive
stropami	Instrumental
stertach	Essive
dochodzący	None
spódnicami	Instrumental
swobodna	Nominative
ogonami	Instrumental
dupereli	Genitive
dachowcami	Instrumental
drżę	None
całkowita	Nominative
płazem	Instrumental
szpadli	Genitive
spodziewało	None
dietetyczna	Nominative
podróżuję	None
kontenerów	Genitive
zakładania	Genitive
poliestrów	Genitive
paznokcia	Genitive
niepodlegli	Nominative
kryjący	None
twierdzące	None
sosowi	Dative
egoisty	Genitive
studiująca	None
paniach	Essive
wybieraj	None
wyjąc	None
machali	None
cewa	Nominative
wylało	None
synonimów	Genitive
zenitowi	Dative
przeżyłaś	None
sanitariuszom	Dative
ambasadach	Essive
usterka	Nominative
drągów	Genitive
hemoliza	Nominative
biedroneczko	Vocative
tektoniką	Instrumental
gleba	Nominative
szantażujmy	None
traktował	None
tronem	Instrumental
kolcach	Essive
fabuła	Nominative
zmysłem	Instrumental
artystą	Instrumental
kobył	Genitive
pacjentkom	Dative
krzesłach	Essive
obserwowane	None
cudzoziemcowi	Dative
czarownicą	Instrumental
szarogęsimy	None
DJ-owi	Dative
odpływów	Genitive
oddany	None
nalewkach	Essive
wąchałyście	None
kolęda	Nominative
mikroorganizmach	Essive
obelga	Nominative
japońska	Nominative
kąpielami	Instrumental
biszkoptom	Dative
snookerami	Instrumental
atrakcyjna	Nominative
dokonywali	None
korzystaliśmy	None
ruszamy	None
znając	None
eposu	Genitive
klimatyzacja	Nominative
proporców	Genitive
pornografią	Instrumental
olch	Genitive
zaczynano	None
razach	Essive
kręgosłupach	Essive
kraśni	Nominative
funktorów	Genitive
najpowszechniejsza	Nominative
ciężarna	Nominative
kupowałyśmy	None
edytowaliby	None
socjologia	Nominative
województw	Genitive
praworęcznymi	Instrumental
eufemizmem	Instrumental
erratami	Instrumental
opuszczany	None
owcę	Accusative
dostarczają	None
spodziewamy	None
chcielibyśmy	None
szyframi	Instrumental
łódkę	Accusative
dereni	Genitive
pożarom	Dative
liczydłem	Instrumental
zwycięzcom	Dative
złamią	None
łechtaczką	Instrumental
dwuznakach	Essive
miechowi	Dative
soczewek	Genitive
zebra	Nominative
podróżach	Essive
historykowi	Dative
wychowaniem	Instrumental
astrologom	Dative
dramatom	Dative
grzebiące	None
planowana	None
śnili	None
odda	None
wytryskiwałem	None
komediami	Instrumental
feministyczna	Nominative
potęgę	Accusative
anachronizmów	Genitive
zmieniona	None
parkingom	Dative
potęg	Genitive
skazana	None
nokautami	Instrumental
Greczynkę	Accusative
egranizacjo	Vocative
założycielowi	Dative
skrzelami	Instrumental
wykorzystujesz	None
słoneczna	Nominative
rekordowi	Dative
kradnij	None
płaczecie	None
taksówkę	Accusative
elementów	Genitive
skorupach	Essive
pogrzebalibyście	None
płotem	Instrumental
płótnami	Instrumental
spektroskopach	Essive
trzonowców	Genitive
ukrywające	None
kwiatem	Instrumental
uwiedź	None
hadisom	Dative
mastektomią	Instrumental
skłotowi	Dative
septyma	Nominative
karetę	Accusative
zakonom	Dative
polecać	None
Hiszpanka	Nominative
komun	Genitive
wielościanu	Genitive
cała	Nominative
uznające	None
remisami	Instrumental
zbiegowi	Dative
cytował	None
konserwach	Essive
warcabów	Genitive
kastrował	None
zapaleń	Genitive
roszpunek	Genitive
kursów	Genitive
lewica	Nominative
węzła	Genitive
krwawiące	None
śmierdziałbyś	None
okresach	Essive
szkiców	Genitive
obronach	Essive
laikom	Dative
igrała	None
deskach	Essive
sowa	Nominative
frywolna	Nominative
sterowcach	Essive
replikach	Essive
Arabka	Nominative
przepisom	Dative
flamingiem	Instrumental
rozbite	None
osłach	Essive
wibratorowi	Dative
szelką	Instrumental
helisom	Dative
rojem	Instrumental
albańska	Nominative
małp	Genitive
zwojami	Instrumental
katarska	Nominative
Etruskom	Dative
rektor	Nominative
ubawów	Genitive
krótkofalówkę	Accusative
zdrad	Genitive
batutą	Instrumental
dowiedziałbyś	None
dostarczałabym	None
chloranu	Genitive
posiadać	None
rasę	Accusative
stawanie	None
znosili	None
brawurę	Instrumental
furo	Vocative
łapiemy	None
wybuchać	None
śloza	Nominative
zniszczą	None
potencjału	Genitive
trzymaniem	Instrumental
grzywka	Nominative
dworca	Genitive
ściągnięte	None
obrzękiem	Instrumental
wielorybów	Genitive
konstytucjami	Instrumental
stawiają	None
wnuczkiem	Instrumental
palaczkę	Accusative
wirom	Dative
szarogęsiłyśmy	None
aureolom	Dative
dzieleniom	Dative
kradnie	None
symfoniach	Essive
kultów	Genitive
marnowałam	None
myśliwemu	Dative
łaźcie	None
laryngolog	Nominative
typowymi	Instrumental
dwukropka	Genitive
świątyniami	Instrumental
kontroluję	None
sławojka	Nominative
obserwowani	None
sztyletom	Dative
stolikowi	Dative
upustami	Instrumental
bezokoliczników	Genitive
rudami	Instrumental
oceniały	None
zachowałem	None
skarbami	Instrumental
szczegółom	Dative
łazienkę	Accusative
zrozumieli	None
futrami	Instrumental
naprawiano	None
przewodem	Instrumental
przesmyków	Genitive
pojawiłby	None
prusaków	Genitive
Dunka	Nominative
wafli	Genitive
pomyłkę	Accusative
atmosfera	Nominative
robotnik	Nominative
chartami	Instrumental
wierzyłem	None
orkiestra	Nominative
podróżowanie	None
turzycach	Essive
opisują	None
amatorszczyznę	Accusative
prosiakowi	Dative
wymyślili	None
ciągnikiem	Instrumental
trąbkami	Instrumental
biurowa	Nominative
tle	Essive
krzemowymi	Instrumental
chwilowymi	Instrumental
propozycją	Instrumental
maszynami	Instrumental
siekiera	Nominative
radząc	None
kamerzysty	Genitive
grzbietowi	Dative
poseł	Nominative
weganizmu	Genitive
zaświatach	Essive
relacjom	Dative
przekładami	Instrumental
powtarzający	None
węgła	Genitive
nomadom	Dative
hałasu	Genitive
sukniach	Essive
zaczynanie	None
promocję	Accusative
biernika	Genitive
kompaktowymi	Instrumental
doprowadzało	None
kurzem	Instrumental
dokładni	Nominative
bywam	None
akordeonem	Instrumental
docenianie	None
graniastosłupach	Essive
baryłek	Genitive
pokrywa	None
piekarzami	Instrumental
palą	None
tajemnicom	Dative
minuto	Vocative
półfinałom	Dative
wychodnemu	Dative
dinozaur	Nominative
organizacjom	Dative
komedię	Accusative
strzech	Genitive
użytkownikami	Instrumental
drobiazgami	Instrumental
praktykach	Essive
drodzy	Nominative
bullę	Accusative
duma	Nominative
edytowanie	None
gonił	None
Chorwatami	Instrumental
makrelom	Dative
idolom	Dative
staramy	None
kontach	Essive
oddawała	None
farbę	Accusative
ścierniskach	Essive
kopertę	Accusative
zakładałybyście	None
stadom	Dative
oglądając	None
kaskadę	Accusative
taflą	Instrumental
kiełbasami	Instrumental
odpoczywali	None
rodzicom	Dative
polecała	None
bezprzewodowymi	Instrumental
modemu	Genitive
ścisła	Nominative
uderzona	None
porodu	Genitive
piżmakowi	Dative
wymianami	Instrumental
bólów	Genitive
dosięgnąć	None
żyjesz	None
berberyjscy	Nominative
łodygą	Instrumental
japońskimi	Instrumental
wyżłach	Essive
grafu	Genitive
roślinożerca	Nominative
ujebałby	None
napraw	Genitive
kowalami	Instrumental
oliwą	Instrumental
wirami	Instrumental
gorzejący	None
imponować	None
zmartwychwstaniom	Dative
skaczący	None
stracono	None
pluskwa	Nominative
pytający	None
waltornią	Instrumental
żyliby	None
litrami	Instrumental
rozwijajcie	None
kochajmy	None
roślinożercom	Dative
tonsuro	Vocative
sodomita	Nominative
jemiołę	Accusative
wytłumaczono	None
aspektami	Instrumental
karafką	Instrumental
pokonano	None
błonami	Instrumental
pustułek	Genitive
godziną	Instrumental
pastor	Nominative
kart	Genitive
atomami	Instrumental
temperaturami	Instrumental
rozróżni	None
orzechowa	Nominative
iniekcjom	Dative
kosztów	Genitive
wymyślałam	None
tancerzach	Essive
logopedio	Vocative
podróżowały	None
powolnymi	Instrumental
dochodzę	None
kulturystami	Instrumental
dworach	Essive
padaczko	Vocative
promami	Instrumental
saksofonista	Nominative
rozproszone	None
zabijemy	None
kopalń	Genitive
bankructwem	Instrumental
poliglota	Nominative
więdnijmy	None
posłucha	None
akweduktami	Instrumental
rycz	None
kapeluszami	Instrumental
gankom	Dative
zapalniczek	Genitive
kłódką	Instrumental
minaretów	Genitive
słynął	None
aminokwasem	Instrumental
burdelom	Dative
kuś	None
kwestionując	None
spodenkami	Instrumental
narodów	Genitive
kuroniówko	Vocative
niedziel	Genitive
elektrolitem	Instrumental
pozoru	Genitive
laserów	Genitive
kamieni	Genitive
hrywna	Nominative
padaczkowymi	Instrumental
podnosząc	None
kalifornu	Genitive
zrabował	None
pomysłach	Essive
lokomotywę	Accusative
dostawałem	None
kuźniom	Dative
postępem	Instrumental
arcybiskupowi	Dative
bywalcach	Essive
anilina	Nominative
Marsjaninowi	Dative
osadach	Essive
mandatami	Instrumental
najzamożniejsi	Nominative
potencjalni	Nominative
kajmanom	Dative
jednokładnościom	Dative
mara	Nominative
kongresu	Genitive
wdowa	Nominative
bratowym	Dative
irydu	Genitive
zdementowało	None
masowca	Genitive
ogonków	Genitive
fabrykę	Accusative
bluzami	Instrumental
zawarł	None
kradniesz	None
kija	Genitive
instytutów	Genitive
pinda	Nominative
jasnoszarymi	Instrumental
życzysz	None
autentycznymi	Instrumental
kapitalistyczni	Nominative
formalnymi	Instrumental
dzwonkami	Instrumental
pensją	Instrumental
biskupom	Dative
waflach	Essive
kredytu	Genitive
kutia	Nominative
konduktor	Nominative
anoda	Nominative
działałaś	None
liberio	Vocative
substancją	Instrumental
gwiezdna	Nominative
likaonów	Genitive
dyplomatom	Dative
karygodna	Nominative
szachistę	Accusative
najebkach	Essive
dzierżylibyśmy	None
potencjałowi	Dative
Rosjaninem	Instrumental
insurekcjami	Instrumental
blachach	Essive
gazowymi	Instrumental
czarodziejach	Essive
dojrzenie	None
czółnem	Instrumental
płonący	None
metropolito	Vocative
owcą	Instrumental
trenowi	Dative
uprawami	Instrumental
rabanem	Instrumental
korzystające	None
nukleonów	Genitive
puszczono	None
przyjaźniejsi	Nominative
krótsza	Nominative
pochodzę	None
szyję	Accusative
ogarniający	None
igrekach	Essive
rekonstrukcja	Nominative
tuńczykom	Dative
wizerunków	Genitive
komunach	Essive
jednorożec	Nominative
tirówek	Genitive
naćpani	Nominative
przyjęci	None
fałszerstwie	Essive
rozgwiazd	Genitive
ichtiopatologio	Vocative
fazą	Instrumental
antropologiczni	Nominative
bokom	Dative
ściernisk	Genitive
kieszonkowcem	Instrumental
norm	Genitive
dyktaturę	Accusative
arsenianami	Instrumental
konstruktywizmem	Instrumental
karetkę	Accusative
trapezach	Essive
legendami	Instrumental
mula	Nominative
trzonach	Essive
oglądały	None
ostrzegałabym	None
oskarżałyście	None
cennika	Genitive
stawiali	None
pindę	Accusative
wersów	Genitive
pnączach	Essive
dedykuje	None
złotówkach	Essive
widziała	None
zapomnij	None
katolickimi	Instrumental
starczymi	Instrumental
podlewać	None
placach	Essive
satrapiom	Dative
Niemiec	Nominative
powiatowi	Dative
wyborcę	Accusative
włączacie	None
robiły	None
doktoratu	Genitive
sylwester	Nominative
ladą	Instrumental
korporację	Accusative
analfabety	Genitive
rajdowcem	Instrumental
tatusiach	Essive
wianie	Essive
zmiano	Vocative
szczwołowi	Dative
zapraszani	None
najintymniejsza	Nominative
muszla	Nominative
jeździły	None
przymiotem	Instrumental
autobusów	Genitive
grzywnami	Instrumental
rzeczywiści	Nominative
królikarnią	Instrumental
Wietnamczykach	Essive
busami	Instrumental
widnokręgów	Genitive
awangardą	Instrumental
nowoczesnymi	Instrumental
zainsynuowałam	None
szachistą	Instrumental
chabetami	Instrumental
cytowali	None
szpitala	Genitive
maskowano	None
migbłystalna	Nominative
kwietniem	Instrumental
przeciwobrazem	Instrumental
popełniła	None
cząbrami	Instrumental
chirurgicznymi	Instrumental
gromadzące	None
substancjom	Dative
mumiach	Essive
atropiną	Instrumental
bakteriach	Essive
wskazywali	None
guglałyście	None
pojawiły	None
teoria	Nominative
trzustka	Nominative
oglądalibyśmy	None
Albańczykami	Instrumental
kierowanie	None
fiordów	Genitive
pociągiem	Instrumental
dziękowała	None
mintajem	Instrumental
prewencją	Instrumental
dokładnymi	Instrumental
potocznymi	Instrumental
wyżłów	Genitive
pediatra	Nominative
interesowi	Dative
przesmykami	Instrumental
śpiworów	Genitive
ślubów	Genitive
srałabyś	None
deweloper	Nominative
zaruchaliby	None
klawiaturami	Instrumental
otaczasz	None
aromatami	Instrumental
kopiący	None
modliszkach	Essive
awanturnikowi	Dative
jednobarwni	Nominative
drożdżowa	Nominative
zarabiająca	None
orgazmach	Essive
szeroka	Nominative
truciznę	Accusative
pośladkach	Essive
teatralni	Nominative
kaskader	Nominative
pomyjom	Dative
słonina	Nominative
ula	Genitive
banknotu	Genitive
grożenie	None
umawianie	None
szpara	Nominative
dodała	None
rysikom	Dative
przyimkach	Essive
rytmom	Dative
ryżowa	Nominative
włosom	Dative
głowic	Genitive
kłopotach	Essive
kartograficzna	Nominative
zabijając	None
medytacjami	Instrumental
przyjmę	None
Włoszkę	Accusative
zabawkami	Instrumental
lizał	None
wrzodów	Genitive
lata	None
antonimu	Genitive
twierdzimy	None
kaczek	Genitive
hamburger	Nominative
kupione	None
boksów	Genitive
umrzyj	None
oślinę	Accusative
przyimka	Genitive
armato	Vocative
pokazywałaś	None
ukryła	None
obrabowałaś	None
połączyły	None
słabi	Nominative
lubicie	None
rozwiążę	None
krowom	Dative
śrubokrętu	Genitive
starali	None
biskupach	Essive
barków	Genitive
warszawianin	Nominative
ulew	Genitive
zamachowcom	Dative
krasy	Genitive
pytasz	None
ewangeliarzy	Genitive
złocie	Essive
halerz	Nominative
dowodziły	None
autentyczni	Nominative
poznana	None
przepraszałyśmy	None
mieszać	None
przyrodnicza	Nominative
zapłaciła	None
dżdżownica	Nominative
paszę	Accusative
głuptak	Nominative
przyniesiony	None
bekach	Essive
kwaternionów	Genitive
wojnach	Essive
złotówko	Vocative
nepalscy	Nominative
sypał	None
rafach	Essive
banalna	Nominative
haśle	Essive
księstwami	Instrumental
kwazarami	Instrumental
wygrają	None
wstawanie	None
kranu	Genitive
koniugację	Accusative
mankietem	Instrumental
lotniskami	Instrumental
wspólnotom	Dative
rozmyślisz	None
puszka	Nominative
jasnymi	Instrumental
archaniołów	Genitive
filologią	Instrumental
kozę	Accusative
uzda	Nominative
dopełniaczowi	Dative
skacz	None
lesbę	Accusative
tubą	Instrumental
deklowi	Dative
Polakiem	Instrumental
rejestrowi	Dative
stadionami	Instrumental
objawów	Genitive
stopom	Dative
konserwacją	Instrumental
sfałszowanie	None
łapom	Dative
koleżanko	Vocative
tworzymy	None
odradzałyście	None
erbem	Instrumental
przeprosić	None
szklaneczkom	Dative
absolutni	Nominative
dzielnikami	Instrumental
twierdziłem	None
trzymajmy	None
gnałoby	None
kronikarzem	Instrumental
kochający	None
zmieniajcie	None
wędrowała	None
warszawianka	Nominative
powtarzać	None
malarkami	Instrumental
dodane	None
chanowi	Dative
rozkazowi	Dative
telenowelą	Instrumental
deltoidów	Genitive
doprowadzano	None
pokazało	None
wymógłby	None
brokułowa	Nominative
winogronie	Essive
obejmując	None
radzenie	None
strachów	Genitive
obrażę	None
goździk	Nominative
łokciem	Instrumental
zamachami	Instrumental
grabią	None
sytuacjo	Vocative
lemingami	Instrumental
poprawiłbyś	None
wzorowi	Dative
korundu	Genitive
nadzorowani	None
znaczył	None
studiowanie	None
wiosłujecie	None
podnosi	None
ciąża	Nominative
dokonywałbyś	None
pępkowi	Dative
winnicami	Instrumental
złupiła	None
astronauta	Nominative
różniczkę	Accusative
wspólnotą	Instrumental
przypadkowymi	Instrumental
czekoladą	Instrumental
upiorem	Instrumental
biegają	None
wrzosowiskach	Essive
bibliografią	Instrumental
szalenie	None
pylnika	Genitive
fok	Genitive
nieprawda	Nominative
cytowane	None
audycjom	Dative
żądane	None
wyjebałabyś	None
kontenera	Genitive
cechę	Accusative
noży	Genitive
ptakom	Dative
śpieszyłaś	None
kwaśna	Nominative
ograniczający	None
wyjaśniany	None
ciężarówką	Instrumental
horyzontów	Genitive
apelacjo	Vocative
urocza	Nominative
cygarami	Instrumental
zimnymi	Instrumental
prorokom	Dative
dostające	None
brzoskwinią	Instrumental
replikami	Instrumental
renegatem	Instrumental
czerniaków	Genitive
lipą	Instrumental
abdykacjach	Essive
składająca	None
kebs	Nominative
czekajcie	None
kawalerko	Vocative
zachciankę	Accusative
nośmy	None
korzystał	None
stawiałoby	None
palma	Nominative
znalazłeś	None
kurę	Accusative
lampartów	Genitive
męką	Instrumental
gwałcicielek	Genitive
lotniskach	Essive
leszczyną	Instrumental
kolekcjonowała	None
armeńscy	Nominative
półkami	Instrumental
grzechom	Dative
gęgałaś	None
jąkały	None
zapaliłby	None
identyfikowałeś	None
broniła	None
okoniom	Dative
komet	Genitive
uczęszczało	None
towarach	Essive
miękkimi	Instrumental
żabkach	Essive
sałata	Nominative
czekałabym	None
mądrymi	Instrumental
podchodząc	None
filmowania	Genitive
rozgwiazdo	Vocative
administratorek	Genitive
zaprowadziłoby	None
czytane	None
kłosów	Genitive
biegaliśmy	None
występuję	None
czytająca	None
bronione	None
startowi	Dative
odbytu	Genitive
wampir	Nominative
obrażali	None
kuzynem	Instrumental
zniszczeń	Genitive
szachownicę	Accusative
okresom	Dative
energiami	Instrumental
niszczmy	None
wywołał	None
kręcimy	None
wystawach	Essive
płynęło	None
wyznaniem	Instrumental
kartograficznymi	Instrumental
biegunkami	Instrumental
obejmowali	None
kantonach	Essive
kontrolom	Dative
tunelem	Instrumental
płaczące	None
kręciłyśmy	None
opiekowaniem	Instrumental
przekomarza	None
populistach	Essive
skowronek	Nominative
wiosłom	Dative
flecisty	Genitive
płonęła	None
perfumerio	Vocative
piłkach	Essive
ezoterycznymi	Instrumental
zatrzyma	None
lipcach	Essive
znaczyć	None
polecają	None
biednymi	Instrumental
demonach	Essive
raciborska	Nominative
fartuchami	Instrumental
deszczom	Dative
stypendiach	Essive
zbierany	None
wierzycielowi	Dative
prała	None
talonami	Instrumental
patynach	Essive
enzymów	Genitive
odkrywała	None
dawcą	Instrumental
ikonom	Dative
pancerzy	Genitive
ruszać	None
modlił	None
występowałby	None
polom	Dative
antykiem	Instrumental
przestrzegano	None
wydawnictwach	Essive
urodzili	None
tonęły	None
strat	Genitive
smutałyście	None
grzechowi	Dative
ruszone	None
alternatywnymi	Instrumental
połączyłaby	None
cynę	Accusative
radziecka	Nominative
naukowcami	Instrumental
nauka	Nominative
zaczynacie	None
wskazujący	None
rybka	Nominative
pustelnikiem	Instrumental
szklanka	Nominative
karmników	Genitive
Bułgarkami	Instrumental
wskazywałaś	None
kaszanko	Vocative
oszukiwał	None
szczegółowa	Nominative
leśna	Nominative
zbiegało	None
oblężeniem	Instrumental
łaźnia	Nominative
feministycznymi	Instrumental
zebrom	Dative
drgający	None
kimałybyśmy	None
realistami	Instrumental
radośni	Nominative
dodatków	Genitive
archipelagem	Instrumental
wyłączać	None
myli	None
mleczek	Genitive
górnolotnymi	Instrumental
temperaturom	Dative
przewagami	Instrumental
przeszkoda	Nominative
ośląt	Genitive
zerżnięta	None
kokainą	Instrumental
dżemom	Dative
kultowi	Dative
kongresów	Genitive
palona	None
modlitw	Genitive
gabinetom	Dative
przeglądach	Essive
żałobami	Instrumental
dłużnikowi	Dative
oceniałem	None
protektoratu	Genitive
ścianą	Instrumental
którakolwiek	Nominative
zabijałabyś	None
dzid	Genitive
szampanem	Instrumental
procom	Dative
śnić	None
czarownicami	Instrumental
wojnami	Instrumental
solipsyzmowi	Dative
podróbka	Nominative
złożyłaś	None
pobrana	None
płaszczkach	Essive
kurtkom	Dative
życzymy	None
jaspisów	Genitive
atrakcyjni	Nominative
materiałach	Essive
koniugacja	Nominative
przerwą	Instrumental
łąkach	Essive
pobożnymi	Instrumental
pesymistka	Nominative
kaczyzmem	Instrumental
ruszy	None
biografiami	Instrumental
stanowiła	None
kodeinę	Accusative
grosza	Genitive
miejsc	Genitive
tuńczyk	Nominative
zdementuje	None
buforów	Genitive
siedzeniem	Instrumental
katastrof	Genitive
zakochana	Nominative
potwierdzić	None
jawiły	None
przyjaciółek	Genitive
zapłaci	None
płakały	None
krzemowa	Nominative
kładą	None
odmienni	Nominative
wiedźmą	Instrumental
alegoria	Nominative
potomkom	Dative
medytacjom	Dative
rozproszono	None
naparstnicami	Instrumental
pierdołami	Instrumental
rajdowiec	Nominative
parzydełkowcach	Essive
wycieczkę	Accusative
iberyjska	Nominative
perscy	Nominative
budzona	None
budżetówko	Vocative
milimetra	Genitive
melodio	Vocative
istotom	Dative
hostelach	Essive
uznawane	None
lądowań	Genitive
dyrektorach	Essive
dzwonem	Instrumental
sójka	Nominative
Chinkach	Essive
diecezjami	Instrumental
osiowa	Nominative
węglanami	Instrumental
centem	Instrumental
schnij	None
podgrupami	Instrumental
kotła	Genitive
ksyloza	Nominative
dewota	Nominative
organistą	Instrumental
fanatyczką	Instrumental
pożytkiem	Instrumental
pewników	Genitive
tomem	Instrumental
pędzili	None
kawonów	Genitive
biznesów	Genitive
żołądków	Genitive
nadgarstkach	Essive
sympatiami	Instrumental
mróweczkami	Instrumental
rzeźba	Nominative
gaśnico	Vocative
zaimportowawszy	None
broicie	None
usuwa	None
rzeźbiarkę	Accusative
płynach	Essive
pokonamy	None
północnokoreańskimi	Instrumental
śnieżką	Instrumental
estońscy	Nominative
szpitali	Genitive
nowotworem	Instrumental
adwersarzom	Dative
zrozumiałam	None
niszcząca	None
podnosił	None
wpływają	None
komunistyczna	Nominative
wymówka	Nominative
nieprawdom	Dative
uśpię	None
magazynierem	Instrumental
akademiach	Essive
kangurami	Instrumental
potwierdziło	None
immunologia	Nominative
kantach	Essive
podkreślany	None
zakonnicom	Dative
jastrzębiach	Essive
pomnikowi	Dative
wozach	Essive
pędzą	None
kaszę	Accusative
goniła	None
diablica	Nominative
wizerunkami	Instrumental
tyłach	Essive
kurhanowi	Dative
tłumaczeniami	Instrumental
cedziły	None
czwórkami	Instrumental
uprzedzeniom	Dative
mazgajowi	Dative
esemesujcie	None
niezbędni	Nominative
przyprawiałem	None
fruktozę	Accusative
środowiskach	Essive
czaplami	Instrumental
sałatek	Genitive
dyskusja	Nominative
zastanawiam	None
sprawiające	None
fasad	Genitive
zestawiony	None
dopływów	Genitive
pianinie	Essive
szafkami	Instrumental
zakładała	None
sławo	Vocative
izomorfizmu	Genitive
poznałbym	None
różdżkę	Accusative
lampami	Instrumental
zauważmy	None
podstawowymi	Instrumental
sałatka	Nominative
kowalem	Instrumental
abstynencją	Instrumental
wyrzuciły	None
skrzydle	Essive
szukamy	None
prestiżowi	Nominative
spojrzeniom	Dative
wizjom	Dative
koza	Nominative
odkryłem	None
usuńcie	None
balistach	Essive
szynę	Accusative
przesadza	None
szachistkami	Instrumental
pytałeś	None
ogłowiem	Instrumental
wstęgą	Instrumental
wąchałabym	None
zakonnikiem	Instrumental
bakteria	Nominative
bakiem	Instrumental
półfinalistką	Instrumental
popołudniami	Instrumental
kurhanu	Genitive
brudzi	None
modo	Vocative
dosięgnęły	None
wertykalnymi	Instrumental
lizanie	None
wybrańcom	Dative
telewizorach	Essive
podejrzewały	None
myszko	Vocative
kopać	None
skakanka	Nominative
zauważyłam	None
rozbije	None
bełtałyście	None
personifikacjami	Instrumental
topografowi	Dative
ciekliście	None
ekspertom	Dative
abdykacja	Nominative
życzyliby	None
upuszczony	None
szafeczek	Genitive
funkcjonariuszom	Dative
uderzą	None
zakazany	None
szanowane	None
skibą	Instrumental
ogromowi	Dative
przyjęty	None
ochro	Vocative
wylać	None
mylenie	None
Baskach	Essive
szczotka	Nominative
suko	Vocative
robiący	None
klik	Genitive
szkodzisz	None
obciążany	None
bywa	None
wujowi	Dative
uczciwymi	Instrumental
bruzdę	Accusative
ratrakom	Dative
mieszkaliśmy	None
cząstkom	Dative
brzuszka	Genitive
magnetofonów	Genitive
chałw	Genitive
szprycha	Nominative
elementarnymi	Instrumental
znałby	None
warstwom	Dative
województwem	Instrumental
papug	Genitive
epizodem	Instrumental
kazaniom	Dative
fiołkiem	Instrumental
porozmawiano	None
garażem	Instrumental
dyplomów	Genitive
potężniejsza	Nominative
starająca	None
przeprowadzanie	None
dbanie	None
neologizmu	Genitive
kiełbasa	Nominative
konsekwencję	Accusative
szarogęsiliście	None
konduktorom	Dative
pachną	None
półkach	Essive
zaryzykuje	None
październikowa	Nominative
afrodyzjakach	Essive
konserwantem	Instrumental
tabliczkami	Instrumental
kaukascy	Nominative
fajką	Instrumental
absorbując	None
Arabom	Dative
porcelanowa	Nominative
zdiagnozował	None
komuna	Nominative
pożreć	None
czekolada	Nominative
dobyłyśmy	None
opowiadaliby	None
medytować	None
biesiadą	Instrumental
przedmiotu	Genitive
kręgami	Instrumental
kalką	Instrumental
podstawą	Instrumental
stolikami	Instrumental
dawek	Genitive
odebrałem	None
schowały	None
ratowano	None
sklepach	Essive
pianę	Accusative
pierdząca	None
położeniem	Instrumental
arsenianem	Instrumental
reumatyzmem	Instrumental
sprawiali	None
trwałby	None
wyrządziła	None
pirsu	Genitive
bankrutowałaś	None
pól	Genitive
potwierdziłby	None
masa	Nominative
jedyneczkach	Essive
napisz	None
cieście	Essive
setą	Instrumental
usuwana	None
szczwołem	Instrumental
magazynu	Genitive
szpaków	Genitive
przeprowadzane	None
szczęśliwa	Nominative
przelecę	None
albami	Instrumental
nurtowi	Dative
założycielom	Dative
kucają	None
knota	Genitive
pokazał	None
podróżami	Instrumental
planetą	Instrumental
dostarczał	None
proponowano	None
filozoficzni	Nominative
chlorkiem	Instrumental
sprawdzianu	Genitive
masturbacjach	Essive
ostrowu	Genitive
ejakulacjom	Dative
krzyczeli	None
opowiadamy	None
tostami	Instrumental
wilczymi	Instrumental
krzyczące	None
imionami	Instrumental
jałmużna	Nominative
Brytyjczyk	Nominative
radzieckimi	Instrumental
Wietnamczyk	Nominative
radę	Accusative
sosów	Genitive
produkowali	None
tańczono	None
wydupczyłyby	None
jagnięca	Nominative
najliczniejsi	Nominative
wektorom	Dative
kratę	Accusative
stepów	Genitive
solna	Nominative
budzilibyśmy	None
sęp	Nominative
koteczków	Genitive
strzelało	None
zebrami	Instrumental
zabijała	None
gościńców	Genitive
bulwę	Accusative
zgubiona	None
zawałem	Instrumental
plansza	Nominative
sprężyn	Genitive
otrzymujemy	None
hazardach	Essive
kawek	Genitive
filarów	Genitive
usuwali	None
dźwigiem	Instrumental
czeska	Nominative
pszczelarstwie	Essive
sprawdźcie	None
mieczem	Instrumental
skrzydełkami	Instrumental
liczebnika	Genitive
dziennikarzami	Instrumental
batonika	Genitive
blokach	Essive
wymusicie	None
mnichami	Instrumental
obrazów	Genitive
antropologach	Essive
loteriach	Essive
zderzakach	Essive
nagrywarkach	Essive
poznasz	None
przypomnijmy	None
karaluchem	Instrumental
enklawa	Nominative
ściągam	None
zagonów	Genitive
pachniesz	None
chorwaccy	Nominative
Fenicjanek	Genitive
śmigłowcach	Essive
kornetowi	Dative
fortepianu	Genitive
węchem	Instrumental
dowodzi	None
żarłokami	Instrumental
wołała	None
nakryty	None
dyspalatalizację	Accusative
pobrała	None
cieśnin	Genitive
migdałach	Essive
kociołkowi	Dative
kładziemy	None
autostopowi	Dative
czerpaków	Genitive
kreatywni	Nominative
obiektu	Genitive
miejska	Nominative
sfora	Nominative
klucza	Genitive
kryte	None
potrzebni	Nominative
strzępami	Instrumental
używać	None
amperomierzach	Essive
budów	Genitive
finałami	Instrumental
wystawa	Nominative
masochistami	Instrumental
zdobiła	None
przedsionkach	Essive
przypuścili	None
szklankę	Accusative
podniosłabym	None
legalna	Nominative
języczków	Genitive
kopał	None
gardle	Essive
zarezerwował	None
komunistę	Accusative
zrabowana	None
wyłączał	None
czernica	Nominative
cienia	Genitive
mieszkaniem	Instrumental
szpitalem	Instrumental
ściągnie	None
rozumniejsi	Nominative
fryzurą	Instrumental
papieros	Nominative
poprawiałbyś	None
walut	Genitive
goląc	None
zaniechałem	None
plecakami	Instrumental
beza	Nominative
monadą	Instrumental
skrzatem	Instrumental
najbogatsza	Nominative
ciepłymi	Instrumental
znasz	None
łykiem	Instrumental
jonów	Genitive
oddawalibyśmy	None
kopiuje	None
rządzony	None
schorzeniem	Instrumental
znakomitszymi	Instrumental
botanikiem	Instrumental
zmienił	None
zostawiliśmy	None
alkoholikom	Dative
bakach	Essive
kupką	Instrumental
celownikach	Essive
słyńmy	None
programach	Essive
ignorujący	None
szariatu	Genitive
kłód	Genitive
bojaliście	None
konwalijka	Nominative
szastać	None
strzelali	None
kredką	Instrumental
egzosferami	Instrumental
schował	None
hierarcha	Nominative
pozwala	None
pejoratywna	Nominative
zadziąsłowa	Nominative
jelicie	Essive
ogromami	Instrumental
zmienieni	None
rozwiążmy	None
kąsaliśmy	None
twarzą	Instrumental
rufą	Instrumental
krain	Genitive
żyj	None
wyrzucił	None
bezczelna	Nominative
pastorowi	Dative
spragniona	Nominative
obrączek	Genitive
Czeszkami	Instrumental
brylantowa	Nominative
pat	Nominative
zdolna	Nominative
czerpała	None
reniferowi	Dative
pobrały	None
dziewczynach	Essive
ułamkach	Essive
najneutralniejsi	Nominative
montażystko	Vocative
kawałami	Instrumental
umarli	None
gepardów	Genitive
tancerzom	Dative
przeszkadzam	None
banglające	None
zamykasz	None
germańscy	Nominative
zemsta	Nominative
budzący	None
kuchniami	Instrumental
plebaniach	Essive
gitarach	Essive
pełnię	Accusative
drągami	Instrumental
ketonami	Instrumental
szczęśliwymi	Instrumental
przywódcach	Essive
prozę	Accusative
rubinu	Genitive
grzeszą	None
Kanadyjczykowi	Dative
kodeksach	Essive
koncie	Essive
teczek	Genitive
kalwinistom	Dative
lonża	Nominative
czekać	None
żuchwę	Accusative
ciastkami	Instrumental
rubel	Nominative
Irlandkę	Accusative
kalafiorów	Genitive
pułkownikom	Dative
rabinem	Instrumental
brewiarzem	Instrumental
kibicować	None
resztom	Dative
pędom	Dative
benzenu	Genitive
przeszkadzali	None
dręczące	None
żądające	None
idiomach	Essive
anarchosyndykalizmu	Genitive
mordowałoby	None
halibutów	Genitive
policjantach	Essive
obeliskami	Instrumental
łakniesz	None
cholew	Genitive
cedrowa	Nominative
granatowców	Genitive
odach	Essive
wojeryzmowi	Dative
znalezione	None
medytując	None
tensorowa	Nominative
pesymisty	Genitive
rysiach	Essive
krawcom	Dative
warszawę	Accusative
lewicą	Instrumental
buzia	Nominative
pluszowa	Nominative
dzielnicom	Dative
dokonujesz	None
wdychające	None
żałosna	Nominative
siło	Vocative
świerszcz	Nominative
orzeczeniom	Dative
powiekach	Essive
supermarketów	Genitive
płac	Genitive
imprezach	Essive
bestią	Instrumental
garnizonowi	Dative
partyzantkę	Accusative
duszący	None
mierzmy	None
choinkami	Instrumental
kulturą	Instrumental
alkaloidowi	Dative
ćwierćdolarówkami	Instrumental
ratujący	None
biografię	Accusative
uciekałam	None
poczekałbym	None
stawu	Genitive
kaszlakowi	Dative
ornatu	Genitive
sądź	None
miską	Instrumental
rozważają	None
jazzowa	Nominative
wódką	Instrumental
suszyła	None
latarniowcowi	Dative
uli	Genitive
dwójek	Genitive
włączałoby	None
odraczalibyście	None
wierzbownica	Nominative
dotykany	None
rekonstrukcję	Accusative
tajemnicę	Accusative
zwrotką	Instrumental
swetrach	Essive
zwyciężała	None
nieporządkami	Instrumental
rzekłem	None
tuzina	Genitive
lnic	Genitive
podajmy	None
zięć	Nominative
demokratę	Accusative
tajgą	Instrumental
najemnik	Nominative
wioseł	Genitive
kikutom	Dative
samba	Nominative
pisane	None
pierdzielibyście	None
przysięgała	None
rogom	Dative
splądrowałabyś	None
herbicydu	Genitive
cipom	Dative
wisiałoby	None
kajasz	None
rozstępu	Genitive
feministek	Genitive
przeinaczyłaby	None
wymagać	None
bywałem	None
kaczką	Instrumental
prezentacja	Nominative
schorzeń	Genitive
pszczołami	Instrumental
łyżką	Instrumental
histydynę	Accusative
tancerka	Nominative
przelecieliby	None
winom	Dative
dechę	Accusative
persymonami	Instrumental
sikałaby	None
ćma	Nominative
sympatia	Nominative
traktowaliśmy	None
owadożerna	Nominative
modach	Essive
ignoruj	None
płynami	Instrumental
statysty	Genitive
monogamio	Vocative
mimozom	Dative
strażnikiem	Instrumental
gnicie	None
radiologię	Accusative
poprawiłoby	None
dowie	None
pastorami	Instrumental
kameleon	Nominative
przyjmować	None
scenariuszy	Genitive
moralni	Nominative
wykresami	Instrumental
ostatnimi	Instrumental
podejrzewałbym	None
agregatom	Dative
iguanom	Dative
sera	Genitive
kucharzem	Instrumental
narkotyków	Genitive
pachę	Accusative
dereniami	Instrumental
głębokimi	Instrumental
chłodna	Nominative
czeladnikiem	Instrumental
darom	Dative
piżmaczków	Genitive
wydziałom	Dative
ciekawymi	Instrumental
więcierza	Genitive
produkował	None
potokowi	Dative
swastyka	Nominative
parówka	Nominative
gustami	Instrumental
zweryfikowało	None
zakałami	Instrumental
wyjaśniliśmy	None
oceniające	None
bryłą	Instrumental
drażniła	None
zatrzymawszy	None
kajakach	Essive
wyczynom	Dative
widnokręgach	Essive
architektom	Dative
łosiem	Instrumental
widziałoby	None
kontynentalna	Nominative
wspomnień	Genitive
kokornaka	Genitive
usuwał	None
komentowaniem	Instrumental
dowiemy	None
korzystałaś	None
zamówili	None
stawała	None
umowę	Accusative
najgęstsi	Nominative
kryły	None
przekłamaniom	Dative
komunistycznymi	Instrumental
otworzyłbyś	None
sufitach	Essive
katalogom	Dative
kosi	None
denaturatem	Instrumental
łudzono	None
lazłaś	None
estetyczna	Nominative
kontynentów	Genitive
desenia	Genitive
ucieczkach	Essive
wspominający	None
wskazywałem	None
wdepnijmy	None
olejami	Instrumental
bandzior	Nominative
manganu	Genitive
matek	Genitive
kijanka	Nominative
maszynach	Essive
rodzinami	Instrumental
imponujmy	None
półprzewodnikiem	Instrumental
treoninę	Accusative
eksklawa	Nominative
buteleczka	Nominative
chemiczna	Nominative
konarami	Instrumental
stojanów	Genitive
galernikach	Essive
fretek	Genitive
pozytonach	Essive
żywicami	Instrumental
abonentom	Dative
raną	Instrumental
piętkę	Accusative
silnikach	Essive
Chińczykom	Dative
uderzyła	None
wyjęte	None
fotografem	Instrumental
radiolokacją	Instrumental
prawidłem	Instrumental
jeżowa	Nominative
religijna	Nominative
zeznaniem	Instrumental
kłóciłyśmy	None
pytamy	None
eksportuje	None
homoseksualistom	Dative
jęłoby	None
markizami	Instrumental
reizmem	Instrumental
wracasz	None
przeprowadzana	None
siana	None
firmach	Essive
ustawek	Genitive
monoteizmu	Genitive
obrzęknie	None
rodzajami	Instrumental
rydzów	Genitive
żaluzjami	Instrumental
słuchanie	None
aniołami	Instrumental
zmieniłaby	None
widnokręgiem	Instrumental
żukiem	Instrumental
korpusowi	Dative
eteru	Genitive
bankami	Instrumental
fajniejsi	Nominative
zamordowany	None
chirurgowi	Dative
zimna	Nominative
lokomotywami	Instrumental
koteczkami	Instrumental
syrenę	Accusative
zwrotkom	Dative
polują	None
lansowana	None
księżyca	Genitive
hipotezami	Instrumental
uważano	None
własnościom	Dative
chodu	Genitive
ciemnoczerwona	Nominative
pytonów	Genitive
rozwijali	None
liszaja	Genitive
gonienie	None
strontu	Genitive
pylonami	Instrumental
pacha	Nominative
lojalką	Instrumental
borowymi	Instrumental
portretem	Instrumental
rybom	Dative
obrzęknęlibyśmy	None
wolnymi	Instrumental
szynszylach	Essive
sprawa	Nominative
majsterkować	None
wanną	Instrumental
tenisistkę	Accusative
papieru	Genitive
planszę	Accusative
szpilką	Instrumental
oddajesz	None
miotach	Essive
łączkę	Accusative
optymizmem	Instrumental
fanatyczkom	Dative
zguba	Nominative
piekarkami	Instrumental
kręgiem	Instrumental
szyba	Nominative
indowi	Dative
zaprzeczyły	None
kreatorem	Instrumental
grzybieniem	Instrumental
żydowscy	Nominative
skorupkami	Instrumental
wołali	None
znajdowałby	None
czyszczona	None
otrzymali	None
kopiowanie	None
mango	Vocative
opisach	Essive
pestkach	Essive
cofać	None
wielokątami	Instrumental
patologiom	Dative
pamiętające	None
pachnijcie	None
doktorowi	Dative
szpar	Genitive
unio	Vocative
sukienek	Genitive
odlewu	Genitive
eksportowało	None
racicami	Instrumental
fiołkom	Dative
tygodnia	Genitive
pytań	Genitive
zwrotek	Genitive
nosiłam	None
pozwalałby	None
uzasadnieniem	Instrumental
ciemiernikom	Dative
wiecom	Dative
autostopu	Genitive
oglądamy	None
proepidemikom	Dative
liceom	Dative
homoseksualistę	Accusative
sprawdził	None
marca	Genitive
sumów	Genitive
fotelowi	Dative
mieszkający	None
kapusta	Nominative
przeżytkiem	Instrumental
getrach	Essive
bezdzietni	Nominative
mazowieccy	Nominative
szczelin	Genitive
zoologia	Nominative
przekrojowi	Dative
gaś	None
wsparli	None
egzaminujący	None
ślubowi	Dative
dziewczętami	Instrumental
przegrałabyś	None
opowieścią	Instrumental
siecią	Instrumental
otworzy	None
nieumarłymi	Instrumental
szafkach	Essive
kulonem	Instrumental
sforę	Accusative
odchodzące	None
dbał	None
mianowników	Genitive
refując	None
podpisów	Genitive
wyprowadzeń	Genitive
stolików	Genitive
psychosomatyczna	Nominative
klinami	Instrumental
napierdalasz	None
komentując	None
basiorów	Genitive
przedmówca	Nominative
turbinami	Instrumental
zmywarką	Instrumental
strzałko	Vocative
kanonizację	Accusative
rotorem	Instrumental
piżamo	Vocative
wojskowymi	Instrumental
popełnili	None
Fenicjanko	Vocative
wybierali	None
wygrałeś	None
cłom	Dative
kac	Nominative
podchodzę	None
pannom	Dative
elitą	Instrumental
oskarżałoby	None
śmiejąca	None
kijów	Genitive
uciekalibyśmy	None
aukcjami	Instrumental
lgnięcie	None
linczem	Instrumental
basom	Dative
ukryć	None
cywilizacja	Nominative
zostawicie	None
katastrofą	Instrumental
lipcami	Instrumental
oddałybyśmy	None
łapali	None
śmiechom	Dative
przedsiębiorcami	Instrumental
fatwę	Accusative
kręgach	Essive
otrzymująca	None
worków	Genitive
wierzył	None
ślimakiem	Instrumental
czajnikom	Dative
staraliśmy	None
pogrzebem	Instrumental
ratowałoby	None
Palestyńczykach	Essive
nadziejom	Dative
lemniskato	Vocative
pląsał	None
posłuchaniem	Instrumental
huśtawkę	Accusative
kłuło	None
słabościami	Instrumental
doceniano	None
hipoteką	Instrumental
skracałoby	None
epizodach	Essive
aktorkami	Instrumental
kaptura	Genitive
mylić	None
rybami	Instrumental
pobrany	None
kolbami	Instrumental
dżokerowi	Dative
zmarłemu	Dative
bramkarzem	Instrumental
nacjonalistyczni	Nominative
dywizów	Genitive
poproś	None
sówka	Nominative
układom	Dative
okupu	Genitive
wędką	Instrumental
narciarstwem	Instrumental
sprzyjałaś	None
pałach	Essive
szanta	Nominative
analizowany	None
głębsza	Nominative
bramo	Vocative
ruszcie	None
lotniskiem	Instrumental
kościelni	Nominative
stanowiłaby	None
butików	Genitive
zakazano	None
świecę	Accusative
zawiodłyby	None
makijażowi	Dative
spadałabym	None
Żydówko	Vocative
grobach	Essive
przynosiła	None
mańkut	Nominative
spotkałem	None
radioizotopami	Instrumental
mandarynko	Vocative
trapezem	Instrumental
jebnięta	None
jajecznica	Nominative
wyrządzono	None
poznaliśmy	None
spróbujesz	None
pługiem	Instrumental
kutafonami	Instrumental
osiągnięciom	Dative
pogadajmy	None
jeżyk	Nominative
szczurowi	Dative
stadionem	Instrumental
modrzewia	Genitive
zakłada	None
różnicą	Instrumental
zadana	None
śliwką	Instrumental
pochówkom	Dative
chrześniakiem	Instrumental
tłumaczyłeś	None
uprawiane	None
graniastosłupów	Genitive
romboedru	Genitive
grzybkach	Essive
społeczeństw	Genitive
dziennikarz	Nominative
spódnicach	Essive
rozważmy	None
siarczynu	Genitive
kopą	Instrumental
woskówka	Nominative
lagun	Genitive
wyżynach	Essive
liczebnikami	Instrumental
surrealistą	Instrumental
przyjęliśmy	None
działali	None
szklarniami	Instrumental
okrutni	Nominative
Słowianka	Nominative
ekspertowi	Dative
kreskówkę	Accusative
jarzębami	Instrumental
goliłyby	None
obserwujące	None
ostróżek	Genitive
wpływały	None
fobiom	Dative
dawane	None
rozważaniami	Instrumental
szaleństwie	Essive
aramejskimi	Instrumental
podstawom	Dative
ciałem	Instrumental
ćwiczono	None
liścia	Genitive
całunów	Genitive
topazem	Instrumental
hamowały	None
monoteizmem	Instrumental
uderzyłyśmy	None
cenili	None
gumami	Instrumental
pieniądzem	Instrumental
ukrywałoby	None
brązowa	Nominative
żołądkowi	Dative
nieładem	Instrumental
pałaców	Genitive
wróżkami	Instrumental
łapiecie	None
nigeryjskimi	Instrumental
wstęgami	Instrumental
poprawiałabyś	None
oddadzą	None
wyniosłaby	None
konfliktu	Genitive
hałasów	Genitive
mieszkacie	None
śpiewałybyście	None
podrywająca	None
pomagamy	None
angolska	Nominative
mierziłabyś	None
kwartałów	Genitive
parkiem	Instrumental
pomiarami	Instrumental
dżinnom	Dative
klaksonami	Instrumental
enklawą	Instrumental
podkowa	Nominative
ślepota	Nominative
cieńszymi	Instrumental
zbir	Nominative
dowodów	Genitive
artykulację	Accusative
nurkować	None
listopadom	Dative
kompilatorów	Genitive
opróżnili	None
symulacjach	Essive
oddychanie	None
blokowiskom	Dative
trzymani	None
literówka	Nominative
zastanawiałyśmy	None
huśtawka	Nominative
radiowi	Nominative
zabijające	None
przyprawiałby	None
wędrowcze	Vocative
fasada	Nominative
umawiali	None
tosterom	Dative
radami	Instrumental
dzierżenie	None
deweloperami	Instrumental
oddziałami	Instrumental
asteryzmu	Genitive
złapałeś	None
skutkiem	Instrumental
joypadami	Instrumental
kartę	Accusative
jałówek	Genitive
nazisty	Genitive
łożyskach	Essive
połączy	None
długom	Dative
laleczka	Nominative
modlące	None
głosami	Instrumental
biletach	Essive
złamać	None
piosenkarzom	Dative
grozach	Essive
czytały	None
kukułek	Genitive
zimować	None
dzwonami	Instrumental
Koreańczykiem	Instrumental
zadymę	Accusative
kosmonauty	Genitive
budowniczymi	Instrumental
nosowa	Nominative
komórkach	Essive
rybozo	Vocative
pisankę	Accusative
milcz	None
wzięta	None
wieczorami	Instrumental
zweryfikuję	None
bandę	Accusative
awanturnikiem	Instrumental
orędziach	Essive
gruszyczką	Instrumental
znaleziony	None
Islandczykiem	Instrumental
dająca	None
kawalerkach	Essive
zadam	None
cienka	Nominative
kredytami	Instrumental
zestawić	None
złożeń	Genitive
antropologiem	Instrumental
siarczanem	Instrumental
zagrodami	Instrumental
tarasach	Essive
karoserię	Accusative
wyrzuciłeś	None
agresor	Nominative
momentach	Essive
rogów	Genitive
dożyli	None
znały	None
stolicami	Instrumental
ubekach	Essive
odkrywają	None
rozczarowali	None
myjemy	None
podkówkom	Dative
czarniejszymi	Instrumental
sadu	Genitive
skończą	None
bibliografio	Vocative
grafiką	Instrumental
kapusiach	Essive
dokonamy	None
obsesyjna	Nominative
płetw	Genitive
odnawialna	Nominative
zieje	None
ostrowami	Instrumental
zakazały	None
zbiegają	None
legendą	Instrumental
fruwać	None
depilatorami	Instrumental
zabójstwie	Essive
rabatowi	Dative
czytelnością	Instrumental
sprawiają	None
kuratorem	Instrumental
płozą	Instrumental
portalom	Dative
wymóż	None
milczą	None
mitom	Dative
siemensa	Genitive
ospo	Vocative
wędrująca	None
prezentacjach	Essive
ślimacznicą	Instrumental
platanami	Instrumental
przytulniejsza	Nominative
oszukuje	None
cętkami	Instrumental
biczami	Instrumental
sprawdzimy	None
stosunkiem	Instrumental
tytoniem	Instrumental
trutni	Genitive
kalwinistami	Instrumental
słomką	Instrumental
parzydełkowców	Genitive
koenzymu	Genitive
bawi	None
cnotliwa	Nominative
uchwytu	Genitive
woskownicami	Instrumental
warszawiakach	Essive
unicestwieni	None
behawioryzmu	Genitive
smrodowi	Dative
jodłę	Accusative
wymówić	None
prędkościomierzach	Essive
gębom	Dative
doceniam	None
manifestami	Instrumental
kupują	None
piramidę	Accusative
atlasach	Essive
wykrwawił	None
gepard	Nominative
sierpnia	Genitive
najbystrzejsza	Nominative
aksjomatach	Essive
iloczynów	Genitive
kontrolowane	None
zagonem	Instrumental
masażem	Instrumental
bykami	Instrumental
puszczali	None
nietoperz	Nominative
kwiatostanu	Genitive
smakowała	None
krwawią	None
wymuszono	None
chłodów	Genitive
jeziorach	Essive
lansowałybyście	None
otruto	None
zacznę	None
dozorów	Genitive
składało	None
wiernością	Instrumental
wyjaśniłoby	None
patriarchom	Dative
umięśniona	Nominative
zeruje	None
powstaniami	Instrumental
parkować	None
wysiądziemy	None
wspomnieniem	Instrumental
śpieszyła	None
sefardyjska	Nominative
zgromadzeniach	Essive
zawarłaś	None
wymiarom	Dative
wądołem	Instrumental
kaszubscy	Nominative
grzęzłaby	None
pożyczkach	Essive
oczkami	Instrumental
rubidowi	Dative
radź	None
olchom	Dative
barbarzyńca	Nominative
maratonu	Genitive
dziewek	Genitive
szkieletach	Essive
pozwalała	None
zagięłam	None
śląscy	Nominative
umierający	None
hojniejszymi	Instrumental
pluszowymi	Instrumental
przesiekę	Accusative
reportażom	Dative
jaśni	Nominative
nękać	None
poprawieni	None
mazgajach	Essive
gęsta	Nominative
guzikami	Instrumental
najzwyklejszymi	Instrumental
zbiorem	Instrumental
słoneczni	Nominative
kapitulacjach	Essive
parterach	Essive
włodarz	Nominative
pralinę	Accusative
pękł	None
śmieciarek	Genitive
aberracjo	Vocative
klimatów	Genitive
spiąć	None
pożyczką	Instrumental
wiewiórkami	Instrumental
żaglach	Essive
boczkach	Essive
szantami	Instrumental
przeżyły	None
wywołaj	None
halibut	Nominative
starać	None
chciwi	Nominative
słoniom	Dative
kwotom	Dative
biurze	Essive
dziedzinom	Dative
ściennymi	Instrumental
rzutu	Genitive
pontyfikatach	Essive
wczasom	Dative
gadajcie	None
republikom	Dative
wydm	Genitive
główka	Nominative
ojczym	Nominative
przeciwwag	Genitive
głupszymi	Instrumental
wyrażeniem	Instrumental
wymyśliło	None
kierowały	None
tokiem	Instrumental
pasożytami	Instrumental
pielgrzymkami	Instrumental
małpowałaby	None
obgadałybyście	None
kuroniówkach	Essive
miesiączkowymi	Instrumental
periodykiem	Instrumental
zjebów	Genitive
wziąć	None
parowu	Genitive
lesbach	Essive
resztę	Accusative
dzwonów	Genitive
dermatologiczna	Nominative
dźwigające	None
wymian	Genitive
kikuta	Genitive
cle	Essive
jaskinia	Nominative
śpiewajmy	None
znaczeniem	Instrumental
kropidłu	Dative
strzałę	Accusative
gil	Nominative
rezultatowi	Dative
zwierciadłach	Essive
rażąc	None
starcach	Essive
Sejmem	Instrumental
gepardach	Essive
szczupła	Nominative
żyroskopów	Genitive
metalurgię	Accusative
policzalni	Nominative
wodoszczelni	Nominative
wspominamy	None
tworzeni	None
jadali	None
sowę	Accusative
orzeł	Nominative
naszyjników	Genitive
arę	Accusative
cybernetyko	Vocative
stylem	Instrumental
kalumniami	Instrumental
tkankom	Dative
pielęgniarzami	Instrumental
wyłączający	None
ogrodami	Instrumental
poczwarka	Nominative
trzymali	None
pomiarowi	Dative
staję	None
piesków	Genitive
wiewiórek	Genitive
rodowi	Dative
więdnięcie	None
wywołała	None
rozmawiano	None
undekanów	Genitive
amatorszczyzną	Instrumental
instytutami	Instrumental
batatów	Genitive
piszemy	None
leczone	None
telefonów	Genitive
odrzucona	None
iłach	Essive
zerżnął	None
chabet	Genitive
jelitem	Instrumental
kwiliłyby	None
amerykowi	Dative
biesiad	Genitive
opactwem	Instrumental
okapów	Genitive
zniknęli	None
straganów	Genitive
fizjonomią	Instrumental
fatwom	Dative
kotką	Instrumental
lotami	Instrumental
lobeliom	Dative
atakowałem	None
spróbowałem	None
kurdyjscy	Nominative
wierz	None
zarucha	None
zerwali	None
żurom	Dative
podróżujący	None
nadużywa	None
żułaś	None
duszami	Instrumental
ojcowiznach	Essive
zauważyły	None
kniahinią	Instrumental
brzydka	Nominative
sezonu	Genitive
opowiadałabym	None
oddają	None
tyrozyna	Nominative
organizmów	Genitive
łazienkom	Dative
łapiący	None
orzecznika	Genitive
dziewicach	Essive
argininę	Accusative
powstaniom	Dative
zdrajczynią	Instrumental
drzazg	Genitive
wykorzystywały	None
wymogli	None
feto	Vocative
podpowiedzią	Instrumental
masochizmem	Instrumental
kurator	Nominative
sypali	None
robocizna	Nominative
lotkach	Essive
biologiem	Instrumental
żurami	Instrumental
dniami	Instrumental
dowodziłoby	None
gluonom	Dative
poważniejszymi	Instrumental
Murzynom	Dative
dystrybucjonizmu	Genitive
ratownikom	Dative
kaplica	Nominative
łódkach	Essive
symulacją	Instrumental
dochodziło	None
przeszkadzało	None
samogonom	Dative
pralką	Instrumental
kulturę	Accusative
bezlitosna	Nominative
piorą	None
rurach	Essive
podałbym	None
urzędnikami	Instrumental
poetach	Essive
identyfikujecie	None
płciami	Instrumental
blokadę	Accusative
kokoszkę	Accusative
ławeczką	Instrumental
połączyli	None
potrzebą	Instrumental
rzemieślnikiem	Instrumental
należelibyście	None
omanu	Genitive
bijekcja	Nominative
kretów	Genitive
potrawa	Nominative
czerwcami	Instrumental
obrusem	Instrumental
słoniną	Instrumental
kupował	None
kołnierzem	Instrumental
replik	Genitive
owcom	Dative
jucho	Vocative
teściom	Dative
sprawdzajcie	None
suszycie	None
kotom	Dative
posiadam	None
połknięta	None
kusicielami	Instrumental
znaleziona	None
bilach	Essive
plotkować	None
burzami	Instrumental
wymiarami	Instrumental
zrabowano	None
dzidę	Accusative
rocznicami	Instrumental
anakondą	Instrumental
rzuciłem	None
akwariów	Genitive
położną	Accusative
operacja	Nominative
dosięgnęła	None
florencka	Nominative
ostateczna	Nominative
krwawiliśmy	None
skronią	Instrumental
ekipach	Essive
motyko	Vocative
opróżniłam	None
pijani	Nominative
atlasów	Genitive
pocztach	Essive
trwająca	None
życząc	None
trędowatemu	Dative
obrazisz	None
przeprowadzałbym	None
zachowały	None
chciał	None
słuchawko	Vocative
marszałkowi	Dative
czyściłyby	None
deszczówkami	Instrumental
slipach	Essive
ciekawszymi	Instrumental
zainsynuowałoby	None
wygnaniec	Nominative
kapryśna	Nominative
suszone	None
obrazić	None
oszustami	Instrumental
lecząca	None
szkół	Genitive
męskozwierzęca	Nominative
błotnikami	Instrumental
stonoga	Nominative
korpusów	Genitive
lwia	Nominative
aktywistkami	Instrumental
wystarczająca	Nominative
obżarstwa	Genitive
gminach	Essive
etymologicznymi	Instrumental
papierków	Genitive
deszczy	Genitive
Irlandczykami	Instrumental
zachowany	None
azyli	Genitive
kłująca	None
platynowa	Nominative
dworkami	Instrumental
usterkę	Accusative
szczupak	Nominative
najbrutalniejszymi	Instrumental
chłopczykiem	Instrumental
armeńska	Nominative
babkami	Instrumental
schizm	Genitive
faradowi	Dative
doceniani	None
niedźwiedź	Nominative
drobiazgach	Essive
tytułów	Genitive
prawna	Nominative
oddam	None
półkula	Nominative
małpom	Dative
pokazano	None
źródłom	Dative
kibicuję	None
stopniach	Essive
potomkowi	Dative
mąkę	Accusative
zmieniasz	None
żyłach	Essive
styczniom	Dative
pokazu	Genitive
ośmiokątami	Instrumental
rysikowi	Dative
bośniaccy	Nominative
automatami	Instrumental
kosarz	Nominative
cenić	None
Indianka	Nominative
niszczony	None
napierdalali	None
ostrzegały	None
zakładałby	None
szczeliną	Instrumental
pomnikom	Dative
arnika	Nominative
systemowi	Dative
poprawnymi	Instrumental
szafkom	Dative
organisty	Genitive
sądzi	None
szakalowi	Dative
warszawą	Instrumental
przestrzegaj	None
znał	None
wanadowi	Dative
księstew	Genitive
czyniący	None
ramienia	Genitive
starcom	Dative
wyznacznikiem	Instrumental
esejach	Essive
przydomka	Genitive
smarkalibyście	None
kładła	None
paszczach	Essive
schizmę	Accusative
zabójstwem	Instrumental
truskawek	Genitive
sekretarką	Instrumental
cierniem	Instrumental
nawach	Essive
dolar	Nominative
korytem	Instrumental
niemieccy	Nominative
dostarczano	None
napierdalankami	Instrumental
wyłudza	None
kaja	None
ostrzejsi	Nominative
wieńca	Genitive
gonią	None
kioskiem	Instrumental
gwiazdozbiorem	Instrumental
gadanie	None
szkutnik	Nominative
odpowiadająca	None
włączało	None
polecali	None
karafkami	Instrumental
podadzą	None
powtarzalibyście	None
konkretnymi	Instrumental
gluonem	Instrumental
złupienie	None
zachowaliśmy	None
nurkujący	None
kartkach	Essive
selenocysteinę	Accusative
niebiańska	Nominative
paradygmatach	Essive
brzydal	Nominative
rozbijesz	None
fazę	Accusative
ulewami	Instrumental
konkurujecie	None
banitę	Accusative
wypadkami	Instrumental
profesom	Dative
kwarców	Genitive
buziakiem	Instrumental
odkryto	None
ambulansu	Genitive
zabiłem	None
Rosjanka	Nominative
drukowało	None
bezsenni	Nominative
toaleta	Nominative
poprosiłeś	None
kapkami	Instrumental
całujący	None
sterczyłyby	None
paniom	Dative
otrzymałeś	None
graficznymi	Instrumental
generałach	Essive
figura	Nominative
desek	Genitive
łódzcy	Nominative
nazwach	Essive
upuszczenie	None
scyzoryka	Genitive
ekspedientka	Nominative
igrzysk	Genitive
górni	Nominative
rozwiązały	None
komentowałem	None
wrześniowymi	Instrumental
wiktowi	Dative
eksportowi	Dative
urządzeń	Genitive
jagodach	Essive
internisty	Genitive
paliły	None
najemcach	Essive
atmosfer	Genitive
kwestionujemy	None
narzekało	None
palmami	Instrumental
slawisty	Genitive
ładowarka	Nominative
opowiadali	None
bażant	Nominative
pogrzebami	Instrumental
głównymi	Instrumental
kichalibyście	None
ruczajach	Essive
gówniarz	Nominative
uczciwsza	Nominative
alfa	Nominative
poiłybyście	None
metaforą	Instrumental
głośnikiem	Instrumental
kurhanach	Essive
smokingiem	Instrumental
obrzędami	Instrumental
waha	None
muzyczni	Nominative
aptek	Genitive
zachodami	Instrumental
prekognicję	Accusative
nazista	Nominative
legend	Genitive
lwiątek	Genitive
szukałem	None
gruczołach	Essive
szczelino	Vocative
skróci	None
antycząstek	Genitive
radiobusolę	Accusative
przejrzystymi	Instrumental
rób	None
dachówek	Genitive
sława	Nominative
filozofem	Instrumental
plotka	Nominative
bluszczy	Genitive
pyłach	Essive
wielościanem	Instrumental
omamów	Genitive
hokeisty	Genitive
geografem	Instrumental
wsiach	Essive
kreską	Instrumental
geodetę	Accusative
strzecha	Nominative
podnieśli	None
dostarczająca	None
laktonami	Instrumental
futrze	Essive
dowodami	Instrumental
kłócę	None
muszlę	Accusative
olszowymi	Instrumental
bodu	Genitive
dyskietkę	Accusative
kawonowi	Dative
procesach	Essive
nalewania	Genitive
uczyłyby	None
metropolity	Genitive
trzonowcami	Instrumental
arystokratom	Dative
brzuchach	Essive
kanią	Instrumental
trąciłaby	None
porażeniach	Essive
słuchana	None
zapamiętano	None
dedykujcie	None
łaziłyście	None
otrzymywana	None
akcjonariuszowi	Dative
wynajęło	None
nastawiłabyś	None
socjalistyczna	Nominative
praelementem	Instrumental
zebranie	None
ogromach	Essive
lalką	Instrumental
nowościach	Essive
skamieniałościom	Dative
głosowaliby	None
żarówka	Nominative
repozytoriów	Genitive
podbiału	Genitive
połączona	None
skargo	Vocative
dziennikach	Essive
wydawnictwom	Dative
żałobę	Accusative
środkiem	Instrumental
jezior	Genitive
zakładowi	Dative
deskami	Instrumental
plemienna	Nominative
kuleczką	Instrumental
fiutowi	Dative
przepiło	None
markizach	Essive
usuniecie	None
echem	Instrumental
mrówkolwami	Instrumental
cmentarzom	Dative
szprychami	Instrumental
pojawiła	None
twierdzono	None
rzepaków	Genitive
zaciążą	None
odstawione	None
pierdzieli	None
obejmujące	None
krokami	Instrumental
węglowodoru	Genitive
reumatyzmu	Genitive
biografowi	Dative
płotko	Vocative
sprzątacz	Nominative
strażnikach	Essive
licznikach	Essive
pierdylionach	Essive
grejpfrutów	Genitive
gąsiorkiem	Instrumental
zakażeniami	Instrumental
ignorowałybyśmy	None
tasakiem	Instrumental
Indianinem	Instrumental
gankowi	Dative
centralizmowi	Dative
polowaniami	Instrumental
plazmo	Vocative
piwnic	Genitive
męczennikowi	Dative
splotem	Instrumental
zazdrościmy	None
bawoła	Accusative
skrzyżowań	Genitive
obojczykiem	Instrumental
akomodacjach	Essive
szpilkę	Accusative
radonu	Genitive
odstępom	Dative
pisarz	Nominative
straciłbym	None
fiutami	Instrumental
opuszczał	None
dźwigała	None
sabotował	None
absorbują	None
kalderach	Essive
cicha	Nominative
elektronowoltów	Genitive
piosenkarzowi	Dative
scenarzystą	Instrumental
sprzątnie	None
nastawię	None
wiśniach	Essive
umawiając	None
żyrafa	Nominative
tablica	Nominative
rozgrzeszyłeś	None
podeszwa	Nominative
jodeł	Genitive
nadgarstków	Genitive
grzeszyłabym	None
obrażeniom	Dative
płomieni	Genitive
plotkując	None
oceanicznymi	Instrumental
płynąc	None
południkach	Essive
założyciel	Nominative
drobino	Vocative
szczytami	Instrumental
luków	Genitive
kryminalistę	Accusative
obliczami	Instrumental
policzkami	Instrumental
występujesz	None
chińczykom	Dative
brona	Nominative
buteleczkach	Essive
jabłoniowi	Nominative
partner	Nominative
śródziemnomorskimi	Instrumental
wydrą	Instrumental
żebrami	Instrumental
skrzypek	Nominative
mangach	Essive
sobolem	Instrumental
epokę	Accusative
litrom	Dative
organizujące	None
uniwersytetów	Genitive
obywatelom	Dative
lubelskimi	Instrumental
problemami	Instrumental
lubią	None
rekonstrukcją	Instrumental
grzebiąc	None
dzieł	Genitive
dzierżyć	None
dyskietkach	Essive
powtarzało	None
ładowała	None
liceach	Essive
ufaj	None
archaicznymi	Instrumental
wschodzą	None
litera	Nominative
świetlówka	Nominative
zasłużyłeś	None
dani	Nominative
zakrzywionymi	Instrumental
gajowemu	Dative
wiosłowaniem	Instrumental
flecista	Nominative
hut	Genitive
piszą	None
zaniechalibyśmy	None
narzekając	None
uczuć	Genitive
dialogiem	Instrumental
dożył	None
hamulca	Genitive
przyrostka	Genitive
siewu	Genitive
beleczkami	Instrumental
homarom	Dative
torpedach	Essive
halami	Instrumental
dumą	Instrumental
wypędzony	None
aukcją	Instrumental
działką	Instrumental
miasteczkach	Essive
magisterko	Vocative
sześciokątem	Instrumental
liczba	Nominative
kościołom	Dative
norwescy	Nominative
gorzelnią	Instrumental
odmianom	Dative
antypapież	Nominative
przegapić	None
czytano	None
aktywniejszymi	Instrumental
pałę	Accusative
grama	Genitive
epoką	Instrumental
obserwują	None
obfita	Nominative
pasm	Genitive
obejmowałyby	None
motorniczymi	Instrumental
zrobiło	None
Hindusach	Essive
bronię	None
gejom	Dative
produkujące	None
lupo	Vocative
złupiony	None
lodowcach	Essive
wulkanem	Instrumental
najdalsza	Nominative
entuzjastach	Essive
znikniecie	None
śmiałbym	None
poprawiajcie	None
podlewamy	None
żwacza	Genitive
susz	Genitive
chciałyby	None
gigantyczni	Nominative
kołdrą	Instrumental
opaleniznach	Essive
Saracen	Nominative
palimpsestów	Genitive
zalogowało	None
barbarzyństwem	Instrumental
oddawać	None
traciłem	None
płodna	Nominative
smakują	None
zaczynała	None
makaronami	Instrumental
zamarzały	None
pistoletów	Genitive
potwierdzisz	None
dotykane	None
skąpcowi	Dative
lansując	None
krzemieniem	Instrumental
znaczyłyśmy	None
siatkówka	Nominative
twierdzeniach	Essive
Kozakom	Dative
tworzony	None
norach	Essive
zachcianka	Nominative
dzierżyły	None
parkowały	None
otrzymałem	None
angielszczyzna	Nominative
aksjomatem	Instrumental
rzygało	None
myśliwcowi	Dative
pokaże	None
odczyniłabyś	None
jadeitem	Instrumental
rachunkowi	Dative
szklarnią	Instrumental
otrzymacie	None
rozwijało	None
runom	Dative
wpływach	Essive
zabijaj	None
demonstrantom	Dative
waletom	Dative
narowowi	Dative
rufę	Accusative
grobu	Genitive
wybuchałyśmy	None
szkodziła	None
słuchająca	None
wstawalibyście	None
studentami	Instrumental
biało-czerwonymi	Instrumental
mandarynek	Genitive
ciasteczkach	Essive
sprawdzianem	Instrumental
zwyciężali	None
nawozów	Genitive
oglądał	None
biegunek	Genitive
blokiem	Instrumental
surowców	Genitive
przepisu	Genitive
reklamę	Accusative
notariuszem	Instrumental
czcionek	Genitive
pandą	Instrumental
agregatów	Genitive
podkreślamy	None
chwalić	None
sprzątnąć	None
słonecznymi	Instrumental
budżetowi	Dative
wygarnęłaś	None
księstwem	Instrumental
ogarniają	None
wstrząsem	Instrumental
miecha	Genitive
wyj	None
przytuliłyśmy	None
zawodnikowi	Dative
napadu	Genitive
potwierdziłyby	None
traktuje	None
asymptotę	Accusative
początkach	Essive
negocjował	None
podejrzewające	None
islamskimi	Instrumental
egzorcyzmom	Dative
najgłębszymi	Instrumental
pocieszy	None
dwuznakiem	Instrumental
oceniali	None
zauważeni	None
remisom	Dative
wyjaśniaj	None
narzeczonemu	Dative
wylogowało	None
fałszywkę	Accusative
spójnymi	Instrumental
przydawkom	Dative
burek	Genitive
pisałeś	None
okradania	Genitive
uliczkę	Accusative
kwartetów	Genitive
występująca	None
czyniono	None
filmowałeś	None
zachowaniem	Instrumental
czekając	None
sylwetkach	Essive
czytałem	None
prokuratorach	Essive
brudnymi	Instrumental
wieprzowinę	Accusative
wahała	None
palimpsestowi	Dative
świerszczy	Genitive
łódką	Instrumental
myliły	None
dziąsłowa	Nominative
zakładkami	Instrumental
reklamowymi	Instrumental
śluzowcowi	Dative
odwiedzacie	None
kanałów	Genitive
linieją	None
fruwająca	None
zniszczył	None
ufają	None
chaotycznymi	Instrumental
animistami	Instrumental
medalem	Instrumental
ramionami	Instrumental
hasłu	Dative
jamochłonów	Genitive
wzięłam	None
stawiane	None
doktor	Nominative
toyota	Nominative
zwiastunami	Instrumental
punktom	Dative
obiecywał	None
mięknie	None
świstun	Nominative
nastawimy	None
przysięgają	None
kwiaciarka	Nominative
perzyn	Genitive
prolinę	Accusative
pierwiastkiem	Instrumental
różniczek	Genitive
technetowi	Dative
protokołach	Essive
winogronach	Essive
mundurami	Instrumental
debiutom	Dative
straciłoby	None
wahaniach	Essive
czyszczone	None
krótkofalówką	Instrumental
uznawały	None
czasówkach	Essive
nart	Genitive
zakażeniom	Dative
spieprzylibyście	None
metropolitę	Accusative
zgliszczom	Dative
jebana	Nominative
trwałymi	Instrumental
znikał	None
syren	Genitive
parkingami	Instrumental
dermatologiczni	Nominative
brodaczach	Essive
obiecywałem	None
oddająca	None
świerkowi	Dative
spieprzałbyś	None
niszczą	None
znoście	None
urokowi	Dative
testowa	Nominative
wargami	Instrumental
mężczyzno	Vocative
zeszłymi	Instrumental
pilnikiem	Instrumental
wódo	Vocative
literówką	Instrumental
lusterkach	Essive
rzeźnią	Instrumental
uśpione	None
humorem	Instrumental
kłótniami	Instrumental
bekonów	Genitive
krasulo	Vocative
warzywami	Instrumental
uczelnia	Nominative
złupiłem	None
przygotowanymi	Instrumental
słyszana	None
wuj	Nominative
imponował	None
złoczyńcę	Accusative
łużyccy	Nominative
puchaczem	Instrumental
projekcjo	Vocative
wyłączając	None
straciło	None
wrzecionie	Essive
zachoruje	None
ekstazę	Accusative
konarem	Instrumental
Albańczykiem	Instrumental
działałbym	None
matrycę	Accusative
mylmy	None
korników	Genitive
latarkami	Instrumental
wahał	None
decymetrom	Dative
fiordami	Instrumental
kolarzem	Instrumental
pełzał	None
dialektem	Instrumental
bramka	Nominative
zalogował	None
bankietami	Instrumental
walkami	Instrumental
panoramą	Instrumental
obrabowane	None
wymyślenie	None
opowieściami	Instrumental
usunęły	None
hałasem	Instrumental
stechiometrią	Instrumental
ptaszysek	Genitive
kochankę	Accusative
frezarkę	Accusative
wybierałem	None
pląsać	None
wasal	Nominative
podpaliła	None
lubrykantami	Instrumental
serwetkach	Essive
antyklina	Nominative
autobusem	Instrumental
Łotyszką	Instrumental
tańczona	None
traktujące	None
spotkali	None
susłów	Genitive
harmoniami	Instrumental
strażach	Essive
silników	Genitive
kolebek	Genitive
austriaccy	Nominative
znaczyłoby	None
dajemy	None
konfitur	Genitive
fransem	Instrumental
sadystycznymi	Instrumental
wróżka	Nominative
Hiszpan	Nominative
prawosławni	Nominative
kolonią	Instrumental
źrenica	Nominative
spieprzmy	None
organizuję	None
dożyjesz	None
histydyno	Vocative
fruwalibyśmy	None
bywanie	None
różyczek	Genitive
stolyca	Nominative
tłumaczą	None
dmuchać	None
znakiem	Instrumental
muzułmaninem	Instrumental
napojami	Instrumental
czarodziejom	Dative
ruletkę	Accusative
krukach	Essive
latarek	Genitive
kubkiem	Instrumental
blendach	Essive
powieściach	Essive
lessami	Instrumental
uchwytów	Genitive
bohater	Nominative
treflach	Essive
rozmaitościach	Essive
absorbowały	None
kreskówkach	Essive
tonę	Accusative
parowozów	Genitive
cieślach	Essive
dymili	None
ceną	Instrumental
śnił	None
banderach	Essive
brązowymi	Instrumental
łzach	Essive
dokonać	None
zaczniesz	None
kuropatwą	Instrumental
brojlerom	Dative
prezydentach	Essive
rybnymi	Instrumental
teizmem	Instrumental
bestiach	Essive
wspominać	None
płacili	None
sypano	None
gronostajach	Essive
kazirodztwu	Dative
kotłowniami	Instrumental
kikutem	Instrumental
morfino	Vocative
prawami	Instrumental
rydwanu	Genitive
skracając	None
artykułem	Instrumental
bramę	Accusative
organizacjo	Vocative
szynka	Nominative
pęknąć	None
ocenisz	None
flamingowi	Dative
dokonałam	None
negocjowały	None
zebrać	None
rozróżniałyście	None
rozczarowałaby	None
dowiedziałam	None
długami	Instrumental
otrzymałyśmy	None
zasp	Genitive
pasażerach	Essive
skurczowi	Dative
opinią	Instrumental
skarbcem	Instrumental
Brytyjczykom	Dative
bakteryjna	Nominative
kazachskimi	Instrumental
dojrzeją	None
wądołowi	Dative
zoogeografię	Accusative
dwukropkiem	Instrumental
śródziemnomorska	Nominative
falochronu	Genitive
demokratom	Dative
herbata	Nominative
pieśniom	Dative
gazetom	Dative
sypała	None
wspólnotę	Accusative
uwielbia	None
wypędzę	None
piłkę	Accusative
mazurscy	Nominative
wizytami	Instrumental
surach	Essive
smołą	Instrumental
znosi	None
opat	Nominative
kroczach	Essive
procentach	Essive
rybozę	Accusative
wyżynami	Instrumental
sitami	Instrumental
gruzom	Dative
zgromadzeń	Genitive
bramkarzowi	Dative
Armeńczyk	Nominative
energiach	Essive
pisarzowi	Dative
perfekcję	Accusative
twierdzeniem	Instrumental
oddane	None
wrogami	Instrumental
marnując	None
kontaktowi	Dative
nasieniowodów	Genitive
demonowi	Dative
aferę	Accusative
westernów	Genitive
zamówiono	None
skazali	None
wygodna	Nominative
sprzątnięte	None
wiewiórką	Instrumental
termometrach	Essive
izbom	Dative
najpłynniejszymi	Instrumental
kosiarz	Nominative
afrodyzjaków	Genitive
najmocniejsza	Nominative
odkrywające	None
okazane	None
wynająć	None
Chińczykami	Instrumental
kocham	None
dręczą	None
rybia	Nominative
chloroformem	Instrumental
płatków	Genitive
krokodyl	Nominative
serwatkę	Accusative
kotwic	Genitive
cudzysłowami	Instrumental
chłamu	Genitive
zastrzeżona	Nominative
zabalsamowane	None
wektorami	Instrumental
glonu	Genitive
pęknięciem	Instrumental
świerka	Genitive
parowców	Genitive
złożyłaby	None
szachista	Nominative
sonatach	Essive
ścieżek	Genitive
wypędzilibyście	None
Kopt	Nominative
apteką	Instrumental
eutanazją	Instrumental
koszona	None
uchodźcą	Instrumental
kryj	None
skłotu	Genitive
pseudonimem	Instrumental
kapłaństwa	Genitive
numerów	Genitive
topolę	Accusative
wizytówka	Nominative
najwyższymi	Instrumental
flądra	Nominative
raziła	None
odpowiadałaby	None
dymnymi	Instrumental
schizofrenia	Nominative
wpływałaby	None
osobach	Essive
orderami	Instrumental
akustyczna	Nominative
przysięgał	None
tranzystorem	Instrumental
esemesowania	Genitive
migawką	Instrumental
porozmawiali	None
dowodzono	None
obraziłem	None
wieśniakowi	Dative
opiekowałaby	None
wielkością	Instrumental
akcjami	Instrumental
raportami	Instrumental
męczennic	Genitive
czerpiąc	None
rozproszcie	None
śpiewałeś	None
wyłudzenie	None
krowianko	Vocative
doświadczeniom	Dative
monogramowi	Dative
wejściami	Instrumental
współcześni	Nominative
stolikach	Essive
kartonowa	Nominative
hrabstwami	Instrumental
trójkątem	Instrumental
dżulem	Instrumental
podnosiło	None
dowodzili	None
krzesełkami	Instrumental
szkodliwymi	Instrumental
przeżyje	None
najwybitniejsi	Nominative
agentur	Genitive
kategorią	Instrumental
napisany	None
skakały	None
doprowadzał	None
płuc	Genitive
przypomnieli	None
pochodnia	Nominative
pułkownik	Nominative
smoła	Nominative
skrzypaczkę	Accusative
placków	Genitive
ujadają	None
mąką	Instrumental
głupcem	Instrumental
pozwalam	None
śmiesznymi	Instrumental
oglądają	None
sprzężony	None
uwielbiał	None
taboru	Genitive
szpitalach	Essive
szanują	None
należałeś	None
sfinksom	Dative
wzgórz	Genitive
koleżanka	Nominative
żyletek	Genitive
cuglami	Instrumental
miecznikiem	Instrumental
budowach	Essive
pełzające	None
wymyśliłeś	None
przynoszenie	None
ochroniarzom	Dative
rufo	Vocative
pobrane	None
stresu	Genitive
próbowało	None
dziennikarkę	Accusative
uznawani	None
żądzą	Instrumental
starając	None
bajek	Genitive
semantykę	Accusative
pozorna	Nominative
zbierali	None
laboratoriach	Essive
nadzorów	Genitive
seminaryjni	Nominative
składałaby	None
gronu	Dative
lotniskowców	Genitive
parkingiem	Instrumental
poroniona	Nominative
piaskownicą	Instrumental
węglowa	Nominative
rękoczynom	Dative
bluzę	Accusative
zagadek	Genitive
złamali	None
kotłownię	Accusative
potrzebowano	None
rzucisz	None
właściwościom	Dative
jaskółkami	Instrumental
nastawiłaby	None
Baskijek	Genitive
endemiczna	Nominative
tworzyła	None
osób	Genitive
wyjściem	Instrumental
męczyłybyście	None
susłowi	Dative
dochodziła	None
wyrządzić	None
znosząc	None
niepokojami	Instrumental
medytujący	None
kolczatka	Nominative
wrażeniom	Dative
antytrynitaryzmowi	Dative
blaskach	Essive
żeń-szeniem	Instrumental
przytulił	None
biznesmenem	Instrumental
blokom	Dative
telefonistkach	Essive
oceniony	None
gałach	Essive
darowizną	Instrumental
pierwszakowi	Dative
wysp	Genitive
lazłybyście	None
skakał	None
ciemnożółta	Nominative
astronautach	Essive
markiz	Genitive
teodolitu	Genitive
likierów	Genitive
skorupiak	Nominative
koszulkach	Essive
zdun	Nominative
okazach	Essive
wykopało	None
marokańscy	Nominative
ubekiem	Instrumental
filiżanko	Vocative
przekleństwami	Instrumental
przyniosłyśmy	None
rowerach	Essive
identyfikujące	None
przegap	None
mowa	Nominative
wiktach	Essive
żniwiarzach	Essive
narodowością	Instrumental
latarniom	Dative
logarytmami	Instrumental
nadzorowi	Dative
zawodnikiem	Instrumental
identycznościach	Essive
skracałbyś	None
znajomością	Instrumental
tendrów	Genitive
pokrzywo	Vocative
kaplic	Genitive
żeglarkach	Essive
grzywami	Instrumental
dobrodziejem	Instrumental
obserwatorowi	Dative
furmankami	Instrumental
wystawami	Instrumental
simensowi	Dative
spięłabym	None
odkryłbym	None
biolog	Nominative
lotniskowca	Genitive
mimoza	Nominative
organizowano	None
towaru	Genitive
badałabyś	None
japonka	Nominative
pulmonolog	Nominative
aksonami	Instrumental
batyskafem	Instrumental
próbowania	Genitive
mitologiach	Essive
wytłumaczony	None
pochodził	None
Chinką	Instrumental
gumowymi	Instrumental
kościołem	Instrumental
leksykografia	Nominative
kategoriami	Instrumental
kojotami	Instrumental
obywatel	Nominative
wybrać	None
okazałyby	None
placowi	Dative
kołpaków	Genitive
płynęłabyś	None
podwiązka	Nominative
gruszek	Genitive
widzeniach	Essive
strzelające	None
krytyk	Genitive
zaimportowałyście	None
wądołom	Dative
wymagałoby	None
samogłosko	Vocative
wyglądała	None
okrągli	Nominative
maszeruje	None
majonezu	Genitive
zauważyłem	None
drukując	None
marzyłybyśmy	None
wrzosowiskiem	Instrumental
rozmywałabyś	None
mapami	Instrumental
płać	None
rozważa	None
raziły	None
kodeina	Nominative
nakryła	None
sadźcach	Essive
dwukropków	Genitive
rękawiczkę	Accusative
brązówek	Genitive
bankructwami	Instrumental
wyprasowała	None
kryptologią	Instrumental
płacić	None
wojnę	Accusative
zabierzesz	None
perłami	Instrumental
roztworu	Genitive
prosiakami	Instrumental
otworowi	Dative
odlotu	Genitive
klas	Genitive
terapeutą	Instrumental
przesłuchaniami	Instrumental
orzecznikowi	Dative
podpiszą	None
kablówka	Nominative
śmietanę	Accusative
kanonierka	Nominative
dotykana	None
iloczynami	Instrumental
kaw	Genitive
prawach	Essive
jambach	Essive
otrzymaliśmy	None
bełkotem	Instrumental
skróćcie	None
całunu	Genitive
ogarniająca	None
roślibyście	None
notowani	None
podrywaniem	Instrumental
gabinetu	Genitive
malinka	Nominative
firm	Genitive
spodenkom	Dative
zaufalibyście	None
pozwalałyby	None
podróżowano	None
ospa	Nominative
śmieciach	Essive
bólach	Essive
surami	Instrumental
mercedes	Nominative
fotosyntezę	Accusative
atmosferą	Instrumental
otaczała	None
gliniarzowi	Dative
zawałów	Genitive
ekierka	Nominative
okrągła	Nominative
organizowała	None
nurkując	None
spalacjo	Vocative
budżetówek	Genitive
wspominane	None
puszczę	None
pieroga	Genitive
trumna	Nominative
kopiujesz	None
pełnymi	Instrumental
opróżnił	None
ograniczaliby	None
wędrowcowi	Dative
uratował	None
poprawiające	None
przytulniejsi	Nominative
turbiną	Instrumental
odbijany	None
wersjom	Dative
tracił	None
sztukę	Accusative
kryjąc	None
klikasz	None
strefom	Dative
narzędnikach	Essive
kontem	Instrumental
chrześniak	Nominative
piętka	Nominative
kołysanka	Nominative
zapominają	None
rybozy	Genitive
bratanicą	Instrumental
pierwotniakom	Dative
partia	Nominative
wyrządziły	None
Wandal	Nominative
źródłami	Instrumental
pożądaj	None
sobowtórem	Instrumental
pacjentek	Genitive
mieszali	None
odbiornikach	Essive
kierem	Instrumental
anioł	Nominative
wyprowadzaniem	Instrumental
sprężynach	Essive
zajebistymi	Instrumental
wyrzuciła	None
hiragana	Nominative
poganami	Instrumental
lojalek	Genitive
badać	None
blokowiskach	Essive
bojanie	None
tatarom	Dative
brawura	Nominative
grusza	Nominative
rozmawia	None
mitologiami	Instrumental
pecetów	Genitive
ratowała	None
kijanek	Genitive
lawendą	Instrumental
monarchiami	Instrumental
maczugę	Accusative
kontrafagotowi	Dative
wyjąwszy	None
wzięła	None
szarówkom	Dative
intryga	Nominative
biografami	Instrumental
bagażników	Genitive
śrubkom	Dative
wolniejsi	Nominative
tworów	Genitive
wysyłają	None
tempem	Instrumental
mknące	None
oddawałem	None
bananom	Dative
bambusowymi	Instrumental
otruł	None
przepraszali	None
dziwek	Genitive
kawałach	Essive
przodowali	None
znali	None
zacnymi	Instrumental
archiwom	Dative
halabardom	Dative
krytyczna	Nominative
posłuchajcie	None
żyjące	None
wyrom	Dative
wygrały	None
histeryczna	Nominative
ołtarzom	Dative
rzeczni	Nominative
nalewalibyście	None
uciekamy	None
Polakowi	Dative
krucha	Nominative
starszymi	Instrumental
sadeł	Genitive
spuszczał	None
kociakiem	Instrumental
okrzemkami	Instrumental
Szwedek	Genitive
malinką	Instrumental
odpoczywająca	None
znalazłszy	None
karykaturę	Accusative
afirmacja	Nominative
wsparte	None
rzucam	None
przygotujesz	None
asteryzmom	Dative
gospodyń	Genitive
oślęciem	Instrumental
eksportowanie	None
ulicach	Essive
siostrzenicom	Dative
przedszkolom	Dative
zastanawialiśmy	None
kasztanów	Genitive
przyszłymi	Instrumental
trybowi	Dative
całuje	None
haftowany	None
paczkami	Instrumental
zachodnia	Nominative
pocą	None
używał	None
borsukiem	Instrumental
kradło	None
średnikiem	Instrumental
strzępom	Dative
psychosomatycznymi	Instrumental
gwiżdżę	None
zegarach	Essive
pieczarach	Essive
górnikiem	Instrumental
idolami	Instrumental
wytłumaczę	None
przepisach	Essive
zdrajczyniom	Dative
łapiesz	None
nosiłaś	None
przeciwnymi	Instrumental
wibrafonów	Genitive
blend	Genitive
buławnikach	Essive
olał	None
powtórzę	None
abiturient	Nominative
identyfikowała	None
studiowałabyś	None
sądami	Instrumental
pomidorów	Genitive
podatkach	Essive
wysiłkach	Essive
aktywisty	Genitive
nicieniami	Instrumental
planuj	None
wyłudziłbyś	None
aucie	Essive
olimpiada	Nominative
kompasów	Genitive
kinem	Instrumental
buziakach	Essive
artysta	Nominative
przereklamowani	Nominative
widmami	Instrumental
tendra	Genitive
kantom	Dative
notuje	None
jaguarów	Genitive
antenę	Accusative
kroiłyśmy	None
brosz	Genitive
chromu	Genitive
kradzione	None
schowałbyś	None
wawrzynu	Genitive
mięśniach	Essive
kołami	Instrumental
wygarnęłyście	None
Włoszkami	Instrumental
rafa	Nominative
powtarzałybyśmy	None
sukinsynem	Instrumental
ogarniać	None
dworzanin	Nominative
pszczółeczką	Instrumental
zawiodę	None
siedzeniami	Instrumental
nazywając	None
papierom	Dative
krachem	Instrumental
udkom	Dative
blokad	Genitive
odwiedzam	None
neolitycznymi	Instrumental
odwzajemniony	None
bransoletom	Dative
stożkom	Dative
flotach	Essive
dzierżąca	None
arię	Accusative
suszono	None
katalońskimi	Instrumental
zapłaciliby	None
społeczni	Nominative
kazachska	Nominative
wskazani	None
bogatsza	Nominative
meczom	Dative
szkliw	Genitive
antlantyckimi	Instrumental
Żydom	Dative
płócien	Genitive
otrzymają	None
aula	Nominative
błyskała	None
najczarniejsza	Nominative
kneblami	Instrumental
czyniące	None
oczywistościach	Essive
pochodniami	Instrumental
opałem	Instrumental
atrybutu	Genitive
strojach	Essive
czytaliście	None
połączyła	None
enterów	Genitive
ostrzeżeń	Genitive
krainach	Essive
ziarnem	Instrumental
kadencjami	Instrumental
pożyczyłoby	None
ejakulacją	Instrumental
bolidowi	Dative
tygrysami	Instrumental
żelatyna	Nominative
kwantach	Essive
pozorem	Instrumental
gestem	Instrumental
wypędzili	None
bawołów	Genitive
szpiegiem	Instrumental
abonowałabym	None
rolnik	Nominative
oceniamy	None
oddawano	None
doprowadzane	None
politologowi	Dative
strajkowi	Dative
krzyczenie	None
łoza	Nominative
babcia	Nominative
nogawek	Genitive
poznańskimi	Instrumental
wygrani	None
togę	Accusative
zadamy	None
wielobokom	Dative
dokonując	None
solnymi	Instrumental
halabardami	Instrumental
głuptasom	Dative
zapomniany	None
biogazem	Instrumental
synom	Dative
pomysłowa	Nominative
dawały	None
szantażować	None
zapłacone	None
drumla	Nominative
ołtarzami	Instrumental
odbija	None
osiągnięciami	Instrumental
zatrzymałem	None
schnęło	None
kanio	Vocative
wylewów	Genitive
czerwonko	Vocative
wywoływali	None
tytoni	Genitive
legenda	Nominative
najebanymi	Instrumental
doprowadzająca	None
kołnierzy	Genitive
świerzbienie	None
informatyk	Nominative
wyłudzać	None
widziany	None
chwaliłem	None
flagę	Accusative
przyzwoitką	Instrumental
kołchozom	Dative
januszem	Instrumental
szczekałem	None
anielska	Nominative
mędrcami	Instrumental
odwiedzające	None
rzucająca	None
konfiturami	Instrumental
rozpaczał	None
przemysłowa	Nominative
cieniach	Essive
kierując	None
rządowi	Nominative
kulami	Instrumental
galernikiem	Instrumental
alkoholikowi	Dative
sarną	Instrumental
chroniono	None
kartek	Genitive
delikwentom	Dative
kilometrówko	Vocative
pokrywająca	None
obora	Nominative
infekcją	Instrumental
półfinału	Genitive
wymagało	None
ekspedientkom	Dative
cytowano	None
pobytami	Instrumental
edytowali	None
prędkościomierzem	Instrumental
ropuch	Genitive
głodówka	Nominative
glinach	Essive
cieplejszymi	Instrumental
używamy	None
przysięgę	Accusative
odstawią	None
opuszczam	None
pochodnym	Dative
paserstew	Genitive
wstążeczką	Instrumental
piastą	Instrumental
żużlom	Dative
myć	None
mauzoleów	Genitive
latałabyś	None
programisty	Genitive
dusiłam	None
iMaców	Genitive
ciuchem	Instrumental
kondygnację	Accusative
uzależnień	Genitive
zapłonu	Genitive
zamarza	None
rozbiły	None
tańców	Genitive
kardiologicznymi	Instrumental
ciałach	Essive
obudowami	Instrumental
tilak	Genitive
problematycznymi	Instrumental
piącha	Nominative
alkoholiczkę	Accusative
elektronik	Nominative
odkryli	None
kwililiby	None
kładę	None
organizatorem	Instrumental
dające	None
głosowaniom	Dative
ciągami	Instrumental
purytanizmu	Genitive
fregatami	Instrumental
absolwentką	Instrumental
kreskami	Instrumental
melodiami	Instrumental
fonologio	Vocative
farbach	Essive
uczniami	Instrumental
lesbijkach	Essive
dałaby	None
pojawiały	None
związkami	Instrumental
uwielbiany	None
klasyfikacjom	Dative
statuetkach	Essive
zajazdach	Essive
kucharką	Instrumental
pandeizmem	Instrumental
odżywek	Genitive
diamentowa	Nominative
imionom	Dative
traktowano	None
kurnika	Genitive
czerwieniami	Instrumental
bib	Genitive
syndykalistach	Essive
googlowałby	None
tłumaczyły	None
pierdzący	None
pokoleniami	Instrumental
piegom	Dative
absurdalna	Nominative
jarząbkami	Instrumental
tęsknotom	Dative
resztkami	Instrumental
urzędnikiem	Instrumental
janusz	Nominative
wyniosą	None
kazaniach	Essive
żaglowcami	Instrumental
Ziemianami	Instrumental
dróg	Genitive
gdańscy	Nominative
Wietnamczykiem	Instrumental
słowikiem	Instrumental
pierwsza	Nominative
palcem	Instrumental
kieszonkowiec	Nominative
zrobiłbyś	None
proca	Nominative
próbujące	None
hipotezą	Instrumental
sóweczkom	Dative
siatką	Instrumental
widziana	None
lataj	None
proponując	None
prywaciarzem	Instrumental
hiperbola	Nominative
zamkniemy	None
urodzony	None
jeździł	None
jaworach	Essive
wodospadach	Essive
rysikach	Essive
twierdzili	None
nicieni	Genitive
rozróżniają	None
okienna	Nominative
piramidach	Essive
parapetami	Instrumental
lizaków	Genitive
tacę	Accusative
owsach	Essive
pismakowi	Dative
zamykały	None
zmyślony	None
cynikach	Essive
komentowany	None
impotencją	Instrumental
przeżuć	None
złotówką	Instrumental
szuler	Nominative
termostatem	Instrumental
drapieżnik	Nominative
kryjówkami	Instrumental
pokażą	None
gwałciciel	Nominative
sieciom	Dative
niszczę	None
cielęcia	Genitive
lingwistami	Instrumental
trzustkę	Accusative
gał	Genitive
osadem	Instrumental
oceną	Instrumental
siatkówek	Genitive
schowano	None
mitologia	Nominative
hrabiach	Essive
kardiochirurgiem	Instrumental
kontrola	Nominative
ciałami	Instrumental
attyką	Instrumental
białkiem	Instrumental
pulsarów	Genitive
edytujemy	None
orkiestrach	Essive
cieńsi	Nominative
pornografowi	Dative
przemyślany	None
kursach	Essive
żeglarstwu	Dative
eksperymentować	None
tworzyło	None
kosztujące	None
grzesznymi	Instrumental
garnizonach	Essive
wahaniami	Instrumental
sarkaliby	None
muszkietami	Instrumental
czytany	None
dostarczamy	None
sukieneczka	Nominative
czapla	Nominative
sonatami	Instrumental
podwójni	Nominative
golom	Dative
ksylofonów	Genitive
polecano	None
wpływami	Instrumental
nadzorowany	None
kryjówkę	Accusative
szpiegami	Instrumental
podał	None
stworem	Instrumental
kszykami	Instrumental
ceremoniom	Dative
dupczący	None
kurwa	Nominative
burdę	Accusative
zamieszek	Genitive
osmańska	Nominative
taborach	Essive
żeneta	Nominative
limburska	Nominative
brzegami	Instrumental
kłódkę	Accusative
wieżowca	Genitive
chłopom	Dative
kucharkach	Essive
antyklin	Genitive
szkłem	Instrumental
radioizotopu	Genitive
łokciami	Instrumental
dosrać	None
planszach	Essive
pszczółkę	Accusative
ametystów	Genitive
bumerangom	Dative
Greczynkach	Essive
rękodziełem	Instrumental
artystko	Vocative
drukowały	None
diagnozowany	None
następna	Nominative
igłą	Instrumental
opalom	Dative
gębami	Instrumental
rodzinna	Nominative
kłujesz	None
czasówko	Vocative
proponowałabyś	None
kajetem	Instrumental
turkusem	Instrumental
marudziliby	None
złapana	None
rewersem	Instrumental
parabolom	Dative
składano	None
proszkami	Instrumental
wschodami	Instrumental
szympansów	Genitive
wskazuję	None
miałom	Dative
jaskrawymi	Instrumental
karabinami	Instrumental
zagadka	Nominative
wodoodporni	Nominative
rafę	Accusative
taksówką	Instrumental
pękania	Genitive
smokom	Dative
zastrzykami	Instrumental
poligonach	Essive
kremację	Accusative
pałacom	Dative
marz	None
obiecujące	None
namiotu	Genitive
fletów	Genitive
biedroneczek	Genitive
śląska	Nominative
dialektologia	Nominative
najpłytsi	Nominative
hipokryzję	Accusative
randkach	Essive
klasztorowi	Dative
lessów	Genitive
ruję	Accusative
pochodnymi	Instrumental
korzystałeś	None
występują	None
demagogowi	Dative
Słowaczką	Instrumental
masek	Genitive
gitarom	Dative
gwiazdozbioru	Genitive
przedsięwzięciami	Instrumental
literówkę	Accusative
pogrzebię	None
szympans	Nominative
jawilibyście	None
nadużyciami	Instrumental
gajom	Dative
kieliszkami	Instrumental
podtytułu	Genitive
gałązką	Instrumental
chochelkami	Instrumental
arystokratę	Accusative
tworzyli	None
telegramu	Genitive
pingwinów	Genitive
warszawo	Vocative
głowicę	Accusative
kosiarko	Vocative
aortę	Accusative
plecakowi	Dative
Persach	Essive
prajęzyka	Genitive
czardasz	Nominative
nalewka	Nominative
rządzenie	None
ściągający	None
tureckimi	Instrumental
korda	Genitive
napisała	None
wpływał	None
podniesiony	None
wytłumaczyłeś	None
warunkami	Instrumental
imitacjo	Vocative
równoleżnika	Genitive
szukajcie	None
ubraniami	Instrumental
sprzętu	Genitive
hemolizami	Instrumental
czepkiem	Instrumental
czyńcie	None
łaknienie	None
minerału	Genitive
tłom	Dative
kolorowa	Nominative
kreskówką	Instrumental
podkreślania	Genitive
narkotykami	Instrumental
oddziałów	Genitive
negatywem	Instrumental
pełnoletnimi	Instrumental
majsterkowały	None
nosi	None
sobotom	Dative
cipa	Nominative
górę	Accusative
tytoniach	Essive
karetkom	Dative
fregat	Genitive
kółek	Genitive
ślubu	Genitive
wiśnio	Vocative
ziemianką	Instrumental
przyzwoleń	Genitive
kąsałbym	None
zabrali	None
dziwię	None
świtu	Genitive
przychodów	Genitive
pokojówko	Vocative
wiertarka	Nominative
bałtyccy	Nominative
łapało	None
wojennymi	Instrumental
napisana	None
kilometrami	Instrumental
jajkach	Essive
syropu	Genitive
zawiedzeniem	Instrumental
toków	Genitive
aksonach	Essive
obliczach	Essive
rozgrzeszyłyśmy	None
zwrotami	Instrumental
słoiczkami	Instrumental
apostołach	Essive
skarbowi	Dative
Amerykanek	Genitive
socjalistą	Instrumental
luster	Genitive
szlauchów	Genitive
terminalom	Dative
trzebiłbym	None
śnię	None
metalom	Dative
ciemnościach	Essive
oceniani	None
niziną	Instrumental
zakazali	None
morelowa	Nominative
kamerzystę	Accusative
oglądać	None
unikaj	None
bania	Nominative
kosmopolitom	Dative
folderami	Instrumental
amuletów	Genitive
rzęsę	Accusative
rzymscy	Nominative
arcydzieł	Genitive
skąpymi	Instrumental
altówek	Genitive
rzeką	Instrumental
władcach	Essive
puściłam	None
inwestycjami	Instrumental
ogrodu	Genitive
hurtownia	Nominative
popierania	Genitive
połączyć	None
historykach	Essive
niedźwiedziowi	Dative
pojawię	None
imbirem	Instrumental
prasami	Instrumental
lemurów	Genitive
radiowozów	Genitive
odkryjesz	None
moczowodach	Essive
drganiami	Instrumental
szyja	Nominative
wyświetla	None
Afganko	Vocative
oskarżająca	None
tragedia	Nominative
uratuj	None
swobodo	Vocative
barw	Genitive
ojcowizno	Vocative
rozważy	None
otaczająca	None
Francuz	Nominative
transparentem	Instrumental
wahano	None
strzelają	None
wahałybyśmy	None
apteka	Nominative
sekundom	Dative
plikom	Dative
przeszkadza	None
plują	None
palący	None
zapierdalałybyśmy	None
sadystyczna	Nominative
rozróżniali	None
wyrek	Genitive
obrażasz	None
sardynko	Vocative
cofało	None
dodzwonisz	None
zestawiona	None
zesrali	None
otoczakom	Dative
pomagają	None
gąsienicami	Instrumental
siusiaków	Genitive
jonizując	None
wybiera	None
karp	Nominative
politechnikami	Instrumental
śmiejecie	None
wiosenna	Nominative
kasę	Accusative
ciężarówka	Nominative
alabastrami	Instrumental
refrenu	Genitive
lado	Vocative
kangur	Nominative
nocami	Instrumental
obrzękowi	Dative
opisywało	None
siedziała	None
koszenie	None
pękły	None
przekonaniom	Dative
artystka	Nominative
robi	None
żłóbkom	Dative
borach	Essive
kruszczyka	Genitive
chóru	Genitive
mleczarzom	Dative
obszarom	Dative
ogarniaj	None
akumulatorów	Genitive
sąsiedzi	Nominative
aut	Genitive
wskazywać	None
pniakach	Essive
śledzi	None
porażko	Vocative
cen	Genitive
zgubi	None
kiosków	Genitive
zrozumie	None
behawioryzmem	Instrumental
medytację	Accusative
nastawiony	None
przeszkodę	Accusative
jaszczurką	Instrumental
deklach	Essive
płomienia	Genitive
wstążkach	Essive
grawitacyjnymi	Instrumental
wschodzi	None
częstymi	Instrumental
słoneczników	Genitive
lianach	Essive
relacjach	Essive
aniliną	Instrumental
seryna	Nominative
żółtawa	Nominative
smuta	None
studentek	Genitive
semestrów	Genitive
kucharzom	Dative
pijawkom	Dative
żarach	Essive
pająkami	Instrumental
cieśnina	Nominative
zamknąwszy	None
pisali	None
parapetów	Genitive
gwałcił	None
ratą	Instrumental
dwórek	Genitive
cieńsza	Nominative
pochówkami	Instrumental
zawodów	Genitive
wysiedli	None
chromosomach	Essive
torebkach	Essive
rozproszyły	None
burkę	Accusative
wirusami	Instrumental
płozę	Accusative
gwałcąc	None
wymusiła	None
odwiedzany	None
geniuszem	Instrumental
śledząca	None
chadzali	None
łudziłeś	None
grahamko	Vocative
kombajnu	Genitive
wahadeł	Genitive
kanapeczkach	Essive
rozróżnimy	None
kontroluj	None
śniące	None
oraczowi	Dative
jabłoniowa	Nominative
galopowałoby	None
milicjom	Dative
generałem	Instrumental
homografom	Dative
meduzą	Instrumental
dżezmenem	Instrumental
spuszczenie	None
spiesząc	None
pomyłkom	Dative
mruczenie	None
karmiące	None
larwa	Nominative
karyna	Nominative
drogo	Vocative
tata	Nominative
czynienie	None
monarchę	Accusative
podła	Nominative
skorupką	Instrumental
antycząstką	Instrumental
rejestracjach	Essive
ikonostasem	Instrumental
czyń	None
gęsia	Nominative
kładący	None
kaskaderowi	Dative
łopatką	Instrumental
ufali	None
katapulta	Nominative
dzielnicę	Accusative
Brytyjczykach	Essive
wiaduktami	Instrumental
mleczanów	Genitive
ścieżkami	Instrumental
kalendarzami	Instrumental
Europejek	Genitive
zostawi	None
starsza	Nominative
jerzykami	Instrumental
piosenkami	Instrumental
szaszłykami	Instrumental
sromami	Instrumental
obiecana	None
trybom	Dative
minetach	Essive
bioder	Genitive
czarownicach	Essive
jeźdźcom	Dative
sześćdziesięciolatkom	Dative
nieodpowiedzialni	Nominative
umyli	None
wyglądający	None
rezultatów	Genitive
sztandarami	Instrumental
morwę	Accusative
zauważyli	None
rocznicą	Instrumental
sprawdzana	None
rombem	Instrumental
makaków	Genitive
zawiedziony	None
kwantowa	Nominative
grahamach	Essive
galaktykach	Essive
pamiętaj	None
wielbłądem	Instrumental
częściowi	Nominative
klikajmy	None
krzycz	None
cywilni	Nominative
pilna	Nominative
pokazywałybyście	None
płakałoby	None
rozmowach	Essive
rozmiarowi	Dative
krzesłami	Instrumental
klątwom	Dative
pracodawco	Vocative
żarłokom	Dative
galeonów	Genitive
politykom	Dative
fletach	Essive
kupiliśmy	None
paszkotami	Instrumental
przeszkadzają	None
libacja	Nominative
abdykację	Accusative
rozróżniały	None
gestów	Genitive
żydowi	Dative
żebrakiem	Instrumental
wdepnąłbyś	None
obszarowi	Dative
szarad	Genitive
uczęszczały	None
stróżem	Instrumental
pasożytów	Genitive
wirtualna	Nominative
zbiegała	None
trudnościach	Essive
szczupli	Nominative
panować	None
ogrodnikiem	Instrumental
krewetką	Instrumental
szafa	Nominative
jastrzębi	Genitive
bratanic	Genitive
gryzący	None
polowaniach	Essive
martwił	None
pocztówkach	Essive
cerkiewnosłowiańskimi	Instrumental
przejściach	Essive
akademią	Instrumental
reputacjach	Essive
rodakom	Dative
pęknięty	None
szeregiem	Instrumental
delikatna	Nominative
kubka	Genitive
trzaska	None
obrabowały	None
ościenia	Genitive
dużymi	Instrumental
myję	None
czyniło	None
tłumaczysz	None
zapomni	None
wynikiem	Instrumental
hamakach	Essive
ładowaniem	Instrumental
mistrzach	Essive
ziemianka	Nominative
wyznacz	None
gromadziły	None
targiem	Instrumental
ruszały	None
składu	Genitive
cenach	Essive
włosem	Instrumental
wilżynach	Essive
jantaru	Genitive
porażka	Nominative
warunkowi	Dative
chroniły	None
kiczami	Instrumental
błotami	Instrumental
mamusiu	Vocative
dobrami	Instrumental
posadami	Instrumental
śliwka	Nominative
drzemano	None
niderlandzkimi	Instrumental
zachodziło	None
jąkający	None
poprzedzać	None
hedonistę	Accusative
moteli	Genitive
wymianom	Dative
modrzewnicą	Instrumental
zaprzeczyła	None
przymiotnikiem	Instrumental
kawiarniom	Dative
wiecznymi	Instrumental
doniczka	Nominative
odpowiednia	Nominative
fretką	Instrumental
zerowałabym	None
wydupczyłoby	None
obrażaniem	Instrumental
marszałkami	Instrumental
islamska	Nominative
dżuli	Genitive
słyszały	None
domatorom	Dative
potworem	Instrumental
tempu	Dative
doiłbym	None
ślimaków	Genitive
kratach	Essive
ukryli	None
chrzcił	None
podeszwach	Essive
robotnikami	Instrumental
gotował	None
lansować	None
anionu	Genitive
zalążków	Genitive
cewnika	Genitive
maziami	Instrumental
protokołom	Dative
ziemniaczana	Nominative
altówkach	Essive
poliestrami	Instrumental
bladsza	Nominative
wpływając	None
popełniłeś	None
pomagający	None
kolekcjonowałbym	None
uważaj	None
mamrotała	None
trzcinami	Instrumental
dziewczynko	Vocative
równoległobokami	Instrumental
znikałem	None
owcach	Essive
lucernach	Essive
biblioteczkach	Essive
fuksów	Genitive
rodzinom	Dative
wyjec	Nominative
strupów	Genitive
półfinalistami	Instrumental
głosowaniem	Instrumental
czepkami	Instrumental
zapomniałeś	None
rzeźbiarstwa	Genitive
zwycięstwom	Dative
sadzonek	Genitive
latał	None
myśliwymi	Instrumental
chrześcijańska	Nominative
lubili	None
śrubeczko	Vocative
trawników	Genitive
pingwin	Nominative
monopolem	Instrumental
tramwajami	Instrumental
labializacja	Nominative
opisywałem	None
usuwałyby	None
blogami	Instrumental
bizonami	Instrumental
rozkładowi	Dative
graniczy	None
półprostym	Dative
krakusem	Instrumental
sępem	Instrumental
miłkach	Essive
gnidami	Instrumental
lekkoatletką	Instrumental
magisterkę	Accusative
wymianę	Accusative
siąknięcie	None
żabkami	Instrumental
szóstkami	Instrumental
logarytmem	Instrumental
najwyżsi	Nominative
mauzoleami	Instrumental
aneksami	Instrumental
rodzajom	Dative
mieszanie	None
dermatologiem	Instrumental
kajakom	Dative
gadałem	None
grzebię	None
baszta	Nominative
źrenicami	Instrumental
niebezpiecznymi	Instrumental
dodawały	None
gotyckimi	Instrumental
balkonach	Essive
czułbym	None
bizonom	Dative
szpitalom	Dative
rządzę	None
okoń	Nominative
aptekarzem	Instrumental
szacunkach	Essive
umrą	None
hamować	None
fundacjom	Dative
budzików	Genitive
zakładajmy	None
dwusuwami	Instrumental
gaście	None
porozmawiaj	None
podejrzewając	None
grzechów	Genitive
zapożyczeniami	Instrumental
krakaliśmy	None
arkadami	Instrumental
komentował	None
kazirodztwa	Genitive
krakusami	Instrumental
wyznaczenie	None
wspólnymi	Instrumental
czasopismu	Dative
spiskach	Essive
układem	Instrumental
grusz	Genitive
programistami	Instrumental
jury	Genitive
migawkę	Accusative
latarka	Nominative
włamaniami	Instrumental
działaczka	Nominative
gwiazdka	Nominative
zawarlibyście	None
województwu	Dative
trzymaliśmy	None
europu	Genitive
wyjaśnili	None
burząc	None
bankrutuje	None
wnuk	Nominative
odbierał	None
zerowaliśmy	None
wymiernymi	Instrumental
kryteriach	Essive
Macedonko	Vocative
piłka	Nominative
terrorystą	Instrumental
napisałeś	None
grzybobrań	Genitive
wylogowaniami	Instrumental
sytuację	Accusative
Polakach	Essive
kozojebcami	Instrumental
przestępcach	Essive
antygenowi	Dative
komórkami	Instrumental
pożyczyłaby	None
dziennikarzom	Dative
kwiaciarnia	Nominative
zauważ	None
kartonami	Instrumental
keratynę	Accusative
śniący	None
zimowymi	Instrumental
połową	Instrumental
tabloidem	Instrumental
serami	Instrumental
tęsknię	None
kantów	Genitive
przyjmują	None
idealni	Nominative
zapraszało	None
aptekarska	Nominative
oskarżali	None
pestkowców	Genitive
uciekinierom	Dative
sprawdzając	None
graniach	Essive
atakowali	None
skazańcami	Instrumental
wybuchając	None
dumała	None
ćmo	Vocative
internatach	Essive
siatkami	Instrumental
centrami	Instrumental
dandys	Nominative
wiśnią	Instrumental
znieczuleniem	Instrumental
nosów	Genitive
biograficznymi	Instrumental
zrabowanie	None
parkuj	None
mżawką	Instrumental
mieczowi	Dative
imitację	Accusative
najsilniejsza	Nominative
politologiem	Instrumental
źli	Nominative
przeglądu	Genitive
znajdujący	None
wywołałoby	None
agrafkę	Accusative
klatek	Genitive
miodowi	Nominative
słynąca	None
potwierdzający	None
sprzyjanie	None
przechodniami	Instrumental
pisaliśmy	None
otruci	None
czekoladę	Accusative
wzięły	None
obalono	None
zatrwianowi	Dative
skowronków	Genitive
ikonostasom	Dative
ranem	Instrumental
rozbierania	Genitive
śliwo	Vocative
olano	None
rządzić	None
kasynami	Instrumental
przeleciane	None
akcentach	Essive
pluję	None
przeszkadzaliście	None
skazała	None
paskala	Genitive
programistach	Essive
malowaniom	Dative
sukienkach	Essive
supermarketowi	Dative
kąsane	None
dżokerach	Essive
sztormu	Genitive
psychuszkami	Instrumental
rurę	Accusative
zapraszające	None
następnikach	Essive
pieluchach	Essive
bywalcom	Dative
scen	Genitive
nazywałem	None
aspektowi	Dative
flota	Nominative
mordując	None
upartymi	Instrumental
meteorach	Essive
ogórkach	Essive
bodzie	Essive
szybsza	Nominative
cyrkowa	Nominative
stołów	Genitive
grota	Nominative
orzecznikach	Essive
królikami	Instrumental
obowiązkiem	Instrumental
źródłosłowu	Genitive
zawrę	None
koszyków	Genitive
wnioskach	Essive
broszurach	Essive
burzące	None
fałszerz	Nominative
prawdopodobna	Nominative
podwieczorka	Genitive
rytmu	Genitive
monogramom	Dative
zamykane	None
bankiem	Instrumental
pasierbowi	Dative
cielętach	Essive
usterek	Genitive
rakowi	Dative
bliska	Nominative
felietonami	Instrumental
denerwował	None
tratw	Genitive
bazyliką	Instrumental
organizacjach	Essive
misjonarzowi	Dative
estetycznymi	Instrumental
działałeś	None
irlandzcy	Nominative
wynajęła	None
emporiom	Dative
jemeńscy	Nominative
potwierdziłaby	None
hipotezach	Essive
bananach	Essive
analogią	Instrumental
dworcowi	Dative
świdrów	Genitive
czytałeś	None
tekściarz	Nominative
tabliczkom	Dative
strzelać	None
drażniąca	None
rówieśnikami	Instrumental
przymierzalnię	Accusative
domkach	Essive
dedykując	None
przestępstwem	Instrumental
arką	Instrumental
tlenie	None
radzili	None
pupę	Accusative
erotyczna	Nominative
rzeczone	None
pokrywający	None
terapię	Accusative
seryną	Instrumental
kierowi	Dative
podaj	None
wykrwawiła	None
zwyczajowi	Dative
gówien	Genitive
gronostajów	Genitive
dechami	Instrumental
żąda	None
skarbcach	Essive
strajkach	Essive
zmieniły	None
termodynamicznymi	Instrumental
spieszmy	None
eksperymentach	Essive
sierpniowa	Nominative
uzależnieniom	Dative
papa	Nominative
przeinaczone	None
kojące	None
kupię	None
odbijać	None
ciekłbym	None
tama	Nominative
spieszy	None
luksa	Genitive
czekające	None
zwu	Genitive
wioskę	Accusative
fantach	Essive
ostrzeżeniom	Dative
wyruchajmy	None
smokingów	Genitive
malinowa	Nominative
żartować	None
bojając	None
pojaw	None
zrzuciła	None
jaśminowcom	Dative
personifikacją	Instrumental
najebana	Nominative
odpoczywałabym	None
synonimowi	Dative
akademio	Vocative
przypominałby	None
zrobiłoby	None
atomów	Genitive
ogonkowi	Dative
stracilibyście	None
obserwuj	None
próbówko	Vocative
niebem	Instrumental
niebytu	Genitive
kręcący	None
zawarły	None
abstrakcją	Instrumental
basenów	Genitive
morderstwach	Essive
wielkopolska	Nominative
rozumów	Genitive
soboli	Genitive
egzonimów	Genitive
wyglądałeś	None
uderzała	None
opowiadam	None
mylicie	None
komitetem	Instrumental
śmiejący	None
uważać	None
jonami	Instrumental
kuleczkach	Essive
lansu	Genitive
łaknąć	None
ofiarę	Accusative
zadały	None
domenach	Essive
guziczków	Genitive
rachunkach	Essive
oszustom	Dative
buddystkami	Instrumental
Węgrem	Instrumental
łyżkach	Essive
czytelnikom	Dative
jadaliby	None
ubrań	Genitive
kaznodzieja	Nominative
pisanek	Genitive
zamykany	None
kciukami	Instrumental
jądrowa	Nominative
sidle	Essive
kruszcem	Instrumental
kopiując	None
wyświetlalibyśmy	None
podatnymi	Instrumental
tonowi	Dative
wielomianem	Instrumental
wywołają	None
dymasz	None
grabili	None
pędów	Genitive
wybiegom	Dative
dostawały	None
liniowi	Nominative
gębą	Instrumental
rolnikami	Instrumental
popełnimy	None
oszukała	None
kuchenka	Nominative
rozważamy	None
sekundami	Instrumental
afirmacją	Instrumental
szatnię	Accusative
zeznań	Genitive
palarnia	Nominative
zostawiła	None
niesprawiedliwymi	Instrumental
unicestwiona	None
dodawaj	None
słuchasz	None
szczenięcia	Genitive
otchłaniach	Essive
nomado	Vocative
podpisałem	None
zupę	Accusative
grzebią	None
edytujące	None
niedźwiedzicach	Essive
zbiorą	None
polimerom	Dative
robiąc	None
ogórkowa	Nominative
tancerzami	Instrumental
odwiedzający	None
stróżach	Essive
skarpetkach	Essive
spieszący	None
zabalsamowana	None
czarno-biała	Nominative
notowany	None
wyspą	Instrumental
sokowi	Dative
tęsknić	None
współpraca	Nominative
ciemienia	Genitive
napletkowi	Dative
śpieszylibyście	None
okapami	Instrumental
kont	Genitive
hiperboliczna	Nominative
przypominałoby	None
sraliście	None
sypie	None
przemyśli	None
miauczą	None
ogolilibyście	None
roślinożercą	Instrumental
utworom	Dative
płatkach	Essive
ogolić	None
twórco	Vocative
węższymi	Instrumental
starcza	Nominative
poprowadzili	None
erytrocytach	Essive
wielokątach	Essive
adresatom	Dative
arginina	Nominative
kolejkami	Instrumental
pojawiwszy	None
łatę	Accusative
nadgarstkiem	Instrumental
jedynymi	Instrumental
oddaj	None
fizycznymi	Instrumental
czyści	Nominative
kryzysem	Instrumental
traktowała	None
Angielko	Vocative
tygrysom	Dative
spotkani	None
sępami	Instrumental
albom	Dative
pytaniach	Essive
złoczyńcom	Dative
tępi	Nominative
mrozach	Essive
akordeonistka	Nominative
mosiężna	Nominative
niepotrzebna	Nominative
Żydówkami	Instrumental
znamion	Genitive
bandach	Essive
prezerwatywom	Dative
kaszle	None
antynomizmowi	Dative
majówkę	Accusative
bielsi	Nominative
wyjąca	None
szczuplejsza	Nominative
miazgę	Accusative
badani	None
rujo	Vocative
brudzenie	None
kółkach	Essive
milczały	None
mumię	Accusative
piekarniami	Instrumental
czyścimy	None
rozważam	None
herbu	Genitive
zbiorowi	Dative
nogami	Instrumental
oceniłabym	None
basach	Essive
jaskółka	Nominative
obrazach	Essive
wioską	Instrumental
przeprowadzali	None
egzonimem	Instrumental
sztandarów	Genitive
ślubami	Instrumental
odraczając	None
okostnym	Dative
otworzył	None
kredytach	Essive
lubimy	None
dochodami	Instrumental
księże	Vocative
celownikom	Dative
przyjmijmy	None
rachunków	Genitive
złapię	None
Waldkom	Dative
homoseksualisty	Genitive
rurą	Instrumental
kramom	Dative
mięsna	Nominative
księżniczek	Genitive
Celtach	Essive
wiosłowałyśmy	None
przepiórka	Nominative
kolca	Genitive
archipelagami	Instrumental
świeco	Vocative
ostryg	Genitive
przedsiębiorstw	Genitive
odpowiadają	None
żeglarkom	Dative
praczka	Nominative
amplitudę	Accusative
albo	Vocative
Włoszką	Instrumental
wesprą	None
próbować	None
cudzołożące	None
marchewnikami	Instrumental
uznający	None
bratkowi	Dative
sprawdziłbyś	None
hymnami	Instrumental
okazało	None
jodłowymi	Instrumental
Atarynko	Vocative
alej	Genitive
ruszający	None
cukiernikom	Dative
turecka	Nominative
pianach	Essive
surówkach	Essive
szaleni	Nominative
najczytelniejsza	Nominative
magnetowidu	Genitive
szybsi	Nominative
bodźców	Genitive
spodziewa	None
siniakowi	Dative
pokazała	None
podczerwona	Nominative
myśliwcem	Instrumental
patriotko	Vocative
wyraźni	Nominative
propagandę	Accusative
gospodarstwem	Instrumental
teksu	Genitive
gadane	None
marach	Essive
oszukałbym	None
protein	Genitive
uwagami	Instrumental
sensem	Instrumental
dodałby	None
mundurkiem	Instrumental
kadetach	Essive
złymi	Instrumental
stawiałyście	None
wyszukiwarkach	Essive
tatuażami	Instrumental
grabarzem	Instrumental
ustawka	Nominative
alfabetycznymi	Instrumental
planetom	Dative
przestępczościom	Dative
lewakiem	Instrumental
uczuciach	Essive
pierestrojka	Nominative
pseudonimach	Essive
internetowymi	Instrumental
pracowita	Nominative
najszybsza	Nominative
możliwościom	Dative
środowiskom	Dative
obrabowany	None
żartuj	None
krtaniowi	Nominative
szukasz	None
grilla	Genitive
pismami	Instrumental
pornograficzna	Nominative
równinami	Instrumental
wybuchała	None
powtórzone	None
stawiało	None
mierząc	None
najlojalniejsza	Nominative
zamordowały	None
dwunastnicę	Accusative
osobowością	Instrumental
przeglądarko	Vocative
mędrcem	Instrumental
marka	Nominative
nękany	None
śnią	None
częstokołowi	Dative
ciąż	Genitive
rzekłyśmy	None
syropów	Genitive
czytało	None
sierotach	Essive
komunistą	Instrumental
wezmą	None
sędzin	Genitive
egzotyczni	Nominative
wiaduktów	Genitive
cytryną	Instrumental
wracał	None
redakcją	Instrumental
sporem	Instrumental
wapnie	Essive
umawiają	None
okiennymi	Instrumental
hydrantu	Genitive
pozorami	Instrumental
sułtanowi	Dative
noszach	Essive
inteligencjach	Essive
oddechowi	Dative
parestezjom	Dative
placom	Dative
szajb	Genitive
deseniami	Instrumental
cewkach	Essive
dedykowali	None
hipis	Nominative
cukru	Genitive
obciążający	None
abonamentu	Genitive
ruń	None
policzka	Genitive
przedramienia	Genitive
mechanizmów	Genitive
potwierdzały	None
temperaturach	Essive
padały	None
amuletach	Essive
masą	Instrumental
wyprowadzeniem	Instrumental
egzorcyzmu	Genitive
uzdom	Dative
zmień	None
impresjonizmowi	Dative
eksportowałoby	None
optymizmu	Genitive
wschodnimi	Instrumental
zaufałem	None
oszustwom	Dative
kurnikiem	Instrumental
labiryntem	Instrumental
burundyjscy	Nominative
równociągła	Nominative
leszczynom	Dative
zaganiaczowi	Dative
proroctwami	Instrumental
pobrało	None
faktach	Essive
Rzymianom	Dative
rozmowami	Instrumental
organizacją	Instrumental
zadaniom	Dative
negacjo	Vocative
kosiłybyście	None
elfia	Nominative
połączyłeś	None
szabatom	Dative
peronach	Essive
sługusami	Instrumental
mewach	Essive
znaczący	None
kobyłą	Instrumental
dwunastnicą	Instrumental
cykli	Genitive
dramatu	Genitive
obojętnymi	Instrumental
poetą	Instrumental
uciekam	None
wiosłujące	None
sytuacjach	Essive
szczucie	None
badem	Instrumental
wdychajcie	None
sikorach	Essive
gili	Genitive
haubicom	Dative
uwielbiali	None
obrabowano	None
testach	Essive
wskazywała	None
rymach	Essive
tropów	Genitive
faraonami	Instrumental
linijkom	Dative
autochtonicznymi	Instrumental
otaczanie	None
dowiecie	None
obsesją	Instrumental
czereśnia	Nominative
makiem	Instrumental
grzęzłoby	None
graniami	Instrumental
buntu	Genitive
basenami	Instrumental
poetką	Instrumental
śledzenie	None
wazonach	Essive
bawiący	None
dozorem	Instrumental
marli	None
spodenek	Genitive
nastawić	None
błyskałyście	None
beżowi	Nominative
irlandzkimi	Instrumental
matówkę	Accusative
broszko	Vocative
wiklinami	Instrumental
kursami	Instrumental
sabotowałem	None
szarlotkach	Essive
potrzebom	Dative
okazałoby	None
identyfikuje	None
klasycyzmowi	Dative
zmywarkach	Essive
sadza	Nominative
wzięliście	None
licealistka	Nominative
kamerom	Dative
ostrzegam	None
szybszymi	Instrumental
odbiornikiem	Instrumental
przyjąłeś	None
leucynami	Instrumental
amplitudami	Instrumental
stracone	None
fryzurami	Instrumental
cegiełka	Nominative
wytłumaczyli	None
przypomnieć	None
przekonań	Genitive
prezentacjami	Instrumental
wapieniach	Essive
wilkom	Dative
dwoista	Nominative
filarom	Dative
gałka	Nominative
rykiem	Instrumental
próbowałem	None
morzami	Instrumental
tektoniczna	Nominative
pokażcie	None
mościami	Instrumental
broniłeś	None
formalni	Nominative
siekaczy	Genitive
kielicha	Genitive
pionowymi	Instrumental
hulajnoga	Nominative
faryzeuszami	Instrumental
obraża	None
sukcesach	Essive
astronomach	Essive
trzebimy	None
gryzienie	None
cytatów	Genitive
smarami	Instrumental
zakupami	Instrumental
cofał	None
watów	Genitive
wyścigów	Genitive
zaczekalibyśmy	None
cięciw	Genitive
pępka	Genitive
aulach	Essive
przeglądarkom	Dative
lingwistę	Accusative
zmieniłoby	None
obiecujesz	None
marakuję	Accusative
treścią	Instrumental
maskując	None
chwaliły	None
odległościom	Dative
łapano	None
ignorował	None
piłami	Instrumental
nóżkach	Essive
przyjęły	None
znajdowałem	None
wesprzyj	None
współczesnymi	Instrumental
druhami	Instrumental
koktajlem	Instrumental
burza	Nominative
cofana	None
świerszczami	Instrumental
pomiarów	Genitive
odlotach	Essive
Katalończykiem	Instrumental
ekwilibrystkach	Essive
akumulatorami	Instrumental
rozmawiają	None
nurkująca	None
pręgami	Instrumental
octanów	Genitive
rozwiązałby	None
montownia	Nominative
przeczytany	None
substancjach	Essive
nihilistami	Instrumental
odrzuciwszy	None
adopcja	Nominative
zerżnęliście	None
zazdrościć	None
zgrubieniami	Instrumental
odebrali	None
papierowa	Nominative
krynicę	Accusative
generałom	Dative
glacjalna	Nominative
kakaowca	Genitive
grzebiemy	None
umarcie	None
odbudowany	None
systemów	Genitive
partiach	Essive
piętrze	Essive
haremu	Genitive
biletów	Genitive
szminkach	Essive
włoska	Nominative
bulwkach	Essive
schizofrenią	Instrumental
rozmyślałybyście	None
narzędziami	Instrumental
godzina	Nominative
ciasna	Nominative
łapany	None
pogrzebałem	None
dobyłyby	None
półkolistymi	Instrumental
ruszało	None
księżyców	Genitive
czai	None
wybierając	None
słonkę	Accusative
używam	None
szczuplejszymi	Instrumental
masowców	Genitive
luźni	Nominative
rozwiążą	None
szybkością	Instrumental
spodziewająca	None
wspominałyście	None
powierzchniach	Essive
wełną	Instrumental
mionu	Genitive
obejmowałby	None
usunięty	None
zajęciom	Dative
komplementowi	Dative
zimowi	Nominative
salamandrom	Dative
tatuażach	Essive
rzucony	None
aktuariuszowi	Dative
azurytem	Instrumental
mityczna	Nominative
planetę	Accusative
uważania	Genitive
zrozumiałaś	None
zespołami	Instrumental
golarko	Vocative
certyfikatem	Instrumental
zeszła	Nominative
odchodami	Instrumental
zna	None
reportaży	Genitive
bytowymi	Instrumental
prominentem	Essive
Żydach	Essive
brązówkom	Dative
mazgajami	Instrumental
przędziwami	Instrumental
wymyślony	None
rościecie	None
potu	Genitive
chciwościom	Dative
ściągałam	None
jodłą	Instrumental
klękalibyście	None
indyczek	Genitive
pokonały	None
hydraulicznymi	Instrumental
fletu	Genitive
turystkę	Accusative
wędrowało	None
lodowisk	Genitive
opróżniłoby	None
przemysłowymi	Instrumental
drzew	Genitive
cela	Nominative
unikały	None
fermionom	Dative
nadzorowali	None
ketchupach	Essive
długopisem	Instrumental
zgubienie	None
obrotowi	Dative
propozycję	Accusative
duszą	Instrumental
Anglik	Nominative
informatykach	Essive
pszenżytu	Dative
faszysta	Nominative
cyborgach	Essive
podchodziliśmy	None
tęsknotach	Essive
kurteczko	Vocative
okazom	Dative
Indiankach	Essive
kłóciłaby	None
hierarchę	Accusative
produktów	Genitive
wzwodom	Dative
kreaturom	Dative
Słowenka	Nominative
kronikarzowi	Dative
pnący	None
reakcjami	Instrumental
zaufanie	None
sprawdzał	None
liżą	None
turystyka	Nominative
wyrzutniami	Instrumental
maskę	Accusative
bek	Genitive
linijkami	Instrumental
konsekwencja	Nominative
śmieciami	Instrumental
hełmom	Dative
plusami	Instrumental
paśnikom	Dative
milicją	Instrumental
antenami	Instrumental
zasad	Genitive
kolejkę	Accusative
śmierdzący	None
demoniczna	Nominative
kucami	Instrumental
dworców	Genitive
mitozach	Essive
jednorożców	Genitive
podatkowa	Nominative
opiniach	Essive
dysydent	Nominative
rósł	None
nuto	Vocative
potoków	Genitive
różniczkowaniem	Instrumental
oharów	Genitive
weseli	Nominative
klimatologią	Instrumental
przepisami	Instrumental
rozmyła	None
pisałbym	None
oglądaj	None
cytatu	Genitive
słomy	Genitive
spróbowałbym	None
marszandem	Instrumental
prądu	Genitive
filmując	None
protekcję	Accusative
rozgrzeszyłybyśmy	None
pigwa	Nominative
uzasadnień	Genitive
warunkom	Dative
ruszył	None
cytowało	None
ziemia	Nominative
scenach	Essive
splądrowałaby	None
śrub	Genitive
łasicach	Essive
nieprzyjemnymi	Instrumental
chwaliło	None
tarka	Nominative
puzonu	Genitive
kozicę	Accusative
dysydentem	Instrumental
przestronnymi	Instrumental
abonamentów	Genitive
elektronami	Instrumental
animacjami	Instrumental
szalona	Nominative
głosowały	None
podrywałyśmy	None
szukaliśmy	None
robotą	Instrumental
komentujący	None
tracimy	None
dachówkom	Dative
stresami	Instrumental
skrzypiące	None
motyl	Nominative
proponowała	None
odbiornikowi	Dative
ustaw	Genitive
pączkom	Dative
świadomymi	Instrumental
otwarto	None
Szwajcar	Nominative
czerwcowymi	Instrumental
grzechotko	Vocative
poleca	None
katolami	Instrumental
zachowaniach	Essive
skrzel	Genitive
przestrzega	None
husytom	Dative
próbuj	None
herbatka	Nominative
studiuje	None
stawiana	None
słyszalnymi	Instrumental
siogunów	Genitive
synonimu	Genitive
emiratów	Genitive
dzierż	None
plotkowano	None
wulkanizmu	Genitive
prefekturach	Essive
naprawiać	None
wołały	None
bizonem	Instrumental
grafikach	Essive
kwazicząstkach	Essive
rafandynkę	Accusative
numeryczna	Nominative
dosięgnięta	None
zapominać	None
lojalnymi	Instrumental
skazał	None
miewają	None
wydupczyła	None
anakonda	Nominative
głosując	None
hrabiemu	Dative
sekundach	Essive
szprych	Genitive
badające	None
czerpano	None
feniksach	Essive
romantyczna	Nominative
hiraganą	Instrumental
sinologię	Accusative
sprzedania	Genitive
psychoterapeutka	Nominative
fenickimi	Instrumental
warszawki	Genitive
zdobiąca	None
oporu	Genitive
szajsom	Dative
płomykówkach	Essive
adekwatnymi	Instrumental
przedstawieniem	Instrumental
ocalić	None
jaworami	Instrumental
dyszom	Dative
wyższa	Nominative
pomyłką	Instrumental
ostrzegają	None
pistoletami	Instrumental
scenarzystami	Instrumental
niedźwiedzica	Nominative
łżach	Essive
ustawom	Dative
metalurgiczni	Nominative
sztormów	Genitive
imiesłowem	Instrumental
skurczom	Dative
scenom	Dative
niewolnikach	Essive
gustowi	Dative
szczurom	Dative
much	Genitive
oprowadzania	Genitive
dokonasz	None
smół	Genitive
cysteinę	Accusative
mieszająca	None
krypta	Nominative
prenumerata	Nominative
siedzisz	None
odpoczywają	None
poligamistami	Instrumental
stadu	Dative
płetwę	Accusative
tatusiom	Dative
pierdziałbym	None
wieńcach	Essive
fletami	Instrumental
aktorkę	Accusative
otacza	None
ukryły	None
sapał	None
optymistko	Vocative
bawię	None
nadepnie	None
jednowymiarowa	Nominative
siarkowymi	Instrumental
rozsadzajmy	None
wziąłby	None
schorzeniom	Dative
tropem	Instrumental
deskarz	Nominative
włącza	None
ślinę	Accusative
faktów	Genitive
kliką	Instrumental
chwastach	Essive
trwając	None
uczęszczałaś	None
ojczysta	Nominative
strzałka	Nominative
lingwista	Nominative
szeptem	Instrumental
przypomni	None
kanałowi	Dative
wyjaśniali	None
dziewczyno	Vocative
skórach	Essive
prawnicza	Nominative
podniesiemy	None
onomatopeję	Accusative
dziwkami	Instrumental
oddając	None
płyta	Nominative
awarię	Accusative
przypomniały	None
łopatami	Instrumental
rowerzystka	Nominative
zaczęły	None
katalońscy	Nominative
steganografio	Vocative
oddający	None
szaleńcach	Essive
akcentów	Genitive
proponujemy	None
zapali	None
radiowa	Nominative
zgubiliby	None
stokrotkom	Dative
chochlików	Genitive
szabatu	Genitive
chatkę	Accusative
bujniejsi	Nominative
logiczni	Nominative
kontrolowana	None
automatyczni	Nominative
prawymi	Instrumental
rzeczką	Instrumental
ignorowana	None
strzelano	None
stawały	None
nakrycie	None
kumałbyś	None
rzuci	None
pazurach	Essive
chowają	None
koncertu	Genitive
kwadransów	Genitive
przeprowadzało	None
kremem	Instrumental
feniksom	Dative
refowałaby	None
imadłom	Dative
dziękuje	None
armata	Nominative
rotorach	Essive
deistach	Essive
nerwów	Genitive
licytację	Accusative
ciężka	Nominative
niepozornymi	Instrumental
linijką	Instrumental
równina	Nominative
tyrozynami	Instrumental
mikrofonu	Genitive
politeistyczni	Nominative
oglądające	None
wytłumaczona	None
sprzątnęłybyście	None
śmierdziało	None
dokonywana	None
potwierdź	None
strzykawkę	Accusative
wyjaśniono	None
lansowaliby	None
praczek	Genitive
haka	Genitive
ubezpieczeń	Genitive
kapel	Genitive
pogromów	Genitive
monarchistami	Instrumental
dosięgnie	None
gabinetów	Genitive
okazicielem	Instrumental
zatok	Genitive
identyfikować	None
