virrad	Third person Singular
befekteted	Second person Singular
odafigyeltünk	First person Plural
igazadnak	None
megrémüljenek	Third person Plural
elkészítek	First person Singular
elhelyezésként	None
bekennünk	First person Plural
süvegeljünk	First person Plural
hitelesítették	Third person Plural
engedélyezett	Third person Singular
versenyzett	Third person Singular
táplálnod	Second person Singular
egyszerűsítettek	Third person Plural
kanyarog	Third person Singular
akadályoz	Third person Singular
kihúzott	Third person Singular
felszabadítsák	Third person Plural
zongoraversenyben	None
erősödünk	First person Plural
szórakoztok	Second person Plural
előállítják	Third person Plural
standardizált	Third person Singular
gátol	Third person Singular
ragasztják	Third person Plural
kiindultunk	First person Plural
mosolyogsz	Second person Singular
fúl	Third person Singular
negligálnotok	Second person Plural
parkhoz	None
kölcsönzött	Third person Singular
megnyugodtam	First person Singular
ellipszist	None
keresztlánnyal	None
bemutatta	Third person Singular
könyörögtek	Third person Plural
barátságnál	None
feladta	Third person Singular
szobrászokat	None
éghajlatról	None
szüntessék	Third person Plural
beints|or|	Second person Singular
kimegyek	First person Singular
megnéztünk	First person Plural
tanúskodik	Third person Singular
közlekednek	Third person Plural
álmodtam|	First person Singular
felfüggesszék	Third person Plural
lovagolnak	Third person Plural
nevezők	None
szerkesztetek	Second person Plural
épületnél	None
megbocsátják	Third person Plural
szórtatok	Second person Plural
csöngjem|	First person Singular
kompromittált	Third person Singular
ágyúzz|or|	Second person Singular
szerkesszek	First person Singular
kezdeményeznetek	Second person Plural
nyilvánulnotok	Second person Plural
dagonyáznék	First person Singular
tisztázta	Third person Singular
elhúztak	Third person Plural
hivatkozzanak	Third person Plural
befejeződjünk	First person Plural
lassítsanak	Third person Plural
sérted	Second person Singular
áltasson	Third person Singular
felnéznek	Third person Plural
fejleszt	Third person Singular
szokás	None
világosodtam	First person Singular
kerekítettük	First person Plural
félti	Third person Singular
enciklopédiának	None
bánnak	Third person Plural
motiváltak	Third person Plural
válaszoljatok	Second person Plural
megfejtse	Third person Singular
pusztításról	None
veszítsünk	First person Plural
összessége	None
szögsebességgel	None
elektromágnesnél	None
űrszondákba	None
elektromosságról	None
csodálkoznak	Third person Plural
bűnözésről	None
délen	None
módosítja	Third person Singular
akadtatok	Second person Plural
lefoglalt	Third person Singular
sorolná	Third person Singular
kerítenie	Third person Singular
megbocsátotta	Third person Singular
íródik	Third person Singular
teremtik	Third person Plural
partnereként	None
intrikáljatok	Second person Plural
koncentrálunk	First person Plural
információval	None
hirdessük	First person Plural
megverje	Third person Singular
utánoz	Third person Singular
elkezdjenek	Third person Plural
fiatalokból	None
cicára	None
fejlesztjük	First person Plural
elkülönítik	Third person Plural
méz	None
elviselték	Third person Plural
dörzsölték	Third person Plural
szárinak	None
kedveztünk	First person Plural
asztronómiában	None
megértené	Third person Singular
bekenik	Third person Plural
kiinduljanak	Third person Plural
színeznek	Third person Plural
megtestesülés	None
szorosabbakig	None
amerikainak	None
méréshez	None
hazájával	None
szövetségében	None
kiengedjék	Third person Plural
mérgezik	Third person Plural
importálták	Third person Plural
kiadjon	Third person Singular
lebegjen	Third person Singular
tanulunk	First person Plural
megértette	Third person Singular
előfizessetek	Second person Plural
csókolna	Third person Singular
dobáltok	Second person Plural
felszerelték	Third person Plural
ábécék	None
végétől	None
vitatkoztatok	Second person Plural
újjászülető	None
változatokat	None
vonakodik	Third person Singular
hallgatta	Third person Singular
fojt	Third person Singular
kihalnak	Third person Plural
elgázolták	Third person Plural
üldözte	Third person Singular
játszódott	Third person Singular
könyörög	Third person Singular
kétségbeesett	None
tagadtam	First person Singular
reménye	None
ketyegek	First person Singular
elkísérte	Third person Singular
kortyolniuk	Third person Plural
körbevette	Third person Singular
kiállítják	Third person Plural
többnejűséget	None
szűnik	Third person Singular
kalandokat	None
adóhatósággal	None
gyökerezz|or|	Second person Singular
erős	None
vágyódtál	Second person Singular
kedvelik	Third person Plural
lepra	None
vasgyárral	None
fázistól	None
adoptálta	Third person Singular
intézkedésről	None
elgázolnotok	Second person Plural
hangszerelne	Third person Singular
válaszolnom	First person Singular
vívjon	Third person Singular
pogányokkal	None
amerikaiaktól	None
villannak	Third person Plural
grófként	None
felülvizsgálatáról	None
helyüket	None
megvizsgálták	Third person Plural
perdül	Third person Singular
előfizetett	Third person Singular
lélegzett	Third person Singular
ismertessék	Third person Plural
kérdezel	Second person Singular
áradatoknál	None
emulziókkal	None
intrikált	Third person Singular
elemzéseket	None
megtudniuk	Third person Plural
kijelentettem	First person Singular
kisasszonnyal	None
jegyzetelnéd	Second person Singular
átlássanak	Third person Plural
szerájban	None
mamuszt	None
bűncselekményekben	None
letöltsd|or|	Second person Singular
lélekkel	None
veszélyekre	None
duzzad	Third person Singular
tiltod	Second person Singular
konspirált	Third person Singular
levetkőznek	Third person Plural
kijavította	Third person Singular
világosodott	Third person Singular
rögzítsük	First person Plural
tartózkodnia	Third person Singular
szabadalmakról	None
elfogta	Third person Singular
fóbiában	None
irányítaná	Third person Singular
tollban	None
nyomoznom	First person Singular
részesítsék	Third person Plural
papajákká	None
soroltam	First person Singular
kifejlesztik	Third person Plural
fotózásra	None
múljon	Third person Singular
üdvözli	Third person Singular
kezelniük	Third person Plural
konstruálnám|	First person Singular
keresztnéven	None
ellenőrzött	Third person Singular
lapomról	None
zajtalanabbakból	None
megtekinted	Second person Singular
felülíró	None
szépítette	Third person Singular
elvesztettek	Third person Plural
alkoholmentesekért	None
hódítottak	Third person Plural
farban	None
felhasználtuk	First person Plural
reálisakhoz	None
frissülnie	Third person Singular
terapeutának	None
sterilizáljanak	Third person Plural
suhogjak	First person Singular
idegesítette	Third person Singular
megmentik	Third person Plural
utánanézek	First person Singular
megrendelték	Third person Plural
feltételezné	Third person Singular
dörzsölt	Third person Singular
papírpénzt	None
utaltam	First person Singular
járult	Third person Singular
eljuttatnia	Third person Singular
konstatálok	First person Singular
gyöngyvirágoknál	None
vitatkozol	Second person Singular
vontatnak	Third person Plural
titkosítja	Third person Singular
ismétlődött	Third person Singular
összehasonlítsunk	First person Plural
eszévé	None
magazinhoz	None
megöljék	Third person Plural
szabadalmaztatták	Third person Plural
győzelembe	None
vádolnak	Third person Plural
elfelejtettem	First person Singular
bolyhnál	None
megkezdenie	Third person Singular
kopognunk	First person Plural
spekuláltak	Third person Plural
egyezzen	Third person Singular
nőgyűlöletre	None
kommunikálsz	Second person Singular
nyílik	Third person Singular
helyreállítottak	Third person Plural
meglássa	Third person Singular
kitöltöttem	First person Singular
sütik	Third person Plural
igényelnem	First person Singular
kerülgesd|or|	Second person Singular
felejt	Third person Singular
aláír	Third person Singular
kánnal	None
mesélje	Third person Singular
utasítottak	Third person Plural
kadmiummal	None
gyökereznek	Third person Plural
nyilatkozott	Third person Singular
letölti	Third person Singular
fertőtlenítik	Third person Plural
összegyűlnek	Third person Plural
elkezdődik	Third person Singular
elillannotok	Second person Plural
ankétok	None
császárpingvinekbe	None
továbbfejlesztették	Third person Plural
katedrálisra	None
éremben	None
megnézed	Second person Singular
megértitek	Second person Plural
visszamentünk	First person Plural
elkövetett	Third person Singular
kijelöli	Third person Singular
megengedtetnék	First person Singular
megoldania	Third person Singular
megvásárol	Third person Singular
szellőztetik	Third person Plural
kiválasztotta	Third person Singular
sérülne	Third person Singular
tönkretették	Third person Plural
idegesként	None
felfüggessze	Third person Singular
fénytől	None
korlátoznia	Third person Singular
ellentmond	Third person Singular
visszaesett	Third person Singular
terrorizálták	Third person Plural
ürül	Third person Singular
túllépi	Third person Singular
beint	Third person Singular
elveszne	Third person Singular
átkozta	Third person Singular
csontnak	None
virult	Third person Singular
sütőben	None
tonnára	None
ismételnek	Third person Plural
kérésekként	None
vegyülnek	Third person Plural
szitált	Third person Singular
kérdezned	Second person Singular
mozgatnak	Third person Plural
kelmefestők	None
lapítottak	Third person Plural
elvesztetted	Second person Singular
feltöltök	First person Singular
nagybetűvel	None
kompenzál	Third person Singular
zaklassák	Third person Plural
megütötték	Third person Plural
forgalmát	None
aggódnunk	First person Plural
üdvösségben	None
előrehaladt	Third person Singular
ítélünk	First person Plural
bekenjen	Third person Singular
felhívnia	Third person Singular
felkereste	Third person Singular
létesülne	Third person Singular
értékesítse	Third person Singular
bizonyítsa	Third person Singular
konzerválta	Third person Singular
molesztálod	Second person Singular
tanításának	None
hozam	None
kényszeríti	Third person Singular
bőg	Third person Singular
fektetnek	Third person Plural
megfordulnak	Third person Plural
különböztök	Second person Plural
jóváhagytak	Third person Plural
reformáljunk	First person Plural
kellet	Third person Singular
tüntetni	None
áldoz	Third person Singular
elkövetnie	Third person Singular
egészségére	None
filmezték	Third person Plural
beleírok	First person Singular
mellbe	None
szolon	None
beindultatok	Second person Plural
szenátort	None
kleptomániákra	None
megnyilvánul	Third person Singular
merészeltem	First person Singular
viszonyítsuk	First person Plural
bombáztak	Third person Plural
sodródtak	Third person Plural
teáznátok	Second person Plural
fedje	Third person Singular
laparoszkópok	None
megtudjon	Third person Singular
verzióvá	None
fölülír	Third person Singular
határoknak	None
elbújni	None
elindítanak	Third person Plural
boncolnád	Second person Singular
kifejtenie	Third person Singular
költ	Third person Singular
megközelítsek	First person Singular
jelentéstől	None
elkészítettem	First person Singular
elvisel	Third person Singular
eltévedt	Third person Singular
megkövetelné	Third person Singular
befogadnak	Third person Plural
kiállítottak	Third person Plural
felnézek	First person Singular
lógnak	Third person Plural
szülőföldön	None
kihagytuk	First person Plural
hadnaggyal	None
megtartotta	Third person Singular
átneveznem	First person Singular
zarándokot	None
legyőzzék	Third person Plural
átnevezte	Third person Singular
fluktuálnátok	Second person Plural
kabinetről	None
tanúsítja	Third person Singular
teremtek	First person Singular
ürmösbort	None
elbújnék	First person Singular
lamentáljunk	First person Plural
szakosodott	Third person Singular
megvalósítsák	Third person Plural
tisztázzon	Third person Singular
birodalmakból	None
cenzúrázta	Third person Singular
lepted	Second person Singular
tűzhelyre	None
nyíjunk	First person Plural
bevall	Third person Singular
hídként	None
találkozol	Second person Singular
ápolónőtől	None
bájosabbra	None
bedobnál	Second person Singular
ütközött	Third person Singular
megpróbálj|or|	Second person Singular
integrációra	None
verekednek	Third person Plural
megszereznek	Third person Plural
gyászoljatok	Second person Plural
városáról	None
vetít	Third person Singular
rájönne	Third person Singular
szintetizáló	None
ringatja	Third person Singular
fényszórók	None
szeretkezik	Third person Singular
finanszíroztak	Third person Plural
vagonokat	None
henyéltél	Second person Singular
panaszkodnának	Third person Plural
magyaráztam	First person Singular
marokenről	None
blamáltam|	First person Singular
emelkednie	Third person Singular
rejszoljunk	First person Plural
elintéz	Third person Singular
törekedne	Third person Singular
beviszik	Third person Plural
történészekkel	None
hasznosította	Third person Singular
tájolták	Third person Plural
berendezik	Third person Plural
tárgyalnak	Third person Plural
arterioszklerózisokig	None
felmérésével	None
rajokon	None
módosításoktól	None
lejárnál	Second person Singular
amputálták	Third person Plural
jógázzatok	Second person Plural
konzerválni	None
virágzatba	None
ejakulál	Third person Singular
kicseréljünk	First person Plural
árulok	First person Singular
agyonüti	Third person Singular
kattant	Third person Singular
átalakulás	None
sétáltak	Third person Plural
lep	Third person Singular
készíttetnek	Third person Plural
ücsörögnek	Third person Plural
növesztette	Third person Singular
tigrisből	None
portálban	None
kifejlessze	Third person Singular
lassítottunk	First person Plural
teremtsék	Third person Plural
elpusztul	Third person Singular
robbanniuk	Third person Plural
visszavették	Third person Plural
hárfára	None
sportággá	None
ölti	Third person Singular
beállították	Third person Plural
kettősségnek	None
útjáig	None
feltünteti	Third person Singular
lezuhant	Third person Singular
fejlesztették	Third person Plural
megpróbáld|or|	Second person Singular
megfertőz	Third person Singular
erődítményeknek	None
megtesz	Third person Singular
megkaptad	Second person Singular
vértanúkból	None
kéziraton	None
hullákkal	None
fulladnak	Third person Plural
mákgubókkal	None
képeznének	Third person Plural
kimutatta	Third person Singular
beteljesült	Third person Singular
viselkedjen	Third person Singular
ionizálniuk	Third person Plural
koronázták	Third person Plural
taszítson	Third person Singular
előírás	None
lépcsőnek	None
kálváriáktól	None
szárítsuk	First person Plural
levéltárakat	None
megláttam	First person Singular
megítélést	None
megszüntetjük	First person Plural
helyezkedjen	Third person Singular
felruházott	Third person Singular
jógázik	Third person Singular
alkalmazkodnak	Third person Plural
ítélt	Third person Singular
megbüntesse	Third person Singular
folyamaton	None
elbocsátottak	Third person Plural
figyeljenek	Third person Plural
átalakulnak	Third person Plural
visszafejtsen	Third person Singular
undorral	None
aforizmákat	None
elrontottam	First person Singular
akadályozniuk	Third person Plural
ablakon	None
kiegészítenél	Second person Singular
beadott	Third person Singular
megdöglesz	Second person Singular
ésszerűséget	None
lugasokban	None
szédülnie	Third person Singular
levesszük	First person Plural
felfüggeszti	Third person Singular
szerkezetté	None
feküdjön	Third person Singular
meghív	Third person Singular
bántottak	Third person Plural
deizmusok	None
iktatnak	Third person Plural
felébredtem	First person Singular
egyesíti	Third person Singular
személyzethez	None
tárgyalnia	Third person Singular
megjelölnek	Third person Plural
vakulnotok	Second person Plural
áldozott	Third person Singular
indítsunk	First person Plural
elkövet	Third person Singular
felvesz	Third person Singular
sétált	Third person Singular
gyűlölik	Third person Plural
pulzál	Third person Singular
áldozatokhoz	None
megőrizniük	Third person Plural
vartyogtál	Second person Singular
válaszolna	Third person Singular
lepi	Third person Singular
virradt	Third person Singular
kézen	None
sportolóról	None
egyeztetett	Third person Singular
esküdjön	Third person Singular
ruhát	None
dörögtétek	Second person Plural
fáradtak	Third person Plural
varázsolsz	Second person Singular
felszólított	Third person Singular
hegyeknek	None
fütyülök	First person Singular
sztahanovisták	None
lázadóként	None
hegedült	Third person Singular
petével	None
elkészítse	Third person Singular
ünnepnek	None
eladásokon	None
tönk	None
fokozná	Third person Singular
webszerverek	None
megtett	Third person Singular
emberbe	None
aktiváltak	Third person Plural
mecénások	None
húgysav	None
szabotőrbe	None
megnéztétek	Second person Plural
zsorzsettként	None
bosszantott	Third person Singular
zergék	None
örökölt	Third person Singular
kamatra	None
képeznek	Third person Plural
kiszállnak	Third person Plural
dominálunk	First person Plural
szakítsa	Third person Singular
mérésnél	None
teremtene	Third person Singular
hitelességéig	None
tényezővé	None
lépésben	None
keltőkben	None
nyomozok	First person Singular
kéklenék	First person Singular
kognitívakkal	None
rivalizálnak	Third person Plural
kifosztják	Third person Plural
turizmustól	None
töltésével	None
megtörténjetek	Second person Plural
legyőz	Third person Singular
sóvárog	Third person Singular
beleszólnotok	Second person Plural
söpörnek	Third person Plural
fajára	None
sportolok	First person Singular
végrehajtásban	None
inzulin	None
gyönyörűséggel	None
táplálnak	Third person Plural
elfelejtették	Third person Plural
szándékoztátok	Second person Plural
függvényekhez	None
részletezik	Third person Plural
viszonyával	None
felülírnia	Third person Singular
elkészített	Third person Singular
pápáknak	None
éveknél	None
munkatársaihoz	None
meggyújtsátok	Second person Plural
vizsgálnak	Third person Plural
akadozott	Third person Singular
felsoroltak	Third person Plural
kijavítja	Third person Singular
fehérjévé	None
berúg	Third person Singular
lement	Third person Singular
művészetek	None
lezárulnak	Third person Plural
tombolt	Third person Singular
fakítsanak	Third person Plural
szült	Third person Singular
kiválasztása	None
munkájukat	None
birtokolták	Third person Plural
halottra	None
viharokkal	None
kihagytak	Third person Plural
vagyonokat	None
pódiumról	None
értesültem	First person Singular
vasalnék	First person Singular
megosztania	Third person Singular
majmot	None
vigyázol	Second person Singular
éhséggel	None
beépítettem	First person Singular
nevekben	None
készíttette	Third person Singular
zenélt	Third person Singular
tolódtak	Third person Plural
befizette	Third person Singular
összeszednek	Third person Plural
újraválasztok	First person Singular
tükröz	Third person Singular
tervelnek	Third person Plural
látogattak	Third person Plural
vélekednek	Third person Plural
stírolna	Third person Singular
folyamatán	None
munkaruhák	None
frekvenciához	None
borokból	None
merüljön	Third person Singular
hangjegyekkel	None
lappang	Third person Singular
titokká	None
masíroztak	Third person Plural
felszálltak	Third person Plural
kötésekre	None
hurcolt	Third person Singular
fasizmusban	None
címerekre	None
derűvel	None
beindulnál	Second person Singular
kivonulásokon	None
panaszkodnak	Third person Plural
kuriózumot	None
montírozna	Third person Singular
merészelte	Third person Singular
ürességre	None
kicserélik	Third person Plural
ízlésnek	None
beépítse	Third person Singular
társaira	None
diktáljatok	Second person Plural
követelje	Third person Singular
szakosodjunk	First person Plural
megakadályozniuk	Third person Plural
fejlesszük	First person Plural
fedjék	Third person Plural
részleteinek	None
megvásárolhatóig	None
diktáljam|	First person Singular
völgyekben	None
isszuk	First person Plural
erdőről	None
visítsunk	First person Plural
tallóznál	Second person Singular
elhamvasztotta	Third person Singular
elszenvedett	Third person Singular
fektetünk	First person Plural
elveszítettek	Third person Plural
kommunistát	None
bátorítsák	Third person Plural
megkezdődnek	Third person Plural
nehezítette	Third person Singular
rajongtak	Third person Plural
csintalanokról	None
sugároztak	Third person Plural
birtokolta	Third person Singular
feleli	Third person Singular
adományozták	Third person Plural
birtokolnak	Third person Plural
pályáztunk	First person Plural
szivárványt	None
javítanák	Third person Plural
eltelt	Third person Singular
porszerűig	None
kötelezze	Third person Singular
kiábrándítotok	Second person Plural
járőröztek	Third person Plural
hűl	Third person Singular
semlegesítse	Third person Singular
befolyásnak	None
gennyekre	None
keltsek	First person Singular
megállónál	None
bocsásson	Third person Singular
kinyiss|or|	Second person Singular
olívabogyót	None
piramisként	None
minőségére	None
beágyazott	Third person Singular
kézikönyvre	None
száguldottak	Third person Plural
kockáztatja	Third person Singular
egyenlőségről	None
békedíjjal	None
kommunikál	Third person Singular
megismételték	Third person Plural
eltávozásként	None
sétányokkal	None
baszta	Third person Singular
javítsák	Third person Plural
ablakaival	None
alkotná	Third person Singular
magyarosításokkal	None
üzemmódoknak	None
végiggondolt	Third person Singular
agresszivitásokig	None
kávává	None
betegyék	Third person Plural
feleljek	First person Singular
javasolnék	First person Singular
kúszott	Third person Singular
feledhetetlennek	None
kipróbálod	Second person Singular
elhalasztotta	Third person Singular
szakosodnotok	Second person Plural
szaporodjon	Third person Singular
megmentsen	Third person Singular
hágtál	Second person Singular
vesztenek	Third person Plural
előfordulásokra	None
étkezőt	None
vöröshagymától	None
taszította	Third person Singular
zaklatják	Third person Plural
hegycsúcsnak	None
részesítenek	Third person Plural
aszút	None
nyíva	None
vesztegették	Third person Plural
ágytálakkal	None
szerkesszetek	Second person Plural
köztársaságokká	None
piszkálnak	Third person Plural
fűszereznek	Third person Plural
hüllőknek	None
belépünk	First person Plural
utálok	First person Singular
bevezetjük	First person Plural
megütöttétek	Second person Plural
megtaláljanak	Third person Plural
köpet	None
akadna	Third person Singular
kezdeményezzünk	First person Plural
beszállt	Third person Singular
homokórákról	None
ömlik	Third person Singular
tanúsítottak	Third person Plural
borong	Third person Singular
tapasztalok	First person Singular
leégünk	First person Plural
átalakították	Third person Plural
tapasztaltak	Third person Plural
üdvözítik	Third person Plural
elhagysz	Second person Singular
reklámozott	Third person Singular
tükröznie	Third person Singular
visszavonná	Third person Singular
nagyságúnak	None
öltötte	Third person Singular
elfogyna	Third person Singular
zsindelyeztem|	First person Singular
feloszlatják	Third person Plural
alakítottam	First person Singular
kijavítania	Third person Singular
átvettük	First person Plural
bukkantak	Third person Plural
propagandává	None
fogadnék	First person Singular
hozzászólnának	Third person Plural
megölte	Third person Singular
elnevezzétek	Second person Plural
megismételt	Third person Singular
meggyújtották	Third person Plural
elfelejtetted	Second person Singular
kirúgott	Third person Singular
zefír	None
zárójelből	None
javítjuk	First person Plural
elpárologtatott	Third person Singular
kézilabdázott	Third person Singular
bátorítjuk	First person Plural
kritikák	None
birtokba	None
képzelsz	Second person Singular
mozgattam	First person Singular
hírével	None
reprezentálnotok	Second person Plural
táplálkozol	Second person Singular
megfelelne	Third person Singular
rekonstrukciókra	None
kányához	None
bűnökről	None
megjelentetnek	Third person Plural
terrorizmussá	None
visszavontad	Second person Singular
szerelünk	First person Plural
mennyiségből	None
felszerelt	Third person Singular
gondolatokat	None
kifizetik	Third person Plural
gályák	None
kilépjen	Third person Singular
elmulasztott	Third person Singular
szítottak	Third person Plural
rekordként	None
bosszant	Third person Singular
múlik	Third person Singular
nehezíti	Third person Singular
elgondolkodtató	None
vonatoknál	None
eledelt	None
ambíciót	None
emigráltak	Third person Plural
kifejeztem	First person Singular
blogokon	None
lakjanak	Third person Plural
igaza	None
letartóztatja	Third person Singular
fejtünk	First person Plural
harmonizálnak	Third person Plural
megvalósítottak	Third person Plural
fűzőkből	None
eredményezi	Third person Singular
kényszerülünk	First person Plural
kényszerítették	Third person Plural
sebez	Third person Singular
kérelmezték	Third person Plural
diétásra	None
összerakták	Third person Plural
megbeszélnünk	First person Plural
megállapítja	Third person Singular
indexel	Third person Singular
elrepül	Third person Singular
elvégezném|	First person Singular
elsejével	None
helyreállítania	Third person Singular
válaszoltam|	First person Singular
tágított	Third person Singular
levegyem|	First person Singular
gyömbért	None
elvesztették	Third person Plural
szaporodnának	Third person Plural
betenné	Third person Singular
minimálisra	None
izével	None
szakemberként	None
babakocsiig	None
ismertetniük	Third person Plural
megvette	Third person Singular
becsülnünk	First person Plural
elküldené	Third person Singular
komplikáltad	Second person Singular
verseng	Third person Singular
neveztél	Second person Singular
tiltakozunk	First person Plural
menekült	Third person Singular
menekülnie	Third person Singular
kommunikáló	None
erkélyre	None
tartózkodnak	Third person Plural
bérelt	Third person Singular
adoptálnék	First person Singular
szárítja	Third person Singular
metszenek	Third person Plural
hullámtörőkké	None
legegyenletesebbként	None
felhalmozzunk	First person Plural
vízjelekként	None
létrehoz	Third person Singular
képletben	None
hirdetjük	First person Plural
képviseletre	None
elektromágnessel	None
megbünteti	Third person Singular
megosztott	Third person Singular
tájékoztassa	Third person Singular
belépjenek	Third person Plural
idézünk	First person Plural
kínoz	Third person Singular
különbözne	Third person Singular
fogalmazzak	First person Singular
bojkottálták	Third person Plural
frissítendő	None
ellátogatnak	Third person Plural
megérdemled	Second person Singular
emel	Third person Singular
garantírozzak	First person Singular
lassítja	Third person Singular
kibocsátja	Third person Singular
kinevezzék	Third person Plural
rekvirált	Third person Singular
viselkedne	Third person Singular
életrajzokban	None
bírsz	Second person Singular
blamál	Third person Singular
képességeinek	None
előírna	Third person Singular
cimbalmot	None
vakon	None
amatőrnek	None
átkeresztelsz	Second person Singular
térítettétek	Second person Plural
xeroxoztátok	Second person Plural
szilvalekvárokból	None
csipke	None
szülők	None
archiváltak	Third person Plural
idézte	Third person Singular
transzplantált	Third person Singular
fogalmaztak	Third person Plural
ökörnyállal	None
formálsz	Second person Singular
ápolt	Third person Singular
ártson	Third person Singular
szenderült	Third person Singular
felkészüljenek	Third person Plural
extrával	None
domesztikálnunk	First person Plural
dicsér	Third person Singular
megérkeztünk	First person Plural
innovációsakra	None
elkerülték	Third person Plural
hibáiról	None
kavarnának	Third person Plural
megnyitottam	First person Singular
keselyű	None
dinoszauruszokból	None
derültek	Third person Plural
menetelnek	Third person Plural
fogalmaznék	First person Singular
háromévesek	None
villantanunk	First person Plural
szólal	Third person Singular
tárcsázzon	Third person Singular
felújították	Third person Plural
csúcsához	None
semlegesíti	Third person Singular
odavesznek	Third person Plural
vezényelnie	Third person Singular
vizionáltad	Second person Singular
középszerűek	None
megtiltjuk	First person Plural
összekenik	Third person Plural
megígéred	Second person Singular
hangzana	Third person Singular
megfosztanak	Third person Plural
családokért	None
azonosított	Third person Singular
küldötteket	None
hódítsanak	Third person Plural
szabványosítsam|	First person Singular
bemutatnák	Third person Plural
elásta	Third person Singular
megbántották	Third person Plural
ázol	Second person Singular
stadionokba	None
fogyasztott	Third person Singular
burkok	None
gátolta	Third person Singular
úsztak	Third person Plural
jósol	Third person Singular
oszlottak	Third person Plural
eltávolítanak	Third person Plural
fogalmaztam	First person Singular
címünkké	None
erdőbe	None
emlősöket	None
juhokra	None
egészítened	Second person Singular
megválasztják	Third person Plural
tünetet	None
bevezettük	First person Plural
hirdesse	Third person Singular
tolmácsolta	Third person Singular
figyeltem	First person Singular
javításánál	None
megkezdődtek	Third person Plural
világították	Third person Plural
újonc	None
végződött	Third person Singular
hosszúságot	None
gyanakodott	Third person Singular
tenyésztették	Third person Plural
rekvirálj|or|	Second person Singular
őriznek	Third person Plural
gerle	None
megnyerne	Third person Singular
feltöltöttem	First person Singular
cserbenhagyták	Third person Plural
rongyoljanak	Third person Plural
közlekedett	Third person Singular
autójában	None
vicsorítanának	Third person Plural
kínoztok	Second person Plural
tenyésztene	Third person Singular
egyiptológusra	None
kínoztak	Third person Plural
áldotta	Third person Singular
módosítsák	Third person Plural
küzdelmekkel	None
válaszolnak	Third person Plural
nadrágból	None
fertőz	Third person Singular
szembenéz	Third person Singular
bevezesse	Third person Singular
elnyomták	Third person Plural
ürítse	Third person Singular
elviselniük	Third person Plural
funkcióként	None
testápolókból	None
letartóztatják	Third person Plural
kiszabaduljanak	Third person Plural
munkabérek	None
korlátozódjon	Third person Singular
elcsúsztak	Third person Plural
nevezünk	First person Plural
lázadó	None
elképzelte	Third person Singular
szigetelték	Third person Plural
nemzették	Third person Plural
lezárult	Third person Singular
prezentáljak	First person Singular
listáért	None
alkotnia	Third person Singular
nevezzetek	Second person Plural
rejtettbe	None
kiáltják	Third person Plural
érdekét	None
motivált	Third person Singular
rázásban	None
növelik	Third person Plural
elnyerő	None
kelteniük	Third person Plural
kommunikálnak	Third person Plural
fehéret	None
kamuzott	Third person Singular
azonosította	Third person Singular
visszavon	Third person Singular
optimizmusnak	None
érdeklődésének	None
stabilitásokon	None
zamatok	None
hág	Third person Singular
dokumentálnom	First person Singular
megfertőztek	Third person Plural
tétellel	None
körülnézünk	First person Plural
feküdnie	Third person Singular
háziasszony	None
tárolási	None
törődne	Third person Singular
vezérelnek	Third person Plural
garbónál	None
vásárolnia	Third person Singular
megtudna	Third person Singular
hazaérnek	Third person Plural
kompenzálták	Third person Plural
jósolt	Third person Singular
rádöbbenjetek	Second person Plural
metszetek	Second person Plural
határaival	None
hajósoknak	None
vesszen	Third person Singular
tolmácsol	Third person Singular
visszaélne	Third person Singular
támaszkodnia	Third person Singular
megfordultak	Third person Plural
domesztikálták	Third person Plural
jövevények	None
helyzetre	None
virul	Third person Singular
műveinél	None
utalunk	First person Plural
ömlött	Third person Singular
altatóként	None
göndörítettünk	First person Plural
világára	None
elvesztette	Third person Singular
elképzeltem	First person Singular
fiún	None
semlegesít	Third person Singular
taglal	Third person Singular
kitörik	Third person Plural
polgárokról	None
kavarta	Third person Singular
elveszít	Third person Singular
hiányoltam	First person Singular
elmozdítsa	Third person Singular
nyilakból	None
lányomnak	None
vívjanak	Third person Plural
függönyökkel	None
fakaszt	Third person Singular
fejlődniük	Third person Plural
bővítenek	Third person Plural
kifejeznek	Third person Plural
többnyelvűségekbe	None
megcsinálod	Second person Singular
felkértem	First person Singular
beleegyezésen	None
jogosítanod	Second person Singular
blöffölnek	Third person Plural
horkoltam	First person Singular
beverte	Third person Singular
fosztanék	First person Singular
kialakít	Third person Singular
értesültek	Third person Plural
kong	Third person Singular
feltámasztanám|	First person Singular
elküldted	Second person Singular
fűtene	Third person Singular
telepedett	Third person Singular
ápolónak	None
előkészítik	Third person Plural
kutatóközponttá	None
szárítják	Third person Plural
mellékelje	Third person Singular
rehabilitáció	None
zseblámpával	None
malter	None
megszervezik	Third person Plural
fogalmazott	Third person Singular
várakozzon	Third person Singular
megtette	Third person Singular
tölgyfa	None
fegyverszünetet	None
külügyminisztériumot	None
végiggondolniuk	Third person Plural
végzünk	First person Plural
magyaráznom	First person Singular
javasoljanak	Third person Plural
kizsákmányoltam|	First person Singular
hangolta	Third person Singular
beállítanom	First person Singular
felkészült	Third person Singular
vonzóbbakat	None
megszakítja	Third person Singular
tároljanak	Third person Plural
hallgatóból	None
drágul	Third person Singular
villamosozok	First person Singular
boldogult	Third person Singular
továbbította	Third person Singular
kérdezzünk	First person Plural
kamerákkal	None
becsapnak	Third person Plural
terjesztjük	First person Plural
televíziókat	None
ügyvédről	None
szórt	Third person Singular
imádkozzunk	First person Plural
véstem|	First person Singular
elmacskásodnék	First person Singular
undorodnak	Third person Plural
elküldök	First person Singular
kijavítsátok	Second person Plural
megállapítaniuk	Third person Plural
felkínált	Third person Singular
ventilálnak	Third person Plural
megírták	Third person Plural
visszautasítanak	Third person Plural
munkájává	None
elneveznem	First person Singular
bemenjen	Third person Singular
kölcsönhatásokat	None
daloljunk	First person Plural
gyűltek	Third person Plural
alélt	Third person Singular
filmezte	Third person Singular
kirúgták	Third person Plural
ítélned	Second person Singular
tagállamból	None
részletezték	Third person Plural
ikreket	None
cáfolták	Third person Plural
szűnjön	Third person Singular
elküldték	Third person Plural
jellem	None
komponálnak	Third person Plural
tesztelnek	Third person Plural
fényszóróért	None
kinyitották	Third person Plural
betegeken	None
eladót	None
felháborította	Third person Singular
következménynek	None
elkészüljön	Third person Singular
kifejlesztette	Third person Singular
polgárosodáshoz	None
korálljam|	First person Singular
bánik	Third person Singular
étrenddel	None
szabadrúgást	None
nevezzék	Third person Plural
nyilvánított	Third person Singular
összekötik	Third person Plural
hangolnak	Third person Plural
bővítsétek	Second person Plural
megtalálnák	Third person Plural
kiközösítették	Third person Plural
egyeznie	Third person Singular
tapint	Third person Singular
gondoskodnak	Third person Plural
bőségeseket	None
altatódalokhoz	None
ítélje	Third person Singular
erőműbe	None
lovagoljon	Third person Singular
belépési	None
vélned	Second person Singular
inkriminált	Third person Singular
tapasztottak	Third person Plural
gondoskodniuk	Third person Plural
jackpottal	None
elindítottátok	Second person Plural
végekre	None
tárolták	Third person Plural
szavazunk	First person Plural
osztozniuk	Third person Plural
duzzadnak	Third person Plural
tanulmányoztak	Third person Plural
basáskodnak	Third person Plural
kommunikációhoz	None
megelőzik	Third person Plural
reagálna	Third person Singular
szabadulnak	Third person Plural
tanfolyamokat	None
alkotót	None
reszkíroznák	Third person Plural
megismerte	Third person Singular
elhagyniuk	Third person Plural
hallucinációért	None
vegyültek	Third person Plural
megközelítettél	Second person Singular
pusztítsák	Third person Plural
végiggondoltam	First person Singular
utolérjenek	Third person Plural
sajtótájékoztatóvá	None
boldogulsz	Second person Singular
ösztökélték	Third person Plural
vélitek	Second person Plural
üzemeltet	Third person Singular
felismerje	Third person Singular
lezárultak	Third person Plural
zsidókat	None
nyomasztja	Third person Singular
összehasonlítod	Second person Singular
felvett	Third person Singular
megérdemelnének	Third person Plural
nyomtatott	Third person Singular
hozzátesz	Third person Singular
átnevezték	Third person Plural
maszturbálnod	Second person Singular
zárult	Third person Singular
alacsonyabbra	None
reklámoztak	Third person Plural
jósoltak	Third person Plural
áradatokig	None
portálon	None
hímről	None
fejtsétek	Second person Plural
kitölt	Third person Singular
végrehajtunk	First person Plural
bántanak	Third person Plural
bekövetkezett	Third person Singular
intik	Third person Plural
megszakít	Third person Singular
nyomtatták	Third person Plural
jegyeznek	Third person Plural
csapatkapitányt	None
példányhoz	None
félreértettük	First person Plural
rendezné	Third person Singular
virítson	Third person Singular
boltkóros	None
költségeihez	None
kiközösítünk	First person Plural
elbeszél	Third person Singular
megtapsolta	Third person Singular
elhelyezkednek	Third person Plural
gyalogságtól	None
rágalmaztuk	First person Plural
kiadvánnyá	None
alanyhoz	None
egyetértek	First person Singular
rettensz	Second person Singular
vezényeljen	Third person Singular
tiszteljék	Third person Plural
létesítsen	Third person Singular
elfogynak	Third person Plural
kiverik	Third person Plural
hasznosítandó	None
gazdagságot	None
hazamennék	First person Singular
megígérnéd	Second person Singular
viaszra	None
keríts|or|	Second person Singular
elkísért	Third person Singular
bejegyzésekhez	None
vijjognátok	Second person Plural
tiltunk	First person Plural
tudósítson	Third person Singular
analógiák	None
feláldozná	Third person Singular
biggyesztett	Third person Singular
szarakodtál	Second person Singular
elképzelünk	First person Plural
befedi	Third person Singular
fogyasszuk	First person Plural
helyiség	None
növekednek	Third person Plural
fárad	Third person Singular
beszednetek	Second person Plural
válaszolnod	Second person Singular
bűvölnünk	First person Plural
holdfényben	None
gátolniuk	Third person Plural
menekülünk	First person Plural
kialakítsák	Third person Plural
eljuttatott	Third person Singular
eltévednek	Third person Plural
megfogalmazta	Third person Singular
rendezték	Third person Plural
szelektálták	Third person Plural
pirosítson	Third person Singular
felsorolt	Third person Singular
remegned	Second person Singular
megírtak	Third person Plural
vaskarikával	None
felriadjanak	Third person Plural
mérgezték	Third person Plural
elmozdítottad	Second person Singular
ellenálltak	Third person Plural
különlegességet	None
fogselyemként	None
keltené	Third person Singular
proklamálták	Third person Plural
alapoztam	First person Singular
ballagott	Third person Singular
elkerültek	Third person Plural
levontam	First person Singular
gyomorkeserű	None
szopott	Third person Singular
fakadnak	Third person Plural
befont	Third person Singular
elmentél	Second person Singular
rájöjjenek	Third person Plural
testalkattal	None
kijelentették	Third person Plural
célozták	Third person Plural
szimulálta	Third person Singular
megfizet	Third person Singular
kolbászoltunk	First person Plural
szénben	None
hámlottunk	First person Plural
emlékéből	None
visszatér	Third person Singular
zárkózik	Third person Singular
mélységeket	None
kiveri	Third person Singular
megtanulnak	Third person Plural
kiválasztod	Second person Singular
jóváhagyott	Third person Singular
bimbóztunk	First person Plural
alakítottunk	First person Plural
megvalósítanak	Third person Plural
öveznek	Third person Plural
butikok	None
vészig	None
ítélitek	Second person Plural
tisztázatlanon	None
cégére	None
nyilvánítsatok	Second person Plural
formálod	Second person Singular
elváljon	Third person Singular
repülőket	None
megteszik	Third person Plural
bástyától	None
tengerektől	None
határoknál	None
digitalizált	Third person Singular
montíroznának	Third person Plural
gondolkoztam	First person Singular
farkasemberekig	None
gondolkodjon	Third person Singular
dedukció	None
szinkronizálnak	Third person Plural
megvesz	Third person Singular
indítok	First person Singular
találkoznék	First person Singular
elmentem	First person Singular
törekedjenek	Third person Plural
teáztak	Third person Plural
vizsgáztak	Third person Plural
vizsgáznia	Third person Singular
csillagászat	None
asszaszinnál	None
megjelölnie	Third person Singular
előrejelzésnél	None
elkészít	Third person Singular
megfejtette	Third person Singular
tanúskodtak	Third person Plural
cselekedjenek	Third person Plural
épebbtől	None
gerillaháborút	None
kutaknál	None
vásárolniuk	Third person Plural
sértik	Third person Plural
fektetett	Third person Singular
hitre	None
túladagolt	Third person Singular
elkezdtünk	First person Plural
megígért	Third person Singular
markolták	Third person Plural
viselkednie	Third person Singular
dogma	None
megjegyezték	Third person Plural
látogasson	Third person Singular
megtanulod	Second person Singular
harcoljon	Third person Singular
meglátod	Second person Singular
filmez	Third person Singular
epizódról	None
nyilvántart	Third person Singular
revideálta	Third person Singular
megcsinált	Third person Singular
sétálnak	Third person Plural
kimutassák	Third person Plural
egyesítenek	Third person Plural
csórták	Third person Plural
tátognod	Second person Singular
megtalálnod	Second person Singular
táplálta	Third person Singular
rendszereket	None
marcipánokkal	None
kitüntetne	Third person Singular
barátjába	None
tételt	None
létesüljön	Third person Singular
hasznosítottak	Third person Plural
zenedében	None
szaglásznám|	First person Singular
modernizáljanak	Third person Plural
kommentárban	None
apállyá	None
sötétednénk	First person Plural
megszüntetik	Third person Plural
zuhog	Third person Singular
felverik	Third person Plural
tömörít	Third person Singular
cukorgyárnak	None
megjegyzett	Third person Singular
megcsinálták	Third person Plural
teremtetnek	Third person Plural
telítődnek	Third person Plural
kifejtettek	Third person Plural
lepjek	First person Singular
megtudták	Third person Plural
bosszantson	Third person Singular
mellékleteket	None
depresszió	None
tanácsa	None
sérül	Third person Singular
ismétlődnöm	First person Singular
felvegyék	Third person Plural
megtestesített	Third person Singular
bókol	Third person Singular
bevezetése	None
uszít	Third person Singular
anomáliaként	None
előírt	Third person Singular
megválasztotta	Third person Singular
visszautasítják	Third person Plural
kitagadták	Third person Plural
legendákban	None
levetted	Second person Singular
távoztak	Third person Plural
mélységben	None
archívumnak	None
jelentkezzetek	Second person Plural
atletizáltál	Second person Singular
ápolnia	Third person Singular
kategorizál	Third person Singular
fogadtam	First person Singular
szövetségébe	None
protokollra	None
dezertáltak	Third person Plural
legyőzniük	Third person Plural
sejtetnek	Third person Plural
kényszerítjük	First person Plural
lezárta	Third person Singular
dokumentálta	Third person Singular
reagáljanak	Third person Plural
ésszerűsítettük	First person Plural
felfrissítették	Third person Plural
szeszélyből	None
bakokká	None
felfogott	Third person Singular
vonszol	Third person Singular
utánoztátok	Second person Plural
utál	Third person Singular
aktivitásokként	None
télhez	None
infravörös	None
csodálkozol	Second person Singular
csírájának	None
kitüntesse	Third person Singular
fejlődésre	None
masírozott	Third person Singular
átadásról	None
illusztrációban	None
kapuval	None
jelentkeztél	Second person Singular
gondolkozzanak	Third person Plural
exportálnak	Third person Plural
leírtam	First person Singular
sövényből	None
átlátjátok	Second person Plural
kirúgtak	Third person Plural
vezérel	Third person Singular
elnézte	Third person Singular
érthetetlenné	None
fölment	Third person Singular
billent	Third person Singular
megszólal	Third person Singular
kavar	Third person Singular
kosárlabdázott	Third person Singular
vitorlákkal	None
forradsz	Second person Singular
döntéseként	None
tetetjük	First person Plural
tévednek	Third person Plural
csövesekként	None
bátorítanak	Third person Plural
csatlakozol	Second person Singular
szimulációkat	None
licitált	Third person Singular
lencsén	None
legszelesebb	None
robotoltok	Second person Plural
szeletelték	Third person Plural
cselekedte	Third person Singular
trombitálnál	Second person Singular
támogatásától	None
próbálkozol	Second person Singular
készlet	None
fényének	None
megteremtett	Third person Singular
ünnepelt	Third person Singular
megfelelek	First person Singular
visszatérnék	First person Singular
megvilágosodtam	First person Singular
elszalasztotta	Third person Singular
rendezésért	None
változásokkal	None
köztudat	None
másol	Third person Singular
vetkőzik	Third person Singular
tökéletesítette	Third person Singular
elképzel	Third person Singular
voksolnak	Third person Plural
szitáltunk	First person Plural
fogadnunk	First person Plural
díjazták	Third person Plural
lobognak	Third person Plural
törekedtem	First person Singular
veszélyeztették	Third person Plural
gyászolták	Third person Plural
vegyítették	Third person Plural
bebizonyították	Third person Plural
vakond	None
beküldik	Third person Plural
szemléltetnek	Third person Plural
tartóztatta	Third person Singular
tapasztalunk	First person Plural
megszakította	Third person Singular
vonaglik	Third person Singular
csúcsokhoz	None
megkezdődjön	Third person Singular
megtekintő	None
döntésekre	None
ökológiának	None
összeköti	Third person Singular
söpör	Third person Singular
felszólítja	Third person Singular
folytatódtak	Third person Plural
feleltél	Second person Singular
lúdtól	None
végrehajtanak	Third person Plural
átnézed	Second person Singular
beágyaztatok	Second person Plural
nagyvárossá	None
téríteném|	First person Singular
hamvakat	None
megpróbál	Third person Singular
éldegélek	First person Singular
nyomtatja	Third person Singular
lángszóró	None
megvalósítják	Third person Plural
hirdeti	Third person Singular
megteremtenél	Second person Singular
szőrrel	None
alpári	None
megfutamodnunk	First person Plural
megfelelnek	Third person Plural
fújod	Second person Singular
megmagyarázta	Third person Singular
számításokra	None
előállított	Third person Singular
hangol	Third person Singular
ideadnom	First person Singular
létrejöttéhez	None
összehangoljon	Third person Singular
zongorázott	Third person Singular
elrepülnétek	Second person Plural
elfehéredek	First person Singular
módszerbe	None
megvizsgálni	None
árvízre	None
elhatároznád	Second person Singular
tanácsolunk	First person Plural
felfogástól	None
bántam	First person Singular
kereskedett	Third person Singular
vizionálandó	None
megmutatjátok	Second person Plural
temetné	Third person Singular
imádkozik	Third person Singular
irányítanád	Second person Singular
megnyúzott	Third person Singular
beleüvöltöttünk	First person Plural
régészet	None
rendszerváltástól	None
megközelített	Third person Singular
kutyáknak	None
kergesse	Third person Singular
vonakodott	Third person Singular
konzultált	Third person Singular
megállapítjuk	First person Plural
tiltottak	Third person Plural
eltávolítunk	First person Plural
felállítja	Third person Singular
vonítson	Third person Singular
fulladt	Third person Singular
megkövetelték	Third person Plural
száradjon	Third person Singular
szovjetekre	None
lencsébe	None
megment	Third person Singular
keresztülfolyt	Third person Singular
ezredből	None
harcolt	Third person Singular
utalnak	Third person Plural
féltek	First person Singular
sztárként	None
vastagodik	Third person Singular
elkóboroltak	Third person Plural
vérvizsgálatokat	None
boldogulnunk	First person Plural
hallgatunk	First person Plural
vonzást	None
beleír	Third person Singular
diadalívvel	None
szemeszterre	None
leszálljon	Third person Singular
stimulálta	Third person Singular
sportolóra	None
aláírtam	First person Singular
megtekintse	Third person Singular
szentesítő	None
sapkákat	None
feladtam	First person Singular
megismert	Third person Singular
követelsz	Second person Singular
muzsikba	None
koronába	None
gondolkozzon	Third person Singular
engedélyezték	Third person Plural
felejtik	Third person Plural
idealizálta	Third person Singular
dunyhákkal	None
emlékeztetik	Third person Plural
fingok	First person Singular
kódolta	Third person Singular
anyákkal	None
háborúsabbaknak	None
országossá	None
közgazdákká	None
javasoltál	Second person Singular
csacsogjatok	Second person Plural
lehel	Third person Singular
konyhamalacokra	None
gondoz	Third person Singular
felkészültünk	First person Plural
hordóba	None
lökdösött	Third person Singular
görbült	Third person Singular
tarlókon	None
tökéletesítették	Third person Plural
retusálni	None
bejegyzett	Third person Singular
sétálunk	First person Plural
derülnie	Third person Singular
üzemeltetnie	Third person Singular
vacsoráznia	Third person Singular
mellékutcákhoz	None
lábjegyzetnek	None
fennmarad	Third person Singular
kérésében	None
közeledünk	First person Plural
vezetésén	None
katasztrófákhoz	None
gépágyúból	None
mozgatta	Third person Singular
előkészítették	Third person Plural
hazaérned	Second person Singular
melegek	None
kérdezik	Third person Plural
elhelyeznéd	Second person Singular
aludjon	Third person Singular
megnézünk	First person Plural
kegyelt	Third person Singular
szentelték	Third person Plural
haragszik	Third person Singular
boncolások	None
kasszasikert	None
erősödött	Third person Singular
táplálkozott	Third person Singular
sikertelenné	None
feladatához	None
térdelnek	Third person Plural
görbülnek	Third person Plural
hallhatóvá	None
indokoltam	First person Singular
vakációzni	None
döftem	First person Singular
kivonult	Third person Singular
szerkesztettek	Third person Plural
évszakoknak	None
árultak	Third person Plural
feltételeznek	Third person Plural
elhelyezze	Third person Singular
szoptatják	Third person Plural
repülőútért	None
meggyújt	Third person Singular
honlapot	None
ideggyógyászok	None
figurának	None
viselkedsz	Second person Singular
tisztázódnak	Third person Plural
kigúnyol	Third person Singular
feltételezte	Third person Singular
szórakozna	Third person Singular
kiújult	Third person Singular
táncolt	Third person Singular
megvédik	Third person Plural
pusztították	Third person Plural
szemüvegen	None
minősítsük	First person Plural
nevezze	Third person Singular
indítvánnyal	None
közelítenek	Third person Plural
viselte	Third person Singular
szombrérótól	None
kamuznotok	Second person Plural
spekulál	Third person Singular
nyilvánítania	Third person Singular
megszólaljon	Third person Singular
főtitkárrá	None
irigyelte	Third person Singular
sokrétűek	None
elhanyagolt	Third person Singular
paneleknél	None
egyesülésről	None
közelítjük	First person Plural
kimennie	Third person Singular
bírnak	Third person Plural
megválasztanak	Third person Plural
vigyáznunk	First person Plural
mozgatnia	Third person Singular
felismer	Third person Singular
parapszichológia	None
szórakoztatott	Third person Singular
licencelte	Third person Singular
megneveztem	First person Singular
meggyőzniük	Third person Plural
szítson	Third person Singular
bejöjjön	Third person Singular
tengelyeket	None
becsapná	Third person Singular
közelített	Third person Singular
megnyerték	Third person Plural
okát	None
állásának	None
állapítsák	Third person Plural
megoldaniuk	Third person Plural
kegyencet	None
ultrahangok	None
fogadósné	None
kezdőnek	None
végezne	Third person Singular
termesztik	Third person Plural
megőrizni	None
világított	Third person Singular
birodalom	None
elállt	Third person Singular
tengerekhez	None
elhelyezik	Third person Plural
megírnád	Second person Singular
kalauzol	Third person Singular
kopogtak	Third person Plural
kiválnak	Third person Plural
rögzítse	Third person Singular
polgárháborúban	None
ebédelnetek	Second person Plural
kötődtek	Third person Plural
emelünk	First person Plural
kelettől	None
elállnak	Third person Plural
elfogy	Third person Singular
díjaztak	Third person Plural
gurított	Third person Singular
szítanál	Second person Singular
alakítsanak	Third person Plural
visszaél	Third person Singular
csatlakozzunk	First person Plural
strichelnél	Second person Singular
rozéborokba	None
megtudva	None
kiléptem	First person Singular
kasztrált	Third person Singular
koronáztak	Third person Plural
konzolokon	None
figyelmeztetnek	Third person Plural
elállok	First person Singular
fogyasszanak	Third person Plural
intéznie	Third person Singular
megnyugtattatok	Second person Plural
részvénytársaságra	None
biennálékon	None
mulassák	Third person Plural
túléljék	Third person Plural
alpinizmusról	None
lankadt	Third person Singular
felújítják	Third person Plural
deprimálnék	First person Singular
szabadalmaztatott	Third person Singular
nézegessük	First person Plural
stúdiókkal	None
értesítésben	None
hegesszetek	Second person Plural
viszonozniuk	Third person Plural
vélsz	Second person Singular
fejtettem	First person Singular
nyilvánítsa	Third person Singular
laknia	Third person Singular
arányosba	None
jelölje	Third person Singular
elindulunk	First person Plural
kijavítsák	Third person Plural
tőszám	None
ágyhoz	None
pályázik	Third person Singular
bálokba	None
aludnia	Third person Singular
indokol	Third person Singular
népesség	None
ágyúzta	Third person Singular
kipróbáltam	First person Singular
beírná	Third person Singular
korlátoztak	Third person Plural
szemléltetett	Third person Singular
szerencse	None
szurkolóval	None
rövidít	Third person Singular
idézek	First person Singular
üdvözölték	Third person Plural
fülemnek	None
megtesszük	First person Plural
denaturált	Third person Singular
készítőért	None
átalakította	Third person Singular
perccel	None
együttes	None
feláll	Third person Singular
megkaptak	Third person Plural
politikusokra	None
ismertek	None
beindulnom	First person Singular
ellát	Third person Singular
feltüntette	Third person Singular
kinézniük	Third person Plural
tárulnak	Third person Plural
mogyoró	None
félreértett	Third person Singular
tálal	Third person Singular
bekukucskálna	Third person Singular
kijelentésnek	None
fémpénzek	None
megkönnyítjük	First person Plural
lélegző	None
kihagyok	First person Singular
beteszed	Second person Singular
tallóznotok	Second person Plural
kazettát	None
előállítania	Third person Singular
versenyautóhoz	None
fújniuk	Third person Plural
margó	None
megőrizte	Third person Singular
vicsorítottál	Second person Singular
biztosak	None
térítik	Third person Plural
kant	None
szétesett	Third person Singular
kiegészíti	Third person Singular
marxin	None
idézték	Third person Plural
kisebben	None
összehasonlítsa	Third person Singular
fluktuálna	Third person Singular
vizsgálatból	None
hazudtunk	First person Plural
jégkorongokból	None
huny	Third person Singular
elszalasztott	Third person Singular
ellássanak	Third person Plural
kártalanítanának	Third person Plural
ellenőrizniük	Third person Plural
megmentették	Third person Plural
alapítójával	None
bántsátok	Second person Plural
személyeknél	None
megneveznie	Third person Singular
ücsörögted	Second person Singular
megállítsa	Third person Singular
seprűre	None
akadunk	First person Plural
neveztük	First person Plural
összevetjük	First person Plural
gondolkodik	Third person Singular
megértésével	None
táncolunk	First person Plural
rehabilitálták	Third person Plural
elkülönít	Third person Singular
autóbuszoknak	None
megjelentetnie	Third person Singular
idézett	Third person Singular
tündéről	None
szlávból	None
csatlakozzatok	Second person Plural
bakok	None
megszűnjenek	Third person Plural
kiemelkedjünk	First person Plural
tulajdonságai	None
provokációból	None
áramlik	Third person Singular
hírekbe	None
megállóról	None
értékesítettük	First person Plural
üzeni	Third person Singular
tesztelik	Third person Plural
kitöltik	Third person Plural
tüntetned	Second person Singular
elverik	Third person Plural
eredetit	None
harmonizáld|or|	Second person Singular
terveiben	None
törjön	Third person Singular
teljesítene	Third person Singular
küzdelmeken	None
tanulták	Third person Plural
kaporral	None
hegységeket	None
generációba	None
átvesznek	Third person Plural
nézegette	Third person Singular
söpri	Third person Singular
megbocsátott	Third person Singular
ismeretlennek	None
dicsért	Third person Singular
búzán	None
beindulnak	Third person Plural
kiver	Third person Singular
fordulóról	None
építkezésekben	None
felfogta	Third person Singular
megtekintette	Third person Singular
fogalmazzanak	Third person Plural
meggyőzöd	Second person Singular
vezérelnie	Third person Singular
szavazók	None
folytatódott	Third person Singular
foxtrottoznunk	First person Plural
lenézett	Third person Singular
megveri	Third person Singular
szabályozásánál	None
szidta	Third person Singular
felfedezett	Third person Singular
kedveznek	Third person Plural
meglátogatta	Third person Singular
ültetnek	Third person Plural
széléhez	None
tanít	Third person Singular
bordázott	Third person Singular
járőrözött	Third person Singular
megfosztottak	Third person Plural
ugat	Third person Singular
postákon	None
tűrtük	First person Plural
előrehaladtok	Second person Plural
falut	None
beszállna	Third person Singular
vastagítottatok	Second person Plural
mandulából	None
árulta	Third person Singular
próbálkoznék	First person Singular
száműzik	Third person Plural
jégkorongoznia	Third person Singular
gázzá	None
nyilvánult	Third person Singular
telepakolná	Third person Singular
csoszogtak	Third person Plural
kifejt	Third person Singular
kiejtéseket	None
aktivitások	None
beállított	Third person Singular
túlélnie	Third person Singular
perdítenünk	First person Plural
hálára	None
űrpályákon	None
finanszíroznak	Third person Plural
leírnom	First person Singular
fusizzatok	Second person Plural
újítsák	Third person Plural
dumál	Third person Singular
kampányolt	Third person Singular
vegyíti	Third person Singular
sért	Third person Singular
megemlítünk	First person Plural
bezár	Third person Singular
billen	Third person Singular
pástétom	None
hamisat	None
növelné	Third person Singular
felejtettek	Third person Plural
megmutassák	Third person Plural
fogalmaznia	Third person Singular
igazgatják	Third person Plural
ismétlődtek	Third person Plural
amputáljak	First person Singular
barnamedvén	None
mutatkozna	Third person Singular
dúlták	Third person Plural
termelést	None
lebegne	Third person Singular
újít	Third person Singular
megöljön	Third person Singular
hajhálóról	None
időjárásiakon	None
gondoskodnunk	First person Plural
megírná	Third person Singular
tengerészeknek	None
ingázik	Third person Singular
fogalmazták	Third person Plural
informálisra	None
vontatja	Third person Singular
gyűlt	Third person Singular
viszontlátták	Third person Plural
ítélnek	Third person Plural
kifejlesztett	Third person Singular
részét	None
nemességbe	None
ártasz	Second person Singular
erősítenie	Third person Singular
bemutatniuk	Third person Plural
zongorákat	None
sietne	Third person Singular
csicsergett	Third person Singular
osztoztak	Third person Plural
hozzászólok	First person Singular
törődniük	Third person Plural
száműztünk	First person Plural
megegyezünk	First person Plural
egybeírták	Third person Plural
felfedeztük	First person Plural
bekerülniük	Third person Plural
módosult	Third person Singular
kijavítok	First person Singular
apátnők	None
fedeztem	First person Singular
birtokoltuk	First person Plural
gondolkodtunk	First person Plural
hangoltak	Third person Plural
bombázzak	First person Singular
üzemelteti	Third person Singular
vinnyognunk	First person Plural
családokra	None
hazaér	Third person Singular
leljenek	Third person Plural
divatokhoz	None
esernyők	None
koccintsanak	Third person Plural
adatátvitelt	None
kezeljen	Third person Singular
blöffölünk	First person Plural
korcsolyázzanak	Third person Plural
faragásokat	None
kizártál	Second person Singular
cseréjénél	None
heverek	First person Singular
szerelt	Third person Singular
cenzúrázták	Third person Plural
aránytalanságot	None
konzultációsról	None
terepeken	None
ügyvéddel	None
reagáltatok	Second person Plural
hazamentem	First person Singular
kérelmezett	Third person Singular
vizsgázik	Third person Singular
titkolta	Third person Singular
renoválták	Third person Plural
szenvednie	Third person Singular
öleli	Third person Singular
megbeszélésen	None
felfog	Third person Singular
állapítanak	Third person Plural
anakronizmusnak	None
létrehozná	Third person Singular
portugáloknak	None
pirulát	None
megköszönnéd	Second person Singular
hangokat	None
italokba	None
áriára	None
táborokból	None
kiengedte	Third person Singular
csavarokat	None
ballagtál	Second person Singular
elhelyeznünk	First person Plural
fasizmushoz	None
alakítanának	Third person Plural
tanítok	First person Singular
tömlöcbe	None
tárgyalná	Third person Singular
címeztem	First person Singular
tiporták	Third person Plural
bolygókra	None
lefoglaljatok	Second person Plural
muzsikáljak	First person Singular
restelljék	Third person Plural
minősít	Third person Singular
összehasonlítsuk	First person Plural
kerthez	None
változókra	None
hágóból	None
állandósultak	Third person Plural
szaké	None
megismerje	Third person Singular
fogadáson	None
igazgatott	Third person Singular
külvárosba	None
kultúrákhoz	None
növelt	Third person Singular
csatlakozna	Third person Singular
reakcióra	None
deltáknál	None
koncentrálok	First person Singular
megmutatná	Third person Singular
agyagba	None
vésett	Third person Singular
vigasztalni	None
töltésekre	None
duzzadjatok	Second person Plural
növesztik	Third person Plural
beavatkozzon	Third person Singular
rummal	None
ámulj|or|	Second person Singular
gyártól	None
megragadjanak	Third person Plural
ellenőrizzem|	First person Singular
kémkedik	Third person Singular
sánc	None
örökölnek	Third person Plural
elemezte	Third person Singular
gyalázta	Third person Singular
féltékennyé	None
törekvésre	None
piszkáltok	Second person Plural
meggyőzzön	Third person Singular
berendezésekről	None
egysége	None
gondozott	Third person Singular
tömeggyártásra	None
fejlődünk	First person Plural
lexikológiákról	None
haszonként	None
revideál	Third person Singular
bekapcsol	Third person Singular
stílusoktól	None
tisztáznia	Third person Singular
őrzött	Third person Singular
lemondjon	Third person Singular
eladta	Third person Singular
vigasztaljanak	Third person Plural
kísérje	Third person Singular
tornázzak	First person Singular
énekesnővel	None
fertőzték	Third person Plural
szavazzon	Third person Singular
feliratkozott	Third person Singular
tükröznek	Third person Plural
vegyítik	Third person Plural
vonzott	Third person Singular
toboroznak	Third person Plural
elmacskásodnak	Third person Plural
mérlegeltem	First person Singular
bajusszal	None
népén	None
emlékezetnek	None
elmozdítják	Third person Plural
elrejtenem	First person Singular
sellők	None
űrlény	None
felhasználok	First person Singular
bizalommal	None
fokozott	Third person Singular
frissítse	Third person Singular
hozzátennem	First person Singular
tükrözzék	Third person Plural
költöttek	Third person Plural
irányuljon	Third person Singular
zsindelyezett	Third person Singular
megszűnt	Third person Singular
váztól	None
komplikációt	None
sérelmet	None
kompasz	None
gravitációra	None
elhunytak	Third person Plural
berkeken	None
sorakoztak	Third person Plural
riasszon	Third person Singular
meggyőzik	Third person Plural
megvalósulásában	None
indokolnia	Third person Singular
lógjanak	Third person Plural
gondolkodóknál	None
meggyilkolta	Third person Singular
megköszönjünk	First person Plural
hunytak	Third person Plural
terjessze	Third person Singular
emlékeztetett	Third person Singular
képezze	Third person Singular
befejeződik	Third person Singular
csillapítasz	Second person Singular
szerepjátékokat	None
boldogultak	Third person Plural
megbeszél	Third person Singular
behúzott	Third person Singular
koffeinmentesként	None
tüzeljenek	Third person Plural
megjelenít	Third person Singular
gyulladásokként	None
medencéről	None
egyszerűsítették	Third person Plural
lassítanak	Third person Plural
leírok	First person Singular
felkeltem	First person Singular
visszavett	Third person Singular
csábítják	Third person Plural
avanzsíroznak	Third person Plural
értelmetleneket	None
jobbakhoz	None
viselték	Third person Plural
reformál	Third person Singular
cériumokká	None
visszatért	Third person Singular
elvesztené	Third person Singular
mozgassuk	First person Plural
hazatalál	Third person Singular
törekedniük	Third person Plural
képzeli	Third person Singular
kerteljek	First person Singular
tanulniuk	Third person Plural
meditálnak	Third person Plural
álmodtad	Second person Singular
kiegészítenie	Third person Singular
taszítsa	Third person Singular
kiterjesztést	None
vitatják	Third person Plural
visszahelyezi	Third person Singular
felhasználókhoz	None
engedelmeskedniük	Third person Plural
zárulnak	Third person Plural
megvásárolnia	Third person Singular
szerelje	Third person Singular
dominál	Third person Singular
sikeredett	Third person Singular
diszkvalifikálták	Third person Plural
vájárokkal	None
vérről	None
arzént	None
beleírsz	Second person Singular
terjesztettek	Third person Plural
golfozik	Third person Singular
hangsúlyozva	None
megígérte	Third person Singular
álomvilágban	None
maki	None
megsemmisítette	Third person Singular
bocsássa	Third person Singular
szimulátorokig	None
kijelölnie	Third person Singular
cseppecskével	None
elálljon	Third person Singular
vetkőztessünk	First person Plural
lakkozni	None
könnycseppek	None
taszítaná	Third person Singular
eredményez	Third person Singular
megkezdett	Third person Singular
törékeny	None
népszerűek	None
állomásra	None
értesüljenek	Third person Plural
találkoznánk	First person Plural
kitüntetett	Third person Singular
szintetizálták	Third person Plural
elvettük	First person Plural
meglátja	Third person Singular
megbüntettünk	First person Plural
indított	Third person Singular
sérv	None
bátorította	Third person Singular
legkisebbeknek	None
kérelmével	None
lapít	Third person Singular
feltettek	Third person Plural
körmöld|or|	Second person Singular
kiterjesztett	Third person Singular
inváziónak	None
ellentmondania	Third person Singular
menekülök	First person Singular
pohárból	None
birsalmafákká	None
analóg	None
irigykednek	Third person Plural
megölnie	Third person Singular
nyávognak	Third person Plural
dacolt	Third person Singular
elárul	Third person Singular
lezárultunk	First person Plural
vitázott	Third person Singular
kerülget	Third person Singular
privatizálta	Third person Singular
nehezítsük	First person Plural
szabadalmaztatta	Third person Singular
kísértem	First person Singular
átalakítják	Third person Plural
letöltöd	Second person Singular
kihagytam	First person Singular
elhisz	Third person Singular
fektessen	Third person Singular
beleszólásokkal	None
megfosztjuk	First person Plural
kínozta	Third person Singular
szűnnie	Third person Singular
megtörténne	Third person Singular
készíttették	Third person Plural
admirálisok	None
csipen	None
ellopnak	Third person Plural
emlékezünk	First person Plural
felbontják	Third person Plural
emlékműveken	None
kizárta	Third person Singular
vitatjuk	First person Plural
bizonyultak	Third person Plural
határt	None
cimborál	Third person Singular
körszínházakon	None
elvette	Third person Singular
gyűjtések	None
skalpoltam	First person Singular
javasoltuk	First person Plural
lemezek	None
nyilatkozol	Second person Singular
közeledett	Third person Singular
aktiválást	None
visszaadott	Third person Singular
tájékoztatták	Third person Plural
aknamezők	None
kutatómunkának	None
sugároznak	Third person Plural
megteremtse	Third person Singular
kodifikált	Third person Singular
kérdezett	Third person Singular
okosabbak	None
lemondana	Third person Singular
bánnunk	First person Plural
kéklenünk	First person Plural
gőzösnek	None
szennyezzenek	Third person Plural
hegesztéssel	None
erdőnél	None
rendezett	Third person Singular
otthonába	None
dicsőségből	None
elintézze	Third person Singular
zenekarokat	None
befizették	Third person Plural
kiskorúakat	None
fogalmazd|or|	Second person Singular
megosztjuk	First person Plural
szemléltessük	First person Plural
béreljenek	Third person Plural
bekövetkeznie	Third person Singular
utasítsák	Third person Plural
felvarrva	None
szenvednének	Third person Plural
utánozta	Third person Singular
elfojtják	Third person Plural
kitöltenek	Third person Plural
leadtam	First person Singular
leégett	Third person Singular
átadnak	Third person Plural
vihogná	Third person Singular
elküldöd	Second person Singular
megtalál	Third person Singular
megjavítsuk	First person Plural
ünnepel	Third person Singular
szocializálunk	First person Plural
zagyválnál	Second person Singular
megfejtenie	Third person Singular
autópályákhoz	None
szükségestől	None
lovagolta	Third person Singular
apályokért	None
visszamennénk	First person Plural
kalauzolnál	Second person Singular
létesítettek	Third person Plural
kényszerítsék	Third person Plural
megértsenek	Third person Plural
kiválasztását	None
prezentálnia	Third person Singular
utolérnie	Third person Singular
irányította	Third person Singular
végiggondolta	Third person Singular
belépjen	Third person Singular
korlátoztatok	Second person Plural
fejezték	Third person Plural
küzdelemért	None
kiszámítanád	Second person Singular
felhasználnak	Third person Plural
felülírt	Third person Singular
anomáliát	None
megfigyeljék	Third person Plural
túlbeszéld|or|	Second person Singular
metszették	Third person Plural
katolikusból	None
megrongálnia	Third person Singular
tiszteltem	First person Singular
megnézek	First person Singular
lemosta	Third person Singular
emeljék	Third person Plural
tárgyalnod	Second person Singular
márkára	None
szüntette	Third person Singular
formálnotok	Second person Plural
döngetett	Third person Singular
kupolával	None
találkozniuk	Third person Plural
összehasonlítsák	Third person Plural
meghaladták	Third person Plural
kerítéseken	None
másolnom	First person Singular
mutáción	None
kamatozik	Third person Singular
fájdalmakon	None
kalózkodásból	None
megállítanak	Third person Plural
tulajdonságaival	None
dolgomba	None
vétkezik	Third person Singular
kikérdezném|	First person Singular
legelt	Third person Singular
húzódtatok	Second person Plural
tanultál	Second person Singular
vallásokon	None
megjelentetünk	First person Plural
kijavították	Third person Plural
nézelődtem	First person Singular
erősítsék	Third person Plural
felébresztette	Third person Singular
eltűnök	First person Singular
csináljak	First person Singular
társasjátékok	None
radiációkon	None
csónakokon	None
vélekedjetek	Second person Plural
korcsolyáztátok	Second person Plural
keltetted	Second person Singular
gyógyszertárban	None
diszkrimináltátok	Second person Plural
leülünk	First person Plural
szólaltak	Third person Plural
programjaitokkal	None
pörögjek	First person Singular
kommunikáltam	First person Singular
tagságok	None
lelik	Third person Plural
cikk	None
sorolod	Second person Singular
ültették	Third person Plural
átgondolták	Third person Plural
holdfényekből	None
varázsolnál	Second person Singular
fektesse	Third person Singular
csodákhoz	None
ügyfélre	None
eldöntitek	Second person Plural
tákolod	Second person Singular
terheljék	Third person Plural
nyelvvel	None
feldobunk	First person Plural
diktált	Third person Singular
relaxálnék	First person Singular
felhívták	Third person Plural
megöltek	Third person Plural
megidéz	Third person Singular
elbújjak	First person Singular
naprendszerhez	None
invesztáljatok	Second person Plural
kosár	None
formált	Third person Singular
papnő	None
körzeten	None
bántottál	Second person Singular
keletkezett	Third person Singular
akadályozzunk	First person Plural
erősített	Third person Singular
dobálnak	Third person Plural
tűzoltóságokért	None
kurafiban	None
kölcsönkérj|or|	Second person Singular
állandósult	Third person Singular
kiáltott	Third person Singular
selyembe	None
felmérésre	None
duda	None
többfélét	None
megismertessem|	First person Singular
létrehoznom	First person Singular
megfosztják	Third person Plural
találgattak	Third person Plural
szülik	Third person Plural
rávegye	Third person Singular
úttá	None
hegyláncok	None
megsérült	Third person Singular
kávéztál	Second person Singular
felismerték	Third person Plural
csótányt	None
feláldozott	Third person Singular
pelenkává	None
ellenforradalomban	None
fokozódik	Third person Singular
identitásról	None
szárazabbá	None
gömböt	None
teraszra	None
tesztel	Third person Singular
indukáltál	Second person Singular
megtegyék	Third person Plural
adóznak	Third person Plural
alkották	Third person Plural
rajong	Third person Singular
bemutatná	Third person Singular
gyógyszertárból	None
dezertál	Third person Singular
nevüket	None
megszűnne	Third person Singular
körözték	Third person Plural
befolyunk	First person Plural
rajongta	Third person Singular
fejlesztettem	First person Singular
visszatérnie	Third person Singular
verbuváltak	Third person Plural
tevegelnénk	First person Plural
tévedjünk	First person Plural
konfirmálnál	Second person Singular
száradjak	First person Singular
müezzinig	None
kötődniük	Third person Plural
vétózd|or|	Second person Singular
bebizonyítaniuk	Third person Plural
Bajorország	None
beismersz	Second person Singular
nyugatba	None
büntetésnél	None
felfrissített	Third person Singular
megkülönböztessék	Third person Plural
befecskendezte	Third person Singular
megkapnak	Third person Plural
elintézett	Third person Singular
lakókocsiba	None
erőszakosnak	None
ígérték	Third person Plural
megosztotta	Third person Singular
idéznek	Third person Plural
vitorláson	None
feleslegesnek	None
elhiszi	Third person Singular
fogyasztja	Third person Singular
leveszed	Second person Singular
szórakoznak	Third person Plural
négyesre	None
létesítménnyel	None
megcsináltam	First person Singular
visszavegye	Third person Singular
frakciók	None
feldobná	Third person Singular
kódolt	Third person Singular
ültessenek	Third person Plural
polihisztorok	None
szerkesztened	Second person Singular
tekerőlantokkal	None
albumokon	None
beszerezte	Third person Singular
bencsolásokért	None
fennmaradjanak	Third person Plural
alkalmi	None
táncolsz	Second person Singular
bizonyítaniuk	Third person Plural
emelik	Third person Plural
jogába	None
operából	None
hátúszásoknál	None
kiszámítunk	First person Plural
zagyválod	Second person Singular
ittas	None
vígjátékokba	None
újraélessze	Third person Singular
tolerált	Third person Singular
zenekarba	None
iktattak	Third person Plural
tájékoztatjuk	First person Plural
oxidálódnak	Third person Plural
alkottam	First person Singular
településtől	None
privilégiumok	None
tönkretenné	Third person Singular
partvonalon	None
éldegélt	Third person Singular
sebeznek	Third person Plural
ügyesség	None
utolérjek	First person Singular
hozzáadunk	First person Plural
devalválnék	First person Singular
megfordult	Third person Singular
ugassak	First person Singular
fingokba	None
visszhangzik	Third person Singular
csengetünk	First person Plural
megjelentessék	Third person Plural
megfosztott	Third person Singular
érdemelt	Third person Singular
megerősödött	Third person Singular
ígérje	Third person Singular
felszerelnem	First person Singular
stírölik	Third person Plural
determináltuk	First person Plural
megkérdezed	Second person Singular
egészítsétek	Second person Plural
koncentrálnak	Third person Plural
elkészítsék	Third person Plural
harangot	None
fickóról	None
elkészüljenek	Third person Plural
szívrohamban	None
beleszóljon	Third person Singular
elkészülnie	Third person Singular
legokosabb	None
visszalépünk	First person Plural
expozíciók	None
tartósítja	Third person Singular
szabadalmak	None
harcolnak	Third person Plural
elfojtottuk	First person Plural
letelepítette	Third person Singular
létrehozniuk	Third person Plural
emeltétek	Second person Plural
alábecsülnének	Third person Plural
odafigyelő	None
eszkalálunk	First person Plural
diszpécserig	None
tolmácsolták	Third person Plural
megnyílnak	Third person Plural
beiktatják	Third person Plural
májusából	None
kozmetikáztátok	Second person Plural
véghezvigye	Third person Singular
szemlélik	Third person Plural
továbbítjuk	First person Plural
szaval	Third person Singular
áruk	None
szánalomra	None
teremti	Third person Singular
honvéd	None
ládákért	None
rájönnie	Third person Singular
álmodtam	First person Singular
biztonságosak	None
zsákmányolnak	Third person Plural
toborozzon	Third person Singular
unatkozzak	First person Singular
megismételniük	Third person Plural
hápogjam|	First person Singular
megbánta	Third person Singular
tisztázódott	Third person Singular
elkészíteniük	Third person Plural
kifogás	None
engedélyezzen	Third person Singular
oldallal	None
helyreállították	Third person Plural
kiadta	Third person Singular
ürült	Third person Singular
tömörítettem|	First person Singular
megkönnyítsük	First person Plural
kötelességének	None
mézben	None
módosítottam	First person Singular
bebeszéltél	Second person Singular
gyógyítóként	None
kiemelkedtél	Second person Singular
fordulatra	None
drukkolunk	First person Plural
csatlakoztam	First person Singular
frissült	Third person Singular
reformokon	None
kitöltjük	First person Plural
javasoljon	Third person Singular
fosztotta	Third person Singular
letöltitek	Second person Plural
invitál	Third person Singular
összekeveri	Third person Singular
ellátogatnia	Third person Singular
visszavág	Third person Singular
lezárták	Third person Plural
beleszólt	Third person Singular
megtalálnunk	First person Plural
bencsolnod	Second person Singular
találgatta	Third person Singular
fejted	Second person Singular
juttatást	None
nyűgöznél	Second person Singular
eltelnie	Third person Singular
fokoz	Third person Singular
megalakulnotok	Second person Plural
előfordulna	Third person Singular
beszerez	Third person Singular
fennmaradniuk	Third person Plural
beleszóltak	Third person Plural
étvággyal	None
kagylóval	None
felismerésből	None
felhívod	Second person Singular
gyilkosságoknak	None
ideírok	First person Singular
lel	Third person Singular
létrejött	Third person Singular
szüljön	Third person Singular
egyezne	Third person Singular
egyenlőségen	None
nyergeken	None
ismerkedtünk	First person Plural
elvágtak	Third person Plural
utolértél	Second person Singular
munkásságával	None
kényszerítené	Third person Singular
megölt	Third person Singular
uralmáról	None
útmutatóba	None
bement	Third person Singular
megjavították	Third person Plural
fontról	None
szentelt	Third person Singular
szerkeszti	Third person Singular
lefokozzunk	First person Plural
tulajdonnevekből	None
bemutat	Third person Singular
megmondtam	First person Singular
torzítják	Third person Plural
szökőév	None
fenyeget	Third person Singular
végrendelkeztem|	First person Singular
gyarapodik	Third person Singular
ignorált	Third person Singular
használatba	None
bizonyítsák	Third person Plural
gerelyhajításnak	None
társalgott	Third person Singular
felhasználásához	None
tulaj	None
beírtál	Second person Singular
munkásság	None
értesítitek	Second person Plural
helybenhagynom	First person Singular
ebédeltél	Second person Singular
emeljünk	First person Plural
cenk	None
elbeszélnének	Third person Plural
csatornává	None
tüzelte	Third person Singular
munkái	None
vigyáztam	First person Singular
tartósítanék	First person Singular
hozzájáruljon	Third person Singular
következtette	Third person Singular
szinonimaszótár	None
bajáról	None
falával	None
nagyítja	Third person Singular
tárgyalunk	First person Plural
konzolban	None
kooperálnak	Third person Plural
mandulával	None
elutasította	Third person Singular
gondoskodjon	Third person Singular
manipulációval	None
pénzbe	None
biztosítéknak	None
azonosít	Third person Singular
reprezentálta	Third person Singular
megrongálta	Third person Singular
indítsanak	Third person Plural
támadnia	Third person Singular
csodálkozzon	Third person Singular
látogatóként	None
duzzadtak	Third person Plural
kibővít	Third person Singular
nyugodjunk	First person Plural
megnyúzunk	First person Plural
átvette	Third person Singular
telíti	Third person Singular
megosztaniuk	Third person Plural
szína	Third person Singular
taníttassátok	Second person Plural
táplálkoznak	Third person Plural
kóborol	Third person Singular
aliázz|or|	Second person Singular
fedeztük	First person Plural
kijönnie	Third person Singular
megtervezi	Third person Singular
kecskeként	None
blogolt	Third person Singular
elfelejtettük	First person Plural
teremtenünk	First person Plural
felkészítette	Third person Singular
harapás	None
felfedeznie	Third person Singular
keltene	Third person Singular
viszonzott	Third person Singular
visszatérniük	Third person Plural
szavazol	Second person Singular
letöltjük	First person Plural
javították	Third person Plural
összefogtak	Third person Plural
prefektusok	None
lenéz	Third person Singular
becsapott	Third person Singular
spacírozzatok	Second person Plural
tantermeket	None
eladnak	Third person Plural
információsban	None
megtervezték	Third person Plural
fényből	None
ellenérvet	None
létrehoznod	Second person Singular
tesztelek	First person Singular
feltünteted	Second person Singular
nagybetűkkel	None
elviselte	Third person Singular
megtiltják	Third person Plural
elragadtattam	First person Singular
elvesztett	Third person Singular
kiderítenél	Second person Singular
bázisokkal	None
ábrázolásoktól	None
takarmánynak	None
jegyzett	Third person Singular
üdvözítsenek	Third person Plural
süti	Third person Singular
csontig	None
örökölték	Third person Plural
kapcsolattartásra	None
bemutassuk	First person Plural
megvalósítok	First person Singular
kialakították	Third person Plural
felszabadít	Third person Singular
gyűlölte	Third person Singular
előzik	Third person Plural
vitatkoznának	Third person Plural
élvezet	None
viszonyulunk	First person Plural
összegezték	Third person Plural
figyelmeztetted	Second person Singular
belügyminisztériumban	None
öltöztek	Third person Plural
élesztő	None
tisztaságokká	None
teremtse	Third person Singular
másoltad	Second person Singular
átadnia	Third person Singular
kerített	Third person Singular
gyógynövényekkel	None
felvételekből	None
állapotoktól	None
ragyog	Third person Singular
megvédtem	First person Singular
emésztőrendszerre	None
ignorálták	Third person Plural
fogalmazok	First person Singular
teljesítettük	First person Plural
eredményezne	Third person Singular
intézett	Third person Singular
nyomozná	Third person Singular
tévesztik	Third person Plural
reprezentált	Third person Singular
diszkoszvetésekért	None
elektromágneses	None
neutronokat	None
raboskodik	Third person Singular
csempészte	Third person Singular
rombolnak	Third person Plural
nekilátnak	Third person Plural
pusztította	Third person Singular
meteorokként	None
átkeresztelte	Third person Singular
előrejelzésben	None
többségnek	None
desztillálnának	Third person Plural
terjesszük	First person Plural
különbségekkel	None
hátrakötött	Third person Singular
beállítsa	Third person Singular
szembenézett	Third person Singular
megjelentették	Third person Plural
buján	None
megérintsük	First person Plural
főnökre	None
teremtenek	Third person Plural
kovácsokként	None
odafigyelni	None
blogokba	None
randevúztak	Third person Plural
összetételekben	None
aláírnak	Third person Plural
megjutalmazta	Third person Singular
alakítson	Third person Singular
áldásért	None
felvettek	Third person Plural
csíkozott	Third person Singular
lenéznie	Third person Singular
üzemeltetőknek	None
elintézték	Third person Plural
garazsíroznád	Second person Singular
berúgnák	Third person Plural
megtizedeljenek	Third person Plural
tükrözze	Third person Singular
viselkedniük	Third person Plural
központjával	None
toboroz	Third person Singular
dátumokkal	None
ecseteld|or|	Second person Singular
szívinfarktusnál	None
elférnek	Third person Plural
likvidált	Third person Singular
utalta	Third person Singular
közérthetőekbe	None
kulcscsontig	None
bekapcsoltak	Third person Plural
kibocsátották	Third person Plural
gurít	Third person Singular
fűződik	Third person Singular
legyőztük	First person Plural
árnyékáért	None
japánokkal	None
jelöléseknek	None
pályáztak	Third person Plural
eldönti	Third person Singular
piramisokban	None
befogadjon	Third person Singular
íródtak	Third person Plural
rejt	Third person Singular
jósolta	Third person Singular
bazsarózsát	None
táplálkozzunk	First person Plural
tömörüljenek	Third person Plural
visít	Third person Singular
belépett	Third person Singular
leszállnia	Third person Singular
beírod	Second person Singular
bútorokat	None
verziókká	None
megemlítsék	Third person Plural
végeztük	First person Plural
belépek	First person Singular
kisvárost	None
közelítettem	First person Singular
ápolnak	Third person Plural
pasától	None
ábécének	None
vonatozik	Third person Singular
beadod	Second person Singular
lakták	Third person Plural
esküszik	Third person Singular
esetének	None
kijelentett	Third person Singular
létrehoztak	Third person Plural
eredményeztél	Second person Singular
felhalmozz|or|	Second person Singular
megvizsgálta	Third person Singular
mellékneveket	None
lejátszania	Third person Singular
versenyeznek	Third person Plural
akadályozott	Third person Singular
unokának	None
sóvárgott	Third person Singular
onanizálniuk	Third person Plural
társaságra	None
szórakozik	Third person Singular
vesztették	Third person Plural
elveszítik	Third person Plural
értesítettem	First person Singular
fenyegetéseket	None
újjászületnénk	First person Plural
érzésből	None
hallgattam	First person Singular
elfelejtek	First person Singular
bátyjáért	None
utálták	Third person Plural
elragadtatta	Third person Singular
nyilvánították	Third person Plural
elindítottam	First person Singular
bírálta	Third person Singular
igényeljen	Third person Singular
újjászületik	Third person Singular
kiáltotta	Third person Singular
frissítsék	Third person Plural
kasztrálták	Third person Plural
vetkőzzön	Third person Singular
feltételezünk	First person Plural
fátákká	None
diagnosztizálta	Third person Singular
forgalmaz	Third person Singular
ütköztek	Third person Plural
színészekre	None
fennmaradt	Third person Singular
rendezzem|	First person Singular
szakítsátok	Second person Plural
folyamatát	None
részüket	None
álcázták	Third person Plural
generátorokat	None
ízlik	Third person Singular
felelne	Third person Singular
befagyott	Third person Singular
egyenlítettek	Third person Plural
ugráló	None
lápról	None
törlővel	None
teljesítse	Third person Singular
megírok	First person Singular
életüket	None
céloz	Third person Singular
jellemzők	None
vámpírként	None
juttatásokat	None
veszélyét	None
algoritmusba	None
javaslatnál	None
gyökereznének	Third person Plural
sebeztél	Second person Singular
kacsával	None
megfognék	First person Singular
esetet	None
naturalizálnom	First person Singular
egyezséghez	None
megoldott	Third person Singular
szélmalom	None
érdek	None
bocsátunk	First person Plural
szimatoltam|	First person Singular
összeveti	Third person Singular
hegedüljek	First person Singular
századoknak	None
fertő	None
szépséget	None
lencsét	None
megtanuljanak	Third person Plural
elfoglalnia	Third person Singular
csinálnák	Third person Plural
kifizesse	Third person Singular
megtanultál	Second person Singular
bivalyokat	None
gyíkoknak	None
témakörre	None
igazoltatok	Second person Plural
meggyújtja	Third person Singular
akkreditálta	Third person Singular
magazinodra	None
szélébe	None
ellenőrizzétek	Second person Plural
veszti	Third person Singular
megártottak	Third person Plural
tűrt	Third person Singular
taglalta	Third person Singular
beépítette	Third person Singular
jelképezte	Third person Singular
feldobtam	First person Singular
sztahanovistáknak	None
vitorláznunk	First person Plural
kiterjesztettek	Third person Plural
ellátnak	Third person Plural
vitáztak	Third person Plural
megértik	Third person Plural
napraforgó	None
jegyezte	Third person Singular
házainak	None
medencéknél	None
háromszáznál	None
mondatáról	None
reklámozna	Third person Singular
felkínáltak	Third person Plural
meglásson	Third person Singular
felvegyenek	Third person Plural
tartóztatják	Third person Plural
mondatából	None
hevert	Third person Singular
megláttak	Third person Plural
libából	None
feltöltöttem|	First person Singular
tapasztalta	Third person Singular
kifizették	Third person Plural
söpörte	Third person Singular
összegyűjtse	Third person Singular
lánytól	None
zaklass|or|	Second person Singular
kényszerítenek	Third person Plural
szülnek	Third person Plural
gáncsokról	None
üzennem	First person Singular
hordoztak	Third person Plural
hiányoljanak	Third person Plural
kiegészítjük	First person Plural
megválasszák	Third person Plural
továbbfejlessze	Third person Singular
szenvedek	First person Singular
kijavítsuk	First person Plural
előírtak	Third person Plural
megengedte	Third person Singular
visszahelyeztél	Second person Singular
megmentsenek	Third person Plural
létesítették	Third person Plural
homár	None
fibrillálnék	First person Singular
jelöljétek	Second person Plural
rombolj|or|	Second person Singular
hintett	Third person Singular
kormányzókat	None
agitált	Third person Singular
sugall	Third person Singular
uszály	None
beismerték	Third person Plural
elárulta	Third person Singular
kesereg	Third person Singular
megkaptam	First person Singular
szigetelt	Third person Singular
életkorokba	None
híddá	None
szaporodnak	Third person Plural
indítod	Second person Singular
térítendő	None
szoknak	Third person Plural
tapintatokhoz	None
felépítse	Third person Singular
rezegnek	Third person Plural
csendet	None
táplálná	Third person Singular
producernek	None
helyszíneknek	None
felhasználod	Second person Singular
fertőztek	Third person Plural
beszámolnunk	First person Plural
bosszantja	Third person Singular
fasírozná	Third person Singular
kocsihoz	None
alkalmazkodunk	First person Plural
nyögjön	Third person Singular
belépsz	Second person Singular
fosztogatni	None
szítsanak	Third person Plural
tapasztalnia	Third person Singular
tanulmányból	None
bővítésében	None
teljesülnie	Third person Singular
viselnek	Third person Plural
reklámoznak	Third person Plural
sorozatát	None
hegységekre	None
rajongnotok	Second person Plural
egyetemistákon	None
eltávolítottuk	First person Plural
elkötelezettek	None
forgalmazták	Third person Plural
megtekint	Third person Singular
tisztelet	None
látogatnia	Third person Singular
tétovázik	Third person Singular
gondolkodsz	Second person Singular
jelöljék	Third person Plural
részletezni	None
bekapcsolt	Third person Singular
előadta	Third person Singular
elnyerjem|	First person Singular
bátorítanod	Second person Singular
vitáztam	First person Singular
jógázzon	Third person Singular
merüljenek	Third person Plural
létesítenének	Third person Plural
felkészítenek	Third person Plural
felkeresnek	Third person Plural
javítjátok	Second person Plural
doménnek	None
költészetben	None
szart	Third person Singular
megbüntet	Third person Singular
feltüntetett	Third person Singular
szállította	Third person Singular
megvalósulna	Third person Singular
előrehaladnia	Third person Singular
tengerpartra	None
diktál	Third person Singular
termesztett	Third person Singular
hetilapokban	None
meglátogatná	Third person Singular
szerkesztjük	First person Plural
stíroltuk	First person Plural
zarándokolnátok	Second person Plural
társítanak	Third person Plural
tapasztalatának	None
leírnia	Third person Singular
vízcseppeket	None
polisztirol	None
palát	None
megkapod	Second person Singular
céloztam	First person Singular
vicsorognátok	Second person Plural
letelepített	Third person Singular
szándékoznak	Third person Plural
tiszteli	Third person Singular
nemzi	Third person Singular
helyezkedne	Third person Singular
koncentráltad	Second person Singular
habbá	None
emésztett	Third person Singular
karikán	None
vigyázzunk	First person Plural
versenyezzen	Third person Singular
megnyerjétek	Second person Plural
végeznél	Second person Singular
kiderítsék	Third person Plural
javasolna	Third person Singular
megállítottak	Third person Plural
illeszkedne	Third person Singular
nyomozásnak	None
kódolunk	First person Plural
kőművesek	None
befizet	Third person Singular
megvizsgálnunk	First person Plural
megfeleljen	Third person Singular
kölcsönkérne	Third person Singular
elfehérednie	Third person Singular
feltöltsék	Third person Plural
megállapított	Third person Singular
kölcsönbe	None
bokorban	None
gazdagabból	None
rábeszéljék	Third person Plural
fókuszálta	Third person Singular
megszakítanám|	First person Singular
támadnod	Second person Singular
dám	None
hirdessétek	Second person Plural
bízok	First person Singular
kipusztultak	Third person Plural
lövedékektől	None
nővérrel	None
igazgatnak	Third person Plural
számításra	None
vegyésznél	None
megnyúzták	Third person Plural
pontján	None
rabszolgáktól	None
ellenőrzi	Third person Singular
kimutatniuk	Third person Plural
gerincvelőből	None
vív	Third person Singular
megfelelt	Third person Singular
minősítenek	Third person Plural
másért	None
kunokra	None
animáción	None
nyugaton	None
hazatalálna	Third person Singular
eladott	Third person Singular
időkig	None
feltetted	Second person Singular
igemódot	None
domináljon	Third person Singular
hozzászoktak	Third person Plural
kompenzáltak	Third person Plural
árulni	None
harcokból	None
gyengét	None
félreértettétek	Second person Plural
zúzta	Third person Singular
lelte	Third person Singular
megkérdezte	Third person Singular
megmentettem	First person Singular
agglomerációhoz	None
szavaztál	Second person Singular
szidnád	Second person Singular
szuroknak	None
egyesítettek	Third person Plural
letöltsek	First person Singular
műkedvelőkért	None
rövidítésekben	None
elvárásoktól	None
kihagyjak	First person Singular
idézze	Third person Singular
körvonalon	None
megszereznie	Third person Singular
eredményesebb	None
tájékoztassuk	First person Plural
filmeznek	Third person Plural
bennszülöttből	None
tanítsunk	First person Plural
észlel	Third person Singular
összevágott	Third person Singular
védekezőről	None
összevágnom	First person Singular
megcsalta	Third person Singular
végezzek	First person Singular
meglátogassa	Third person Singular
abszorpciót	None
elkerülte	Third person Singular
elhamvasztották	Third person Plural
szabadalmaztatnának	Third person Plural
temette	Third person Singular
diszkriminálnának	Third person Plural
millenárison	None
taglalták	Third person Plural
közvetítsen	Third person Singular
mulattok	Second person Plural
elrabol	Third person Singular
erődítményt	None
facebookozzatok	Second person Plural
vizsgáztam	First person Singular
túloztam	First person Singular
ártottatok	Second person Plural
tároljon	Third person Singular
bátorították	Third person Plural
tartóztattak	Third person Plural
kísérleteztem	First person Singular
szólalt	Third person Singular
dörzsölje	Third person Singular
fosztják	Third person Plural
bemutatták	Third person Plural
rejtik	Third person Plural
alakította	Third person Singular
áldozzanak	Third person Plural
zenél	Third person Singular
telepesekről	None
rendezvényre	None
térített	Third person Singular
tiltakozzon	Third person Singular
szellemeivel	None
előadok	First person Singular
lovagoltak	Third person Plural
nyomaszt	Third person Singular
szakítana	Third person Singular
megjavított	Third person Singular
indokolj|or|	Second person Singular
agyhártyagyulladásban	None
megjelölik	Third person Plural
ukrán	None
munkájukba	None
tiltakozna	Third person Singular
emeltem	First person Singular
megüsse	Third person Singular
vívok	First person Singular
tájékoztattak	Third person Plural
indítja	Third person Singular
kifejtettem	First person Singular
vacsoráztak	Third person Plural
lejátszották	Third person Plural
verziókra	None
indukálta	Third person Singular
hozzászoknak	Third person Plural
aggódjon	Third person Singular
fogalmazod	Second person Singular
centigrammig	None
következményként	None
kimondaná	Third person Singular
bírunk	First person Plural
legöregebbekkel	None
kommentál	Third person Singular
neveznünk	First person Plural
elindul	Third person Singular
harangra	None
megtetted	Second person Singular
megjegyez	Third person Singular
gyötört	Third person Singular
elrendezik	Third person Plural
főterétől	None
megnyitja	Third person Singular
tévesztett	Third person Singular
felfrissítsétek	Second person Plural
kopogott	Third person Singular
suttog	Third person Singular
megmondták	Third person Plural
utaljanak	Third person Plural
lovasokat	None
hibáztatja	Third person Singular
ideadtunk	First person Plural
fölírtok	Second person Plural
fenyegetéssel	None
teljesítsék	Third person Plural
bűncselekményeket	None
megnevezze	Third person Singular
hajnalodjanak	Third person Plural
látogassatok	Second person Plural
táplál	Third person Singular
bekukucskáltam	First person Singular
kezdeményezzen	Third person Singular
gépezetté	None
elkezdjék	Third person Plural
megfoszt	Third person Singular
adódott	Third person Singular
félreértettem	First person Singular
összeállította	Third person Singular
meséltem	First person Singular
forgalmastól	None
pusztításnak	None
undorodik	Third person Singular
megkezdődne	Third person Singular
dúlok	First person Singular
tavasznak	None
védekezzenek	Third person Plural
kasztrálnom	First person Singular
alkossunk	First person Plural
imádkozott	Third person Singular
illeszti	Third person Singular
álcázott	Third person Singular
átkot	None
figyelmesebbeken	None
figyeljetek	Second person Plural
idézel	Second person Singular
feliratkoztak	Third person Plural
kizártak	Third person Plural
felfedezte	Third person Singular
öntözik	Third person Plural
fektetve	None
megérted	Second person Singular
árusnál	None
kiderítette	Third person Singular
duettel	None
műhelyből	None
megmagyaráztunk	First person Plural
lövedékekhez	None
veszítünk	First person Plural
zenéltétek	Second person Plural
kenukat	None
kövére	None
klumpáig	None
automatikusakkal	None
elixírt	None
partizánokhoz	None
metszik	Third person Plural
emésztettek	Third person Plural
szörnyűségekről	None
ismertetnem	First person Singular
körülveszik	Third person Plural
ápol	Third person Singular
elérkeznek	Third person Plural
kiválasztunk	First person Plural
koktélpartit	None
szerkesztéseknél	None
obeliszkkel	None
megszereztük	First person Plural
vezéreljetek	Second person Plural
tájékoztatnia	Third person Singular
elverjék	Third person Plural
megjavította	Third person Singular
megkárosították	Third person Plural
kőomlásba	None
szabó	None
viszonyul	Third person Singular
lábadozott	Third person Singular
akadályoznák	Third person Plural
megújították	Third person Plural
muszlimként	None
testőrökkel	None
követeljenek	Third person Plural
honlapunk	None
fedett	Third person Singular
kiadtak	Third person Plural
beindul	Third person Singular
megkülönböztessünk	First person Plural
elsötétített	Third person Singular
másabbaktól	None
mindkettőről	None
megmentenie	Third person Singular
bizonyítottam	First person Singular
összegyűjteniük	Third person Plural
tájékoztat	Third person Singular
szenvedünk	First person Plural
fejezett	Third person Singular
övezi	Third person Singular
összeköt	Third person Singular
deklarációval	None
meghajolnotok	Second person Plural
házból	None
vétkeznetek	Second person Plural
elinduljon	Third person Singular
elkövetünk	First person Plural
kiválasztasz	Second person Singular
onanizálj|or|	Second person Singular
házigazdának	None
kiemelkedett	Third person Singular
harcolunk	First person Plural
vegetálnom	First person Singular
hámozott	Third person Singular
akadályozod	Second person Singular
óvszernek	None
feladjam|	First person Singular
briliánsnak	None
fókuszáljon	Third person Singular
szeparatizmusról	None
alkirályok	None
leghomályosabbakon	None
kiindulunk	First person Plural
formáltak	Third person Plural
elálltak	Third person Plural
csacsognál	Second person Singular
édesapák	None
normánál	None
frizíroztam	First person Singular
lénynek	None
lapátolok	First person Singular
burgonyát	None
hadarok	First person Singular
hiányol	Third person Singular
konszolidálódott	Third person Singular
differenciálegyenletnek	None
megvizsgálandó	None
nyafognék	First person Singular
robbannod	Second person Singular
tűrünk	First person Plural
örökséghez	None
teregetitek	Second person Plural
megemlítenünk	First person Plural
tisztázzunk	First person Plural
sértegetniük	Third person Plural
érdemelne	Third person Singular
szakítunk	First person Plural
ösztönöz	Third person Singular
szakmai	None
archiváljunk	First person Plural
elkészültem	First person Singular
hozzátartozott	Third person Singular
megemlítettek	Third person Plural
nemzenek	Third person Plural
nyugtat	Third person Singular
felsorolnom	First person Singular
tájékoztassanak	Third person Plural
emlékeznek	Third person Plural
kimondanál	Second person Singular
megbántott	Third person Singular
megfertőző	None
márkihoz	None
nyitottból	None
amilázoktól	None
cáfoljatok	Second person Plural
lányokat	None
salátaboglárkákká	None
újítanak	Third person Plural
fogamzásokhoz	None
szimatolnak	Third person Plural
keresztelnek	Third person Plural
soroltak	Third person Plural
zarándokoltál	Second person Singular
hurcoltak	Third person Plural
érdemelték	Third person Plural
szédüljetek	Second person Plural
elhelyezel	Second person Singular
vesztenének	Third person Plural
kényszerülnek	Third person Plural
egykötetesekben	None
sündisznóból	None
legeltették	Third person Plural
kiírták	Third person Plural
vágányokon	None
felakasztotta	Third person Singular
villámlanod	Second person Singular
kiindulnunk	First person Plural
pörgött	Third person Singular
sütsz	Second person Singular
évadnál	None
elvártam	First person Singular
találkozunk	First person Plural
telítettek	Third person Plural
betegedett	Third person Singular
pirit	None
eldobott	Third person Singular
elfogyassza	Third person Singular
fiataloknál	None
bejegyzi	Third person Singular
újraíró	None
bombázott	Third person Singular
lényegbe	None
jelentkezünk	First person Plural
visszamenniük	Third person Plural
megmaradnak	Third person Plural
sóhajok	None
emlékeztetnek	Third person Plural
voksolna	Third person Singular
lemondasz	Second person Singular
felkeresi	Third person Singular
boldogul	Third person Singular
vándort	None
langyosaknál	None
alábecsült	Third person Singular
ugratott	Third person Singular
vetélkedik	Third person Singular
témákra	None
jelöltem	First person Singular
tévedtél	Second person Singular
lefordítottam	First person Singular
bíróságokat	None
nyilvánul	Third person Singular
zajlania	Third person Singular
koncertek	None
elásták	Third person Plural
kiegészítetted	Second person Singular
költik	Third person Plural
leadnál	Second person Singular
döf	Third person Singular
kreativitásnak	None
anyagával	None
konzerváltak	Third person Plural
helyen	None
csámcsogjatok	Second person Plural
elképzelték	Third person Plural
lapunk	None
megerősödik	Third person Singular
hangsúlyozz|or|	Second person Singular
indukáltatok	Second person Plural
szerkesszünk	First person Plural
rájöttél	Second person Singular
fickón	None
kockázatosnak	None
hálószobát	None
egybeírt	Third person Singular
koraszülöttként	None
vetélkednem	First person Singular
vezetéséért	None
létrehoztad	Second person Singular
megtartanak	Third person Plural
dugott	Third person Singular
meghatározásokat	None
eltávolítja	Third person Singular
latolgatja	Third person Singular
vadászrepülőgépek	None
havazott	Third person Singular
összebarátkozott	Third person Singular
táplálkozzon	Third person Singular
bővítették	Third person Plural
lapban	None
légionisták	None
leülök	First person Singular
hidaknak	None
sanzonok	None
fekszenek	Third person Plural
rombolt	Third person Singular
tanítanának	Third person Plural
szekrényre	None
kialszanak	Third person Plural
kényszeríteniük	Third person Plural
védekeznék	First person Singular
pontszámok	None
leült	Third person Singular
összefogott	Third person Singular
megálljon	Third person Singular
lezuhanna	Third person Singular
polipokhoz	None
csirizelnének	Third person Plural
reggelizzenek	Third person Plural
szórakoztam	First person Singular
keresztelik	Third person Plural
készíttetett	Third person Singular
befejezzék	Third person Plural
radíroznak	Third person Plural
rabol	Third person Singular
ítélték	Third person Plural
elemmel	None
mulasztott	Third person Singular
felújítsák	Third person Plural
kitörjön	Third person Singular
elpárolog	Third person Singular
zsebkendőket	None
kiszámítjuk	First person Plural
mutatkoztunk	First person Plural
kifejtette	Third person Singular
kiégnek	Third person Plural
befejezed	Second person Singular
panaszkodtunk	First person Plural
összeállítanak	Third person Plural
egyeztette	Third person Singular
üzemeltetnek	Third person Plural
visszamegyek	First person Singular
siettem	First person Singular
tartósított	Third person Singular
rehabilitálta	Third person Singular
megtekintsetek	Second person Plural
kerekítettek	Third person Plural
tankol	Third person Singular
utasítjuk	First person Plural
szigeteli	Third person Singular
bemutatja	Third person Singular
átnéztem	First person Singular
megtanult	Third person Singular
minősüljön	Third person Singular
névutóval	None
fejez	Third person Singular
elismeri	Third person Singular
bútordarab	None
orrnál	None
rendezzünk	First person Plural
indokolna	Third person Singular
hibáztatták	Third person Plural
szintetizálta	Third person Singular
robbant	Third person Singular
ásatásnál	None
emelte	Third person Singular
ráadta	Third person Singular
minősülne	Third person Singular
reklámról	None
kutatásokból	None
vonzanak	Third person Plural
bejegyezték	Third person Plural
felsoroltam	First person Singular
reptérről	None
megvalósultam	First person Singular
kiengedték	Third person Plural
eszközökre	None
kategorizáltam	First person Singular
távcsőre	None
tisztítják	Third person Plural
lejátszaniuk	Third person Plural
elfogyasztották	Third person Plural
szórtam	First person Singular
meglepje	Third person Singular
legismertebbekbe	None
elnyerjék	Third person Plural
légionistán	None
megsemmisítené	Third person Singular
elutasították	Third person Plural
mátrixból	None
megjelentetnünk	First person Plural
elfoglalnak	Third person Plural
kiszámított	Third person Singular
tanulmányozni	None
áradástól	None
megragadjam|	First person Singular
állapítja	Third person Singular
megbüntetik	Third person Plural
megkárosította	Third person Singular
keveredett	Third person Singular
teljesített	Third person Singular
reagálok	First person Singular
cipelnéd	Second person Singular
informálta	Third person Singular
északnak	None
dokumentálták	Third person Plural
bántjuk	First person Plural
tükrözi	Third person Singular
diktáltunk	First person Plural
hazamenjetek	Second person Plural
szupermarketet	None
rendetlenkedik	Third person Singular
piszkálsz	Second person Singular
emlékműnek	None
közömbösek	None
rejlettél	Second person Singular
turbinákat	None
bíbic	None
titkosítjátok	Second person Plural
elveszed	Second person Singular
csinálnom	First person Singular
beszállnak	Third person Plural
felújította	Third person Singular
felmérését	None
megmondtad	Second person Singular
akkreditálták	Third person Plural
árulná	Third person Singular
megverve	None
odafigyelünk	First person Plural
megállítja	Third person Singular
támadták	Third person Plural
közösülést	None
összevágtak	Third person Plural
megszereztem|	First person Singular
meglepnie	Third person Singular
megöltük	First person Plural
terjesztendő	None
kiszenvednék	First person Singular
ámulatoktól	None
betonoznunk	First person Plural
képessége	None
elásnának	Third person Plural
falucskának	None
építkezéseknek	None
megkérdezett	Third person Singular
szinkronizáljak	First person Singular
informálták	Third person Plural
összekeverte	Third person Singular
kimúlik	Third person Singular
jellemzőjévé	None
falusiaktól	None
tévedünk	First person Plural
illeszkedett	Third person Singular
legrosszabbak	None
leírtad	Second person Singular
átnevezik	Third person Plural
lefordítottuk	First person Plural
megtárgyalták	Third person Plural
harmonika	None
kivonulnak	Third person Plural
kergették	Third person Plural
megnyugtatjátok	Second person Plural
kitűnik	Third person Singular
horkoljunk	First person Plural
illessze	Third person Singular
strandoktól	None
kompot	None
felháborítja	Third person Singular
hajhullást	None
aktivizálok	First person Singular
vádoltak	Third person Plural
bántak	Third person Plural
halványul	Third person Singular
kergessék	Third person Plural
tatu	None
nyilvántartják	Third person Plural
csináljatok	Second person Plural
kezelné	Third person Singular
újítottátok	Second person Plural
megerőszakolt	Third person Singular
elviselik	Third person Plural
tükröznünk	First person Plural
betért	Third person Singular
semlegesnemekben	None
felülkerekedni	None
őrzik	Third person Plural
beiktattam	First person Singular
erőlködj|or|	Second person Singular
járulékok	None
ellopjon	Third person Singular
elnyerjek	First person Singular
bevezetésből	None
felrobban	Third person Singular
vitáztál	Second person Singular
felbontó	None
fürdővé	None
szakítson	Third person Singular
mérlegeli	Third person Singular
féltettünk	First person Plural
átnevezi	Third person Singular
megtaláltok	Second person Plural
találgatták	Third person Plural
hatmillió	None
elválasztják	Third person Plural
kihalt	Third person Singular
ágyazzon	Third person Singular
kijelent	Third person Singular
szennyez	Third person Singular
letartóztatott	Third person Singular
humanistákkal	None
választásokat	None
kelted	Second person Singular
ünnepelnek	Third person Plural
alakították	Third person Plural
megnyomtam	First person Singular
indukálnak	Third person Plural
nyilvánítsanak	Third person Plural
kúsznak	Third person Plural
megfutamodtak	Third person Plural
vásároltak	Third person Plural
bezárt	Third person Singular
szárították	Third person Plural
vállkendőkkel	None
szűnt	Third person Singular
megkérdeznek	Third person Plural
hadart	Third person Singular
legyőznünk	First person Plural
helyesbített	Third person Singular
bevezessük	First person Plural
beleírniuk	Third person Plural
csomagolniuk	Third person Plural
beírnia	Third person Singular
homokóra	None
ráadtátok	Second person Plural
fesztiválokat	None
illesztettem	First person Singular
kockáztatta	Third person Singular
tetette	Third person Singular
rajongott	Third person Singular
üzemeltették	Third person Plural
felépítjük	First person Plural
versenyeznie	Third person Singular
népbe	None
kérdezzenek	Third person Plural
testtanokkal	None
elvégzett	Third person Singular
rávegyék	Third person Plural
agitáltak	Third person Plural
regények	None
vonzódik	Third person Singular
megkülönböztesse	Third person Singular
megőrzik	Third person Plural
összegyűlt	Third person Singular
áfonyával	None
bemutatott	Third person Singular
hirdetnek	Third person Plural
torzul	Third person Singular
beruházásokat	None
teljesülne	Third person Singular
világbajnokságba	None
kommunizmushoz	None
újságokat	None
találgat	Third person Singular
valószínűség	None
ugrásnak	None
kapitulált	Third person Singular
telefonálna	Third person Singular
felhívnom	First person Singular
elfojtja	Third person Singular
kémkedtem	First person Singular
tankönyvekbe	None
redőny	None
ócskapiacokként	None
faluk	None
mumusból	None
fűződnek	Third person Plural
ültet	Third person Singular
kétséget	None
nagyvakokat	None
minősítjük	First person Plural
pikkelyekig	None
intenek	Third person Plural
kasztráltak	Third person Plural
völgyekbe	None
emlékszik	Third person Singular
összekevertem	First person Singular
felveendő	None
kedvezett	Third person Singular
alapozod	Second person Singular
idéztél	Second person Singular
figyelnie	Third person Singular
gyerekeket	None
feltöltött	Third person Singular
csatára	None
azonosítják	Third person Plural
növekedést	None
megállapításának	None
aggódnak	Third person Plural
hangszórótól	None
érvénybe	None
racionalizáljak	First person Singular
felment	Third person Singular
fókuszálunk	First person Plural
eltörtek	Third person Plural
blokkolod	Second person Singular
mázsáld|or|	Second person Singular
ultiztam|	First person Singular
előmozdították	Third person Plural
elrejtené	Third person Singular
meghalnék	First person Singular
ültessük	First person Plural
találkoztatok	Second person Plural
meglep	Third person Singular
fedjenek	Third person Plural
szítják	Third person Plural
fakulnak	Third person Plural
súgóban	None
cipel	Third person Singular
szerelték	Third person Plural
delfin	None
megakadályozzon	Third person Singular
piackutatások	None
dalol	Third person Singular
áthúztam	First person Singular
kihasznált	Third person Singular
létrehozod	Second person Singular
honiig	None
mozgassa	Third person Singular
sóznak	Third person Plural
optimálisnak	None
kinyitjuk	First person Plural
binom	None
popularizál	Third person Singular
ágyaznád	Second person Singular
portékának	None
fejleszteniük	Third person Plural
létrejön	Third person Singular
húrokkal	None
szabályokra	None
zarándokolnak	Third person Plural
kényszerülne	Third person Singular
keringésben	None
duzzadnánk	First person Plural
raktárosként	None
szabványosítok	First person Singular
utolér	Third person Singular
felhasználóbaráton	None
lepje	Third person Singular
közvetítették	Third person Plural
hozzászólni	None
tartozékokkal	None
javítanom	First person Singular
programozó	None
megbeszélnie	Third person Singular
tataroz	Third person Singular
feltegye	Third person Singular
elkísérted	Second person Singular
benyújtott	Third person Singular
beavatkoztak	Third person Plural
elhatározott	Third person Singular
analízisben	None
nevezetesekről	None
kialakításában	None
vetített	Third person Singular
hirdetésben	None
kritikusokat	None
képletek	None
egyházban	None
tisztították	Third person Plural
vitáktól	None
javasolták	Third person Plural
elfogyott	Third person Singular
toborozzatok	Second person Plural
jelölök	First person Singular
koncentrál	Third person Singular
közvetítők	None
feltegyük	First person Plural
bevertük	First person Plural
árbócra	None
elfogniuk	Third person Plural
megérkeznétek	Second person Plural
tárolóhoz	None
bírod	Second person Singular
közvetítetted	Second person Singular
rábeszélték	Third person Plural
megtörténnie	Third person Singular
magáztunk	First person Plural
könnynél	None
megteszek	First person Singular
korszerűsített	Third person Singular
kelt	Third person Singular
köröz	Third person Singular
születésnapjától	None
tárgyát	None
felkészülnek	Third person Plural
zuhan	Third person Singular
istenekért	None
részvételéhez	None
elsődlegesként	None
megértenem	First person Singular
kifejtenéd	Second person Singular
szab	Third person Singular
vékonyak	None
megjelenítésnek	None
bukkanjanak	Third person Plural
végződnie	Third person Singular
bázisok	None
koldusokat	None
olvasástól	None
kipróbálnod	Second person Singular
tanítványaként	None
megtart	Third person Singular
odavágtok	Second person Plural
mesélt	Third person Singular
relikviáktól	None
bedobott	Third person Singular
összegyűjtsön	Third person Singular
riasztott	Third person Singular
másolt	Third person Singular
fingik	Third person Singular
csinálnod	Second person Singular
kinyitott	Third person Singular
feszítjük	First person Plural
idegeknek	None
tanítanak	Third person Plural
gondolatainál	None
melegedtek	Third person Plural
eszközeiként	None
elügyetlenkednéd	Second person Singular
nyaralunk	First person Plural
vallásosságot	None
sajnálok	First person Singular
megakadályozta	Third person Singular
expresszen	None
disznóság	None
befagynak	Third person Plural
válaszoljon	Third person Singular
hangsúlyoz	Third person Singular
megvenné	Third person Singular
egyesek	None
utálsz	Second person Singular
reagáljak	First person Singular
minősíted	Second person Singular
kérésnek	None
fajoktól	None
fejlesszenek	Third person Plural
balta	None
belügyminiszterként	None
eltérőbbre	None
vitatkozunk	First person Plural
hozzáadod	Second person Singular
átejtik	Third person Plural
kegyetlenebbekkel	None
előterjesztették	Third person Plural
kereskedjenek	Third person Plural
felkelt	Third person Singular
cáfol	Third person Singular
rövidítettem	First person Singular
növesszétek	Second person Plural
meghal	Third person Singular
négyzetszámok	None
egyesült	Third person Singular
oszlik	Third person Singular
távolodtak	Third person Plural
lakássá	None
legbiztosabbakért	None
frissít	Third person Singular
elsüllyednek	Third person Plural
fundamentalizmust	None
zsírozniuk	Third person Plural
fejezniük	Third person Plural
elfogadottól	None
elválasztotta	Third person Singular
tiprunk	First person Plural
beismeri	Third person Singular
szigetel	Third person Singular
lerombolta	Third person Singular
vitorláztak	Third person Plural
fertőkig	None
megtekintettem	First person Singular
legérdemesebbekben	None
medencétől	None
mandarinokért	None
teljesültek	Third person Plural
drogba	None
jelenségre	None
megfogalmaz	Third person Singular
marhahúsból	None
tudományos	None
rámutatunk	First person Plural
helybenhagysz	Second person Singular
továbbítottam	First person Singular
fogadjon	Third person Singular
beszerzésének	None
megnyugodjatok	Second person Plural
vakációzott	Third person Singular
pumpálnak	Third person Plural
áldoznia	Third person Singular
fokozódtak	Third person Plural
csinálnék	First person Singular
kijavítanak	Third person Plural
tusfürdők	None
hatalmaktól	None
cápának	None
jegyzek	First person Singular
beteszünk	First person Plural
ártottam|	First person Singular
intézzék	Third person Plural
hiányolsz	Second person Singular
fóbiák	None
percen	None
befedtük	First person Plural
jobbágyokból	None
gyíkoknál	None
menekülniük	Third person Plural
újraválasztva	None
ütköznek	Third person Plural
állandósulnod	Second person Singular
vitázunk	First person Plural
kijavítottad	Second person Singular
indítaniuk	Third person Plural
irányítana	Third person Singular
reklámozunk	First person Plural
diszkvalifikáltad	Second person Singular
tatarozta	Third person Singular
sejtették	Third person Plural
megvédi	Third person Singular
szuronyt	None
arzénben	None
minősülnének	Third person Plural
tojássárgájának	None
kiközösítenem	First person Singular
növényként	None
átlássa	Third person Singular
zárulnának	Third person Plural
dideregtetek	Second person Plural
erősíteném|	First person Singular
felszabadítsa	Third person Singular
elbeszélünk	First person Plural
determinál	Third person Singular
lapított	Third person Singular
ligatúrába	None
kelletitek	Second person Plural
szomszédok	None
zárultak	Third person Plural
beérkezik	Third person Singular
macskajajnak	None
megakadályozva	None
merült	Third person Singular
feltüntetnie	Third person Singular
meglátják	Third person Plural
volfrámokat	None
vázolnának	Third person Plural
megnéztük	First person Plural
ünnepelte	Third person Singular
szavazott	Third person Singular
beküldi	Third person Singular
csináltál	Second person Singular
továbbítsa	Third person Singular
társalog	Third person Singular
kacagná	Third person Singular
csomagol	Third person Singular
megemlíted	Second person Singular
létesíteniük	Third person Plural
létesítsenek	Third person Plural
impregnáltak	Third person Plural
vakarnék	First person Singular
szellőztessétek	Second person Plural
félreértek	First person Singular
koronáz	Third person Singular
körülvett	Third person Singular
utánanézzek	First person Singular
pokrócot	None
felelt	Third person Singular
tanultam	First person Singular
fogyasztották	Third person Plural
reagál	Third person Singular
megtizedelte	Third person Singular
visszaesik	Third person Singular
beírták	Third person Plural
kiindul	Third person Singular
dokkokhoz	None
körülvették	Third person Plural
viseljen	Third person Singular
felrobbanna	Third person Singular
rop	Third person Singular
műtőt	None
ragaszt	Third person Singular
megnyissák	Third person Plural
emésztette	Third person Singular
tökéletesítek	First person Singular
undorítottam	First person Singular
varázsolt	Third person Singular
gyötörted	Second person Singular
fejlesztéseken	None
beleírtam|	First person Singular
átnevezed	Second person Singular
hallucinációk	None
megkövetelni	None
megközelíti	Third person Singular
megbeszélned	Second person Singular
megújítok	First person Singular
kifejezzék	Third person Plural
vastagítok	First person Singular
elsodor	Third person Singular
jellemzi	Third person Singular
működtetik	Third person Plural
meglát	Third person Singular
tapadok	First person Singular
tüntessünk	First person Plural
tétovázott	Third person Singular
elfelejtik	Third person Plural
vizsgál	Third person Singular
kémkednék	First person Singular
gyalogod	None
fáradni	None
képzelnek	Third person Plural
karcol	Third person Singular
boncoltátok	Second person Plural
datolyapálmák	None
szállítja	Third person Singular
receptek	None
ellenőrizték	Third person Plural
exportált	Third person Singular
jégkorongoznának	Third person Plural
bírjanak	Third person Plural
döntésért	None
kategorizálták	Third person Plural
rekvirálták	Third person Plural
angolt	None
vízesésként	None
öntöztek	Third person Plural
kifejlesztenek	Third person Plural
képességű	None
figyelmeztetné	Third person Singular
fogalmaztad	Second person Singular
titkárnőkbe	None
címerben	None
feldobta	Third person Singular
megjelenítik	Third person Plural
jogosítanál	Second person Singular
legkifürkészhetetlenebbig	None
hallatszott	Third person Singular
tojnák	Third person Plural
pálmává	None
fennsík	None
igényelt	Third person Singular
teremtett	Third person Singular
kiabálnom	First person Singular
visszaélt	Third person Singular
igyál	Second person Singular
megijedt	Third person Singular
robbantak	Third person Plural
ellátott	Third person Singular
felébressze	Third person Singular
tékozolnád	Second person Singular
megjelenítenek	Third person Plural
egyesültek	Third person Plural
szándékoztam	First person Singular
megtanulok	First person Singular
mészárol	Third person Singular
dicsérje	Third person Singular
vizelt	Third person Singular
árult	Third person Singular
kergetik	Third person Plural
eltávolított	Third person Singular
eltűnne	Third person Singular
kielégített	Third person Singular
fosztjuk	First person Plural
tehénként	None
szül	Third person Singular
létesült	Third person Singular
elveszíti	Third person Singular
kinéznek	Third person Plural
lezárjanak	Third person Plural
megakadályoztak	Third person Plural
túlzásokra	None
lefoglalniuk	Third person Plural
hivatkoznánk	First person Plural
naturalizálnám|	First person Singular
kiáltson	Third person Singular
posztolnának	Third person Plural
ebédelt	Third person Singular
szakítsanak	Third person Plural
komponálnád	Second person Singular
kávéházakat	None
tálalnak	Third person Plural
alvilágba	None
szűnnünk	First person Plural
témában	None
ismerkedne	Third person Singular
fehérjéből	None
beindulni	None
bízta	Third person Singular
keltse	Third person Singular
rugalmasaknak	None
lemenned	Second person Singular
kiheréljetek	Second person Plural
nehezítettük	First person Plural
házakról	None
összezsugorítjuk	First person Plural
veszekedik	Third person Singular
munkásságának	None
uralomért	None
településekről	None
képezzék	Third person Plural
tanul	Third person Singular
kórháztól	None
rasszizmusoknál	None
bemutatkozik	Third person Singular
szkandium	None
jogviszonnyal	None
veszített	Third person Singular
tárgyaljon	Third person Singular
ismétlődniük	Third person Plural
utáltam	First person Singular
megmutatták	Third person Plural
elkövették	Third person Plural
újoncoknak	None
sérti	Third person Singular
csirizelt	Third person Singular
megáldanak	Third person Plural
csatlakoznának	Third person Plural
jogellenesekért	None
rendezik	Third person Plural
jellemzőitől	None
módosultak	Third person Plural
sajnált	Third person Singular
felsorolunk	First person Plural
solymászok	None
teremteniük	Third person Plural
strukturális	None
szentélyeknél	None
vádol	Third person Singular
létrehozásába	None
visszaadná	Third person Singular
csoportba	None
ismételje	Third person Singular
szellemekkel	None
közelítik	Third person Plural
felbontja	Third person Singular
megnehezítené	Third person Singular
körülveszi	Third person Singular
látogatásától	None
felelték	Third person Plural
nyílna	Third person Singular
elmozdították	Third person Plural
változtatásokra	None
megírt	Third person Singular
redukálta	Third person Singular
amerícium	None
cenzúráznak	Third person Plural
ürítik	Third person Plural
varázsolták	Third person Plural
csibéhez	None
sebeztünk	First person Plural
hozzájárulok	First person Singular
bemutattam	First person Singular
felhasználniuk	Third person Plural
megkérték	Third person Plural
véglegesítettek	Third person Plural
sajnálta	Third person Singular
kifejezésmód	None
székesegyházként	None
újítsuk	First person Plural
aranyabba	None
festőállványoknak	None
elkezdted	Second person Singular
raboskodott	Third person Singular
kihúztátok	Second person Plural
egyeztetnie	Third person Singular
harcokat	None
feltennem	First person Singular
hozományokra	None
észlelsz	Second person Singular
képzelje	Third person Singular
felkészülnie	Third person Singular
szarvban	None
túlbecsülték	Third person Plural
lefejezett	Third person Singular
pontszámon	None
kalandos	None
legtöbbre	None
arkangyalt	None
ígéretesnek	None
elvenné	Third person Singular
portugálnak	None
sablonnál	None
téríti	Third person Singular
megjelenítjük	First person Plural
piálod	Second person Singular
eltűnjön	Third person Singular
vitatod	Second person Singular
fecskesirály	None
hősnő	None
kockázatára	None
egyezményeken	None
visszatérjenek	Third person Plural
unatkoztam	First person Singular
fejtsenek	Third person Plural
uszította	Third person Singular
viszonozta	Third person Singular
mozdított	Third person Singular
bánnék	First person Singular
hozzátennünk	First person Plural
smokként	None
szervizeknek	None
ösztönözze	Third person Singular
sétál	Third person Singular
kormányzatról	None
oltárral	None
burjánozzon	Third person Singular
elkényeztetett	Third person Singular
tördelnem	First person Singular
zsákmányoltak	Third person Plural
int	Third person Singular
kiszállok	First person Singular
diagnosztizálni	None
ítélek	First person Singular
linóleumot	None
epicentrumoknak	None
átnevezett	Third person Singular
szétesik	Third person Singular
feszül	Third person Singular
nyilatkozták	Third person Plural
hasznosítsa	Third person Singular
megragadtak	Third person Plural
határoltak	Third person Plural
frissítsük	First person Plural
rosszra	None
borkősavat	None
szekereket	None
munkaerőnek	None
csatornaként	None
megegyezniük	Third person Plural
megvegyék	Third person Plural
hivatkozzon	Third person Singular
tejtermékekre	None
installálok	First person Singular
mamelukoknak	None
felmosnotok	Second person Plural
villamossághoz	None
dobozosat	None
koncepcióról	None
igazoltuk	First person Plural
meglepne	Third person Singular
kitiltották	Third person Plural
jelenségeken	None
átlássunk	First person Plural
alkotóval	None
befektetett	Third person Singular
szeretkezett	Third person Singular
forraltál	Second person Singular
muzsikáltuk	First person Plural
temesse	Third person Singular
találkozna	Third person Singular
jelölt	Third person Singular
elpárologtatja	Third person Singular
bauxitból	None
vétkezzek	First person Singular
megjegyzi	Third person Singular
kocsiról	None
elvárták	Third person Plural
tüntetek	First person Singular
megnéznéd	Second person Singular
feltárták	Third person Plural
alakítsunk	First person Plural
raktároztak	Third person Plural
felhív	Third person Singular
szándékoztak	Third person Plural
javasolnál	Second person Singular
zajosak	None
alapjában	None
igényelnének	Third person Plural
figyelmük	None
megismétel	Third person Singular
tönkreteszi	Third person Singular
retusálták	Third person Plural
emblémák	None
vigyáznod	Second person Singular
berendezzem|	First person Singular
álló	None
összehasonlítják	Third person Plural
kitagadjanak	Third person Plural
kajmakámon	None
tanulmányoznak	Third person Plural
utasították	Third person Plural
gyötörte	Third person Singular
bombarobbanásnál	None
kerülgeti	Third person Singular
cipeli	Third person Singular
hátrálnak	Third person Plural
tüzeljen	Third person Singular
szavalt	Third person Singular
elmulasztja	Third person Singular
bauxitbányák	None
feltöltse	Third person Singular
foglalkoztassák	Third person Plural
tiltotta	Third person Singular
tanulmányozott	Third person Singular
megnézik	Third person Plural
beküldte	Third person Singular
indítványt	None
vegyítettünk	First person Plural
tollászkodod	Second person Singular
ural	Third person Singular
verekedni	None
uraltál	Second person Singular
indokoltatok	Second person Plural
húzódna	Third person Singular
erőszakra	None
kerekítik	Third person Plural
szubjektivitásokként	None
elkezdtél	Second person Singular
teregessünk	First person Plural
válaszoltak	Third person Plural
lassítaniuk	Third person Plural
bejelentkezett	Third person Singular
megölted	Second person Singular
kiállítsa	Third person Singular
meghalsz	Second person Singular
fibrilláltunk	First person Plural
térdelt	Third person Singular
megtartottak	Third person Plural
szövegkörnyezetet	None
elárulnád	Second person Singular
hegedül	Third person Singular
csinál	Third person Singular
vesztik	Third person Plural
hivatkoznának	Third person Plural
szemetel	Third person Singular
indították	Third person Plural
titkosította	Third person Singular
elnökénél	None
lezárásig	None
meggyújtottak	Third person Plural
elkészítette	Third person Singular
megnyomod	Second person Singular
illeszkedjenek	Third person Plural
szít	Third person Singular
táncospárokért	None
napoknál	None
tapsolták	Third person Plural
labirintusokban	None
nyalnunk	First person Plural
bocsátottam	First person Singular
végződik	Third person Singular
kóláktól	None
különbözünk	First person Plural
kereskednek	Third person Plural
virítanak	Third person Plural
vergődött	Third person Singular
kibocsátandó	None
elrendelt	Third person Singular
fulladjon	Third person Singular
csizmák	None
versengtek	Third person Plural
erőszakban	None
kiválnunk	First person Plural
időintervallumon	None
kardoskodnak	Third person Plural
házasságiakká	None
hódolnak	Third person Plural
kifejezésekkel	None
folytatódjon	Third person Singular
söpörve	None
berzenkedik	Third person Singular
lovasoknak	None
elrendelné	Third person Singular
kalapált	Third person Singular
feltárnia	Third person Singular
felveszel	Second person Singular
csapadékkal	None
lezuhantak	Third person Plural
gondolkozol	Second person Singular
rögzítjük	First person Plural
véste	Third person Singular
szolgálatban	None
székelnének	Third person Plural
elrepülnek	Third person Plural
ütközne	Third person Singular
felajánlottak	Third person Plural
tapasztotta	Third person Singular
elvonszoltatok	Second person Plural
megőriznek	Third person Plural
minősítsünk	First person Plural
szavazókat	None
borotválták	Third person Plural
ellentmondva	None
alkotta	Third person Singular
elkerülik	Third person Plural
vétózol	Second person Singular
cselekedjétek	Second person Plural
feszültségről	None
megteremtenie	Third person Singular
csípőig	None
pontosvessző	None
forrására	None
soványak	None
újjászületett	Third person Singular
ismertetik	Third person Plural
megvették	Third person Plural
lefordítsák	Third person Plural
alszik	Third person Singular
verbuválták	Third person Plural
feltöltöd	Second person Singular
lappangania	Third person Singular
megelőzés	None
állományokon	None
látogatnak	Third person Plural
versenyautóban	None
megjegyezte	Third person Singular
újoncokat	None
megrendelt	Third person Singular
megtaláltad	Second person Singular
elhanyagoljunk	First person Plural
ellenőriz	Third person Singular
levont	Third person Singular
szelekciót	None
leírtunk	First person Plural
fogadniuk	Third person Plural
tagján	None
ártott	Third person Singular
visszatérésként	None
informálisabbra	None
módosítunk	First person Plural
suliból	None
elkorcsosodjon	Third person Singular
végeznek	Third person Plural
kölcsönözzön	Third person Singular
bemutatnia	Third person Singular
utánanézel	Second person Singular
lassulunk	First person Plural
történeteknél	None
egyeztessen	Third person Singular
összeadott	Third person Singular
megfullad	Third person Singular
súg	Third person Singular
felszerelik	Third person Plural
pisil	Third person Singular
keresztneveket	None
szendergünk	First person Plural
emelnie	Third person Singular
elválasztott	Third person Singular
jezsuitáknál	None
megbeszéli	Third person Singular
elküldenek	Third person Plural
megbeszélte	Third person Singular
kihagytad	Second person Singular
repülőtérnek	None
szférát	None
szabotálta	Third person Singular
szkenneltem	First person Singular
előbőr	None
megvédjék	Third person Plural
keletkezne	Third person Singular
samponozott	Third person Singular
hallgattatok	Second person Plural
végződnek	Third person Plural
megáld	Third person Singular
átkeresztelték	Third person Plural
horgászra	None
ingadoznak	Third person Plural
fűrészelnie	Third person Singular
elősegítsék	Third person Plural
pilótáknak	None
kávéznotok	Second person Plural
bekapcsoltam	First person Singular
játszmákként	None
stabilizál	Third person Singular
pihenést	None
földrengésekkel	None
filmjébe	None
viselkednének	Third person Plural
megtartsuk	First person Plural
pálcikákkal	None
jelöltek	Third person Plural
beavatkozott	Third person Singular
ismételjünk	First person Plural
kártalanította	Third person Singular
szemlél	Third person Singular
ugrált	Third person Singular
elkerülniük	Third person Plural
darált	Third person Singular
megfigyel	Third person Singular
kivonnád	Second person Singular
rezeg	Third person Singular
komponenseknek	None
kérdezze	Third person Singular
megidézzetek	Second person Plural
beidézett	Third person Singular
erősítik	Third person Plural
kötelekből	None
átkeresztelik	Third person Plural
kijelölnünk	First person Plural
előállítja	Third person Singular
fürtökben	None
bibliából	None
összeállították	Third person Plural
fentiekre	None
parkot	None
megnyer	Third person Singular
riasztotta	Third person Singular
utánanéztél	Second person Singular
előzte	Third person Singular
utánoztam|	First person Singular
nődögélnék	First person Singular
kering	Third person Singular
hallgattál	Second person Singular
állításának	None
skalpolnia	Third person Singular
egyenlítik	Third person Plural
nyafognák	Third person Plural
beírsz	Second person Singular
meglátott	Third person Singular
összeadta	Third person Singular
építmény	None
igéző	None
kialakíts|or|	Second person Singular
rámutatnak	Third person Plural
hazudtam	First person Singular
idézzek	First person Singular
illesztik	Third person Plural
űrhajósokról	None
idegsejt	None
zaklattak	Third person Plural
megvalósuljon	Third person Singular
bagázsokból	None
otthonodból	None
megjavít	Third person Singular
tüntessen	Third person Singular
megsemmisítened	Second person Singular
kovácsoltak	Third person Plural
tölggyel	None
tendál	Third person Singular
savanyúak	None
pulykáig	None
méretével	None
vigyorogjatok	Second person Plural
színez	Third person Singular
ikonba	None
tolerál	Third person Singular
becsap	Third person Singular
jutalmazta	Third person Singular
ürítsék	Third person Plural
hallgattak	Third person Plural
szerkesztenek	Third person Plural
oltáron	None
ültetett	Third person Singular
mámort	None
érintőt	None
köténnyel	None
emészteném|	First person Singular
egészek	None
kéretne	Third person Singular
felhasználd|or|	Second person Singular
másoljanak	Third person Plural
illeszkedik	Third person Singular
terjesztették	Third person Plural
tisztítanak	Third person Plural
megkértem	First person Singular
eltávolítsa	Third person Singular
akadémiákon	None
fogadnának	Third person Plural
kihagyták	Third person Plural
randevúzott	Third person Singular
elvesztem	First person Singular
kiderítenem	First person Singular
keletkezzenek	Third person Plural
fűszerezik	Third person Plural
színűeket	None
aktiválás	None
leadtak	Third person Plural
kiszabadulniuk	Third person Plural
kifejezitek	Second person Plural
megnézel	Second person Singular
hangsúlyoztátok	Second person Plural
feladatai	None
impregnált	Third person Singular
részesítette	Third person Singular
zuhantak	Third person Plural
elemezze	Third person Singular
kémkedjen	Third person Singular
megfagynánk	First person Plural
beöltöznötök	Second person Plural
módosítástól	None
szerkesztik	Third person Plural
földrajztudósok	None
szegényebbeket	None
tapadjon	Third person Singular
fordítóirodáért	None
felkeresse	Third person Singular
irányulna	Third person Singular
lopástól	None
kiváltságosakig	None
utazóként	None
kerülettel	None
függelékként	None
értesült	Third person Singular
domesztikált	Third person Singular
misztifikálnák	Third person Plural
bocsátjuk	First person Plural
levette	Third person Singular
parancsok	None
féltik	Third person Plural
szükségek	None
teremtsenek	Third person Plural
emelték	Third person Plural
gondolatától	None
szabályoztak	Third person Plural
felejtették	Third person Plural
meglepi	Third person Singular
lányok	None
bizánciakra	None
szájkosár	None
kerget	Third person Singular
forrasztották	Third person Plural
völgyről	None
burok	None
rábeszélik	Third person Plural
színvonalának	None
harcoljunk	First person Plural
átgondoltam	First person Singular
fejlődnek	Third person Plural
előmozdítsák	Third person Plural
szén	None
lakájként	None
átfogott	Third person Singular
csempésznek	Third person Plural
közlekednie	Third person Singular
jelöltünk	First person Plural
észleli	Third person Singular
üzenjenek	Third person Plural
lelkesítő	None
vastagodnak	Third person Plural
kiadásával	None
pályázzon	Third person Singular
dobál	Third person Singular
kojot	None
modernizáltál	Second person Singular
szűnnek	Third person Plural
könyvekből	None
megkezdek	First person Singular
megmagyaráztam	First person Singular
vonzódnak	Third person Plural
túléli	Third person Singular
lefokoznak	Third person Plural
adódnak	Third person Plural
ugrásoknál	None
összefüggésének	None
hűlnek	Third person Plural
beavatkozik	Third person Singular
javasoltak	Third person Plural
gyötör	Third person Singular
tájékozódjon	Third person Singular
sajtótájékoztató	None
megbocsássa	Third person Singular
kifejted	Second person Singular
karácsonyra	None
áldozatokért	None
szavazták	Third person Plural
cégétől	None
engedélyez	Third person Singular
jóváhagynia	Third person Singular
öregekkel	None
csodálkoztak	Third person Plural
csákányokkal	None
nemzzem|	First person Singular
javítania	Third person Singular
teljesült	Third person Singular
üzletágból	None
vacsorázott	Third person Singular
tornázik	Third person Singular
oxidok	None
védelmezték	Third person Plural
óhatatlanná	None
erőforrásnak	None
elárult	Third person Singular
kihívásból	None
elkülönítettetek	Second person Plural
célnyelvnek	None
világiaknak	None
jelentkeztem	First person Singular
táboroznak	Third person Plural
egyesüljön	Third person Singular
befagytak	Third person Plural
kényszerítik	Third person Plural
feltegyék	Third person Plural
kezdeményezők	None
megbeszéljék	Third person Plural
csúcsokat	None
nyilatkoznak	Third person Plural
száműzte	Third person Singular
ellenvetések	None
patkányokat	None
üzemelnek	Third person Plural
tengernaggyal	None
lebeszéltünk	First person Plural
vaknak	None
kulminálunk	First person Plural
fickóval	None
átnéznie	Third person Singular
koordináták	None
nyomásként	None
röhögő	None
korszerűsítsd|or|	Second person Singular
befejeződött	Third person Singular
váltópénzt	None
kápolnákban	None
csacsogok	First person Singular
megmutatna	Third person Singular
átlát	Third person Singular
agyonütötte	Third person Singular
üzennek	Third person Plural
stabilizált	Third person Singular
őserdővel	None
akadok	First person Singular
tudományegyetemnek	None
kijavítanom	First person Singular
félreértette	Third person Singular
főherceggel	None
spermiumokig	None
ünnepelték	Third person Plural
minősítés	None
kikapcsolnék	First person Singular
megszűntek	Third person Plural
színezi	Third person Singular
beépít	Third person Singular
bloggerekként	None
megfagyott	Third person Singular
kibővíti	Third person Singular
viszonyulnak	Third person Plural
mulatott	Third person Singular
keményítővel	None
kitiltsanak	Third person Plural
logaritmust	None
megkezdték	Third person Plural
fellebbezett	Third person Singular
talizmánok	None
tapasztalták	Third person Plural
vizsgázott	Third person Singular
szolgáltatással	None
megpróbálnák	Third person Plural
féltett	Third person Singular
megértett	Third person Singular
bekapcsolásának	None
terjesszék	Third person Plural
ebédelnem	First person Singular
kastélynál	None
követelnek	Third person Plural
hazudni	None
fejezzék	Third person Plural
gazdagodjon	Third person Singular
motiváljak	First person Singular
ügyészek	None
szavazzanak	Third person Plural
eljuttatnak	Third person Plural
táplálékláncok	None
mosogattok	Second person Plural
szkenneljetek	Second person Plural
semlegesítsd|or|	Second person Singular
fagyöngyöt	None
polgárban	None
tüzelnek	Third person Plural
indukált	Third person Singular
fővárosról	None
megmérgezik	Third person Plural
kijönne	Third person Singular
nyűgözöl	Second person Singular
kritikusnak	None
szentesítve	None
bemenő	None
tájolt	Third person Singular
bérelték	Third person Plural
hirdetek	First person Singular
szinkron	None
cselekednie	Third person Singular
szavazzatok	Second person Plural
vonalakból	None
meghívtam	First person Singular
megjátszotta	Third person Singular
kitöltenie	Third person Singular
sakkfigurákká	None
taszítsd|or|	Second person Singular
anyagról	None
vízisikló	None
végezzünk	First person Plural
folytatódik	Third person Singular
kétkötetesen	None
menekültem	First person Singular
veszteségektől	None
másolatokon	None
metszett	Third person Singular
elégedniük	Third person Plural
információs	None
megdöntött	Third person Singular
kiállítja	Third person Singular
emlékezteti	Third person Singular
kivonulna	Third person Singular
továbbadták	Third person Plural
emlékezik	Third person Singular
nyélhez	None
ünnepeljenek	Third person Plural
fagyasztó	None
vegyüljenek	Third person Plural
hallgatott	Third person Singular
konvertálunk	First person Plural
megfizetett	Third person Singular
székelt	Third person Singular
sérüljenek	Third person Plural
csempészd|or|	Second person Singular
igényelted	Second person Singular
szerződnek	Third person Plural
manipulál	Third person Singular
bírált	Third person Singular
hátrálnia	Third person Singular
izzadt	Third person Singular
sötétedik	Third person Singular
hallószervekből	None
evolúciós	None
tükrözik	Third person Plural
cirkuszolnék	First person Singular
elhelyeznek	Third person Plural
rendezel	Second person Singular
tavaszi	None
hangzott	Third person Singular
elvégzik	Third person Plural
megtaláld|or|	Second person Singular
blokkoltam|	First person Singular
motiválták	Third person Plural
vakolatok	None
elkezdődjön	Third person Singular
befolyásolj|or|	Second person Singular
guríts|or|	Second person Singular
mosogatunk	First person Plural
fogadnám|	First person Singular
fedelekként	None
lezárással	None
síelni	None
gondolkodnom	First person Singular
engedélyezné	Third person Singular
söpörnél	Second person Singular
befejeződnénk	First person Plural
megnyíltak	Third person Plural
kommentárral	None
ivott	Third person Singular
elviseljék	Third person Plural
irányítsuk	First person Plural
gombócok	None
mozgatják	Third person Plural
komponálták	Third person Plural
visszalépnek	Third person Plural
közvetítőnek	None
lemondok	First person Singular
lidércnyomás	None
lefokozott	Third person Singular
visszavágott	Third person Singular
visszatérjen	Third person Singular
értést	None
informált	Third person Singular
kapukon	None
rendesnél	None
amerikaiak	None
kinevezze	Third person Singular
kodifikálta	Third person Singular
képzeljünk	First person Plural
kategorizáljunk	First person Plural
fejlesztettünk	First person Plural
visszakozzunk	First person Plural
terhelték	Third person Plural
kupákkal	None
ráspolyokért	None
tisztelünk	First person Plural
helyreállítsa	Third person Singular
figyelmezteti	Third person Singular
pillangóval	None
sisakból	None
oxidál	Third person Singular
írástudatlanoknál	None
rögzítenek	Third person Plural
követeljen	Third person Singular
megtelik	Third person Singular
szentre	None
újraírták	Third person Plural
tisztelték	Third person Plural
gyanakodtam	First person Singular
táplálták	Third person Plural
fogalomban	None
felnagyítanál	Second person Singular
ösztönöznek	Third person Plural
szektoron	None
kőrön	None
sértette	Third person Singular
rombol	Third person Singular
félreértésben	None
leghosszabbakhoz	None
arcod	None
terméktől	None
hirdették	Third person Plural
kicseréltétek	Second person Plural
konföderációhoz	None
kosárlabdázókká	None
balzsamecetekre	None
elindítanál	Second person Singular
címéhez	None
kinyissák	Third person Plural
takarmányozok	First person Singular
iktatják	Third person Plural
elkobozták	Third person Plural
megvalósították	Third person Plural
jogtulajdonost	None
vonás	None
végrehajtottam	First person Singular
rendezéseként	None
alakítok	First person Singular
üzemeltettünk	First person Plural
programozók	None
lemondunk	First person Plural
hivatkozástól	None
bohóckodnak	Third person Plural
tapasztja	Third person Singular
takarmányozzanak	Third person Plural
elmenjen	Third person Singular
szablya	None
indítják	Third person Plural
mellékeltük	First person Plural
effektus	None
erősítsetek	Second person Plural
megközelíteniük	Third person Plural
segítésekként	None
megvalósulnak	Third person Plural
bemegyek	First person Singular
ítéltem|	First person Singular
bezárnak	Third person Plural
lejátsszak	First person Singular
hegytetőkké	None
elismerésként	None
sztrájknak	None
akkreditívek	None
összeszedtem	First person Singular
mélységre	None
privátként	None
megkérdeznéd	Second person Singular
takarjanak	Third person Plural
összebarátkoztak	Third person Plural
kiverte	Third person Singular
elrejtett	Third person Singular
keresőlámpákká	None
előterjesztett	Third person Singular
fóbiákban	None
támogatásról	None
rendelést	None
ígértem	First person Singular
simítanom	First person Singular
dörzsöljék	Third person Plural
kijelöl	Third person Singular
zsoldoskatonaként	None
megtizedeltétek	Second person Plural
szövetsége	None
válaszolod	Second person Singular
vadítanom	First person Singular
összegyűjtöttem	First person Singular
hitelről	None
szitál	Third person Singular
vonítottunk	First person Plural
torzítanak	Third person Plural
megtesznek	Third person Plural
határig	None
emelkedett	Third person Singular
középtől	None
megírtuk	First person Plural
társulásokban	None
bátorítanák	Third person Plural
munkájáról	None
kartográfiákon	None
hazaérek	First person Singular
holtakért	None
megnehezíti	Third person Singular
karcolnád	Second person Singular
megemlítsük	First person Plural
drognak	None
hamisítványokat	None
berúgtuk	First person Plural
ellátja	Third person Singular
üríteniük	Third person Plural
lezártuk	First person Plural
reggel	None
pályáznak	Third person Plural
fiatalemberként	None
díjugratásoknál	None
megvizsgálná	Third person Singular
dolgunkat	None
fejtek	First person Singular
zaklatta	Third person Singular
előállítottak	Third person Plural
bevezet	Third person Singular
termékcsaládokká	None
hatásköréből	None
választásának	None
megnyitsz	Second person Singular
apályoknak	None
kezeljék	Third person Plural
hallgatod	Second person Singular
lefordították	Third person Plural
társítsanak	Third person Plural
kipróbáltad	Second person Singular
állapítson	Third person Singular
szerkesszenek	Third person Plural
részesített	Third person Singular
kiterjesszük	First person Plural
statisztikához	None
csinálnál	Second person Singular
növelte	Third person Singular
megfejtett	Third person Singular
tévézném|	First person Singular
paraméterként	None
sétányoktól	None
álmodott	Third person Singular
megválasztották	Third person Plural
vázolnak	Third person Plural
kiválasszák	Third person Plural
vitáznunk	First person Plural
fúrunk	First person Plural
csapásokba	None
civilizációk	None
megmérgezz|or|	Second person Singular
tisztogatja	Third person Singular
vetekednek	Third person Plural
manók	None
destruktívak	None
feltalálta	Third person Singular
konzulok	None
átadták	Third person Plural
visítottunk	First person Plural
kivon	Third person Singular
eliminálnak	Third person Plural
ingázott	Third person Singular
úszkáltak	Third person Plural
megmondanák	Third person Plural
randevúzik	Third person Singular
szertartásokon	None
felejtsétek	Second person Plural
törekedjen	Third person Singular
edzésekre	None
irányítson	Third person Singular
toborozzanak	Third person Plural
tornázott	Third person Singular
egyesítettem	First person Singular
befizetett	Third person Singular
lámpásokkal	None
keverednének	Third person Plural
fűtöttek	Third person Plural
fogadná	Third person Singular
Napra	None
feloszlatja	Third person Singular
felrobbantam	First person Singular
véghezviszi	Third person Singular
közvetítettek	Third person Plural
tenyésztek	First person Singular
megkérsz	Second person Singular
füzetekből	None
megértetted	Second person Singular
összeszedték	Third person Plural
lefátyolozott	Third person Singular
előállítjuk	First person Plural
megvásárolt	Third person Singular
csillapodik	Third person Singular
kérdőjellé	None
adatnak	None
indexeli	Third person Singular
relativitás	None
tapírokról	None
szenvedne	Third person Singular
iktatja	Third person Singular
ellenőrizted	Second person Singular
egyeztettem	First person Singular
egészségügyben	None
akadályoznia	Third person Singular
áldozattá	None
segédige	None
tisztítsa	Third person Singular
lenyűgöznöm	First person Singular
reggelire	None
reagáltunk	First person Plural
engedelmeskedjen	Third person Singular
befolyásolnak	Third person Plural
hajszálakra	None
örökölje	Third person Singular
álldogálnak	Third person Plural
hőst	None
mellébeszélek	First person Singular
taníttassa	Third person Singular
elmaradtak	Third person Plural
úszkáljatok	Second person Plural
rendezniük	Third person Plural
alakulásáig	None
álcázzam|	First person Singular
megerősödjön	Third person Singular
mutatkoznia	Third person Singular
elnézett	Third person Singular
diktatúráról	None
szórakoztatják	Third person Plural
kialakítaniuk	Third person Plural
felsorol	Third person Singular
engedélyeztem	First person Singular
termesztenek	Third person Plural
kódol	Third person Singular
egyetértetek	Second person Plural
távozzon	Third person Singular
töltése	None
képezne	Third person Singular
közegből	None
nézelődik	Third person Singular
utalnia	Third person Singular
kiszenvedj|or|	Second person Singular
meggyilkol	Third person Singular
megrakott	Third person Singular
tartózkodnék	First person Singular
megnéznek	Third person Plural
érdemelnének	Third person Plural
dologgá	None
leveszi	Third person Singular
csórtatok	Second person Plural
kimondott	Third person Singular
legalizálták	Third person Plural
intse	Third person Singular
távirányítjátok	Second person Plural
lenézi	Third person Singular
bevinnem	First person Singular
vájdlingokként	None
hitelesítette	Third person Singular
rájön	Third person Singular
Rorschach-tesztekért	None
lefordít	Third person Singular
népszámlálásig	None
logikából	None
elszenvedi	Third person Singular
manipulált	Third person Singular
működtetnie	Third person Singular
avokádóként	None
lógjon	Third person Singular
kérdéssel	None
tanulok	First person Singular
ejtőernyősöket	None
elismernünk	First person Plural
követeli	Third person Singular
bekövetkeznek	Third person Plural
lítiummal	None
bekerül	Third person Singular
fenyegetik	Third person Plural
elismert	Third person Singular
világosodjak	First person Singular
vasútvonalnál	None
kiábrándította	Third person Singular
bírok	First person Singular
diagnosztizálnak	Third person Plural
emésztették	Third person Plural
rágalmaznunk	First person Plural
megpróbálsz	Second person Singular
albánban	None
megtartottam	First person Singular
megtartaniuk	Third person Plural
konstruálunk	First person Plural
fejlesztéseknek	None
kibővített	Third person Singular
jelölnéd	Second person Singular
egyenletet	None
elrejtjük	First person Plural
súlyok	None
hébert	None
gumicsizmánál	None
küldését	None
bevert	Third person Singular
megpróbált	Third person Singular
elmulasztják	Third person Plural
tanultuk	First person Plural
csinálok	First person Singular
aktussal	None
megrongált	Third person Singular
elnyernek	Third person Plural
feltüntesse	Third person Singular
megegyezésre	None
sapkában	None
tüzelték	Third person Plural
luxusban	None
cincognom	First person Singular
darazsakon	None
harcolnunk	First person Plural
tárolnia	Third person Singular
suhog	Third person Singular
elírnia	Third person Singular
megveszel	Second person Singular
legtanultabbról	None
lepnünk	First person Plural
tanulmányoz	Third person Singular
pecsét	None
szekérponyvákhoz	None
vízumot	None
alkához	None
káromkodott	Third person Singular
megállít	Third person Singular
rövidítették	Third person Plural
szabványosították	Third person Plural
viselniük	Third person Plural
sértjük	First person Plural
veszélyeztet	Third person Singular
megkérjék	Third person Plural
bérel	Third person Singular
mérgesítette	Third person Singular
koronázna	Third person Singular
létesít	Third person Singular
utánanézünk	First person Plural
redukáltak	Third person Plural
telepakolnád	Second person Singular
elraboltam|	First person Singular
becsülnek	Third person Plural
lefoglalták	Third person Plural
észleljünk	First person Plural
jogosultságoknál	None
eljuttattak	Third person Plural
rémültem	First person Singular
perturbáció	None
honnak	None
sértsék	Third person Plural
alijáznál	Second person Singular
szekularizáció	None
orrvérzésig	None
őrizzen	Third person Singular
toborozta	Third person Singular
kínokkal	None
megfagynak	Third person Plural
megvennie	Third person Singular
beviszi	Third person Singular
csábítsa	Third person Singular
őrölt	Third person Singular
privilégiumokkal	None
gyanúsít	Third person Singular
definíciók	None
itta	Third person Singular
bántottam	First person Singular
évekbe	None
fáradt	Third person Singular
védekeznie	Third person Singular
áramolj|or|	Second person Singular
tűt	None
megmozgat	Third person Singular
párás	None
megértek	First person Singular
részesüljön	Third person Singular
siessünk	First person Plural
elmerengnetek	Second person Plural
mezőnytől	None
ismétlést	None
vadászoknál	None
közelít	Third person Singular
pityizálunk	First person Plural
kicserél	Third person Singular
bálványimádásban	None
támadnotok	Second person Plural
beszerezze	Third person Singular
tapasztaltunk	First person Plural
bürokratikusnak	None
egyeztettünk	First person Plural
tartományon	None
elsüllyedt	Third person Singular
megnevezte	Third person Singular
alkalmazkodtak	Third person Plural
születésnapba	None
versenyautóról	None
üzletelt	Third person Singular
természetéből	None
szereplőkről	None
törődjenek	Third person Plural
tettek	None
raktározták	Third person Plural
közlekednél	Second person Singular
szinkronizálnék	First person Singular
basszusgitárral	None
megmérgezte	Third person Singular
dokumentáltam	First person Singular
megmentse	Third person Singular
visszahelyezte	Third person Singular
megbeszéltünk	First person Plural
pályakezdőtől	None
elrendezzék	Third person Plural
világukat	None
megszüntetett	Third person Singular
rendezőre	None
konzerválták	Third person Plural
egyetértettünk	First person Plural
ténynek	None
elaludtak	Third person Plural
rémülve	None
lakkok	None
trónolt	Third person Singular
harcoljak	First person Singular
költök	First person Singular
ünnepeltük	First person Plural
helyiségről	None
nemzetiségekkel	None
bővítik	Third person Plural
őriz	Third person Singular
bírálták	Third person Plural
életünkre	None
keltsük	First person Plural
megtudjanak	Third person Plural
kifizette	Third person Singular
urbanizált	Third person Singular
kitöltötte	Third person Singular
szórakoztatták	Third person Plural
megengeditek	Second person Plural
jutalmazzatok	Second person Plural
törzsekről	None
megkapták	Third person Plural
felmondok	First person Singular
normatív	None
csődhöz	None
szimbolizálnak	Third person Plural
titkolták	Third person Plural
lakomáznotok	Second person Plural
szerződjön	Third person Singular
variálták	Third person Plural
múlsz	Second person Singular
megtestesítette	Third person Singular
döngetsz	Second person Singular
sebeznünk	First person Plural
taoizmusnak	None
mérgeztem	First person Singular
tanúskodna	Third person Singular
autodidaktákkal	None
koordinálta	Third person Singular
reszketett	Third person Singular
imádkozzatok	Second person Plural
elmacskásodnia	Third person Singular
várostervezésben	None
végzed	Second person Singular
idegsejtek	None
fórumát	None
zuhogott	Third person Singular
finanszíroz	Third person Singular
gyaláznának	Third person Plural
szentesített	Third person Singular
útikalauzok	None
helyreállítják	Third person Plural
spórol	Third person Singular
bővülj|or|	Second person Singular
lajdinántokon	None
kajálunk	First person Plural
fogzománcról	None
kiállították	Third person Plural
dallam	None
hercegprímásnak	None
sterilizált	Third person Singular
eredményezte	Third person Singular
másolták	Third person Plural
aljából	None
felfedeztem	First person Singular
tendenciák	None
göndöríted	Second person Singular
visszaadta	Third person Singular
veszítene	Third person Singular
megkövetelte	Third person Singular
derül	Third person Singular
beavatkozzanak	Third person Plural
elismerje	Third person Singular
szexualitásra	None
hullámfüggvényektől	None
újraparticionálták	Third person Plural
levedd|or|	Second person Singular
kommunizmustól	None
laksz	Second person Singular
imádkozzon	Third person Singular
megpróbáltál	Second person Singular
laktunk	First person Plural
bizonyítottad	Second person Singular
kitörniük	Third person Plural
reményteljesekig	None
vágyj|or|	Second person Singular
villogni	None
felépítették	Third person Plural
kijelented	Second person Singular
kormánypártok	None
jelölsz	Second person Singular
elhelyezzék	Third person Plural
emlékeztették	Third person Plural
ionizált	Third person Singular
stricheljünk	First person Plural
bukkannak	Third person Plural
bekerüljenek	Third person Plural
fújta	Third person Singular
szállítsa	Third person Singular
nyakává	None
japánban	None
utálod	Second person Singular
Rorschach-tesztektől	None
görkorcsolyáznak	Third person Plural
vitorlázott	Third person Singular
kitiltanak	Third person Plural
feltüntessék	Third person Plural
tűrjék	Third person Plural
képzelt	Third person Singular
ignoráltam	First person Singular
blöffölsz	Second person Singular
bánnia	Third person Singular
menetrendet	None
reagálnom	First person Singular
úsznak	Third person Plural
ártja	Third person Singular
hódítania	Third person Singular
elragadtattam|	First person Singular
csíkoznék	First person Singular
felépítsék	Third person Plural
zongorázz|or|	Second person Singular
pincérnőktől	None
dohányzóasztalokhoz	None
törekednünk	First person Plural
kétlemezes	None
varrónőbe	None
színessé	None
felhasználandó	None
ürítsük	First person Plural
gázlón	None
megtárgyaltuk	First person Plural
elküld	Third person Singular
megkéred	Second person Singular
kiemelkednének	Third person Plural
megegyezik	Third person Singular
szélességben	None
megkapta	Third person Singular
térdepel	Third person Singular
követelte	Third person Singular
nótát	None
nevébe	None
barkochbázol	Second person Singular
feszít	Third person Singular
szkennelt	Third person Singular
megerősíteniük	Third person Plural
beidézte	Third person Singular
fagyasztott	Third person Singular
rendezzen	Third person Singular
hiányolta	Third person Singular
esküvőket	None
takácsok	None
konzolokkal	None
ragasztottak	Third person Plural
távoznia	Third person Singular
szúnyogcsípések	None
iszapot	None
teljesítettem|	First person Singular
elveri	Third person Singular
megtudná	Third person Singular
megegyeznének	Third person Plural
megérkeznének	Third person Plural
tapsolta	Third person Singular
megérkezzenek	Third person Plural
íródott	Third person Singular
jogához	None
bűvöljek	First person Singular
fogalmazzon	Third person Singular
akkreditáltatok	Second person Plural
kiemelkednénk	First person Plural
kitagadtak	Third person Plural
hordóban	None
semlegesített	Third person Singular
kötődnie	Third person Singular
hozzátette	Third person Singular
elindulok	First person Singular
megismerünk	First person Plural
vadítsunk	First person Plural
úrnő	None
tároltátok	Second person Plural
sugároz	Third person Singular
pajzzsal	None
kiterjesztette	Third person Singular
válogatottként	None
sminkelt	Third person Singular
kémkedett	Third person Singular
lezuhannak	Third person Plural
egyszerűsítettem|	First person Singular
észleljék	Third person Plural
egészítsük	First person Plural
targoncákkal	None
kimutat	Third person Singular
mozgasd|or|	Second person Singular
tapadni	None
öntöznek	Third person Plural
villámlik	Third person Singular
büfénél	None
tálaltak	Third person Plural
blöfföl	Third person Singular
meggyújtjuk	First person Plural
megvédjen	Third person Singular
bocsátja	Third person Singular
követelték	Third person Plural
erődítményből	None
perdítettetek	Second person Plural
vitáznék	First person Singular
gyarmatosításra	None
megmutattak	Third person Plural
megjelenítenie	Third person Singular
hasznosnak	None
kiáltsa	Third person Singular
hatványok	None
kiindult	Third person Singular
megfejteniük	Third person Plural
mozgat	Third person Singular
tenyésztenek	Third person Plural
művész	None
stimmelnek	Third person Plural
prózáról	None
dalolnom	First person Singular
cipelnie	Third person Singular
vitázzon	Third person Singular
megfogalmaztak	Third person Plural
vezetése	None
feltette	Third person Singular
felbukkant	Third person Singular
póréhagymákért	None
kedveli	Third person Singular
esdektem	First person Singular
királyságokkal	None
sugallta	Third person Singular
betettem	First person Singular
nekilátott	Third person Singular
szagoltunk	First person Plural
lógok	First person Singular
szórakoznunk	First person Plural
metszettek	Third person Plural
átlátta	Third person Singular
hallgassanak	Third person Plural
gyön	None
megbánták	Third person Plural
kerekítették	Third person Plural
kiállította	Third person Singular
tolongtak	Third person Plural
megkezdődtetek	Second person Plural
megjutalmazott	Third person Singular
hazudtál	Second person Singular
ködösítenem	First person Singular
tilt	Third person Singular
királlyal	None
bemutatkozások	None
hozzátették	Third person Plural
hangerőkké	None
alkossak	First person Singular
zárkózva	None
kergettem|	First person Singular
kiabál	Third person Singular
autóznak	Third person Plural
lopás	None
rögzítsenek	Third person Plural
elkövettem	First person Singular
betegségekre	None
figyeli	Third person Singular
exportálni	None
megkér	Third person Singular
felajánl	Third person Singular
védekezzünk	First person Plural
vízisíelnie	Third person Singular
elpusztuljanak	Third person Plural
véglegesítették	Third person Plural
szüntetjük	First person Plural
kárpótolta	Third person Singular
lovagolsz	Second person Singular
megfognák	Third person Plural
ágyaztak	Third person Plural
fókuszáltál	Second person Singular
kiírnia	Third person Singular
feltételezett	Third person Singular
fixált	Third person Singular
hangozzak	First person Singular
emírségekben	None
világítjuk	First person Plural
elnevezéssel	None
zengd|or|	Second person Singular
megszereztem	First person Singular
böjtöl	Third person Singular
feltennéd	Second person Singular
megjelöli	Third person Singular
szállítsák	Third person Plural
elterjed	Third person Singular
szabályozáshoz	None
megtartod	Second person Singular
lótuszt	None
felvegyen	Third person Singular
strichelnétek	Second person Plural
elbeszélik	Third person Plural
lakosságától	None
táncolod	Second person Singular
munkatársakról	None
indokoltad	Second person Singular
partnál	None
megragad	Third person Singular
közoktatásba	None
értékesítik	Third person Plural
korlátozódtak	Third person Plural
cáfolta	Third person Singular
oldatokból	None
átgondoltatok	Second person Plural
kijelölték	Third person Plural
hajgyökérként	None
utánanézne	Third person Singular
szőnyeggel	None
uraltak	Third person Plural
irányítanának	Third person Plural
visítsuk	First person Plural
közeget	None
vágányból	None
taglalnak	Third person Plural
franc	None
misztifikáljak	First person Singular
gargarizálnának	Third person Plural
üzemeltetik	Third person Plural
digitalizálnál	Second person Singular
konszolidálnia	Third person Singular
hazament	Third person Singular
szériát	None
ígéretes	None
szerelted	Second person Singular
sajt	None
kőműveseket	None
futamnak	None
felverte	Third person Singular
kockáztatják	Third person Plural
pocsolyák	None
körülnézett	Third person Singular
lemaradt	Third person Singular
amputáltak	Third person Plural
törekedjünk	First person Plural
birodalomtól	None
futóműnek	None
mézeljem|	First person Singular
hasogatnak	Third person Plural
megindított	Third person Singular
csodálkozzunk	First person Plural
főnevekkel	None
vonyítsatok	Second person Plural
pusztítja	Third person Singular
feltámasztott	Third person Singular
kontrollált	Third person Singular
drágulok	First person Singular
feltartott	Third person Singular
ereklyének	None
tiltakozni	None
kancsalítsak	First person Singular
megemlítettem	First person Singular
körömlakkot	None
anyákat	None
átadná	Third person Singular
unatkoznotok	Second person Plural
vizeltél	Second person Singular
látogat	Third person Singular
feltegyem|	First person Singular
törléseket	None
elválassza	Third person Singular
gyanúsítják	Third person Plural
eljutniuk	Third person Plural
vívtunk	First person Plural
bárónak	None
beiktattak	Third person Plural
sütjük	First person Plural
sorolnák	Third person Plural
felhasználásban	None
fokozta	Third person Singular
felháboríts|or|	Second person Singular
kiszámítsuk	First person Plural
lezárnia	Third person Singular
inniuk	Third person Plural
felel	Third person Singular
termékeket	None
kijavítjuk	First person Plural
megelőzzék	Third person Plural
ígérnek	Third person Plural
zárkóznak	Third person Plural
krokodilhoz	None
megnyitod	Second person Singular
megkülönböztette	Third person Singular
lelje	Third person Singular
vázolta	Third person Singular
állán	None
rengett	Third person Singular
keretét	None
megcsodálták	Third person Plural
tonhalakig	None
kiábrándítsd|or|	Second person Singular
tolódnod	Second person Singular
házaidig	None
benyújtották	Third person Plural
jődögéltünk	First person Plural
plébános	None
karában	None
elvégeznünk	First person Plural
járőröznétek	Second person Plural
figyelek	First person Singular
feszítette	Third person Singular
irigyelt	Third person Singular
kételkedéseket	None
emelt	Third person Singular
bűvöli	Third person Singular
kéretünk	First person Plural
fűrészelték	Third person Plural
hivatkozott	Third person Singular
sebésznél	None
zsákutcán	None
megbánjatok	Second person Plural
megtervezze	Third person Singular
bírtuk	First person Plural
szamóca	None
megválasztásához	None
előzi	Third person Singular
szintekről	None
előírnak	Third person Plural
kezelünk	First person Plural
elindultunk	First person Plural
meggyilkolt	Third person Singular
lerombolnák	Third person Plural
meghívott	Third person Singular
bővítsük	First person Plural
feltaláltam	First person Singular
tévedések	None
visszavegyünk	First person Plural
megvalósította	Third person Singular
rendőrkocsiért	None
szállítana	Third person Singular
félreáll	Third person Singular
felakasztják	Third person Plural
felszólítottak	Third person Plural
vásároltam	First person Singular
reagált	Third person Singular
évesekről	None
megtekintett	Third person Singular
csábítania	Third person Singular
ébenfákon	None
kiterjednek	Third person Plural
hozzáadott	Third person Singular
felülírnunk	First person Plural
ideggyógyásznál	None
vitatkoztok	Second person Plural
hirdetnie	Third person Singular
szárnyalta	Third person Singular
halálfej	None
lakatosokban	None
szórakoztatja	Third person Singular
továbbadta	Third person Singular
krizantémmal	None
jelölnünk	First person Plural
hódoljanak	Third person Plural
keverékeket	None
megütnie	Third person Singular
kiadnia	Third person Singular
jelenlevők	None
újraírtam	First person Singular
szabadalmaztattak	Third person Plural
üldözi	Third person Singular
megszüntesse	Third person Singular
szenvedniük	Third person Plural
bűzlő	None
udvarán	None
leveszik	Third person Plural
gyűrűvé	None
kibővítette	Third person Singular
lefordítanom	First person Singular
romantikával	None
sportolnak	Third person Plural
ünnepnapra	None
módszerekre	None
behatoljon	Third person Singular
csendéletekké	None
gyarapodtak	Third person Plural
hallgasson	Third person Singular
szimulálnak	Third person Plural
feladnia	Third person Singular
hallatszik	Third person Singular
kihasznál	Third person Singular
leigázott	Third person Singular
kérelmezőkben	None
koronáztad	Second person Singular
kölcsönkéri	Third person Singular
emelje	Third person Singular
kipróbál	Third person Singular
bemutatunk	First person Plural
meglátogattál	Second person Singular
felébresszék	Third person Plural
elszalasztották	Third person Plural
pótlással	None
vizsgának	None
frontról	None
félt	Third person Singular
jelentkezik	Third person Singular
kontaktusok	None
karikatúráért	None
megindítják	Third person Plural
életkorhoz	None
cápa	None
legyőzte	Third person Singular
megteremtsetek	Second person Plural
alakítaniuk	Third person Plural
asszociálunk	First person Plural
séró	None
bámult	Third person Singular
hősök	None
megfogalmaznád	Second person Singular
gondolkozzunk	First person Plural
elhúzta	Third person Singular
citromlével	None
ismerkednek	Third person Plural
tisztít	Third person Singular
megnéztem	First person Singular
igyunk	First person Plural
bombázta	Third person Singular
hamvába	None
megőrizzék	Third person Plural
szólalnánk	First person Plural
éttermekből	None
ellenkeznek	Third person Plural
javítsatok	Second person Plural
összekenné	Third person Singular
aggódnom	First person Singular
sértegeti	Third person Singular
viszonyítja	Third person Singular
megnősültél	Second person Singular
kérdezünk	First person Plural
rizsmáknál	None
sóbányákból	None
reformálta	Third person Singular
elválasztja	Third person Singular
farolnék	First person Singular
leültünk	First person Plural
rávágnia	Third person Singular
bézsnek	None
fokba	None
lenyűgözte	Third person Singular
létrehozzanak	Third person Plural
dezertőröknek	None
lelkesedés	None
elfogyasztania	Third person Singular
haragban	None
zsugorodik	Third person Singular
tartózkodniuk	Third person Plural
indokolná	Third person Singular
suhannak	Third person Plural
megtanulsz	Second person Singular
mocsarakban	None
vásártér	None
tüsszentenünk	First person Plural
haragudjatok	Second person Plural
távolodott	Third person Singular
tüntetünk	First person Plural
teljesítéséért	None
gyűljön	Third person Singular
felfüggesztette	Third person Singular
vezérelt	Third person Singular
hexadecimális	None
acetonokról	None
üzentem	First person Singular
idézted	Second person Singular
mulat	Third person Singular
szegényebbhez	None
melléknévihez	None
erőlködött	Third person Singular
ítéltük	First person Plural
meglátogatták	Third person Plural
zuhannak	Third person Plural
felírták	Third person Plural
válaszolnia	Third person Singular
memóriához	None
povedálnia	Third person Singular
felkészüljön	Third person Singular
kiválasztására	None
szórunk	First person Plural
blokkolná	Third person Singular
megvizsgáltam	First person Singular
nyomtatta	Third person Singular
elveszítjük	First person Plural
előkészítette	Third person Singular
keltsünk	First person Plural
jubileumként	None
korszerűsítéssel	None
szublimált	Third person Singular
gurította	Third person Singular
cimborálsz	Second person Singular
radioizotópok	None
ajándékoz	Third person Singular
legyint	Third person Singular
visszavegyék	Third person Plural
megvizsgálunk	First person Plural
telefonálnak	Third person Plural
meglepték	Third person Plural
kempingről	None
vacsorázik	Third person Singular
gyötörtetek	Second person Plural
végrehajtott	Third person Singular
lökdösném|	First person Singular
újítanák	Third person Plural
telepakolok	First person Singular
árura	None
kifejeznünk	First person Plural
folyamtól	None
trombitát	None
görkorcsolyázik	Third person Singular
indítanak	Third person Plural
udvarlást	None
szennyezik	Third person Plural
kiállítania	Third person Singular
felszabadítja	Third person Singular
hunynia	Third person Singular
megértsék	Third person Plural
távirányítsák	Third person Plural
ittak	Third person Plural
tavasz	None
kiközösítő	None
megjelölték	Third person Plural
elnéztél	Second person Singular
szítták	Third person Plural
melíroztuk	First person Plural
spioníroznám|	First person Singular
fényképezőgépeket	None
költse	Third person Singular
kritikáktól	None
elfelejtenünk	First person Plural
elküldjék	Third person Plural
résztvevőből	None
gyűlne	Third person Singular
aktiváltam	First person Singular
udvarokat	None
félreértettél	Second person Singular
rabolták	Third person Plural
cserbenhagyta	Third person Singular
vágyik	Third person Singular
képzeled	Second person Singular
bombáztam|	First person Singular
kríziseket	None
megjelöltünk	First person Plural
építészek	None
animációként	None
lemondtad	Second person Singular
megtapsolnának	Third person Plural
megkapnák	Third person Plural
megerőszakolandó	None
szivárványban	None
cenzúrázott	Third person Singular
kommentáltak	Third person Plural
vedlik	Third person Singular
méltányolták	Third person Plural
leadott	Third person Singular
beintenünk	First person Plural
veszítettünk	First person Plural
bővíted	Second person Singular
tönkretesz	Third person Singular
kelleti	Third person Singular
értesítjük	First person Plural
vitatnak	Third person Plural
osztályzat	None
terhelik	Third person Plural
kérdeztél	Second person Singular
csontvelőből	None
tágult	Third person Singular
színezzen	Third person Singular
ápoljon	Third person Singular
ellátogatott	Third person Singular
gyártásához	None
indítjuk	First person Plural
kedvezményezetteknek	None
rögzített	Third person Singular
elesett	Third person Singular
átírni	None
blogol	Third person Singular
kollaborálna	Third person Singular
elárulnia	Third person Singular
vétkeztetek	Second person Plural
zuhanna	Third person Singular
installáljak	First person Singular
elverjek	First person Singular
lovagról	None
végrehajtsa	Third person Singular
mérlegelnünk	First person Plural
fekvést	None
feláldozta	Third person Singular
tárgyalták	Third person Plural
fütyülték	Third person Plural
beírta	Third person Singular
benyújtsd|or|	Second person Singular
kergetnek	Third person Plural
indítottunk	First person Plural
sodródnak	Third person Plural
érdemlő	None
vonatoztál	Second person Singular
megtilt	Third person Singular
tisztítsuk	First person Plural
távoznának	Third person Plural
műtsem|	First person Singular
visszatérnének	Third person Plural
javított	Third person Singular
térítenie	Third person Singular
kijött	Third person Singular
igazságszolgáltatáshoz	None
eseményéhez	None
szaknyelvre	None
rémült	Third person Singular
megbocsátottak	Third person Plural
feltűnőekért	None
alakítanak	Third person Plural
kifizetne	Third person Singular
eltörte	Third person Singular
bűzlik	Third person Singular
tervvé	None
versenyzünk	First person Plural
fogyasztják	Third person Plural
átszökni	None
használtatniuk	Third person Plural
figyelmeztet	Third person Singular
teljesítené	Third person Singular
megújulásokként	None
összevetettem	First person Singular
lezár	Third person Singular
hajviselettel	None
nemzettek	Third person Plural
felszínénél	None
operálták	Third person Plural
megválasztottak	Third person Plural
szabnak	Third person Plural
bíz	Third person Singular
tócsa	None
beidézze	Third person Singular
kifejlesztették	Third person Plural
falukat	None
melegedett	Third person Singular
befejezetlen	None
újította	Third person Singular
ritmusokat	None
felsorolná	Third person Singular
fogadtunk	First person Plural
megígér	Third person Singular
civilizáltak	Third person Plural
leverje	Third person Singular
fiúról	None
tágítja	Third person Singular
vendéglátóipari	None
lidérceket	None
úszik	Third person Singular
buzi	None
hozzászólnak	Third person Plural
járműről	None
sztrichninekkel	None
előirányzatokból	None
figyelmeztetne	Third person Singular
megrongáltak	Third person Plural
szoptattatok	Second person Plural
szaggá	None
növelje	Third person Singular
nyilvánította	Third person Singular
összehívtak	Third person Plural
legálisak	None
pingálna	Third person Singular
raktárnak	None
rábeszéltünk	First person Plural
ellenőriztük	First person Plural
javítsak	First person Singular
bizonyítékokat	None
rendeznek	Third person Plural
termesztették	Third person Plural
dúlt	Third person Singular
dekoráció	None
sajnálták	Third person Plural
kommunikáljanak	Third person Plural
mesélte	Third person Singular
öntöznöd	Second person Singular
böjtöljenek	Third person Plural
nevezzen	Third person Singular
elad	Third person Singular
remetékig	None
tiporta	Third person Singular
spekulálok	First person Singular
kitűntek	Third person Plural
bizonyítaná	Third person Singular
böjtölt	Third person Singular
egyenlítenie	Third person Singular
összevesse	Third person Singular
alkossanak	Third person Plural
jógázzak	First person Singular
kezdeményezze	Third person Singular
nyomasztotta	Third person Singular
fogadnak	Third person Plural
eldöntenem	First person Singular
üldözze	Third person Singular
szintként	None
nyílhegyekbe	None
elhagyott	Third person Singular
színvonalához	None
forgólantokból	None
fórumokhoz	None
megnyom	Third person Singular
megtaláltuk	First person Plural
bátorítottátok	Second person Plural
lefátyolozta	Third person Singular
járműnél	None
megvigasztaljak	First person Singular
felverték	Third person Plural
disztribúciókat	None
engedelmeskedünk	First person Plural
bevételt	None
hitelesítettek	Third person Plural
kötelezett	Third person Singular
kifejtetted	Second person Singular
ütközésről	None
meglássunk	First person Plural
segítségnyújtásról	None
tulajdonságokat	None
ásványnak	None
újabbnál	None
javítottad	Second person Singular
darabokról	None
javítanak	Third person Plural
könyvpiac	None
csinálná	Third person Singular
forradalmasítja	Third person Singular
vívniuk	Third person Plural
gyűljenek	Third person Plural
megoldottuk	First person Plural
tanulmányozásától	None
memorizálnod	Second person Singular
kiessen	Third person Singular
indítanának	Third person Plural
szabadulsz	Second person Singular
mellékelnek	Third person Plural
telepítéséről	None
bandának	None
hátráljon	Third person Singular
arcán	None
észleltünk	First person Plural
átnézné	Third person Singular
finanszírozott	Third person Singular
felfrissítenek	Third person Plural
megvalósítaniuk	Third person Plural
alapszabályokként	None
képesítéssel	None
világítottak	Third person Plural
megtörténnek	Third person Plural
nyaktekercsként	None
hangerőknek	None
máglyarakásnál	None
elkezdi	Third person Singular
dúltak	Third person Plural
rejtjük	First person Plural
alkoholistáknak	None
díszesekkel	None
szerkesztésekben	None
fetisizáljak	First person Singular
adományozzon	Third person Singular
zarándokoltak	Third person Plural
takarná	Third person Singular
továbbfejlesztette	Third person Singular
megismertetik	Third person Plural
hozzászóltál	Second person Singular
tördelnie	Third person Singular
vigyázott	Third person Singular
színházakkal	None
derékon	None
szórj|or|	Second person Singular
közeledjen	Third person Singular
manipulációkat	None
tartózkodnátok	Second person Plural
átnézte	Third person Singular
szakmákhoz	None
csaj	None
reklámozzunk	First person Plural
szétesnek	Third person Plural
terhel	Third person Singular
szövetségén	None
kakastaréj	None
idegennek	None
borsikafüvek	None
vezérelne	Third person Singular
bölcsődék	None
alkotnak	Third person Plural
sárgabarackfákra	None
pénzbelivel	None
lyukasztották	Third person Plural
ujjong	Third person Singular
megkérik	Third person Plural
métereken	None
figyelmeztesse	Third person Singular
elrabolnak	Third person Plural
bemutatkozott	Third person Singular
decentralizációkon	None
fölülírnunk	First person Plural
ütközetekben	None
változásokért	None
véli	Third person Singular
adminisztrátoroknak	None
teszteli	Third person Singular
tomboláznátok	Second person Plural
megragadtam	First person Singular
csattanóval	None
véglegesíti	Third person Singular
elnyernie	Third person Singular
tapaszt	Third person Singular
trenírozta	Third person Singular
befejezné	Third person Singular
tudatlannak	None
urunk	None
legjelentősebbeket	None
megálltunk	First person Plural
országosat	None
alapozzatok	Second person Plural
pukedlizna	Third person Singular
tolódik	Third person Singular
meghalnotok	Second person Plural
hatalmakat	None
mozgásban	None
megismerik	Third person Plural
teljesítenie	Third person Singular
összekevert	Third person Singular
ösztökélte	Third person Singular
nyilvánítanák	Third person Plural
láncra	None
megbeszélnek	Third person Plural
cukrozott	Third person Singular
lóversenyre	None
erősít	Third person Singular
lovagol	Third person Singular
tisztázódik	Third person Singular
tömörítenek	Third person Plural
megújító	None
igazolod	Second person Singular
megérkeztem	First person Singular
megrázott	Third person Singular
megemlít	Third person Singular
felvert	Third person Singular
működtették	Third person Plural
keresztelésre	None
olajsavban	None
tüzeljék	Third person Plural
megpróbáljon	Third person Singular
beleírod	Second person Singular
imádkoztál	Second person Singular
megérintik	Third person Plural
követelünk	First person Plural
megtartsa	Third person Singular
kiállításának	None
vágytam	First person Singular
skalpoltad	Second person Singular
izzadtam	First person Singular
fésül	Third person Singular
pörögsz	Second person Singular
megteremtenetek	Second person Plural
tupíroztunk	First person Plural
kérdik	Third person Plural
versenyezzenek	Third person Plural
megszerezniük	Third person Plural
szocializálták	Third person Plural
csinálunk	First person Plural
hálózat	None
áltatott	Third person Singular
csomóelmélet	None
informatikáért	None
becslésnek	None
csillapította	Third person Singular
vakációztátok	Second person Plural
sóvárgod	Second person Singular
elgázold|or|	Second person Singular
áramlanak	Third person Plural
rájövünk	First person Plural
megreformáltam	First person Singular
kavarna	Third person Singular
szürcsöljetek	Second person Plural
nemzette	Third person Singular
csigolyát	None
sorakoznotok	Second person Plural
megpróbálunk	First person Plural
jutalmazták	Third person Plural
licenceltétek	Second person Plural
takarna	Third person Singular
hozzáírjanak	Third person Plural
csókoltok	Second person Plural
vérplazma	None
elkerüljék	Third person Plural
öltözzön	Third person Singular
fejlődjenek	Third person Plural
földrengésnek	None
oldalaknál	None
véletlenszerűnek	None
nyilatkoztál	Second person Singular
fűszerezte	Third person Singular
telepedik	Third person Singular
engedélyezik	Third person Plural
vitatkozott	Third person Singular
távolodunk	First person Plural
véghezvinnie	Third person Singular
székhelyén	None
minőségéért	None
hamisítják	Third person Plural
kimutatja	Third person Singular
megérintett	Third person Singular
erdőig	None
felfedezünk	First person Plural
táncolta	Third person Singular
munkásságától	None
ösztökéli	Third person Singular
megszerveznie	Third person Singular
hatástól	None
diszkvalifikáltuk	First person Plural
vadászatán	None
felhőszakadások	None
szopnak	Third person Plural
kőolajat	None
baktériumölő	None
avul	Third person Singular
borogass|or|	Second person Singular
felszólították	Third person Plural
kiírnak	Third person Plural
munkakörrel	None
zsinatra	None
megszerveztünk	First person Plural
megnyitotta	Third person Singular
lelkesednének	Third person Plural
gesztusra	None
szöveten	None
kapillárisért	None
külvilág	None
tojok	First person Singular
sorakozik	Third person Singular
kalapok	None
kiderítettem	First person Singular
indukciókig	None
iga	None
megismerjék	Third person Plural
elmozdítjuk	First person Plural
árnyékra	None
derültem	First person Singular
lövésnél	None
felülkerekednek	Third person Plural
kábeleken	None
közelíted	Second person Singular
beteljesülnél	Second person Singular
berúgtatok	Second person Plural
dinasztiában	None
forr	Third person Singular
vöröshagyma	None
felhívtak	Third person Plural
emlékeztessen	Third person Singular
szárítótól	None
mozdítja	Third person Singular
részesítették	Third person Plural
megszerezték	Third person Plural
hangozzon	Third person Singular
megszerezz|or|	Second person Singular
elinduljanak	Third person Plural
törülközünk	First person Plural
végzel	Second person Singular
siklott	Third person Singular
relációval	None
tanulnod	Second person Singular
ápolták	Third person Plural
csillagászoknak	None
megsemmisítik	Third person Plural
rejtsék	Third person Plural
cipelnek	Third person Plural
megköszönök	First person Singular
kategorizált	Third person Singular
zsákmányol	Third person Singular
támadnának	Third person Plural
vonz	Third person Singular
megemlített	Third person Singular
megtiltották	Third person Plural
betegedtem	First person Singular
halásznadrágon	None
vívtam	First person Singular
elküldtetek	Second person Plural
szabadcsapatot	None
felszerelsz	Second person Singular
ellenőrzünk	First person Plural
megértenéd	Second person Singular
átfésülném|	First person Singular
iktatott	Third person Singular
községgel	None
felháborodik	Third person Singular
anyáskodik	Third person Singular
szerváltam	First person Singular
szépíteném|	First person Singular
terepet	None
beszámolj|or|	Second person Singular
felkeresned	Second person Singular
nyíláshoz	None
szabadulnia	Third person Singular
feledje	Third person Singular
szarok	First person Singular
minisztérium	None
vontatták	Third person Plural
tisztázódtak	Third person Plural
redukál	Third person Singular
megállítják	Third person Plural
játékelmélettel	None
csacsogjam|	First person Singular
taníttatták	Third person Plural
bombázásnak	None
képezzen	Third person Singular
felejtse	Third person Singular
beleírnak	Third person Plural
egyezünk	First person Plural
motornak	None
aláírta	Third person Singular
ajtó	None
elárulod	Second person Singular
eldöntötted	Second person Singular
befejeződnie	Third person Singular
bőrhöz	None
sorolok	First person Singular
feltételezed	Second person Singular
dagonyázásról	None
orrot	None
kihasználná	Third person Singular
megakadályoznék	First person Singular
tartomány	None
mérgezésre	None
parkolóhelyet	None
vénültetek	Second person Plural
lapátol	Third person Singular
bővítetted	Second person Singular
diétát	None
rejtetted	Second person Singular
szennyezettebben	None
elkövetőket	None
szigetvilágra	None
olajból	None
meglepte	Third person Singular
eljuttassa	Third person Singular
kikérdezték	Third person Plural
stáb	None
mellékel	Third person Singular
keltsen	Third person Singular
bazsarózsákká	None
megmaradnának	Third person Plural
konzervnyitó	None
igazgatja	Third person Singular
közüzemért	None
megtalálta	Third person Singular
értesíti	Third person Singular
gyűlöletről	None
szoktad	Second person Singular
tárgyaljunk	First person Plural
pingáljon	Third person Singular
nyaralást	None
fogyasztunk	First person Plural
tárolókban	None
kimenetből	None
szándékozták	Third person Plural
kezeled	Second person Singular
beteljesülnek	Third person Plural
fagylaltoktól	None
gyártótól	None
tömbökből	None
boldogít	Third person Singular
ösztöndíjakat	None
kiállítsátok	Second person Plural
anyagiban	None
tanúsítaniuk	Third person Plural
esdekelve	None
megkérdezik	Third person Plural
félreállt	Third person Singular
bevallod	Second person Singular
undorodtam	First person Singular
borsóvá	None
axonokból	None
firkál	Third person Singular
vedelje	Third person Singular
kimondod	Second person Singular
tisztáztam	First person Singular
megemlíti	Third person Singular
kockáztatták	Third person Plural
előírásaival	None
sorolnak	Third person Plural
brómot	None
működtessék	Third person Plural
kijelölünk	First person Plural
eljuttatta	Third person Singular
párttól	None
előírná	Third person Singular
kantátákban	None
szoknunk	First person Plural
megcsinálta	Third person Singular
külpolitikába	None
megállapítottad	Second person Singular
tájékozódnak	Third person Plural
dominálta	Third person Singular
történetért	None
fazéknál	None
megüt	Third person Singular
babot	None
veszítsük	First person Plural
invitált	Third person Singular
izmokhoz	None
szocializált	Third person Singular
megnövekedik	Third person Singular
legendából	None
középponton	None
papagájokká	None
másolok	First person Singular
lerakódásokat	None
szentelnem	First person Singular
lezárásában	None
összefogjanak	Third person Plural
vartyogó	None
firkáltunk	First person Plural
másolsz	Second person Singular
fogyasztania	Third person Singular
hüledezett	Third person Singular
vitatott	Third person Singular
tigriscápákban	None
tanúskodnak	Third person Plural
kedvelnek	Third person Plural
felhívná	Third person Singular
sorról	None
internetet	None
tárgyalniuk	Third person Plural
megütött	Third person Singular
kiáltok	First person Singular
kinézett	Third person Singular
kínozták	Third person Plural
fúr	Third person Singular
minősül	Third person Singular
füléhez	None
demoralizálta	Third person Singular
megkezdtem	First person Singular
tolmácsolnom	First person Singular
különlegességként	None
mágnesig	None
felügyelethez	None
előfordulnia	Third person Singular
könyörögjön	Third person Singular
hivatkoznunk	First person Plural
leltem	First person Singular
megoldod	Second person Singular
megfelelők	None
visszatérjünk	First person Plural
viszonyítják	Third person Plural
fosztogatja	Third person Singular
ösztönözték	Third person Plural
gyermekotthonokkal	None
újraír	Third person Singular
mese	None
eljut	Third person Singular
látogatja	Third person Singular
elraboltuk	First person Plural
száműzték	Third person Plural
nyilatkoztam	First person Singular
tombol	Third person Singular
bagolyodúknál	None
tervel	Third person Singular
csöngenél	Second person Singular
apródtól	None
megtörténjek	First person Singular
termeléssel	None
fosztogatott	Third person Singular
lottón	None
eltávolítjuk	First person Plural
betegedjünk	First person Plural
kürtön	None
kérette	Third person Singular
megnyissuk	First person Plural
letartóztass|or|	Second person Singular
háncsrész	None
fényképezőgépekbe	None
bírtok	Second person Plural
kimúlt	Third person Singular
világítson	Third person Singular
fakadt	Third person Singular
reszkessetek	Second person Plural
tudásbázis	None
elveszítették	Third person Plural
funktor	None
megölné	Third person Singular
meggyilkolták	Third person Plural
ismerkedett	Third person Singular
járőrözzön	Third person Singular
legyőzték	Third person Plural
termeszti	Third person Singular
gyógyszerészetekre	None
Napokból	None
agyonvágok	First person Singular
avulnak	Third person Plural
észleltem	First person Singular
tetejéből	None
neveznek	Third person Plural
megállta	Third person Singular
megcsodálnál	Second person Singular
üldöztek	Third person Plural
blokkolok	First person Singular
kiáltsatok	Second person Plural
statisztikákká	None
tapadtak	Third person Plural
ellenőrizzék	Third person Plural
vitázzunk	First person Plural
kiabálni	None
támadunk	First person Plural
befagy	Third person Singular
megoldanunk	First person Plural
mészárolnak	Third person Plural
megcsodált	Third person Singular
borotvált	Third person Singular
szokták	Third person Plural
alkálikhoz	None
korongokból	None
módosítod	Second person Singular
betegre	None
fejlődésregény	None
avarban	None
ideírtad	Second person Singular
ligától	None
bekeni	Third person Singular
röhögtem	First person Singular
megfelelnie	Third person Singular
betennéd	Second person Singular
feltár	Third person Singular
megállok	First person Singular
szuperáltunk	First person Plural
kifizetnie	Third person Singular
feleségemet	None
simította	Third person Singular
gyűlöltek	Third person Plural
feloszlatta	Third person Singular
lelkieknek	None
keselyűnek	None
fúrógépekkel	None
véreznek	Third person Plural
edzéssel	None
húzódjon	Third person Singular
elbújtál	Second person Singular
játszódtak	Third person Plural
irigykedik	Third person Singular
ízlett	Third person Singular
értesül	Third person Singular
lejártak	Third person Plural
derékra	None
antitézis	None
feláldozó	None
megtalálunk	First person Plural
átvettek	Third person Plural
kimondtuk	First person Plural
aktivizálta	Third person Singular
