divertiraient	None
indiqueraient	None
repaîtraient	None
écartela	Past
raidissaient	Past
encourir	None
artificialiser	None
émasculé	Past
cameras	Future
dévierait	None
progressera	Future
appelez	Present
embaucha	Past
universaliserais	None
dévaluer	None
égalait	Past
incommoder	None
épicerait	None
entamer	None
tanceriiens	None
attraper	None
desverent	Past
reprocherais	None
concevra	Future
remémoré	Past
barbé	Past
marquèrent	Past
transmuer	None
exportez	Present
charpenter	None
andoctrinasses	Past
maîtriser	None
criminaliseraient	None
cramé	Past
ménager	None
rapprocheront	Future
agir	None
gronder	None
cambriolerais	None
accommodassions	Past
ferrez	Present
faiblissant	Present
réoccupâmes	Past
reviendraient	None
barreras	Future
coopérèrent	Past
paya	Past
ébrécher	None
coniureriez	None
crépiter	None
scandaliser	None
concorder	None
frictionner	None
remontrant	Present
embarqua	Past
sécurisé	Past
plaignant	Present
imposeraient	None
embracheras	Future
enfoncera	Future
abîmerait	None
engobez	Present
rapprochait	Past
sanctuarisâmes	Past
précédé	Past
transmuteriez	None
interdît	Past
raccordé	Past
gobons	Present
amnistier	None
allégea	Past
enyvrassent	Past
absorberaient	None
ordonna	Past
isolé	Past
cyanura	Past
rédiger	None
asproierai	Future
bêler	None
tambourinerions	None
démondialisé	Past
enseignât	Past
convoquera	Future
essaierai	Future
dérapait	Past
sauvegardera	Future
dépenseraient	None
sortiront	Future
sanctionnez	Present
sextuplé	Past
aventurera	Future
empalant	Present
lascher	None
emprisonné	Past
enterra	Past
secrété	Past
effrois	Present
radiosonderaient	None
séjournerai	Future
indigné	Past
distinguer	None
bulla	Past
boursoufflassiez	Past
alourdira	Future
aimerait	None
recueil	Present
casser	None
dédoubleront	Future
révélèrent	Past
patina	Past
renouèrent	Past
dépénaliser	None
acculé	Past
dénaturasse	Past
menaceraient	None
indaguâtes	Past
essuyai	Past
gravez	Present
licencier	None
dégotter	None
encouragèrent	Past
réimposer	None
prévisualisé	Past
réintégrer	None
boirait	None
cavalai	Past
passionnait	Past
transfigurer	None
subordonner	None
partagerais	None
cordialiseraient	None
dériveront	Future
articulera	Future
preparer	None
pilotant	Present
écorcer	None
pieuteront	Future
wikifieront	Future
incarnaient	Past
tiraillant	Present
réhabituerais	None
décolorant	Present
exigera	Future
soutenaient	Past
scintillaient	Past
affacturassiez	Past
éclatèrent	Past
cadras	Past
r'asseurer	None
confirez	Future
ædifiassiez	Past
accommodait	Past
démarrerait	None
constituât	Past
azimutasse	Past
enconnerais	None
tamiserai	Future
délivra	Past
gaché	Past
assurerai	Future
geü	Past
rectifiera	Future
dupliquant	Present
solariserais	None
frappé	Past
grillât	Past
détruirons	Future
énoncera	Future
abrogeait	Past
gazéifieras	Future
déshydrater	None
ovra	Past
ruez	Present
usiner	None
coïncidait	Past
calqué	Past
nier	None
sacrifieront	Future
enverraient	None
donneras	Future
anima	Past
élimineront	Future
illustrer	None
démarrera	Future
empiler	None
gigoter	None
jouir	None
allégua	Past
ordonnera	Future
consolé	Past
recovrissons	Past
arrimer	None
intercaler	None
prêtons	Present
mont	Present
caractériserions	None
relièrent	Past
entrouvriront	Future
réexporter	None
marquons	Present
maîtrisaient	Past
surlignassions	Past
surligner	None
sabras	Past
planifiant	Present
supervisera	Future
asticoter	None
extorquer	None
courba	Past
manœuvra	Past
ciblez	Present
inculqua	Past
aggraver	None
rapatriant	Present
vénérer	None
bousculait	Past
avoidiiens	Past
ravaudai	Past
reposa	Past
bivouaquant	Present
impacterait	None
retoucher	None
désœuvrasse	Past
élaborait	Past
dédicaça	Past
préludé	Past
alcalifiait	Past
succèderait	None
doperais	None
compiler	None
ballotteras	Future
puer	None
approchant	Present
agrégea	Past
chauferai	Future
démoralisant	Present
magnifier	None
pullulant	Present
allongeriez	None
crussions	Past
emballer	None
reclassa	Past
réutilisaient	Past
encontriez	Past
prémunir	None
raccrocher	None
adoptèrent	Past
courriellant	Present
dédoublonnassions	Past
supai	Past
polygoniser	None
coloraient	Past
maîtrisant	Present
étiqueter	None
quichât	Past
capitulèrent	Past
chinoiserez	Future
désinfectant	Present
rétractera	Future
culminerait	None
fournirez	Future
abhorrer	None
sentit	Past
éveillé	Past
captivèrent	Past
toréa	Past
acoquinons	Present
recoudre	None
diminueraient	None
défenestrant	Present
ouïr	None
convergé	Past
atteindrait	None
apostasierez	Future
suner	None
dialogué	Past
transigeâmes	Past
coutait	Past
grèverais	None
curoies	Past
entremêlaient	Past
lierait	None
commettre	None
arpentaient	Past
baptisait	Past
dérangeait	Past
refirent	Past
gravitons	Present
décliné	Past
accepteriez	None
clôturerai	Future
rééditant	Present
reflétasse	Past
proposèrent	Past
présupposant	Present
menèrent	Past
esparpeilliiens	Past
méprisait	Past
racontera	Future
radouber	None
déculottons	Present
pinasse	Past
sude	Present
agrafer	None
légitimer	None
refonctionnassiez	Past
ressayer	None
agrandiras	Future
rôti	Past
humer	None
constatèrent	Past
révérant	Present
focusseriez	None
tomber	None
défroqué	Past
bruni	Past
vanter	None
tançassions	Past
réveillaient	Past
racontaient	Past
rétrogradant	Present
vieillirai	Future
routa	Past
torpilleriez	None
bravé	Past
derumpruies	None
livrèrent	Past
nitra	Past
redevint	Past
incitons	Present
angarier	None
enpoisonnoit	Past
produisons	Present
animer	None
tremblez	Present
confiait	Past
apostasier	None
dégringoleriez	None
déroutasse	Past
relancer	None
acceptera	Future
lésinèrent	Past
revinrent	Past
déchargera	Future
ameuterons	Future
réunira	Future
ribota	Past
purifier	None
hala	Past
professionnaliseraient	None
cessaient	Past
négligeaient	Past
entretaillant	Present
produiraient	None
énoncer	None
assoupli	Past
navré	Past
ratisserait	None
ravager	None
variai	Past
iriez	None
formulé	Past
renseignait	Past
mystifier	None
écoulait	Past
revérifié	Past
començai	Past
remémorera	Future
entredunroies	None
avalé	Past
renseigné	Past
régurgitant	Present
occasionné	Past
échapperont	Future
pariez	Present
peinant	Present
cratériserons	Future
reconcentrassions	Past
agiter	None
esloignissons	Past
traçaient	Past
entrainera	Future
yaourteront	Future
pondu	Past
iolyeroient	None
automatisant	Present
sauvegarder	None
mâterez	Future
enfoncèrent	Past
canoniser	None
abstenait	Past
tuant	Present
trovas	Past
dérober	None
décrochant	Present
fend	Present
informant	Present
infesté	Past
préférèrent	Past
manifesterons	Future
guie	Present
torcherez	Future
superiez	None
oeuvré	Past
bavé	Past
vacillant	Present
corrigé	Past
bataut	Present
replier	None
m’enfuirai	Future
bégayait	Past
prédominaient	Past
enquêtera	Future
captera	Future
concluons	Present
préoccupaient	Past
boucher	None
défruiterons	Future
polliniser	None
lasseront	Future
photographiait	Past
cangeront	Future
ambrons	Present
buez	Present
occuperai	Future
portraiturer	None
carté	Past
distingueraient	None
agira	Future
encrassé	Past
pilons	Present
anticipa	Past
étoffera	Future
tocha	Past
pressuriserions	None
vestir	None
arriverai	Future
cacheront	Future
saisissons	Present
rackettant	Present
opérer	None
bossassions	Past
dérivait	Past
remilitariserai	Future
réquisitionnèrent	Past
confondons	Present
parqueté	Past
hiérarchiser	None
encadré	Past
amnistiant	Present
trafiquant	Present
essait	Present
hypnotisé	Past
copulant	Present
servirons	Future
descendait	Past
collectèrent	Past
lurrasmes	Past
tisât	Past
revivifié	Past
urinasse	Past
palabrer	None
formulas	Past
vendanger	None
folant	Present
enfanta	Past
syncopé	Past
faufila	Past
brit	Present
ébousinassent	Past
consulteriez	None
lampez	Present
éditez	Present
disposeraient	None
flairs	Present
trainait	Past
désolidarisa	Past
conspuait	Past
bloquèrent	Past
assagir	None
fraser	None
étayé	Past
pillier	None
entraînerait	None
piétiner	None
réussissaient	Past
décrier	None
titra	Past
targé	Past
ceindrons	Future
soneroies	None
couplant	Present
rejoindrai	Future
avisassiez	Past
révisons	Present
inspirerait	None
approcheront	Future
expérimentant	Present
lyser	None
crevez	Present
varié	Past
éperonner	None
reconduisit	Past
apercevaient	Past
dispersèrent	Past
éloigneront	Future
dénouant	Present
perpétré	Past
procureraient	None
éclipsèrent	Past
établît	Past
embellissant	Present
renfermeraient	None
surnommant	Present
irritaient	Past
crissé	Past
inaugurerions	None
habituer	None
detrancissoiz	Past
recenseras	Future
scellé	Past
opposeront	Future
ostraciser	None
trituré	Past
remuant	Present
craquelait	Past
défenestré	Past
sonera	Future
synchronisassent	Past
compellast	Past
bégayer	None
abrégeait	Past
chauffer	None
datait	Past
supplantait	Past
révolutionnasses	Past
interpelé	Past
prophetiza	Past
dissuadera	Future
environnant	Present
oubliez	Present
checker	None
désorbé	Past
commissionnant	Present
ravageaient	Past
élirait	None
réhabiliter	None
turné	Past
classaient	Past
ennoyasse	Past
proclamerait	None
apparaitraient	None
réverbéré	Past
équipa	Past
turlupinât	Past
paraffiné	Past
hiverna	Past
approprieront	Future
reconnaître	None
déloger	None
rongea	Past
abstiendront	Future
affirmer	None
fournir	None
subodoras	Past
moutonné	Past
déconcerter	None
chaut	Present
pressuré	Past
nominer	None
frangeant	Present
confèrerait	None
edifié	Past
salifierions	None
dénonçant	Present
obliqua	Past
vivrais	None
pochait	Past
touchât	Past
botterait	None
financer	None
décapitait	Past
allègueras	Future
respectez	Present
violeront	Future
affirmèrent	Past
cabrer	None
rassemblaient	Past
préciserait	None
démissions	Past
imputant	Present
déménagera	Future
attrapera	Future
bayser	None
fédérèrent	Past
nome	Present
licitai	Past
ratifiait	Past
douteraient	None
trahissant	Present
pardonnons	Present
updateriez	None
démasquait	Past
paniquer	None
égorgeraient	None
réclamèrent	Past
enfermèrent	Past
abstrairez	Future
braverai	Future
haranguer	None
cumula	Past
masculinisé	Past
snober	None
abandonnerait	None
muscadâmes	Past
priveraient	None
adapteraient	None
exilèrent	Past
énonçant	Present
notifieraient	None
flatiroit	None
dégoulinant	Present
diversifièrent	Past
effaré	Past
jubilerions	None
craignit	Past
abondassiez	Past
sombras	Past
guettez	Present
actualiseras	Future
envions	Present
dédouanasse	Past
rattachera	Future
cherchait	Past
sectoriseras	Future
compliquaient	Past
détruisant	Present
désentrelacerez	Future
méditant	Present
guèdassions	Past
débarassé	Past
envisager	None
complaît	Present
peinte	Present
épouvanter	None
détruisaient	Past
cachierent	Past
enchaussâmes	Past
conbatis	Past
avoisinera	Future
étrangler	None
dît	Past
lustra	Past
goutter	None
accentua	Past
arguait	Past
présenterons	Future
injuriant	Present
synchroniser	None
bénéficiez	Present
déshonoré	Past
pitonnerez	Future
initierait	None
manquerais	None
castré	Past
pagayant	Present
tordu	Past
forcèrent	Past
exilant	Present
siphonner	None
réfracté	Past
dégrifferez	Future
twista	Past
soutiré	Past
collaborait	Past
étudiera	Future
aveulissaient	Past
horrifiâtes	Past
catégoriser	None
crachier	None
durcissait	Past
noveriez	None
réfractassiez	Past
prouver	None
faudrait	None
vengeons	Present
potentialiser	None
patronner	None
reconstruiront	Future
subtilisât	Past
préserva	Past
vulcaniser	None
compléta	Past
cafté	Past
désagrégeant	Present
présentaient	Past
présentèrent	Past
attabler	None
esperant	Present
hisser	None
pillaient	Past
hésiteront	Future
exigèrent	Past
grandissons	Present
préluda	Past
rétablissant	Present
pomponnerons	Future
réfractant	Present
convertir	None
conduisons	Present
hocha	Past
fauché	Past
décomposé	Past
meslé	Past
métissé	Past
plumer	None
réadapté	Past
évoluèrent	Past
conduirait	None
subodorant	Present
refroidira	Future
déchiqueté	Past
solderons	Future
revendu	Past
soillames	Past
coloniser	None
mécrurent	Past
crostiiez	Past
engloutissait	Past
aléser	None
essayeraient	None
assassinas	Past
méritas	Past
colorer	None
concluez	Present
thésaurisera	Future
attesterait	None
hâtèrent	Past
démasquer	None
adjugeait	Past
discouru	Past
sabordant	Present
bouturasse	Past
plaire	None
survenait	Past
orneront	Future
recommençaient	Past
recensait	Past
réprimanderaient	None
marger	None
composta	Past
riocha	Past
rencontreraient	None
nafreroie	None
écrivons	Present
piégèrent	Past
esbauchasses	Past
choisirez	Future
aluminé	Past
éventilleras	Future
renouant	Present
recommandèrent	Past
tertiarisâtes	Past
calomniez	Present
pétitionner	None
étoupâtes	Past
semé	Past
suspend	Present
alpaguer	None
vieillîmes	Past
éclabousser	None
rattrapèrent	Past
camouflant	Present
minimisait	Past
alumeriiens	None
sunjastes	Past
sabrasse	Past
remarqueras	Future
enroulant	Present
amputant	Present
survolté	Past
exploitera	Future
amontant	Present
rivalisaient	Past
ruait	Past
jugeraient	None
garder	None
enragea	Past
rabâché	Past
attribuerait	None
dépoussiérer	None
rapela	Past
décrochera	Future
embarquez	Present
débarquant	Present
disjoindre	None
replorastes	Past
aboyer	None
tenta	Past
nuancerais	None
rentabiliserions	None
mandatant	Present
apostrophé	Past
affina	Past
présélectionnâtes	Past
observeront	Future
exploiter	None
assurât	Past
approvisionnaient	Past
obéirai	Future
préfèreront	Future
encaisser	None
complèteront	Future
royé	Past
affadir	None
générant	Present
itérer	None
ardoisé	Past
aurait	None
désistera	Future
chercheront	Future
obliqué	Past
apparenta	Past
provocquoient	Past
honorez	Present
nécessitait	Past
reposant	Present
subsister	None
harpèrent	Past
retroussé	Past
détaillé	Past
joindra	Future
épousez	Present
accéléré	Past
relieront	Future
revêtu	Past
projeta	Past
précipité	Past
anéantirent	Past
nettoyaient	Past
échauffait	Past
ripaillaient	Past
chercherait	None
statuera	Future
commutant	Present
aicha	Past
encuntras	Past
rompt	Present
cofinancé	Past
concocté	Past
obtenant	Present
sablerait	None
répudier	None
exfiltrerait	None
arrogeraient	None
embauchaient	Past
entretiendront	Future
soudé	Past
scalper	None
différentièrent	Past
préréglé	Past
ambré	Past
choisissez	Present
mappa	Past
contraignant	Present
bénira	Future
surdimensionner	None
succombé	Past
augmentèrent	Past
ratez	Present
prévisualiser	None
éclipserait	None
patoisant	Present
remisse	Past
clavarder	None
reniflant	Present
réutilisait	Past
désintègrerions	None
galopa	Past
réessayé	Past
challenger	None
forniroiz	Future
immobiliser	None
énonçaient	Past
effrayerait	None
chalouper	None
rechigner	None
dépénalisant	Present
fureter	None
interconnecter	None
instrumenteraient	None
défrisant	Present
accrédité	Past
noteront	Future
ravirent	Past
promouvoir	None
importunait	Past
matérialisaient	Past
véhicula	Past
consisteraient	None
décora	Past
théoriser	None
prononceraient	None
hissé	Past
boulanger	None
obtiendrions	None
privèrent	Past
bifferont	Future
mépriserai	Future
bordez	Present
civiliser	None
indemniserais	None
despensé	Past
replaçant	Present
agonisant	Present
rasas	Past
immunisasses	Past
lamas	Past
enchanta	Past
dira	Future
plagiant	Present
navalisasses	Past
toiler	None
doter	None
assisterait	None
enmurerai	Future
campant	Present
léguèrent	Past
pilonna	Past
façons	Present
gangrener	None
troquer	None
flaquer	None
embaucherions	None
volerait	None
retouchant	Present
joignez	Present
plusse	Past
trébuchant	Present
tapissaient	Past
siroter	None
graduer	None
supposèrent	Past
organisa	Past
trinqué	Past
quitta	Past
mobiliser	None
carrera	Future
trémula	Past
assisteront	Future
exprimait	Past
poétiser	None
lassas	Past
branlocher	None
citaient	Past
caillé	Past
compéter	None
prescrivaient	Past
abolir	None
comprendre	None
happé	Past
ascensionnerai	Future
rechignaient	Past
surviendra	Future
gravitait	Past
gaffez	Present
disparaitre	None
purposiiens	Past
brossé	Past
épouser	None
écumera	Future
poursuivraient	None
rembourserait	None
gagnerez	Future
régné	Past
assignait	Past
cokéfier	None
surtitrerait	None
bénéficieront	Future
calculer	None
attireraient	None
accostaient	Past
circonscrire	None
négliger	None
votaient	Past
butinant	Present
condamna	Past
vocalisâtes	Past
jaillirent	Past
enfreignait	Past
réglementé	Past
télévisons	Present
gelèrent	Past
exonérant	Present
claironnant	Present
grincer	None
resterai	Future
accolant	Present
paniqué	Past
regnant	Present
gâcher	None
vaccinant	Present
assimileront	Future
suffirait	None
fécondera	Future
composeront	Future
réfléchirais	None
entachèrent	Past
brouter	None
mitrailla	Past
munissez	Present
ateinsissoiz	Past
percolé	Past
destournoit	Past
guetta	Past
mescreras	Future
lairoient	None
vaqué	Past
éreintait	Past
cueillait	Past
tirerions	None
incluait	Past
détendit	Past
escoffièrent	Past
discernerons	Future
parvenu	Past
pava	Past
douterons	Future
obtenir	None
pourchassé	Past
scinda	Past
carous	Present
bénéficieraient	None
confina	Past
cartographiâtes	Past
maitrisons	Present
revêt	Present
échelonna	Past
triplant	Present
faudras	Future
objectivèrent	Past
houspillèrent	Past
consolider	None
suffoqué	Past
invoquant	Present
combattant	Present
vivrions	None
censurerons	Future
florissant	Present
confessant	Present
sélectionner	None
sonnerais	None
minorant	Present
isolait	Past
réfléchi	Past
baratter	None
constituait	Past
affirmeront	Future
blâmèrent	Past
classerait	None
récusait	Past
fusionnaient	Past
retrouvera	Future
périmer	None
lamer	None
galvaniser	None
azimutâtes	Past
taggé	Past
préfigura	Past
tromperont	Future
psalmodié	Past
coter	None
rabota	Past
côtelé	Past
fétichisa	Past
irai	Future
horrifiant	Present
consulteront	Future
cabossé	Past
cerclant	Present
radouci	Past
transparaitriez	None
balayaient	Past
gagnerons	Future
trichait	Past
coud	Present
capota	Past
encodant	Present
couterait	None
dévoyer	None
attendît	Past
mineras	Future
radiostérilisassions	Past
cossas	Past
subventionnerions	None
rétrécissait	Past
pina	Past
concurrencerait	None
divisé	Past
pourvoirait	None
américaniser	None
vidé	Past
fana	Past
laper	None
gomma	Past
médailler	None
retrouvait	Past
cailletas	Past
maigri	Past
publiez	Present
intuberais	None
sonnerait	None
obtiendraient	None
relaxer	None
séparer	None
dérougi	Past
retraitant	Present
obtureriez	None
désamorcé	Past
purger	None
desguisasmes	Past
embringuer	None
pleurnichant	Present
intimé	Past
examinera	Future
interrompit	Past
irriguas	Past
gravèrent	Past
aveugler	None
résumerais	None
survivant	Present
pelotas	Past
totalisèrent	Past
scolarisé	Past
évangélisèrent	Past
gardât	Past
mécontenta	Past
ignifugé	Past
régénéré	Past
solliciterait	None
surprotégeâtes	Past
communiant	Present
gypseras	Future
débouché	Past
retracer	None
vainquisses	Past
fondera	Future
déplurent	Past
concaténer	None
censurer	None
délimitait	Past
empilaient	Past
dédouanez	Present
ancontras	Past
autonomiserez	Future
perçaient	Past
flatté	Past
décrétait	Past
éveillera	Future
déboiser	None
pausmasmes	Past
immortalisera	Future
réguler	None
correspondre	None
rétablira	Future
acté	Past
bleui	Past
chiffrant	Present
vivotant	Present
giter	None
desjeunerons	Future
empâté	Past
feuilletons	Present
papilloterait	None
dessaisissait	Past
boudât	Past
sortirez	Future
décoloniser	None
définissaient	Past
avisant	Present
démolissait	Past
enraya	Past
traumatisant	Present
nazifierai	Future
coïté	Past
ombrassent	Past
résiderait	None
cambriolé	Past
sourcer	None
départageant	Present
procréer	None
courraient	None
prouvons	Present
évoluer	None
bavardocherons	Future
franchisé	Past
influencèrent	Past
professionnaliser	None
intervenaient	Past
cuydas	Past
parvenir	None
confesser	None
bourlinguer	None
écharpé	Past
farina	Past
traquait	Past
rediscuté	Past
célébraient	Past
dépeuplèrent	Past
pains	Present
énervait	Past
foirons	Present
déterré	Past
coïncider	None
escusast	Past
exploiterait	None
adopta	Past
exigerait	None
réabsorber	None
intercepter	None
sevré	Past
déplût	Past
focaliseras	Future
frima	Past
renos	Present
stoppassiez	Past
dévala	Past
dépeindre	None
inaugurer	None
démêlé	Past
enorgueillissaient	Past
retenu	Past
égouttasse	Past
offrez	Present
sacrer	None
réveillerons	Future
alertera	Future
grimpait	Past
secouaient	Past
porra	Future
entournerions	None
filigrana	Past
coopter	None
implémentera	Future
récidiva	Past
égala	Past
resiphonna	Past
empescher	None
ménageait	Past
buchez	Present
éroder	None
questionnèrent	Past
feuilleter	None
parodiant	Present
aliéné	Past
convaincras	Future
reléguer	None
débuter	None
malmené	Past
franchi	Past
exclura	Future
surnommer	None
éviscérer	None
dropper	None
optant	Present
dardez	Present
remariait	Past
renerent	Past
signeraient	None
argumentez	Present
fournissant	Present
éprouverait	None
paraphé	Past
consisteront	Future
ranimant	Present
objectait	Past
traquaient	Past
adressât	Past
melloie	Past
réentendrait	None
rapprocheraient	None
méfia	Past
existerait	None
abstint	Past
resterait	None
durèrent	Past
gagnerions	None
boycotta	Past
effondrera	Future
fonctionnaient	Past
désappointé	Past
tordre	None
tunerez	Future
résoudrait	None
désuni	Past
haucié	Past
accompagnera	Future
métabolisassions	Past
planifié	Past
emménager	None
regardé	Past
freineront	Future
enlacé	Past
joas	Past
rebaptisant	Present
implanter	None
fixez	Present
abrogea	Past
surestimant	Present
prisait	Past
rester	None
querre	None
optimisez	Present
prisast	Past
capturer	None
arivassent	Past
communions	Present
édifiassent	Past
démontrer	None
sangler	None
conclurait	None
fiabiliserions	None
gicler	None
grape	Present
moustrassiez	Past
interpella	Past
renseigner	None
entreprendront	Future
boursouflassent	Past
aborderait	None
défausser	None
concurrencé	Past
aiguisé	Past
pigmenterons	Future
éditant	Present
supplierons	Future
refaisant	Present
préfacera	Future
blacklisterons	Future
débouclassiez	Past
fripons	Present
reluire	None
comprennes	Present
étalaient	Past
parjurer	None
médiatiser	None
fédèrerait	None
étanchassions	Past
consignait	Past
époustouflé	Past
affecté	Past
travestir	None
exigeraient	None
relaxé	Past
barder	None
tigrons	Present
déprogrammeriez	None
usera	Future
assaut	Present
prolongeaient	Past
dépecer	None
adviendrait	None
flècherons	Future
pormenerai	Future
humaniser	None
réveillonnait	Past
ouata	Past
retourna	Past
couronné	Past
abimé	Past
répondrez	Future
rapporta	Past
ansanglanté	Past
apposer	None
conversant	Present
foudroyé	Past
argua	Past
dénoncé	Past
serions	None
relèvera	Future
louangeassiez	Past
fanant	Present
empêchaient	Past
palpai	Past
éclipsé	Past
coexisté	Past
surpayeriez	None
raccompagné	Past
hériterait	None
grappillé	Past
représentant	Present
fauchant	Present
empêchèrent	Past
moduler	None
déconstruirez	Future
quittai	Past
bataillez	Present
longeaient	Past
éraflé	Past
élisant	Present
monder	None
accepteras	Future
toucher	None
daignant	Present
désigneras	Future
récupérèrent	Past
tairions	None
pondant	Present
dégradé	Past
tumames	Past
assommer	None
épuiseront	Future
salassent	Past
insurgèrent	Past
limeront	Future
embauchèrent	Past
jackasses	Past
ironisant	Present
scanné	Past
rapporterait	None
gèrerait	None
revendit	Past
déchainé	Past
assermentait	Past
limitez	Present
muté	Past
couvriraient	None
assainissant	Present
marinai	Past
sila	Past
calmé	Past
coincé	Past
disqualifierait	None
inclurent	Past
séquencé	Past
exécutant	Present
embusquerons	Future
enquêtèrent	Past
décarburer	None
postula	Past
combattrons	Future
votait	Past
survenir	None
fixer	None
waiteras	Future
embobinassions	Past
bloquerai	Future
exhalé	Past
débarqué	Past
tuber	None
crédita	Past
lofa	Past
occlurent	Past
dissuada	Past
nonce	Present
impatientait	Past
connaîtront	Future
cameriez	None
accessoirisèrent	Past
troublera	Future
servaient	Past
illusionneras	Future
retransmettre	None
régurgité	Past
estérifier	None
exterminé	Past
bronzaient	Past
tuerai	Future
slavisant	Present
achopper	None
sacralisant	Present
convia	Past
écouteront	Future
ruiner	None
maltraitassiez	Past
traduirai	Future
soubhaitterions	None
atténuerait	None
piaillassions	Past
challengerais	None
beurrerait	None
organiser	None
hacha	Past
vasta	Past
assistait	Past
déconcerterions	None
crédibiliser	None
remarqueront	Future
interné	Past
lyophiliser	None
succombèrent	Past
adossa	Past
aencrissons	Past
invité	Past
disons	Present
pullulasse	Past
repasserait	None
vouèrent	Past
trouver	None
mesparlerai	Future
rasa	Past
opiner	None
défini	Past
retardasse	Past
dècrypteraient	None
infligea	Past
rabroué	Past
tombé	Past
ficher	None
déclenché	Past
congédié	Past
réconciliant	Present
fredonner	None
stagnaient	Past
parleront	Future
enpoisonnoient	Past
désigna	Past
fissionnassiez	Past
goupillerai	Future
couvrait	Past
expliquons	Present
finaliserez	Future
seela	Past
picotasse	Past
risquerez	Future
translitèreraient	None
sortant	Present
défendra	Future
baigner	None
spécialisèrent	Past
participeront	Future
décriraient	None
radoubasse	Past
revenons	Present
ausculter	None
mèneraient	None
negotiassions	Past
développer	None
accastillerez	Future
sillonna	Past
coécrira	Future
relocalisâtes	Past
énonçasse	Past
avérassent	Past
calfater	None
paraitrai	Future
contrôlerai	Future
nait	Present
banqueter	None
suralimenté	Past
rédigé	Past
recenser	None
massa	Past
emporterait	None
hypothéqua	Past
suscitèrent	Past
paraîtront	Future
détroussait	Past
carreler	None
distingué	Past
diagnostiquai	Past
saliver	None
frottant	Present
jurer	None
jaunir	None
atterri	Past
emploieraient	None
dirons	Future
interdiraient	None
racketté	Past
prononcerais	None
hanter	None
déferla	Past
désintéressèrent	Past
dépraverais	None
croyant	Present
adreçastes	Past
rapetissé	Past
déchoit	Present
avalisa	Past
survolait	Past
verser	None
flairer	None
délasser	None
favorisait	Past
évertuer	None
entrebâillerai	Future
redevenir	None
accommoda	Past
enrouilleras	Future
étrenné	Past
expirait	Past
fortifia	Past
choyer	None
complexifiant	Present
noter	None
renflouer	None
espumiiez	Past
signifiait	Past
émaner	None
démoralisa	Past
câlissons	Present
asséchèrent	Past
plaignes	Present
snackerez	Future
desmanteaus	Present
méritez	Present
accessoiriser	None
montrer	None
jetez	Present
recasaient	Past
dédiaient	Past
professé	Past
soulassions	Past
asproieroit	None
propulseront	Future
classât	Past
abritèrent	Past
dynamisa	Past
coursons	Present
visitera	Future
reconsidéré	Past
affaiblissaient	Past
capotât	Past
étiré	Past
affectionner	None
réaménager	None
construiront	Future
lancinant	Present
subît	Past
répétait	Past
coltiner	None
apaisèrent	Past
contrecarreriez	None
effacerai	Future
recélait	Past
rêvèrent	Past
délinquait	Past
abriter	None
agglomérer	None
saulvoient	Past
rebotai	Past
écopai	Past
craindrait	None
lanterna	Past
discrétisaient	Past
miré	Past
collons	Present
découragerait	None
perturbèrent	Past
espunez	Present
renièrent	Past
fuita	Past
fouinant	Present
filera	Future
aimerai	Future
profitaient	Past
inculper	None
peintes	Present
proposant	Present
enrênas	Past
paine	Present
breaker	None
soldé	Past
battrais	None
votons	Present
surpassera	Future
mijoter	None
remarquerez	Future
dotèrent	Past
autofinancé	Past
moquasses	Past
ravagea	Past
considerant	Present
solidifiant	Present
guider	None
interrompaient	Past
ressentirait	None
limiteraient	None
aouroient	Past
enchainé	Past
culpabiliserait	None
malté	Past
décrire	None
esquisser	None
imprégner	None
desnoas	Past
suns	Present
révolter	None
tâcha	Past
saulveront	Future
estompera	Future
mouchant	Present
encaustiquez	Present
hut	Present
serrèrent	Past
rendrai	Future
humilié	Past
équivaut	Present
signalèrent	Past
gréer	None
prétendons	Present
vale	Present
expérimenta	Past
apprêta	Past
arpenté	Past
focaliserais	None
déflaterez	Future
écarter	None
bouler	None
consacrera	Future
consolait	Past
nasalisé	Past
conquerriiens	None
excommuniâmes	Past
mimeront	Future
régissaient	Past
diffracter	None
esclairer	None
handicaper	None
amoindriront	Future
intima	Past
plierait	None
mimait	Past
remettre	None
déciderai	Future
ferma	Past
accroitrons	Future
acéra	Past
engouffraient	Past
reformuler	None
chiquerez	Future
infléchît	Past
bucherons	Future
bercer	None
cohabiter	None
ravagera	Future
bricola	Past
fissuré	Past
libèrera	Future
échouer	None
délaisser	None
reconcentrer	None
changeras	Future
attaquer	None
écarquillerait	None
jugea	Past
lixivions	Present
traumatisa	Past
éliminons	Present
nationaliser	None
abaisser	None
rembarquerait	None
appréhendaient	Past
préméditas	Past
cicatrisant	Present
expérimentons	Present
purgeant	Present
rappelant	Present
grillagé	Past
imaginons	Present
patinait	Past
exempta	Past
allongé	Past
répondes	Present
soupçonnerait	None
affirmé	Past
intérioriser	None
fraudé	Past
engourdir	None
débroussailler	None
déprivons	Present
étirera	Future
empêcherais	None
apostasierions	None
punaisé	Past
persécuta	Past
subornerais	None
gangrené	Past
élançait	Past
acclameraient	None
encadrant	Present
éliminaient	Past
demourasses	Past
modifions	Present
enchaînez	Present
téléguider	None
désinfectai	Past
classer	None
conventionneront	Future
restituer	None
triait	Past
meut	Present
omettaient	Past
supputeriez	None
unifiant	Present
substituant	Present
blecha	Past
surgiront	Future
faillisent	Past
revoyait	Past
modifiait	Past
éduquait	Past
affaisser	None
déclamé	Past
damna	Past
déganter	None
perdrais	None
agressé	Past
cuidasse	Past
terrassant	Present
retirer	None
détaxé	Past
méprisez	Present
encadrer	None
pressentaient	Past
éventrer	None
brosderiiez	None
substituer	None
feutreriez	None
tenter	None
feront	Future
comblant	Present
invoqua	Past
contribuer	None
adjoindra	Future
rêvera	Future
canaliser	None
projetons	Present
désenclaverons	Future
relancera	Future
avoisinaient	Past
frotté	Past
décrions	Present
éreinter	None
accédant	Present
renaît	Present
aiguillonner	None
renchérissent	Past
carburé	Past
imaginerait	None
implémentant	Present
répétant	Present
désolait	Past
écarteler	None
sniffer	None
boita	Past
dépensez	Present
éluer	None
surviendrez	Future
dégueulasses	Past
enrager	None
décimer	None
abouchant	Present
assassiner	None
refoula	Past
permettre	None
produire	None
mixé	Past
regagna	Past
maltraitèrent	Past
minera	Future
buché	Past
attendaient	Past
révisera	Future
élucidé	Past
oserait	None
accostera	Future
heiz	Present
jalonnaient	Past
apaisé	Past
mythifier	None
retenta	Past
préjugé	Past
arrangerais	None
fermâtes	Past
esfreeront	Future
assembla	Past
terrorisa	Past
cointoierai	Future
phantasia	Past
terminait	Past
perpétuant	Present
transpiré	Past
renommerait	None
fraîchirait	None
constaterait	None
migrant	Present
renié	Past
vengez	Present
deserves	Present
collectionna	Past
semaient	Past
agaçait	Past
valas	Past
résolu	Past
réajuster	None
rétracter	None
déclaraient	Past
réexpédia	Past
intersectera	Future
rabrouera	Future
ravina	Past
ensuit	Present
peaufiné	Past
critiquez	Present
examinaient	Past
déployaient	Past
redimensionnant	Present
basé	Past
polychromisassent	Past
mectrois	None
égorger	None
capturèrent	Past
accomplira	Future
dévergondèrent	Past
mariaient	Past
écartaient	Past
importé	Past
consacreront	Future
dégaza	Past
bouclerait	None
obtient	Present
magyarisé	Past
dévoileront	Future
éteignit	Past
entremêlerait	None
décrirai	Future
anticipait	Past
détonant	Present
brisé	Past
élaborant	Present
prêchaient	Past
roya	Past
appareilla	Past
introduirait	None
balayera	Future
désalinisâmes	Past
rattrapa	Past
troublez	Present
italianiser	None
gratifier	None
nitraté	Past
grimper	None
effeuiller	None
accélérassiez	Past
pendre	None
loti	Past
nageroient	None
strierions	None
suspendu	Past
recourber	None
cunseilloies	Past
marxisant	Present
évacué	Past
embauchant	Present
taraudèrent	Past
conformèrent	Past
escherriiez	None
réagirent	Past
insinuait	Past
étouffèrent	Past
étouffons	Present
mascherai	Future
éviterai	Future
envahiraient	None
attristât	Past
alumassent	Past
sommant	Present
desguisissons	Past
représenteront	Future
pendra	Future
désavantager	None
consigner	None
renversa	Past
interviewant	Present
rengager	None
dînait	Past
prospérèrent	Past
appelât	Past
répandre	None
ramenant	Present
bullé	Past
teindre	None
tanguerons	Future
soudas	Past
dévalé	Past
conciliait	Past
nidifiant	Present
séjournaient	Past
borner	None
commuté	Past
lisser	None
exacerbé	Past
ulcérer	None
voudrions	None
rebrousser	None
banaliser	None
courir	None
empanaché	Past
vibrons	Present
inspireraient	None
écouter	None
mesparliiez	Past
rallié	Past
raisonné	Past
surlignassent	Past
accostait	Past
sépareront	Future
synchronisant	Present
pondait	Past
sécuriser	None
complaire	None
dégroupé	Past
étonner	None
fleuriront	Future
subverti	Past
chevauchait	Past
débarrassèrent	Past
déviant	Present
mentionnerez	Future
accepterez	Future
dépêché	Past
acheva	Past
coulissera	Future
arive	Present
fucker	None
soûler	None
confronté	Past
retiendra	Future
lissa	Past
obstrua	Past
rassiriez	None
controverseriez	None
agrandir	None
baptoias	Past
transféraient	Past
dénué	Past
étudierait	None
enseignait	Past
régnez	Present
rejuvenerent	Past
prononçaient	Past
miniaturisât	Past
fréquentant	Present
violenté	Past
diplômant	Present
moulinasse	Past
réexaminé	Past
gravira	Future
parvenez	Present
supplicieras	Future
copiloté	Past
publier	None
rompaient	Past
sécrétant	Present
déshonorant	Present
barbons	Present
consacrât	Past
dézoomer	None
soignerait	None
contenant	Present
deviendrais	None
minèrent	Past
tacha	Past
miniaturisèrent	Past
considerer	None
fidélisé	Past
loupé	Past
concerna	Past
ondulé	Past
déchargèrent	Past
mendiant	Present
débrouillera	Future
transmit	Past
culminant	Present
épaulera	Future
syndicalisait	Past
fouillait	Past
recomposant	Present
détérioraient	Past
pencher	None
obérant	Present
fortifièrent	Past
comploter	None
pardonnerez	Future
desert	Present
interagi	Past
subsistant	Present
systématisant	Present
multipliaient	Past
blaguer	None
scruté	Past
choquer	None
écrivez	Present
bloquons	Present
fusionné	Past
vantaient	Past
escartast	Past
espirera	Future
pesez	Present
traduirait	None
certifia	Past
cédé	Past
réapprendre	None
saucissonner	None
posa	Past
juxtaposait	Past
cota	Past
engloutira	Future
recrutant	Present
grossissaient	Past
barré	Past
gala	Past
despencer	None
suscitait	Past
tumas	Past
compénétrez	Present
réimprimez	Present
bouillons	Present
rejoindrait	None
prêchait	Past
égratigner	None
coproduiraient	None
engraisserez	Future
enconvenenças	Past
souler	None
congestionneriez	None
connecta	Past
pocher	None
commerçant	Present
résisté	Past
huai	Past
entamé	Past
débrouillait	Past
assoirait	None
redundant	Present
amarrant	Present
dénombra	Past
vouchas	Past
triomphèrent	Past
déchainer	None
homicidât	Past
régnèrent	Past
embarquâmes	Past
drilla	Past
soufflant	Present
complexant	Present
graver	None
relançons	Present
parfumait	Past
anesthésier	None
merveilleroies	None
déclineriez	None
exigeaient	Past
animez	Present
prouvèrent	Past
vomi	Past
pourrissait	Past
oscillant	Present
monétisâtes	Past
transmettrai	Future
subtilisant	Present
relançâmes	Past
renouvellera	Future
chargeaient	Past
redevinrent	Past
codétinsses	Past
citait	Past
décidèrent	Past
attenta	Past
somatiseras	Future
remonteront	Future
édulcorer	None
nappé	Past
décongeler	None
mouchetant	Present
équivaudra	Future
agrémentait	Past
rémunérer	None
évoquasse	Past
déferlé	Past
progressé	Past
besognasses	Past
développé	Past
soutinrent	Past
fauté	Past
banquetait	Past
remplacera	Future
décongestionner	None
hausser	None
opposer	None
blessera	Future
coniurera	Future
synthétisé	Past
lorgnons	Present
transpirait	Past
entreprenait	Past
borné	Past
surchauffant	Present
mentir	None
désirerait	None
inoculer	None
ajouterons	Future
survives	Present
cuntenoies	Past
habilitâtes	Past
adjugez	Present
descendraient	None
flater	None
éjectait	Past
interrompant	Present
monitorerais	None
tu	Past
virgulâtes	Past
secorre	None
réquisitionnant	Present
commanditer	None
agglomérassions	Past
redessinait	Past
désassemblé	Past
ménageaient	Past
parferions	None
nivelé	Past
espérez	Present
détourneront	Future
courtiseraient	None
sozleveras	Future
desevreroies	None
expier	None
hybridé	Past
méthyler	None
adosser	None
décoiffer	None
épauleras	Future
écrémer	None
délita	Past
surveilliiez	Past
pinceront	Future
instrumenter	None
distinguera	Future
concèderez	Future
enveloppant	Present
masquant	Present
capteraient	None
escamotant	Present
coqueta	Past
décompresseraient	None
alerta	Past
sculptera	Future
instaurerait	None
haïra	Future
ressoudassent	Past
éterniser	None
écrirais	None
transcrivaient	Past
écoutèrent	Past
triompher	None
défoncé	Past
apprenez	Present
dévouait	Past
gênez	Present
noterai	Future
quérir	None
scandait	Past
défibrinas	Past
aluma	Past
narguer	None
rottions	Past
disperserait	None
perçait	Past
précipitera	Future
déclamaient	Past
exterminèrent	Past
ensemençant	Present
renoncer	None
courbas	Past
pâtissa	Past
allaient	Past
embrasserai	Future
déprogrammer	None
déconfirais	None
ansanglanteroit	None
dirent	Past
sourciller	None
forçaient	Past
arboriseras	Future
enjoignîtes	Past
remercyeroient	None
dépliant	Present
apprendrai	Future
retardera	Future
embusqué	Past
évider	None
abeurvèrent	Past
grêlât	Past
rengainâmes	Past
plaindra	Future
apparaitre	None
séchez	Present
recréer	None
avancerait	None
éliminerait	None
entêterait	None
mentirait	None
dédommagé	Past
reformatât	Past
réserver	None
escumenjoie	Past
annotait	Past
rajouteront	Future
levons	Present
correspondit	Past
succombera	Future
détroussé	Past
théoriserions	None
siphonné	Past
projeté	Past
amputé	Past
cardé	Past
ruserions	None
concentrera	Future
bâillonnerons	Future
déséquilibrerait	None
roullé	Past
connaitrait	None
indigna	Past
lançons	Present
enfilaient	Past
transcrivant	Present
investirent	Past
trouveraient	None
égarez	Present
plairont	Future
référer	None
mitraillassiez	Past
rejetteraient	None
germanisé	Past
ossifiai	Past
seroit	None
déchaina	Past
contacter	None
eslançast	Past
renseignèrent	Past
amassèrent	Past
détester	None
assourdir	None
reléguant	Present
peaufina	Past
pénaliserez	Future
économisera	Future
binant	Present
reguardoit	Past
serrer	None
distancer	None
extrayant	Present
rivera	Future
noyautant	Present
déclinait	Past
redevons	Present
utilisaient	Past
absout	Present
déprécié	Past
châtiant	Present
politiser	None
lanternons	Present
réislamiser	None
commenteront	Future
interpoler	None
alambiqué	Past
nombrant	Present
pilonnèrent	Past
spéculèrent	Past
gémissant	Present
patrouilleront	Future
baffa	Past
redressant	Present
remédia	Past
ameuter	None
désolidarisassiez	Past
expérimentait	Past
maîtrisait	Past
convoiteras	Future
détectèrent	Past
basculassent	Past
nuisirent	Past
dirigeai	Past
transformez	Present
destournas	Past
alosast	Past
glissait	Past
fessait	Past
divulguera	Future
confortera	Future
ulula	Past
dévaluant	Present
raconté	Past
pénaliserait	None
incombant	Present
tortillas	Past
répercutait	Past
macadamisasses	Past
écrire	None
espéré	Past
blanchissant	Present
droppâtes	Past
guéerions	None
vengeait	Past
occupant	Present
dégrafasses	Past
chatouillerais	None
convainc	Present
valorisera	Future
capotassiez	Past
deviendrait	None
évidant	Present
restructuré	Past
gênerais	None
incinérer	None
maculer	None
ressentiront	Future
stoppaient	Past
dévastèrent	Past
actionner	None
criminalisait	Past
désapprouvâtes	Past
décochant	Present
agacer	None
dégoûtez	Present
adressait	Past
prétendront	Future
pila	Past
saturant	Present
détournait	Past
autodétruises	Present
débuterait	None
shooté	Past
tarifierait	None
délavé	Past
bossa	Past
glané	Past
reboiser	None
paser	None
excorieront	Future
citerai	Future
amenuisant	Present
fauchez	Present
feuilletterions	None
réécoutait	Past
sectionner	None
ballas	Past
voiturassent	Past
convaincrait	None
sophistiqueras	Future
bouélant	Present
dysfonctionneriez	None
vautrer	None
trompaient	Past
décroché	Past
tarirent	Past
regrez	Present
occulté	Past
raclé	Past
essayerais	None
royer	None
leurré	Past
sos	Present
prierais	None
triompherions	None
ferrasse	Past
plumé	Past
chiffré	Past
crocheter	None
aspireras	Future
bouchons	Present
longeriez	None
exaltant	Present
éternisa	Past
souhaitons	Present
dégénérer	None
railla	Past
acosta	Past
pétiller	None
entamons	Present
désengorger	None
apercevant	Present
rejugerez	Future
flashé	Past
biaiser	None
aiguillera	Future
annexera	Future
airez	Present
rattrapons	Present
rallongeassions	Past
ciblant	Present
durcir	None
malaxer	None
capituler	None
tabasser	None
subir	None
simuler	None
escamoté	Past
torturâmes	Past
désentrelaçaient	Past
acylé	Past
échouerait	None
détrônerait	None
échelonnera	Future
abrogera	Future
abusèrent	Past
redirigera	Future
somondroie	None
éloignez	Present
redoutant	Present
ansera	Future
rancir	None
malmena	Past
réprouvé	Past
laver	None
aparla	Past
persistèrent	Past
effondrant	Present
déploieraient	None
battrons	Future
fausser	None
écouleront	Future
baladas	Past
délia	Past
amorçassent	Past
edifier	None
damageroies	None
relayèrent	Past
immatriculé	Past
avoisinerait	None
destinait	Past
organisé	Past
maugréas	Past
épuré	Past
tonifier	None
catalysassiez	Past
prohiberai	Future
rapatrié	Past
opteraient	None
scorassions	Past
enluminer	None
rouvrir	None
bêcher	None
classifierons	Future
ébat	Present
afferma	Past
renonça	Past
reconsolidaient	Past
factorisé	Past
sommait	Past
sectionné	Past
rétablissons	Present
aboli	Past
chuinteriez	None
généralisera	Future
renaîtra	Future
penant	Present
tourmenta	Past
renové	Past
gêné	Past
contrefaites	Present
surdoser	None
pâturant	Present
couvraient	Past
réimporter	None
imputer	None
apprécions	Present
brida	Past
suivrait	None
solderont	Future
abornerait	None
accompagnèrent	Past
descellerions	None
prima	Past
romancerez	Future
rencontrerai	Future
orthogonaliseriez	None
ressusciterait	None
réécouta	Past
odora	Past
intenté	Past
procurez	Present
feras	Future
compétant	Present
charriant	Present
getera	Future
détoxifier	None
simplifions	Present
déshériter	None
astiquerais	None
monnayâtes	Past
patronna	Past
rétrocédèrent	Past
devenir	None
gruger	None
essuyait	Past
souhaitant	Present
connaîtrions	None
baiser	None
survenaient	Past
certifieraient	None
exclurent	Past
trémulassions	Past
charabièrent	Past
doi	Present
rachetèrent	Past
exécuterait	None
retraversé	Past
perdu	Past
parquerait	None
bernas	Past
anuieroies	None
reliassent	Past
rapas	Past
coprécipiteriez	None
authentiquas	Past
gerba	Past
rentreraient	None
controversé	Past
dire	None
repousser	None
diriger	None
éclairciriez	None
entamerait	None
lotir	None
déboussolai	Past
apprendront	Future
couronnèrent	Past
rendre	None
potasseriez	None
énervant	Present
citerais	None
redynamisant	Present
perdons	Present
exauçant	Present
drillerons	Future
souhaitera	Future
agenouillé	Past
pénètreriez	None
usurper	None
poignirent	Past
autoproclamant	Present
contesterai	Future
tolèrerait	None
abdiquant	Present
huiler	None
consentiraient	None
couru	Past
renseignez	Present
dépulperont	Future
séparant	Present
raffoleras	Future
enchaînant	Present
juxtaposant	Present
véhiculant	Present
satisfaisaient	Past
impliquant	Present
rembarrer	None
renâcler	None
radicalisait	Past
bruleraient	None
répondirent	Past
résuma	Past
labourasse	Past
resisterions	None
reprendre	None
chelas	Past
décerna	Past
guidaient	Past
mensualisât	Past
glissé	Past
aillons	Present
zonas	Past
allongèrent	Past
prisé	Past
distendu	Past
apprêter	None
adressé	Past
réaffecta	Past
agreer	None
pétillassent	Past
prévient	Present
rejouant	Present
gourer	None
menjües	Present
erra	Past
qualifierais	None
synthétisait	Past
simplifierait	None
galochons	Present
interconnectant	Present
aprovenderoit	None
déambulant	Present
réunirent	Past
croupir	None
oublierait	None
colletasse	Past
conserverais	None
calcinons	Present
sourîmes	Past
fleura	Past
aparelleroit	None
dirai	Future
pousseriez	None
externaliser	None
anéantira	Future
existez	Present
immatriculer	None
surévalué	Past
pansé	Past
resituer	None
pluma	Past
rectifiait	Past
estiveriez	None
possédons	Present
rassurerait	None
coloniserons	Future
klaxonner	None
ramassèrent	Past
lettré	Past
trias	Past
unifié	Past
chapitrassions	Past
résulter	None
déshonorer	None
exigeant	Present
rebandâtes	Past
dévora	Past
informatiser	None
fulgurant	Present
rallongé	Past
glissons	Present
satelliser	None
épargnèrent	Past
bomberai	Future
permet	Present
aisa	Past
espoantant	Present
subirait	None
alésé	Past
diaphragmaient	Past
réveillez	Present
espéra	Past
devraient	None
normaliser	None
déconner	None
faciliteraient	None
compromettait	Past
waste	Present
habiteront	Future
déguisant	Present
piler	None
frappa	Past
embêtez	Present
inondaient	Past
concerta	Past
numa	Past
administrerait	None
visionné	Past
robotiserions	None
affolé	Past
feniriiens	None
théorisa	Past
arraisonner	None
réarmant	Present
mâchonner	None
règnerait	None
dauber	None
immortalisant	Present
raisonnant	Present
touché	Past
affubler	None
engager	None
remportèrent	Past
froissait	Past
effilé	Past
brutalisassions	Past
coulisserait	None
révisasses	Past
turnes	Present
taxer	None
évaluera	Future
répétaient	Past
pulvérisons	Present
sursautera	Future
transgressâmes	Past
sympathiser	None
spécifierons	Future
parlez	Present
blondir	None
stria	Past
réentendu	Past
virâtes	Past
familiarisera	Future
persifflerais	None
dribblant	Present
disculpa	Past
bigla	Past
nia	Past
profitons	Present
remplissait	Past
aguerrait	Past
baisserait	None
restaurez	Present
rebattissiez	Past
intervertir	None
tarderait	None
allumé	Past
desservirent	Past
calant	Present
traduisirent	Past
raccrochera	Future
embêtait	Past
surabondant	Present
avivasse	Past
ballotta	Past
cagua	Past
suscitons	Present
reprochait	Past
récitera	Future
navrant	Present
bousculé	Past
capa	Past
visiteraient	None
débrider	None
bouillirait	None
éborgnerait	None
dénonça	Past
déclamant	Present
engageaient	Past
protestas	Past
découvrir	None
boudait	Past
enchevêtré	Past
résiliera	Future
limiterais	None
subordonnait	Past
moraliser	None
taner	None
majorerait	None
devenaient	Past
émerger	None
bâillonner	None
corromprait	None
limant	Present
valait	Past
parabola	Past
développant	Present
réimplanter	None
allégué	Past
asset	Present
renta	Past
devrait	None
tétons	Present
dolez	Present
naviguer	None
obligeraient	None
constituerait	None
taffasses	Past
examiné	Past
warder	None
complaisait	Past
jalousé	Past
imbiber	None
dynamiser	None
revenir	None
signifiaient	Past
répondrons	Future
interférant	Present
associera	Future
illustraient	Past
adossé	Past
interceptèrent	Past
ponctua	Past
entretenons	Present
perduré	Past
direz	Future
cessant	Present
lubrifié	Past
toléraient	Past
investira	Future
zigzaguer	None
bloquera	Future
positionnaient	Past
optera	Future
resplendissant	Present
favoriserez	Future
exhiber	None
enracina	Past
revendirent	Past
renfermerait	None
ghettoïser	None
philosopher	None
disparaitront	Future
parabolera	Future
rançonner	None
recensaient	Past
chemisé	Past
interverti	Past
rejoindraient	None
poissant	Present
percutai	Past
écoper	None
démobiliser	None
flingué	Past
capturerait	None
appendu	Past
enoinz	Present
internèrent	Past
soutirerai	Future
longer	None
débarrassa	Past
founder	None
commanditerez	Future
pyrolysâmes	Past
félicitèrent	Past
enveieit	Past
griller	None
souhaita	Past
défricher	None
immigrant	Present
morfondait	Past
orbitaient	Past
ornementer	None
sonnant	Present
sauvegardez	Present
explicqueroient	None
caoutchouté	Past
rétrograda	Past
remettrons	Future
traqueront	Future
essaima	Past
obstruâmes	Past
liquéfiant	Present
coûté	Past
harpé	Past
collant	Present
compromettre	None
nettoyèrent	Past
écoeuré	Past
puisera	Future
désinformer	None
designé	Past
aventurerais	None
sonder	None
rempilas	Past
manœuvré	Past
ferroutant	Present
tentai	Past
cotisant	Present
fidéliser	None
eschanjant	Present
qualifia	Past
dédorassent	Past
orientalisant	Present
amena	Past
imposa	Past
parsemé	Past
entrouvrira	Future
forjas	Past
aboieriez	None
travailleras	Future
empêché	Past
convoitaient	Past
déboursâtes	Past
factoriser	None
programmant	Present
coïncidèrent	Past
livraient	Past
coûteraient	None
japperiez	None
familiarisé	Past
ébattre	None
accumula	Past
intéressera	Future
bénissaient	Past
broma	Past
oz	Present
conduira	Future
coécrire	None
pédalant	Present
dépuceler	None
fusé	Past
protesterai	Future
accoutumeras	Future
amasser	None
chaunjames	Past
démoralisé	Past
malaxé	Past
abstinrent	Past
rassurait	Past
reposait	Past
tardèrent	Past
revendait	Past
hésitant	Present
attesteraient	None
amusons	Present
trespasser	None
tracassé	Past
remédiassions	Past
réformer	None
cuntredire	None
piratant	Present
polémiqua	Past
adioustasmes	Past
meublant	Present
chauferoiz	Future
résorber	None
jugerait	None
arrogé	Past
analyser	None
gratté	Past
ravalé	Past
décideraient	None
arracheront	Future
claustras	Past
remaria	Past
differe	Present
incurva	Past
relancerai	Future
baser	None
desservit	Past
distordu	Past
désarmer	None
manquait	Past
deut	Present
planer	None
décidât	Past
pilotas	Past
envasé	Past
bossant	Present
présumé	Past
osé	Past
troublerait	None
ordonnancer	None
alourdirait	None
fleurdeliseront	Future
diviseront	Future
existait	Past
bioaccumulé	Past
catastrophez	Present
augmentons	Present
fissura	Past
stationnant	Present
plier	None
croz	Present
déménagea	Past
captivait	Past
auditionné	Past
terminât	Past
balbutier	None
popai	Past
réitérer	None
cuntredistrent	Past
mercher	None
servir	None
doctrina	Past
loguer	None
campera	Future
revigorer	None
curuneroie	None
fripé	Past
accrut	Past
mériteraient	None
campas	Past
est	Present
ganglions	Past
glousserait	None
briguerait	None
repeleriiens	None
dénueront	Future
abrègerais	None
mangeras	Future
immola	Past
reconvertir	None
affriolerait	None
conservé	Past
dansera	Future
gougé	Past
informer	None
taffèrent	Past
dépréciassent	Past
encartouchèrent	Past
reloger	None
défiscaliser	None
aimeraient	None
hypnotiser	None
excommunia	Past
classera	Future
désœuvreront	Future
connectera	Future
blanchir	None
dépêchons	Present
gagnez	Present
précipiteront	Future
régressé	Past
boulé	Past
défragmenterions	None
acidifierai	Future
détenant	Present
parola	Past
affinera	Future
astin	Past
reconnaîtront	Future
reflétant	Present
déparerait	None
augé	Past
cloner	None
permuté	Past
scorant	Present
saluera	Future
marbré	Past
municipaliser	None
dégarnir	None
franchirais	None
visitait	Past
tarauderont	Future
rendraient	None
endommageasses	Past
fouinas	Past
ruserai	Future
maintînt	Past
déroché	Past
accusaient	Past
marier	None
coururent	Past
sentiraient	None
infirmant	Present
retraçassiez	Past
déçut	Past
braver	None
atendierent	Past
entremettre	None
réentend	Present
coopterons	Future
invoquerais	None
grouillait	Past
congédier	None
bombarderas	Future
réexaminer	None
avancer	None
sabordèrent	Past
contrevenir	None
remettra	Future
espaçant	Present
désarticulé	Past
facilitait	Past
détectait	Past
usas	Past
exprimaient	Past
resservir	None
trei	Present
désoxygéné	Past
effectuaient	Past
communiquer	None
rétorquer	None
dépossédèrent	Past
impliquerait	None
chomé	Past
décomprimerais	None
psychanalysé	Past
roba	Past
désintéressait	Past
croulant	Present
commérant	Present
dépolarisant	Present
découvrirait	None
méthaniser	None
renaître	None
appuierait	None
garantiraient	None
embrouillé	Past
essorer	None
plaidait	Past
momifier	None
éradiquant	Present
résultait	Past
rafraîchirait	None
cuntredirai	Future
démarreront	Future
prattiqueront	Future
attérit	Past
émouvoir	None
saupoudré	Past
intronisa	Past
échancrâmes	Past
cultivons	Present
agrippé	Past
personnifier	None
boivre	None
optaient	Past
exacerbèrent	Past
effilant	Present
combattront	Future
restaurerais	None
bez	Present
scanner	None
convoquant	Present
mastiquassent	Past
craqueler	None
retourné	Past
allouera	Future
péchant	Present
abstiendra	Future
sonas	Past
homogénéiser	None
concéda	Past
dénigraient	Past
agresser	None
sigler	None
tombait	Past
superait	None
industrialisé	Past
déplacerait	None
écrivaient	Past
maillant	Present
réfutaient	Past
alkylé	Past
prêtera	Future
driverons	Future
souriant	Present
intellectualiser	None
entrèrent	Past
chemisassent	Past
alliant	Present
regorgeant	Present
revécu	Past
imaginerais	None
dilapider	None
assécha	Past
clamèrent	Past
moqueront	Future
merveilleroit	None
déglutir	None
stocker	None
secorroient	None
emprisonner	None
agenouiller	None
astiquer	None
révélait	Past
entreprendre	None
vouloir	None
sucez	Present
quémander	None
acceptât	Past
toisé	Past
lieront	Future
déposerait	None
réinvestissons	Present
crypter	None
excellèrent	Past
maillochas	Past
démentes	Present
dansa	Past
waites	Present
stipulait	Past
humecter	None
disséminâtes	Past
caguai	Past
franchissant	Present
astreignîtes	Past
orai	Past
abstenez	Present
tranlatissons	Past
interagissaient	Past
réapparait	Present
exfolieraient	None
démissionnait	Past
endossant	Present
éparpillé	Past
homoérotisât	Past
préparerait	None
débarquaient	Past
récidivant	Present
approprièrent	Past
baragouiner	None
endommagèrent	Past
avertira	Future
vocalisé	Past
rétrécissant	Present
privez	Present
recollerais	None
répertorieront	Future
serraient	Past
marketer	None
craignant	Present
promeṣimes	Past
paraître	None
humiliait	Past
écloriez	None
interférer	None
pressèrent	Past
avancerez	Future
réaffirmait	Past
débrouilla	Past
décrété	Past
valsez	Present
classerai	Future
enregistrer	None
dézinguer	None
cauterisastes	Past
subsisterons	Future
desmet	Present
baserez	Future
affermir	None
aventuré	Past
éloigneraient	None
déplorera	Future
filtrer	None
considérât	Past
assibila	Past
chipoter	None
governeriiens	None
consoler	None
tana	Past
disparaitrait	None
assemblé	Past
tane	Present
fonctionnalisas	Past
étriqué	Past
hué	Past
repétriras	Future
fréquentèrent	Past
poêlé	Past
vivaient	Past
dépensant	Present
supposez	Present
exemplifias	Past
captivé	Past
vieler	None
polymérisant	Present
dissuader	None
cliqua	Past
estofferez	Future
dépasseraient	None
resigna	Past
blasonnait	Past
reigneroies	None
devora	Past
blessait	Past
manifestèrent	Past
wardes	Present
adjoindre	None
estimer	None
batisse	Past
arriver	None
materna	Past
frétassions	Past
rainurasse	Past
pressait	Past
squatter	None
indaguai	Past
rationnâmes	Past
réaffirmé	Past
moralisé	Past
redoubler	None
luitterois	None
converti	Past
suiffassions	Past
affligea	Past
envahissait	Past
augmenterait	None
chavirèrent	Past
endettant	Present
desclot	Present
assené	Past
nouasse	Past
baislerons	Future
repeignant	Present
barderiez	None
menaçait	Past
vandalisé	Past
dynamiter	None
cueillissions	Past
corrodé	Past
emboîter	None
brancher	None
reformé	Past
blacklisté	Past
réuniront	Future
réintroduisit	Past
cristallisa	Past
asserchasses	Past
obéiront	Future
abêtîtes	Past
récolterez	Future
intéresserai	Future
voucher	None
amenuisait	Past
quémanderai	Future
protègeront	Future
dialysé	Past
intensifiera	Future
proroger	None
raquer	None
adulé	Past
encroissoie	Past
conquerant	Present
joames	Past
casé	Past
habitua	Past
éliminant	Present
assommas	Past
dégénérant	Present
ombrasse	Past
oserai	Future
supervisé	Past
corroder	None
neutralisé	Past
observer	None
confessa	Past
décoincer	None
bifurquassent	Past
enregistrera	Future
réactualisant	Present
repomper	None
télécommandez	Present
viola	Past
élargirait	None
dégrèverais	None
retardait	Past
alléguait	Past
arrivait	Past
taire	None
démotivant	Present
conditionnerait	None
grimacer	None
absorber	None
cers	Present
cunseillera	Future
préludant	Present
singé	Past
subdiviser	None
décrétons	Present
outiller	None
inspireras	Future
blinder	None
espiasse	Past
soupirant	Present
chavira	Past
aidaient	Past
engraissait	Past
conditionneront	Future
retenté	Past
scander	None
ruché	Past
vacciner	None
hérissons	Present
anglicisant	Present
répéter	None
replaçâmes	Past
cataloguer	None
enjolivant	Present
débridait	Past
rockerez	Future
perdrions	None
récupèrerait	None
embellir	None
ressemblaient	Past
torréfier	None
présidait	Past
controversa	Past
redresserait	None
serons	Future
kerre	None
basèrent	Past
tardai	Past
arrosé	Past
estropier	None
contrôlèrent	Past
alambiquasse	Past
paramètrerait	None
enfermer	None
missent	Past
encourut	Past
généralisant	Present
cotisèrent	Past
réserveraient	None
lithographié	Past
réenregistrera	Future
tanna	Past
sollicitaient	Past
attisassent	Past
assainir	None
hachuré	Past
évaporera	Future
rassurai	Past
encrochasses	Past
incorporèrent	Past
termineraient	None
transposera	Future
cavaler	None
essayaient	Past
kidnapper	None
danseront	Future
contiendra	Future
proclamait	Past
écumait	Past
givré	Past
grelottant	Present
retirerais	None
irritant	Present
fonçassiez	Past
fédéralisé	Past
appliquons	Present
migrait	Past
abrasasses	Past
voyagea	Past
invoquait	Past
infligeant	Present
décomposer	None
sones	Present
accueillerons	Future
magnant	Present
encerclait	Past
refluaient	Past
gaspillé	Past
voidant	Present
dépassionné	Past
administré	Past
ossifié	Past
batteraient	None
envisagerais	None
treta	Past
gardons	Present
régalant	Present
radioactivasses	Past
pantoise	Present
posaient	Past
restez	Present
ratatiné	Past
dimensionnant	Present
ombrageant	Present
thermisé	Past
pond	Present
mentionnerons	Future
modéré	Past
fécondé	Past
communiqueraient	None
envahi	Past
gouvernerait	None
déposséda	Past
agissait	Past
épaulant	Present
blasphémer	None
révoltaient	Past
taxant	Present
confirmera	Future
séparera	Future
introduisîmes	Past
appellerais	None
étouffasses	Past
exposait	Past
enchausseraient	None
maintenir	None
paraffinas	Past
hellénisé	Past
valorisant	Present
évadé	Past
dinez	Present
pivotâmes	Past
brassaient	Past
tinté	Past
plastifié	Past
ariserait	None
balancera	Future
énergisaient	Past
desancreras	Future
collaborer	None
taffez	Present
cultivaient	Past
repèreront	Future
colportant	Present
traversait	Past
dérobera	Future
disqualifier	None
poursuivrons	Future
impressionnaient	Past
relancé	Past
rabattu	Past
lamassent	Past
exclamé	Past
faillit	Past
calmait	Past
monteplïe	Present
caractériseront	Future
manœuvrait	Past
surnager	None
parvient	Present
écoutait	Past
gréé	Past
affermissant	Present
rentreront	Future
reformulez	Present
commuter	None
étatisé	Past
implosé	Past
abriant	Present
raineriez	None
limiterait	None
ruminer	None
exerceraient	None
réimmergeassions	Past
affectant	Present
apostilleront	Future
refaisait	Past
réarrangeant	Present
appliqueraient	None
appareiller	None
dallera	Future
talonnant	Present
acheta	Past
vomir	None
présideront	Future
raccompagnait	Past
crisser	None
pataugeant	Present
réapprisse	Past
chuchoter	None
chu	Past
disculper	None
lésiné	Past
suffisait	Past
apportera	Future
voguait	Past
éprend	Present
amenuiser	None
broutant	Present
préviendrai	Future
régularisa	Past
traduisaient	Past
listait	Past
excommunierions	None
entreprend	Present
manigancé	Past
fédéraliser	None
profitez	Present
fertilisé	Past
doper	None
griserions	None
conférèrent	Past
quadrillé	Past
curer	None
détruisit	Past
regagner	None
onduler	None
doutèrent	Past
assigner	None
cajolâtes	Past
feinteraient	None
qualifier	None
lesser	None
consulterait	None
investiraient	None
instituèrent	Past
minez	Present
alez	Present
dédicacé	Past
élevé	Past
risquez	Present
voulez	Present
obérer	None
glissera	Future
nidifieras	Future
plaisantait	Past
alluma	Past
obtiendrai	Future
cocufié	Past
monda	Past
murmuraient	Past
approcher	None
émeut	Present
embarquer	None
récitait	Past
billeterai	Future
peiner	None
assermenter	None
injuriaient	Past
bioaccumuler	None
courbait	Past
conteneurisé	Past
reconfigura	Past
opposait	Past
fussent	Past
fonctionnerait	None
renfrognâmes	Past
mélangèrent	Past
essaies	Present
adoniseriez	None
émancipera	Future
étaleront	Future
ébruiter	None
conclurai	Future
googler	None
existèrent	Past
relia	Past
métisser	None
endigué	Past
encoller	None
permuta	Past
fusai	Past
déséquilibrer	None
déchristianisant	Present
flancher	None
parrainez	Present
tressaient	Past
grouillant	Present
concentreraient	None
entourloupons	Present
tarir	None
casquèrent	Past
émincé	Past
retapé	Past
nit	Present
savourez	Present
rober	None
différenciant	Present
récolter	None
resquillerez	Future
dépulpassions	Past
allait	Past
joindront	Future
désamianter	None
épongeant	Present
ostasmes	Past
personnaliser	None
achètera	Future
espacer	None
ajoutez	Present
reformait	Past
interpellé	Past
bombarderait	None
sema	Past
présagé	Past
resurgira	Future
accabler	None
accélérait	Past
gorgé	Past
blablater	None
penetrerez	Future
évaporant	Present
houas	Past
entrechoquer	None
prédominer	None
sexé	Past
torner	None
combinerait	None
raillé	Past
digéré	Past
remplacèrent	Past
hydraterais	None
loguait	Past
balancer	None
satisfaire	None
entêté	Past
découperaient	None
végétasse	Past
vouer	None
subdivisons	Present
guidèrent	Past
royons	Present
sombrerai	Future
chocolaterait	None
limité	Past
pastiché	Past
rouiller	None
chiffrerait	None
reniflâmes	Past
devenu	Past
frappant	Present
entretenu	Past
esgruneriiez	None
délier	None
sublimant	Present
ankyloser	None
pissier	None
amorcèrent	Past
sévissant	Present
desservi	Past
faindriiez	None
roussirait	None
choisir	None
pèlerinâmes	Past
partitionnâmes	Past
réparant	Present
responsabilisé	Past
supprimer	None
distillant	Present
touchez	Present
déversait	Past
hispanisé	Past
encerclerons	Future
stoppé	Past
spéculait	Past
relayant	Present
injecter	None
colonisera	Future
fournissons	Present
effrayassiez	Past
garé	Past
intuber	None
calera	Future
situerait	None
wais	Present
enthousiasmer	None
débarrassé	Past
détectaient	Past
encartonné	Past
beuglant	Present
rejoua	Past
pédalé	Past
risquer	None
renoué	Past
rendrait	None
repêcher	None
excuserez	Future
consacrez	Present
dénichera	Future
rejoignirent	Past
prévenir	None
expliquaient	Past
ruisselait	Past
spécialisa	Past
protègerait	None
compromettraient	None
édifié	Past
planifier	None
représentait	Past
dilapida	Past
enchéri	Past
endiguer	None
abatis	Past
rebondir	None
écouteras	Future
polygoniserait	None
chalouperaient	None
shampooinas	Past
ascensionna	Past
désigner	None
commérer	None
contrevenaient	Past
ébaucherions	None
abritasses	Past
acclamé	Past
cascadant	Present
cartonner	None
élancé	Past
paralyser	None
planera	Future
acétylâtes	Past
énumérant	Present
égalisant	Present
déclinerait	None
expliquerais	None
identifieraient	None
retombai	Past
monstré	Past
interdiront	Future
dissipèrent	Past
taisait	Past
saboté	Past
commémoré	Past
renoveriiens	None
négligerons	Future
stabilisant	Present
lanternèrent	Past
défibrinez	Present
proporteriiens	None
diffusèrent	Past
attelaient	Past
usaient	Past
solubilisant	Present
masquer	None
natté	Past
proposer	None
regarda	Past
contingenté	Past
exigerais	None
deschaucerons	Future
restreindrait	None
donnassent	Past
préfèrerais	None
copiait	Past
ruinait	Past
retombèrent	Past
enragé	Past
viabiliser	None
intervenir	None
mutant	Present
déshérité	Past
déçoit	Present
profitant	Present
employez	Present
inventer	None
alterneront	Future
retrouverais	None
conversé	Past
blinda	Past
vouchissoiz	Past
poudrer	None
caracoler	None
invitait	Past
rembourrasses	Past
miner	None
mander	None
énumérer	None
désensablaient	Past
retombaient	Past
commercialisassiez	Past
éprouvait	Past
échantillonner	None
demoroit	Past
désignerait	None
aprismera	Future
minimiser	None
fissionnaient	Past
déglaçai	Past
viellerons	Future
brees	Present
bombardèrent	Past
démarrèrent	Past
arrosant	Present
améliorant	Present
ascendit	Past
fausserait	None
recracha	Past
rougi	Past
punir	None
exploserait	None
nettoyait	Past
émaillant	Present
perdre	None
citer	None
fist	Past
fortifiera	Future
tisser	None
retint	Past
initialiser	None
tirasse	Past
condamnerait	None
circula	Past
joignait	Past
resounderiiez	None
preferer	None
accidenter	None
encarté	Past
décentré	Past
pourvoit	Present
retiendrons	Future
nettoyé	Past
acheminèrent	Past
gaufrer	None
hiberné	Past
projetaient	Past
parfumant	Present
lésiner	None
commandité	Past
choper	None
délivrait	Past
contrait	Past
édulcorant	Present
effiler	None
répudiera	Future
penchons	Present
géolocalisé	Past
confondez	Present
lofer	None
engraver	None
tromperons	Future
jurons	Present
enverrais	None
imploser	None
gainant	Present
contiendrait	None
restauraient	Past
contestaient	Past
étayer	None
calquer	None
kier	Present
assenant	Present
tenteront	Future
remettant	Present
refuserait	None
surpassa	Past
décidons	Present
défendrait	None
germera	Future
interagissant	Present
retoucha	Past
révolteront	Future
digérer	None
avalasse	Past
réactiva	Past
roda	Past
hissaient	Past
décida	Past
lemmatiserions	None
disputèrent	Past
englobaient	Past
demanderont	Future
recentré	Past
vaincre	None
consacrerai	Future
encouraient	Past
demeurât	Past
patinant	Present
débattaient	Past
intentant	Present
amélioreront	Future
trépaner	None
syndiqueraient	None
discernait	Past
connaitriez	None
grondait	Past
puisèrent	Past
octroyant	Present
désarmèrent	Past
mesura	Past
écrivant	Present
caviarder	None
permît	Past
herborisât	Past
chanter	None
raffermir	None
obligeât	Past
peignâmes	Past
rachèteront	Future
irait	None
gèrera	Future
reformera	Future
endurci	Past
essayer	None
recherché	Past
formatâmes	Past
errait	Past
émulsionner	None
defines	Present
dérobassions	Past
maltraité	Past
valider	None
remplaçât	Past
appuierais	None
disputer	None
chronométrant	Present
installèrent	Past
tâchera	Future
composèrent	Past
soula	Past
informons	Present
vêtir	None
abêtir	None
effeuillé	Past
aggrava	Past
effectuer	None
contournera	Future
localisé	Past
recherchera	Future
endormi	Past
allâmes	Past
télégraphier	None
désespérer	None
annexant	Present
adresserais	None
aventurerait	None
remouilleriez	None
aduler	None
réfrigérer	None
jura	Past
osciller	None
visons	Present
prélasser	None
cimenté	Past
claustra	Past
automutiler	None
polycopiait	Past
guérissant	Present
travaillerai	Future
tigreras	Future
improvisèrent	Past
suivre	None
couinant	Present
contreras	Future
esclairasmes	Past
libellé	Past
corser	None
expliciterions	None
réprimé	Past
couvrant	Present
laquer	None
masterisé	Past
démettre	None
laminer	None
rejoindrons	Future
libéraliser	None
boira	Future
flattant	Present
achopperai	Future
ratatiner	None
courouchierai	Future
politisé	Past
démentira	Future
calasses	Past
brulaient	Past
araisnastes	Past
compilait	Past
oralisasse	Past
divorcer	None
prévisualisassent	Past
alier	None
antresavons	Present
enculer	None
reparlerons	Future
iectas	Past
capitula	Past
redescendu	Past
élit	Present
profanas	Past
buter	None
reformulerais	None
situait	Past
ajustait	Past
recompter	None
flotteront	Future
demonstrant	Present
rigolons	Present
phantastiquât	Past
interdisant	Present
barricadant	Present
perdurerons	Future
regroupant	Present
exécré	Past
explorait	Past
retransférer	None
suivriez	None
supposant	Present
waster	None
architecturerait	None
sucer	None
répètera	Future
décrurent	Past
privilégieront	Future
développera	Future
remémora	Past
suffiraient	None
accoster	None
chavirer	None
bres	Present
rappelât	Past
rencontrerait	None
inviter	None
irritait	Past
armorié	Past
reclassé	Past
détendu	Past
commencerons	Future
élargir	None
affluaient	Past
institutionnaliser	None
quêter	None
contrebalancer	None
pasissons	Past
terraient	Past
défendront	Future
subsumer	None
défouler	None
ravir	None
vivras	Future
déchanter	None
recevoir	None
amusera	Future
questionnait	Past
constateras	Future
catalogua	Past
étrangleriez	None
tartiner	None
songeaient	Past
antras	Past
empêcheraient	None
fronda	Past
décrétèrent	Past
meublé	Past
bastonné	Past
sangloter	None
carait	Past
brillait	Past
incinérant	Present
baratineraient	None
fourrer	None
renseignera	Future
recrutaient	Past
refermerait	None
concrétisèrent	Past
avantagea	Past
lutteront	Future
recrachant	Present
bêtifiai	Past
initialisé	Past
terrifiant	Present
relever	None
tuerais	None
dégazé	Past
sanctuarisant	Present
rééditera	Future
honorer	None
traversez	Present
surévaluer	None
merchandisa	Past
réactivera	Future
vaincrait	None
alambiqueraient	None
couchait	Past
persécutaient	Past
charmant	Present
liquidez	Present
crayonner	None
abrité	Past
cicatrisïeroit	None
esmaiasse	Past
enchaînas	Past
électrifiant	Present
épouserai	Future
localisera	Future
hélant	Present
enquiquinerons	Future
précipiter	None
vendrait	None
communieront	Future
sodomiser	None
inspirèrent	Past
remilitariser	None
moissonner	None
approchait	Past
déconcentrer	None
entraineront	Future
écrira	Future
convertiront	Future
retournerais	None
résulté	Past
témoignèrent	Past
clarifier	None
épicer	None
jetons	Present
paradant	Present
enflerions	None
stagnât	Past
balbutiant	Present
voide	Present
leurrer	None
inquiétait	Past
soulèveraient	None
respiraient	Past
réfléchir	None
persiflassions	Past
martelait	Past
donna	Past
carger	None
clignant	Present
griffassiez	Past
ennuyait	Past
euthanasié	Past
observerez	Future
déstructurer	None
enrober	None
mentez	Present
ensanglantaient	Past
naissant	Present
phosphoryler	None
prévoira	Future
léchant	Present
rétracta	Past
nions	Present
normas	Past
espundriiez	None
crevait	Past
viserait	None
renvoyer	None
escroquer	None
rationnerions	None
satura	Past
occidentaliserait	None
tercez	Present
contresigneront	Future
zingué	Past
persisteront	Future
déchiffrait	Past
rabattit	Past
démerder	None
désagrégeaient	Past
récompensé	Past
devinrent	Past
industrialisa	Past
suggérèrent	Past
considérons	Present
grammaticalisassent	Past
tacherais	None
houspiller	None
subodoré	Past
ralentir	None
soldait	Past
catastrophé	Past
découpâmes	Past
paincteroies	None
saupoudrer	None
puisant	Present
factura	Past
trimbaler	None
débordait	Past
hocher	None
consacraient	Past
empirèrent	Past
désistant	Present
boitait	Past
encouragez	Present
utiliseras	Future
pépiez	Present
remettrait	None
intensifié	Past
tenterons	Future
déboucherait	None
renfermera	Future
gazéifier	None
préviendrait	None
brisâtes	Past
abondant	Present
ancré	Past
cirasse	Past
progressa	Past
retinrent	Past
fournissait	Past
putrifier	None
progresseriez	None
désossé	Past
dénié	Past
redévelopper	None
huchier	None
masquaient	Past
denunceroient	None
désarçonnant	Present
procédaient	Past
antrespargnier	None
desarmasmes	Past
impugneriez	None
sponsorisera	Future
oublieront	Future
shootant	Present
promut	Past
réhausser	None
luxons	Present
émergerait	None
cliver	None
ignora	Past
minuta	Past
rétrécira	Future
intoxiquer	None
fortifier	None
embarrassait	Past
loupant	Present
goutant	Present
requit	Past
merda	Past
redonnait	Past
golferaient	None
abandonnez	Present
copierez	Future
composé	Past
avérait	Past
reprendrais	None
tortillons	Present
comptabilisait	Past
bonifiant	Present
secourussiez	Past
baraquera	Future
pénalisassiez	Past
examina	Past
consister	None
allouer	None
consoliderons	Future
dégarni	Past
jaunissant	Present
oré	Past
engloutir	None
entamera	Future
documenteras	Future
flaquèrent	Past
empierrer	None
promettrait	None
foiré	Past
comprendrais	None
troubler	None
écoutez	Present
défendons	Present
misses	Past
percez	Present
trimbalai	Past
bouleversé	Past
doutaient	Past
présenteraient	None
funda	Past
prononcer	None
sédimentez	Present
donnerait	None
prêtant	Present
résumé	Past
saturait	Past
semer	None
levant	Present
fugué	Past
trompera	Future
différant	Present
mincirions	None
embastiller	None
permettraient	None
instaurera	Future
alïeriiez	None
emménagé	Past
débutant	Present
paines	Present
consommerait	None
clairons	Present
arrivât	Past
carbonitrureriez	None
infligera	Future
rentrerai	Future
musiquerai	Future
apposez	Present
chevauchast	Past
pixellisaient	Past
fêtait	Past
contenu	Past
visas	Past
corroborer	None
récompenserait	None
excellé	Past
enlèverai	Future
exemptant	Present
chambouler	None
prospéra	Past
éclatasses	Past
ardoisasses	Past
sondant	Present
surédifiaient	Past
formaliser	None
frôla	Past
canna	Past
dounroies	None
irriguer	None
trifouiller	None
peuplait	Past
moisir	None
libéraient	Past
répliquer	None
ansant	Present
perchai	Past
suives	Present
coster	None
inquiété	Past
arretons	Present
incitèrent	Past
aberrant	Present
cousu	Past
applaudiras	Future
restitué	Past
massons	Present
chiant	Present
subvient	Present
affinas	Past
ligaturé	Past
grimpera	Future
abrévié	Past
stigmatisé	Past
confisquer	None
braser	None
consommer	None
mordiller	None
pilleroies	None
cité	Past
saxophonâtes	Past
dévasteraient	None
reconnaitre	None
marchaient	Past
tractait	Past
sacra	Past
vagi	Past
encager	None
attestaient	Past
amoché	Past
especuleroie	None
romanisâmes	Past
mangier	None
stimulerait	None
opprimaient	Past
jurerais	None
eschaldant	Present
reposaient	Past
bornerait	None
allumant	Present
ozona	Past
supputer	None
immolé	Past
produisirent	Past
amorcer	None
capons	Present
lover	None
posant	Present
retouchera	Future
ligaturer	None
extraire	None
entrerons	Future
œuvrèrent	Past
voté	Past
dénier	None
plané	Past
emmèneraient	None
socorroient	None
enchaînera	Future
intervenu	Past
réserverais	None
impliqueriez	None
situé	Past
réverbèreras	Future
encaissé	Past
ramasser	None
fureté	Past
disloquèrent	Past
déposer	None
essoignerons	Future
enlisant	Present
condamné	Past
imputaient	Past
colligeassions	Past
complèterai	Future
tarifé	Past
prometiiez	Past
redessiner	None
épousseter	None
réentonnerons	Future
truffer	None
produisait	Past
darda	Past
simulé	Past
hydrogénas	Past
enlever	None
conjecturant	Present
empoisonna	Past
jardiner	None
exila	Past
ergoter	None
rampait	Past
ignoreront	Future
bourgeonnasses	Past
exploraient	Past
exprimer	None
perdrez	Future
gagnerais	None
administra	Past
soupçonnant	Present
rapiécer	None
parfaire	None
témoigné	Past
attendrons	Future
inscrivait	Past
réouvrant	Present
plièrent	Past
rêvasser	None
requérir	None
figerait	None
réinstaller	None
embarquaient	Past
rens	Present
huant	Present
participerait	None
peiné	Past
alerté	Past
demeneroie	None
confrontera	Future
recevrais	None
récoltèrent	Past
pénalisait	Past
dissipé	Past
repêcha	Past
ausculté	Past
prêtez	Present
amortissons	Present
estimait	Past
excepté	Past
refermant	Present
transposerez	Future
résidait	Past
cerner	None
peinerait	None
assombri	Past
dérouler	None
dépendre	None
entama	Past
rempiler	None
nourrirait	None
entrebâilleriez	None
perturbera	Future
briguer	None
mundiferoit	None
rebaptisera	Future
refuser	None
écroulerait	None
éperdu	Past
entrerez	Future
entourlouperaient	None
suivait	Past
cafter	None
assolant	Present
avéra	Past
intellectualisez	Present
mellasses	Past
incarneront	Future
réifié	Past
spécialisera	Future
interpeler	None
engraisser	None
jazzer	None
biner	None
garantirait	None
exhortèrent	Past
ascendant	Present
transiger	None
altereroit	None
posons	Present
tronçonnez	Present
saoulant	Present
assumaient	Past
bâillera	Future
dépucelé	Past
effriter	None
alternera	Future
impulsera	Future
profaner	None
couchez	Present
privas	Past
opposera	Future
grandirent	Past
vinifié	Past
battraient	None
vidanger	None
prodiguera	Future
tentant	Present
embouché	Past
cognerait	None
progressait	Past
intéressez	Present
ânonner	None
garnir	None
permutasse	Past
cessèrent	Past
réinjecterai	Future
bombarda	Past
cautionnant	Present
s’ingénieront	Future
sacrifiasses	Past
restituaient	Past
escrisis	Past
rompu	Past
suffi	Past
goua	Past
redéposait	Past
syndiquer	None
conveioies	Past
inhumèrent	Past
jouxtant	Present
lèvera	Future
récompensait	Past
marginalisé	Past
appétassent	Past
crit	Present
implantera	Future
écartera	Future
rencontrons	Present
haché	Past
émergèrent	Past
ressentiraient	None
précipiterait	None
het	Present
rassemblera	Future
blasonner	None
effondré	Past
endossèrent	Past
retournèrent	Past
coûter	None
défiai	Past
dépollué	Past
miser	None
oppressassiez	Past
ajoz	Present
écarquiller	None
poursuivi	Past
apatissez	Present
mouliné	Past
déceler	None
bivouaquer	None
proclameront	Future
dorlotassions	Past
consent	Present
étudions	Present
conduisaient	Past
essartez	Present
découlant	Present
présager	None
compétai	Past
hibernâtes	Past
poivrer	None
dépérir	None
jalousait	Past
justifiez	Present
proporteroie	None
renseignaient	Past
commanderai	Future
remastérisé	Past
pionnerions	None
périssait	Past
volaient	Past
conjurant	Present
inséminera	Future
puet	Present
humanisé	Past
décodant	Present
arrivai	Past
lamper	None
retournera	Future
parapher	None
reconditionnerions	None
entonneront	Future
pista	Past
repensant	Present
vaporiserons	Future
destiner	None
subjuguant	Present
commencer	None
jugèrent	Past
galvaudé	Past
reherserai	Future
pilant	Present
réapparaitre	None
achates	Present
voudraient	None
estre	None
réinstaurer	None
explicitons	Present
exacerber	None
fidéliserai	Future
réinterpréter	None
dévaluai	Past
fomenter	None
confortait	Past
interagiront	Future
initiera	Future
enjoignirent	Past
appellant	Present
épluchant	Present
scolarisant	Present
mixer	None
fixa	Past
combiné	Past
haletassiez	Past
recommandons	Present
allégeait	Past
débouchera	Future
cultivé	Past
réajouter	None
dinguerais	None
délogèrent	Past
brandira	Future
paralysant	Present
immobilisèrent	Past
propagèrent	Past
pochoit	Past
narrait	Past
éditorialisez	Present
amnistia	Past
retiendraient	None
paumeriez	None
démembré	Past
remanié	Past
achaz	Present
polir	None
aboivreroie	None
chercherai	Future
comprirent	Past
déclassifié	Past
arpégé	Past
remballer	None
rançonnèrent	Past
enveloppèrent	Past
résidé	Past
fondissiez	Past
valoriserait	None
débarquait	Past
légalisa	Past
médiatisons	Present
dévirginiseriez	None
souciaient	Past
tourmentaient	Past
fraiser	None
frequenz	Present
arrivera	Future
sinisa	Past
poncer	None
mentait	Past
combattre	None
dusse	Past
impacta	Past
agrémenta	Past
plaindrait	None
prélevaient	Past
moucheté	Past
reconstruisant	Present
regrettez	Present
équiperait	None
carda	Past
soustrayait	Past
urbaniser	None
transplanté	Past
empocheront	Future
retrousser	None
étrillèrent	Past
sciez	Present
evacut	Present
pourchasserions	None
formera	Future
concernerait	None
platiné	Past
maigrir	None
engloutissant	Present
intoxiquerait	None
rétrograder	None
infléchir	None
surveillez	Present
liquidera	Future
mâcher	None
connoté	Past
tapisseriez	None
multiprogrammerez	Future
temporiser	None
devancer	None
comparaient	Past
enquit	Past
inventait	Past
accomplirent	Past
deportai	Past
sautait	Past
rougir	None
vengerai	Future
coaguler	None
kiffer	None
débarasser	None
catcha	Past
dégivrerait	None
reculons	Present
viabilisé	Past
abrita	Past
turner	None
regeteriiez	None
toiletter	None
désincarcérâmes	Past
presser	None
adjurant	Present
autogèreraient	None
aveuglant	Present
déclarera	Future
glissa	Past
éditer	None
lâchera	Future
désapprouverait	None
accréditer	None
accroitriez	None
octroiera	Future
exploitant	Present
creistreies	None
éviteraient	None
assura	Past
improviser	None
partons	Present
peinaient	Past
nuancer	None
enoinstrent	Past
esquissait	Past
planai	Past
asproiast	Past
échoir	None
correspond	Present
souciez	Present
annulèrent	Past
explicitant	Present
supprimerait	None
chargeons	Present
t'adors	Present
enfoncer	None
démontrera	Future
fallut	Past
interfacer	None
contrefaisant	Present
dénoterait	None
renouer	None
meuler	None
parçonassent	Past
réceptionnait	Past
publiant	Present
solenniseriez	None
garderas	Future
déniaiser	None
mitigé	Past
èchera	Future
affaissa	Past
violeraient	None
jaillissant	Present
diligenter	None
dégager	None
cadrait	Past
tiraillé	Past
agirent	Past
adhèrera	Future
froissant	Present
cintré	Past
réhabituer	None
suborner	None
adopterai	Future
revisita	Past
décélérant	Present
recèlerait	None
changerons	Future
frôler	None
valoriser	None
refilant	Present
déménageaient	Past
cumuler	None
ployer	None
signifier	None
admirait	Past
exhibant	Present
adhéré	Past
anéanti	Past
nitrifierait	None
reverriez	None
dénivèlerait	None
commercialisèrent	Past
videra	Future
fanatisé	Past
marcheraient	None
bistouilleriez	None
concocter	None
figureraient	None
lobas	Past
joast	Past
donnez	Present
encourageons	Present
quitteraient	None
pivoter	None
sentes	Present
déguisaient	Past
relire	None
énuméré	Past
luttas	Past
essayerai	Future
informerais	None
réélu	Past
déchargea	Past
proviendront	Future
diviserait	None
compénétrons	Present
disnasse	Past
achèterais	None
époustouflant	Present
catégoriserait	None
medecines	Present
jugulant	Present
dressèrent	Past
grisonnant	Present
cillerait	None
réussiraient	None
valorisé	Past
manquez	Present
pédalerait	None
acate	Present
poliça	Past
aller	None
fusillant	Present
armasses	Past
amplifiassions	Past
topographia	Past
paint	Present
interpénétrer	None
raréfié	Past
rapporter	None
exposeraient	None
frouillassiez	Past
apitoyer	None
reparlerai	Future
abandonnèrent	Past
choppassent	Past
ocra	Past
extrapoler	None
dédramatisera	Future
préexistaient	Past
adopteraient	None
correspondaient	Past
réconforter	None
gueulé	Past
blâmez	Present
priera	Future
conserveraient	None
hosta	Past
prospectant	Present
relevât	Past
grognons	Present
abstenant	Present
rinçant	Present
punirait	None
vastes	Present
enterraient	Past
escortera	Future
emboutassions	Past
mutai	Past
triompherait	None
crapa	Past
valorisa	Past
surmonter	None
placent	Present
hypnotisa	Past
réajusté	Past
dévisagerait	None
réussir	None
foulait	Past
recovreras	Future
outrepasser	None
nombreroit	None
canz	Present
præmunirait	None
atucha	Past
orent	Past
assiégea	Past
décoré	Past
tisonnerions	None
craindraient	None
budgétisassiez	Past
rebattu	Past
médire	None
transigeons	Present
blanchirai	Future
recherchons	Present
resoundastes	Past
déclarer	None
surfa	Past
chauler	None
sursaturé	Past
arborâtes	Past
domineraient	None
vernissé	Past
empester	None
repérer	None
prononcez	Present
centras	Past
chercheraient	None
purpenserai	Future
améliorez	Present
émasculer	None
retoucherions	None
déformait	Past
grea	Past
revenez	Present
préparaient	Past
accompagner	None
prédire	None
terminant	Present
reculas	Past
dissimulaient	Past
développerai	Future
cert	Present
tonsurer	None
mercyerai	Future
francisa	Past
explorant	Present
dépassèrent	Past
controversons	Present
vexant	Present
fâchez	Present
débaucha	Past
démordra	Future
empresser	None
harponné	Past
calma	Past
désespérez	Present
déposant	Present
prestoit	Past
quicherais	None
signait	Past
foudroieriez	None
massacraient	Past
sculptant	Present
oraliseriez	None
poseront	Future
déplaçons	Present
appartenaient	Past
utiliserai	Future
quintupler	None
surévaluât	Past
retardaient	Past
toussait	Past
médisez	Present
relisons	Present
jonglant	Present
ancra	Past
assuraient	Past
mutiler	None
guia	Past
agrégèrent	Past
bleutai	Past
énucléerais	None
réceptionna	Past
représenter	None
solliciter	None
commué	Past
calfeutré	Past
daigna	Past
décommunisassent	Past
effritant	Present
roelas	Past
écrabouiller	None
sectionneriez	None
glousser	None
rationner	None
friserions	None
jouissez	Present
professa	Past
maîtrisai	Past
suffiront	Future
végéta	Past
emprisonnera	Future
déculpabiliser	None
aspirait	Past
souper	None
raflé	Past
suspendit	Past
busses	Past
externalisèrent	Past
serpentèrent	Past
saouler	None
adoucissait	Past
regardaient	Past
triomphé	Past
exhibait	Past
rééquiper	None
nécessitera	Future
perfectionné	Past
entourer	None
attendant	Present
germa	Past
devourerent	Past
esveillassiez	Past
débusquant	Present
attardera	Future
licitâmes	Past
paradoxerai	Future
manœuvrassiez	Past
appréhender	None
parfissent	Past
intuberait	None
relâchant	Present
granulé	Past
secondé	Past
seina	Past
ravalerais	None
vielé	Past
présenta	Past
séjournant	Present
armerait	None
bullant	Present
traînera	Future
volait	Past
buer	None
exempter	None
défléchirait	None
rehaussant	Present
redressé	Past
constituant	Present
déchirons	Present
confirmerait	None
interprétez	Present
alcooliser	None
attardant	Present
récapitulé	Past
surajouter	None
réprimèrent	Past
veuillent	Present
enchevêtrassiez	Past
praeparasmes	Past
soutirant	Present
apparentant	Present
conservait	Past
minoré	Past
coinçant	Present
égrenant	Present
couvenir	None
pâti	Past
collectaient	Past
perdurait	Past
chuta	Past
attestant	Present
entrechoquant	Present
déséquilibrant	Present
mariera	Future
regnier	None
doser	None
interloquer	None
resignerais	None
éparpillant	Present
secouassions	Past
spécifiassent	Past
comptera	Future
symbolisera	Future
hydrogéner	None
réémissions	Past
visa	Past
atteindraient	None
montrera	Future
exprimeraient	None
regrimper	None
remercié	Past
vaironnerait	None
grinçant	Present
recolonisé	Past
administrer	None
drapé	Past
laisseriez	None
calligraphier	None
suppléant	Present
descendez	Present
navigué	Past
balisant	Present
catalyseraient	None
aviliriez	None
exhalai	Past
guerroyaient	Past
esgratignerons	Future
affermer	None
redynamisèrent	Past
pardonnez	Present
patienta	Past
consyderer	None
inférant	Present
éduquer	None
inventorier	None
repassez	Present
brayer	None
soudait	Past
t’ensauvas	Past
réactualiser	None
gouré	Past
conserverait	None
influer	None
échangerait	None
ridiculiser	None
gréa	Past
appauvrir	None
bazardé	Past
trampas	Past
rétractant	Present
anus	Present
exclu	Past
déroutera	Future
choya	Past
affranchirent	Past
invalidait	Past
décontenancer	None
concèdera	Future
lévitant	Present
élevant	Present
redoublant	Present
reignier	None
égorgeait	Past
serrant	Present
faucha	Past
distribuer	None
déploraient	Past
titubant	Present
aviserait	None
accueilleraient	None
revendiqua	Past
entériner	None
mandera	Future
confessaient	Past
séjourner	None
découper	None
rouillé	Past
truffa	Past
entreraient	None
classant	Present
aspiraient	Past
égaliseras	Future
plaisant	Present
dictèrent	Past
tyrer	None
débattre	None
propagé	Past
sinisant	Present
désinstallé	Past
inscrire	None
contesteraient	None
dénigrait	Past
dépassionner	None
réduisez	Present
replantèrent	Past
postuler	None
empêcherait	None
installait	Past
effectuez	Present
privilégions	Present
effoirassions	Past
reproduiront	Future
croustillons	Present
prolongeons	Present
aidier	None
connoter	None
intrigua	Past
aiant	Present
rebondissait	Past
pressentit	Past
référant	Present
recomposé	Past
décalqué	Past
coiffant	Present
remboursant	Present
rencontrait	Past
zappant	Present
parallélisé	Past
ruer	None
parodiaient	Past
retardant	Present
laboureront	Future
bougerait	None
muni	Past
persévérant	Present
affichant	Present
défend	Present
crawler	None
complotait	Past
actionna	Past
gaba	Past
ciseler	None
achèvera	Future
attacha	Past
engloberai	Future
masserait	None
versa	Past
gascher	None
provoquerez	Future
prémunissant	Present
terrassé	Past
fracasseras	Future
redeviendra	Future
resserré	Past
oscilleront	Future
marmonner	None
aourissons	Past
règlementait	Past
intimidaient	Past
tonna	Past
rissoler	None
radiopasteurisassent	Past
pasa	Past
sabra	Past
réhydraté	Past
récompensera	Future
séjournait	Past
replaça	Past
délivrer	None
escortaient	Past
numériser	None
désola	Past
embarrassant	Present
adjoignirent	Past
remarquons	Present
convergeraient	None
reparaître	None
entreprenant	Present
bouillonnant	Present
sortiras	Future
attribuez	Present
soutenons	Present
cassez	Present
désengageant	Present
boulant	Present
segonder	None
détremper	None
jetterait	None
munira	Future
refusionner	None
approvisionné	Past
arboraient	Past
allongeaient	Past
appuyé	Past
repete	Present
paraphraser	None
resistant	Present
encaserné	Past
chloré	Past
départager	None
renverser	None
bigarré	Past
tripotassent	Past
annexer	None
plierai	Future
sollicitera	Future
interprétons	Present
indemnisassions	Past
suscitaient	Past
gasteroit	None
empiegerons	Future
combler	None
dateraient	None
cimenter	None
succèdera	Future
lésinant	Present
abouté	Past
réioniseras	Future
terrassons	Present
assaillir	None
anseriez	None
scella	Past
cirer	None
buvons	Present
insistant	Present
présageaient	Past
insufflé	Past
enchevêtrerions	None
tabula	Past
sédentarisant	Present
choisiront	Future
évasez	Present
attend	Present
reparlera	Future
rot	Past
clore	None
divisera	Future
connaitrais	None
recadré	Past
rejetait	Past
vendez	Present
modulé	Past
flori	Past
osez	Present
pourmenerois	None
dispersa	Past
fissurer	None
recruté	Past
restituera	Future
dépérissant	Present
délogera	Future
tiquer	None
inféodant	Present
percolant	Present
classé	Past
labourons	Present
inspecter	None
délocalisant	Present
soulignaient	Past
gauja	Past
embrasserait	None
fournirait	None
dilater	None
réécrivez	Present
soulagea	Past
incomberait	None
arraisonné	Past
nonces	Present
défaisait	Past
boycotteraient	None
demorai	Past
importaient	Past
dévoilant	Present
étudier	None
déconfirez	Future
délibéré	Past
rattraperions	None
peuplaient	Past
animait	Past
graduaient	Past
décillant	Present
lancerait	None
interner	None
abonnissez	Present
conduisait	Past
côtoiera	Future
grossirent	Past
récusera	Future
pactiser	None
supervisant	Present
finaliser	None
copions	Present
envouté	Past
comptèrent	Past
associer	None
planteront	Future
communier	None
draonclerai	Future
rallumant	Present
enrôlassions	Past
contrevenait	Past
chantonnant	Present
anticiper	None
gauda	Past
défolié	Past
eûtes	Past
redécouvert	Past
resserrant	Present
dégoutant	Present
estaing	Present
parvenons	Present
collectionnera	Future
escoffiai	Past
emboîta	Past
gênèrent	Past
duta	Past
gyrerais	None
artificialisé	Past
préoccupé	Past
curuneriiens	None
rebaptiserons	Future
crawleras	Future
islamisant	Present
subdiviserait	None
representer	None
affaibli	Past
égaliser	None
durera	Future
comparaitrai	Future
antendistes	Past
infectaient	Past
trônait	Past
peuplerait	None
consumer	None
transita	Past
eriter	None
aparellasses	Past
prætendu	Past
limogé	Past
étoffer	None
irradier	None
suas	Past
relativisant	Present
abimassiez	Past
pasteuriserons	Future
demandât	Past
déclineront	Future
reconnecter	None
chômer	None
recréerai	Future
dégraissé	Past
aventurait	Past
moudre	None
requinquer	None
griffé	Past
pikes	Present
rene	Present
antéposait	Past
tabustant	Present
barattez	Present
comblèrent	Past
proliférèrent	Past
detranprissoiz	Past
livrer	None
réussît	Past
saveurs	Present
catéchiser	None
candi	Past
exposerait	None
retracé	Past
excellera	Future
déconnectai	Past
diffusons	Present
transmissions	Past
panaché	Past
prédisait	Past
encorné	Past
minimisassions	Past
coller	None
réunir	None
opina	Past
intitulasses	Past
divergeaient	Past
aidez	Present
descendrais	None
ravagerait	None
martelé	Past
élancèrent	Past
afficher	None
balaya	Past
motivons	Present
existant	Present
candidatas	Past
instaurèrent	Past
saccageaient	Past
becquèrent	Past
boycotteront	Future
enmureroie	None
chopé	Past
attirèrent	Past
récuserais	None
estiva	Past
raviverions	None
déshabillant	Present
incliné	Past
disposant	Present
communicquassent	Past
chiquer	None
codait	Past
frire	None
versons	Present
prénommera	Future
aguerrit	Past
ensuivraient	None
décevoir	None
torsadé	Past
penché	Past
vacillasse	Past
rebiffa	Past
bistré	Past
appellerions	None
colorant	Present
angariai	Past
indemnisé	Past
refuserions	None
échapperait	None
retirait	Past
pressurisé	Past
exonéré	Past
soudoyant	Present
distordait	Past
apostèrent	Past
arborait	Past
défendrais	None
vendît	Past
emportèrent	Past
formait	Past
diligenteriez	None
présiderait	None
affadi	Past
gambadant	Present
décrira	Future
dégommèrent	Past
tabler	None
courtisant	Present
apparaissaient	Past
ondoyassions	Past
droguer	None
mixera	Future
écorcher	None
ouillé	Past
translittérer	None
argumentant	Present
terminerait	None
bouclant	Present
pratiquons	Present
aviserons	Future
incendiait	Past
maximaliser	None
ensanglanta	Past
reculait	Past
stockera	Future
provoquait	Past
encrant	Present
rechigné	Past
transfusera	Future
correspondait	Past
injurier	None
miras	Past
introduisez	Present
vibrant	Present
diffusez	Present
canalisèrent	Past
commander	None
rediriger	None
déléguer	None
estomaquât	Past
traçant	Present
rempailleront	Future
segmentâmes	Past
réaliseront	Future
rafistoler	None
abaubirai	Future
acclama	Past
mériterait	None
plongerait	None
perforer	None
crénelerons	Future
avitaillerai	Future
accréditait	Past
gratifia	Past
agrémenteront	Future
agiriez	None
relevèrent	Past
installeront	Future
encommençassiez	Past
lacer	None
flatta	Past
reconduire	None
excitons	Present
décrypta	Past
exalter	None
sentît	Past
supputé	Past
interromprait	None
cocufia	Past
introduisît	Past
ensuivre	None
morussons	Past
effronterai	Future
étirait	Past
engajoit	Past
escorcheroies	None
expertisé	Past
inverseriez	None
attester	None
éduqué	Past
reconnaîtrez	Future
obtiendrais	None
cantonner	None
revécussiez	Past
serviraient	None
dégringolèrent	Past
battirent	Past
décompter	None
clôtura	Past
cez	Present
spiraler	None
reprocherait	None
tuaient	Past
autoproclama	Past
apprécierais	None
enfourcher	None
trançasses	Past
accourant	Present
reviendrai	Future
mentionner	None
réélire	None
parcourra	Future
tempêter	None
meugleras	Future
pérennisera	Future
régulant	Present
enfumer	None
époussetassent	Past
repeuplaient	Past
tirèrent	Past
encontrerent	Past
rançonnant	Present
titiller	None
truquer	None
tarissaient	Past
rétractait	Past
broz	Present
accusera	Future
disposeront	Future
remontez	Present
endimancherais	None
choisissait	Past
harasser	None
totalisassions	Past
promulgué	Past
singulariseras	Future
calfaté	Past
traînaient	Past
décalaminer	None
couvoitoies	Past
férierons	Future
tentons	Present
augmenterai	Future
déchiffré	Past
attribuons	Present
écrasant	Present
postulait	Past
siérait	None
camas	Past
opérèrent	Past
proliférant	Present
pacifier	None
signèrent	Past
clonas	Past
bâcher	None
raya	Past
élucidant	Present
empêchez	Present
dessaler	None
regrettait	Past
chaparder	None
attaquerait	None
parrainas	Past
procurera	Future
mortifier	None
exhumer	None
falsifia	Past
déchaussant	Present
parçonnera	Future
enflammant	Present
plantèrent	Past
féminisant	Present
biseauté	Past
caractérisait	Past
puis	Present
prodigua	Past
andoctrineroies	None
fonctionneraient	None
constatant	Present
démenait	Past
précisez	Present
rompre	None
pressenti	Past
aimerais	None
décolorer	None
restreindre	None
estimerait	None
feintant	Present
fourvoyé	Past
entreprît	Past
retisser	None
désamorçant	Present
ancrera	Future
orbitait	Past
perler	None
scandalisant	Present
præsenteriez	None
formerait	None
transcrivit	Past
esgareroit	None
hypnotisant	Present
décommandé	Past
traita	Past
professionnalisassions	Past
engueulant	Present
tâter	None
réagirais	None
benzoylassions	Past
entachera	Future
fuité	Past
dépasser	None
élèverait	None
swingueras	Future
retoqueriez	None
rouât	Past
rationaliser	None
singularisé	Past
absconsasse	Past
chapeauter	None
bafouer	None
emmagasiner	None
inversait	Past
cunreïiens	Past
intériorisant	Present
apprendre	None
boucla	Past
perforé	Past
candidater	None
comparé	Past
iurassions	Past
alerent	Past
mapper	None
conta	Past
vu	Past
externaliseront	Future
complimenté	Past
conféré	Past
diffuser	None
condescendant	Present
génuflexerons	Future
déroberions	None
essayerait	None
ôtons	Present
anticipé	Past
évita	Past
élaboré	Past
boulangeas	Past
conduire	None
effectueraient	None
rivaliserait	None
lavons	Present
moula	Past
enfreignant	Present
limitèrent	Past
restructurant	Present
réformait	Past
ruminant	Present
culpabilisèrent	Past
dévoilait	Past
dispatché	Past
omissions	Past
désespéra	Past
achoppé	Past
perfectionna	Past
dormir	None
mesurons	Present
exerceront	Future
nuancé	Past
taxaient	Past
férier	None
évoqueraient	None
alarmant	Present
égalèrent	Past
mélangeront	Future
admiré	Past
préparons	Present
rencontrerez	Future
rétorquant	Present
pédaler	None
alléguer	None
surchargeant	Present
déclasser	None
singler	None
vernirez	Future
décalera	Future
diamanter	None
démené	Past
apercevrait	None
abstiendrai	Future
discuta	Past
cherroit	None
demourer	None
azura	Past
déchireront	Future
dilapidé	Past
dépeignaient	Past
reflèteraient	None
accumulait	Past
bué	Past
invectivant	Present
apportant	Present
exclama	Past
enflasses	Past
consistèrent	Past
skier	None
toilerait	None
recourbant	Present
pontifiait	Past
assommé	Past
penchaient	Past
volerai	Future
galvauder	None
imperméabiliser	None
exemptait	Past
faussant	Present
stéréotypons	Present
guéer	None
fredonné	Past
manigancerez	Future
attaquant	Present
emmènerai	Future
convaincre	None
calibrer	None
cuvrissoiz	Past
émettaient	Past
inféoder	None
fixèrent	Past
démembrer	None
débardasse	Past
laisserais	None
bidouiller	None
insupportera	Future
toiser	None
dédier	None
enchainer	None
apprendrais	None
incitaient	Past
compactant	Present
aumosneront	Future
bémolisassions	Past
misait	Past
engageraient	None
prétextaient	Past
évangélisaient	Past
repiaulâtes	Past
territorialisé	Past
harmonisé	Past
appâté	Past
tourmenté	Past
sponsoriser	None
biffer	None
téléphoné	Past
surchargerait	None
maitrisé	Past
affectaient	Past
éjectas	Past
confrontant	Present
sautillé	Past
proposeront	Future
prépayé	Past
surpassèrent	Past
clivant	Present
dressa	Past
défroissaient	Past
concerter	None
aiguillons	Present
beneïroient	None
postulant	Present
obtempérer	None
contrebattre	None
témoignerez	Future
ébrasé	Past
accumuleront	Future
transmettons	Present
discrétiser	None
préoccupant	Present
siu	Present
conformant	Present
écrémons	Present
dégradait	Past
frangez	Present
relevaient	Past
dampneriez	None
commencera	Future
houasse	Past
remporter	None
engendré	Past
empirait	Past
visèrent	Past
boire	None
ajoutant	Present
accédez	Present
engineroient	None
épousèrent	Past
cabrera	Future
rejoignez	Present
ellis	Present
confluant	Present
craquèteriez	None
convoyer	None
devançant	Present
accaparaient	Past
déambulâmes	Past
supplier	None
reconquirent	Past
visionnait	Past
améliorera	Future
gaitier	None
tyranniser	None
acquérir	None
inquietez	Present
caria	Past
recensé	Past
comprit	Past
inversera	Future
parlerait	None
démêlant	Present
plagié	Past
cadencer	None
perpétuera	Future
épancher	None
déjeusnerions	None
bagua	Past
soustrayaient	Past
vaudrait	None
acceptant	Present
trouvant	Present
errera	Future
achetèrent	Past
outillons	Present
encourrions	None
professionnalisant	Present
douteront	Future
incrémentant	Present
identifier	None
exporta	Past
reprenant	Present
defendant	Present
coloré	Past
objecter	None
joncheras	Future
balleraient	None
cazt	Present
traduisant	Present
interprèteront	Future
entraînèrent	Past
révolutionné	Past
foulera	Future
desceller	None
commanderont	Future
fantasia	Past
mater	None
traînerait	None
dotera	Future
esmas	Past
remédiera	Future
devoreroiz	Future
creva	Past
codirigeait	Past
englué	Past
indiquons	Present
profilait	Past
demoureriez	None
chassa	Past
caractériserait	None
extruderez	Future
différa	Past
surnomma	Past
formai	Past
poursuivrait	None
exigez	Present
guillotina	Past
ralentira	Future
dépendraient	None
dévouera	Future
durant	Present
corriger	None
satisferions	None
récupérer	None
horizontaliser	None
réaménagea	Past
prendront	Future
courber	None
codifié	Past
encerclant	Present
vaguer	None
débriderions	None
assonassent	Past
enserrer	None
réfléchira	Future
attendrai	Future
insisterai	Future
décomposaient	Past
affamant	Present
paralysait	Past
ballons	Present
préfèrerai	Future
sabrant	Present
assistera	Future
tacler	None
notâtes	Past
psychanalysassent	Past
somoundre	None
exécuté	Past
distancierait	None
conformait	Past
penastes	Past
vitupérer	None
menacerait	None
superviserait	None
déconseilleriez	None
metoie	Past
liquida	Past
meditoient	Past
greeront	Future
prêchons	Present
raterais	None
rebaptisé	Past
décuplant	Present
partit	Past
regeterai	Future
lixiviait	Past
végétalisé	Past
prova	Past
montrons	Present
augurant	Present
justifièrent	Past
nazifiât	Past
archivera	Future
intensifiaient	Past
réexportas	Past
flanquer	None
habiteraient	None
submergé	Past
affilia	Past
démontait	Past
diminuait	Past
paramétrassent	Past
stabilisé	Past
blessèrent	Past
clignotons	Present
rissolé	Past
attacherais	None
militer	None
mordait	Past
divertissait	Past
solenniserions	None
nécessitaient	Past
trôné	Past
tachant	Present
jauger	None
gouverneront	Future
recourait	Past
jacasser	None
déplumé	Past
taquiner	None
renversait	Past
opterait	None
capturez	Present
effrontant	Present
brandir	None
veiglassent	Past
emprisonnait	Past
pimenté	Past
déparas	Past
payeront	Future
cosignera	Future
maintinrent	Past
ramassaient	Past
géolocalisera	Future
taillerions	None
débanda	Past
recentrer	None
désapprendriez	None
cheveroiz	Future
amuserais	None
pliaient	Past
blasphemer	None
ameuté	Past
vérifiera	Future
étouffer	None
devrais	None
feinter	None
fédérait	Past
ébouler	None
enjoignait	Past
aiguillonnaient	Past
ragierent	Past
zébras	Past
foutrais	None
gémir	None
brandissant	Present
fléchissant	Present
châtié	Past
fuyaient	Past
hydraterait	None
adresseront	Future
entraîna	Past
incubant	Present
ôtera	Future
incombé	Past
blasonneront	Future
glorifiant	Present
arrachant	Present
chérir	None
déserté	Past
allons	Present
nettoyer	None
réutiliserait	None
limassent	Past
caqueter	None
débrancher	None
dater	None
titrant	Present
accouassent	Past
admirant	Present
plastifia	Past
pulvérisant	Present
omit	Past
soulevé	Past
remuons	Present
muait	Past
radoucir	None
ondoyer	None
déchiqueter	None
t'appelas	Past
affligeant	Present
éconduirons	Future
téléphona	Past
truqué	Past
encadreraient	None
nomadisaient	Past
enorgueillir	None
clignoter	None
figuras	Past
jacta	Past
navigueriez	None
édicter	None
défrayant	Present
développa	Past
polluâmes	Past
référons	Present
rediscuter	None
jalonné	Past
envoyant	Present
mesurez	Present
retrouveraient	None
chiper	None
accessoirisé	Past
bada	Past
déstabilisa	Past
rebarberai	Future
incarné	Past
costumer	None
structurer	None
infourmasse	Past
vouait	Past
diffusait	Past
ruinas	Past
stipula	Past
riverez	Future
déployant	Present
hériter	None
titrera	Future
méritera	Future
convoyé	Past
décharneraient	None
desdeignerons	Future
domicilier	None
triant	Present
dérouté	Past
énoncèrent	Past
étrillât	Past
réfrigèreriez	None
joindrai	Future
asséner	None
privatisant	Present
inquiéter	None
prépareraient	None
munissant	Present
avertissez	Present
trotta	Past
détendez	Present
règlementa	Past
destournassiez	Past
accompagneront	Future
mouliner	None
deviser	None
affirmez	Present
bénéficia	Past
esquissant	Present
suspecta	Past
détruisez	Present
navrerai	Future
résideraient	None
compareront	Future
amassé	Past
déstabiliseraient	None
réinventant	Present
abonder	None
atomisant	Present
répartira	Future
numérisé	Past
affuter	None
rodant	Present
désaxé	Past
talochons	Present
complotèrent	Past
diagnostiqué	Past
élaborâmes	Past
intrigué	Past
côtoyait	Past
remixa	Past
galvanisa	Past
ranimé	Past
délibéra	Past
décomposerait	None
minimisa	Past
perdureront	Future
empala	Past
feignit	Past
défera	Future
publieraient	None
déboursé	Past
oseraient	None
ériflâtes	Past
embauchez	Present
priver	None
réinitialisant	Present
réduisit	Past
complimenterons	Future
dimériseriez	None
couder	None
réveillèrent	Past
entraîneront	Future
réprimandant	Present
éclaircirait	None
informait	Past
apparierons	Future
ramenaient	Past
déconstruisant	Present
tumbas	Past
déboutonné	Past
mutualisé	Past
bagarrer	None
gosta	Past
entrabrassiiens	Past
mémorisa	Past
embrasera	Future
chahuterez	Future
entrelarderas	Future
hypnotisâmes	Past
désorber	None
étrillé	Past
ceignait	Past
affirmaient	Past
mentionnerai	Future
transporterait	None
incuber	None
décollé	Past
métaboliser	None
primaient	Past
abala	Past
identifiez	Present
croiserait	None
rôtîtes	Past
énoncerait	None
paineriiez	None
survinrent	Past
varieront	Future
précipitons	Present
bottai	Past
concerner	None
surgissait	Past
vivifié	Past
béquetaient	Past
campait	Past
adossant	Present
attisant	Present
inaugurèrent	Past
recouvert	Past
surpasser	None
prôner	None
accotera	Future
trépané	Past
fleurirent	Past
russifié	Past
croirez	Future
possédez	Present
practicquant	Present
détestant	Present
diffusé	Past
mordre	None
remetre	None
gisoie	Past
égrainant	Present
notons	Present
ruisselant	Present
possèderait	None
interpénètreront	Future
dénoncerait	None
fléchèrent	Past
dactylographier	None
kiet	Present
unifièrent	Past
démoustiquerions	None
déposait	Past
désaltérer	None
fédéra	Past
réchappé	Past
novas	Past
jonchant	Present
trucidassiez	Past
aggravaient	Past
friseront	Future
wikifiant	Present
soulant	Present
schtroumpfaient	Past
ozer	None
guiderait	None
tord	Present
jugeriez	None
iretissoiz	Past
caville	Present
observaient	Past
décloisonnasses	Past
habiliter	None
remontâmes	Past
expiant	Present
déconnant	Present
pencherais	None
divulgua	Past
dévisager	None
étonnaient	Past
carencé	Past
outras	Past
temporisant	Present
préconiser	None
saturé	Past
conformeraient	None
fourmillait	Past
appréhendé	Past
secourt	Present
garderez	Future
cloué	Past
jauni	Past
ignoreraient	None
oscillerait	None
transhumait	Past
baréta	Past
avoisiner	None
chasserait	None
raffolant	Present
redemander	None
déverser	None
démaquillant	Present
freinerait	None
valaient	Past
consacrant	Present
grognerais	None
enforce	Present
plorer	None
engouffrait	Past
absentasses	Past
amuseront	Future
halant	Present
monophosphorylassiez	Past
mélanger	None
brillera	Future
évaser	None
casernez	Present
vandaliser	None
ressaisir	None
relocaliser	None
croître	None
accréditeraient	None
phagocyterez	Future
tué	Past
écœurer	None
altéré	Past
béez	Present
ployé	Past
manipulaient	Past
fricoter	None
apaiserait	None
lasser	None
interconnecté	Past
émerveilla	Past
dépassait	Past
rabattait	Past
entreprenons	Present
informèrent	Past
bicarbonaté	Past
gret	Present
hanterait	None
somounsistes	Past
vrombissant	Present
autoanalysasses	Past
soulevez	Present
désirèrent	Past
dévaster	None
élaboreront	Future
assiéger	None
éviterez	Future
avertissait	Past
gaffer	None
terminer	None
comprendrons	Future
arrangeant	Present
enconchasses	Past
compensa	Past
obéiraient	None
téléphonait	Past
ignoreras	Future
brillerait	None
chérissant	Present
pester	None
argumenter	None
venté	Past
forceront	Future
caramboler	None
mentionnât	Past
restaient	Past
basculait	Past
anonymisant	Present
réanimé	Past
desirast	Past
cavilloies	Past
balisé	Past
tinter	None
feinté	Past
dotaient	Past
contreviendrait	None
dirigeons	Present
atteignaient	Past
épongeras	Future
dégourdissant	Present
vaciller	None
babiller	None
feintait	Past
délestai	Past
injectera	Future
mènera	Future
excentrer	None
mènerions	None
conplainsimes	Past
masturba	Past
embrasé	Past
orbiterait	None
atteignons	Present
révoqua	Past
niquer	None
sonnèrent	Past
soulignant	Present
importez	Present
proscrivant	Present
brulé	Past
foisonnaient	Past
assoit	Present
abréagissons	Present
taquinons	Present
éditorialisera	Future
festina	Past
salez	Present
renoncé	Past
évangélisant	Present
carbonylassions	Past
guideront	Future
meller	None
rhabillé	Past
mélangera	Future
spécifia	Past
annexerait	None
absorbait	Past
prétextant	Present
enharnacheraient	None
taraudé	Past
récrions	Present
animalisèrent	Past
ristournerez	Future
tirerais	None
solidifieriez	None
crevèrent	Past
chuterait	None
nerverait	None
depeschassiez	Past
airaient	Past
peser	None
innocenté	Past
enroulaient	Past
dédièrent	Past
adot	Present
ravageant	Present
déplorant	Present
assertassiez	Past
structuré	Past
surfacer	None
redécouvrant	Present
baisseront	Future
imitez	Present
sommeillait	Past
défriser	None
assureront	Future
illuminer	None
pistait	Past
autonomiser	None
collé	Past
maquillèrent	Past
prêtaient	Past
brandissait	Past
imprégnait	Past
piloter	None
consommant	Present
acquerra	Future
maniaient	Past
demourastes	Past
songeant	Present
enchevêtrant	Present
voterait	None
cris	Present
annula	Past
relégua	Past
baliser	None
incité	Past
kuider	None
constitueraient	None
réaffirmèrent	Past
exportaient	Past
surplombé	Past
terrifier	None
errai	Past
confiât	Past
téter	None
maximisé	Past
ignorerais	None
méritasses	Past
trotter	None
embraserait	None
avenger	None
tuerons	Future
serviront	Future
confirmaient	Past
sonnez	Present
accouchait	Past
unifier	None
interprétant	Present
resteraient	None
étalez	Present
débander	None
déléguèrent	Past
agrandissaient	Past
traduisez	Present
redécoller	None
voucherai	Future
choquait	Past
puisaient	Past
effrayant	Present
dévalons	Present
oxydaient	Past
vider	None
planifiera	Future
cloisonnant	Present
fouiner	None
répondriez	None
ferrer	None
consentît	Past
popé	Past
leicher	None
juster	None
impacteriez	None
ratera	Future
réexprimeriez	None
dispersez	Present
chipas	Past
filé	Past
acclamant	Present
flatirons	Future
platina	Past
déchargeait	Past
soutenu	Past
récoltaient	Past
douèrent	Past
desraisnoies	Past
exsudant	Present
monteplïeriiez	None
préciserai	Future
applaudissaient	Past
alertait	Past
égorgèrent	Past
interviennes	Present
moissonneriez	None
permissions	Past
réservez	Present
mimé	Past
remontaient	Past
gerberas	Future
résisteront	Future
échelonnant	Present
tondant	Present
décéda	Past
sablerais	None
choqua	Past
émettez	Present
courserions	None
décoller	None
affectionné	Past
promouvait	Past
accepté	Past
christianisant	Present
manifestant	Present
porpenseroie	None
trouveront	Future
déféqué	Past
boudiné	Past
eschaperoient	None
main	None
arrivez	Present
commercialisait	Past
corrélé	Past
méthanisas	Past
rater	None
attendre	None
sulfaté	Past
enchaîneront	Future
embêtera	Future
bafoué	Past
modernisait	Past
travaillé	Past
noterait	None
kiert	Present
poussez	Present
pétrifiant	Present
récompensaient	Past
éveilleront	Future
reconceptualiseriez	None
tabulâtes	Past
coexistèrent	Past
transmettrait	None
contrediraient	None
prohibaient	Past
cotai	Past
ajoutera	Future
signifia	Past
timbré	Past
voudriez	None
distrayaient	Past
égayerions	None
craquer	None
syndiqué	Past
agressez	Present
émanciper	None
rouscaillâtes	Past
violenta	Past
dépucela	Past
exhumé	Past
produisant	Present
tronquer	None
carneterait	None
exonérer	None
réalignasse	Past
lapider	None
obéissaient	Past
désincarcérer	None
durci	Past
souffrira	Future
recentrerait	None
vitupèrerons	Future
gesticuler	None
contraster	None
altérait	Past
tromperais	None
intellectualisâtes	Past
gava	Past
promulguera	Future
listez	Present
évertué	Past
taguerions	None
recharger	None
cloîtré	Past
gives	Present
désosser	None
étatiseront	Future
détourneraient	None
suffixez	Present
inspira	Past
placardisé	Past
opprimait	Past
frayé	Past
offrons	Present
brader	None
lobera	Future
sursauter	None
adhèrerais	None
apparaitront	Future
statua	Past
soumettre	None
critiquer	None
attient	Present
procedes	Present
hasarda	Past
ravitailler	None
assignant	Present
rincez	Present
retarda	Past
codirigeant	Present
relocalisé	Past
afrayissoiz	Past
repasserai	Future
momifia	Past
labouré	Past
constituaient	Past
amnistiez	Present
rouspéter	None
outrepassé	Past
maltraitant	Present
réimmergé	Past
baver	None
proviendrais	None
ligotant	Present
bottas	Past
salé	Past
aseptisassiez	Past
monopolisa	Past
diffamait	Past
remédieront	Future
inhumé	Past
dédaignerions	None
glandouillerions	None
movroies	None
arrogeant	Present
débarbouillons	Present
popularisé	Past
révèleraient	None
roua	Past
lutta	Past
lyncher	None
redoublèrent	Past
frôlera	Future
pardonnait	Past
acheminé	Past
finas	Past
critiqué	Past
assumait	Past
essaimeront	Future
enjoliver	None
enchaîné	Past
mentionnerait	None
tercer	None
cofinancerez	Future
cintrer	None
différer	None
nouait	Past
vécurent	Past
désenchanté	Past
évitons	Present
soutenant	Present
protegeasmes	Past
eût	Past
patrouillait	Past
redynamiser	None
profiler	None
aventuraient	Past
vangissoiz	Past
tabasserait	None
gêner	None
contrediront	Future
standardisant	Present
présidentialiser	None
tracer	None
contraindre	None
conduisant	Present
sombrèrent	Past
regarderaient	None
croyaient	Past
apprêtait	Past
baladant	Present
formuler	None
reverserait	None
exerçait	Past
réfléchissant	Present
tarderaient	None
collationné	Past
gêneraient	None
embarquera	Future
remplissons	Present
miraculé	Past
enculerions	None
reformer	None
élevait	Past
subdivisé	Past
décampâmes	Past
européanisâtes	Past
diagnostiquer	None
fricassera	Future
demourerent	Past
démarquaient	Past
méjugea	Past
dresceriiens	None
regonfleriez	None
éluder	None
polluant	Present
contesteront	Future
griffons	Present
essarté	Past
bloqué	Past
soldaient	Past
plaisantant	Present
réussissant	Present
reblogua	Past
répercuter	None
levait	Past
fulminant	Present
innocenta	Past
crachoterais	None
succomberont	Future
desserré	Past
totaliserait	None
condamner	None
benzoyleraient	None
praesenter	None
dégotassent	Past
passionnant	Present
envahiront	Future
infligeassent	Past
dégoudronnerai	Future
déblayeront	Future
livrerait	None
doublez	Present
déboucheront	Future
lofant	Present
dissuadé	Past
connotez	Present
désactivera	Future
gravissant	Present
citas	Past
accepterai	Future
rossa	Past
appréhendèrent	Past
aborder	None
endurcirais	None
invalideraient	None
centralisa	Past
pilé	Past
pousseraient	None
virevolter	None
liasses	Past
appuyer	None
apprêtez	Present
seiner	None
tornerai	Future
cuisiné	Past
embauma	Past
répertorier	None
attirerait	None
edifiant	Present
ceignes	Present
réorchestré	Past
entraider	None
contestons	Present
répudiait	Past
amalgamer	None
éclater	None
épaulé	Past
pourvoira	Future
brava	Past
retournerons	Future
ionisant	Present
