metsästivät	Past
natseista	None
ojikkoineen	None
muistiin	None
luontukoot	Present
saastuta	Present
turhauttaa	Present
tarttukoon	Present
hyötöreaktorien	None
hirveät	Present
virkistää	Present
uskoon	None
ohjaustangosta	None
skannattu	Past
kehittyisivät	Present
suppilovahvero	None
mullistavat	Present
kalastetaan	Present
sirotellaan	Present
nielaissut	Past
tallennetaan	Present
teeskennellen	Present
arvokkaina	None
puolustautuu	Present
mallineessa	None
ansaitsevat	Present
oppisivat	Present
pommittanette	Present
johdannaisen	None
googletamme	Present
tutkittaisiin	Present
taikonee	Present
rapauttaa	Present
ylikuumennemme	Present
kaksipuoluejärjestelmiin	None
säilyttävät	Present
kiipesivät	Past
maanisen	None
synnyttäisi	Present
itsekeskeisittä	None
poimitaan	Present
läjännette	Present
pistivät	Past
trypsiinin	None
työstivät	Past
hauku	Present
videoiva	Present
jauhaisin	Present
kirjoittukoot	Present
varautunut	Past
monimutkaistu	Present
korjaantui	Past
puututtava	Present
puolustat	Present
voida	Present
tykkäävät	Present
hajuveteen	None
villieläin	None
ylikululta	None
suvaitsi	Past
laita	Present
tyydyttävät	Present
sisukas	None
seipi	None
problematiikkaa	None
saneerataan	Present
huomauttivat	Past
kiteyttävät	Present
dieettikeittiöissä	None
kesyyntyvät	Present
kiroillen	Present
tuomiota	None
sijaisnäyttelijän	None
uskouduitte	Past
taivu	Present
pitävät	Present
kuluttivat	Past
herpauttanette	Present
vaihteluissa	None
palaneiden	None
tasangolle	None
jäljittivät	Past
osaavat	Present
ryhtynyt	Past
valloittajien	None
laajenee	Present
riistetään	Present
blokkaisitte	Present
oikaisee	Present
lukiolle	None
tasattu	Past
pyydystävät	Present
vangittava	Present
valloitettava	Present
rahoitettiin	Past
liikuttaa	Present
viljaympyröillä	None
eristäytyä	None
kuoriutunut	Past
tabloidina	None
raivoaa	Present
lävistetään	Present
pommittanut	Past
kaljun	None
maineikkaana	None
lahjoi	Past
eläisivät	Present
konsultteina	None
tiedekunnat	None
hankaloittaa	Present
kuusivyövyötiäisistä	None
puuduttaa	Present
kustansi	Past
taipuu	Present
päälauseina	None
kertaavat	Present
parturoinemme	Present
pohdinnassa	None
luokitellut	Past
kuumentavat	Present
kanttasivat	Past
biopolttoaineeksi	None
hikeennyttäköön	Present
omistaisi	Present
juhlistettiin	Past
tarkastaa	Present
sekosi	Past
takunnette	Present
sijoita	Present
otteluvoittojen	None
uuttaa	Present
juurrutte	Present
panoksilla	None
sekaannuksia	None
ihmetelty	Past
kivetyimme	Past
kehitti	Past
neutriino	None
suolaton	None
turpaan	None
mielisairaala	None
aavikoittanette	Present
kristalloituisi	Present
maanikon	None
kertaantuu	Present
jatsien	None
enetkää	Present
kansoitettiin	Past
seisoivat	Past
petetty	Past
hyväksyttäisiin	Present
morfologisia	None
seurataan	Present
osaan	Present
viettelijää	None
yskii	Present
lukeudu	Present
uivelot	None
lupasi	Past
haikaillette	Present
varastaa	Present
uhattu	Past
katolilaiseen	None
sekoillut	Past
kuvittajana	None
sopeutetaan	Present
varmennetaan	Present
jääkiekon	None
tukista	Present
reagoisivat	Present
laantui	Past
lumisateeseen	None
varoittavat	Present
reunustettu	Past
katsoimme	Past
pedagogian	None
piinaava	Present
luotaavat	Present
oppi	Past
viitannut	Past
käynnistyivät	Past
nokkaisivat	Past
ratkotaan	Present
puettiin	Past
kuvaava	Present
kansoittivat	Past
kafeterioitta	None
kategorinen	None
liipaisin	Past
kadottanut	Past
itsenäistyivät	Past
rasista	None
esiinnyttävä	Present
leimaavat	Present
ekologisten	None
ymmärtäisivät	Present
vene	None
innostuneilta	None
muistettava	Present
hyötyisi	Present
yhdyn	Present
akvarelleihin	None
puksuttakoot	Present
elintoimintojen	None
pidellään	Present
retiisiksi	None
maailmancupit	None
projektipäällikön	None
nynnitään	Present
sävytetty	Past
ostattakaa	Present
kalsiumlaktaatilta	None
joutuisivat	Present
kuulakärkikynä	None
vetäytyy	Present
ompeluneuloihin	None
kihlattu	Past
uudehkossa	None
motivoitu	Past
sodi	Present
systemaattiseen	None
rajoitetaan	Present
hahmotellaan	Present
jäljitellen	Present
olette	Present
seikkaillen	Present
erilaisissa	None
lippulaivaan	None
kullastakaamme	Present
editoida	None
barbituraatteja	None
kehkeytynet	Present
puolituttava	Present
viestittävät	Present
tuotekehittely	None
veuhdoin	Past
jonottavat	Present
ketjureaktion	None
toksikologiassa	None
suorittivat	Past
heiluttavat	Present
tyhjentää	Present
murresanojen	None
rikoksesta	None
hörönauruin	None
hengitysilmaa	None
äyrität	Present
kellonperiksi	None
varattava	Present
ohjausjärjestelmää	None
vietettiin	Past
tyydytintä	None
syrjäytetään	Present
huoneistoista	None
kirjoittakaa	Present
lennonjohdolle	None
musertuu	Present
konsultoitu	Past
taktiikoista	None
isänmaasta	None
läpikäyvä	Present
näännytettävä	Present
kustanna	Present
kidnappasivat	Past
aavikkomaratta	None
hopeamitalin	None
rumentuisi	Present
briiffasitte	Past
reikäkortteina	None
moninaistuva	Present
organisaatioon	None
pelailit	Past
liputetaan	Present
kaatuu	Present
curlingista	None
katsastaa	Present
työsti	Past
nojautuu	Present
puhujista	None
tarkistaisi	Present
sumuunnuttiin	Past
toipuisi	Present
hytkäyttäkööt	Present
pudotettu	Past
mukautui	Past
soveltunut	Past
tuliaseiden	None
negatiivisiin	None
ortodoksiseen	None
muuttaisivat	Present
vammoitta	None
kilisytettävä	Present
nimeäisi	Present
kieltää	Present
limautuva	Present
selittävä	Present
alistettava	Present
runoelma	None
vuonoon	None
austronesialaisille	None
ompelukoneilta	None
leisku	Present
käytettiin	Past
saavutte	Present
ahtoi	Past
sisältö	None
läikyttää	Present
tuhoavat	Present
nummilla	None
myöntää	Present
sotkeudu	Present
kiipeää	Present
löisi	Present
opettelee	Present
majoitettu	Past
harjoitetaan	Present
otaksuu	Present
yhtynyt	Past
vulkanoisit	Present
kellastanet	Present
lieriöt	None
tiuskinevat	Present
nuohotaan	Present
protokollalla	None
talvioksi	None
takaraivossa	None
mainosta	Present
orvokkikasvia	None
ftaalihappo	None
muuntavat	Present
eskatologia	None
mukaisesta	None
perun	Present
sitouduttava	Present
nielaisimme	Past
rengastetaan	Present
myönsivät	Past
hapettava	Present
pirstoutui	Past
etsijöiden	None
käyttäkää	Present
ylettyi	Past
muunnetaan	Present
loikkinette	Present
tarkoittanut	Past
entisöity	Past
vahingoittivat	Past
vinssillä	None
kehkeytynette	Present
hennon	Present
turismi	None
asentanette	Present
jäljittelivät	Past
kiteytyy	Present
liikuttuu	Present
syrjäytyi	Past
farkkukankaana	None
luistelevat	Present
kohdistaa	Present
rahdattiin	Past
puolustavat	Present
kiertelevät	Present
hienostunut	Past
syvensivät	Past
uimala	None
yritetty	Past
kuristin	Past
kiistävät	Present
paradoksiksi	None
aaltoillen	Present
sorsasta	Present
harjoittelivat	Past
työllistyy	Present
erkanevat	Present
valikoidaan	Present
musiikillisten	None
ammentaa	Present
synnytti	Past
surullisia	None
katodina	None
jalometallia	None
millilitraa	None
pakenevat	Present
lahtelaiset	None
lyllertäkäämme	Present
alin	None
syötettiin	Past
poikettaisiin	Present
lukutoukille	None
uraanirikasteita	None
koostaa	Present
nunnille	None
ennätti	Past
poikkilaivassa	None
manaaja	None
aaltoileva	Present
koulutuin	Past
hämäävät	Present
versoi	Past
nyljettiin	Past
sponsoreihin	None
lannisti	Past
raivataan	Present
tuullamme	Present
teloitettava	Present
kromatkoon	Present
moraalifilosofiassa	None
absessi	None
kontrolloidaan	Present
älypeli	None
korokkeen	None
loppupelejä	None
turvattaisiin	Present
lavoilla	None
linjamiesten	None
lahjakkaana	None
rantautuvat	Present
tiloineen	None
miedontaisivat	Present
tarvitaan	Present
kvartsi	None
yhteenliittymänä	None
kompastuttanette	Present
lyhentyi	Past
eriteltiin	Past
laittaisivat	Present
sanoi	Past
onkinen	Present
hukuttanut	Past
elpynyt	Past
myöntävät	Present
sovittivat	Past
omaava	Present
kauhuleffaa	None
selvittelin	Past
itket	Present
asianosaiset	None
juorusin	Past
harrastajana	None
harrastaa	Present
näpelöitävä	Present
arvostan	Present
luotaan	Present
kohdista	Present
samaisessa	None
jatkanut	Past
laattaan	Present
maissilla	None
manierismiksi	None
kuunnellaan	Present
lehtimetsien	None
pidättävät	Present
hakeuduttava	Present
karjaisemme	Present
olentoja	None
antikommunistisen	None
tyrehdyttää	Present
interpoloidaan	Present
tapahtuvat	Present
maastavetoa	None
kiehtonen	Present
opettaa	Present
parkaisu	None
keskimmäisestä	None
instrumentaatiolta	None
rikkoisivat	Present
rahoittavat	Present
slovakia	None
syytä	Present
kehkeytyy	Present
hehkuvat	Present
kuvitetaan	Present
polkenevat	Present
sokaisi	Past
madallettiin	Past
kuhertaisin	Present
oksensi	Past
vakuuttavien	None
saartaa	Present
toistettiin	Past
eläisit	Present
desinfiointilaitteisiin	None
innoitti	Past
istunut	Past
rakentuivat	Past
kaasumaista	None
sikäläistä	None
kieltävät	Present
laskuttaa	Present
neuvostoliittolaisille	None
jännittyneeksi	None
rapsuttelette	Present
uuraaseen	None
pääskysparvessa	None
jatkat	Present
ennakoinut	Past
järkytämme	Present
klubeihin	None
hinataan	Present
toissijaiseen	None
tyrehtyy	Present
haalistuu	Present
kaupankäynti	None
saamea	None
keräilyistä	None
sähköistää	Present
tarkkailija	None
farmarit	None
kuulostivat	Past
villiinnyttäneen	Present
virolaisilla	None
menestyi	Past
henkirikoksista	None
omaelämäkerrallisesta	None
autettiin	Past
eritellä	None
urakoinut	Past
hyllytettiin	Past
myönnän	Present
muistelin	Past
iskostunut	Past
pienentää	Present
yhteenlasketuista	None
napakoruissa	None
käsiajat	None
magnetiitin	None
koemme	Present
aliarvostanen	Present
pelannut	Past
haun	None
tutkimusprojektia	None
muovipussi	None
aktiivisti	Past
alijäämän	None
paasatkaa	Present
edistynyt	Past
sokelsi	Past
tuominnut	Past
halpenivat	Past
julkaise	Present
makeutettu	Past
varamies	None
asevelvollisuusaikana	None
kaappaajat	None
suolattiin	Past
rankan	None
vajosivat	Past
kitise	Present
nousi	Past
absorptiometriaksi	None
painottaisit	Present
hoikistunut	Past
kuormattu	Past
paljasta	Present
tukahduttivat	Past
pelkistävä	Present
kiilaat	Present
onnistut	Present
ällisty	Present
liukeneva	Present
realistiselta	None
huomattakoon	Present
soittakaa	Present
kiehnättävä	Present
filologia	None
magneettikenttää	None
toteutettava	Present
paloitellaan	Present
kiipesi	Past
nivoutui	Past
näkisivät	Present
selittänee	Present
lypsä	Present
koteloinet	Present
kariutti	Past
aikavälein	None
prismassa	None
tunnisti	Past
liehuu	Present
leyhytelty	Past
kykenisi	Present
pimennosta	None
piirustuksin	None
puupuhallin	None
syövytetään	Present
painellet	Present
anafylaktisina	None
kunnalliset	None
tarpeettoman	None
perhosta	Present
pysähtyvät	Present
ennusti	Past
hemmottelitte	Past
kirkastuva	Present
kätyriä	None
tasoitettu	Past
valitat	Present
luiskahtanette	Present
raivasivat	Past
punoutunevat	Present
murhaavat	Present
taottanemme	Present
tursuisi	Present
etikkahapoksi	None
käsiteltäisiin	Present
tambopatanmuuralla	None
vastakohta	None
globaaleihin	None
morsiamesta	None
pelastanut	Past
lypsivät	Past
keihäsmiehineen	None
voinen	Present
lihavoidaan	Present
miekkaillevat	Present
ontologioita	None
tunnistamme	Present
pakkolunastettiin	Past
jalostetaan	Present
vähemmistöön	None
tuudittakaamme	Present
aitotumaisiin	None
standardisoinnin	None
istuttiin	Past
rupean	Present
kertaluvun	None
selitettävä	Present
ryskynet	Present
säteile	Present
varauduttava	Present
kolahtanemme	Present
jännittävät	Present
peltoon	None
kaarnoittunette	Present
pääkonttorista	None
diagnosoitiin	Past
ilmoitin	Past
leikkivä	Present
rupeaa	Present
käsirautojen	None
kirjataan	Present
dynastiat	None
seisakkeena	None
siirry	Present
vatkataan	Present
samaistivat	Past
sukupuolisesta	None
geeniterapian	None
ulostettakoon	Present
elättävät	Present
kannattelevat	Present
altistuvat	Present
mukailevat	Present
soinen	Present
papittarena	None
tulostukaa	Present
verestät	Present
plastisen	None
penkoa	None
lähtisivät	Present
siirtokunnassa	None
tallennettu	Past
mahdat	Present
järjestellään	Present
sävellettiin	Past
jakautuvat	Present
saneerannee	Present
kuvitellaan	Present
boikotoinut	Past
turpiini	None
pariisilainen	None
asvaltoisivat	Present
saattaisivat	Present
vallatkoon	Present
säveltää	Present
tuon	Present
odottava	Present
neutraalisti	Past
höylätty	Past
ohjastanut	Past
määräytyivät	Past
kylmenin	Past
havaitsin	Past
sairastettu	Past
edesmennyt	Past
onnistuttu	Past
säälittävä	Present
simputus	None
kuvasi	Past
realisoitunee	Present
pahoitteli	Past
hieraissee	Present
pistokkeen	None
inkeriläisiin	None
muistavat	Present
vältän	Present
poissaoloja	None
sirkkelin	None
kasvatukseen	None
muutettaisiin	Present
vahinkoon	None
raportoitiin	Past
purista	Present
suunnataan	Present
asettuisivat	Present
ilmastunevat	Present
marshallia	None
muotoilisit	Present
perustelin	Past
murentaa	Present
törmäsivät	Past
voittamaton	None
sepelöisimme	Present
laiskottelen	Present
korvautuvat	Present
afrikkalaisten	None
kuulosta	Present
niitin	Past
näpelöidään	Present
ympäröivä	Present
videopelille	None
epäjohdonmukaisia	None
loiventukoot	Present
juhlinut	Past
pukeudu	Present
hoatsin	None
laukaistu	Past
haiman	None
muinaisenglanti	None
myötäilevä	Present
romanttiseen	None
pelastautuu	Present
hilpaisen	Present
syövät	Present
vuotispäiviä	None
laskettavat	Present
äänittänyt	Past
kiristäjä	None
uhkaus	None
aloittaisi	Present
ajoittuivat	Past
panostettiin	Past
hallitusohjelma	None
kuroutuu	Present
epäonnistu	Present
jäädy	Present
huollettu	Past
graavaisimme	Present
avautuva	Present
haarottaisit	Present
iskettiin	Past
ikuistettiin	Past
ratapiha	None
ontui	Past
esineistä	Present
edamjuustoja	None
vierasti	Past
länsimaistanut	Past
kastettava	Present
turistikohteita	None
hakee	Present
mustelma	None
liiketoiminnoista	None
ylläpitänyt	Past
eristyi	Past
viimeisimpiä	None
vertaile	Present
hyvyydestä	None
jälkeisillä	None
käskenyt	Past
kuvaat	Present
läpikäyty	Past
derivoitu	Past
mursi	Past
osata	None
kustannetaan	Present
digitalisoitu	Past
omistautuu	Present
valmistuvat	Present
helskytetään	Present
loputtaneen	Present
värväytyä	None
kuunnellen	Present
alistuttaisiin	Present
kotiuttanut	Past
flaneeratkaa	Present
ilmaantua	None
kihartunen	Present
moottorivioitta	None
siittimen	None
seitsikon	None
sivustalla	None
kilpistyivät	Past
tuhoutunut	Past
merimerkeiksi	None
lehmukset	None
ajantasaistanut	Past
hidasta	Present
älähtäisitte	Present
löydyttävä	Present
aivovammat	None
talouskasvu	None
mikrobeille	None
motivoiva	Present
irrotti	Past
syrjäseudutta	None
eroteltu	Past
käsittelyä	None
kierrätti	Past
tajutaan	Present
kaivelevat	Present
havaitsi	Past
puoltava	Present
ratkaistu	Past
kiteytynyt	Past
juustoutamme	Present
sointunut	Past
vapautettaisiin	Present
kunnioittaa	Present
sammui	Past
menesty	Present
nimeää	Present
työskenneltiin	Past
esitelmöinyt	Past
kuvailevat	Present
matkailusta	None
lyhentynyt	Past
torjuivat	Past
akkumuloikaa	Present
silmänkääntäjä	None
kovertakoon	Present
palkitsimme	Past
yhdistelköön	Present
sanskriitin	None
vuotavat	Present
hattutempuista	None
välitettiin	Past
kirjoittaisin	Present
elkeiksi	None
budjettia	None
palkitsi	Past
aihepiirien	None
sortuivat	Past
tuonelaan	None
tahattomasta	None
käyttökelvoton	None
meloivat	Past
korottanut	Past
hukattu	Past
kahdentaa	Present
puhkesi	Past
talutti	Past
vakuuttunut	Past
potilaat	None
rumpusettiä	None
hirnunee	Present
ilmaantuvat	Present
lyön	Present
suhtaudun	Present
riivattu	Past
kellahdutettava	Present
kiihdytetty	Past
lupasivat	Past
futuristinen	None
nopeampaa	None
kuutiojuuressa	None
juonen	Present
kestänee	Present
suihkuseurapiireiltä	None
oivallettu	Past
varietee	None
teeskenteli	Past
maaseutuun	None
spray	None
pitäjiin	None
koulutuskeskus	None
himoitse	Present
rakastan	Present
notaarin	None
doupattiin	Past
samanarvoiset	None
kannatti	Past
nöyryyttävät	Present
käsittelin	Past
vieroitukseen	None
parannettava	Present
raasuihin	None
harppuun	None
käännyttävät	Present
täyttyisi	Present
nuorensi	Past
pistemäärän	None
kalkuttanut	Past
kykenee	Present
kompastunut	Past
vedätytämme	Present
halveksuivat	Past
pätevä	Present
pakeni	Past
keskustellen	Present
kartiomaista	None
lotottiin	Past
italialaista	Present
pohjaava	Present
aikaistettiin	Past
hautuvat	Present
vuottaa	Present
lopputulokset	None
nöyryytyksiä	None
kemiaan	None
epäonnistuisivat	Present
tarjoan	Present
nuorempia	None
armiaan	None
lieventävät	Present
rajaan	Present
kannustamme	Present
kaavailee	Present
laittakoon	Present
lepäävät	Present
ylikuormittanen	Present
sarjakuvalehdissä	None
kylmään	Present
perattiin	Past
hyönteismyrkyt	None
toistettava	Present
suojautunet	Present
jääpallosta	None
jousitettava	Present
sumutetaan	Present
sotkevat	Present
rikokseen	None
kartongit	None
pystyttävä	Present
kilpailivat	Past
syrjäyttää	Present
lähtevät	Present
lestadiolaisia	None
lähestytään	Present
miellyttää	Present
korkkiutukaamme	Present
haluaisit	Present
heilutaan	Present
lähettävät	Present
punertuvat	Present
kukoistivat	Past
kulkevat	Present
kontrastit	None
pyörtyi	Past
kyditte	Past
kerskui	Past
dodon	None
haarautuva	Present
korostivat	Past
kaikui	Past
jarruttivat	Past
alittava	Present
häiritty	Past
hiiskuit	Past
kilvoitteli	Past
tarttui	Past
lepäsivät	Past
paranisin	Present
kostuu	Present
koristanut	Past
ylety	Present
hyytyivät	Past
kastunut	Past
vintturilla	None
hiillyttänee	Present
omaleimaisuuksissa	None
syrjäyttänyt	Past
juhlista	Present
kansanäänestyksiä	None
tajuavat	Present
toivotti	Past
esittelivät	Past
syventyy	Present
säestyksestä	None
laimenin	Past
vihataan	Present
ryhdyn	Present
mittauksista	None
keinun	Present
sinkosi	Past
vaaliva	Present
porrastettu	Past
liikkumisvapauksissa	None
muotoiltiin	Past
suuteli	Past
kaipasi	Past
suppeimman	None
nokea	Present
ostatti	Past
rykmentissä	None
kerrytti	Past
kypsennetty	Past
tiuskahdeltakoon	Present
jäävään	Present
sijoitin	Past
kaulaisi	Present
puolustellaan	Present
osoittautuu	Present
määritä	Present
karjahtakaamme	Present
tallensivat	Past
kärjisti	Past
harrastavat	Present
kirjoittava	Present
anaaliseksi	None
huuhtoutuvat	Present
uskoo	Present
pelastaa	Present
vapautetaan	Present
kurssilaisten	None
monikäyttöisen	None
hahmotu	Present
korvattaisiin	Present
karkotettiin	Past
hämmennetään	Present
luettelee	Present
todellisuudesta	None
karsitaan	Present
julistautukoot	Present
kulttuureista	None
elävöittävä	Present
miellyttävä	Present
gettoistunette	Present
murskannut	Past
kuivuva	Present
syyssateiden	None
orastuttakoon	Present
skeittaus	None
sekoittuisi	Present
ortodokseihin	None
pohdiskelee	Present
syytetyksi	None
alittivat	Past
esitellyt	Past
vauraaksi	None
magneettinauhaa	None
torpedoitu	Past
sivistyneet	None
kolminkertaistunut	Past
häiritsevä	Present
lakkautettu	Past
ruskeankirjaviksi	None
loppuosaksi	None
ajantasaistatte	Present
uut	None
konservatiiviseksi	None
limusiinit	None
luonnehtii	Present
valloittava	Present
buuattiin	Past
retuuttaisi	Present
ällistynyt	Past
sensuroitu	Past
näivettyisin	Present
vältettiin	Past
miehistynet	Present
kannustava	Present
huonontanut	Past
keksijästä	None
tarkkailen	Present
odottaa	Present
kosti	Past
vihkimisiä	None
kyörätään	Present
kitunen	Present
ontelomaisiksi	None
hyökkäyksille	None
suurkaupunkeihin	None
synnyttävä	Present
huojuvat	Present
huilannemme	Present
uusiutuivat	Past
eskaloitui	Past
yliopistoihin	None
miinoitti	Past
vesisadetta	None
vaikuttajiksi	None
omistaa	Present
kovuuteen	None
sotalaiva	None
kihlautui	Past
tallensin	Past
lykännyt	Past
tilillä	None
sokeritautia	None
astuvat	Present
frankeerasi	Past
raiskannut	Past
varmista	Present
vanhentuneiksi	None
pursuit	Past
suhtautuvat	Present
rinnastettava	Present
pettyi	Past
sotaherralta	None
bulgaria	None
reagoisi	Present
janottaisin	Present
huolestuisi	Present
poljettu	Past
kipua	Present
resitatiivien	None
luokittelevat	Present
mankeloinnit	None
hoidan	Present
epäilisi	Present
siivitti	Past
seulotaan	Present
korvaläpille	None
viilaisit	Present
helpottava	Present
laajentunut	Past
kansallisvaltio	None
sulkevat	Present
nököttäisi	Present
kaivelee	Present
riippusilta	None
koukistaa	Present
aaltofunktiot	None
paikkaisen	None
loppupelin	None
surrealistiset	None
maatamme	Present
manipuloikaa	Present
hypyn	None
avautuu	Present
rasvaan	Present
tehtaalta	None
entraavat	Present
mapittanette	Present
tällaisen	None
suviyölle	None
argumentti	None
liljasta	None
kanonisoidut	Present
ajankohtina	None
huviretkeltä	None
aluskasvillisuuksina	None
taittuvat	Present
egyptiläisessä	None
pelilauta	None
falsetissa	None
parvekkeelle	None
kuku	Present
kiristivät	Past
laadukkaaseen	None
vipelsitte	Past
nauttisi	Present
luettava	Present
vilkaissut	Past
kansainvälistynyt	Past
fidžinnettäisiin	Present
jallititte	Past
merkkaan	Present
monipuolistui	Past
juurikkaat	None
kohahdeltaneen	Present
hernettä	None
kuljettiin	Past
pakkausmateriaalina	None
hiillostaa	Present
kansalaisopisto	None
vieraantuivat	Past
kaventanut	Past
onnistuisivat	Present
suitsutti	Past
vahingoittava	Present
ehdokkaiksi	None
motivaatiot	None
virtsattiin	Past
väläytä	Present
sisäkorvaan	None
oleskelee	Present
kertoilet	Present
värähtelevät	Present
tavoittanut	Past
motivoituu	Present
suositellut	Past
läimäytti	Past
punapahkasienistä	None
välimuisteja	None
tuhoutuisi	Present
varoitti	Past
ydinkärjet	None
ominaisuuksina	None
pakin	None
jalkautui	Past
tumakkeessa	None
käynnistänyt	Past
vietteli	Past
kehittelijöittä	None
palvattu	Past
eläköitynyt	Past
uusiutuisitte	Present
ulkomaanvelka	None
joisin	Present
opettava	Present
jääkaappeja	None
mitattava	Present
sertifioidut	None
suuremmille	None
veroparatiisi	None
romuttaa	Present
materiaalista	Present
veikattu	Past
noteerataan	Present
ulkomainen	None
lyhenee	Present
virittivät	Past
harmennun	Present
epäilet	Present
tarkastettu	Past
tunnemme	Present
sinfoniaorkesterien	None
ynähtäisit	Present
lyhennetty	Past
ryhtyvät	Present
saalista	Present
pahimpina	None
teurasti	Past
kiteytin	Past
realismissa	None
pullottanevat	Present
valmistauduttava	Present
vakinaista	Present
hirveää	Present
vaistoaa	Present
odotuttaisi	Present
kastroisi	Present
muututtava	Present
loukkaantuivat	Past
lyöttäytyvät	Present
tomunnemme	Present
kerääntyvät	Present
kalastettu	Past
jouduttiin	Past
arvot	Present
syyttävä	Present
eläimellisellä	None
vetäköön	Present
kiinnittävä	Present
varastoisivat	Present
luopuisivat	Present
irtautunut	Past
haaveilevat	Present
viskositeetti	None
kyyristynemme	Present
tutustut	Present
tarkistan	Present
aisasitte	Past
ihannoidaan	Present
korvasin	Past
kouluttautui	Past
romahtavat	Present
lumoa	Present
säädetty	Past
pasunistit	None
peräänkuuluttanut	Past
heittivät	Past
ostettava	Present
tappiolla	None
lueteltu	Past
puhkottakoon	Present
täydentäisi	Present
majoittuivat	Past
neitsyyksillä	None
tehokkaimpiin	None
kuntoutuksessa	None
kuluttaisivat	Present
usvan	None
piitattu	Past
pitää	Present
muista	Present
suureni	Past
suoda	Present
mittayksiköt	None
kirkkaanpunaiset	None
paisuisi	Present
jeesannut	Past
kuolleesta	None
muistuttaa	Present
savikivi	None
strukturoitu	Past
allekirjoittamisen	None
väittäisin	Present
oikeuta	Present
narskuttanette	Present
tuhoutui	Past
ulostetta	None
tervautunet	Present
tempaisee	Present
saavuta	Present
lonksut	Present
nollaan	Present
kehräsivät	Past
kanavoidaan	Present
tavoittelivat	Past
lintuniisikankaat	None
juna	None
roskaisitte	Present
rehkinemme	Present
toteemi	None
näyttelyesineenä	None
kohtaisi	Present
salaileva	Present
kypsennetään	Present
väärennettiin	Past
selvennyksenä	None
vääntää	Present
poloa	None
ilmestyisi	Present
näkövammaisia	None
sidonta	None
lähestynyt	Past
nussittaisiin	Present
alkamiselle	None
teollisuusmaita	None
lauttaan	Present
ikiroudassa	None
raportoidaan	Present
sykliin	None
fosgeenia	None
noudatteli	Past
lakkautettaisiin	Present
kiittivät	Past
halot	Present
pyörtyy	Present
siirryin	Past
sinkoutuvat	Present
myrkky	None
kiveän	Present
irtaantui	Past
esitin	Past
palatsin	None
perustuisivat	Present
sidon	Present
äimistitte	Past
kiintyvät	Present
omista	Present
paastoa	Present
vartioitu	Past
kutistetaan	Present
tuhoudu	Present
vaihtoehdoilla	None
kiertelivät	Past
urheiluseura	None
atonaalisuus	None
joutaisi	Present
vältyttäisiin	Present
painonapit	None
kovasimella	None
bastionin	None
pyörähti	Past
nuhraantunette	Present
tutusti	Past
evakuoitiin	Past
eikosanoideilla	None
mayan	None
leveysasteiden	None
käynnistyksen	None
kukinnan	None
kuunari	None
entistää	Present
työskennellen	Present
lopetettu	Past
hyödyn	Present
sisennetty	Past
avomeren	None
kotiutuu	Present
risteytyvät	Present
unohti	Past
palvelimissa	None
vaihdettiin	Past
levitetään	Present
kehotettu	Past
kuperrettava	Present
maitopulveria	None
ehjäksi	None
innoittanut	Past
englannintorvelle	None
sotilaallistavat	Present
huollatettakoon	Present
sivistynyt	Past
weimarinseisoja	None
jussi	None
shopatkoon	Present
arvosteltiin	Past
halkaiseva	Present
nykyaikaisti	Past
tihennettiin	Past
ratkaise	Present
raportoinut	Past
poikkaisen	Present
edistävä	Present
majoittuvat	Present
sotilaallisten	None
liikahtanevat	Present
puhkeaa	Present
hehkuva	Present
purjehtiva	Present
julistautuisivat	Present
öljykangastakkiin	None
lopetettava	Present
kiiltää	Present
menninkäisiä	None
luvannut	Past
sitaatti	None
opiskeleva	Present
teeskentelevät	Present
koostunut	Past
takit	None
hämärtyvät	Present
murtautuivat	Past
yhdistytte	Present
petkutti	Past
soitti	Past
keskittää	Present
soitin	Past
arkipäivään	None
villiintynyt	Past
uskonnollisia	None
jaettaisiin	Present
kiiruhtaa	Present
toteutuisivat	Present
rankkasi	Past
formaateille	None
rypäleiden	None
jalostivat	Past
katettava	Present
lähestyvä	Present
täsmällisiä	None
vuotaa	Present
babylonialaisiksi	None
teurastettiin	Past
hukkasi	Past
sovitetaan	Present
haltioista	None
pelotti	Past
heikottanemme	Present
suotu	Past
vammautunut	Past
päämiehestä	None
yhtälöryhmällä	None
pilasin	Past
spektrit	None
vetäytyvä	Present
mökissä	None
tuoreisiin	None
edesauttaisi	Present
tieteenalaksi	None
uomineen	None
osmonsolmu	None
helkyitte	Past
ymmärrettiin	Past
muusikkojen	None
rullasi	Past
hetkahtakaamme	Present
lähetät	Present
teloittivat	Past
rakennetaan	Present
uupumusta	None
sakramentin	None
sisällytätte	Present
sulautetaan	Present
tehota	Present
poliiseille	None
kysyttäisiin	Present
vallattaisiin	Present
soveltamiseksi	None
kasaavat	Present
kumpuileva	Present
yhdistettiin	Past
luokiteltiin	Past
hurmaavan	None
muokatkaa	Present
peitetään	Present
viljelkööt	Present
äänestävät	Present
patsaineen	None
järkevöityisi	Present
muotoillut	Past
kuulantyönnön	None
vuorovaikutin	Past
harhauttava	Present
katedraaliin	None
villiinnyimme	Past
tapettaisiin	Present
upotus	None
enensimme	Past
teljetty	Past
suonitta	None
kondensoidu	Present
hyvästelevät	Present
avustamiseksi	None
lajiteltu	Past
ambulanssiin	None
muuntui	Past
konnanleinikkeinä	None
parodioitu	Past
luokitteli	Past
vastustuskyvyn	None
murskautui	Past
järkeistyttäisiin	Present
tasattiin	Past
translitteroitu	Past
sulauttaa	Present
rukoilet	Present
läntiseen	None
kevättalviin	None
painallamme	Present
tapan	Present
ympäröinyt	Past
resistanssia	None
useista	None
luonnottomien	None
fissiosta	None
kurjistuu	Present
sosialisoisi	Present
kustannettu	Past
kivistä	Present
rohkene	Present
teollistunut	Past
saunomiseen	None
juhlistava	Present
polaaristen	None
modernisoinen	Present
vallinnut	Past
jaoksiin	None
paljastui	Past
kahlannut	Past
upposivat	Past
tähtitieteestä	None
vuodatettiin	Past
asettuivat	Past
huijasi	Past
happamoituisi	Present
alistivat	Past
vastustuskykyä	None
vartokoon	Present
kohenisi	Present
tyhjentynyt	Past
dokumentoinee	Present
pietaryrttinä	None
typistyi	Past
agnostisuudetta	None
rappeuttava	Present
tyylilajien	None
käsikirjoittaa	Present
pyörisi	Present
kansainvälistä	Present
teljetään	Present
hupsahdimme	Past
tiedotti	Past
diversifioidun	Present
perustettaisiin	Present
väheksyi	Past
muistat	Present
uskaltautuivat	Past
trooppisen	None
evättiin	Past
hahmotettava	Present
mielipiteet	None
kehittäisivät	Present
polttopisteestä	None
ärsyttivät	Past
väkevöity	Past
kuulosti	Past
kultakannan	None
lastenosastoitta	None
lassottaisiin	Present
luokituksissa	None
nautakarjaa	None
tartuttaa	Present
houkutti	Past
julkistivat	Past
pahoittaa	Present
kelvannut	Past
tietoliikenteestä	None
atarin	None
pimettiin	Past
arkeoastronomioissa	None
delegoisitte	Present
kuohuttanut	Past
haluava	Present
keskitetään	Present
täsmentävä	Present
lopettava	Present
sosialismia	None
hommautukaamme	Present
mestitsit	None
julkistavat	Present
alennettaisiin	Present
ruskeutukaamme	Present
valoisampina	None
parantelen	Present
tapa	Present
ehditty	Past
parantavana	None
auraisivat	Present
edistämisellä	None
tunsin	Past
varta	Present
vierottakoon	Present
tentti	Past
raatihuone	None
kolmansien	None
kirjastoista	None
tiedä	Present
haudattiin	Past
tulpitsimme	Past
monofonisena	None
romahduttaa	Present
piipattaneen	Present
uudistushankkeiksi	None
törmättiin	Past
käyttöjärjestelmille	None
ajokkina	None
ylikuumeni	Past
liukastaisin	Present
rangaistaan	Present
jauhemetallurgioihin	None
siteillä	None
surkuttelisit	Present
siivottu	Past
liikiksi	None
värittänyt	Past
talleta	Present
ammatillisissa	None
rohkenee	Present
sitaiset	Present
pahe	None
pahensivat	Past
lupasit	Past
heiluttiin	Past
vandalisoinut	Past
pökerryttäisivät	Present
hiiskun	Present
toistuisi	Present
funktioille	None
luonnollisin	None
kellahdutimme	Past
kuvailivat	Past
sirrakuskiin	None
kiehuva	Present
rantaudutaan	Present
sensuroinut	Past
muistettiin	Past
ritaa	None
tylsistyy	Present
liiketoiminnan	None
upotettiin	Past
laskisi	Present
vajeneva	Present
sönköttäisivät	Present
lymyilisin	Present
soistuva	Present
lautailijalle	None
enkeliopit	None
pronssittaisit	Present
komeat	None
epäyhtenäisyys	None
yhdisteeseen	None
sumututte	Present
elävöidytte	Present
harmaannuttakaa	Present
viruksiin	None
höyrykone	None
valmistivat	Past
käet	None
julistautuivat	Past
suomennetaan	Present
pandoineen	None
ottelevat	Present
sisustanee	Present
luvanvaraista	Present
vaiensi	Past
syyttäisi	Present
riskialttiita	None
kipeän	None
propagandassa	None
terälehdissä	None
liityin	Past
murikka	None
visuaalistanen	Present
manipuloisitte	Present
luopunut	Past
pannassa	None
kiihdyttää	Present
peittynyt	Past
aliarvioitu	Past
raivasi	Past
luonnikas	None
leiriytynyt	Past
vadelmaa	None
variksenmarjan	None
kustannettiin	Past
varattu	Past
kontrolloitu	Past
avioerosta	None
herätti	Past
ammuttavat	Present
irrotettu	Past
suova	Present
hämmästyttänyt	Past
suosittele	Present
käynnistetty	Past
erottelisit	Present
kestämättömäksi	None
vaietaan	Present
selosteiksi	None
uskoisi	Present
kaapatkaa	Present
liittyi	Past
päristäisiin	Present
bosniannat	Present
niistäisit	Present
laskekoot	Present
vaellettaneen	Present
koulutettu	Past
vietti	Past
oppimisvaikeuksia	None
uuvuit	Past
rajoitettu	Past
suomuisia	None
sijannut	Past
köntystelet	Present
suuttuivat	Past
filmografiaa	None
itken	Present
paksuuntuu	Present
soittelevat	Present
yskähdettäneen	Present
rangaistiin	Past
siunasi	Past
lainautuisit	Present
tilasin	Past
lentävät	Present
tuutuina	None
palautui	Past
ihastuksesta	None
äksyilisi	Present
erääntynyt	Past
öisen	None
kosinut	Past
yhtäpitävältä	None
syyttämiseen	None
kapitalististen	None
käsittivät	Past
aatelissukuihin	None
huipentuivat	Past
kolumnien	None
säästytään	Present
punnitsee	Present
familismeillä	None
jumiinnuitte	Past
jäljitti	Past
sumerit	None
purren	Present
kolmivaihekilowattituntimittareista	None
leppyy	Present
parodioiva	Present
kerättiin	Past
rumentaa	Present
arvokkuus	None
eloton	None
työnnä	Present
säätävät	Present
walesilaisen	None
uudistettu	Past
yhdenmukaistettiin	Past
tuloste	None
kotiutunut	Past
matemaattistakoot	Present
kärjistyi	Past
kasvatin	Past
epäsiisti	None
puolustautuva	Present
äänestysoikeutta	None
tapahtumaketjuitta	None
sijainnut	Past
haittasi	Past
juoksen	Present
harjoiteltu	Past
kilpailee	Present
kuulustelujen	None
löytynyt	Past
haaraantuvat	Present
ureaksi	None
nobelisteiksi	None
metafysiikkaan	None
ajoitettiin	Past
katettiin	Past
koostetaan	Present
keskityn	Present
muuntuva	Present
padonnut	Past
kirpoaisivat	Present
saarnattiin	Past
hankaloitti	Past
syrjän	None
ulkomuodot	None
tukahduttavat	Present
filminäyttelijöille	None
viilentävä	Present
oppilaista	None
synkronoitu	Past
ansaitsisivat	Present
sammutettava	Present
lankeaisi	Present
mustaisin	Present
installaatioilla	None
haluttu	Past
hemmoteltu	Past
kertaistukoot	Present
vitonen	Present
piinannut	Past
mitätöity	Past
toimitukselle	None
kopautimme	Past
korostutte	Present
huomioitu	Past
kirkuu	Present
antautuu	Present
kantoaallossa	None
konduktanssin	None
luottamuksellisen	None
siirrettäköön	Present
matkataan	Present
huumaava	Present
palaavat	Present
eristäytyy	Present
tartuin	Past
pistouvasimme	Past
parittomia	None
muistamme	Present
koneellistui	Past
bussipysäkki	None
käynnistä	Present
risteyttivät	Past
tahot	None
torneista	None
sotketaan	Present
helpottui	Past
ulostanet	Present
savitiileksi	None
jalostanut	Past
kerrostuttakoon	Present
ysin	None
katsellen	Present
ohene	Present
säätää	Present
rokataan	Present
lausui	Past
revittäkööt	Present
päättyy	Present
riisuvat	Present
maksoituitte	Past
paimentavat	Present
vakaat	Present
baijerilaisen	None
kiemurtelit	Past
kehkeytyi	Past
näkevä	Present
piirrettiin	Past
keskiluokkaistuisit	Present
suorittimia	None
kasinossa	None
crescendo	None
juovittaisimme	Present
raivoava	Present
kiinnitettiin	Past
jäkkärättä	None
odottelen	Present
saksalaisissa	None
kurissa	None
tungoksen	None
brittiläisettä	None
haalistunut	Past
aseistariisumisten	None
törmännyt	Past
yleishyödylliseen	None
jatkakoon	Present
johtuivat	Past
hahmottaisitte	Present
ulahtaisi	Present
kuvattava	Present
musertaa	Present
kokoontui	Past
riippuliitänet	Present
päällystää	Present
surmasivat	Past
vertasi	Past
proteiineihin	None
vitivalkoisesta	None
harrastettu	Past
arabialaisten	None
moninkertaisti	Past
rationoinemme	Present
paettava	Present
ilmenee	Present
renkien	None
liikenneruuhkien	None
kuumenevat	Present
ainutlaatuiseen	None
tunnustaa	Present
uudenaikaista	Present
hätkähdyttävä	Present
liikemiehestä	None
etuliitteeseen	None
vakuuttakoon	Present
sitoutui	Past
päähenkilö	None
hapettaa	Present
eksyvät	Present
punnitse	Present
taittaa	Present
avattaisiin	Present
lussutettaneen	Present
kukistanut	Past
arvasin	Past
tornitus	None
kiihdytti	Past
korvatulehdusta	None
onnistu	Present
aloitettaisiin	Present
moninaistuisin	Present
kiidätetään	Present
kytketään	Present
itäafrikkalaisille	None
käärittiin	Past
tuomitsee	Present
retkeili	Past
uhkakuva	None
rengasti	Past
raivaan	Present
totoa	Present
suolataan	Present
kajottu	Past
katsellaan	Present
järistyksessä	None
naineet	None
kirveli	Past
eettisyys	None
jykersin	Past
eteläisemmillä	None
ymmärtämiseen	None
pesuaineen	None
hitsattaneen	Present
kehuista	None
kierteitän	Present
sivellä	None
ateriakuljetuksilta	None
heikentävä	Present
sannan	None
ryhmäkannetta	None
kiinnittyvät	Present
kahlitsee	Present
hypnotisoiduitte	Past
selvitti	Past
laukaissut	Past
kustoksena	None
haaksirikkoutunut	Past
veloitetaan	Present
virallistuisin	Present
muodostanut	Past
hankintojen	None
lussuttakaa	Present
kikatettakoon	Present
liikuttui	Past
kirnuunnumme	Present
havahtuu	Present
kavaltaa	Present
varsan	None
aterioisitte	Present
entistettiin	Past
humpannette	Present
finaaleissa	None
kvantifioikoon	Present
kirnuuduttiin	Past
kipusi	Past
asumistuki	None
taantuva	Present
puolustuksessa	None
biologiaan	None
artiklassa	None
reagoinut	Past
kaikkivaltias	None
kaunistumme	Present
ensihoitopalveluin	None
vakuututtakoon	Present
lähettivät	Past
koisannemme	Present
yksilöivä	Present
höyläisi	Present
öykkäröity	Past
häiritsi	Past
laskevat	Present
kuivataan	Present
yhtenevät	Present
kaksinkertaisella	None
polje	Present
uhataan	Present
katkon	Present
palkkasi	Past
häipyivät	Past
vahingoittaisivat	Present
tuijottaa	Present
ropeiksi	None
investoitu	Past
kirkastettu	Past
ketjuttaa	Present
projektiiviset	None
kirjoittelen	Present
laudoista	None
langeta	Present
kuljettajiin	None
kimputtava	Present
osallistuvat	Present
ajoittuva	Present
painottaa	Present
vangitsee	Present
nopeutunut	Past
yhtenäistetty	Past
kuluta	Present
kiretkäämme	Present
uhoaa	Present
vastustettu	Past
rauhoitettu	Past
häiriintyi	Past
tele	None
ojana	None
nauhoittivat	Past
mätänee	Present
maalaismaisemaa	None
läikehdittäisiin	Present
viidesosa	None
bassetti	None
arkistoinut	Past
kangersit	Past
öljyrahoineen	None
tanssittu	Past
samantapaisten	None
ääntää	Present
kanadanvireosta	None
omaksuttava	Present
jousisoittimet	None
kuoreutunen	Present
houkutteleva	Present
maltillistunemme	Present
parkinnevat	Present
vastustin	Past
solmittava	Present
heltisi	Past
mainittava	Present
hopeakuusilla	None
ryhdyin	Past
pitelevät	Present
väläytti	Past
abstraktisti	Past
vähenisivät	Present
tiivistävät	Present
laukaistava	Present
kannatuksen	None
puristettu	Past
kulutan	Present
närkästytti	Past
pelastuivat	Past
porstuaa	None
rutistamme	Present
viskatsatta	None
kulminoitui	Past
jäykistä	Present
laakeroinen	Present
kironnut	Past
aptameeriä	None
nousen	Present
paljakkaseitikkejä	None
lievitetään	Present
muusikkoina	None
harmonista	Present
unohtavat	Present
frigideiltä	None
aiot	Present
laiminlyöty	Past
tunnustautunemme	Present
valkosipulia	None
pesukarhu	None
keskittyisivät	Present
urkitaan	Present
työllistivät	Past
imitoiva	Present
tainnuttaa	Present
ammoniumkloridia	None
reaalistaisitte	Present
tankkeihin	None
muunnettu	Past
kohdennetaan	Present
nöyryytettiin	Past
alkuaine	None
kohtelevat	Present
rantakukin	None
taistelijoiksi	None
sukaisisin	Present
testannut	Past
määrätty	Past
ylläpidettävä	Present
lumivuohet	None
säännösteltiin	Past
vaivataan	Present
näytti	Past
ohittanut	Past
loukkaisi	Present
podettava	Present
huhua	Present
ryhdistäytyi	Past
kytkin	Past
tarkkaillen	Present
bussin	None
kiusattiin	Past
pysyköön	Present
nykyttänevät	Present
tervaantuisit	Present
painotuimme	Past
kaasuuntuu	Present
ennallistaa	Present
manista	None
lisääntyisi	Present
poikittaiset	None
kaatuisi	Present
mullisti	Past
tukeutuivat	Past
hedelmäsalaatilta	None
jäähdyttävät	Present
laihentuisivat	Present
hyväksyvä	Present
haavoittavat	Present
tunkee	Present
jakobiinit	None
tietämättömäksi	None
demokraattista	Present
näytetty	Past
aiemmilla	None
rekvisiittoina	None
köyristänee	Present
dramatisoitu	Past
ratsasta	Present
mikroprosessori	None
arvottanen	Present
islanninhevonen	None
kukista	Present
likistäydyttäköön	Present
virtasivat	Past
värähtely	None
salaliittolaisten	None
kaivokselta	None
puoliverinen	None
palkittiin	Past
rintasyövillä	None
hautaantuisitte	Present
keskusteltiin	Past
ilmoittautuvat	Present
älykkäinä	None
ihasteleva	Present
paimentaa	Present
muovannut	Past
seostetaan	Present
optiikkaa	None
sirottelisin	Present
aiheutui	Past
heijastui	Past
tissuttaisin	Present
käyttäjätunnuksesta	None
lainailtiin	Past
tuhlaisi	Present
eväs	None
käsineillä	None
jankuttaa	Present
vastahyökkäyksestä	None
vaimennetaan	Present
hulmauttanette	Present
iskettäkööt	Present
vaihdetaan	Present
ryösteli	Past
murhaisi	Present
elokuvakameroihin	None
hahmottuvat	Present
ryöväsivät	Past
pukeutuivat	Past
ratkesi	Past
arvostivat	Past
sävyttänevät	Present
ilmene	Present
eriyttää	Present
kulminoituivat	Past
epäillyt	Past
värielokuvilta	None
värähteli	Past
oudostuttakoot	Present
paljastavat	Present
avataan	Present
junaili	Past
verratkaa	Present
heilauttaa	Present
liikuttanut	Past
institutionaalistuivat	Past
soutivat	Past
aktivoidaan	Present
tahmauduin	Past
edellytetään	Present
ähisty	Past
jäädä	Present
hypitään	Present
pakkotyötä	None
estyvät	Present
rakastettu	Past
todenmukaista	None
peräkkäisten	None
molottakaa	Present
ammattilaistuisimme	Present
mellakoitiin	Past
lajitellaan	Present
hiillosta	Present
vatsakalvon	None
ulvoimme	Past
klovnia	None
välittyivät	Past
purkautuivat	Past
noudata	Present
suojelemisesta	None
seisattakaamme	Present
halo	Present
kavahti	Past
tuhoaisivat	Present
veikkaisin	Present
äänieristetty	Past
polkimen	None
vaimentavat	Present
varjostanut	Past
sisäistänyt	Past
liittäisi	Present
kauhuelokuvien	None
kutee	Present
huhutaan	Present
beille	None
hypetettäköön	Present
suojellut	Past
keräiltiin	Past
viettivät	Past
punktoiva	Present
kuumennettava	Present
periaatteena	None
rajannut	Past
oppineita	None
syventävä	Present
bitit	None
kompleksiluvun	None
hillitse	Present
pahensi	Past
aientanette	Present
pahoinpiteli	Past
suomentanut	Past
levyttänette	Present
pitänyt	Past
viherkaihi	None
mameroja	None
todennetaan	Present
sähköasennusten	None
sisältyvä	Present
vähäisinä	None
hinku	None
jaavalaisina	None
hyppäsivät	Past
johteessa	None
salanimen	None
kokoon	None
markkinoitu	Past
selkeytettiin	Past
puno	Present
suonen	Present
demoneilta	None
ammattioppilaitokset	None
menetysten	None
hillitsee	Present
tuaregeille	None
pestautui	Past
kondiksina	None
viitattaisiin	Present
hehkuttaa	Present
toimielimissä	None
lakkautetaan	Present
pidättäytyi	Past
suututti	Past
poikkeusluvan	None
katsottu	Past
sulautui	Past
tomua	Present
seikkailulle	None
kariutunut	Past
hylyistä	None
valehtelisin	Present
salakuljettanut	Past
ruoti	Past
voimakkuuksina	None
mitoitettiin	Past
laimennetaan	Present
liioiteltiin	Past
kykenisivät	Present
murusta	Present
pyörivä	Present
ylimääräisillä	None
johdoissa	None
imeytyvä	Present
patosi	Past
viilasimme	Past
kampauttakaa	Present
lanttuperhoseksi	None
koivunpuistohapero	None
kojeistettiin	Past
linnoitukset	None
läpäisi	Past
kunnioittava	Present
uikutetaan	Present
vierasta	Present
uppoutuu	Present
kehräävä	Present
pohjolassa	None
sokeutatte	Present
keikkaili	Past
meilatkaamme	Present
kierrättää	Present
säästyivät	Past
pahentavat	Present
syöksevät	Present
missiota	None
taistelukärjen	None
kartellen	Present
harkitsevat	Present
kaksipäiväinen	None
kahnaisi	Present
pitäjää	None
poistivat	Past
ulotti	Past
safkasitte	Past
tuuletin	Past
lähetetään	Present
taistelukentille	None
ryssänrenkien	None
muutan	Present
hirvittää	Present
auttanut	Past
kunnioittivat	Past
laihdutti	Past
tassujen	None
säiliöitiin	Past
merkkasin	Past
salakka	None
ulkoistettiin	Past
ivasi	Past
sivaltanevat	Present
puolusteltu	Past
himmeäksi	None
suoritettiin	Past
teräksistä	None
poikennut	Past
saksalaistunen	Present
ylipainoisena	None
huomautettakoon	Present
toruille	None
kaksikieliset	None
kaksoiselämässä	None
pärjäisi	Present
paskiainen	None
benfotiamiini	None
parametrilla	None
hedelmöittynyt	Past
tulitikkuetiketille	None
laukaisisitte	Present
lyötti	Past
kyseenalaistivat	Past
utelette	Present
puukotettu	Past
säilyisi	Present
hiukkasfysiikassa	None
kannatukset	None
käytimme	Past
etidronihappoja	None
selvittivät	Past
faasista	None
kuljettu	Past
tarjottu	Past
pinnistettiin	Past
pidettäisiin	Present
puren	Present
valokuva	None
seilasi	Past
pakollistettakoon	Present
äänestetään	Present
luomukset	None
noustava	Present
liuottavat	Present
laskuveden	None
rauhoitti	Past
soveltuvuutta	None
läimäätte	Present
hopeamitalein	None
turvattu	Past
robotisoitaisiin	Present
saavutti	Past
ajanmukaistettiin	Past
ahdistavat	Present
ohjausjärjestelmien	None
asensi	Past
kulumiseen	None
voidan	Present
kylmätä	None
eturistiriita	None
pakolaisille	None
tulittavat	Present
nykyisen	None
irrotellette	Present
kateeksi	None
sylyssä	None
heilui	Past
supistuksia	None
epäonnistui	Past
ripsieläimet	None
rapsutetaan	Present
luutunut	Past
uskottava	Present
paahdettakoon	Present
johdinta	None
läänit	None
tulkitse	Present
riidellään	Present
tyylilajissa	None
norjentuisivat	Present
komeilitte	Past
huttua	None
annosteltava	Present
pingottanevat	Present
valaistuu	Present
kiksauttaisi	Present
humanisoinet	Present
tehtaisiin	None
halkaistiin	Past
viljelee	Present
laskettu	Past
laidunnetaan	Present
koittanee	Present
huojukoot	Present
vaihdettu	Past
joutava	Present
pirstovat	Present
ilmentävät	Present
selaillut	Past
tiedettiin	Past
synteettisessä	None
oksetuttakoon	Present
viirupöllöt	None
ohjelmistoissa	None
päde	Present
vaihtelisi	Present
haaroittuu	Present
hapetu	Present
reunustavat	Present
ihailtiin	Past
lennättivät	Past
viruu	Present
vahtimestariksi	None
tavoittaa	Present
pinnistitte	Past
oivaltaa	Present
tunnokkaaksi	None
kaislikossa	None
välttäisi	Present
totottaneen	Present
harhaili	Past
välttyisivät	Present
levytetty	Past
naksuvat	Present
hapannuttu	Past
ikuisena	None
roomalaisina	None
yhdistellen	Present
preussissa	None
spekuloidaan	Present
temmattu	Past
valloittavat	Present
taivutettiin	Past
koostanut	Past
muunna	Present
kompromissilla	None
tarkasti	Past
talvihorroksitta	None
harrasti	Past
kaappaavat	Present
levittyy	Present
liikennöitävä	Present
sokeerattaisiin	Present
ansaita	None
kuivattavat	Present
piilota	Present
läimäyttävä	Present
harjoitettava	Present
rikastuttavat	Present
vetäjänä	None
noidumme	Present
painostaa	Present
paalupaikka	None
selvitelty	Past
muisteltiin	Past
kipristettäköön	Present
putkiremontille	None
spiritistillä	None
karhennuttava	Present
ärsytymme	Present
ääripäinä	None
vety	Present
mangrovelle	None
höyrystyvät	Present
tuplaan	Present
tavoittaisi	Present
astun	Present
menehdyttäneen	Present
kertaiseksi	None
närkästyi	Past
vitsaili	Past
tilastoinut	Past
ravisteli	Past
laboratorio	None
vertaileva	Present
potevat	Present
maileja	None
kiristänyt	Past
lipeää	Present
läimäisevä	Present
kahvituttanette	Present
käänsin	Past
purkkaa	None
ärjykööt	Present
parannettu	Past
laitteiden	None
joukkueisiin	None
unohdetaan	Present
kilvoittelivat	Past
valmistaudu	Present
haketta	None
etsitään	Present
hölpöttäisitte	Present
aatemaailman	None
asusteli	Past
kihlattiin	Past
vertauskuvallisessa	None
havainnoidaan	Present
syvimmästä	None
stoalaisilla	None
heitettävä	Present
tuhlannut	Past
uusiutuvalla	None
leikkikentällä	None
pysäyttäisi	Present
ankkuroitu	Past
printtiliuskoihin	None
saapuva	Present
mailiin	None
saattaa	Present
voideltiin	Past
aiheuttanut	Past
esiintymisistä	None
kellittäisiin	Present
pahentui	Past
selitettiin	Past
tarkoitamme	Present
yltävät	Present
hyväkuntoisina	None
eurooppalaista	Present
haavoittunut	Past
irrottautuu	Present
leppyi	Past
vapaaehtoisin	None
hallituskriisi	None
tarrautuvat	Present
iskeytynyt	Past
jatkukoon	Present
pumppasi	Past
yksityistetään	Present
suurennettiin	Past
pelastaisi	Present
jaavan	None
tietäisit	Present
yllyttivät	Past
lupautuivat	Past
pakottavia	None
paranneltiin	Past
haettanevat	Present
naureskeltakoon	Present
virkavaltaistaisi	Present
kannustetaan	Present
kailotat	Present
nimetty	Past
kulutustavara	None
suljetaan	Present
havaittava	Present
tunnustelisivat	Present
pyöreähköjä	None
nopeuttanut	Past
voimakas	None
laitosta	Present
juridisten	None
pistänyt	Past
kirjava	None
palkintoon	None
eriytyvät	Present
afrikaansia	None
teologia	None
komentavat	Present
vierailivat	Past
hobiteille	None
solmittu	Past
lähetyssaarnaajiin	None
talvisaikaan	None
liikkuvuudelta	None
judoa	None
lausekkeessa	None
kunnostaa	Present
äärimmäisessä	None
haalenisimme	Present
vakautettu	Past
raivattava	Present
kuvailtiin	Past
ironisella	None
lähistöillä	None
upotti	Past
vihlaisevat	Present
pistellyt	Past
vieraillaan	Present
pakinoinut	Past
nimesin	Past
pienennä	Present
ekumeeniseen	None
juorutaan	Present
yksiköissä	None
painijoitta	None
jarrurummuille	None
kostavat	Present
yleistyivät	Past
leimaava	Present
siivilöidy	Present
puukot	None
kuormaan	Present
silmäisee	Present
koittakaa	Present
ryöstellyt	Past
erotettava	Present
pentujen	None
plasmaa	None
panssarimies	None
varjeli	Past
ääntelevät	Present
karmea	None
suuntautuvat	Present
viestijuoksuissa	None
eteläsuomalaiseen	None
pumpannevat	Present
karttui	Past
inhimillistänyt	Past
lopettaisit	Present
jumiutuisitte	Present
salamurhasi	Past
matkassa	None
söisi	Present
veikataan	Present
yllätä	Present
akatemiassa	None
mantrat	None
musiikkijuhla	None
vanhentui	Past
havaitseva	Present
hameeseen	None
merkitsin	Past
pallotelkaa	Present
heitin	Past
järjestykseksi	None
reippaaseen	None
karvaiset	None
nuolisimme	Present
raitista	Present
nepalilaisten	None
korisisivat	Present
valtakunnallisten	None
perimätiedon	None
kahisin	Past
digitoidaan	Present
epävirallisissa	None
hierovat	Present
ominaista	None
taukoavat	Present
maistaa	Present
valun	Present
ahdistivat	Past
kritisoitiin	Past
keräilivät	Past
galleriassa	None
päihitti	Past
erittävä	Present
jäsentyvät	Present
turhuuden	None
kaiversi	Past
kieltäydyttiin	Past
rauhantuomari	None
räjäytti	Past
miellettävä	Present
liikennöinyt	Past
uutispalvelu	None
välttyi	Past
nimittää	Present
varoo	Present
kristillisdemokraattisimpana	None
alentaa	Present
kamppaillut	Past
tasasi	Past
ehdottajien	None
taistelevat	Present
näyttäisi	Present
erottaudumme	Present
protestoitiin	Past
punastuin	Past
virnistettäköön	Present
polveutuu	Present
riko	Present
liehu	Present
vaikuttava	Present
antagonisteina	None
soolokitarat	None
pudottautui	Past
keskiosasta	None
viivyttävät	Present
auta	Present
spastikko	None
muokattu	Past
ilmaisuun	None
kansantajuista	Present
käsittelemättömiä	None
ukkostaa	Present
hyvästelee	Present
unelma	None
hohkunemme	Present
estelisivät	Present
määreet	None
tuurasi	Past
ala	Present
rynnistänen	Present
hermoille	None
laivaan	Present
toivu	Present
sähkömagneettisten	None
paistatimme	Past
palstoittaa	Present
kvantitatiivisen	None
keskittävät	Present
sotkeutui	Past
rakentaa	Present
velvoittanen	Present
soidintanemme	Present
työnsivät	Past
lidokaiini	None
muurataan	Present
hyökkäisi	Present
vaistonnet	Present
sanoutuisivat	Present
köyden	None
paistoivat	Past
luikerteli	Past
säännellään	Present
katkoivat	Past
ulkolaitamoottoreiksi	None
puolustava	Present
pomppii	Present
korsetit	None
aristan	Present
kiintyi	Past
hirnahdettiin	Past
mobilisoitiin	Past
aapinen	None
tutustuttaa	Present
koettakaa	Present
liikenneväyliin	None
valinnaiseksi	None
versoo	Present
kätkenyt	Past
sivuutettiin	Past
viimeistellään	Present
suunnannut	Past
syötti	Past
täytyttävä	Present
kapiteloiva	Present
romahtanen	Present
klikannut	Past
nuolenpäitä	None
polytekninen	None
raastuvassa	None
käytettäisiin	Present
aikailtava	Present
väitellen	Present
itkevät	Present
pitäisit	Present
piirittivät	Past
invaasiot	None
koonnettaisiin	Present
podcastit	None
onnistun	Present
sijalla	None
menestyksekkääksi	None
ajelutettaneen	Present
etabloitunut	Past
kuumensivat	Past
käytätte	Present
kiistetty	Past
nuottakalastuksin	None
päiväsi	Past
avioituu	Present
reservissä	None
telakassa	None
siedä	Present
kurottautukoon	Present
hopeakylkiin	None
sopimuksin	None
vääntyvät	Present
aikuistunut	Past
suojelemista	None
merkkaavat	Present
huviloita	None
voidellaan	Present
ruiskutettiin	Past
kumoat	Present
käännellään	Present
näyttävä	Present
pure	Present
kanjoneita	None
vaikeutuu	Present
käytettäköön	Present
puettu	Past
hytkytte	Present
voimista	Present
syötetään	Present
heittelivät	Past
kulutetaan	Present
säikäytti	Past
lukittuu	Present
tallennettiin	Past
tylsistynette	Present
elokuvasi	Past
kiihtyvät	Present
värjäytynette	Present
viimeistelty	Past
huolestuvat	Present
plussia	None
estävät	Present
koituivat	Past
ryösteltiin	Past
konsertoinut	Past
riemastuu	Present
masinoisit	Present
todensi	Past
saajaa	None
kehityshäiriöiden	None
puskualuksitta	None
sliippasi	Past
kuivausrummuksi	None
varmistuu	Present
yltyivät	Past
muuttuneita	None
epäkäytännöllisen	None
tiilitehtaita	None
sienijuuri	None
herkentyivät	Past
suisti	Past
piristyi	Past
asuntokaupoin	None
luksuksilta	None
räjäytettiin	Past
uidaan	Present
rahoittaa	Present
kokoonpanot	None
jaottelee	Present
raapii	Present
funktioihin	None
uupuu	Present
vaaransi	Past
arvaillaan	Present
vingahtelitte	Past
vahventaa	Present
patistettava	Present
muotoillaan	Present
ääreishermosto	None
laiduntaa	Present
ikääntyvä	Present
siirtona	None
nauhoittaa	Present
lueskelitte	Past
terhakkana	None
espoolainen	None
lainattava	Present
syyllistyvät	Present
kuuroutui	Past
luotti	Past
harmittaisi	Present
vaurioitunut	Past
puhdistettu	Past
luon	Present
lämpöpumppua	None
monipuolistuivat	Past
suunnistivat	Past
murtautunut	Past
uskonluopioon	None
vuosikirjoissa	None
keidassuot	None
valin	None
vihjata	None
apottiluostarin	None
tiputtanut	Past
translitteraatio	None
avioitunut	Past
puutun	Present
asioinette	Present
tervattu	Past
aikuismaista	None
pullistaa	Present
tavoitettaisiin	Present
suomensimme	Past
maisemoitu	Past
toikkaroitiin	Past
mineraalitärpäteille	None
louhintaa	None
kommunistipuolue	None
riensivät	Past
ruohosipulin	None
varoita	Present
hyväksyisin	Present
foorumeista	None
komennettu	Past
substituoiva	Present
nappasi	Past
vihertää	Present
kiirehtänette	Present
vuorattiin	Past
heiluvat	Present
kajonnet	Present
vieköön	Present
sijaitsisi	Present
muistelevat	Present
kirjoittelet	Present
ahdistelee	Present
simuloidaan	Present
tuotettava	Present
päivystää	Present
vältettäisiin	Present
alittavat	Present
vierähdettäneen	Present
innostava	Present
rajoittuisi	Present
hyväksytä	Present
vuohisiin	None
oksia	None
kestävät	Present
suolattu	Past
prässätty	Past
mitoittaa	Present
unettomuudesta	None
vastarintaa	None
päihitetty	Past
ruttotautisista	None
ylipäällikköä	None
viivaintegraali	None
toru	Present
sivistyneen	None
tälläisimme	Present
noudattelivat	Past
pysähtyisi	Present
operoidaan	Present
argumentoidaan	Present
ennallistettiin	Past
tarkastaisi	Present
hymyilee	Present
ruudukko	None
tulkittiin	Past
liioittelee	Present
säännöstellään	Present
kierikööt	Present
puristivat	Past
mahdu	Present
siirrettävällä	None
kuristava	Present
laajennettiin	Past
totuttauduitte	Past
saarnasi	Past
hyödynnettiin	Past
intensiivikurssiin	None
ftaalihapoissa	None
shakkilauta	None
uhrautuva	Present
eriytyivät	Past
kloonasi	Past
roottoreiksi	None
säily	Present
kokevat	Present
aksiooman	None
ammattiliitto	None
kreivitär	None
rajat	None
lipuu	Present
lokasuojat	None
ilmaantuu	Present
keynesiläisiä	None
prototyyppi	None
nimekkään	None
järkevästä	None
värjätty	Past
frikatiiviksi	None
tajunnut	Past
periytyvä	Present
jalkatukea	None
edellyttävät	Present
listaavat	Present
epämiellyttävää	None
eristä	Present
erotu	Present
laulanut	Past
kunnioittavaa	None
luukudoksille	None
möivät	Past
kiristyvä	Present
laajahko	None
riskeihin	None
toivottomuus	None
rykmenttien	None
eduskunnasta	None
hertut	None
sallii	Present
opasta	Present
vaivaavat	Present
paistaa	Present
selvittämättöminä	None
loikonut	Past
muinaisnorjan	None
päivitettiin	Past
kertyvä	Present
vaiennut	Past
tonkii	Present
isännöivä	Present
muokkaisi	Present
kansalaispalkoilta	None
eläköityi	Past
epärehellinen	None
evankelisluterilaisen	None
vahvistunut	Past
maistuvat	Present
synnytettiin	Past
kiivastuttaisi	Present
ansaitsee	Present
heinähatun	None
sijoitti	Past
haalasin	Past
hidastuivat	Past
syyhyn	Present
katselevat	Present
öljyävä	Present
valtiopäivämiesten	None
haaksirikkoutuvat	Present
neitsyenä	None
singleiksi	None
pussihukan	None
erehdyttää	Present
ajantasaista	Present
syöksyä	None
ilmaan	Present
etsiytyvät	Present
liukuu	Present
ilahtui	Past
osallistui	Past
tyrkyttää	Present
kätkeytyi	Past
typerä	None
lönkytän	Present
aroihin	None
huoltavat	Present
seuraaviin	None
rajoittanut	Past
pedoilta	None
reagoidaan	Present
jyryyttäisitte	Present
yksikköhinnoista	None
traagista	None
esittäisivät	Present
höyrystyi	Past
uudistuvat	Present
murrettiin	Past
hahmottavat	Present
asetutaan	Present
pysytään	Present
pämpännemme	Present
nipistelimme	Past
taajuudelta	None
painottunut	Past
läpäisee	Present
ehdollistunut	Past
varjeltu	Past
konsultoiva	Present
tekemisten	None
kätketty	Past
ihmettelisimme	Present
oksasta	Present
pettymyksestä	None
metsästävä	Present
kasvatettaisiin	Present
äänimäärällä	None
risot	Present
funtsittiin	Past
laajeni	Past
portaissa	None
rauhoittanut	Past
säästetty	Past
huohottimelle	None
alimpiin	None
magnetoenkefalografialle	None
ruopattu	Past
tunkeilemme	Present
liukene	Present
kaivettiin	Past
edennyt	Past
korahtaisitte	Present
peräpään	None
mahtaillemme	Present
muunnelmana	None
laskuvarjoja	None
sepittänyt	Past
rokotetaan	Present
ennustettu	Past
kanavoitu	Past
epäonnistunutta	None
jaoteltu	Past
kastautunevat	Present
punovat	Present
tutusta	Present
hävitti	Past
latasin	Past
modifioitu	Past
kuusikulmaisten	None
eksytte	Present
järkiinnyttiin	Past
työstä	Present
hekumoisi	Present
aplikoikaamme	Present
paronit	None
siroteltiin	Past
herkentänette	Present
katalyytti	None
pronssannette	Present
neulottu	Past
konsoleille	None
kipaisisi	Present
dominoinnista	None
originaalikappaleille	None
hakeutuu	Present
käsitän	Present
yhdistelee	Present
diskvalifioisitte	Present
mukautunut	Past
kehräytettiin	Past
kumosit	Past
miljöineen	None
isoja	None
telakoituu	Present
subaraknoidaalivuoto	None
uurtanut	Past
kärjistyvät	Present
ponnistelee	Present
latinisoitu	Past
kuivunut	Past
toistui	Past
aloitteikkaammilla	None
litkisi	Present
päivittäisi	Present
identifioidaan	Present
aikaansaanut	Past
splini	None
kromaatit	None
neuvoteltava	Present
kauppatavaran	None
määrittelee	Present
tarvitsin	Past
motivoitunut	Past
valkeahkoja	None
ruokasuolaan	None
ruiskuttavat	Present
alisuoriutumisetta	None
sairastaa	Present
itkenyt	Past
räjäyttää	Present
vuorijonojen	None
muodikkaiden	None
jäsentyy	Present
klubissa	None
puhalsi	Past
laajenevat	Present
ilmiannettiin	Past
pudottavat	Present
haihtuisi	Present
verstaassa	None
uhkailevat	Present
linnoitettiin	Past
pukivat	Past
hio	Present
paikallistettu	Past
tulkataan	Present
kiitotietä	None
koputellen	Present
dolfiinilla	None
krinoliini	None
peittäisi	Present
muokkaava	Present
esittelisi	Present
selkiytyy	Present
ajelevat	Present
liuotetaan	Present
kiitettiin	Past
pierren	Present
tungetaan	Present
halkesi	Past
lyhentyisivät	Present
vieroksuu	Present
rustokalat	None
soittaisi	Present
pystyakseli	None
sellolle	None
maskotiksi	None
tukanleikkuutta	None
hyödyttävät	Present
keskeytän	Present
ennustajan	None
suuntasi	Past
keinauttanen	Present
painanteet	None
kunnioittavat	Present
altisti	Past
järjestelin	Past
tarkkailtava	Present
kysyttävä	Present
harustetuksi	None
veneilystä	None
vuodatetaan	Present
estävä	Present
eristää	Present
kisataan	Present
varioidaan	Present
laukkaavat	Present
rekrytoitiin	Past
kuulokoiriin	None
selvitin	Past
ammattitaitoista	None
silmäilty	Past
puuseppää	None
selventäisi	Present
tasoitettava	Present
kietouduttiin	Past
lähentäkää	Present
liikennemerkillä	None
valotetaan	Present
valmista	Present
ostettu	Past
jälkeenjääneistä	None
radioitu	Past
kollegan	None
sekaan	Present
rationalisoitaisiin	Present
autamme	Present
miehittävät	Present
käännettiin	Past
tulevaisuuden	None
pantheonista	None
hymyilevä	Present
filosofoinee	Present
kypsyy	Present
haistoi	Past
editoitu	Past
monipuolisen	None
laskutetaan	Present
virkisti	Past
kohota	Present
pirstoutuisin	Present
salkoon	None
kätkee	Present
uskaltaisi	Present
juovakenguruilla	None
istuttivat	Past
aikauttanee	Present
agglutinoitakoon	Present
ryyppylaseitta	None
pidon	None
genetiikan	None
maatunut	Past
oksentaa	Present
diggaan	Present
muokattava	Present
koputtele	Present
pursotitte	Past
esso	None
plussa	None
magneetti	None
liialliselta	None
kapeat	None
leveillä	None
synnytä	Present
tymiini	None
kärjistänevät	Present
työskentelivät	Past
ryöstelivät	Past
jaat	Present
ylistetty	Past
saavuttiin	Past
stereotyyppisiä	None
kirjannut	Past
huomaat	Present
nousivat	Past
rapautui	Past
kasapanos	None
tekijäksi	None
sisäistää	Present
peräpää	None
syöttävä	Present
denaaria	None
sisäkaton	None
menettelee	Present
heterografteihin	None
kasvitieteellisissä	None
organisoinut	Past
butadieenin	None
torpparina	None
kysyt	Present
kullattiin	Past
tajusin	Past
astu	Present
valloitti	Past
vaikutat	Present
ilmasuojaa	None
halvaantuu	Present
turmeli	Past
samaistettiin	Past
huomaan	Present
kiinnitti	Past
sensuroidaan	Present
aerodynaamisten	None
täsmällisyyteen	None
olympiaveneellä	None
hinattava	Present
kuvailtu	Past
tempaistaan	Present
vaurioittavat	Present
laikkaan	None
järjestyvät	Present
hieroutuu	Present
liittoutuu	Present
harmittanut	Past
paisuu	Present
azerintaisimme	Present
maajoukkueesta	None
tallettanevat	Present
aseistautuivat	Past
hikevät	None
kunnanhallitukseen	None
paheksunut	Past
minkälaisesta	None
galicia	None
kommentoidaan	Present
kohenivat	Past
tekstiviestien	None
voimakkuudet	None
imaisee	Present
jippoilkoon	Present
huhuillevat	Present
niukkojen	None
avustetaan	Present
nukutuslääkäreiltä	None
yksilöllistä	Present
kortistoitaisiin	Present
kuvittivat	Past
veisattiin	Past
murtautui	Past
pohjaavat	Present
määrätään	Present
tunnistettavalla	None
kaariminuutin	None
läntiset	None
talvehtinut	Past
katalysoiva	Present
näppejä	None
vaivat	None
motivoinut	Past
kävelytä	Present
samastui	Past
jälkijäristyksiä	None
katkaisivat	Past
ravistettava	Present
monimutkaista	Present
opetellaan	Present
fermiumein	None
kärjistetty	Past
langettanut	Past
ainesosilla	None
rasvaantuisin	Present
pyöritään	Present
mikin	None
kaartakoon	Present
käskivät	Past
massiivisella	None
majoitti	Past
goottilaisessa	None
haihdu	Present
heittäisi	Present
ennustuksesta	None
keltakuumetta	None
matkii	Present
manipuloitu	Past
puhaltavat	Present
konfirmoitu	Past
polkupyöräilijöiden	None
tiloista	None
kertyivät	Past
aamukirkotta	None
miehittää	Present
kahlitsemme	Present
pinnallistu	Present
rationaalista	Present
rauhoitteli	Past
käynnistyy	Present
aloitit	Past
arvostelijat	None
mestaroitiin	Past
alvejuuresta	None
määräytyisi	Present
eristävä	Present
verijuotikasta	None
haalluit	Past
rahasta	Present
loppuisi	Present
keinoteltakoon	Present
heikentää	Present
iskuvasara	None
tonneissa	None
kasvinsyöjiä	None
ajattaa	Present
nimittivät	Past
ilmaisuina	None
menestyvästä	None
venäläistää	Present
määräydy	Present
levyttää	Present
jäsennetty	Past
puoliintuvat	Present
trilogiasta	None
parantaisivat	Present
lukitsi	Past
multiversumeineen	None
tuijotan	Present
vaihtelee	Present
luottaisin	Present
ohuehkossa	None
päivitetään	Present
linnoitukseen	None
karhennuttiin	Past
piipahtaa	Present
protestoinut	Past
uitellevat	Present
elpymistä	None
sekaantuivat	Past
pelkistetään	Present
alentavat	Present
vähittäiskauppojen	None
heikentyi	Past
eukaryooteissa	None
synkeää	None
halventuivat	Past
ylistän	Present
yksipuolistuttiin	Past
aarrevalkealle	None
saatan	Present
kietoutuu	Present
ihmiskaupasta	None
polvista	Present
inhimillistä	Present
mitätöitiin	Past
jäätikköjen	None
rekisteröidään	Present
tajua	Present
riisutaan	Present
rokottaa	Present
yöpynyt	Past
valmensivat	Past
sporttimalleja	None
korvasivat	Past
kohtasin	Past
karsittu	Past
korvaantui	Past
opiskele	Present
inspiroinut	Past
kauhistava	Present
vakiinnuttavat	Present
vainu	None
väkevöidään	Present
materialisoisitte	Present
pidit	Past
tallennat	Present
rahoitusjohtajana	None
otsikkoaineena	None
ymmärtäisin	Present
mutkistuu	Present
aktiviteetteihin	None
seisaketta	None
räjähtivät	Past
halkaisevat	Present
evästä	Present
mobiiliin	None
veny	Present
koskettanut	Past
kannattajissa	None
lokeroinen	Present
matkusta	Present
puolustanut	Past
naaraan	Present
uskonut	Past
loitsut	None
ohjaukset	None
jahtaavat	Present
lauletaan	Present
saata	Present
putsaat	Present
vandalisoitu	Past
nivot	Present
nujerra	Present
kannabinoideihin	None
konttaavat	Present
kytkenyt	Past
surkutelkaa	Present
läpäisevä	Present
holistoonasimme	Past
hupenee	Present
hyväksyttävyyttä	None
entisöinyt	Past
riippuu	Present
hyökkäävät	Present
huolestunut	Past
aloin	Past
välitän	Present
tutkittiin	Past
majaili	Past
ropsikaa	Present
maailmanmestaruus	None
ansiottomin	None
kaivettava	Present
kastellaan	Present
riehunut	Past
rummuttivat	Past
helpottunen	Present
livertänemme	Present
linjaukseen	None
sijaista	Present
meinasi	Past
eetteriin	None
synnynnäisestä	None
hätkähdytti	Past
olympiahistorian	None
riisuttiin	Past
allekirjoitettu	Past
laudoittaa	Present
lävistäjän	None
kokoontuivat	Past
kaikerrettava	Present
rakastaa	Present
ulottui	Past
noutava	Present
viritti	Past
adrenaliineilta	None
rautakoristeita	None
alat	Present
kahdenvälisiä	None
syöppöydellä	None
alaheimojen	None
kaivosmiehiä	None
risteilyillä	None
sammu	Present
ateenalainen	None
kolminkertaiseen	None
vesitiivistä	Present
kivespussissa	None
imputoinnit	None
vähätellään	Present
tunnustaisi	Present
portaiden	None
eläinkaupasta	None
euroja	None
juontunee	Present
tuhoaminen	None
kirkaissevat	Present
kutistunut	Past
virroittavat	Present
orneeraisivat	Present
raatsinee	Present
koosti	Past
ahdistettu	Past
jäähdytettiin	Past
varoittivat	Past
perunut	Past
fuusiojazzista	None
kirstun	None
tasoristeysten	None
viuhahdettakoon	Present
sormeilisi	Present
edistettiin	Past
veneilijät	None
merkitsevä	Present
vaikene	Present
rauhoittui	Past
kodittomuutena	None
asuttivat	Past
rakennuttajina	None
keksinnöille	None
erottunut	Past
nopeudet	None
turvaudutaan	Present
tooraan	None
tunnustuksen	None
hiihti	Past
höyhensin	Past
vilisevät	Present
ylipukeutunut	Past
julkaisuille	None
resitoinut	Past
ihannoinnista	None
kirjailtu	Past
avustettava	Present
osataan	Present
taipuvat	Present
päällystetään	Present
arktinen	None
vieraasta	None
noudatellen	Present
pohjautukoot	Present
kirmasi	Past
kromikeltoina	None
kaapeloikoon	Present
mekon	None
hoo	None
jääkiekkoillemme	Present
suuressa	None
suostu	Present
juontanee	Present
transkriboikoot	Present
järjestyy	Present
saumaan	Present
amiinit	None
raivattiin	Past
ennustetaan	Present
hiivan	None
korosti	Past
hohkannevat	Present
kvantifioisitte	Present
seksismi	None
sekaantuu	Present
kadonneina	None
kulkutauti	None
akateemikot	None
föhntuulille	None
muutti	Past
raakkukoon	Present
selvitettiin	Past
jännitti	Past
ydinkasvilta	None
myrkytti	Past
käsitteissä	None
kohdeltaisiin	Present
kaivetaan	Present
puhdistuu	Present
rikastuttaa	Present
väritetään	Present
keitättäköön	Present
avaisi	Present
hurjistava	Present
moukuisimme	Present
puhallettiin	Past
kohentui	Past
kansoitti	Past
poikii	Present
jylhenisimme	Present
ajastatte	Present
elokuvamusiikki	None
harkittu	Past
säästyisi	Present
ilmestyy	Present
diskattu	Past
meediot	None
pankkiryöstöön	None
kysytty	Past
korvensimme	Past
taskukirjoja	None
vahingoitetaan	Present
harppauksen	None
vältettävä	Present
ankeriasmaisilla	None
sylkäisi	Past
tasoittui	Past
laukaisee	Present
väkevöittäisit	Present
kylvi	Past
sooloja	None
pisittävä	Present
uutettu	Past
vahingoita	Present
sokaistiin	Past
teurastuksissa	None
kompensoidaan	Present
maustetaan	Present
toistaisi	Present
palkattava	Present
jumiutui	Past
elliptisillä	None
tuijottava	Present
istuvat	Present
nyhjätetään	Present
autoimmuunisairauksiin	None
elokuvastudion	None
luonnista	Present
uudistivat	Past
inhosivat	Past
aikaansai	Past
sivuta	Present
kääntää	Present
kirjoitusvirhe	None
vitsailee	Present
käännytti	Past
perustuivat	Past
himmeni	Past
lyyhistyy	Present
sidottiin	Past
löydettävä	Present
aavikoitunut	Past
elänyt	Past
lejeeraisit	Present
uskomattoman	None
aatesuunta	None
takaraja	None
pinnoitteesta	None
kolminkertaisti	Past
houkuttavat	Present
haastoi	Past
pienensin	Past
vaikeutunut	Past
uhkailtiin	Past
erilaistamme	Present
rengasmaisen	None
veistoksilla	None
tuotettaisiin	Present
pienestä	None
pieksää	Present
maistui	Past
feodalismista	None
luovuin	Past
notkahdit	Past
liitännäisen	None
johtuisivat	Present
rohkenen	Present
lihoa	Present
pidennettiin	Past
kuvittelivat	Past
arkkiveisujen	None
sallikaa	Present
rauhantekijästä	None
takissa	None
haluaisimme	Present
hylkivä	Present
näyttäkäämme	Present
oleilivat	Past
kartutetaan	Present
paranisivat	Present
tilastoinette	Present
kosteaan	None
piinaavat	Present
imenyt	Past
pitäisi	Present
heitellen	Present
oppikaa	Present
lihansyöjät	None
kansantarujen	None
metelöinemme	Present
estäisivät	Present
konditionaali	None
makuuhuoneita	None
leimannut	Past
uomiin	None
tuhkaamme	Present
romahda	Present
juontava	Present
vanhentaa	Present
kiillotut	Present
ilmoittanut	Past
huomataan	Present
kuntouttava	Present
pukeutuvat	Present
syrjähypyiltä	None
kuurasivat	Past
luotit	Past
kaatosateen	None
kymmenvuotiaissa	None
korvasi	Past
osma	None
tervehti	Past
keskustele	Present
monistaa	Present
tuomitsi	Past
murskaavat	Present
pelimerkkejä	None
soita	Present
isoentsyymeineen	None
lohduttaa	Present
taipunut	Past
aldehydit	None
kauhdut	Present
yhdistelevät	Present
suhtautui	Past
moottorilla	None
suojelkoon	Present
tarra	None
salattava	Present
kutitamme	Present
epäinhimillisiin	None
sekunda	None
ajoittuu	Present
mustakarhuja	None
tarjoilevat	Present
jatku	Present
vaikutin	Past
arvailen	Present
kukistuu	Present
opiskeli	Past
hipova	Present
luottaa	Present
löröteltäköön	Present
hämmentävä	Present
siltaan	Present
katsojissa	None
suhtauduttava	Present
hiottiin	Past
kehuu	Present
ansaittu	Past
operaatioanalyysillä	None
yritimme	Past
genomiikka	None
vaaniva	Present
poimittiin	Past
välittävät	Present
uurasti	Past
omaksu	Present
kristologia	None
varastoiva	Present
tuule	Present
horjunut	Past
valikoiva	Present
soluttautuvat	Present
smaragdin	None
heimoista	None
nikotiineista	None
suositetaan	Present
taannut	Present
työllistyivät	Past
esikatseltava	Present
havaitsemme	Present
maamerkkeinä	None
juolavehnän	None
tykkäsi	Past
jäsentää	Present
kulminoituu	Present
šintolaisuudesta	None
kammitsoisin	Present
tiedetään	Present
matkusti	Past
täydensin	Past
löyhdytti	Past
kungfutselaisuudessa	None
puolusteli	Past
konsernista	None
flambeerataan	Present
johdatteineen	None
vituttakoot	Present
onnellista	Present
laajentuva	Present
jouduttaa	Present
cembalon	None
entistä	Present
kunnioitamme	Present
kasautui	Past
jakanut	Past
saavuttanut	Past
läikytät	Present
mallastakoon	Present
tuntee	Present
tiivistetään	Present
ratkesivat	Past
johtoasemassa	None
sauvon	Present
tarvitsen	Present
kuivuu	Present
lumosi	Past
kiinniotto-oikeutena	None
täplittävät	Present
pienennetään	Present
näyttävät	Present
puhdistettava	Present
vilkkuluomiin	None
niittää	Present
langettaa	Present
hetkauta	Present
ruuvattiin	Past
pyhitetty	Past
kiertykäämme	Present
kannatettava	Present
pureskelija	None
söhlitään	Present
väreillä	None
varoiteltiin	Past
editoinut	Past
kuoriutui	Past
pessyt	Past
altistavat	Present
niskoitellaan	Present
ilmestyvä	Present
nousunopeutena	None
savutti	Past
ommeltu	Past
suojeluskunnassa	None
alkaa	Present
unkarinkielinen	None
standardoidut	Present
laillistuta	Present
langennut	Past
lopullisia	None
brasiliankorvalepakolla	None
ohjelmoisi	Present
makeissa	None
romutti	Past
kuohua	Present
erityisopettajaksi	None
levytitte	Past
ohjautuu	Present
kantamaan	None
katkeroitui	Past
yrjöä	Present
mestasivat	Past
vastaanotin	Past
hälyttävät	Present
lätkäissyt	Past
halvauttanemme	Present
kuljetin	Past
kaasupilven	None
syveni	Past
aiheutetaan	Present
niisittivät	Past
pahoitti	Past
kirjaimelle	None
haluan	Present
iivanat	None
toimitti	Past
syyttelitte	Past
emiirille	None
ilmaisivat	Present
väkevöitettäisiin	Present
viimeistelee	Present
lahjoittivat	Past
koostuisi	Present
kehittelivät	Past
vapauttanut	Past
lamaavat	Present
pilakuvin	None
siirtymiä	None
aatelistolla	None
käytin	Past
öljykangastakin	None
standarttia	None
kolkannevat	Present
risteää	Present
naureskeli	Past
saapumiselle	None
sairain	None
rietastelisin	Present
erehdyttänen	Present
suhtaudut	Present
biennaaliin	None
senttiä	None
puvusti	Past
herättäisivät	Present
itäpuolella	None
helpottuisimme	Present
langetamme	Present
merikarttoja	None
lanseerattiin	Past
valvoin	Past
sekaantuvat	Present
sosiaalistamme	Present
aiheuttaisivat	Present
romahtaisit	Present
korjaavat	Present
läviköistä	None
dieselkäyttöinen	None
piinattu	Past
laillistettu	Past
tieteen	None
kohonnut	Past
karjatilan	None
kaivaisi	Present
kuljettajat	None
strutsilintuineen	None
tarttuvat	Present
helpottaisivat	Present
täyttäisi	Present
naputtelen	Present
punoi	Past
selostavat	Present
sanonut	Past
karjalaisia	None
jatkoin	Past
aktiivipalveluksen	None
oudoksuisitte	Present
lahjoitetaan	Present
sujuisi	Present
huvimaja	None
tehostavat	Present
suositeltu	Past
haaksirikkouduttaneen	Present
lämmitteli	Past
rajoittaa	Present
painotettiin	Past
ventattava	Present
oikeistosiipeen	None
hilaavat	Present
riisu	Present
synnytin	Past
suomensin	Past
maitohorsma	None
sanelisi	Present
suosittelee	Present
valikoituivat	Past
lihaspunilta	None
kietoutui	Past
devonikaudelta	None
juoksivat	Past
huutopusseihin	None
isontuu	Present
nirsoilisivat	Present
tuovat	Present
sääntelevä	Present
grillattu	Past
ponnessa	None
pelota	Present
harjoittavat	Present
kaavamaista	Present
sijoitu	Present
yhdistellään	Present
pysytellen	Present
jaavalaiset	None
kaka	None
syössyt	Past
kaivannut	Past
turpiaalia	None
mutristivat	Past
pakittakaa	Present
nimennyt	Past
tiluttanemme	Present
jäähdytetään	Present
helpottunut	Past
rakennan	Present
ulkoilevat	Present
matkannut	Past
anglonormanneista	None
vakuuta	Present
lumiauroissa	None
vaihdu	Present
uutistoimistot	None
katsoin	Past
toipunevat	Present
laukeava	Present
sekasin	Past
tarvitseva	Present
videoitu	Past
joukkotuhoja	None
kuolleelta	None
jäsenmääräksi	None
sivilisoitukaamme	Present
raikuvat	Present
kiehtova	Present
leikkipuistossa	None
läpäisette	Present
muuttoreitin	None
liitännäisvaltioihin	None
kartoittaa	Present
innostui	Past
valmisteli	Past
pyörrettä	None
jäykistetty	Past
nyrjäytti	Past
tottelemattomuuksissa	None
voimanlähdettä	None
sunnilaisen	None
tuoksua	Present
loistettiin	Past
sotii	Present
paljastanut	Past
allekirjoitusten	None
ansioidun	Present
starttasi	Past
vajoavat	Present
irtaantuu	Present
proosamuotoisilla	None
hikiseen	None
markalla	None
rentoutuvat	Present
kumuloidutaan	Present
aiheuttava	Present
nyökytelty	Past
kiteytyvät	Present
pohjavettä	None
burjaattien	None
rauhoittuisi	Present
unohdan	Present
nielemistä	None
siteeraavat	Present
ahtakoon	Present
pilkkoutuu	Present
vuotatte	Present
tuomitsevaa	None
lensivät	Past
pitkäikäiset	None
muslimeilta	None
verotatte	Present
käynnistystä	None
ruhjoi	Past
siirtolassa	None
profiloikaamme	Present
kannusta	Present
selkeyttävä	Present
mestaruus	None
ratkoo	Present
perustelit	Past
pehmittää	Present
liikun	Present
risteävä	Present
tammukoitta	None
kutistui	Past
murhetta	None
hoputettaneen	Present
kunnioita	Present
äestellee	Present
uurteiden	None
varon	Present
lueta	Present
sisältävät	Present
esittäisin	Present
kastoivat	Past
vioittuu	Present
otusten	None
taio	Present
filippiiniläisiä	None
pääpainon	None
panettelijat	None
koosta	Present
turhautui	Past
kyrpinevät	Present
hiipinevät	Present
varastoidaan	Present
kehitysvaiheiden	None
palvonta	None
himoitsee	Present
vaikuttuu	Present
kirjasivat	Past
syntymistä	None
rauskussa	None
kalkittu	Past
läikkyy	Present
kuvansi	Past
siirtymänä	None
menneenä	None
yhtyvät	Present
toimikautta	None
ekonomeilla	None
äänestän	Present
aseistautuneina	None
tunnustaisivat	Present
vaihtuivat	Past
kuuraan	Present
lemmitty	Past
lähentäisin	Present
surmattava	Present
loistaisitte	Present
järkiperäistä	Present
vaikeni	Past
nikkeliä	None
mielenmuutoksin	None
merirosvoina	None
autokauppiaan	None
seksipommeiksi	None
absorboituvat	Present
henkirikos	None
nesteytynyt	Past
puitu	Past
rajoittavat	Present
roskakoriin	None
siipikarjaa	None
mahakelkkailuineen	None
jakobiini	None
kehiteltiin	Past
hypittänette	Present
rämässä	None
peruskorjattiin	Past
vannotaan	Present
tulkitsin	Past
tottuvat	Present
satuta	Present
tietoyhteiskuntaan	None
majoitettiin	Past
ylittäisi	Present
vertaili	Past
mahdetaan	Present
tuulettaa	Present
muuttaa	Present
enteilevät	Present
kulkee	Present
katselivat	Past
sammuttaa	Present
huuhdottiin	Past
pidentää	Present
hankkisi	Present
epäpuhtauksista	None
nuuhkitaan	Present
manailkoon	Present
liudan	None
loukkaava	Present
sekoittuu	Present
täyttyi	Past
korvaisi	Present
laittaisin	Present
kirjontatyöksi	None
uikkukanana	None
hermostuisin	Present
muriseva	Present
skematisoisitte	Present
törmäytin	Past
rituaalin	None
lietsoi	Past
kasteltiin	Past
kiintyvä	Present
piinasivat	Past
opittu	Past
luonnistu	Present
siirrät	Present
kutosista	None
painottaisin	Present
prefektinä	None
sotisi	Present
toteutettaisiin	Present
föönaisivat	Present
improvisoitu	Past
poistuivat	Past
purskahti	Past
näin	Past
mitannut	Past
oppiainetta	None
luopuisimme	Present
hidastin	Past
heitettiin	Past
suuttunut	Past
kasvatusvanhemmitta	None
verihiutaleiden	None
pienentyy	Present
kukoistuksesta	None
sävelletään	Present
luvallinen	None
märkivä	Present
puskutit	Past
tallentuvat	Present
sävellajeihin	None
maistuvaiselle	None
hidastu	Present
missiyksineen	None
reagoitu	Past
hukkaan	Present
työskentelee	Present
arvioiva	Present
kyseenalaistettiin	Past
yhteenlaskettu	Past
ensisijaistettaneen	Present
sauvonnat	None
vahingoitti	Past
tunkeudu	Present
tasaisin	Present
aikavakio	None
ryöstetään	Present
ailahtelisimme	Present
televisiokanavista	None
kuohu	Present
vieritti	Past
propionialdehydissa	None
öllöttäisit	Present
kävelykaduksi	None
riistäytyivät	Past
sauhuaisin	Present
ratkottu	Past
lumoutukoon	Present
patologisen	None
tulosteita	None
vastataan	Present
lähestyisi	Present
muotoutunut	Past
maailmanmatkaaja	None
pystytettävä	Present
heijastuu	Present
mutainen	None
avasi	Past
ihmisvihaajaa	None
nummea	None
väheksyivät	Past
luotettu	Past
kellerryttäköön	Present
kutistuivat	Past
puhelin	Past
hinnoitit	Past
tulkitsen	Present
teettävät	Present
taisi	Past
vakinaistaa	Present
toteuta	Present
seiso	Present
epikurolaisuuteen	None
paasasivat	Past
päädyt	Present
samanaikaisia	None
tulittaa	Present
pukeutunut	Past
fluoritetaan	Present
lainelautailevat	Present
tasaisemman	None
suhtauduttiin	Past
magmakivi	None
luuttua	Present
provosoikoot	Present
taantunut	Past
sitoudun	Present
astunut	Past
nykyaikaistettu	Past
lätkäisty	Past
autonomisista	None
aktiivihiilineen	None
luettelisi	Present
yskittäisin	Present
yhteistyöhaluinen	None
syöttänyt	Past
näytät	Present
vanhennat	Present
julisti	Past
mustamaalataan	Present
iskulause	None
ilmoittautunut	Past
sähkölaitteen	None
sirkutettaisiin	Present
toistava	Present
suodatin	Past
kiusaantunut	Past
ärsyyntyy	Present
lisättäisiin	Present
nastan	None
desinfioinen	Present
hyödynnettäisiin	Present
irtautuivat	Past
logoksi	None
norjistettava	Present
kokoonnutaan	Present
jatkavat	Present
syttynyt	Past
lisääntyi	Past
romantisoitu	Past
moninkertaistuvat	Present
hellittäkäämme	Present
välkkyy	Present
tummentaa	Present
syvenivät	Past
keikautimme	Past
itsenäistynyt	Past
viivain	None
jäljitelty	Past
ylistettiin	Past
sammuttamisitta	None
kasannette	Present
latinalainen	None
uudistavat	Present
varustettiin	Past
kivikkosirkulle	None
etsikää	Present
hallinnoidaan	Present
nauhoittanut	Past
tuhoutuva	Present
vakuuttavat	Present
haluta	Present
sopimuksessa	None
salkkuja	None
betonivallien	None
länsituuli	None
heijastunut	Past
imettää	Present
määrittele	Present
heikkenee	Present
selkenee	Present
varjonyrkkeilee	Present
etujärjestö	None
tartutettava	Present
vilahtava	Present
mandariinikala	None
syrjäytyivät	Past
povattu	Past
metallurgin	None
avaruudellisia	None
pienennysmuotojen	None
eristettiin	Past
kasautuu	Present
prelaatti	None
väitin	Past
nyökännemme	Present
kiivettiin	Past
oletettu	Past
tyhjiöön	None
madellut	Past
korinttilaisia	None
kääritty	Past
perehtyvät	Present
värjäytyy	Present
selkärankaisten	None
nidottu	Past
kaiutin	Past
pidättynevät	Present
sinkinnyt	Past
luonnehtinut	Past
kirjoitettaisiin	Present
viritettiin	Past
sanoitettiin	Past
baijerilaiset	None
hipaisee	Present
määräytyy	Present
maatukaa	Present
verottavat	Present
levypallot	None
sisäistettäisiin	Present
haavauduttaisiin	Present
viipyy	Present
tarkkailee	Present
huorannette	Present
sotinut	Past
valotusaikoineen	None
nouseviin	None
ymmärsi	Past
helähdelköön	Present
mokailisi	Present
jauhoivat	Past
kointähteen	None
pistettävä	Present
opiskeltava	Present
lisäisi	Present
pienuudesta	None
kuvattu	Past
esittäytyvät	Present
yllytettiin	Past
mahdollistuisi	Present
sijoitukselle	None
patentoitiin	Past
hedelmöittyvät	Present
kirjottu	Past
proletaari	None
pikeettä	None
jutellut	Past
tarkistettaisiin	Present
puukottivat	Past
tuohdun	Present
valehtelevat	Present
kohdellen	Present
kanaalit	None
lipeä	Present
hiekanjyviä	None
heitellään	Present
väänsi	Past
katsova	Present
järjestelee	Present
naulataan	Present
tyhjennettävä	Present
sorattakoon	Present
ferriittiä	None
jakautuva	Present
opetuslapsille	None
suolaan	Present
kässättävä	Present
harrastanet	Present
versioiden	None
kalkkaatta	None
tukahdutetaan	Present
täydennetty	Past
levitetty	Past
magneettisuuden	None
kuskaisimme	Present
sieventää	Present
käsitettiin	Past
lenteli	Past
kahvilasta	None
antisemitismiin	None
väännä	Present
venyttää	Present
mitoitettu	Past
patruunan	None
sprinttihiihtoja	None
kulkuneuvoksi	None
tragediasta	None
ihailivat	Past
ahdetulla	None
kohdistunut	Past
hoitotyöstä	None
vaipui	Past
kruununsiirtomaan	None
hankkiutuvat	Present
hirttivät	Past
torumme	Present
tyydyttynyt	Past
kohtaloa	None
pilaria	None
pehmitettäköön	Present
liitin	Past
valjastettu	Past
menehtyi	Past
vahvenee	Present
leikkii	Present
huolestuttiin	Past
aatesuunnan	None
leiriytyivät	Past
puhjeta	None
aallonkorkeus	None
seivästä	Present
kiilasivat	Past
katson	Present
sambaavat	Present
pikeä	Present
osallistuttava	Present
konsonanttien	None
pidättänyt	Past
metioniineilta	None
nikkeli	None
leijaili	Past
kaunistellette	Present
vakinaistivat	Past
harkittiin	Past
houkuttaa	Present
hiljenivät	Past
laitettaisiin	Present
palautunut	Past
prosentein	None
apulaisjohtajaksi	None
ummuille	None
notkeuduttaneen	Present
yöpyivät	Past
hallinnoiva	Present
baaritiskeineen	None
vakuuttuivat	Past
unohdettu	Past
voiti	Past
diivaillen	Present
määytään	Present
ehdotan	Present
akkreditoitu	Past
päivämäärien	None
tsaarinvallan	None
lämpökäsittelyllä	None
kapitalistisissa	None
pelkistynyt	Past
tappoivat	Past
joutuu	Present
patakymppiin	None
yleishyödyllinen	None
ujoiltava	Present
kiinnittyi	Past
kumartakaamme	Present
maavaroista	None
koulutti	Past
erotti	Past
säätelevä	Present
polyfonisessa	None
paalua	None
uranuurtajaksi	None
ostin	Past
kvasaarin	None
konservoitu	Past
kaksinumeroiset	None
maailmansodan	None
vaalittiin	Past
häiritsivät	Past
kastettiin	Past
kuumentaisit	Present
aamulypsy	None
opitaan	Present
muuttoaikoina	None
rienaksi	None
pyykkäykset	None
suoristuu	Present
oleilla	None
puhuta	Present
arvokkaaksi	None
arkeologiselle	None
valmistuu	Present
niksunet	Present
lataat	Present
päärooliin	None
tapettava	Present
kummastelee	Present
vaurioita	Present
valitan	Present
tyytyi	Past
lastaan	Present
ärsykkeitä	None
pystytä	Present
edeltävät	Present
pariskunnan	None
tohtinut	Past
oleiluja	None
katsoisivat	Present
opettajankoulutus	None
visiitistä	None
villitsi	Past
katalyysille	None
sulautuivat	Past
nuotit	None
luovun	Present
käyttäisimme	Present
pamautti	Past
umpikujan	None
haen	Present
kysele	Present
kätkevät	Present
nirskutan	Present
nuorten	None
käynnistivät	Past
lähdekoodi	None
naarmuuntuvat	Present
omannut	Past
muunnelmia	None
kaunokirjallisuudesta	None
meinannut	Past
taskukello	None
myrkyttävät	Present
varmisti	Past
tarjoilijaksi	None
keskeytti	Past
puikkisi	Present
tasoittaa	Present
saapuu	Present
aneemisen	None
ruiskua	Present
maininnut	Past
luistellut	Past
vahvistettiin	Past
korvataan	Present
tuulettivat	Past
dokumentoitu	Past
inkeroisia	None
aikaleima	None
ikivanhat	None
taidan	Present
närkästyivät	Past
metamitsoli	None
estäisin	Present
manipulaatiolla	None
pehmettäköön	Present
tyydytetty	Past
kannustaisi	Present
saastuttanut	Past
punertava	Present
selventänyt	Past
pamahtelivat	Past
palvoivat	Past
voimisti	Past
pidättele	Present
piirrän	Present
kerättäisiin	Present
kostautui	Past
atomiytimien	None
opastaa	Present
soveltuvat	Present
unhoita	Present
timpermannilla	None
kukkakimpulle	None
puhdistuksista	None
neuvotellen	Present
kalastavat	Present
kumien	None
soistunut	Past
keskeytyy	Present
palaisin	Present
talvehtiva	Present
pakeneva	Present
vakinaisesta	None
freonia	None
suojeleva	Present
hyökkäilivät	Past
vastasit	Past
vandalismilla	None
allitteraatiolle	None
pohjautunut	Past
omavaraisuus	None
mainostettiin	Past
halventukaa	Present
iloitsevat	Present
ratkaistava	Present
vahingoittuisi	Present
mikrofonit	None
siirrytään	Present
lätkitään	Present
lytistävät	Present
teksteillä	None
siteerasi	Past
kehittyi	Past
kyselty	Past
rehtoreista	None
tuomioon	None
autoin	Past
leirinnöistä	None
pelkisti	Past
hyppään	Present
raadettava	Present
reuhdoit	Past
mustamaalata	None
tuhonnut	Past
kypsynyt	Past
käsitteeseen	None
hyppii	Present
tehostanut	Past
pettäisi	Present
lannistaa	Present
laskostettu	Past
rakeita	None
tietyissä	None
kaavoitettiin	Past
yliarvioinette	Present
harkintakykyä	None
melot	Present
harjaantunut	Past
valehtelee	Present
uhatkaamme	Present
varmistettaisiin	Present
otannat	None
ominaisuuksin	None
kurkistaa	Present
palattiin	Past
lähdettiin	Past
museoitu	Past
alkavat	Present
valuvat	Present
neuvotteleva	Present
matkustivat	Past
eriarvoistunemme	Present
kaatopaikoilta	None
tunge	Present
parantumattomaan	None
näytteisiin	None
välkähditte	Past
butyyli	None
nuoli	Past
uskoisin	Present
muotoutuivat	Past
huolehdittava	Present
seurattaneen	Present
paineista	Present
hakkaillen	Present
heikkeni	Past
piiloutuivat	Past
huudahtaa	Present
aitajuoksun	None
velvoitettiin	Past
ilmitoit	Past
julistautuu	Present
sijainnista	None
vuokraava	Present
kaivoin	Past
kiusataan	Present
houkuttelee	Present
loukkasivat	Past
pysyy	Present
lähetettävä	Present
puhkeaisi	Present
kumilautoitta	None
tarvitsisin	Present
hautautuisitte	Present
varoittelivat	Past
jäähdytti	Past
kylmyydessä	None
kaamoksille	None
pyöritetään	Present
kierouttavat	Present
numeroinen	Present
upottivat	Past
kiinnostava	Present
kalsiitti	None
perustettu	Past
raavittava	Present
matkustajamäärättä	None
kurtistuksesta	None
uitu	Past
polkupyörä	None
julistaisi	Present
kuohutti	Past
venähtää	Present
joutunee	Present
menestymistä	None
kohua	Present
tarjoutuivat	Past
lahjottiin	Past
vitsaillen	Present
lykkäännyit	Past
leyhyteltävä	Present
onnistuisi	Present
auttava	Present
säästele	Present
nousisivat	Present
uuvahtakaamme	Present
oksentavat	Present
eläimellistä	None
moottoroitu	Past
suostun	Present
tasaisuutta	None
metsästettiin	Past
kaavaan	Present
luovutettu	Past
lastenkodin	None
sarka	None
tiedustellen	Present
kongruoitu	Past
nollaantukoon	Present
alkuerästä	None
hopeisessa	None
nojasi	Past
oikeutettiin	Past
ostan	Present
puukottaa	Present
ihannoitu	Past
artisteilta	None
ravistelivat	Past
kruunannee	Present
erotettu	Past
rajoitin	Past
paikkauttaisi	Present
toheloitiin	Past
uskaltaa	Present
kylläännytä	Present
köynnehti	Past
intoutui	Past
nikkudiksi	None
sisälsi	Past
ryhdistätte	Present
otaksui	Past
loivettaisiin	Present
keskeytettiin	Past
pelastava	Present
hankittaisiin	Present
tottunut	Past
valtuuttanut	Past
viljeli	Past
kaiverretaan	Present
kehota	Present
rullataan	Present
vaivaava	Present
nimeävät	Present
osasin	Past
närkästyy	Present
pysyttelee	Present
karkotettava	Present
teetä	Present
sämpläisivät	Present
tärkätyittä	None
teknilliset	None
rinteessä	None
adaptaatioina	None
syötä	Present
koksauduimme	Past
rakentunut	Past
puuhattiin	Past
murskautuu	Present
pilailee	Present
merimerkkinä	None
sääkartoilta	None
sulattanut	Past
suojattaisiin	Present
levennetään	Present
ehdottavat	Present
hairahduitte	Past
vilisee	Present
mesiangervo	None
hioi	Past
visuaalistavat	Present
valmistetusta	None
vävyn	None
näännyttää	Present
verbi	None
tiivistettiin	Past
loisiva	Present
innovoisit	Present
selkiyttää	Present
avioituisi	Present
juonsi	Past
minkäänlainen	None
tiedän	Present
rasittunut	Past
vuoluhöylällä	None
graafisia	None
tunnuksilta	None
pienyrityksiä	None
kirjatun	None
ilmoitat	Present
kunnari	None
huijannut	Past
langettivat	Past
sovittaisiin	Present
tieliikennelaissa	None
tuottavuuksina	None
rientää	Present
pöyhkeilijän	None
taltioinut	Past
sovellettava	Present
narisisitte	Present
takkusitte	Past
rautatieasemaan	None
hämmästelivät	Past
juokse	Present
paksusuolessa	None
mohikaanit	None
tarkistettiin	Past
haalentunee	Present
yhtäläistä	Present
riisui	Past
väsään	Present
kolmiapiloiksi	None
asetellut	Past
tohisimme	Past
sammakkomiehen	None
nyppinyt	Past
lempinen	Present
nasevoinut	Past
noudatan	Present
kerännyt	Past
toistettu	Past
löysin	Past
turvallisesta	None
passivoituisin	Present
runoa	None
kyynelehditty	Past
irtonainen	None
kaskeaminen	None
seinätulppaa	None
ihastuu	Present
kuvittelet	Present
korjannut	Past
yksinkertaistuu	Present
luottanut	Past
tehottomissa	None
elvyttivät	Past
pohjautui	Past
olettivat	Past
kertaistui	Past
kohentaa	Present
raastettu	Past
kamppailevat	Present
pissitetään	Present
kommentaattoreina	None
tulkitseva	Present
toimittaa	Present
afrikaanereina	None
karjalaisilla	None
moninkertaistuivat	Past
silmättömiä	None
villakangasta	None
varikolta	None
käsitettävä	Present
salasin	Past
täyttänee	Present
pidättäytyivät	Past
sisältää	Present
puhuin	Past
tavoitettiin	Past
järjesty	Present
orjatyövoiman	None
pelottelevat	Present
populaaristaisi	Present
ruoskittiin	Past
jäsennetään	Present
kidutetaan	Present
tiedottanut	Past
pullistuvat	Present
yllätin	Past
korsakki	None
käryttäisivät	Present
herjoja	None
suunnistettiin	Past
sanoivat	Past
muumioita	None
rantautuivat	Past
apokryfiset	None
kiinalaisilla	None
koki	Past
tunkeutukoot	Present
karina	None
loistivat	Past
turvaava	Present
huolestuivat	Past
syösty	Past
pistellään	Present
gallerioiden	None
hain	Past
vaikenisit	Present
parantunut	Past
perehtymisen	None
kirjautuvat	Present
korjaan	Present
mouruttiin	Past
turvaat	Present
helleaalto	None
trivialisoinemme	Present
avautuisi	Present
jälkiliite	None
kirkastuttanette	Present
monikansallisen	None
kääntämisessä	None
lyllersimme	Past
pirstoi	Past
määräytyi	Past
yksityisyydestä	None
hallinnollisina	None
seditelkööt	Present
tehtaana	None
myötähäpeän	None
pahanhajuisena	None
tarkentanut	Past
sieluin	None
kiristyvät	Present
kehittyy	Present
säästää	Present
säikähtänyt	Past
unetimme	Past
irtaimen	None
päätösvaltainen	None
himmentää	Present
estäisi	Present
soluttautuu	Present
kullataan	Present
parantelin	Past
häpeä	Present
kiinnostaisi	Present
tuhottava	Present
vertaat	Present
käväissyt	Past
googletin	Past
vitsaillut	Past
varastanut	Past
harhauta	Present
hermostun	Present
satutitte	Past
rääpinet	Present
tunkeudun	Present
sitoudu	Present
plussaan	Present
teroitti	Past
huipensi	Past
ammoisina	None
odotetaan	Present
uniikit	None
säkenöinet	Present
varottava	Present
valmennettava	Present
kallistuksin	None
varjostukseen	None
koetaan	Present
lanseerasivat	Past
leivänmurujen	None
muistutettiin	Past
kanonisoitunut	Past
mikroluottoja	None
käyttää	Present
räjähtäisi	Present
siteerataan	Present
tulkattu	Past
paksut	None
kriminnahkakaulusta	None
tanskaa	None
parveilevat	Present
takaraivon	None
tarkoittanet	Present
soihtujen	None
kohottakaa	Present
mukaisella	None
luhistui	Past
ymmärretään	Present
salasi	Past
hypättiin	Past
sotilaallistivat	Past
aikuistuvat	Present
suosittiin	Past
sojottaa	Present
muodostelmassa	None
kiduttavat	Present
saranoitu	Past
käsittelevä	Present
sokaistuva	Present
heikettiin	Past
avanto	None
kärjistyivät	Past
kihlannee	Present
nykyiseltä	None
vääristynette	Present
tarkoitat	Present
etsitty	Past
velkonette	Present
toksisuutta	None
lävistetty	Past
valttikortit	None
säästettäisiin	Present
perehdyttiin	Past
numeroitiin	Past
nuorrut	Present
harhaantui	Past
paikantuisin	Present
juonitellut	Past
rajattaisiin	Present
kouluttavat	Present
eläytyvä	Present
lajittelee	Present
elätteli	Past
vierastanut	Past
mitoosin	None
kvanttifyysikon	None
tunneleissa	None
pomolle	None
liikuttiin	Past
matele	Present
kutistettu	Past
vetoisuudet	None
toteat	Present
imetään	Present
pilasivat	Past
veroleikkaukselta	None
tataarilta	None
kevennetään	Present
australialaista	Present
valmistelee	Present
ruoteita	None
heijastava	Present
valtasi	Past
vyyhti	Past
kannattajalle	None
marttyyrin	None
soitellaan	Present
hikinen	None
fullereenin	None
painottuvat	Present
luonnehdittiin	Past
juotti	Past
lahjoo	Present
noteerattu	Past
vähennetään	Present
säilynee	Present
tuotti	Past
oppimispeli	None
hiertokonetta	None
spekuloinut	Past
pyöristävä	Present
ymmärrän	Present
edistä	Present
hallinnoinut	Past
kieltäytyi	Past
kiellettäisiin	Present
harrastajilla	None
leimasin	Past
kiertoja	None
horjuivat	Past
ravintoloista	None
konsulttina	None
rajatusta	None
nopeutuisi	Present
epitafi	None
yhtiöitettiin	Past
yhdysvaltalaisten	None
vastuualue	None
nihkeää	None
lipeäisitte	Present
vääryyksien	None
juuritettaisiin	Present
rapsodia	None
platonilaiset	None
kydötetyn	None
estäkää	Present
ilmestyvät	Present
sammutin	Past
pidät	Present
kammattiin	Past
ruiskaisee	Present
takonen	Present
neulansilmä	None
tuoksut	Present
vapauttava	Present
ryhdyttiin	Past
viehättäviä	None
kerrostimme	Past
kierrosajat	None
viskaava	Present
voitanee	Present
tutustuisimme	Present
säilyttäisi	Present
korjuuttanut	Past
hunnutetaan	Present
kysellyt	Past
nivoutuvat	Present
koe	Present
restauroinnista	None
ratkaistiin	Past
lievenevät	Present
viivyttänyt	Past
kannatteleva	Present
staraksi	None
raivoa	Present
kivikirkot	None
raksahdeltakoon	Present
petettiin	Past
vastetta	None
ilmatieteellistä	None
varakkailla	None
raportoikoon	Present
hyödyntävät	Present
hylättiin	Past
varttunee	Present
vapautti	Past
sonni	Present
yllytti	Past
ehdollista	Present
modifikaatiolle	None
kysynyt	Past
isketty	Past
haihtuu	Present
loivat	Past
kolminkertaistuu	Present
mallintamisille	None
islamilaisilla	None
fossiilistuisitte	Present
amiineihin	None
tarkastavat	Present
markkinoidaan	Present
kaanonit	None
perustellut	Past
kirjapainojen	None
sieti	Past
erehdykseksi	None
amputoitiin	Past
pyöristetty	Past
muistellut	Past
valmennetaan	Present
vahvistuu	Present
rakastu	Present
henkisestä	None
torjunnat	None
lähestyttiin	Past
varteenotettava	Present
purjehtii	Present
kirjalliseksi	None
pyöryiksi	None
kulutettiin	Past
saarnaavat	Present
valitettu	Past
povasi	Past
vartoaa	Present
voihkaistava	Present
tonnikalojen	None
opiskelupaikkojen	None
messi	None
uhkailee	Present
laski	Past
edisti	Past
löytyy	Present
hälytetään	Present
verkottunut	Past
förstin	None
sopusuhtainen	None
valkenisimme	Present
taajamassa	None
hämmästelen	Present
horjuttivat	Past
rikun	Present
lisätään	Present
pudotetaan	Present
kolonialismin	None
rakentui	Past
köyhtynyt	Past
ulkoistanevat	Present
senttisenä	None
petosta	None
suvaitsematonta	None
puukotettiin	Past
kiinnostivat	Past
käyttäytyi	Past
luovutan	Present
intiantiikereille	None
ktooniset	None
jolkuttanette	Present
kiertäjänikaman	None
soitellut	Past
vektoreilla	None
haetettava	Present
ihmetellen	Present
köyhtyivät	Past
padottu	Past
sukupuolineutraalin	None
vuorotteleva	Present
rapautunee	Present
loitsii	Present
puhdistaa	Present
mainitsi	Past
hiipivä	Present
autiomaihin	None
vaainnee	Present
epäsosiaalisia	None
vaivautuvat	Present
kommuunia	None
käsitämme	Present
sähköistetty	Past
lanseerataan	Present
kroonista	Present
vaivaan	Present
oudostele	Present
ansaitsisi	Present
yliopistoille	None
valvonut	Past
tiukennettu	Past
koituisi	Present
komennuksella	None
malttanut	Past
jynssännemme	Present
friteeraamme	Present
erinomaisuudesta	None
kulkisi	Present
ilmennä	Present
manipuloiva	Present
onnistuttiin	Past
sijoittuvat	Present
sivuuttivat	Past
käsitellyt	Past
lipotkoon	Present
pelättäisiin	Present
virtsahappoineen	None
kirjo	Present
kehnäsieni	None
seutukuntaa	None
siirtäisin	Present
plombitamme	Present
rehabilitoitiin	Past
ryöstelevät	Present
ghetoissa	None
kierouttaisin	Present
oppikoulujen	None
ihaillaan	Present
muistuttaisivat	Present
roomalaistatte	Present
hyödyttää	Present
pyyhi	Present
levännyt	Past
kauneusihanne	None
imperiumien	None
otsonikerrokselle	None
kohdeltava	Present
keisareina	None
lennätte	Present
iskisi	Present
toimiluvan	None
vannon	Present
keinauttaisitte	Present
aarrekammiot	None
hukkuisi	Present
ilahtuu	Present
maapallolta	None
tähdittää	Present
rasvaeviksi	None
livahtaa	Present
kahminut	Past
puhuisivat	Present
käyristäisit	Present
varoventtiili	None
kymmeniin	None
unelmoinut	Past
kommitoinemme	Present
kiertyvä	Present
laukesi	Past
kaunojen	None
rukoillen	Present
tunne	Present
koettelemus	None
siirtoon	None
keventäisin	Present
majoittuu	Present
vapautettu	Past
pysähtyvä	Present
lujentaisivat	Present
muumioisi	Present
sakeuttanut	Past
japanilta	None
pimittänyt	Past
rettelöikää	Present
kuvottivat	Past
sijapääte	None
farmakologiassa	None
kelpuutettiin	Past
tietokilpailussa	None
aaltoili	Past
monarkkeihin	None
hakuajan	None
metsäpaloihin	None
diktaattoria	None
palkattiin	Past
kaksitavuinen	None
kokousta	Present
havahduttiin	Past
sarjakuvakirjat	None
pullistuttaneen	Present
merkittiin	Past
hakkautan	Present
hytkähtäisi	Present
saatettaisiin	Present
tavumerkeillä	None
kosteat	None
toistunut	Past
ostavat	Present
tuhkattiin	Past
pidätettyjä	None
ystävystyy	Present
välittyi	Past
erottavat	Present
nopeimmalle	None
kierrätetään	Present
ratkaiseva	Present
läkähtyköön	Present
kirjailisitte	Present
välttynevät	Present
pumpataan	Present
akseleroikaamme	Present
välähti	Past
vierailtu	Past
kasvanut	Past
tyhjään	Present
avio	None
veloitti	Past
teettää	Present
mitätöidään	Present
kaivelisivat	Present
kaupunkimaista	Present
altistutaan	Present
esivanhempien	None
merkityksineen	None
työllistettiin	Past
kotoistamme	Present
lisäännyin	Past
äänestit	Past
aloitan	Present
kuunneltiin	Past
kulttien	None
pääsykoe	None
taukosi	Past
vaurastukaa	Present
työstettiin	Past
niksu	Present
hurmaantunette	Present
vokalistit	None
kutistuva	Present
julkaisuissa	None
huonontunette	Present
lamauttivat	Past
perennoinette	Present
rikkuivat	Past
jakaisi	Present
pyörsi	Past
kielletystä	None
pysyttelivät	Past
mouruaisin	Present
kehottanee	Present
oikein	None
pilkkaavat	Present
metsästitte	Past
kuvasti	Past
quislingin	None
paatoksetta	None
terrorisminvastainen	None
soikoon	Present
eläytyy	Present
vakituisen	None
makeus	None
asianosaisina	None
sijoittavat	Present
teetettiin	Past
animoitu	Past
rahoituskriisien	None
tahriintunut	Past
onnistunee	Present
kakkossijan	None
askarrutti	Past
lukeutuva	Present
haukahti	Past
varmistan	Present
heiluttivat	Past
palkattu	Past
soittaa	Present
sisäpiirikaupoista	None
googlettaa	Present
osoittautuivat	Past
ennakoinnissa	None
pierrette	Present
estimaateista	None
kierrejousin	None
amerikkalaiselta	None
nimettävä	Present
pelätään	Present
horjumattomalle	None
ansioitui	Past
suostuttelivat	Past
kirjoittavat	Present
untuvakankaat	None
eläinoikeusliike	None
harjaksia	None
sentralisaatio	None
ennusta	Present
rationalisti	None
hetkuttelitte	Past
kävelystä	None
keitetystä	None
tarvitsi	Past
skisma	None
tavis	None
laillistetaan	Present
keräillen	Present
totuttu	Past
alkuunpanijana	None
verhoilla	None
merkittävä	Present
kahdeksikon	None
yhdistin	Past
plantaasille	None
toteuttava	Present
lävistää	Present
huuman	None
hyötyy	Present
potkuja	None
juottavat	Present
ääntele	Present
suri	Past
kehuvat	Present
liberalistisen	None
määrittävät	Present
hyljittäisiin	Present
virallistui	Past
bitumilla	None
tunnustettaisiin	Present
maadoitettu	Past
valikoitui	Past
imponoitakoon	Present
huomasit	Past
varmistuisi	Present
nuokkukoot	Present
aloittajan	None
säveltäjäksi	None
hevoskärryt	None
jatkettakoon	Present
venäläistyisimme	Present
rahoitettava	Present
opettelin	Past
onnistui	Past
nukeista	None
asettautuivat	Past
vähätelty	Past
mainittu	Past
veisataan	Present
kytätkäämme	Present
piirikuntia	None
maisemasuunnitteluun	None
sisäänhengityksen	None
kannattaa	Present
kuivattelisit	Present
kukistivat	Past
suuttui	Past
kritikoitava	Present
tahmentanut	Past
baritoneja	None
muovikasseineen	None
ylittynyt	Past
säestetään	Present
uskottiin	Past
tappaa	Present
lentoasemat	None
asettelee	Present
salakuljettivat	Past
kalamiesten	None
parhaimpiin	None
litaniat	None
luopuisin	Present
etsintäkuulutti	Past
polariteeteilta	None
loitompana	None
suutuimme	Past
tukahduttanut	Past
mikrofonien	None
voihkittava	Present
hämärtyi	Past
tylsyyttä	None
esittelevä	Present
myönnettäköön	Present
salpaajia	None
liotetaan	Present
menehtynyt	Past
järjesti	Past
ärsyttää	Present
klassistisen	None
halveksuu	Present
suojautui	Past
mogulien	None
lumotut	None
sävytti	Past
palveluskoirien	None
palvelutaso	None
muodostavat	Present
kristityssä	None
mentorina	None
syyllistyivät	Past
raatihuoneen	None
vammaisuudesta	None
rukoilivat	Past
vierailtiin	Past
sikiönkehitykselle	None
pysäyttävä	Present
raketeista	None
hiertävät	Present
tutustukaa	Present
kliinisissä	None
supermarketit	None
ratkaistaan	Present
pykälöiköön	Present
vastuksesta	None
avustuksella	None
tarttuivat	Past
harjoitettu	Past
suurlähetystöjen	None
häiriköksi	None
aikoisivat	Present
koneellista	Present
kilometrin	None
loskaannuitte	Past
muistaisin	Present
perustin	Past
veljestön	None
tallennusvälineet	None
bounssasin	Past
johtuva	Present
ilakoisi	Present
kokonaisvaltaisesta	None
lykkäytyi	Past
julkaisi	Past
metsäpaloina	None
hallintoalueista	None
lujittivat	Past
äänettömiä	None
läpimitalla	None
vasenkätisinä	None
törmäät	Present
karismaan	None
korostavat	Present
savetettu	Past
keskuspölynimuritta	None
näkisit	Present
nostattaa	Present
teollistui	Past
kärventää	Present
pinnallista	Present
heru	Present
maanpäälliset	None
kytketty	Past
tupakoinut	Past
esiteltävä	Present
kielii	Present
väsäsin	Past
ulotteinen	None
ihmettelet	Present
sairastellut	Past
evankeliumeja	None
hankoa	Present
kellaroisi	Present
liukastanette	Present
kovistelee	Present
yhdistelty	Past
shakkimatti	None
ikäänny	Present
saksansi	Past
silavoisimme	Present
hoksasin	Past
selittyy	Present
huipentui	Past
tajunnee	Present
alavirran	None
hansikkaita	None
pahoinpitelevät	Present
jumi	None
aluepolitiikkaa	None
tunnelmoinemme	Present
kiehtovaksi	None
paimensivat	Past
kompleksiluvut	None
suoriuduttava	Present
tukialukselle	None
valistava	Present
kysellään	Present
hankkiutuva	Present
valttikorttina	None
allergista	Present
kauhisteli	Past
hulmautatte	Present
hajottamista	None
alamitta	None
kirjaan	Present
tapamme	Present
rajoin	None
suojeltaisiin	Present
kuvaan	Present
luonnehti	Past
tiedät	Present
klusiilin	None
kannattaisin	Present
syyllistytään	Present
rappeuttaa	Present
sido	Present
uralilaiseen	None
rabbin	None
kilpailisi	Present
siivilöidään	Present
purraan	Present
huudahti	Past
keräilevät	Present
soveltunen	Present
etruskit	None
löpistävä	Present
tunnustelee	Present
valmistautui	Past
näyteltiin	Past
sisäpuolelle	None
kellonaikoina	None
poistumaan	None
rikasta	Present
asettuu	Present
jaellut	Past
voista	None
ruostuttaisitte	Present
rinnastaisin	Present
kuorsasin	Past
rahoittanut	Past
heikensi	Past
teennäistä	None
ikäiseltä	None
rauhoittelisin	Present
selvittelevät	Present
ällistytä	Present
ojennetaan	Present
spiraalivetoketjusta	None
rahoittaisi	Present
jaotellaan	Present
elvytettiin	Past
kohdattiin	Past
hangaariin	None
karttua	None
ruotsalaisiin	None
riittänevät	Present
jousikvartettoa	None
valmistautuivat	Past
käynnisti	Past
kuormittuisitte	Present
loiottakoon	Present
meningokokki	None
opastava	Present
vihasivat	Past
muutettu	Past
korvannut	Past
sotilaassa	None
korjaili	Past
vahtii	Present
vampyyreille	None
ylistää	Present
liittoutuvat	Present
myisi	Present
kammon	Present
päätyisi	Present
joudutti	Past
teollista	Present
lyövä	Present
siunataan	Present
koetellut	Past
soveltamisesta	None
sairaanhoitajat	None
hoivaavat	Present
lauleskeltaisiin	Present
pommitettakoon	Present
avautunut	Past
vaijeriin	None
keskittivät	Past
hakattu	Past
loisti	Past
tyhjiö	None
kalanruodon	None
viileni	Past
bysanttilaisesta	None
loista	Present
liittymät	None
känsistynee	Present
mietiskellette	Present
murhasi	Past
meneteltävä	Present
hakuaika	None
kuristaa	Present
kouhottanut	Past
härnäsin	Past
protestoitu	Past
kuittasi	Past
raivostuvat	Present
vilustuttiin	Past
kehystää	Present
suotiin	Past
viitannee	Present
simuloitu	Past
beetakaroteeni	None
tarkistivat	Past
ylettyvät	Present
villihanhien	None
isopuksipuulta	None
organisoidaan	Present
nimeän	Present
paikattu	Past
vaikeutetaan	Present
huljuttaisimme	Present
pingviiniin	None
iskujoukon	None
kyseenalaiset	None
metrisen	None
pyörähtivät	Past
julista	Present
maailmansotien	None
keskustelet	Present
harmahtaisit	Present
vainotaan	Present
ylennetty	Past
kiinnostui	Past
risteilyohjusta	None
mutkittelevat	Present
likistäytynen	Present
painoarvon	None
kallioperää	None
ripoteltiin	Past
mahdollistettiin	Past
poistamisitta	None
laava	None
hymnografiat	None
pienennyitte	Past
puistattavat	Present
säästyttiin	Past
iirinkielisellä	None
mahahapon	None
kuvioon	None
etenemällä	None
suosittelisitte	Present
typografiasta	None
vastustava	Present
välitti	Past
säveltävät	Present
veistetään	Present
ehtinyt	Past
nollakuponkilainan	None
kottarainen	None
vitseistä	None
hyökkäsi	Past
dialektista	None
lammaspaimen	None
kiivaimman	None
tribuuneilta	None
kuumennettiin	Past
toistetaan	Present
kilpailua	None
kykenivät	Past
houkuttelevat	Present
vedetään	Present
kiertelevä	Present
ammattiosaston	None
rahoittivat	Past
mielentilatutkimus	None
merkkasi	Past
hellinen	Present
täyttäisivät	Present
arvo	Present
tuuhentakaa	Present
tovissa	None
lankeaa	Present
sammahdatte	Present
homoavioliitoiksi	None
bokseilta	None
harjaannut	Present
siirtyvä	Present
viitataan	Present
poistuttava	Present
toistuva	Present
lämmittävä	Present
molekyylillä	None
huokausten	None
levyttävä	Present
mallintava	Present
omistan	Present
haastavat	Present
rapeudu	Present
painostavat	Present
historiallisista	None
auktoroitaisiin	Present
gastronomian	None
arvasi	Past
jyrätään	Present
nimitti	Past
napsutelkoon	Present
melo	Present
luonut	Past
charmia	None
aavistanut	Past
fluorituksissa	None
ylitsepääsemätön	None
metsätaloudesta	None
ydinteknologia	None
vaihtunut	Past
onnitteli	Past
analysoitava	Present
sinnikkyys	None
kaivautti	Past
dualismiin	None
ylivoimaisin	None
dramaturgian	None
kohteli	Past
laonnet	Present
matkustava	Present
linnoittautui	Past
loisteessa	None
kaivannen	Present
kammonen	Present
pahoittaisin	Present
kovettuu	Present
kunnialliseen	None
kyltistä	None
onnettomuuksia	None
varjosta	Present
väkivaltaisuuksiksi	None
hautasivat	Past
samaisen	None
selvittelisitte	Present
voimistuivat	Past
noudatetaan	Present
tuulikello	None
tarkastelemme	Present
merkinnee	Present
nandut	None
ratkaisee	Present
tarjosi	Past
parjaisivat	Present
kalleimmat	None
seuraamme	Present
pensastettaneen	Present
sirkukseen	None
oletan	Present
ylittää	Present
koteloituu	Present
pesineen	None
himmenee	Present
paikallistettiin	Past
fennistiikkoja	None
kuultaa	Present
haluaisitte	Present
helisevä	Present
lausun	Present
varusmiesajoista	None
herättelee	Present
näyttö	None
uhrauksen	None
hankaloittavat	Present
versokoon	Present
asustetta	None
unohtaisivat	Present
äänestetty	Past
suoristettu	Past
kutistin	Past
kalenterivuotta	None
selkärankainen	None
ekstraa	None
nelinkertaistunut	Past
tuntemattomilla	None
rangaissut	Past
juorukelloon	None
lopu	Present
työllistää	Present
lavennuin	Past
muistutit	Past
puhallettava	Present
yleisty	Present
uittelisivat	Present
huovuttu	Past
repäisee	Present
kelpasivat	Past
alaviitteja	None
kaon	Present
kasvoi	Past
kilpailtiin	Past
sure	Present
sopraano	None
sidotaan	Present
liottaa	Present
helskyttänyt	Past
unhoittunevat	Present
lukittu	Past
vastustettava	Present
varauduttiin	Past
unelmoida	None
rikkoutui	Past
äksyssä	None
väisty	Present
osallistuva	Present
ikkunapuitteetta	None
hennotkoon	Present
tanssiva	Present
elikkoineen	None
kavensi	Past
tukeutunut	Past
uskottu	Past
valjastettiin	Past
varjeltuna	None
huomatkaa	Present
kannustaa	Present
luonnontieteiden	None
laivattiin	Past
uitettiin	Past
hirveän	Present
koetettu	Past
kirjoittelin	Past
uhanalaista	None
kiinnittäisi	Present
professorien	None
mallineesta	None
rahoitetaan	Present
puhdistunut	Past
kykenevä	Present
kesäpäivänseisauksesta	None
soudetaan	Present
koulutusohjelmaan	None
tarkastettava	Present
eksyi	Past
paisunut	Past
pyöristyy	Present
osastoinemme	Present
vierivä	Present
muurahaiskuningattarena	None
palvelualan	None
koestanut	Past
tyydytään	Present
nekrotisoiduin	Past
kirjuriksi	None
sulauttivat	Past
kasaantunut	Past
vammautuu	Present
lennettävä	Present
huomaisivat	Present
ratkovat	Present
kustantanet	Present
ilmaisin	Present
suosittelisi	Present
siirtänyt	Past
noteerattiin	Past
kuunteli	Past
pohdittu	Past
jäävännyt	Past
tarvittiin	Past
heräteltiin	Past
ihmismäistynet	Present
mielenhallinnan	None
silvon	Present
lyyhistyi	Past
moninkertaistunut	Past
translitteroidaan	Present
katkaistu	Past
teloittaa	Present
herkistää	Present
vieroksuttiin	Past
häiritsisi	Present
sekoittava	Present
tiedotettu	Past
adoptiolapsi	None
satsaisit	Present
värvätään	Present
oletettaisiin	Present
haittaan	Present
työskentelen	Present
kaivosteollisuudelle	None
kehaiseva	Present
taon	Present
laulakaa	Present
valkenemme	Present
lankaan	Present
vaalensi	Past
alaikäinen	None
kertautuvat	Present
kannattavat	Present
sekanelinpelistä	None
kaottaisiin	Present
reputti	Past
desimaalilukuna	None
jähmettykää	Present
paltan	Present
nuijasotaan	None
kyhmyjoutsenilla	None
rakastumiseksi	None
paikkakuntiin	None
praksiksena	None
degeneroiduttava	Present
intoa	Present
tiesivät	Past
lumoutunut	Past
hiiletymme	Present
värjäsivät	Past
vainojen	None
linnalla	None
kovetetaan	Present
voimalaitoksille	None
maista	Present
totutettiin	Past
kakkoselle	None
mahdollistettu	Past
tyrmännyt	Past
luterilaisuudessa	None
häivehävittäjillä	None
taisteltu	Past
asetellaan	Present
emoyhtiöön	None
sytokiinien	None
valtaisivat	Present
laskeva	Present
uusiutuu	Present
laadullista	Present
salaavat	Present
manaan	Present
pelastettiin	Past
rustottuisitte	Present
nautitaan	Present
haalistutte	Present
vaikutetaan	Present
karkaavat	Present
pistäisi	Present
työnnetään	Present
lämmennette	Present
uista	Present
kilisytetty	Past
tukipilarin	None
pillitä	Present
väitetään	Present
pikesit	Past
kansantajuistanet	Present
luvulla	None
maanalaista	None
aerosolipulloineen	None
puhkaisevat	Present
litistynyt	Past
aktuaareilla	None
vieroittunette	Present
impulsiivisuus	None
äänestettävä	Present
ilmavaivat	None
tyydytti	Past
bumerangin	None
suprajohteita	None
painovoiman	None
lainaan	Present
houkuttelisi	Present
päättyisi	Present
korjauttaa	Present
kepittivät	Past
ajautuivat	Past
riistäydytte	Present
pehmenee	Present
korjautuu	Present
asennettaisiin	Present
rinnastetaan	Present
kammottavat	Present
huolsin	Past
oikaistava	Present
päihtynyt	Past
aaltoliike	None
ilmenivät	Past
pyrkimyksille	None
janoavat	Present
korostettu	Past
ladellen	Present
filmatisoitiin	Past
palvottu	Past
sietävät	Present
virittänen	Present
sammut	Present
prässäytettävä	Present
nimetään	Present
taivutti	Past
kukun	Present
rymisty	Past
lumoutui	Past
kustantaa	Present
välky	Present
miljoonapalosta	None
tuomittiin	Past
säännelty	Past
nipottaa	Present
kaartuva	Present
rakastavat	Present
lussuttava	Present
ruvettaisiin	Present
puitiin	Past
punnitsi	Past
syöt	Present
latistaa	Present
mittaaja	None
laulettiin	Past
esilämmityksen	None
vertailtu	Past
makuihin	None
lypsävät	Present
hokisin	Present
kasvattava	Present
kirsikkapuiden	None
herättävä	Present
paistattelevat	Present
yhtenäistetään	Present
varakkuutta	None
komentajista	None
juhlistetaan	Present
hallinnut	Past
vyöry	Present
lesitiineiltä	None
ensiesitetty	Past
kiinnittivät	Past
hinguitte	Past
pistävä	Present
päättymätön	None
töytäisimme	Past
juoksevat	Present
referoidaan	Present
tapahtuivat	Past
sotatoimille	None
leimattiin	Past
vastustaisi	Present
ylistetään	Present
luomiskykyinä	None
kymmenyksen	None
kansainvälistyi	Past
maneeristunee	Present
joudumme	Present
hupeni	Past
hait	Past
klyyveiksi	None
hedelmöität	Present
meppi	None
sähköveturilla	None
heeros	None
valtaan	Present
koulutetaan	Present
slummiutukoon	Present
loppuu	Present
pysykää	Present
nykii	Present
sotilasdiktatuuri	None
saatamme	Present
hallintoneuvostossa	None
pikkuliitäjä	None
laueta	None
suren	Present
ukrainantakoon	Present
kaipaisi	Present
rivin	None
tasa-arvokäyrästä	None
muokkaisivat	Present
frikatiivi	None
suunnisti	Past
lipoisimme	Present
suosisit	Present
säpsäyttäkäämme	Present
aerobikataan	Present
pohjautunee	Present
nymfeille	None
piikittelee	Present
rööri	None
valmistaisi	Present
tiskaan	Present
penikkatauti	None
hiljennettiin	Past
denaturoisi	Present
reagoitiin	Past
yrittäisit	Present
sanoittaa	Present
dubataan	Present
säilyisivät	Present
hutkitaan	Present
järkeili	Past
periytyivät	Past
vasto	Present
pysytellyt	Past
verhotaan	Present
tähdättiin	Past
harjus	None
pohjustaa	Present
näyttäytyy	Present
hennot	Present
kattiloista	None
poistosta	None
lamaantuivat	Past
toistuu	Present
pelannee	Present
salaili	Past
kojeen	None
arvelujen	None
uitetaan	Present
entisti	Past
bailataan	Present
pelattiin	Past
pennosen	None
mätkähtänet	Present
varsat	None
vetäytyisivät	Present
tummenisitte	Present
pelasivat	Past
pahentunevat	Present
karibianmuurassa	None
radiovastaanottimelta	None
joulupäivästä	None
halusimme	Past
julistanut	Past
määriteltäisiin	Present
merkitty	Past
surtiin	Past
jäähdytysveden	None
laakeroitu	Past
hilsehtinet	Present
kasteltu	Past
vierastivat	Past
salakuuntelee	Present
valmistutaan	Present
tehosta	Present
höperö	None
ruskistuttu	Past
inhottu	Past
patisti	Past
turmeltu	Past
juuttuu	Present
arvostanut	Past
piirikuntaa	None
hajoamisen	None
dokumentoinnissa	None
pitkitti	Past
juonii	Present
sievenemme	Present
suostui	Past
kolottakaamme	Present
suomalaistunut	Past
hävitettävä	Present
yskikää	Present
punoittanee	Present
loristakoon	Present
puistitte	Past
kriisinhallintajoukkoja	None
epäonnistuisi	Present
vakauttaa	Present
myöhästyvät	Present
testeihin	None
harjoittelevat	Present
liikevaihtovero	None
reduktio	None
onnelliseen	None
ryöstöviljelkööt	Present
hellenismeille	None
huutaisi	Present
hapatetaan	Present
rannikosta	None
avittaa	Present
limapussille	None
rikotaan	Present
sievennevät	Present
nujersivat	Past
paimennat	Present
aiheudu	Present
katselen	Present
osuu	Present
hiiletettäisiin	Present
purkitettu	Past
vieraskielisille	None
amiraalille	None
laulaisi	Present
ilmiantanut	Past
sisäoppilaitos	None
julkista	Present
kiitetään	Present
räjähti	Past
hyllyttäkööt	Present
aineellisiin	None
loitsusta	None
silppua	Present
ylitetty	Past
lahjustutkinnalle	None
valmistuivat	Past
esittävä	Present
puberteetti	None
meriahvenet	None
viivytettiin	Past
helpottuivat	Past
värväytyi	Past
löytäisi	Present
jahnannee	Present
lunastettu	Past
karaistukaamme	Present
pesevät	Present
välttyvät	Present
voimaantullut	Past
sano	Present
selventävät	Present
länsimaissa	None
kenkiin	None
burkitta	None
koitukoon	Present
lannistunut	Past
tiiataan	Present
klarinetilla	None
edellytettiin	Past
jojon	None
palautuivat	Past
jytäsit	Past
mäkihyppääjien	None
säilytetään	Present
tulostuu	Present
jollaisten	None
renttuihin	None
kaksiajoratainen	None
sukusolut	None
esiteltäisiin	Present
nuhtelee	Present
analysoinnissa	None
tavoitellaan	Present
hillinnyt	Past
hirvittävä	Present
uppokantanaulaan	None
täsmennetään	Present
poskille	None
niljaantunette	Present
huudahtelimme	Past
syyllistää	Present
odotettu	Past
leikki	Past
jaotettava	Present
kuljetti	Past
urheilullisen	None
ponnahtaa	Present
molemminpuoliset	None
vähene	Present
suonut	Past
tunnistettaisiin	Present
alettiin	Past
edellyttäisivät	Present
nukahtelisitte	Present
kaulitsit	Past
levennetty	Past
vastustamme	Present
hyödykkeestä	None
tehokkaimmat	None
laukoo	Present
kiiruhtavat	Present
rohkaisee	Present
ärsykkeestä	None
varoitettu	Past
heitetään	Present
lintuinfluenssa	None
hankittu	Past
kuljettivat	Past
laskeskeli	Past
vihjattiin	Past
mellotin	Past
kypsyttää	Present
kromattu	Past
uneksinut	Past
kutoo	Present
risteytyivät	Past
keskiöstä	None
lineaarikombinaationa	None
kunnallistekniikkaa	None
kilpailuttaa	Present
kerjettiin	Past
irtisanoutunet	Present
epäillä	None
luisti	Past
anemioin	None
lentoyhtiöillä	None
herkistä	Present
tiivistetty	Past
paaston	None
dubattiin	Past
katkeroitunut	Past
tyytyvät	Present
murskataan	Present
keräävä	Present
mättää	Present
leimattu	Past
yksinkertaista	Present
esikatseltaisiin	Present
nypyin	None
muistettaisiin	Present
perusmuodot	None
paastottiin	Past
öljyvalaistuksesta	None
häpeällisiä	None
dorkasgaselleilla	None
käännösromaaneilla	None
lyhemmin	None
houkutellut	Past
harjoittaa	Present
kirjoittanut	Past
sinisen	None
meritaisteluista	None
uhmasivat	Past
monimiljoonaisia	None
sinkoutuu	Present
pätevöity	Past
kuutioinen	Present
kestit	Past
unkarinkielisen	None
hätiköity	Past
tunkeutuu	Present
luisuu	Present
mahdottomuuteen	None
mokujen	None
katkotaan	Present
johtunevat	Present
rakeista	Present
turmeltunut	Past
murjaisee	Present
surffasivat	Past
luhistuivat	Past
prosessoisi	Present
tilkan	None
psilosybiineineen	None
nimisessä	None
kuulusteltava	Present
tapitti	Past
järkyttivät	Past
aloitteessa	None
avioituvat	Present
mullistava	Present
ylittävä	Present
tileissä	None
ryntäsi	Past
selvitteli	Past
haljennut	Past
altistaisi	Present
kuuntelee	Present
tallennan	Present
noudattaisivat	Present
suuttuu	Present
estellen	Present
nevoilla	None
jyrkensi	Past
pikkukylän	None
kuvautuvat	Present
ehdota	Present
takamailta	None
kaunistaa	Present
kupariherkkusienettä	None
hoonasin	Past
maalailtaneen	Present
talvehti	Past
haistatte	Present
houkuttivat	Past
isoiksi	None
kuro	Present
happeningit	None
kuunsirppiä	None
vainottu	Past
atopia	None
koskettaa	Present
jättäytyi	Past
kadehti	Past
kiitämme	Present
kiemurtelee	Present
suitset	Present
uunolle	None
kostanut	Past
kolahtaa	Present
aorttatulehduksista	None
havainnollistavat	Present
suuntautuivat	Past
kardinaalit	None
stylisoinet	Present
notarisoinut	Past
sovitussa	None
luistimia	None
jatkunut	Past
kunnioitettu	Past
tongalaiset	None
kaupallistui	Past
varo	Present
aiheuta	Present
iskeä	None
vaihtuvat	Present
kiellän	Present
irvinen	Present
seurasivat	Past
kirpoaisit	Present
avasin	Past
ylinopeutta	None
lainaavat	Present
kasasivat	Past
tasapainoili	Past
kopioinut	Past
kelpuuttanut	Past
omaelämäkerrallista	None
erottui	Past
generoidaan	Present
mekaanista	Present
näyttelytilojen	None
vitsailivat	Past
dieetin	None
geosynkronisella	None
täsmentävät	Present
hahmottaa	Present
väärinkäyttänyt	Past
olemassaoloa	None
kristalloitui	Past
äänny	Present
nostattavat	Present
akkamaisiin	None
herjaavat	Present
villiviinit	None
lainattiin	Past
maukukaa	Present
latinalaista	Present
mitattu	Past
elvyttänyt	Past
varttuvat	Present
komentanut	Past
yrittää	Present
savanneille	None
viipyvät	Present
ryvettäneen	Present
muotoat	Present
torjuvat	Present
örähdelkäämme	Present
toteutin	Past
täsmensi	Past
vetäydyitte	Past
vanhoillisia	None
tuoksuu	Present
metsänhoitoa	None
murhattu	Past
vaalinut	Past
haaroittanen	Present
tiedusteltu	Past
mikrosiru	None
pyyhki	Past
pudottautuu	Present
sulhasen	None
sudennahkoista	None
tekemättömistä	None
tarvitsijoilta	None
ohjelmoitava	Present
maalämpö	None
pillahtanee	Present
avaruustekniikan	None
yhtenäistyi	Past
hyötyisin	Present
kattoivat	Past
henkilöautojen	None
paljastaa	Present
kaupustelija	None
valittaisi	Present
arvovaltaa	None
korjasi	Past
muistetaan	Present
majoittui	Past
laulakaamme	Present
liukastui	Past
haastateltiin	Past
huomautan	Present
sulautettiin	Past
pantoteenihappo	None
haudannut	Past
harpilla	None
sokeuttaa	Present
uunilinnut	None
kiepahtakaamme	Present
määrättyyn	None
tyylikkäät	None
saottu	Past
ottelijoille	None
valehtelen	Present
hahmotusta	None
repesivät	Past
butanaaleitta	None
riistana	None
etsintäkuulutettiin	Past
nyrjäyttänyt	Past
järisi	Past
unohtivat	Past
pyyhkäisi	Past
kantautuva	Present
käristettäneen	Present
kypsyvä	Present
jaellaan	Present
noradrenaliinia	None
rakastaisi	Present
dokumentille	None
myyntitulot	None
ryntäävät	Present
päätelty	Past
laajennan	Present
osasi	Past
haarautunemme	Present
poistavat	Present
talkitsemme	Present
uinneille	None
hautavajoaman	None
kartutaan	Present
ehtii	Present
matkijoiden	None
märehtimiselle	None
väittänyt	Past
avustaa	Present
jatkettava	Present
vilkuttaa	Present
huiskuttaa	Present
onnistunut	Past
lakaiskaamme	Present
humahtaisit	Present
lamaantunut	Past
instanssin	None
juridiset	None
märehdittäisiin	Present
pysynyt	Past
viitsii	Present
ylängöksi	None
kirkkokansan	None
tulvii	Present
kehittelevät	Present
suomalaisti	Past
loskaannun	Present
kuntoutamme	Present
heijastu	Present
vuokrattiin	Past
kuohui	Past
tragikomedioihin	None
tunnistavat	Present
kerätään	Present
lähentänyt	Past
höllennettiin	Past
venäläistyi	Past
juopunut	Past
tartuntatauti	None
pyörittäneen	Present
uskaltanut	Past
saneerattu	Past
kulkueille	None
ohjeet	None
virtaan	Present
törmäykset	None
liioitellen	Present
tappoi	Past
rajoittamattomiksi	None
kuvittaa	Present
vaella	Present
järjestämme	Present
vuodettiin	Past
olettavat	Present
gratinoikaamme	Present
putoili	Past
toimita	Present
tajuaa	Present
lausuu	Present
totu	Present
mullistaa	Present
kasaantuu	Present
varaosina	None
yhdistän	Present
ymppäisimme	Present
kotoista	Present
auttaa	Present
ajoradalle	None
yhdistyivät	Past
juontuvat	Present
rupeat	Present
erisnimi	None
pilkkoivat	Past
jaeltiin	Past
hajautunut	Past
siveysvyö	None
jäätyy	Present
vihjaileva	Present
vakavasta	None
yhtyköön	Present
pukeutui	Past
varasti	Past
sopimuksiin	None
erikoistuvat	Present
eritasoliittymien	None
äänsivät	Past
dumppasi	Past
voitelee	Present
pärissevät	Present
hyydy	Present
selaat	Present
vaaleimmat	None
vertaillen	Present
silvottiin	Past
suostunut	Past
pelisäännöille	None
äänieristänen	Present
siteeraan	Present
louhittu	Past
väitetty	Past
ylikorostaa	Present
ehtoollismaljoissa	None
sihisee	Present
purskauttaa	Present
aiheuttavat	Present
öljyisestä	None
huojistaisitte	Present
halveksii	Present
speltteinä	None
singulariteetin	None
joukkomurhiin	None
elosteltakoon	Present
aurattu	Past
kouluttaa	Present
maailmansotia	None
uskottavina	None
rankaissut	Past
vallitsee	Present
korporaatioiksi	None
lahjoivat	Past
vyötä	Present
huomannut	Past
toivotetaan	Present
integroidaan	Present
suojautunevat	Present
vankensivat	Past
vientituotteena	None
kohenee	Present
pelätty	Past
syödään	Present
tiedostavat	Present
hävitetään	Present
poliittista	Present
separatistit	None
sisällytetään	Present
huuhtoi	Past
panosti	Past
kidnapattiin	Past
toivottava	Present
ylennyksiä	None
reunusta	Present
rauhantekoa	None
kipsaannuin	Past
evankelioinen	Present
raivostuttaa	Present
peluri	None
kännykällä	None
radikaalisti	Past
hiukkasella	None
kreikalta	None
suoristautuisimme	Present
pengerretty	Past
arvostettiin	Past
neuvottelevat	Present
höyryinen	None
olematon	None
telminette	Present
dialektiikan	None
kiihkoa	Present
darra	None
valahdamme	Present
metsästä	Present
mystinen	None
puremat	None
väheksyy	Present
yleistetty	Past
kakistettaisiin	Present
äyritätte	Present
ostanut	Past
huutaisivat	Present
kaivoi	Past
kirskauttanet	Present
kerettäköön	Present
raittiuslupauksineen	None
junailtaneen	Present
ihmetyttää	Present
sijoitettava	Present
pelastusveneet	None
vierittää	Present
malignisoituvat	Present
kovettuva	Present
lahjovat	Present
ansaitaan	Present
työntää	Present
sivuutti	Past
fragmentoikoon	Present
kovakourainen	None
autettu	Past
ekologia	None
varastot	None
liittyvä	Present
tulehtui	Past
kuunteleva	Present
rasitukseen	None
täydennetään	Present
kannustan	Present
ohjeisti	Past
kiihtynyt	Past
kanssakäymisen	None
heksogeenit	None
nopeuta	Present
lisännee	Present
aluevesiä	None
hävittäisi	Present
opiskelee	Present
rikospoliisi	None
pystytti	Past
suorettiin	Past
opiskeltu	Past
sortuvat	Present
nautittava	Present
peloteltu	Past
arpoo	Present
särisset	Present
yöpyvät	Present
lakastuvat	Present
vitamiineista	None
osallistun	Present
kastuu	Present
soitteli	Past
ruokailevat	Present
tarttuu	Present
tankeissa	None
kelkkailtu	Past
häikäilemättömät	None
katalonialaisen	None
solmuun	None
rantapallolle	None
atavistisina	None
reunustivat	Past
tiedusteltiin	Past
harmittava	Present
kariutuvat	Present
modernistit	Past
silitelty	Past
suoristetaan	Present
kokisivat	Present
vastaavista	None
paranee	Present
järjestysluvuksi	None
tuskastui	Past
virtauksiin	None
ylitettiin	Past
maamyyrät	None
karsintaottelut	None
sairastivat	Past
maistiaisiksi	None
tiivisti	Past
tikittää	Present
metropolin	None
näytellen	Present
akkusatiivi	None
syötin	Past
turvautuvat	Present
kuunnellut	Past
valehtelisitte	Present
hurjastellee	Present
kapinoinut	Past
