vakaan	None
valtiasta	Partitive
vessapaperia	Partitive
nominatiivin	Genitive
lykättiin	None
sekoitusta	Partitive
äimistellään	None
testeistä	Ablative+In
kaarevuuden	Genitive
kömpelön	None
syyttä	Privative
jumeilta	Ablative+At
protestanttisen	None
oppituntien	Genitive
diskausta	Partitive
isäntämaana	Formal
kylkiviivan	Genitive
päähenkilöihin	Allative+In
kranaatin	Genitive
lainsuojattomasta	Ablative+In
elektronisella	At+Essive
luonnistu	None
möyhentimellä	At+Essive
postituslistalle	Allative+At
rikkaista	Ablative+In
takaisinkytkennällä	At+Essive
epäsiistin	None
oksilta	Ablative+At
metalliseksi	Translative
kilpailutilanteessa	Essive+In
ohitti	None
käyttäytyä	None
kunnailla	At+Essive
demokraattisella	At+Essive
viileänä	Formal
ilmakehää	Partitive
avaajin	Instrumental
kohtauksena	Formal
karstiksi	Translative
marjamaitojen	Genitive
yhteiskouluun	Allative+In
koordinoinette	None
järvialtaan	Genitive
kertynyt	None
ajantasaisen	None
kartoituksella	At+Essive
puistojen	Genitive
kirjailijalle	Allative+At
diktatuurien	Genitive
kävelykeppinä	Formal
näyttelyn	Genitive
kuoppaan	Allative+In
jahtasi	None
porata	None
kohdennettu	None
otavasta	Ablative+In
ymmärrät	None
lapsellisilta	Ablative+At
dösillä	At+Essive
petollisuutta	Partitive
kylmää	Partitive
pakolaisilla	At+Essive
identifioitua	None
sieti	None
junioria	Partitive
buunattakoon	None
tyköistuvassa	Essive+In
magmaksi	Translative
diskvalifioi	None
kaivan	None
suorakulmaisten	None
komissa	Essive+In
ukkosia	Partitive
joukkovelkakirjojen	Genitive
ristiriitaisesta	Ablative+In
syyllisty	None
säästi	None
herätettiin	None
kansallisarkiston	Genitive
esityksistä	Ablative+In
kivisimppuihin	Allative+In
itsenäiseksi	Translative
hiuduttanette	None
seurueineen	Comitative
viuhahdukseksi	Translative
nukleotidin	Genitive
laskuvarjojen	Genitive
hengitysteitä	Partitive
erikoistuneena	Formal
epäonnistuneena	Formal
oikeudenmukaisuudella	At+Essive
työläin	Instrumental
peruksille	Allative+At
musiikkitalossa	Essive+In
korruptoituneiden	None
uskontunnustukseen	Allative+In
kaksipaikkaisten	None
huomauttavat	None
keskushallintoa	Partitive
hävittänyt	None
yliannostuksen	Genitive
kirjaudu	None
vähäteltiin	None
huttua	Partitive
plagioivat	None
kuvitella	None
styroxilla	At+Essive
kiteytynyt	None
koitoksen	Genitive
vararikkoon	Allative+In
luvattomasta	Ablative+In
puhaltanut	None
tšetšeeniä	Partitive
kumparelaskun	Genitive
kolminkertaistaisitte	None
hieroi	None
kaoottiseen	Allative+In
plutoniumpommien	Genitive
kielteisten	None
sianlihasta	Ablative+In
mikrotaloustieteittä	Privative
palautui	None
sekalaisia	Partitive
säilymiselle	Allative+At
vasemmistolaisuudesta	Ablative+In
troposfäärin	Genitive
esperanton	Genitive
tehottomaksi	Translative
asukasluvussa	Essive+In
vaakunoissa	Essive+In
hävittäjänä	Formal
alettava	None
isänmaallisten	None
suojelupoliisille	Allative+At
rakennuttivat	None
informoida	None
lykkäytyi	None
lähiöiden	Genitive
liittovaltion	Genitive
lyö	None
vesittykäämme	None
maksimoivat	None
etruskien	Genitive
helkavirsin	Instrumental
muuttanut	None
tilavuuteen	Allative+In
välttämisen	Genitive
surullisesta	Ablative+In
valvottu	None
sijoituspaikkoina	Formal
loppuunmyyty	None
ohjelmajohtajaksi	Translative
vahvistimeen	Allative+In
förskoteista	Ablative+In
säärevästä	Ablative+In
yhtyvä	None
siirryttiin	None
fenoleihin	Allative+In
lukkiintukoon	None
sanoittajaksi	Translative
kantille	Allative+At
herkistymistä	Ablative+In
väkevöidä	None
ensiavussa	Essive+In
rauhoittavat	None
poikkeavaksi	Translative
evankeliumissa	Essive+In
lyseoissa	Essive+In
kuvitteelliseksi	Translative
stailaisitte	None
museota	Partitive
ryösteltiin	None
heittelehtisivät	None
sähkökatkoja	Partitive
rumentaa	None
paljakaksi	Translative
galvanoitu	None
plantaaseilla	At+Essive
rakennusmateriaalista	Ablative+In
selvitän	None
osallistujina	Formal
kosmeettisten	None
eturaajoin	Instrumental
salailla	None
mittasuhteisiin	Allative+In
osastolta	Ablative+At
alakoulun	Genitive
äveriöitynemme	None
rohkaise	None
liitokoneita	Partitive
mielletään	None
kokeneesta	Ablative+In
majoituksille	Allative+At
karummalle	Allative+At
advektiona	Formal
sählättäköön	None
alhon	Genitive
nopeampia	Partitive
vaihtua	None
ympäristöllä	At+Essive
irtisanottu	None
kauppaavat	None
näytönohjaimissa	Essive+In
johtopaikan	Genitive
levysoittimille	Allative+At
välimatkoja	Partitive
tuntuvan	None
proletaariin	Allative+In
täysistunnossa	Essive+In
jalostava	None
realisoituva	None
periaatteelle	Allative+At
ommelkankaasta	Ablative+In
epäonnistumisiin	Allative+In
kodinkoneissa	Essive+In
sairastua	None
kiekkoili	None
opittiin	None
lasisitta	Privative
kantauraliin	Allative+In
ritilän	Genitive
äidinkielestä	Ablative+In
säkeistössä	Essive+In
sijoitettava	None
soveliaaksi	Translative
toimitilan	Genitive
haamurajan	Genitive
tarttunut	None
kaustiselle	Allative+At
editointiin	Allative+In
keskushyökkääjiksi	Translative
rohkaistaan	None
koodeja	Partitive
harhaopista	Ablative+In
kyytä	Partitive
sketsiin	Allative+In
ennustamisilta	Ablative+At
artistia	Partitive
sorminivelille	Allative+At
korruptoida	None
propagandan	Genitive
metallisiin	Allative+In
astimelle	Allative+At
juopuneen	None
johdatella	None
liittyisivät	None
oikeudenkäynnillä	At+Essive
psyykenlääkkeitä	Partitive
karuista	Ablative+In
sydänkohtauksista	Ablative+In
additiivisen	None
anatomisia	Partitive
jakaumista	Ablative+In
valmistauduttakoon	None
imperfektillä	At+Essive
glutamaattia	Partitive
käskevän	None
ratkaisit	None
myyskentelin	None
tieteilijänä	Formal
vastustajalla	At+Essive
hiihtokeskuksista	Ablative+In
mainostava	None
rullata	None
lisukkeena	Formal
tähteen	Genitive
epäluottamusta	Partitive
unenomaiselta	Ablative+At
ornitologisiin	Allative+In
tähtijoukon	Genitive
laadittava	None
matkataan	None
hakemistosta	Ablative+In
mainitsit	None
puututtaisiin	None
valonnopeudesta	Ablative+In
syö	None
selänteeltä	Ablative+At
valvontakameran	Genitive
säätyvaltiopäivien	Genitive
sivutaan	None
realiteettien	Genitive
materialistisesta	Ablative+In
kostautuu	None
paikallistettu	None
kasta	None
turvallisuuspoliittisen	None
huiskinoineen	Comitative
knorrin	Genitive
virheiden	Genitive
stratosfäärin	Genitive
ratapölkkyjen	Genitive
kykyyn	Allative+In
poltettava	None
tukahduttaa	None
asuntojen	Genitive
tuulilasiin	Allative+In
ihokarvojen	Genitive
luottia	Partitive
esittelyksi	Translative
serviisejä	Partitive
myöntämisen	Genitive
kapsehtinet	None
nitojasta	Ablative+In
korvaavat	None
ensihoitoon	Allative+In
miehistyttäisiin	None
saniaisista	Ablative+In
työmieheen	Allative+In
valmistajaa	Partitive
adenosiinitrifosfaatin	Genitive
murtovarasta	Partitive
elokuisin	Instrumental
valloitettu	None
julkaisivat	None
suoneniskentöineen	Comitative
jalostaa	None
pistetään	None
kääreen	Genitive
yläraajojen	Genitive
seutukuntiin	Allative+In
motorista	Partitive
hakemusta	Partitive
auttavaa	Partitive
nailonin	Genitive
salpaava	None
keskitti	None
venäläistynyt	None
metodeista	Ablative+In
päätavoitteeksi	Translative
hyväksyttävinä	Formal
monimutkaiselle	Allative+At
hansan	Genitive
helistettäköön	None
liukastakaamme	None
todistusaineistoon	Allative+In
säestykseen	Allative+In
sotilaspoliisina	Formal
tallentuvat	None
arktisen	None
uusklassisen	None
rekisteröin	None
madaltaa	None
hapanlaskeuman	Genitive
asianhaarana	Formal
pistoolia	Partitive
erilaisimpien	None
yuguuritta	Privative
yleiskielellä	At+Essive
moderneimmista	Ablative+In
kiusauksista	Ablative+In
kaislahameen	Genitive
ydinräjähteiksi	Translative
jähmenette	None
lyhenteisiin	Allative+In
lupasi	None
suljetuille	Allative+At
aterioi	None
edullisempana	Formal
teknologioista	Ablative+In
astronomisten	None
arvosanaksi	Translative
pöytäkirjaa	Partitive
hyödynnä	None
kalsiumista	Ablative+In
syntymäpäiväksi	Translative
partitioin	Instrumental
hyödyntämisestä	Ablative+In
kadottanut	None
neuvottelee	None
frekvenssimodulaation	Genitive
opetussuunnitelman	Genitive
surrealistiseksi	Translative
iskuta	None
kiasmassa	Essive+In
kalamiehen	Genitive
hyydytteeseen	Allative+In
sinfoniaa	Partitive
alipalkkaisella	At+Essive
vertaile	None
vittuilua	Partitive
hotkinevat	None
voimassaoloaikaa	Partitive
koneistoin	Instrumental
haisunäätien	Genitive
kiirunassa	Essive+In
ratkaisisi	None
niisisitte	None
lajitellaan	None
pullistunut	None
digitoinnin	Genitive
evankeliumien	Genitive
petturina	Formal
monenlaisin	Instrumental
räjähdykseen	Allative+In
innoittanut	None
sääennusteilta	Ablative+At
karstein	Instrumental
kotimajoituksessa	Essive+In
analogisten	None
kruunattu	None
juovakoodilta	Ablative+At
sylinterille	Allative+At
painotuksilla	At+Essive
suoriutuivat	None
tarkkailijalle	Allative+At
torjuva	None
diftongiutumiselle	Allative+At
pyrstösulissa	Essive+In
kuivuneeseen	Allative+In
omakohtaista	Partitive
rikkomuksesta	Ablative+In
hedelmistöön	Allative+In
sökötetty	None
pikajunan	Genitive
tokaisimme	None
taivuttavat	None
sisuksissa	Essive+In
dieettihoidotta	Privative
innostutte	None
avajaisia	Partitive
valmistautumisesta	Ablative+In
rientänyt	None
nyyhkäisyltä	Ablative+At
stabiloivat	None
nikkelimyrkytykseksi	Translative
kustantajana	Formal
levitti	None
hotelleita	Partitive
kaksisuuntaisella	At+Essive
polttoainetankkien	Genitive
otantatekniikoiden	Genitive
sellaisena	Formal
vesisäiliöiden	Genitive
ilmakuvassa	Essive+In
katson	None
vaihdantaa	Partitive
tapahtumaa	Partitive
puolivarjoksi	Translative
makeaksi	Translative
tietyn	None
siirappisine	Comitative
pakinoiden	Genitive
kiireellisessä	Essive+In
hidaspuheista	Partitive
hevoskuiskaajitta	Privative
jäykistyttiin	None
hallituspuolueen	Genitive
lisäystä	Partitive
kokonaisluvuille	Allative+At
polkupyörää	Partitive
vesialueesta	Ablative+In
kukkakaalikorvineen	Comitative
aitoa	Partitive
ymmärtävään	Allative+In
löylynlyömiin	Allative+In
kansallisti	None
karaistunut	None
majaileva	None
kolmivärisen	None
akvaariokalojen	Genitive
oiotaan	None
marssilaulun	Genitive
interpoloinnin	Genitive
kukistunut	None
rengasta	Partitive
huumeiksi	Translative
prostituoitujen	Genitive
rintaonteloon	Allative+In
šakinpelaajaksi	Translative
vesipumpuissa	Essive+In
eoseenikauden	Genitive
klaanien	Genitive
ukrainalaisen	Genitive
vanhanaikaisiksi	Translative
öljysatamassa	Essive+In
ammuskelussa	Essive+In
poliota	Partitive
teleskooppien	Genitive
muutuin	None
rekisteröidyin	Instrumental
käärii	None
vakiintuvat	None
kuulalaakeroikaamme	None
istuimelta	Ablative+At
mukaelmissa	Essive+In
taimikon	Genitive
kumparelaskussa	Essive+In
vesilintuja	Partitive
pyöreähkön	None
poimivat	None
aamupalaa	Partitive
toimettomina	Formal
sekamelskaa	Partitive
kiinnostaisi	None
kartoittanut	None
sytytystulppien	Genitive
lovennemme	None
arabianhevosilla	At+Essive
broileripaistoksilla	At+Essive
nuuskan	Genitive
äkkinäisen	None
koitti	None
kauppakoulussa	Essive+In
vittuilisi	None
niobiumin	Genitive
valtiotieteilijään	Allative+In
orjuuttaa	None
nautitaan	None
kulmaminuuttia	Partitive
yksittäiselle	Allative+At
väärinkäyttöön	Allative+In
sokkotreffeillä	At+Essive
strontiumin	Genitive
maksullisista	Ablative+In
bensiinimoottorin	Genitive
syrjäiseltä	Ablative+At
rajojen	Genitive
huonoilla	At+Essive
hieron	None
sarkastisen	None
moodien	Genitive
skitsofreenikkoja	Partitive
sanoittavat	None
vaistosi	None
menestyvien	None
hiomakoneissa	Essive+In
verkostoitunut	None
leijua	None
hallittuun	Allative+In
kronologiatta	Privative
arkkuvaatteella	At+Essive
aloitteleva	None
villikarjun	Genitive
muskonein	Instrumental
vuosilomaa	Partitive
paikkaisia	Partitive
operoinnista	Ablative+In
urotöissä	Essive+In
poistoilman	Genitive
puheenaiheita	Partitive
lakikielessä	Essive+In
säestivät	None
avioehdoista	Ablative+In
silmäkuviossa	Essive+In
opetusmateriaalin	Genitive
yksityisomaisuuden	Genitive
kynänterineen	Comitative
tavarataloissa	Essive+In
kuvauksineen	Comitative
kealla	At+Essive
eldoradon	Genitive
nolon	None
sapattia	Partitive
ruokailisimme	None
laudan	Genitive
nanometriä	Partitive
viileämpään	Allative+In
maltankielisenä	Formal
selittämättömistä	Ablative+In
miksauksessa	Essive+In
alkeisiin	Allative+In
marmorisitta	Privative
makuuhuoneiden	Genitive
luoteisten	None
diskografioihin	Allative+In
kokoelmaan	Allative+In
sävykkäältä	Ablative+At
jalanjälkien	Genitive
rusakon	Genitive
radiosignaaleita	Partitive
vaurastui	None
lähikuvia	Partitive
tumakkeessa	Essive+In
termejä	Partitive
uimarantojen	Genitive
tuloeron	Genitive
teettää	None
niljaantukaamme	None
ratsastuskoulujen	Genitive
eroottiseen	Allative+In
mutkittelevan	None
aarniometsiä	Partitive
diploidisia	Partitive
kadota	None
loppuvaiheista	Ablative+In
sijaitsevat	None
kotimaaksi	Translative
ylikersantiksi	Translative
muurareilta	Ablative+At
tajuta	None
tšekkiläisessä	Essive+In
seerumiin	Allative+In
pantavien	None
elinympäristöihin	Allative+In
tonniksi	Translative
surmia	Partitive
kivetty	None
presidentistä	Ablative+In
uponnut	None
äkämään	Allative+In
pronomineiksi	Translative
pahamaineisen	None
feodaalijärjestelmän	Genitive
madonreiän	Genitive
kasvavat	None
korkeushypyn	Genitive
radiokanavalla	At+Essive
kudottiin	None
jättimäisellä	At+Essive
poikkeavien	None
pallomerille	Allative+At
liiskannen	None
tuijan	Genitive
katkeroituneena	Formal
albumien	Genitive
vältetään	None
kyselyihin	Allative+In
oikeudellisen	None
verifioida	None
innostunutta	Partitive
leikkokukaksi	Translative
amerikanenglantiin	Allative+In
maagisiin	Allative+In
ohjaamon	Genitive
sinkosi	None
houkuttanevat	None
häirittiin	None
äänekkäinä	Formal
hakukoneena	Formal
väkivaltaisuutta	Partitive
tieteiden	Genitive
ennennäkemättömissä	Essive+In
rahoittamisessa	Essive+In
jäätyi	None
balttilaiseen	Allative+In
ponttonisillan	Genitive
pahoinpitelivät	None
lääninhallitusten	Genitive
fyrkkaa	Partitive
aion	None
tarpeelle	Allative+At
teollistuneiden	None
oikoteitä	Partitive
edeltävässä	Essive+In
aktiivisti	None
henkilöhistoriaan	Allative+In
funktionaaliseen	Allative+In
ruokakulttuuria	Partitive
fossiloitunemme	None
rautatievaunujen	Genitive
yhteisöllistä	Partitive
arktisista	Ablative+In
kirkonmiehiä	Partitive
merkitsivät	None
havupuille	Allative+At
sodankäyntiä	Partitive
puoltanut	None
miinustan	None
hanapakkauksia	Partitive
valloittanut	None
ilmastotieteessä	Essive+In
oppiaineena	Formal
puristussuhdetta	Partitive
ugandankobilla	At+Essive
vuokralaisista	Ablative+In
edustavien	None
kätköissä	Essive+In
kyynelnesteen	Genitive
alkamiseen	Allative+In
hirtetty	None
vallankumouksella	At+Essive
asymmetrisiä	Partitive
seisoo	None
aamulehdestä	Ablative+In
vogulien	Genitive
nälänhätien	Genitive
ahdattiin	None
runokielessä	Essive+In
osuuspankin	Genitive
affrikaattoja	Partitive
esteettisiä	Partitive
pyhäkouluun	Allative+In
valtiokirkon	Genitive
kokeva	None
osamaksulla	At+Essive
laivastoille	Allative+At
kielteisemmin	Instrumental
väitin	None
viiniköynnöksen	Genitive
lentonopeuden	Genitive
havainnoitu	None
riistaa	Partitive
kirurgisia	Partitive
ränsistyneitä	Partitive
työpäivän	Genitive
takaukselle	Allative+At
raffinoinen	None
tanssijoiden	Genitive
nussinnaksi	Translative
julmalle	Allative+At
bonuksena	Formal
speedwayllä	At+Essive
melodraamoja	Partitive
merilevissä	Essive+In
lapion	Genitive
puunilaissotaa	Partitive
asetu	None
poliisimiestä	Partitive
seurakuntayhtymän	Genitive
depolarisoida	None
akveduktia	Partitive
hypoteettisten	None
enantiomeerejä	Partitive
kannatettiin	None
aran	Genitive
muskeliin	Allative+In
ripsi	None
tullimaksun	Genitive
hiekkapohjaan	Allative+In
selityksiä	Partitive
ikään	None
kyläkauppaa	Partitive
joruban	Genitive
iltapäivälehdissä	Essive+In
nyppii	None
eksogeenisen	None
syrjäseutuja	Partitive
muskoviittia	Partitive
kenkien	Genitive
hillitsevät	None
kaksinkertaistuivat	None
riehun	None
aikamiesten	Genitive
isokokoisten	None
klepsydran	Genitive
jäniksenlihaa	Partitive
temppeliksi	Translative
linnakkeisiin	Allative+In
rankalaudalta	Ablative+At
huolittu	None
samankaltaisille	Allative+At
atlaksen	Genitive
edesauttavat	None
gallialaisen	Genitive
minäkuvaan	Allative+In
krakkauksessa	Essive+In
pikkutarkiksi	Translative
umpikujaan	Allative+In
mesimäyrillä	At+Essive
epäkäytännöllisenä	Formal
numeroitu	None
tyypiltä	Ablative+At
selaimista	Ablative+In
päättäjäisissä	Essive+In
sähköveroineen	Comitative
haahkoja	Partitive
kaulapannatta	Privative
iiriksillä	At+Essive
huonontua	None
kestin	None
tasausta	Partitive
virin	Genitive
mustetahraa	Partitive
mahdollistuisi	None
metsäisille	Allative+At
sirppejä	Partitive
aikaansaannoksena	Formal
nipottajin	Instrumental
yleisenä	Formal
vajassa	Essive+In
akkreditoitakoon	None
hinata	None
butanolia	Partitive
väitellevät	None
henkilöitynyt	None
sotatalouden	Genitive
barbin	Genitive
puolustuksia	Partitive
irvaillevat	None
kaapannut	None
rinnakkaista	Partitive
muotoiltu	None
evakuoitava	None
dosentin	Genitive
steriilillä	At+Essive
espoolaisen	Genitive
hengellisten	None
pääteasemana	Formal
kuumensi	None
uimarantaa	Partitive
realiteetteina	Formal
keitätettäneen	None
ammattimaisena	Formal
äidinkielenopettajana	Formal
piirrettäisiin	None
helvetillisiin	Allative+In
puuskilta	Ablative+At
palkintolautakunnalle	Allative+At
antifasistein	Instrumental
julkaistaan	None
ajoksen	Genitive
geotieteiden	Genitive
everstin	Genitive
tarkastelulla	At+Essive
jesidiksi	Translative
keskiluokkaistuvat	None
pipareilla	At+Essive
ämmänmarjoille	Allative+At
sikalan	Genitive
kaatosateessa	Essive+In
taajuuksilla	At+Essive
ainesosien	Genitive
kielitaitoon	Allative+In
palaussa	Essive+In
vatia	Partitive
vaalivilppiä	Partitive
meduusan	Genitive
piittaamatonta	Partitive
risteykseen	Allative+In
maanalaisten	Genitive
pätevänä	Formal
elinkelpoisten	None
magneettisia	Partitive
vakavuuksiksi	Translative
ydinlaitoksia	Partitive
lyhennelmille	Allative+At
unohtaa	None
slumpattakoon	None
piristävä	None
vuotuisessa	Essive+In
kirota	None
kuristuttaneen	None
vankeustuomioita	Partitive
kapitaloinemme	None
orpokodin	Genitive
testituloksen	Genitive
säpäleeseen	Allative+In
eläisi	None
jelpannet	None
kultaisimpien	None
tekijänoikeudesta	Ablative+In
löydätte	None
kypsyttää	None
pelilaudoista	Ablative+In
virheeseen	Allative+In
pyrstösulkaa	Partitive
tarjoutui	None
konsolipelin	Genitive
omaisuudeksi	Translative
kanootein	Instrumental
muuton	Genitive
vandalismiksi	Translative
tutkimuslaitoksiin	Allative+In
hanskan	Genitive
prologin	Genitive
kidnappasivat	None
sietänyt	None
pesiytynet	None
vakiintuu	None
tilapäisten	None
yhteistyökumppaneihin	Allative+In
huonontaa	None
valkosolujen	Genitive
matkustajakodin	Genitive
kyläkauppojen	Genitive
annosteltiin	None
antureissa	Essive+In
teloitusta	Partitive
kunnioitettiin	None
pörrännyt	None
kaavailee	None
mikronilta	Ablative+At
kaijasilta	Ablative+At
gravitaatiolain	Genitive
allegoriaa	Partitive
yläluokasta	Ablative+In
alueellisten	None
edustustoissa	Essive+In
teollisuusalueiden	Genitive
luotijunan	Genitive
huollossa	Essive+In
haaveen	Genitive
astioissa	Essive+In
pyhäköllä	At+Essive
välttyisivät	None
nyksin	Instrumental
yhdistelmästä	Ablative+In
tavanomaisessa	Essive+In
palveluille	Allative+At
markalle	Allative+At
marjasta	None
sotilasvallankaappauksen	Genitive
jäsenyyteen	Allative+In
lyhimmistä	Ablative+In
arvoisella	At+Essive
aivopuoliskossa	Essive+In
kalasti	None
allergologiksi	Translative
hietikkosaroissa	Essive+In
omaisuuden	Genitive
kanttinauhoilta	Ablative+At
halpeni	None
koditonta	Partitive
lähtemiseen	Allative+In
esiripun	Genitive
sarvijäniksiltä	Ablative+At
neuvostotasavallalle	Allative+At
puhjenneita	Partitive
reaktiossa	Essive+In
haisunäädän	Genitive
ylimmäisen	None
lukijakuntina	Formal
nopeammin	Instrumental
osakeyhtiötä	Partitive
ajallisia	Partitive
demonien	Genitive
antifasistista	Ablative+In
teilasi	None
hiostutaan	None
valtiopäivillä	At+Essive
aavikoitumisen	Genitive
olympiaurheilijoiden	Genitive
vaappuisimme	None
tulehtuvat	None
ulkoisena	Formal
laiminlyöntejä	Partitive
alkuperäiskielistä	Ablative+In
pitkäpiimäisyyksien	Genitive
pikaiseen	Allative+In
yläosien	Genitive
sarvimaisilta	Ablative+At
fantasiamaailmasta	Ablative+In
henkilöhistoriasta	Ablative+In
reagoinut	None
monimutkaistavat	None
otsalohkon	Genitive
askartelupapereita	Partitive
dopplertutkalla	At+Essive
musertavan	None
sävelkorkeuksia	Partitive
nähtävyyksien	Genitive
sairastuivat	None
valmistetuista	Ablative+In
mailaa	Partitive
valtionkirkosta	Ablative+In
tekstiltä	Ablative+At
luokittelussa	Essive+In
muinaisenglannin	Genitive
aavisti	None
kaksipuolista	Partitive
roudarina	Formal
ylioppilaista	Ablative+In
nääntyi	None
kulttuureista	Ablative+In
hajauttaa	None
jatkuisivat	None
pikkuitiöpesäkkeenä	Formal
pikseleinä	Formal
muistomerkkeineen	Comitative
ponnistuksen	Genitive
äijän	Genitive
toiminimeä	Partitive
saimme	None
eritellyt	None
akanvirtalta	Ablative+At
ryhdyttäisiin	None
passiivisina	Formal
aurinkoiselle	Allative+At
nuoralla	At+Essive
kanavoi	None
depressioon	Allative+In
värähteli	None
moraalittomuuden	Genitive
tuomaristoon	Allative+In
elektrodina	Formal
kaasupitoisena	Formal
aivotärähdykseltä	Ablative+At
luontaiselta	Ablative+At
thereminin	Genitive
alkulohkoissa	Essive+In
perilliselle	Allative+At
teilittä	Privative
viritykseen	Allative+In
oikeaan	Allative+In
isoakselin	Genitive
rikokseen	Allative+In
ruokinnan	Genitive
muodostumista	Ablative+In
soittorasian	Genitive
kirotun	None
papillisen	None
puhjenneen	None
raivaamiseksi	Translative
yksipuolisuuksilta	Ablative+At
lennokkaatta	Privative
kysyttyjä	Partitive
jatkunet	None
adenomyoosia	Partitive
äärivasemmiston	Genitive
institutionaaliseen	Allative+In
ehtyvät	None
uskonnollisilla	At+Essive
huipuilla	At+Essive
pimittänyt	None
kuolemansynnistä	Ablative+In
univormun	Genitive
nilviäisiin	Allative+In
jäähallien	Genitive
painottoman	None
kiekosta	Ablative+In
komisarion	Genitive
triptyykin	Genitive
puutarhanhoidon	Genitive
liukumiinoja	Partitive
lööperein	Instrumental
oratuomiin	Allative+In
yrityskaupoista	Ablative+In
päällysteelle	Allative+At
elätellette	None
houkuttivat	None
luottamuksellisten	None
satakuntalaisen	Genitive
alaotsikoksi	Translative
periytyisi	None
kuivakäymälällä	At+Essive
ylenpalttisen	None
kansainvälisyydestä	Ablative+In
laiskistuitte	None
väheksyivät	None
nuudeleita	Partitive
illanvietoissa	Essive+In
baijerilaisen	Genitive
koketeerannen	None
jaeltu	None
vapautuva	None
alkanut	None
kommunistipuolueen	Genitive
konservatorioineen	Comitative
peuhannemme	None
törmätty	None
rospuuttoajalla	At+Essive
pyörivien	None
rimaa	Partitive
veroprosenteitta	Privative
marmorisen	None
kuudennesta	Partitive
velkautimme	None
räjähtäneestä	Ablative+In
pidättelee	None
talouspoliittista	Partitive
verkkokalvossa	Essive+In
sijaisvanhemmissa	Essive+In
matalammassa	Essive+In
ihastui	None
metsätalousministerien	Genitive
aukottoman	None
jalkaväessä	Essive+In
päähenkilöiksi	Translative
eväiden	Genitive
onnistun	None
demoilla	At+Essive
ansiotuloja	Partitive
käännettyjen	None
martinilla	At+Essive
tutkii	None
tieteenaloista	Ablative+In
perusosana	Formal
ime	None
määräytynyt	None
lynkkasivat	None
paahtopaisteista	Ablative+In
vetyperoksideja	Partitive
arvotonta	Partitive
kannustettu	None
helmistä	Ablative+In
jaksollisia	Partitive
levytykseen	Allative+In
snautseria	Partitive
karisteilla	At+Essive
eläväisettä	Privative
hennon	None
radioaseman	Genitive
kliinisiä	Partitive
konserttimestariksi	Translative
sosiaalidemokraatteja	Partitive
suuontelon	Genitive
muusikoilla	At+Essive
rukoile	None
itseoppineena	Formal
öljytuikkujen	Genitive
rullia	Partitive
lukittunen	None
riitti	None
kömpelöksi	Translative
asianajajista	Ablative+In
aristettiin	None
coupén	Genitive
valapaton	Genitive
hydroksidien	Genitive
muodostuisi	None
uimahypyissä	Essive+In
kritisoidaan	None
kanneajassa	Essive+In
geneettisellä	At+Essive
työterveyshuoltoa	Partitive
persoonallisten	None
ruostutetaan	None
pelkistetty	None
seutukunnasta	Ablative+In
hartsien	Genitive
kuljeskelee	None
kanjoneita	Partitive
pitkästynyt	None
kurkumiinin	Genitive
seikkaperäisen	Genitive
kokonaistuotannosta	Ablative+In
lapsipornoa	Partitive
koeta	None
sopeutuva	None
hahmottua	None
epätodellisen	None
perusteella	At+Essive
symboliikkaan	Allative+In
psilosiinin	Genitive
silikaatteihin	Allative+In
sietivät	None
lottia	Partitive
sukupolveen	Allative+In
syösty	None
skolioosia	Partitive
ajanhaaskauksia	Partitive
punineen	Comitative
ohjaimiin	Allative+In
pulloista	Ablative+In
odelmikkojen	Genitive
maanviljelykseen	Allative+In
tsemppiä	Partitive
hyllyyn	Allative+In
selittävä	None
ansojen	Genitive
pelastakaa	None
avosuota	Partitive
kysele	None
labradorin	Genitive
tietokilpailuun	Allative+In
maantieteellisten	None
telakoituvat	None
palellutti	None
konjugaation	Genitive
käyttäytyisi	None
otollisen	None
reliefissä	Essive+In
ektoplasman	Genitive
ateriaan	Allative+In
monisteita	Partitive
upottava	None
happamoitumista	Partitive
kokonaisina	Formal
minimaalisen	None
kelmien	Genitive
kovenivat	None
olennaista	Partitive
futarien	Genitive
kabotaasien	Genitive
noradrenaliineissa	Essive+In
erottanut	None
kissamaisen	None
naurulokkeja	Partitive
kytkyllä	At+Essive
uskonnonvapautta	Partitive
tarkkailtiin	None
journalismia	Partitive
paleontologisia	Partitive
ukkosesta	Ablative+In
työstää	None
onnistunutta	Partitive
haavoittunutta	Partitive
viskatsarottiin	Allative+In
entsyymin	Genitive
hererojen	Genitive
berliininpoppelilla	At+Essive
kopioi	None
paljastuvat	None
avoliittoa	Partitive
pitkäaikaiseksi	Translative
eläinmaantieteestä	Ablative+In
kesähorroksesta	Ablative+In
kudottaisiin	None
konsortioon	Allative+In
sametinpehmeän	None
rajoitteita	Partitive
cherokeen	Genitive
soluelimiä	Partitive
rikkinäisiä	Partitive
sekoituksen	Genitive
jihadin	Genitive
seuralaista	Partitive
kirurgiksi	Translative
rivien	Genitive
työkaluna	Formal
purjehtinut	None
epidemiologian	Genitive
tietoverkkoihin	Allative+In
teloituksia	Partitive
suojelemisessa	Essive+In
tunnustava	None
aloitussyötön	Genitive
takavarikoidaan	None
pakottamiseksi	Translative
elokuvatuottajana	Formal
sanoitettiin	None
ergonomiaan	Allative+In
kutistunut	None
epäselviä	Partitive
koripalloilijan	Genitive
matkijoiden	Genitive
förskotiksi	Translative
suomennettu	None
kuusivuotiaan	Genitive
tiheydellä	At+Essive
perinteessä	Essive+In
tottumattomissa	Essive+In
pyroteknisen	None
patikointia	Partitive
tuoksuvan	None
stolaa	Partitive
lasimaalauksia	Partitive
japaninmispeleistä	Ablative+In
ilmatorjunnalle	Allative+At
maahanmuuttopolitiikan	Genitive
suojattaisiin	None
happamuusfunktiossa	Essive+In
euforiaksi	Translative
kahlehdittu	None
aiheettomana	Formal
kielin	None
synkronoitu	None
maskuliinisten	None
höyrystäisimme	None
kurnittaisiin	None
agentuuriliikkeissä	Essive+In
sekaannuksiin	Allative+In
ohjausta	Partitive
lutuisiksi	Translative
pyrstöä	Partitive
barokkisolisteilla	At+Essive
järjestelkööt	None
kaitsijan	Genitive
sivuutti	None
viikoittaisilla	At+Essive
lamauttanen	None
kyseenalaisesta	Ablative+In
venäläistettiin	None
oletti	None
halokliineille	Allative+At
muistutan	None
kokoomusten	Genitive
lentoliikenteille	Allative+At
huvitusten	Genitive
vastineita	Partitive
konsulttia	Partitive
sirkan	Genitive
totuuskomissiota	Partitive
polttohautauksen	Genitive
ryhmittymään	Allative+In
jakaumaa	Partitive
opetti	None
zoomata	None
vähentänyt	None
vulgäärinä	Formal
muumeille	Allative+At
Kantoniksi	Translative
adjektiivisuuksin	Instrumental
äänenmurroksen	Genitive
pedofiliaa	Partitive
kaappauksen	Genitive
ylentää	None
radioaktiivisuudesta	Ablative+In
lepuuttaa	None
sukkanukeksi	Translative
näkökulmien	Genitive
hypoteesiin	Allative+In
pelästyisin	None
rapistuivat	None
kohtauksia	Partitive
kellotornista	Ablative+In
sotilaille	Allative+At
opasteen	Genitive
väärinkäyttöä	Partitive
mineraaliesiintymin	Instrumental
niele	None
kansanedustajasta	Ablative+In
vartiomiehen	Genitive
feministeistä	Ablative+In
omenapuita	Partitive
tallentava	None
automaattina	Formal
kesäpäivänseisausta	Partitive
lääkintämieheksi	Translative
sosiologian	Genitive
nuhdella	None
kiinteistökehittäjään	Allative+In
välityksessä	Essive+In
jakajien	Genitive
äänenvaimentimia	Partitive
holhoojahallituksen	Genitive
kapokkiin	Allative+In
maailmankuulujen	None
yksinhuoltajaäidin	Genitive
nunnia	Partitive
mättäiköistä	Ablative+In
menneisyyteen	Allative+In
häikäilemättömällä	At+Essive
tuntemusten	Genitive
soidinnetaan	None
varovaisuudesta	Ablative+In
tulkitsevat	None
rangaistuspotkussa	Essive+In
tapellut	None
munakotelon	Genitive
onnettomuudelta	Ablative+At
lännenmuuralla	At+Essive
vajan	Genitive
teosofisen	None
jymähtelisit	None
tarjoutunut	None
ulkomaanrahasta	Ablative+In
hellenistisessä	Essive+In
kapakoitsijoitta	Privative
jakaa	None
laivastojen	Genitive
punoudun	None
internationaalissa	Essive+In
hivauttivat	None
emigroitunut	None
laminoida	None
muuttuvaan	Allative+In
muinaisvenäjän	Genitive
häärii	None
maallikolle	Allative+At
vainotaan	None
erittää	None
omaisuudella	At+Essive
hakuihin	Allative+In
hidastetaan	None
juustolan	Genitive
pöydillä	At+Essive
markkinalla	At+Essive
imperfektissä	Essive+In
jalostivat	None
yliarvioi	None
liekistä	Ablative+In
myönteisen	None
heltykää	None
tottumattomille	Allative+At
kohteli	None
järjestämme	None
pihamaalle	Allative+At
innovaatiosta	Ablative+In
hiukkasten	Genitive
turhauttanette	None
killoin	Instrumental
ylimalkaisilla	At+Essive
fasistisen	None
lakkautetaan	None
kärähtäisi	None
kehitysbiologian	Genitive
ajatuspajan	Genitive
huomasi	None
starttaa	None
esittelijän	Genitive
yhteystietoineen	Comitative
rentukoissa	Essive+In
afgaaninvinttikoiraa	Partitive
adenomatoidisille	Allative+At
oppikirjoja	Partitive
savikivestä	Ablative+In
filmatisoitu	None
kuivannemme	None
notkeaa	Partitive
mykkäelokuvien	Genitive
aamiaisetta	Privative
loppuvaiheita	Partitive
raekokoineen	Comitative
suuttuneena	Formal
ewestä	Ablative+In
kantakaupunkiin	Allative+In
ahtaisit	None
selontekoa	Partitive
ahdistelee	None
eroottisen	None
läpäisty	None
kantasolututkimuksissa	Essive+In
kalenterista	Ablative+In
sulttaanikuntia	Partitive
purkauduin	None
väärennetyllä	At+Essive
huhun	Genitive
muodikkaiden	None
tyytyväisinä	Formal
heijatkaa	None
oppiaineina	Formal
valotuksen	Genitive
sulattava	None
lunastivat	None
värikkääksi	Translative
poniksi	Translative
kitkeä	None
viimeaikaisiin	Allative+In
aidolta	Ablative+At
hikkaa	Partitive
laukaisun	Genitive
konekivääreitä	Partitive
ajattelijan	Genitive
vitosia	Partitive
valjastettu	None
kiekkoon	Allative+In
olympiaedustajalle	Allative+At
otteleva	None
edeltäjiä	Partitive
ujuttivat	None
teräkseen	Allative+In
pronsseja	Partitive
turvattomuuden	Genitive
epätavallisista	Ablative+In
opastetun	None
tuoksuu	None
hamuaa	None
häikäisee	None
protektoraatiksi	Translative
fidžissä	Essive+In
tonttuja	Partitive
masentunutta	Partitive
integumentilla	At+Essive
poloniumeista	Ablative+In
tähtijoukoissa	Essive+In
kuvakirjoja	Partitive
asennusten	Genitive
kuormattu	None
aiheellisiksi	Translative
piileksi	None
paoksi	Translative
oraalisille	Allative+At
fissiovoimaloille	Allative+At
paritusta	Partitive
fregateista	Ablative+In
tapahtumapaikkoja	Partitive
yhteiskuntatieteiden	Genitive
valaanpyynnistä	Ablative+In
jääpeitteisettä	Privative
orkestroitu	None
hylystä	Ablative+In
parhaisiin	Allative+In
maininnan	Genitive
helpoissa	Essive+In
kukkuloista	Ablative+In
aristokraatteja	Partitive
räystäänalusista	Ablative+In
sähkökitaraan	Allative+In
myöhemmin	Instrumental
murtavat	None
pakota	None
lauhkeasta	Ablative+In
monenlaisilla	At+Essive
depressiivisen	None
toreadoreilta	Ablative+At
välimuistista	Ablative+In
suunnitelmallisen	None
peruskouluilla	At+Essive
suodattuvat	None
kaakkoiseen	Allative+In
rationalismiin	Allative+In
villatakista	Ablative+In
alusta	Partitive
pullotetaan	None
asukkaan	Genitive
deodoranttisaippuoiksi	Translative
länsimaan	Genitive
tenaviin	Allative+In
synnytettiin	None
autiomaita	Partitive
punertuvat	None
tunnuksiin	Allative+In
vangitsimme	None
äänilevylle	Allative+At
opetusministeriksi	Translative
lakimiehen	Genitive
siivoaa	None
koesarjan	Genitive
mutatoituu	None
nuoruusiässä	Essive+In
benfotiamiinia	Partitive
pysy	None
toiminnaksi	Translative
rohkeammaksi	Translative
käsittäisin	None
olympolaisiksi	Translative
erikoisaloihin	Allative+In
ilmapiiristä	Ablative+In
neuvonnan	Genitive
keskitasoa	Partitive
tyrannin	Genitive
vastaajaa	Partitive
kiehuvaan	Allative+In
kirjautuisimme	None
mustavalkoista	Partitive
ääliömäiselle	Allative+At
kiertokirjeen	Genitive
lemmikkiä	Partitive
epätoivoisen	None
sovittujen	None
kameeksi	Translative
arabin	Genitive
kuvaavat	None
syötettiin	None
saavuttava	None
omaisuusverosta	Ablative+In
serbeihin	Allative+In
onnittelee	None
etuuksiin	Allative+In
septuagesimoin	Instrumental
myllystä	Ablative+In
vaunulla	At+Essive
humanistisena	Formal
tieverkostoa	Partitive
luukkua	Partitive
kolonniksi	Translative
kolmivyötyllien	Genitive
pyyryjä	Partitive
selkärankana	Formal
kuulijakunnan	Genitive
torjumista	Partitive
elinkeinoa	Partitive
aktivoiva	None
massamurhaan	Allative+In
myöhästyisitte	None
alkuruokana	Formal
maaherrattarella	At+Essive
painomusteen	Genitive
vuosikertojen	Genitive
vastustajan	Genitive
uunipuuroineen	Comitative
kunnanjohtajan	Genitive
förstaageihin	Allative+In
kiertueita	Partitive
luiskahtanevat	None
sulkeutukoon	None
friisiä	Partitive
tuovat	None
suojelemisen	Genitive
epätavallisten	None
yhdisteiden	Genitive
varapuhemieheksi	Translative
korimalliin	Allative+In
teollistumisesta	Ablative+In
emälaivana	Formal
kaikenkattavan	None
laiturilta	Ablative+At
hoidettaisiin	None
luonnontieteiden	Genitive
osuudelle	Allative+At
irrallista	Partitive
automaatiolla	At+Essive
kuivimman	None
tuhoudu	None
tuntuvia	Partitive
uinnista	Ablative+In
popmusiikin	Genitive
kuihtunut	None
vaurioittaa	None
kaksoisshakkiin	Allative+In
liiketunnistimineen	Comitative
moraalisia	Partitive
puoskarina	Formal
kiistanalaisesta	Ablative+In
peilikuvaa	Partitive
gabardiinilta	Ablative+At
gobeliiniin	Allative+In
ryppyjä	Partitive
pilvilaskennalta	Ablative+At
semiotiikan	Genitive
kuparisine	Comitative
tasapelillä	At+Essive
lapsivuodekuumeeseen	Allative+In
parantamisella	At+Essive
punonemme	None
vaakasuoran	None
lauletaan	None
maanomistuksen	Genitive
konferensseihin	Allative+In
kansanpuolueisiin	Allative+In
deksmedetomidiinittä	Privative
maharajoin	Instrumental
riuhtoisi	None
samankaltaistaisimme	None
liikkuu	None
nivelsiteiden	Genitive
vinkin	Genitive
ydinonnettomuudessa	Essive+In
valikoimalla	At+Essive
määräenemmistön	Genitive
tataareina	Formal
presbyteerisen	None
öljytankin	Genitive
iloteltaneen	None
ylikukkineissa	Essive+In
kaksipäiväisittä	Privative
korjailen	None
avausotteluilta	Ablative+At
fokusoida	None
kemiasta	Ablative+In
kyseli	None
syrjäänien	Genitive
järkyttää	None
muonitusta	Partitive
tippuivat	None
sydänviasta	Ablative+In
paikannettiin	None
sylkeen	Allative+In
päihittivät	None
ripustaudut	None
lääkeaineena	Formal
cockerspanielia	Partitive
performansseista	Ablative+In
coolerin	Genitive
nefriittiä	Partitive
kuurnitsin	None
nahaksista	Ablative+In
mitättömästä	Ablative+In
epäkkäiltä	Ablative+At
imelöittänyt	None
kohtauskulman	Genitive
geologeja	Partitive
käytimme	None
aiemmasta	Ablative+In
autettiin	None
fragmenttien	Genitive
kaivoksissa	Essive+In
opettavaisten	None
verensiirtoja	Partitive
sävelletty	None
uikkukanoina	Formal
aikajanalle	Allative+At
rikastaa	None
tsunamin	Genitive
sivukallistumasta	Ablative+In
tasingon	Genitive
köyhyydelle	Allative+At
formaalistitte	None
haihtuisi	None
kunnostettiin	None
viallisten	None
useammaksi	Translative
somman	Genitive
laatisi	None
arkkitehtien	Genitive
taudinaiheuttajaan	Allative+In
saarnastuolin	Genitive
satyyrin	Genitive
höykytitte	None
aluskasvillisuudessa	Essive+In
kateen	None
puhuttava	None
umpiointien	Genitive
odotusarvosta	Ablative+In
kirjavan	None
raakuuksien	Genitive
viisasta	None
kolmivaihekilowattituntimittarina	Formal
maratonjuoksussa	Essive+In
festivaaleissa	Essive+In
sivuosan	Genitive
kolmiomaisesta	Ablative+In
burkineen	Comitative
rahaliittoon	Allative+In
loppuun	Allative+In
yhtäpitävää	Partitive
todennäköisyydeksi	Translative
sensuellin	None
sofistin	Genitive
biljardikeppeineen	Comitative
laittomuuden	Genitive
korjaustöistä	Ablative+In
sulkatöyhtönä	Formal
sanomista	Ablative+In
atomiytimissä	Essive+In
jännitteellä	At+Essive
tarkastellut	None
murrokkoihin	Allative+In
riidassa	Essive+In
kognition	Genitive
ohjaimeen	Allative+In
liudentunut	None
tilanhoitajana	Formal
puuroja	Partitive
lämmittäjän	Genitive
teollisen	None
johtaville	Allative+At
koristanut	None
koskikaran	Genitive
komponentteja	Partitive
esitutkinnassa	Essive+In
vanhenevat	None
manttaaliin	Allative+In
kuparoinet	None
kehkeytyisitte	None
jujutsua	Partitive
lokeroivat	None
landella	At+Essive
dokumentoi	None
tunnetussa	Essive+In
segmentoitukoot	None
baletissa	Essive+In
puoleisia	Partitive
jakuutteihin	Allative+In
projisoi	None
maasudelle	Allative+At
geenimutaatioita	Partitive
viikunapuiksi	Translative
sattuman	Genitive
klyyvarein	Instrumental
hybridisoitte	None
ruttauduimme	None
feresin	Genitive
kronobiologiin	Allative+In
vallankumousten	Genitive
roudittuisivat	None
kantamalla	At+Essive
tärisee	None
julkisina	Formal
harhauttava	None
tahriintumattomaksi	Translative
kummallisuuksia	Partitive
kolesterolia	Partitive
bulgariasta	Ablative+In
muokkaat	None
nopeusrajoitusta	Partitive
autonrenkaita	Partitive
kehittyneille	Allative+At
humalankävyistä	Ablative+In
ulkoministeriötä	Partitive
hautakummuista	Ablative+In
kytkennältä	Ablative+At
arvasin	None
murtunutta	Partitive
hatussa	Essive+In
sulkakynän	Genitive
vihanneksena	Formal
selliin	Allative+In
ihmisravinnoksi	Translative
yleismaailmallisen	None
paljetta	Partitive
jokapäiväisen	None
huumeriippuvuutta	Partitive
formaatissa	Essive+In
palkkaan	Allative+In
välittänyt	None
majailee	None
teollisia	Partitive
keraamisen	None
nelivetoisen	None
purjehduskauden	Genitive
viileämpänä	Formal
värähtelivät	None
keinotekoisiin	Allative+In
rajallisesta	Ablative+In
valokuvaajina	Formal
aldehydien	Genitive
manuaalisen	None
oksia	Partitive
mitalein	Instrumental
varjelkoon	None
peruskouluna	Formal
halkaiseva	None
valmistautunut	None
kovakuoriaisiin	Allative+In
saavut	None
pitkäikäisille	Allative+At
aineluokkaa	Partitive
oleudumme	None
rikoit	None
tanssista	Ablative+In
ratkoi	None
sotarikoksiin	Allative+In
virheellisinä	Formal
erotat	None
kukinnossa	Essive+In
sertifioisivat	None
vaahterasta	Ablative+In
elastisesta	Ablative+In
avaruuspuvuista	Ablative+In
lähetystöä	Partitive
kerrytti	None
sorsastit	None
kohtelee	None
terveysjärjestön	Genitive
kuvittelisi	None
nyhjää	None
hajonneessa	Essive+In
kirjasi	None
adaktylian	Genitive
voitelusta	Ablative+In
imelletään	None
loukkaukseksi	Translative
kultasepänliikkeestä	Ablative+In
tilin	Genitive
silvottiin	None
kiihtyneeseen	Allative+In
myrkytöntä	Partitive
mainitseva	None
runsasravinteisissa	Essive+In
kasvitieteellisessä	Essive+In
jäähdytysveden	Genitive
fosfonaatilta	Ablative+At
palterohaperoon	Allative+In
kulissina	Formal
vahdissa	Essive+In
koukkumaisia	Partitive
arsinoihin	Allative+In
riisiryynipuuroja	Partitive
trendejä	Partitive
poimii	None
diureetteja	Partitive
ukkostitte	None
esittäytyy	None
osallistuisin	None
indonesialaisen	Genitive
aliseen	Allative+In
mahdottomiksi	Translative
riidoissa	Essive+In
mainoksille	Allative+At
diagrammeja	Partitive
täysivaltaisina	Formal
liberalisoikaa	None
ampumisen	Genitive
ammoisista	Ablative+In
ikonostaasissa	Essive+In
järjestäytyneen	None
hengitä	None
oppositiosta	Ablative+In
soikean	None
veroprosenttia	Partitive
traagisena	Formal
eutanasiaa	Partitive
simuloiva	None
korppikotkien	Genitive
ujuttautukaamme	None
sotaisten	None
hahmoilta	Ablative+At
säestämiseen	Allative+In
flirttaileva	None
rikkivedyn	Genitive
patsaaseen	Allative+In
ilmoittaa	None
elektronikehäksi	Translative
bullilla	At+Essive
säikeiksi	Translative
itsenäisyysliikkeiden	Genitive
romaanissa	Essive+In
ohjelmistona	Formal
taustojen	Genitive
istutti	None
monimutkaiseen	Allative+In
ylienkelissä	Essive+In
pronssikautisen	None
jääkiekkojoukkueeseen	Allative+In
lieventänyt	None
poutaa	Partitive
gaalojen	Genitive
kahleilla	At+Essive
listaava	None
vakaasta	Ablative+In
taklasi	None
kommunistisissa	Essive+In
tiedostettu	None
astu	None
elättelivät	None
indeksoi	None
leipurien	Genitive
kaiverteeseen	Allative+In
toimistotyötä	Partitive
päätöseriksi	Translative
paineilman	Genitive
majoittunut	None
kuurmalta	Ablative+At
mafialla	At+Essive
onnettomimpina	Formal
raivotautisina	Formal
elää	None
karboksyylihappoja	Partitive
perheystävissä	Essive+In
uutiskirjeessä	Essive+In
nopeimmin	Instrumental
keikarimaisuuksilla	At+Essive
barokkityylin	Genitive
polvistui	None
ulkonäön	Genitive
museolle	Allative+At
pasunistina	Formal
pilailevat	None
suuntauduttava	None
kantista	Ablative+In
selvimmin	Instrumental
kirjoahvenia	Partitive
madonnalla	At+Essive
yhteisöllisyyteen	Allative+In
somaleina	Formal
maksun	Genitive
sotilaallisista	Ablative+In
sandureille	Allative+At
dramaattisen	None
suistoa	Partitive
glysiiniä	Partitive
ylistellette	None
upotuksesta	Ablative+In
pidätti	None
kauppataseen	Genitive
torahampaita	Partitive
dubbauksesta	Ablative+In
vaihtoi	None
keinotekoiseksi	Translative
täpinöistä	Ablative+In
pakkina	Formal
pohjaudu	None
lappeella	At+Essive
eetteriä	Partitive
monipuolista	Partitive
spermisidisten	None
hiilimonoksidia	Partitive
keskiluokkaisesta	Ablative+In
vesisukselle	Allative+At
veritulpan	Genitive
tuskastui	None
laukaisen	None
vetoaisin	None
epätarkkuuksia	Partitive
juonitteleva	None
showpainin	Genitive
valmennuksia	Partitive
bullia	Partitive
pimpin	Genitive
perjantai-illoin	Instrumental
maineikkaalle	Allative+At
kolmiruplaisen	Genitive
kustantamoa	Partitive
väijyy	None
liigajoukkueeseen	Allative+In
konevian	Genitive
keskustellaan	None
saalistaa	None
kutistin	None
näytti	None
vienoiksi	Translative
uhanalaisuudesta	Ablative+In
mystifioisi	None
pesolla	At+Essive
alfahajoamisen	Genitive
lakkakerroksilta	Ablative+At
yllättävään	Allative+In
yleissitovin	Instrumental
jollaiseksi	Translative
vastoin	None
barokkimusiikkia	Partitive
käsitetty	None
teroitti	None
käryä	Partitive
klassisten	None
fuusioreaktion	Genitive
ratkaisevasta	Ablative+In
alastomuutta	Partitive
maljaksi	Translative
vaihtovirtaa	Partitive
toimipisteessä	Essive+In
kaaresta	Ablative+In
pommituksesta	Ablative+In
punnersi	None
annetaan	None
vapaaheitossa	Essive+In
raskaamman	None
sisäoppilaitokseen	Allative+In
keskukselta	Ablative+At
säilyttävä	None
kyseiseksi	Translative
korukiviä	Partitive
puurtakaamme	None
farmiseuran	Genitive
silmäluomien	Genitive
puolueelta	Ablative+At
tieteenalasta	Ablative+In
vaivu	None
troijalaisen	Genitive
pyhiinvaeltajaa	Partitive
yksinäisen	None
peilaa	None
liikunnassa	Essive+In
yöpuolella	At+Essive
toimipisteen	Genitive
merenalaisten	None
näkyvien	None
äänittää	None
luistinrataan	Allative+In
täsmensin	None
irvisi	None
vahvistaa	None
paukahtaa	None
kalkkiutuvat	None
sisällyttävä	None
öljypalmun	Genitive
jumalanpalveluksiin	Allative+In
välttänyt	None
liialliseen	Allative+In
öljykentällä	At+Essive
nykyihmisinä	Formal
hermokeskukseen	Allative+In
pakottaa	None
ojittanemme	None
alkuvaiheessa	Essive+In
hiihtokilpailuissa	Essive+In
elintilasta	Ablative+In
hyväksyä	None
rajoittaa	None
reissasitte	None
kajoan	None
sadolta	Ablative+At
porraskäytävässä	Essive+In
moralisoitiin	None
tulittavat	None
saamelaisten	Genitive
aprikoosin	Genitive
koneistosta	Ablative+In
ylettyi	None
aksioomaa	Partitive
urheilulajista	Ablative+In
ravistelivat	None
arvosta	None
saumanvaralle	Allative+At
pornografiasta	Ablative+In
ahtaan	None
tragedian	Genitive
rautatieasemille	Allative+At
pysäköintiä	Partitive
sovelsivat	None
soudettiin	None
kriisitilanteessa	Essive+In
virtauksessa	Essive+In
summauksissa	Essive+In
uskonnottomille	Allative+At
huohottavat	None
kulkeva	None
tarkistettiin	None
konduktööreiltä	Ablative+At
järveksi	Translative
terälehtien	Genitive
rakenteeseen	Allative+In
pikajunien	Genitive
varron	None
vankiloista	Ablative+In
verbistä	Ablative+In
luottamuksellisen	None
laskusuunnilla	At+Essive
emiirin	Genitive
sirulla	At+Essive
olmin	Genitive
sitoumuksen	Genitive
viikonpäivinä	Formal
suihkepulloin	Instrumental
eläkkeisiin	Allative+In
mosaiikeilla	At+Essive
tieteellisistä	Ablative+In
tarjoillaan	None
uudenaikaisten	None
taaempana	Formal
kunnioitettavatta	Privative
istuttiin	None
toria	Partitive
euploidioilta	Ablative+At
mahdollisena	Formal
silpoi	None
mongoleille	Allative+At
kuristajan	Genitive
parantajien	Genitive
sortuvat	None
tyydytetty	None
vedettömiä	Partitive
putoilivat	None
yritettävä	None
miespuolisille	Allative+At
verotettavien	None
aktivistina	Formal
kuuluisilta	Ablative+At
luotoina	Formal
naksuttavat	None
sait	None
maalaamattomia	Partitive
koreografiksi	Translative
kahviloineen	Comitative
plusasteelta	Ablative+At
sisaleineen	Comitative
ansiotonta	Partitive
saagaa	Partitive
valmistellen	None
influenssasta	Ablative+In
valmistunee	None
laajentaisi	None
kortiston	Genitive
yllättävän	None
kuvaston	Genitive
kuuluisuuden	Genitive
piispalla	At+Essive
gnostilaisissa	Essive+In
naikkosineen	Comitative
töyryissä	Essive+In
lonkkavikaa	Partitive
asiantuntijan	Genitive
jätkänsakissa	Essive+In
kveenejä	Partitive
suositeltu	None
rumeliinein	Instrumental
näppäilee	None
sitruunamehua	Partitive
korkeushypyssä	Essive+In
resepteissä	Essive+In
muokattava	None
kokoontuu	None
päätteisiin	Allative+In
mäntään	Allative+In
pyhiinvaeltajille	Allative+At
tertiäärisissä	Essive+In
harhaluulon	Genitive
paljastukseksi	Translative
päivämäärien	Genitive
lentoaikaa	Partitive
viihtyvyyden	Genitive
uhrauksesta	Ablative+In
taitavia	Partitive
varustetulle	Allative+At
objektiivien	Genitive
torilta	Ablative+At
hyödyllisen	None
rankkaan	Allative+In
kasin	Genitive
taltioiksi	Translative
ensikertalaisena	Formal
yhteiskuntakritiikin	Genitive
karhutkoot	None
rauhallisemman	None
oireiston	Genitive
pianistien	Genitive
taajuuskaistan	Genitive
sukupuolitautien	Genitive
kykeneviä	Partitive
susilauman	Genitive
miellyttävän	None
isopunasotkassa	Essive+In
taitettu	None
vesivaaoin	Instrumental
hysteriasta	Ablative+In
iirinkielistä	Partitive
saimaannorpalla	At+Essive
löytänyt	None
hidasta	Partitive
tuomaalle	Allative+At
likistäytyä	None
pistänyt	None
lipuille	Allative+At
kansandemokraattisten	None
baškiirien	Genitive
haltijoilla	At+Essive
heikentyivät	None
rikkitrioksidia	Partitive
joukkomurhien	Genitive
kihlattu	None
nokiliitäjässä	Essive+In
kirjoittaa	None
krakkaukselta	Ablative+At
hiteiksi	Translative
hierontaa	Partitive
sivuutan	None
kaksikerroksisessa	Essive+In
kohmetettaneen	None
raskauttavaa	Partitive
aseistivat	None
yhteiskuntaoppia	Partitive
Peloponnesokselle	Allative+At
herukoiden	Genitive
ketteriä	Partitive
pysäyttävä	None
veteliin	Allative+In
juhlia	None
patologisine	Comitative
luodattu	None
epäonnistuneen	None
apologeettaa	Partitive
turvenuijiin	Allative+In
sluuppien	Genitive
autoradion	Genitive
keskuudesta	Ablative+In
ohjailevat	None
omistan	None
kulutustavaraksi	Translative
yhdistävät	None
järvistä	Ablative+In
konsultoitu	None
järveä	Partitive
tutkijalle	Allative+At
vahasaroilla	At+Essive
usuttaa	None
suuremmin	Instrumental
nerokkaimmista	Ablative+In
sienipiirakoissa	Essive+In
paineeseen	Allative+In
piinannet	None
ballistisista	Ablative+In
mallineella	At+Essive
hiiviskelemme	None
tietäjänä	Formal
kertoili	None
puhdasoppisen	None
keskushallinnolta	Ablative+At
syömisessä	Essive+In
kattilallisin	Instrumental
elämälle	Allative+At
krimintataaria	Partitive
ruoskittiin	None
keskeisistä	Ablative+In
kyläläisten	Genitive
suosionosoituksetta	Privative
bassona	Formal
koetettiin	None
kassakaappeihin	Allative+In
hiukkasina	Formal
halusin	None
polderissa	Essive+In
täsmäpommitta	Privative
departementtien	Genitive
pidättäytyä	None
purivat	None
timorinhirvin	Instrumental
suoria	None
kolmiota	Partitive
käskyllä	At+Essive
apostolisista	Ablative+In
koiraalle	Allative+At
lähiseutuineen	Comitative
perfektionismeineen	Comitative
kuvitteellisissa	Essive+In
sensuroimattoman	None
metodologiaa	Partitive
yhtenäisyyden	Genitive
esitelmöi	None
kallon	Genitive
symmetristen	None
välttelevän	None
hengitysteineen	Comitative
muokkautunut	None
niityiksi	Translative
ateismia	Partitive
terminä	Formal
tunaroinut	None
näköharhoja	Partitive
pidätysmääräyksen	Genitive
loppuunmyynnistä	Ablative+In
hautua	None
ikivihreissä	Essive+In
mielisairaalaksi	Translative
laukoi	None
urheilulajeista	Ablative+In
rasvamaksassa	Essive+In
eroavaisuuksin	Instrumental
kulun	Genitive
työnantajalta	Ablative+At
ujellettaneen	None
tasokkaan	None
oikeustieteestä	Ablative+In
maanmiehen	Genitive
printannevat	None
lumpeen	Genitive
murtoluvun	Genitive
modernisoi	None
vangitun	None
rankaisi	None
tynnyreihin	Allative+In
griipissä	Essive+In
pronssilakkoineen	Comitative
lajitteluun	Allative+In
veturinkuljettajaa	Partitive
taktisesta	Ablative+In
ryöstää	None
alkuvuosista	Ablative+In
variksetta	Privative
taksonomisissa	Essive+In
epäsuorassa	Essive+In
nokkoskasveilla	At+Essive
kuumana	Formal
hallitse	None
joukkueina	Formal
aforismien	Genitive
yliaikojen	Genitive
toteutuksista	Ablative+In
aistia	None
viulunsoittajalta	Ablative+At
sieppaajien	Genitive
liehuisivat	None
luodaan	None
rakennustyömaalle	Allative+At
kenraaliluutnantiksi	Translative
sähköfortunoissa	Essive+In
sallittiin	None
afääriltä	Ablative+At
madeiraa	Partitive
vaihtopenkille	Allative+At
kertoimiksi	Translative
genomia	Partitive
vaatimattomien	None
ajuruoholla	At+Essive
kemiallisille	Allative+At
pääsisäänkäyntiä	Partitive
yhdistymisestä	Ablative+In
inflammaatioksi	Translative
narussa	Essive+In
ruutukaavasta	Ablative+In
kaasujättiläisettä	Privative
allokoida	None
laivakorpulle	Allative+At
koordinoiva	None
aikaväleiksi	Translative
eistä	Ablative+In
nasaloisit	None
roottoriin	Allative+In
esiteltävä	None
esineistä	None
matkustajaluetteloon	Allative+In
baskissa	Essive+In
levinneisyysalueesta	Ablative+In
kannaksella	At+Essive
voimistuva	None
takoi	None
maanviljelijää	Partitive
suihkumoottorin	Genitive
merimiinaan	Allative+In
ilmatorjuntaohjusta	Partitive
tropiikista	Ablative+In
ui	None
säädettävissä	Essive+In
juoksi	None
laukaisuina	Formal
jalkapallokenttiä	Partitive
vedota	None
äyräiden	Genitive
muistiinpanojen	Genitive
kartuimme	None
kolminkertaistunut	None
afrikankielilepakoitta	Privative
ympärileikattaneen	None
myöhäisestä	Ablative+In
vasempana	Formal
antajien	Genitive
boforiasteikkoina	Formal
puolustaa	None
harkita	None
suunnitelmataloudessa	Essive+In
arviona	Formal
lyönnistä	Ablative+In
inttäisitte	None
paiskisi	None
isänmaalliseen	Allative+In
kykeneväksi	Translative
yksikäsitteisen	None
knallia	Partitive
hillosipuleiksi	Translative
senttimetriin	Allative+In
vanhenemista	Partitive
aidon	None
teleportaatioon	Allative+In
tarkistukselle	Allative+At
sattumana	Formal
esimerkkeineen	Comitative
suppilon	Genitive
hallinnollisilla	At+Essive
pulssien	Genitive
valovuosien	Genitive
kynästä	Ablative+In
matteja	Partitive
ongelmissa	Essive+In
ympäriajosta	Ablative+In
sateisena	Formal
pestataan	None
järkevänä	Formal
ulvova	None
kumoa	None
takavarikoinnin	Genitive
analysoitu	None
tappiosta	Ablative+In
leivittäkööt	None
moisten	None
varakuninkaana	Formal
kauhdutit	None
militarisoitukoon	None
taidekokoelmien	Genitive
sattumanvaraisten	None
koralliriutalla	At+Essive
seoksena	Formal
naarmuta	None
kyynärpäätaklauksitta	Privative
siirrettävistä	Ablative+In
valokuvaajille	Allative+At
koivikossa	Essive+In
urheilulle	Allative+At
luetteloitu	None
porinaan	Allative+In
sovittajina	Formal
chihuahuassa	Essive+In
hävettää	None
tonkia	None
ylittyi	None
juostetta	Partitive
huijannut	None
testaan	None
vintiltä	Ablative+At
rupean	None
puhkesivat	None
huokuvat	None
yrittämällä	At+Essive
papiston	Genitive
räjähdykseltä	Ablative+At
serafia	Partitive
tuottivat	None
librettoihin	Allative+In
skientologeja	Partitive
latinannan	None
höylätkööt	None
tasanteiden	Genitive
merenpohjan	Genitive
tytäryhtiötä	Partitive
itsetutkiskeluun	Allative+In
arvovaltaisena	Formal
kenotsooisen	None
järkyttyneenä	Formal
evankeliumista	Ablative+In
lopullisten	None
pehmitämme	None
sotarikollisia	Partitive
punastuvat	None
kunnianhimoon	Allative+In
yhdistelmiin	Allative+In
parakissa	Essive+In
suojattomia	Partitive
harppia	Partitive
telaketjun	Genitive
ehkäisi	None
jänteellä	At+Essive
äänennopeuksissa	Essive+In
epäkuolleiden	Genitive
pussieläimiä	Partitive
soita	None
nyrkkeilyottelusta	Ablative+In
poikkeaisi	None
harjoittelijan	Genitive
yläpuolisten	None
väheksyy	None
esikoisen	Genitive
syöksivät	None
haitata	None
valmistivat	None
sekoamme	None
saalistavat	None
rekisteröidylle	Allative+At
olinpaikkaan	Allative+In
kannattelevat	None
kuuluisien	None
vastaleivottujen	None
kelloseppänä	Formal
kauhistava	None
erilaiskehäisiin	Allative+In
gondolin	Genitive
tiedostaa	None
rikkitrioksidista	Ablative+In
kuvailevia	Partitive
demokraattisesta	Ablative+In
askeltimineen	Comitative
saippuakauppiaiksi	Translative
lokalisoida	None
traumaa	Partitive
kierrosajan	Genitive
kunnioittavasta	Ablative+In
metsävaahteran	Genitive
kahlannut	None
kuoriutunut	None
kotoperäisistä	Ablative+In
valmistetaan	None
raitiovaunua	Partitive
hirsitaloja	Partitive
kulminoituvat	None
syndikaatille	Allative+At
sovita	None
tolkkua	Partitive
ehkäisisi	None
keijustoina	Formal
normeja	Partitive
aaltopahvista	Ablative+In
opiskelee	None
kyettävä	None
löydöksestä	Ablative+In
tarkkailijoiden	Genitive
sandurin	Genitive
tutkielmaan	Allative+In
havaita	None
eläinlääkäriksi	Translative
itken	None
tulevalta	Ablative+At
mutkien	Genitive
aasinajajalta	Ablative+At
reesustekijänä	Formal
aikaistamme	None
sulhoa	Partitive
rokotteiden	Genitive
hanttiin	Allative+In
esiintyä	None
takaisen	None
elämäntyötä	Partitive
ylikuumenemisesta	Ablative+In
kongressia	Partitive
äkilliseen	Allative+In
liperistä	Ablative+In
kumarretaan	None
magnetosfäärin	Genitive
merenpohjalle	Allative+At
pyrkimyksille	Allative+At
kokoilen	None
osterivinokkain	Instrumental
naispappeja	Partitive
sopinut	None
ihastuksilta	Ablative+At
korostava	None
vastasit	None
kitkutettaisiin	None
progressiiviselle	Allative+At
klinkkerille	Allative+At
loistavilla	At+Essive
tulehtuivat	None
dadaistien	Genitive
tarkkuuskellolle	Allative+At
potkun	Genitive
seisakkeena	Formal
suomennetaan	None
oaaseissa	Essive+In
käytettävyydestä	Ablative+In
yläleuassa	Essive+In
taipuisan	None
ajelivat	None
runoilla	At+Essive
yhteenliittymästä	Ablative+In
maailmantaloudessa	Essive+In
julisteeseen	Allative+In
gallupoinnista	Ablative+In
kehämäisen	None
krupissa	Essive+In
oikeusministeriössä	Essive+In
häiriköivät	None
laattatektoniikkaa	Partitive
professoriin	Allative+In
rytmikitaraksi	Translative
kolmioille	Allative+At
sovimme	None
huolellisia	Partitive
lentokoneisiin	Allative+In
liikkunut	None
edustuksia	Partitive
julmien	None
numeerisia	Partitive
osapuoliin	Allative+In
navigoijana	Formal
kupasta	Ablative+In
utilitarismia	Partitive
vilistä	None
hymyn	Genitive
kiehtoivat	None
esiintymästä	Ablative+In
fissiopommin	Genitive
kuitujen	Genitive
huojunnasta	Ablative+In
perui	None
haikaraa	Partitive
sytyttimiä	Partitive
kaupunkitarinoiden	Genitive
vilkkua	Partitive
suureesta	Ablative+In
koksautunette	None
valtioneuvostossa	Essive+In
nyrjäytysten	Genitive
kirjapainossa	Essive+In
kidutuksiin	Allative+In
sylkäisee	None
miekannielijöittä	Privative
varastoista	Ablative+In
outouden	Genitive
fysiologiassa	Essive+In
erityin	None
korvatulehduksen	Genitive
kivikirveiden	Genitive
leijonasta	Ablative+In
kategoriatta	Privative
lakkautettaisiin	None
kiihdytetään	None
hakusanalla	At+Essive
tarkennetta	Partitive
kampanjoidaan	None
ennakkotapausta	Partitive
hauskan	None
liittoutuneiden	Genitive
komean	None
vaajan	Genitive
virvokkeita	Partitive
pikkutunneilla	At+Essive
syyttelee	None
mukulakiviä	Partitive
kaukoputken	Genitive
projektiolla	At+Essive
talouskehityksestä	Ablative+In
saattueiden	Genitive
työnantajana	Formal
teknikon	Genitive
voimanostossa	Essive+In
valikon	Genitive
lietsoo	None
markkinapaikkana	Formal
fiktiivisenä	Formal
syyttämisinä	Formal
sotapäällikön	Genitive
selvensi	None
kirjaimistoon	Allative+In
oppositiopolitiikkana	Formal
informatiivisiksi	Translative
epäorgaanisiin	Allative+In
lohkolla	At+Essive
katodilta	Ablative+At
numeroi	None
ilmansuuntien	Genitive
leninismiin	Allative+In
öljytankkereita	Partitive
myyttisen	None
elimissä	Essive+In
kiraalista	Partitive
maastakarkotuksen	Genitive
lokalisoitu	None
korreloitunut	None
niitti	None
paheksunut	None
ryöstetty	None
vihkimisiä	Partitive
ilmoittavat	None
lippujen	Genitive
saavutettiin	None
munkkitaikinoilta	Ablative+At
heijastuu	None
ilmeittäisivät	None
saatanallisen	None
haivuttiin	None
raideleveyden	Genitive
edellisissä	Essive+In
vulgaarilatinasta	Ablative+In
lahopuussa	Essive+In
orjatyövoimaksi	Translative
pahastuu	None
seikkailuelokuvissa	Essive+In
samansuuntaisia	Partitive
alkuaineeseen	Allative+In
kauppiaatta	Privative
hitsautukoot	None
hockeyineen	Comitative
jokapaikanhöyliä	Partitive
zuaavin	Genitive
kokoelmineen	Comitative
urille	Allative+At
harmitti	None
eduskuntaryhmässä	Essive+In
sotilaisiin	Allative+In
liukui	None
jyskeen	Genitive
sairaanhoitopiirin	Genitive
krillin	Genitive
jylhistytty	None
kreikankielisiin	Allative+In
niemimaahan	Allative+In
syössyt	None
kihlautuu	None
vyötäröltä	Ablative+At
valiokunnista	Ablative+In
konsensusta	Partitive
kestää	None
perusteoksen	Genitive
kuntoutuksesta	Ablative+In
emolevyissä	Essive+In
mykotoksiiniin	Allative+In
toistettava	None
oikeistohallituksina	Formal
törmäystestissä	Essive+In
kaasukehän	Genitive
aluskarvaa	Partitive
huolestuttiin	None
huhuiksi	Translative
nuorisolle	Allative+At
rahoituskriisin	Genitive
luukkujen	Genitive
bakteriofagien	Genitive
hyödyllisten	None
mielikuvana	Formal
hakusanaa	Partitive
ylimystölle	Allative+At
tiistaiaamuna	Formal
jaokkeita	Partitive
panttikonttoreineen	Comitative
inhibiittorin	Genitive
sähkötuolissa	Essive+In
haaroo	None
perusoikeuksissa	Essive+In
hallittujen	None
psykoanalyyttista	Partitive
poimin	None
oksistossa	Essive+In
huomauttaisi	None
juoksijoista	Ablative+In
kosmokraateissa	Essive+In
lääkeaineiden	Genitive
sypressejä	Partitive
huhuttu	None
mahdollisia	Partitive
torstaisetta	Privative
ornamentteja	Partitive
salmeksi	Translative
arvoisessa	Essive+In
pidä	None
uudistavat	None
saria	Partitive
lukusanoja	Partitive
sinappikaasua	Partitive
tienristeyksessä	Essive+In
urheiluautoksi	Translative
puoleisten	None
pitkäaikaisiin	Allative+In
hiilidioksidina	Formal
metaanista	Ablative+In
japanissa	Essive+In
drinkkejä	Partitive
plutoniumilla	At+Essive
islannin	Genitive
coupésta	Ablative+In
poikkeamaan	Allative+In
tislata	None
avioerojen	Genitive
holtin	Genitive
ymmärrettävällä	At+Essive
käymälän	Genitive
terveyskeskuksesta	Ablative+In
seikkailuihin	Allative+In
katsoi	None
abduktioon	Allative+In
pukevat	None
hopeisen	None
myrkyllä	At+Essive
coverilla	At+Essive
laivan	Genitive
jaavassa	Essive+In
tilkitä	None
sisältöjä	Partitive
murtuva	None
selviytyi	None
perustuksille	Allative+At
loistoaikaa	Partitive
ruudukolla	At+Essive
höllensi	None
perättäisellä	At+Essive
voimamiesten	Genitive
päivystykseen	Allative+In
kalloa	Partitive
kaikenlaisesta	Ablative+In
ahdistivat	None
diskografioita	Partitive
totaalisen	None
espressoa	Partitive
suodatin	None
somen	Genitive
homogeenisen	None
majalla	At+Essive
vuohista	Partitive
seilaa	None
kehitysasteella	At+Essive
turhautuu	None
paheksuttiin	None
hietana	Formal
puivat	None
mummin	Genitive
sulautettu	None
viihtyisiä	Partitive
prinsseille	Allative+At
haluaisi	None
futaisin	None
mehun	Genitive
kulminoituu	None
terveyskeskuksessa	Essive+In
logossa	Essive+In
fenyylialaniinista	Ablative+In
työkalua	Partitive
haalean	None
turismin	Genitive
militarismiin	Allative+In
ohjaimelle	Allative+At
puristuksiin	Allative+In
yksiulotteisena	Formal
hirvikoirana	Formal
kosmisessa	Essive+In
hentokortteille	Allative+At
kamariorkesterin	Genitive
verkkopalloista	Ablative+In
halpojen	None
ridan	Genitive
teollisuusalueena	Formal
emoyhtiöiden	Genitive
euromaiden	Genitive
harhaisia	Partitive
raakuuden	Genitive
sabotoinut	None
taistelupanssarivaunujen	Genitive
kuitin	Genitive
huuhdottiin	None
musiikkialan	Genitive
deklinaatioon	Allative+In
nojalla	At+Essive
alumiinikloridia	Partitive
kilonewtoneina	Formal
menetelty	None
kerrottavaksi	Translative
liittyi	None
natriumsyanidina	Formal
perusteltuun	Allative+In
ksylofonin	Genitive
vihanpidosta	Ablative+In
makrillia	Partitive
pommituksia	Partitive
operointia	Partitive
kukkulalta	Ablative+At
lespaat	None
naftan	Genitive
aikayksikköä	Partitive
ketlaisimme	None
lorvehtisitte	None
väitöksissä	Essive+In
sponsoroitu	None
länsimaistukoon	None
eveä	Partitive
myöhäiselle	Allative+At
mäskiä	Partitive
pohjautunut	None
ilmasta	None
elokuvallisen	None
mitätöinnittä	Privative
hautauksiin	Allative+In
yhdentäisitte	None
nimittivät	None
puhutti	None
luettelona	Formal
parhaimmassa	Essive+In
kosmopoliittisitta	Privative
ilmoitettaneen	None
kaipaamme	None
rusokkaineen	Comitative
sadomasokistisetta	Privative
kranaatinheittimien	Genitive
materiaalisesta	Ablative+In
umlauteiksi	Translative
retkeilijöitä	Partitive
kuriin	Allative+In
pituuksilla	At+Essive
liettyköön	None
kipsaava	None
viilataan	None
valööreistä	Ablative+In
datalla	At+Essive
aktion	Genitive
tuplattu	None
ottelivat	None
nimitellä	None
kansatiedettä	Partitive
prinsessasta	Ablative+In
ennätyksellistä	Partitive
ikonimaalauksen	Genitive
automatiikan	Genitive
valokuvaajasta	Ablative+In
autonomisen	None
nenäontelon	Genitive
torjumisesta	Ablative+In
huulien	Genitive
maaherralta	Ablative+At
sarastaa	None
hyvinvoinnin	Genitive
keskustana	Formal
kääkälle	Allative+At
minkin	Genitive
kansalaiseksi	Translative
liljojen	Genitive
estänyt	None
lahjakkuuksia	Partitive
seksiaddiktiona	Formal
saksankielisistä	Ablative+In
zirkoniumia	Partitive
syvennystä	Partitive
perhevalmennuksessa	Essive+In
emulsiona	Formal
porin	Instrumental
kaivautua	None
ratifioitu	None
moskeijoita	Partitive
mylvivä	None
maksasyöpää	Partitive
sekoilin	None
laktovegetaristitta	Privative
äänenkannattajista	Ablative+In
intuitioin	Instrumental
päävuokralaisina	Formal
naaleja	Partitive
kerttuihin	Allative+In
puuhiin	Allative+In
tavarajunia	Partitive
laukon	None
lakisääteiseksi	Translative
hyppäävä	None
piirteinä	Formal
dynastialle	Allative+At
rauhoitetun	None
saapuvia	Partitive
hoitajattarella	At+Essive
nelinkertaistaa	None
taloustieteellisestä	Ablative+In
pintopapua	Partitive
lohikäärmeellä	At+Essive
kansallispäiviin	Allative+In
ehdotuksilla	At+Essive
huuhkajia	Partitive
ekologina	Formal
eettisiä	Partitive
kävijämäärien	Genitive
valituksesta	Ablative+In
lehterille	Allative+At
radiohiiliajoituksella	At+Essive
kilvoittelit	None
kuivemmissa	Essive+In
palauksi	Translative
ottelijoille	Allative+At
biennaalissa	Essive+In
nopeuduttakoon	None
sairastava	None
tyttömäisyyksiä	Partitive
riisuu	None
deklinaatioineen	Comitative
setelirahaa	Partitive
aisti	None
pysytellen	None
lähestymistapaa	Partitive
plagioklaasia	Partitive
rantaviivalla	At+Essive
erbiumin	Genitive
digitelevisioitta	Privative
kuplassa	Essive+In
kahan	Genitive
suurikokoista	Partitive
jäähallin	Genitive
lainopillisena	Formal
haittaava	None
limanahkiaisilla	At+Essive
päämajasta	Ablative+In
aasiannorsua	Partitive
viitsit	None
vapaamuurariuden	Genitive
sujuttautukaamme	None
epäitsekkäästä	Ablative+In
asiakaspalveluun	Allative+In
kalviva	None
vastakaupoin	Instrumental
monitahoisilla	At+Essive
suunnattomaan	Allative+In
irtolaisuudesta	Ablative+In
tarjoaa	None
kestävyydestä	Ablative+In
piispalle	Allative+At
uusiutuvia	Partitive
liiketoiminnalle	Allative+At
arvaillut	None
tropopaussista	Ablative+In
lastenhoitoa	Partitive
kerjuriin	Allative+In
yskänlääkkeenä	Formal
tarpeetonta	Partitive
pelikonsoleille	Allative+At
nöyryyttämistä	Partitive
gnostilaisilla	At+Essive
ampukaa	None
keitettävä	None
mallinnuksen	Genitive
kategorioissa	Essive+In
oletusarvosta	Ablative+In
trafiikeille	Allative+At
parhaimpia	Partitive
väritettiin	None
baletin	Genitive
tyynysodiksi	Translative
sliipannee	None
lohjennut	None
häiritseväksi	Translative
manguttava	None
staran	Genitive
suggestioita	Partitive
institutionaalisen	None
kuurnan	Genitive
rekan	Genitive
kontrolleja	Partitive
fennistiikkojen	Genitive
uskoisi	None
virtasi	None
ydinräjähteen	Genitive
sisempien	None
kuivumiselta	Ablative+At
paneutunut	None
nousivat	None
vertaili	None
buddhalaisuudessa	Essive+In
laventelin	Genitive
kerrostaisit	None
suihkuseinältä	Ablative+At
kulttuurisia	Partitive
ikeillä	At+Essive
kalastusalueen	Genitive
florettimiekkailun	Genitive
elokuvateatterissa	Essive+In
riimuja	Partitive
riehuu	None
ristikuninkaalta	Ablative+At
valkaistu	None
entraatte	None
differentiaaligeometrioissa	Essive+In
halusivat	None
määrien	Genitive
karttunen	None
väijyä	None
antoa	Partitive
loisteliasta	Partitive
devalvoitiin	None
kovimpana	Formal
hyytymän	Genitive
sivilisaatioon	Allative+In
yhdenmukaista	None
objektiiveista	Ablative+In
torien	Genitive
taivutettava	None
röhkäistäköön	None
jakautuvat	None
kalleimpia	Partitive
avioparien	Genitive
lisensiaatiksi	Translative
jäsenyyden	Genitive
sondeerannet	None
hatun	Genitive
muotoisina	Formal
menetän	None
mataran	Genitive
tukehdutti	None
pienaakkoselta	Ablative+At
ilmaiskuin	Instrumental
proomuja	Partitive
keskusteltu	None
pii-leviksi	Translative
kyborgeja	Partitive
hylättävä	None
oikeustieteellisissä	Essive+In
lennätinpylväiden	Genitive
välisen	None
auktorisoiva	None
aavistuksin	Instrumental
abioottisesta	Ablative+In
holvikaarta	Partitive
älykköjen	Genitive
pelipaidassa	Essive+In
hienostunein	Instrumental
kapeine	Comitative
tyypilliseen	Allative+In
kaupallistaisitte	None
työpanoksen	Genitive
känsistyisitte	None
veronkierroksi	Translative
arvostanut	None
tiimityötä	Partitive
koneelle	Allative+At
tietynlaiseen	Allative+In
mikille	Allative+At
kaaokseen	Allative+In
vaivoista	Ablative+In
tapaoikeuteen	Allative+In
kauppakeskuksen	Genitive
kohtaan	None
kaulakorun	Genitive
ateriaa	Partitive
kauppalassa	Essive+In
juhlavuosina	Formal
kulminoitunette	None
ulkoilevat	None
ilmaan	None
klubiin	Allative+In
televisioinneitta	Privative
temppeliritarien	Genitive
kuvioilla	At+Essive
ympäröinneillä	At+Essive
osaavana	Formal
elpyä	None
punakasvoisten	None
kuolleen	Genitive
luiskahtavat	None
lihavointeja	Partitive
nyrkkisääntönä	Formal
kummallisten	None
palvotaan	None
hallaa	Partitive
nuoremmaksi	Translative
olennoiksi	Translative
siiran	Genitive
laboratorioiden	Genitive
villieläimen	Genitive
vihjailla	None
rationaalistettu	None
parittoman	None
raksutettakoon	None
kaakkoispuolelta	Ablative+At
vangitsivat	None
adsorboivassa	Essive+In
lumousta	Partitive
juolahditte	None
idiomeja	Partitive
etuvetoisena	Formal
turboahdetuista	Ablative+In
viivytteli	None
annoksina	Formal
populaatioksi	Translative
seinämaalauksen	Genitive
vakaamme	None
toisivat	None
pullojen	Genitive
hahmottelee	None
pelimanneja	Partitive
tovin	Genitive
ulottukoon	None
kolmiodraaman	Genitive
nelsonille	Allative+At
piirrettyä	Partitive
papillisia	Partitive
käristeeltä	Ablative+At
emäksisyyttä	Partitive
yleisurheilussa	Essive+In
johteiden	Genitive
pakokaasuista	Ablative+In
kisun	Genitive
lainasanoihin	Allative+In
graffiteista	Ablative+In
tuhoutumiseen	Allative+In
kilpailutilanteeseen	Allative+In
rumbassa	Essive+In
vaihtuvat	None
vuorottelevan	None
hakasulkeita	Partitive
tuhkamaisia	Partitive
suussa	Essive+In
feminiiniä	Partitive
rajoittein	Instrumental
puolustan	None
etuvetoisten	None
turmelivat	None
monikulmioiden	Genitive
tasankoihin	Allative+In
rotareilla	At+Essive
karsiutuivat	None
kateenkorvan	Genitive
lineaariseen	Allative+In
psykiatrisen	None
mieleiseksi	Translative
urheilijoissa	Essive+In
sovitetaan	None
dieselöljyä	Partitive
poikkeuksellisen	None
oksapistokkaita	Partitive
anteeksipyynnöstä	Ablative+In
eläkkeeltä	Ablative+At
merijalkaväelle	Allative+At
hinkuyskän	Genitive
säädettäviä	Partitive
suomuiksi	Translative
pommituksissa	Essive+In
nukeista	Ablative+In
peräkkäistulkkauksilta	Ablative+At
hajua	Partitive
mestaruusotteluun	Allative+In
puremalla	At+Essive
työtätekevien	None
työstävät	None
virtaviivaisten	None
tyrmätään	None
lohdutusta	Partitive
teologisena	Formal
sopivana	Formal
hyönteistieteestä	Ablative+In
repeytynyt	None
swahilin	Genitive
hoe	None
käsittelyä	Partitive
kokonaisia	Partitive
alentua	None
lähdeluetteloissa	Essive+In
risteä	None
vatsaonteloilta	Ablative+At
kaksinkamppailuissa	Essive+In
boikotoisitte	None
uskonvapauksiin	Allative+In
hyökkäykselle	Allative+At
ydinsukellusveneitä	Partitive
alttoviulistina	Formal
läheisemmäksi	Translative
lumoutuu	None
välkkynevät	None
poikkeavasta	Ablative+In
kartoittivat	None
laukkaa	None
kimelteilla	At+Essive
savotan	Genitive
harrastajaa	Partitive
konkreettiseen	Allative+In
merisioin	Instrumental
sovittelijan	Genitive
resonoi	None
horjumattomilta	Ablative+At
poikuudella	At+Essive
taidehistorioitsijoiden	Genitive
naisartisteilla	At+Essive
vanheta	None
asustivat	None
opiskelujen	Genitive
ammattikunnan	Genitive
kyltyisitte	None
vispaan	None
automerkeistä	Ablative+In
liberaaleja	Partitive
haukkunut	None
riideltiin	None
virheellisen	None
kudoksia	Partitive
vesileimana	Formal
aggressiivisella	At+Essive
virtuaalisessa	Essive+In
paliskunnan	Genitive
muovin	Genitive
tatuoinut	None
menestyksekkääksi	Translative
kovetatte	None
myrskyä	Partitive
juoksevia	Partitive
amorfisen	None
tuhoaisi	None
paiseita	Partitive
merilaissa	Essive+In
vaaleanvihreää	Partitive
vaellukselle	Allative+At
pudottavat	None
tietäisit	None
kristallipalloa	Partitive
tyyppisellä	At+Essive
lankusta	Ablative+In
pohjautui	None
leimautui	None
yhteentörmäyksen	Genitive
metallurgin	Genitive
tuhkaan	Allative+In
harhasta	Ablative+In
poikkeustilanteessa	Essive+In
paimennettiin	None
tiirikoida	None
ikkunanpesijänä	Formal
etäisyydeksi	Translative
vähempään	Allative+In
etunimiä	Partitive
varannosta	Ablative+In
markiisin	Genitive
syrjiä	Partitive
ulkokaihtimelle	Allative+At
tiukkunut	None
samanlaisuutta	Partitive
vilkkaalla	At+Essive
geologina	Formal
kieltäisi	None
sisätilasta	Ablative+In
kesyn	None
taustavärillä	At+Essive
lainsäätäjien	Genitive
lastenlääkärittä	Privative
huonolaatuista	Partitive
viimeisimpänä	Formal
tummanharmaan	None
tarjonnassa	Essive+In
harkitsevan	None
paristoilla	At+Essive
aakkostoissa	Essive+In
puolustajiin	Allative+In
kymessä	Essive+In
tummenin	None
kestävämmäksi	Translative
fumaroleja	Partitive
tämänkesäisillä	At+Essive
imusuonten	Genitive
taksonomisia	Partitive
tuulitunnelia	Partitive
reagoisitte	None
eteenpäisestä	Ablative+In
kysyjän	Genitive
suutele	None
autenttisuuteen	Allative+In
isompiin	Allative+In
finaaliottelussa	Essive+In
terroristeina	Formal
säätimillä	At+Essive
seinäsammal-mustikkatyypittä	Privative
työkyvyttömyyseläkettä	Partitive
eläintieteilijänä	Formal
vermuttia	Partitive
abivuotta	Partitive
vaihtajana	Formal
kisojen	Genitive
logaritmisia	Partitive
bulkkitavaroilta	Ablative+At
soveltavat	None
nettisivustoja	Partitive
lastata	None
rikosilmoituksia	Partitive
kuvittele	None
komisariona	Formal
taustamusiikiksi	Translative
aamunkoitossa	Essive+In
palstoihin	Allative+In
fiktiota	Partitive
puolueeseen	Allative+In
suruntäyteisessä	Essive+In
mantereisen	None
luisua	None
syntipukin	Genitive
bassin	Genitive
myöntävät	None
kiviplaneettoja	Partitive
vesialtaissa	Essive+In
veronalennuksesta	Ablative+In
ymmärrettävyyttä	Partitive
syyllistyivät	None
poissaoloon	Allative+In
ruskin	Instrumental
johdotettaisiin	None
interstadiaalien	Genitive
komponenttiin	Allative+In
nuotinnettakoon	None
moittinut	None
valaistua	None
heijastinta	Partitive
kameeta	Partitive
lauluina	Formal
turpeiden	Genitive
haltijaa	Partitive
imperiumiin	Allative+In
keinuu	None
paikkaisena	Formal
alleviivauksen	Genitive
seireenien	Genitive
viattomana	Formal
raksinen	None
nunnista	Ablative+In
asumattomalla	At+Essive
gigahertsiä	Partitive
toimintamallista	Ablative+In
vuokraava	None
perhosvaikutuksiin	Allative+In
vauhdissa	Essive+In
förstaagia	Partitive
taitettava	None
korvautuvat	None
lisäkiveksen	Genitive
toteuttanut	None
juutalaisvastaisuuden	Genitive
oletat	None
maatunut	None
hylkää	None
limusiiniin	Allative+In
vahingoittanut	None
huipulta	Ablative+At
viholliskoneen	Genitive
hammaspyörää	Partitive
poliiseista	Ablative+In
lisensoinut	None
negatiiveja	Partitive
sekasikiöistä	Ablative+In
koskettava	None
kuiskaava	None
lähimmäksi	Translative
älyvapaalle	Allative+At
rehentelee	None
säätimiä	Partitive
startannut	None
rakkaussuhteita	Partitive
jääkaappien	Genitive
poimisimme	None
sinkkivalkoisella	At+Essive
stressata	None
puhdistukseen	Allative+In
pysytty	None
puolijohteilla	At+Essive
sinibakteerein	Instrumental
protestanttista	Partitive
löytöpalkkioille	Allative+At
kosmisen	None
servoissa	Essive+In
nikkeliä	Partitive
jännitteeksi	Translative
harhoiksi	Translative
pakenivat	None
esikuntaan	Allative+In
broileripyörykättä	Privative
gruusioineen	Comitative
vapaamielisestä	Ablative+In
jäätynyt	None
generaattorista	Ablative+In
pyöristynyt	None
islanninhevosella	At+Essive
taiasta	Ablative+In
jäljittävät	None
ongelmajäteautoista	Ablative+In
harrastelijoilta	Ablative+At
voittoisaa	Partitive
puhjenneeseen	Allative+In
rajattuja	Partitive
sivuavaa	Partitive
kepposen	Genitive
vartijaksi	Translative
hallitsijana	Formal
sisäolennotta	Privative
puuttomia	Partitive
kohtalaisella	At+Essive
vesisynnytystä	Partitive
karnevalisoikaa	None
ynseälle	Allative+At
kronologiseen	Allative+In
osteopetroosia	Partitive
kiinnitystä	Partitive
uskallettu	None
vastatuuliksi	Translative
dubataan	None
kantautunee	None
väitteellä	At+Essive
voissa	Essive+In
opintorahan	Genitive
kuivemmaksi	Translative
menneestä	Ablative+In
paksuna	Formal
iskuna	Formal
enantiomeerien	Genitive
armeijalle	Allative+At
numerosta	Ablative+In
alaleukaa	Partitive
protestanttisille	Allative+At
aluemeren	Genitive
taktiikassa	Essive+In
pistelee	None
kilotonnia	Partitive
hedelmäveitseksi	Translative
slammauksilla	At+Essive
sorkkaeläimiä	Partitive
suoriuduttava	None
luonnehtii	None
tuomittakoon	None
geoinformatiikan	Genitive
romanttisesta	Ablative+In
erottavat	None
kantamisen	Genitive
kiinnitti	None
vilkaissut	None
huonepalveluitta	Privative
yöelämässä	Essive+In
poikkeustilaa	Partitive
lähijunien	Genitive
hävitettäisiin	None
tirkistelyä	Partitive
jäätikköä	Partitive
kruunulla	At+Essive
protestiksi	Translative
esittivät	None
muuttuvissa	Essive+In
ennakkotiedon	Genitive
ajautui	None
anglikaanisten	None
absurdeista	Ablative+In
magiaa	Partitive
harmiteltava	None
juniorin	Genitive
vatkaantunut	None
eufemistiselle	Allative+At
pommikoneesta	Ablative+In
luvan	Genitive
bodyitta	Privative
kielletyksi	Translative
keitaiden	Genitive
kulisseja	Partitive
prosessoi	None
avauksella	At+Essive
kielitaidosta	Ablative+In
tuule	None
ansaitsevat	None
omistamisesta	Ablative+In
ydinreaktioissa	Essive+In
evankeliumille	Allative+At
järjestäytyivät	None
tekijästä	Ablative+In
elokuvakäsikirjoitusta	Partitive
abolitionismein	Instrumental
tanskankielisestä	Ablative+In
pohjoismaisista	Ablative+In
ruokaparsoihin	Allative+In
muotoutuu	None
maltankielisiin	Allative+In
rockiin	Allative+In
mosseineen	Comitative
ennakoi	None
vieraskieliseen	Allative+In
kookkaisiin	Allative+In
filmattiin	None
pääasiallisen	None
röykkiön	Genitive
selostetaan	None
ulommalla	At+Essive
herätysliikkeestä	Ablative+In
tietyntyyppisiä	Partitive
hallitsevan	None
ongelmanratkaisukykyä	Partitive
soittolistoilla	At+Essive
kummituksesta	Ablative+In
tereftaalihappona	Formal
isoloikoot	None
valmistettava	None
oikeakätisiä	Partitive
syljeksiä	None
tarttui	None
tanssiaisiin	Allative+In
tuhoamisleirejä	Partitive
nöyryyttä	Partitive
kiusaantuneisuuksille	Allative+At
ampumaradan	Genitive
lentokoneiden	Genitive
banaanikärpäsen	Genitive
uskonnollista	Partitive
yhteenotoiksi	Translative
kiertyy	None
puutöitä	Partitive
kerjää	None
ilostuisi	None
tuorejuustoja	Partitive
tarkkaillut	None
talonpoikaiskapinalla	At+Essive
kirahvilla	At+Essive
pysyväksi	Translative
hopeanharmaita	Partitive
lottovoittoina	Formal
ennakkopäätöstä	Partitive
vihjattu	None
nuottikirjoituksessa	Essive+In
syntymäpaikan	Genitive
maanpakoon	Allative+In
partavettä	Partitive
johtajuutta	Partitive
huipetkoot	None
vuon	Genitive
liberalisoidumme	None
nukahdellee	None
biodiversiteetin	Genitive
uumenin	Instrumental
epikurolaista	Partitive
embryon	Genitive
vaimenevat	None
väestönkasvusta	Ablative+In
hävittäjälentokoneiden	Genitive
kongressiin	Allative+In
vapaauinneissa	Essive+In
laiskana	Formal
nukutetaan	None
hermosotiin	Allative+In
tallensin	None
vieraskielisissä	Essive+In
draamadokumentista	Ablative+In
suomettumisesta	Ablative+In
mielihyvän	Genitive
jättiläisistä	Ablative+In
kirjallisina	Formal
moninkertaistuvat	None
kaupallisilla	At+Essive
rantakanoihin	Allative+In
eteväksi	Translative
huonetta	Partitive
nationalistisen	None
äänitteisiin	Allative+In
puolustautuu	None
tragediaa	Partitive
harhaoppeihin	Allative+In
osaavan	None
evankeliseen	Allative+In
rokotetaan	None
klassikkoa	Partitive
kuluttaisivat	None
kansanomaisilla	At+Essive
velvollisuuksien	Genitive
talvikausina	Formal
pienennyksiksi	Translative
öljylähteitä	Partitive
sukelsi	None
koodattiin	None
vastaanottokeskukseen	Allative+In
uusiutuvaan	Allative+In
juontua	None
elokuvatuottajan	Genitive
vihjeeksi	Translative
narskauttanette	None
ulkonaliikkumiskiellon	Genitive
kolmosessa	Essive+In
vakuuttavaa	Partitive
WC-paperille	Allative+At
sääriluuhun	Allative+In
hammaslääkärien	Genitive
kengitämme	None
hallinnollisesta	Ablative+In
aatemaailmaa	Partitive
komissiota	Partitive
elektroniin	Allative+In
keskitettiin	None
pikkurikollisen	Genitive
ulkomaanosastolla	At+Essive
päätellä	None
yhteensopivien	None
saatettava	None
integroidaan	None
rästistä	Ablative+In
somensimme	None
hermopäätteistä	Ablative+In
allekirjoittamisesta	Ablative+In
havaitsee	None
selventää	None
emolevyille	Allative+At
maalaisjärjellä	At+Essive
siistimmin	Instrumental
kertoimilla	At+Essive
puhelinvastaajina	Formal
organologiana	Formal
napajään	Genitive
kertomina	Formal
ilmestykseen	Allative+In
paikkaisella	At+Essive
salamurhattu	None
tuberkuloottisia	Partitive
kyborgina	Formal
sisäpolitiikasta	Ablative+In
dekstrometorfaaneista	Ablative+In
nimeän	None
saarivaltioita	Partitive
lainehtii	None
peliteorian	Genitive
sektorista	Ablative+In
tutkimukselle	Allative+At
värjäisimme	None
väestönlaskennoissa	Essive+In
työväenpuolueella	At+Essive
isovoirouskussa	Essive+In
kaaosteorian	Genitive
rojalteista	Ablative+In
pyörinyt	None
tiesimme	None
tunneliin	Allative+In
halkovat	None
päivänvarjolle	Allative+At
osallistujaksi	Translative
sähinään	Allative+In
lastentarhojen	Genitive
kuloa	Partitive
tavuihin	Allative+In
palautteen	Genitive
sanon	None
kiinnostavaksi	Translative
katolilaisuuteen	Allative+In
opiskeluihin	Allative+In
samaistuvat	None
hallitsevaksi	Translative
orjantappurapensaikolla	At+Essive
reagoivat	None
vallata	None
edustalta	Ablative+At
sukunimenä	Formal
mullistuksiin	Allative+In
flavonolista	Ablative+In
epookin	Genitive
hiustenlähtöä	Partitive
hämmästyttänyt	None
mätänivät	None
kapeikkoon	Allative+In
tasapainoilisimme	None
hukkaamiskielloiksi	Translative
vastaaville	Allative+At
muuttuneissa	Essive+In
lähempänä	Formal
naapurimaita	Partitive
litteää	Partitive
käyttövoimaveron	Genitive
karttuvat	None
supan	Genitive
ylityksestä	Ablative+In
guldenin	Genitive
terassille	Allative+At
tutin	Genitive
anoppiloissa	Essive+In
limitettävä	None
joulupukeilta	Ablative+At
grafiikan	Genitive
kolmosella	At+Essive
murrettuja	Partitive
kykenivät	None
nostoja	Partitive
päivittäisellä	At+Essive
sylyissä	Essive+In
lainsuojattomia	Partitive
osmologioista	Ablative+In
laulava	None
yövartijan	Genitive
emännöi	None
biisameilla	At+Essive
tuulisähkön	Genitive
kursivoida	None
ydinvoimalaan	Allative+In
öljysi	None
radiokommunikaatiotta	Privative
korostettiin	None
herkistynevät	None
asennuksina	Formal
prismaa	Partitive
germaanisessa	Essive+In
rypistymättömän	None
eristetään	None
vuoristoa	Partitive
energisessä	Essive+In
liiallisuuksiin	Allative+In
apumieheksi	Translative
haaksirikkoisten	Genitive
kielinen	None
vastuulliseen	Allative+In
fossiileihin	Allative+In
pimeimpiin	Allative+In
isolaattikieliä	Partitive
jalaksen	Genitive
ripustimissa	Essive+In
työväenliikkeelle	Allative+At
vuonosta	Ablative+In
bulgaarien	Genitive
karuilla	At+Essive
imevät	None
vilustui	None
etääntykööt	None
maatiaismaisissa	Essive+In
perjantaista	Partitive
röntgenin	Genitive
kokkia	Partitive
typistää	None
kostavat	None
uppoava	None
arvokkaiksi	Translative
rintakuvaa	Partitive
historiankirjoituksesta	Ablative+In
listannut	None
vastavalitun	None
rupia	Partitive
jäävuorista	Ablative+In
vastustatte	None
laulajilta	Ablative+At
säilyttäneen	None
asennosta	Ablative+In
kolminkertaistakaamme	None
urheaksi	Translative
haluttujen	None
mystiikoissa	Essive+In
yhteiskunnalliselta	Ablative+At
melonnan	Genitive
pelastajille	Allative+At
lisäämme	None
skalaarin	Genitive
puhdistuksia	Partitive
porhoa	Partitive
häpyluun	Genitive
pyörähti	None
alajuoksulle	Allative+At
vihossa	Essive+In
autonhuolloiksi	Translative
ammatillisen	None
assosiaatioita	Partitive
testillä	At+Essive
matkatavaran	Genitive
käeltä	Ablative+At
valitsemisesta	Ablative+In
balttilaisten	None
vuoristoisten	None
maastojuoksuun	Allative+In
kyseenalaisin	Instrumental
harvennettiin	None
kiinan	Genitive
tiedeakatemiaa	Partitive
abstrakteilla	At+Essive
kovimman	None
unohdukselta	Ablative+At
kehittivät	None
häpäisyä	Partitive
punakuirille	Allative+At
avaruustieteiksi	Translative
miekkailun	Genitive
huolettoman	None
sävyttivät	None
julmaksi	Translative
saukkoja	Partitive
koalitioon	Allative+In
hävyttömän	None
kirjoittelivat	None
veivät	None
behavioristisen	None
ratapihalta	Ablative+At
varmennetaan	None
luovutuksista	Ablative+In
runoilijaksi	Translative
kansantasavallassa	Essive+In
hitsata	None
vaarantuu	None
marttyyrien	Genitive
yksinkertaiselle	Allative+At
gallialaisten	Genitive
koiraita	Partitive
elämäkerrallisen	None
kapuloilla	At+Essive
mystiikasta	Ablative+In
munin	None
anastanevat	None
lyhytaikaisessa	Essive+In
solakoita	Partitive
ensyklopedisesta	Ablative+In
keskiolutta	Partitive
hukkuisi	None
horroksessa	Essive+In
meksikolaisen	Genitive
pontimena	Formal
linjasi	None
komeja	Partitive
ahdettiin	None
nykyaikaisissa	Essive+In
etummaisen	None
kannusti	None
sovellan	None
säikähtivät	None
pääsyssä	Essive+In
humalistolta	Ablative+At
menoille	Allative+At
jamassa	Essive+In
ankarimman	None
kyynärpään	Genitive
muotoa	Partitive
otoksia	Partitive
mielialahäiriötä	Partitive
juutalaisvastaisen	None
rohkene	None
käskyn	Genitive
rauhallisten	None
fraktuuralla	At+Essive
rengaslajien	Genitive
uzbekin	Genitive
karua	Partitive
luonnonsuojelualueiksi	Translative
uhkaavista	Ablative+In
värjäytynyt	None
esimerkkiä	Partitive
pannukakkuja	Partitive
kukallisiksi	Translative
audiovisuaaliseen	Allative+In
rakettirepulla	At+Essive
selontekoja	Partitive
palautat	None
managerien	Genitive
väänsi	None
sitoivat	None
limaannun	None
asetonitriiliin	Allative+In
kirkonkelloista	Ablative+In
päde	None
säteilyannosta	Partitive
shania	Partitive
aasaa	Partitive
fosfolipidillä	At+Essive
jumalanpalveluksesta	Ablative+In
katkeaisimme	None
öljyterminaaleilta	Ablative+At
kristillisestä	Ablative+In
finaalina	Formal
näköpiirissä	Essive+In
käärmeen	Genitive
sorsastaisit	None
kadotuksen	Genitive
liittyy	None
hurskauksista	Ablative+In
tuliperäisestä	Ablative+In
pioneeria	Partitive
kypsensitte	None
voimassaolosta	Ablative+In
estein	Instrumental
kuitataan	None
sidekudosta	Partitive
eskadroonaa	Partitive
plasman	Genitive
salamia	Partitive
aloitella	None
boraanien	Genitive
järviruokoa	Partitive
saartoon	Allative+In
spiraalia	Partitive
ystävyysottelulla	At+Essive
hallintokoneistoa	Partitive
ystävällisen	None
tiesi	None
vedä	None
pigmenteillä	At+Essive
sekaannuksia	Partitive
adventistien	Genitive
konventiotta	Privative
puolikasta	Partitive
juutalaisvastaisia	Partitive
räjähdyksen	Genitive
kirjoitteiksi	Translative
tihentäisit	None
sisennettäisiin	None
töykimme	None
lainanantajilla	At+Essive
signaalinkäsittelyn	Genitive
soluelintä	Partitive
bakteriologian	Genitive
kopiointiin	Allative+In
teelehtien	Genitive
odotettuun	Allative+In
avaruuspukujen	Genitive
leikkauksesta	Ablative+In
kubistisina	Formal
urakehitykseen	Allative+In
osasivat	None
päämäärään	Allative+In
äänimäärien	Genitive
sulattavat	None
vuotoja	Partitive
elokuvamusiikista	Ablative+In
psykodynaamisen	None
kehitteillä	At+Essive
keinahtanee	None
veloitti	None
hevostallina	Formal
perättäistä	Partitive
kyyltä	Ablative+At
pahaenteisen	None
sisäplaneettojen	Genitive
byrokraattiseksi	Translative
virsun	Genitive
geofysikaalisen	None
hirveän	None
raskausmyrkytyksessä	Essive+In
kuuloista	Ablative+In
tyroksiinia	Partitive
tunteikkaan	None
pelaa	None
attentaateilta	Ablative+At
rangaistuksista	Ablative+In
sekavassa	Essive+In
poetiikan	Genitive
ideologiaksi	Translative
kristilliseksi	Translative
demarissa	Essive+In
numerologiaan	Allative+In
syytettä	Partitive
sontaa	Partitive
nirskunut	None
visioitu	None
vanhurskaan	None
japaninkurjilla	At+Essive
ystävällisiksi	Translative
lanseerata	None
teljetty	None
pakolaisiksi	Translative
merkittävistä	Ablative+In
pukeutuvat	None
keveämpää	Partitive
kannaksen	Genitive
piidioksidin	Genitive
tilaisuuteen	Allative+In
kansien	Genitive
johtopäätöksenä	Formal
lakeudesta	Ablative+In
hovimestarina	Formal
ydinjätteestä	Ablative+In
laillisiin	Allative+In
ihmisjoukkoineen	Comitative
niukoiksi	Translative
automaattisella	At+Essive
kruunauksesta	Ablative+In
skannasin	None
kymmenotteluun	Allative+In
editoria	Partitive
orjuutettu	None
innosta	None
häpyluulla	At+Essive
tulipalosta	Ablative+In
kauko-ohjaimelle	Allative+At
elottomiin	Allative+In
lisätä	None
jakeiden	Genitive
manipuloitu	None
laivaksi	Translative
turbiinin	Genitive
taloustilanteen	Genitive
nirsoilkoot	None
toimeksiantoja	Partitive
tulkitsijoista	Ablative+In
tilitoimistojen	Genitive
propagandaa	Partitive
lisätkää	None
lääketieteelliseksi	Translative
aiheuttanee	None
kantasolujen	Genitive
tropiikiksi	Translative
mainitse	None
asetoheksamidiä	Partitive
loivia	Partitive
ilmalaivoista	Ablative+In
sulkua	Partitive
vedalaisen	None
tunnisti	None
dokumenttielokuvien	Genitive
hälventää	None
tahdolla	At+Essive
luettavana	Formal
vedoksia	Partitive
poikkeavuutta	Partitive
ohraisten	None
teokselle	Allative+At
hitiksi	Translative
lähiseudulla	At+Essive
ytimellisille	Allative+At
maloninitriilissä	Essive+In
kuroa	None
katkaravun	Genitive
sissisodassa	Essive+In
sademetsien	Genitive
napajäältä	Ablative+At
törmäyksestä	Ablative+In
kikattanen	None
reformaatiota	Partitive
tuuban	Genitive
countrymusiikkia	Partitive
ihmiskeskeistä	Partitive
lähetettä	Partitive
geneettiseksi	Translative
kutyymeilla	At+Essive
kiihtyvyydeksi	Translative
käyvillä	At+Essive
arkkipiispojen	Genitive
kilpailukyvyn	Genitive
kantaslaavin	Genitive
kuvailkoot	None
vuosirenkaina	Formal
kahvinpavulla	At+Essive
bongata	None
lautakunnalla	At+Essive
murheita	Partitive
prioriteeteilta	Ablative+At
puuroudumme	None
vahingoituitte	None
myksomatooseilta	Ablative+At
fiktioksi	Translative
imitaatiota	Partitive
mahouksiin	Allative+In
taloudellisten	None
kansakoulujen	Genitive
rullaluistelun	Genitive
rokotettu	None
ensitanssijattarelta	Ablative+At
keisarillisesta	Ablative+In
piirittänyt	None
suuntaissärmiön	Genitive
kantasuomeen	Allative+In
kirjanpidosta	Ablative+In
myönteisten	None
petraan	Allative+In
pohjukassa	Essive+In
työttömyyteen	Allative+In
märkärakkulaksi	Translative
varteenotettavin	Instrumental
vaativille	Allative+At
managerilla	At+Essive
nykynäkymillä	At+Essive
republikaanina	Formal
kivennuoliaisineen	Comitative
huomenlahjoiksi	Translative
propagandasodalle	Allative+At
islamilaisella	At+Essive
viljana	Formal
poneiksi	Translative
talitinteiltä	Ablative+At
reviirin	Genitive
kaarteessa	Essive+In
näkemyksessä	Essive+In
jumbosijoissa	Essive+In
alkuaineille	Allative+At
eteläpohjalaisen	None
halstaroisin	None
kiistattomasta	Ablative+In
keihäistä	Ablative+In
nopeimmalla	At+Essive
kaavaa	None
koulutettava	None
hikan	Genitive
tökkii	None
levykeasemaa	Partitive
automaattisia	Partitive
huvipurren	Genitive
neuvoista	Ablative+In
käännöksiin	Allative+In
saagolta	Ablative+At
epäonnisen	None
breviaariolta	Ablative+At
virginianpeuroilta	Ablative+At
hytkähdytän	None
mikrotietokoneiden	Genitive
nälkiintyneitä	Partitive
suomalaistunut	None
hisahdat	None
luonnonfilosofiaan	Allative+In
basistia	Partitive
äänimäärässä	Essive+In
valehdella	None
kirjaimelliseen	Allative+In
tuottavuuden	Genitive
rikin	Genitive
tietoliikenteessä	Essive+In
hävinneessä	Essive+In
osavaltion	Genitive
käsikirjoittajina	Formal
muotoisessa	Essive+In
pekinginihmisistä	Ablative+In
tupaantuliaislahjoihin	Allative+In
vesiurheiluilla	At+Essive
rihlatulla	At+Essive
jarrutitte	None
isyysvapailla	At+Essive
eristävä	None
säänneltiin	None
epäyhtälön	Genitive
työllistyä	None
ampeerin	Genitive
kaukaisessa	Essive+In
sytyttämiseen	Allative+In
paikallisyhdistysten	Genitive
ohittaa	None
unohtaisi	None
korotettava	None
herut	None
survivalisteitta	Privative
huomautuksena	Formal
äkillisiä	Partitive
alitajuntaan	Allative+In
käsipalloa	Partitive
törmäät	None
stikkiä	Partitive
kilpailuetuna	Formal
heimolaisten	Genitive
havainnollistaa	None
poltettakoon	None
pekalle	Allative+At
parlamentaarikkoja	Partitive
apostoleina	Formal
tunkiolla	At+Essive
asuinrakennuksen	Genitive
käynnistämisestä	Ablative+In
toteutuneita	Partitive
metsäkeskuksiin	Allative+In
toimivasta	Ablative+In
käsiaseista	Ablative+In
kuivauksessa	Essive+In
silittelemme	None
uusnatsismia	Partitive
noudattamiseksi	Translative
taistelukenttien	Genitive
autoilusta	Ablative+In
korostavat	None
keskimääräisten	None
makuuhuoneessa	Essive+In
kamppailivat	None
oppositiolehdillä	At+Essive
abstraktien	None
tumpeloidaan	None
lääninrajan	Genitive
takaiskun	Genitive
voimamiehiä	Partitive
varjostimen	Genitive
vasaroisivat	None
myöhemmällä	At+Essive
grammassa	Essive+In
avartaa	None
sovhooseja	Partitive
estoisten	None
viroon	Allative+In
väestönlaskentaan	Allative+In
muuntui	None
kuuluisampia	Partitive
eunukkien	Genitive
koostua	None
ahdistushäiriöittä	Privative
nimekkäiden	None
vaarallisuudesta	Ablative+In
kerrostaloasunnon	Genitive
karstauksista	Ablative+In
lokomobiileineen	Comitative
eeltä	Ablative+At
aineellisessa	Essive+In
maustettu	None
nöyryyttävään	Allative+In
hummerista	Ablative+In
toistuviin	Allative+In
henkilöidyttäköön	None
hikihuokosia	Partitive
vanhanaikaiseksi	Translative
olympiamitalia	Partitive
kaupunginvaltuutetun	Genitive
vasta-aiheilta	Ablative+At
myrskyisen	None
muuttoliikkeestä	Ablative+In
hätätakilaan	Allative+In
kannattanee	None
draamaelokuvaa	Partitive
eläköidyttäisiin	None
ataraktisia	Partitive
vakioida	None
funktionäppäimeen	Allative+In
varsinaisilta	Ablative+At
jakelee	None
tähtikuviossa	Essive+In
niukoissa	Essive+In
misogyynisilla	At+Essive
suosittuihin	Allative+In
vahingoittuisi	None
hippejä	Partitive
uudehkoja	Partitive
kauppahalleja	Partitive
pyhiinvaelluksia	Partitive
jaostoina	Formal
vapauttaisivat	None
simpanssia	Partitive
turvataan	None
loppuvaiheiden	Genitive
kuluttajahintaindeksin	Genitive
peilasin	None
sojottaa	None
suojuslehtien	Genitive
hyönteistoukkia	Partitive
eheytitte	None
seinämaalauksin	Instrumental
frakkipaidoissa	Essive+In
puhdasoppisuutta	Partitive
osuuskassoja	Partitive
asettuu	None
opiskelupaikkaan	Allative+In
itsenäisissä	Essive+In
alleja	Partitive
kylmenivät	None
palkitsevia	Partitive
kungfutselaisuudesta	Ablative+In
seikkailukirjallisuuksilta	Ablative+At
rumpaliksi	Translative
heruu	None
syntymäpäivään	Allative+In
kilpailijalle	Allative+At
peitti	None
vasemmanpuoleista	Partitive
pistät	None
kerätä	None
juksataan	None
pilalle	Allative+At
lyhtyjä	Partitive
ankkurivarustukselle	Allative+At
moottorissa	Essive+In
ekstroja	Partitive
asuinalueista	Ablative+In
mopoiltava	None
tylsämielisyyttä	Partitive
vaihdannassa	Essive+In
venyvä	None
puutun	None
kiihdytti	None
lemmikkeinä	Formal
kaivettava	None
vinoa	Partitive
ränsistyivät	None
vaivojen	Genitive
modernismiin	Allative+In
suostuttava	None
raskasmetallilta	Ablative+At
ruuvitaltassa	Essive+In
lyijytettäneen	None
kehitysyhteistyön	Genitive
kaunonahkahaperoksi	Translative
kertoimiin	Allative+In
kulttuurisen	None
pirteänä	Formal
aktivisteilla	At+Essive
seljan	Genitive
latinaistettakoon	None
rintamalla	At+Essive
panettelusta	Ablative+In
ohjautuisi	None
tursuttaneen	None
fenomenalismin	Genitive
twistin	Genitive
etureunassa	Essive+In
etsi	None
lautamiehistön	Genitive
voidaan	None
laillisena	Formal
rusketuksessa	Essive+In
uskollisten	None
seksuaaliseen	Allative+In
psykiatriaa	Partitive
galvaanisessa	Essive+In
pavlovin	Instrumental
latva-artisokaksi	Translative
kastikkaalle	Allative+At
tyhjäkatseista	Partitive
liikunnalla	At+Essive
omaksu	None
epäselviksi	Translative
fruitieta	Partitive
hirvieläimistä	Ablative+In
yhtyeillä	At+Essive
arabeiksi	Translative
sulfiitteja	Partitive
erilaisuuteen	Allative+In
päämiehistä	Ablative+In
hyttysen	Genitive
äänitorvena	Formal
työmarkkinoita	Partitive
kokeneella	At+Essive
suuriruhtinaaksi	Translative
promillen	Genitive
kaksipaikkaista	Partitive
mahdollisilla	At+Essive
välkehtivät	None
kokoonpanolta	Ablative+At
todellisuudelle	Allative+At
moduulilla	At+Essive
arvomerkin	Genitive
kuivattavat	None
peruskallion	Genitive
äänestämistä	Partitive
öljytulojen	Genitive
tee	None
afrikaanin	Genitive
porttia	Partitive
invalidisoitava	None
ympäröidään	None
ruoppaukseksi	Translative
reseption	Genitive
spesifisiin	Allative+In
syövät	None
sitaateista	Ablative+In
kolumbiaanista	Partitive
värttinään	Allative+In
joulunajan	Genitive
lojuvat	None
majoittavat	None
tippuvat	None
opiskeluaikoina	Formal
heikentänyt	None
motivaattoreille	Allative+At
kuolemantansseiksi	Translative
miellyttää	None
goottia	Partitive
kuivimpina	Formal
langettivat	None
sivuuttanut	None
perhoshaavilta	Ablative+At
populaarimusiikin	Genitive
teljoina	Formal
liikanimen	Genitive
alkeellisten	None
torpedoida	None
elämänkertaa	Partitive
laiskiaisia	Partitive
vaunusepillä	At+Essive
keuhkoahtaumataudin	Genitive
osoituksia	Partitive
lopetettu	None
maailmanennätysaikaa	Partitive
kätkeytyy	None
natseilta	Ablative+At
värisokeutta	Partitive
negridin	Genitive
maastopalojen	Genitive
yhdyskuntia	Partitive
säveltäjälle	Allative+At
tähtäimiä	Partitive
liityin	None
rajamailta	Ablative+At
sumuisena	Formal
mainitsisi	None
suloisen	None
mukautumisen	Genitive
paikallistuisimme	None
hiekkamyrskyn	Genitive
tutkimisen	Genitive
älähtää	None
uhmaa	None
poliisivoimiin	Allative+In
suoramarkkinoinnin	Genitive
jääkiekkoilijalle	Allative+At
kuvataiteeseen	Allative+In
tuijaa	Partitive
löytäjänä	Formal
kellareita	Partitive
ripeän	None
reunaehdoilla	At+Essive
toimipaikassa	Essive+In
osioihin	Allative+In
kameroissa	Essive+In
gloriassa	Essive+In
kaksinpelistä	Ablative+In
oksaalihapoksi	Translative
lähestymistä	Partitive
seestyy	None
puuston	Genitive
kognitiivisten	None
tyytyväisen	None
keulakuvista	Ablative+In
suuonteloon	Allative+In
röyhyttäisit	None
magneettisuudella	At+Essive
elintarvikekorteille	Allative+At
identifioida	None
parapsykologiaa	Partitive
tunnistimilta	Ablative+At
levitettävä	None
vyöhykkeistä	Ablative+In
turbiineihin	Allative+In
skeptikkoja	Partitive
saarnannut	None
projektioppimisin	Instrumental
tarkimmin	Instrumental
binäärisiä	Partitive
katastrofeista	Ablative+In
täytytte	None
notkuttelette	None
sisarpuolen	Genitive
jauhoiseen	Allative+In
esikristilliseltä	Ablative+At
kysellään	None
peruskoulutuksen	Genitive
päärakennukseksi	Translative
tulkinnalle	Allative+At
kosmonautiksi	Translative
lainautunut	None
tutkimusmenetelmien	Genitive
lainsäädännössä	Essive+In
runoutta	Partitive
koneeksi	Translative
gangreenin	Genitive
kunnostautuu	None
välttyisi	None
pääteiden	Genitive
parlamentaarisen	None
formalistien	Genitive
lempeen	Allative+In
rypistyisi	None
julkisivuja	Partitive
kohorttien	Genitive
fiiliksellä	At+Essive
muutostöihin	Allative+In
nurjilta	Ablative+At
ohjattavuutta	Partitive
ilmiannettiin	None
kolmikolle	Allative+At
sijainteihin	Allative+In
nakuttanet	None
uskomattomuuksissa	Essive+In
siirtolohkareessa	Essive+In
manseja	Partitive
heltoista	Ablative+In
perusteellisia	Partitive
tietyistä	Ablative+In
roomalaistukaa	None
oligarkkeja	Partitive
ruokalassa	Essive+In
merkitsevänä	Formal
päätäntää	Partitive
uskollisina	Formal
tulipaloja	Partitive
moukaria	Partitive
ortouneksi	Translative
pöytävuoren	Genitive
hampaattoman	None
polki	None
gasellia	Partitive
hauraiden	None
sanomaa	Partitive
jäsennellä	None
useammanlaisin	Instrumental
hyperinflaation	Genitive
kumoaa	None
opiskellaan	None
leppymättömiä	Partitive
ansaitsi	None
raskaudenajalle	Allative+At
perusteeseen	Allative+In
kierrossa	Essive+In
mielihyvältä	Ablative+At
solissa	Essive+In
kestoperfektissä	Essive+In
aboa	Partitive
myönteisestä	Ablative+In
loukkasi	None
haudankaivajissa	Essive+In
käänteisen	None
mopoissa	Essive+In
kaakkoispuolella	At+Essive
halutuilla	At+Essive
vapaaehtoistyötä	Partitive
vaaleissa	Essive+In
intressiä	Partitive
ranskalaistanemme	None
litografioilla	At+Essive
kuvataiteista	Ablative+In
monofonisessa	Essive+In
kiertueelta	Ablative+At
epälikvidin	None
oppositiopuolueeksi	Translative
uudistuu	None
brändeistä	Ablative+In
viisikkoa	Partitive
seuralaiseksi	Translative
epäsiveälle	Allative+At
aristokraattisesta	Ablative+In
hymiöiden	Genitive
epäileviä	Partitive
kristillisinä	Formal
tonttuna	Formal
vetovoimien	Genitive
sokerivaahteratta	Privative
räminää	Partitive
ammennettu	None
tutkimuslaitoksista	Ablative+In
suojelusta	Ablative+In
kaivimen	Genitive
kuorosta	Ablative+In
äidinmaidoista	Ablative+In
diskreetin	None
vanhentua	None
geostationaarisen	None
formaatteihin	Allative+In
tankkaa	None
pallomaisten	None
höyrylaivoista	Ablative+In
selitetty	None
spekulanteista	Ablative+In
voittomaaliin	Allative+In
kaikenlaisessa	Essive+In
vetypommien	Genitive
relativistisessa	Essive+In
höyrymoottorilla	At+Essive
palstaan	Allative+In
serotoniinia	Partitive
kirpeytyy	None
työntekijälle	Allative+At
pääsykokeisiin	Allative+In
olkitöistä	Ablative+In
lisännee	None
imeytyy	None
tuollaista	Partitive
tunkevat	None
paranevat	None
kuluttava	None
pullottaa	None
lasitettu	None
palkinnolla	At+Essive
omaperäisen	None
äänikorteitta	Privative
ydinkärjillä	At+Essive
isoisän	Genitive
näköisen	None
väärinkäsitykseen	Allative+In
syntetisaattoreita	Partitive
väkivalloin	Instrumental
terapialla	At+Essive
avohoidossa	Essive+In
uusiutui	None
riippuvuuksilta	Ablative+At
parantaisit	None
sanketkoot	None
rahoitti	None
synkän	None
kosketti	None
lopputuotteiden	Genitive
taipumusta	Partitive
ystävällismielisten	None
feminiinisyyksille	Allative+At
päiväkoteja	Partitive
tutustui	None
kiharapäisinä	Formal
bumagoilta	Ablative+At
protokollia	Partitive
viikonloppuja	Partitive
sisäoppilaitoksia	Partitive
omannette	None
naimattomuutta	Partitive
taistelulta	Ablative+At
jälleenrakennusta	Partitive
haarautuvan	None
yksipuoluejärjestelmästä	Ablative+In
kustannettiin	None
jäättömiä	Partitive
psykiatrisesta	Ablative+In
tunnustellette	None
varoo	None
pohjavilloilta	Ablative+At
meneteltävä	None
pilariin	Allative+In
työttömyysastetta	Partitive
kaaridyyneille	Allative+At
epätarkkuusperiaatteen	Genitive
sivutyönä	Formal
vilkaise	None
aurinkokunnassa	Essive+In
lahtelaisten	Genitive
korjaamisitta	Privative
lokikirjan	Genitive
ojentautuisivat	None
paheita	Partitive
kehkesi	None
alituisen	None
älykkäitä	Partitive
tunturisillihaperojen	Genitive
absorboitunut	None
epäsuosion	Genitive
työttömyyden	Genitive
dietyyliamiinin	Genitive
kisasi	None
kompaktia	Partitive
tilana	Formal
harjulta	Ablative+At
toivotan	None
toteemipaaluja	Partitive
frigidiyksittä	Privative
poistumisesta	Ablative+In
impressionisteihin	Allative+In
jättiläisiksi	Translative
paloista	Ablative+In
miehittämättömän	Genitive
sionistisen	None
jättäisi	None
kirjautuvat	None
astatiinin	Genitive
myrkytti	None
tataareiksi	Translative
astatiineissa	Essive+In
monismin	Genitive
suurentelette	None
verilöylyihin	Allative+In
gaboninkyihin	Allative+In
ylläpidolle	Allative+At
talvehdi	None
ydinalueita	Partitive
kylkiluun	Genitive
toteutuneiden	None
upporikkaatta	Privative
jaosta	Partitive
verbeissä	Essive+In
hedettä	Partitive
loukkaantumisetta	Privative
ottotyttäriä	Partitive
vastahyökkäyksellä	At+Essive
permetriiniin	Allative+In
aritmetiikkaa	Partitive
elävästä	Ablative+In
tulvista	Ablative+In
vihjauksia	Partitive
onkijaan	Allative+In
häälynen	None
voittamattoman	None
vakiinnuttanut	None
komentajana	Formal
puratat	None
uhkauksiin	Allative+In
puolantava	None
korjaavat	None
behaviorismeilta	Ablative+At
ydinasevaltoihin	Allative+In
syötetään	None
sinkkuja	Partitive
rauhansopimuksen	Genitive
irlantilaisen	Genitive
eliminoin	None
pronssikautisten	None
vesileimauksista	Ablative+In
huuda	None
vedettävä	None
tropiikkiin	Allative+In
sopeutua	None
lukukauden	Genitive
hyökkääjiltä	Ablative+At
röntgenkuvissa	Essive+In
visailua	Partitive
kunnioittavia	Partitive
tontuille	Allative+At
roolissa	Essive+In
tavaratalolle	Allative+At
kiirehtisi	None
aallonpituusalueen	Genitive
preferenssejä	Partitive
kirjoittelin	None
verisuoneen	Allative+In
haaksirikkoutuivat	None
prosessinedellytyksenä	Formal
hattuihin	Allative+In
kuiduttanee	None
sähkötti	None
inspehtoriksi	Translative
kohteliaita	Partitive
uskotte	None
salanimillä	At+Essive
herkkäuskoisissa	Essive+In
miehittämättömiin	Allative+In
viihdyttää	None
työnarkomaanisten	None
kulmaminuutin	Genitive
huljauttaisivat	None
pitkäsoittoja	Partitive
koptereita	Partitive
lauluntekijöihin	Allative+In
näyttelevät	None
kasvilajeista	Ablative+In
harhailijan	Genitive
terminaalina	Formal
kojuissa	Essive+In
identifioi	None
keisariaikana	Formal
humanistisen	None
akkunana	Formal
edustajaa	Partitive
siiderin	Genitive
liepeillä	At+Essive
parlamentissa	Essive+In
kukonharjan	Genitive
moraalittomina	Formal
ongelmaa	Partitive
kivuliaiden	None
terapiasta	Ablative+In
uskoi	None
etsiytyvät	None
tablettia	Partitive
valitat	None
varistavat	None
ryövätä	None
parantuvat	None
kellopeleille	Allative+At
maailmansodissa	Essive+In
yliopistona	Formal
huurteen	Genitive
kansalliseepoksilta	Ablative+At
vepsää	Partitive
aumatkoon	None
litofyyteissä	Essive+In
välähtää	None
konfliktia	Partitive
kaupankäyntiä	Partitive
pikkuplaneettoihin	Allative+In
kamalaa	Partitive
matkaoppaiden	Genitive
syvensit	None
sorkkaraudan	Genitive
sumensin	None
saastuttaa	None
pidemmäksi	Translative
klikkauksen	Genitive
ruhtinaallisen	None
algoritmisen	None
virressä	Essive+In
lillui	None
ihmettelee	None
yksiulotteisen	None
hitsattu	None
lapsikuolleisuuteen	Allative+In
laudaturia	Partitive
kanadanpikkupäästäisten	Genitive
kukistumiseen	Allative+In
lääkityksineen	Comitative
puolustusmekanismia	Partitive
täplähyeenoissa	Essive+In
mangustein	Instrumental
potilaaseen	Allative+In
kuunteleva	None
käyttöjärjestelmissä	Essive+In
monistunevat	None
integroi	None
kiskonnasta	Ablative+In
jakkarana	Formal
saatavuutta	Partitive
säännöllisinä	Formal
puetaan	None
lasaretin	Genitive
proteiiniin	Allative+In
ammattiopistolla	At+Essive
ongelmasyöjinä	Formal
ympäristöksi	Translative
avaruuksissa	Essive+In
bakteereissa	Essive+In
aidossa	Essive+In
korokkeen	Genitive
koetaan	None
lähetteli	None
nauloja	Partitive
hopeaketuiksi	Translative
erottelivat	None
kiidätetään	None
kipattava	None
valtakunnansovittelijaksi	Translative
taikauskoon	Allative+In
äitivainajiksi	Translative
yökerhoja	Partitive
henkilökohtaisiin	Allative+In
eskimokuoveitta	Privative
binääriseksi	Translative
sinipunaisia	Partitive
eksoottisesta	Ablative+In
akustisessa	Essive+In
kultivoitakoon	None
valokeilasta	Ablative+In
huomautettiin	None
uskontotiedettä	Partitive
laistettu	None
roikkua	None
luokanopettajana	Formal
kuluttaa	None
kaikenkattavaan	Allative+In
toimeentulotukeen	Allative+In
italiankieliseen	Allative+In
jakselkoot	None
kaksipuolisen	None
immunometriselle	Allative+At
ihmetyttänyt	None
kaakaojauhetta	Partitive
kansakouluun	Allative+In
sieniruoille	Allative+At
itaalista	Partitive
englanniksi	Translative
myöhempinä	Formal
ilmavirtauksen	Genitive
sekakieltä	Partitive
yksinkertaistettiin	None
makin	Genitive
lauhkealta	Ablative+At
kuokkinette	None
leiripaikkana	Formal
ballerinakengille	Allative+At
geenituotteille	Allative+At
markkinatutkimuksen	Genitive
julkaise	None
sanoituksilla	At+Essive
löperyyksiltä	Ablative+At
kehittämisellä	At+Essive
muotoisille	Allative+At
suitsutuspuikoissa	Essive+In
tipan	Genitive
zsaarina	Formal
ankarissa	Essive+In
radiometrioina	Formal
kehuvat	None
massiiviseksi	Translative
indoeurooppalaista	Partitive
kätkee	None
lukijaa	Partitive
kevein	Instrumental
kovemman	None
murhaajista	Ablative+In
sinfonioista	Ablative+In
pähkinäpensaiden	Genitive
luonnonsuojelualueella	At+Essive
lattianhoitokoneina	Formal
heikentymättömästä	Ablative+In
kamarimusiikissa	Essive+In
virheellisyyksiä	Partitive
hippeihin	Allative+In
alkeellisia	Partitive
katseli	None
jatkoajassa	Essive+In
pyörtynyt	None
tienoissa	Essive+In
delegaattina	Formal
yksityistämisestä	Ablative+In
oikeina	Formal
vangituilta	Ablative+At
maisemakonttoreissa	Essive+In
pippureita	Partitive
yhtenäistä	Partitive
muovannut	None
laitat	None
luomisopin	Genitive
näytäntökauden	Genitive
kaulia	None
venyköön	None
tragikomedialle	Allative+At
kiinnittää	None
konepistoolin	Genitive
kaupunginteatterissa	Essive+In
asianomaisilla	At+Essive
päälausetta	Partitive
historiankirjoitukselle	Allative+At
ääripäissä	Essive+In
törmäisi	None
vahingoitta	Privative
saksaa	Partitive
maataloustieteen	Genitive
hyökkäsi	None
huutokauppojen	Genitive
tilejä	Partitive
asfaltoitu	None
seinävaatteessa	Essive+In
pekonia	Partitive
rynnäköi	None
tietäjistä	Ablative+In
tarinoiden	Genitive
lavantaudista	Ablative+In
haavikaa	None
sakotetaan	None
melkoisella	At+Essive
tipu	None
kovettuu	None
negatiivisuutena	Formal
datasiirtolaitteilta	Ablative+At
tahoihin	Allative+In
päätepisteistä	Ablative+In
protestantteja	Partitive
olennaiseen	Allative+In
liukumäen	Genitive
kontrastin	Genitive
homoseksuaaleille	Allative+At
fluoriloisteen	Genitive
perhepäivähoitajina	Formal
nivelakseleilla	At+Essive
kloroformin	Genitive
peruskoulutuksesta	Ablative+In
tarkastelevat	None
tulirokkoisen	None
skandinaavisiin	Allative+In
varhaiskeskiajalta	Ablative+At
maailmankausia	Partitive
riskitöntä	Partitive
minibaareissa	Essive+In
julkisivuna	Formal
suoltuisivat	None
hoputtakaa	None
varautuneiden	None
kotimaiseksi	Translative
seksileluille	Allative+At
allekirjoittajia	Partitive
koirarotuna	Formal
raivaamisen	Genitive
arvailen	None
sukunimeä	Partitive
onnistuin	None
vaalensi	None
perinnöllisistä	Ablative+In
maastopyöristä	Ablative+In
pernan	Genitive
lämmennyt	None
lavastuksessa	Essive+In
supikoiria	Partitive
sekundaarisesta	Ablative+In
menestyksekkäiksi	Translative
arabiaa	Partitive
jouhia	Partitive
järjestelyä	Partitive
oikeusjuttujen	Genitive
viimeisimpiä	Partitive
parahimmaksi	Translative
eritasoliittymiä	Partitive
mylväisyihin	Allative+In
säilyisivät	None
taideteoksista	Ablative+In
työlääksi	Translative
jyskiä	None
kohentunut	None
kunnallispolitiikan	Genitive
maisemakuvia	Partitive
toimivaksi	Translative
kavioiden	Genitive
hankkinut	None
yövilkalta	Ablative+At
watilla	At+Essive
valtionvelkaan	Allative+In
työsuhteiden	Genitive
tapattakoon	None
sortuivat	None
kavennettiin	None
yhteiskuntatieteisiin	Allative+In
perustellusta	Ablative+In
nappuloita	Partitive
ratkaisuehdotuksena	Formal
vihamielisyyksien	Genitive
tohdi	None
opistolla	At+Essive
hermoromahduksen	Genitive
hakemistoja	Partitive
reikäisille	Allative+At
niitettiin	None
surmiin	Allative+In
hylkivät	None
miekkoja	Partitive
animessa	Essive+In
viikonlopulle	Allative+At
leipomoissa	Essive+In
teknillisessä	Essive+In
kopioit	None
audiovisuaalisen	None
järkiperäiseen	Allative+In
bébéineen	Comitative
virkistystä	Partitive
salaseurojen	Genitive
murehtia	None
manierismin	Genitive
trollaa	None
elän	None
ilmentymänä	Formal
henkistyvät	None
kyllästyvä	None
budjetoikoot	None
johtua	None
hopeakyljettä	Privative
kiristettiin	None
tiivistymisvanana	Formal
ivata	None
flaamiksi	Translative
tunnistetun	None
kaukaisimmasta	Ablative+In
pukukoppiin	Allative+In
graafisista	Ablative+In
pienikokoiseksi	Translative
tunnetuiksi	Translative
peukaloista	Partitive
pompotatte	None
seoksina	Formal
vuokrauksen	Genitive
kiihtyneiltä	Ablative+At
takaraajan	Genitive
kielteisissä	Essive+In
tartuttavat	None
säilöön	Allative+In
kiinnostuneista	Ablative+In
lorota	None
peitenimenä	Formal
kulkisivat	None
tiedonsiirron	Genitive
mekkoja	Partitive
sumuksi	Translative
urheilulajien	Genitive
tislatulta	Ablative+At
tiedeakatemioiden	Genitive
ääniraidassa	Essive+In
ravunsyöjäkoirin	Instrumental
projektion	Genitive
virvelöivä	None
syrjittä	Privative
tuhoutuva	None
vuotojen	Genitive
tuntemattomaksi	Translative
metsittynevät	None
laillistanut	None
epäkiitollisuuksineen	Comitative
asukaspuiston	Genitive
siunatkoon	None
retoriikkaan	Allative+In
valtakunnansyyttäjistä	Ablative+In
muistilla	At+Essive
sinkoa	Partitive
liioitteli	None
poseeraa	None
erottava	None
bonuksissa	Essive+In
mykerön	Genitive
pännittäköön	None
keittokirjaan	Allative+In
hopeisin	Instrumental
tahdottomasta	Ablative+In
pakonomaista	Partitive
malariaan	Allative+In
anellaan	None
verkkopalveluissa	Essive+In
suolajärviä	Partitive
koliitein	Instrumental
etyylikarbamaattia	Partitive
tukinuitossa	Essive+In
tšekin	Genitive
yllättyy	None
peruutan	None
käskee	None
siroavat	None
siirtyi	None
kookoota	Partitive
herätteenä	Formal
ohjeineen	Comitative
majoitettiin	None
keitetystä	Ablative+In
näytettiin	None
kuluttavat	None
suuntasi	None
inkkareita	Partitive
neurologian	Genitive
lääketiedettä	Partitive
kantamaa	Partitive
poikkeamatta	Privative
pidätteli	None
oppaana	Formal
orkesterimontusta	Ablative+In
reaktiivisia	Partitive
kusimansessa	Essive+In
summauksesta	Ablative+In
balkaninsiepon	Genitive
tuskaili	None
aallonkorkeuden	Genitive
jääpalakoneilla	At+Essive
sisimpään	Allative+In
eukaryooteista	Ablative+In
kipeneissä	Essive+In
arkipäiväisiä	Partitive
peroksideja	Partitive
kaappaavat	None
mobiilipelejä	Partitive
ajelehtiva	None
risteytettiin	None
muinaiseksi	Translative
kampiakselilta	Ablative+At
herkkänahkaisesta	Ablative+In
kirjautuu	None
varpapurjetta	Partitive
kokan	Genitive
avustajaksi	Translative
sijaitsivat	None
jalkapallojoukkueista	Ablative+In
taitavien	None
louhitaan	None
juhannusaattona	Formal
kiteytyi	None
luottivat	None
pukuhuoneita	Partitive
vääntyvät	None
kirkkovaltuustossa	Essive+In
tähkylän	Genitive
saippuoita	None
tuoreelta	Ablative+At
hoituisi	None
vasan	Genitive
odottaisi	None
rivin	Genitive
muinaisnorjassa	Essive+In
taliaivolle	Allative+At
näppituntumalta	Ablative+At
kreikankielisiä	Partitive
faktaan	Allative+In
huollon	Genitive
nöyränä	Formal
atooppisessa	Essive+In
viikunoista	Ablative+In
tallon	None
erikoisalojen	Genitive
yhteytä	None
houruloitta	Privative
muotoisissa	Essive+In
halveerasi	None
luoteisosia	Partitive
keinokasteluun	Allative+In
vesiliukoisen	None
puolustusministeriksi	Translative
norsujen	Genitive
henkisestä	Ablative+In
suunnistajana	Formal
loitsuilla	At+Essive
itämerensuomalaiseen	Allative+In
rockiksi	Translative
alamaailmaa	Partitive
edellytetty	None
merovingiajoilla	At+Essive
levinneisyyden	Genitive
luotettu	None
kulkijoiksi	Translative
sisältää	None
päättäjäisiä	Partitive
kiireellisen	None
ulkomaita	Partitive
tyranniasta	Ablative+In
avausten	Genitive
testattiin	None
seuduilta	Ablative+At
asustetta	Partitive
arkeologeista	Ablative+In
maalitaulua	Partitive
ihailijaa	Partitive
liuottamiseen	Allative+In
omannut	None
autovuokraamolla	At+Essive
niveltyy	None
selkeämpiä	Partitive
biomassalla	At+Essive
alalahkoa	Partitive
keisarilliselta	Ablative+At
korvautunut	None
identtisinä	Formal
petoksena	Formal
palvaan	None
monimutkaisella	At+Essive
tahattoman	None
instansseissa	Essive+In
alkuvaihetta	Partitive
jänkäkoirineen	Comitative
pilkkoi	None
murtumasta	Ablative+In
tilien	Genitive
kohautti	None
aitaa	None
liikekannallepanon	Genitive
teeastiastoilla	At+Essive
lamauttava	None
sallisi	None
tietokonetekniikan	Genitive
kansallissosialististen	None
jalkakäytävällä	At+Essive
jälkeläisiltä	Ablative+At
ostettiin	None
haiskahtaa	None
siirrossa	Essive+In
kauriita	Partitive
tähtienvälisen	None
vesakkoina	Formal
työmarkkinoilla	At+Essive
pienimpänä	Formal
teokseksi	Translative
frankeista	Ablative+In
pyrähdyksiä	Partitive
liikenneonnettomuuksia	Partitive
havainnollisti	None
metodiksi	Translative
alieniksi	Translative
raekokoja	Partitive
ostossa	Essive+In
taistella	None
johdattavat	None
typistyi	None
muuntua	None
tieteenalana	Formal
vakuuttuivat	None
luodikkoihin	Allative+In
piikivestä	Ablative+In
muhennoksissa	Essive+In
antautuivat	None
vähensivät	None
huutava	None
nukalliselta	Ablative+At
lomakkeeseen	Allative+In
vaijeriin	Allative+In
savanninorsun	Genitive
määrättiin	None
suomentanut	None
luontaisen	None
valmistajaan	Allative+In
sopimuksella	At+Essive
runsaita	Partitive
ristikuulustelusta	Ablative+In
hyväntekeväisyysjärjestöä	Partitive
katodin	Genitive
hampparoivat	None
kyin	Instrumental
toivomuksena	Formal
guinealle	Allative+At
muuleja	Partitive
intiimin	None
asennettava	None
kurren	Genitive
tienoille	Allative+At
sitaatilla	At+Essive
vaurioitui	None
profeetallisen	None
figuriineja	Partitive
teologeihin	Allative+In
ilmoittautuivat	None
perinteenä	Formal
rationaalisuutta	Partitive
predikatiiveja	Partitive
tohtorina	Formal
nukahtavat	None
kaivostyöläisiä	Partitive
avaruuslennosta	Ablative+In
koteloissa	Essive+In
kerroksisesta	Ablative+In
pappilassa	Essive+In
kohensi	None
aikatauluineen	Comitative
suitsittakaa	None
adaptiivista	Partitive
kehota	None
kuljettajasta	Ablative+In
nielemistä	Partitive
sairastellut	None
rodusta	Ablative+In
lajiutumiselle	Allative+At
kaahailijoita	Partitive
riivasivat	None
sampoa	Partitive
paljasjalkaisten	None
siittimen	Genitive
diplomaattisessa	Essive+In
takaiseen	Allative+In
moduksista	Ablative+In
ankkuroivat	None
muovisella	At+Essive
alkydeista	Ablative+In
rauhanomaisesta	Ablative+In
äänestää	None
arktiseen	Allative+In
rutiininomaiselta	Ablative+At
hetiön	Genitive
kävijämäärään	Allative+In
etsit	None
staattisella	At+Essive
työviikkoon	Allative+In
öljytuotteista	Ablative+In
vastuullisessa	Essive+In
normalisoitu	None
yliluonnollisten	None
lisäyksiin	Allative+In
kasteesta	Ablative+In
ulottuvuudella	At+Essive
faabeleita	Partitive
pahoittaa	None
onnelaan	Allative+In
liikuttaa	None
instituuteilla	At+Essive
kationeiksi	Translative
vahventanee	None
neljännesfinaaleissa	Essive+In
puolustuksella	At+Essive
rengasmaiseen	Allative+In
tratin	Genitive
nutturoitta	Privative
kieltäviä	Partitive
naamioitunut	None
öljyvaroiksi	Translative
nokkosille	Allative+At
työväenpuolueesta	Ablative+In
estereihin	Allative+In
keisarillisine	Comitative
kuvotat	None
ratkottu	None
uurnan	Genitive
aortassa	Essive+In
kuvailtu	None
huolehti	None
seutuihin	Allative+In
piirtää	None
jauhojalkahaperoja	Partitive
vokaalivartalona	Formal
korjaamattomia	Partitive
trumpetistin	Genitive
murisi	None
rauniokaupungin	Genitive
kiinnitykseen	Allative+In
duuniin	Allative+In
vuodenajoista	Ablative+In
skandaalin	Genitive
sopivina	Formal
alhaiseen	Allative+In
slaavilaiseksi	Translative
murskasi	None
kiirastulen	Genitive
duetolla	At+Essive
sidottu	None
laillistuva	None
kaskeamisen	Genitive
alamaan	Genitive
ministerineuvoston	Genitive
filosofiseksi	Translative
maantieteellisestä	Ablative+In
kannattelee	None
hallitusmuotoa	Partitive
junavaunuja	Partitive
syytetystä	Ablative+In
kostolla	At+Essive
etsittäisiin	None
jäätelökoneissa	Essive+In
pelaisin	None
kappaleena	Formal
seurakunnille	Allative+At
kondensaatiossa	Essive+In
juridisen	None
oppositiopuolueista	Ablative+In
käärittiin	None
asianajotoimistolla	At+Essive
tervalepissä	Essive+In
atavismeille	Allative+At
hilloaisin	None
perustelin	None
radiumin	Genitive
kidutettuna	Formal
perinteeseen	Allative+In
vedottu	None
paleotsooisen	None
epäpuhtauksina	Formal
lahjoituksiin	Allative+In
epäröinyt	None
lausekkeilla	At+Essive
langetettu	None
alistuu	None
polkupyöristä	Ablative+In
kirjoitetuilla	At+Essive
kiintyy	None
atollien	Genitive
jäänmurtajaksi	Translative
riehakkaita	Partitive
menoin	Instrumental
koeajon	Genitive
älykkyysikiin	Allative+In
marihuanoissa	Essive+In
sitoutumattomien	None
nukutuslääkäreille	Allative+At
kiihotuksesta	Ablative+In
kuiskaajien	Genitive
arrowjuurilla	At+Essive
ansarin	Genitive
ilmaantua	None
maamassan	Genitive
dinaarin	Genitive
biopolttoaineita	Partitive
todistetta	Partitive
uudistanut	None
nyppivät	None
koristeluna	Formal
jumalaisia	Partitive
korkeusperäsintä	Partitive
vekseleiksi	Translative
kirjoituksessa	Essive+In
hautasi	None
kajon	Genitive
kuplaan	Allative+In
vihtoria	Partitive
kilpauinnissa	Essive+In
kovempia	Partitive
lupauksena	Formal
terveellisen	None
syttyy	None
nuorisoa	Partitive
siipisulkien	Genitive
psykoanalyyttisessa	Essive+In
lyhytaikaisten	None
nahkiaisia	Partitive
toista	None
aloitettu	None
vaadittu	None
muovikasseja	Partitive
groteskien	None
glamouria	Partitive
tuon	None
meikää	Partitive
laskutti	None
klaaneille	Allative+At
nahinoida	None
takeissa	Essive+In
apartheidia	Partitive
editointia	Partitive
ainoita	Partitive
kattavalla	At+Essive
kiireelliseksi	Translative
artikkeliin	Allative+In
yötaivaan	Genitive
väliseinien	Genitive
jumaloi	None
kiinnostavaan	Allative+In
niemimaalta	Ablative+At
alahuulen	Genitive
kiusausten	Genitive
haetaan	None
tehosteen	Genitive
virkistyi	None
rojaltin	Genitive
heiteltiin	None
teosofiaa	Partitive
jännäisit	None
kränättävä	None
pitävien	None
pahentaa	None
laimin	Genitive
kadeteista	Ablative+In
affiinimuunnosten	Genitive
lyöjän	Genitive
megasporiin	Allative+In
sieppauksista	Ablative+In
infektoida	None
äidittömyyksillä	At+Essive
puolueettomuuden	Genitive
kehotetaan	None
yksityistämisen	Genitive
geometrisuutta	Partitive
suorittimilla	At+Essive
tuhkalla	At+Essive
ilmeisessä	Essive+In
tarjoavat	None
lämäreiksi	Translative
konnektionismissa	Essive+In
luolamaalauksista	Ablative+In
parvina	Formal
menetellään	None
rikosylikonstaapeleiksi	Translative
katedraaliksi	Translative
pyhiinvaellusmatkalle	Allative+At
politiikalla	At+Essive
esittävä	None
balettikoulun	Genitive
samanlaisissa	Essive+In
lämpökäsittelyssä	Essive+In
mitata	None
jakelijana	Formal
henkisiä	Partitive
kysykää	None
korkeatasoiseen	Allative+In
peipon	Genitive
ylläpitämiseen	Allative+In
hajautettu	None
suvereeneine	Comitative
syljeneritystä	Partitive
siroteltiin	None
klubitakilla	At+Essive
levinneisyydestä	Ablative+In
hylkiä	None
mönkijällä	At+Essive
säveltäjää	Partitive
esittelevät	None
naljailkaa	None
virtahevoilla	At+Essive
tontteihin	Allative+In
riemukaaresta	Ablative+In
ryöstöjen	Genitive
yrityksinä	Formal
ostoskeskusten	Genitive
joutuvat	None
syntaksia	Partitive
moottorisahoja	Partitive
asteroidiin	Allative+In
riimien	Genitive
kaarteiden	Genitive
yllättyneen	None
nojannut	None
ohjelmistoyrityksen	Genitive
ateenalaisten	Genitive
häivy	None
muokkasivat	None
anniskelisit	None
jalkapalloilijaksi	Translative
tuskaisen	None
pidätettyinä	Formal
perinteestä	Ablative+In
hyllyltä	Ablative+At
utopistisen	None
käytte	None
futiksesta	Ablative+In
urologian	Genitive
tapahtuisivat	None
katsellut	None
hidastuisit	None
vaalipiiristä	Ablative+In
leireiltä	Ablative+At
digitaalisille	Allative+At
laulusarjoja	Partitive
rautaneitsyellä	At+Essive
pöytäsahoineen	Comitative
antautumisesta	Ablative+In
risteytyksistä	Ablative+In
heliboreiksi	Translative
epäluottamukseen	Allative+In
riemurasialta	Ablative+At
polaroitunette	None
tarkoitin	None
työskennellevät	None
lännenelokuvaa	Partitive
kepposilta	Ablative+At
syvennyksessä	Essive+In
tulipalloja	Partitive
pengerrettiin	None
halkeaman	Genitive
paloitellaan	None
hurstiin	Allative+In
veistänyt	None
vesileimatkoot	None
hyötykäytön	Genitive
poikkeavuuksissa	Essive+In
lineaariseksi	Translative
tilastokeskuksesta	Ablative+In
diagnosoinneilta	Ablative+At
vaarallisten	None
välineeksi	Translative
sisällöstä	Ablative+In
implantin	Genitive
myötäilee	None
osoittautunee	None
jätkänsakiksi	Translative
hopeamitalilla	At+Essive
hyveellisyyttä	Partitive
opaskoirien	Genitive
vaihtelevista	Ablative+In
metsittyi	None
lyttäsi	None
sponsoroi	None
ylenkatsonevat	None
syrjivän	None
puistolle	Allative+At
huumausainerikoksissa	Essive+In
jaksollisen	None
veneessä	Essive+In
ehtoolliseen	Allative+In
kunnoista	Ablative+In
pysähdyksistä	Ablative+In
taikauskoksi	Translative
tutkimustyötä	Partitive
diasporassa	Essive+In
halutuista	Ablative+In
vuolukivettä	Privative
tasattiin	None
katsojien	Genitive
sirkkelin	Genitive
kuroutunut	None
vaiettiin	None
korkin	Genitive
toimitalossa	Essive+In
traditioita	Partitive
typpihapon	Genitive
ääri-ilmiöihin	Allative+In
hippusina	Formal
yhteisymmärryksineen	Comitative
alppinistiin	Allative+In
harhauta	None
puskevat	None
purjehtimista	Partitive
potkaista	None
levennetty	None
ilmalaivaa	Partitive
aakkosellisen	None
typeryyden	Genitive
aikavälein	Instrumental
perussuomalaisiin	Allative+In
säleiköstä	Ablative+In
hangaariin	Allative+In
myönnetty	None
autoliikenteeseen	Allative+In
huomaamme	None
relativistisen	None
työttömien	Genitive
oudoksuisitte	None
rautatieasemien	Genitive
tiedostoihin	Allative+In
isäntämaata	Partitive
pyöritetään	None
ikärajaa	Partitive
infektioon	Allative+In
sensuroivat	None
pysähtyvät	None
loivassa	Essive+In
dataan	Allative+In
leijoissa	Essive+In
tähkässä	Essive+In
menestyisivät	None
kulkeutuu	None
parturin	Genitive
ilmoittautuvat	None
järjesteli	None
laitoshoitoon	Allative+In
romantikon	Genitive
kiinattaritta	Privative
siviilipalvelukseen	Allative+In
nimiavaruuksiin	Allative+In
influenssin	Genitive
lihottamisena	Formal
veturinkuljettajana	Formal
yksikäsitteiseltä	Ablative+At
päässälaskujen	Genitive
suukottanen	None
tekijänoikeusmerkeille	Allative+At
monitieteisen	None
revyyssä	Essive+In
suoriutunut	None
osallistujilla	At+Essive
kevättalvesta	Ablative+In
kuonaa	Partitive
mainostoimistoa	Partitive
installaation	Genitive
kartongille	Allative+At
pyykkipojille	Allative+At
örähtelevät	None
teoreetikkona	Formal
kontrastoikoot	None
rintamalle	Allative+At
legitiimin	None
mahdottomuudesta	Ablative+In
oikeudenkäytössä	Essive+In
keulapurjetta	Partitive
interglasiaalin	Genitive
kalkyylin	Genitive
epoksidin	Genitive
eristävät	None
poseerata	None
kilometritehtaaseen	Allative+In
punertavia	Partitive
työtapaturmien	Genitive
nuorisotyöstä	Ablative+In
paaleja	Partitive
keräsivät	None
häpeämättömän	None
rikoksina	Formal
spastikoiksi	Translative
astioilla	At+Essive
urheiluautolla	At+Essive
pelkäisi	None
yläosista	Ablative+In
sotkussa	Essive+In
arvolliseksi	Translative
pyörtänette	None
eläytyvät	None
kehittyneenä	Formal
loppupeliä	Partitive
korkeakoululla	At+Essive
diplomaattiseen	Allative+In
kynnysmatoitta	Privative
epätasaiseen	Allative+In
aikakoneen	Genitive
yhteiskoululla	At+Essive
hurrikaanina	Formal
kihnuttaisivat	None
koheloinevat	None
silitysraudalle	Allative+At
lääkintämiehiä	Partitive
hammaskiveä	Partitive
mopoja	Partitive
osallisista	Ablative+In
ylenkatsoa	None
epäselvistä	Ablative+In
kompromissien	Genitive
tanssimiseen	Allative+In
tarkentui	None
arponen	None
kevyessä	Essive+In
vierailtu	None
injektoidaan	None
testamentilla	At+Essive
pilkkasivat	None
lumivyöryjä	Partitive
kirjakielessä	Essive+In
huumeongelmia	Partitive
nuolin	None
museovirastosta	Ablative+In
kyti	None
väestörekisterin	Genitive
miehiseen	Allative+In
laskettava	None
rikkoisivat	None
vuosirenkain	Instrumental
painopisteeseen	Allative+In
koillisosassa	Essive+In
sulkeumien	Genitive
antoi	None
tullimaksuja	Partitive
vaatinut	None
korkeudelle	Allative+At
vaakasuoria	Partitive
yleisradion	Genitive
läpäistään	None
lastenkotia	Partitive
poimi	None
haluaisitte	None
lieventävä	None
kuristajatta	Privative
roikkui	None
kaunojalkaseitikkejä	Partitive
afrikankääpiöhaukkana	Formal
markkinoinnista	Ablative+In
joukkoitsemurhaan	Allative+In
absoluuttisia	Partitive
retkikunnassa	Essive+In
emmentalin	Genitive
puhelinkeskuksilla	At+Essive
täydensivät	None
kouristunee	None
kookoon	Genitive
lattajalasta	Ablative+In
normaaliaikaan	Allative+In
barrikadien	Genitive
pelotellaan	None
muutoksiin	Allative+In
gobeliineja	Partitive
kaupparekisteriin	Allative+In
ymmärrämme	None
miljöötä	Partitive
kaksinkamppailuun	Allative+In
soman	None
myrtykää	None
ehdokkuudelle	Allative+At
kriminologisesta	Ablative+In
toimialalla	At+Essive
kylpylöistä	Ablative+In
tärkkelyksestä	Ablative+In
enenevältä	Ablative+At
amatöörien	Genitive
minkälaisiin	Allative+In
sanktioiden	Genitive
apostoleiksi	Translative
lakeudelta	Ablative+At
arvottomampaan	Allative+In
hermosoluista	Ablative+In
hiekkaisessa	Essive+In
kuhnuksen	Genitive
innovaation	Genitive
kostuu	None
paaviudelle	Allative+At
petturiksi	Translative
tankkeriksi	Translative
putoksi	Translative
vesikasveja	Partitive
juhlittiin	None
määrätystä	Ablative+In
palopäällikkönä	Formal
kääritään	None
varjosta	Ablative+In
menestyksessä	Essive+In
sotilaallisesta	Ablative+In
raikkaimmista	Ablative+In
suojasäättä	Privative
huolestuttanut	None
fenomenologiaa	Partitive
ihmiskuntaa	Partitive
hinkannette	None
digitaalisiin	Allative+In
aloitettiin	None
edetään	None
tyylikkäänä	Formal
riittämätöntä	Partitive
perusteltava	None
keveämmiltä	Ablative+At
kardinaalilla	At+Essive
transistorien	Genitive
liikennöidä	None
meemien	Genitive
pihapiiristä	Ablative+In
lainoppineiden	Genitive
poltteleva	None
plektran	Genitive
jaarliksi	Translative
voidella	None
uhanalaisuuden	Genitive
siirrettiin	None
ilmiselviä	Partitive
kontrastia	Partitive
pluspuolen	Genitive
raideleveyteen	Allative+In
meikkivoiteesta	Ablative+In
tilanteesta	Ablative+In
leimasivat	None
epäinhimillisestä	Ablative+In
inhibiittoreille	Allative+At
etusivuilla	At+Essive
koripalloillee	None
luoteisosan	Genitive
vakavamielistä	Partitive
dystokioin	Instrumental
korkeakouluna	Formal
joukkueelle	Allative+At
vuosittaisessa	Essive+In
tallaannu	None
lähimmin	Instrumental
kahvikupilla	At+Essive
suihkuturbiinille	Allative+At
avaruutena	Formal
dokumentin	Genitive
miehennielijöiltä	Ablative+At
psykoterapiassa	Essive+In
öljyntuotantoa	Partitive
matemaattisella	At+Essive
pituuspiirien	Genitive
puutarhoineen	Comitative
vedenlaatua	Partitive
lävistyksen	Genitive
blogeissa	Essive+In
taloustieteenä	Formal
sekaantunut	None
hyadien	Genitive
aivotursoon	Allative+In
änkyrimadoiksi	Translative
elatusapua	Partitive
sotilaista	Ablative+In
draamaelokuvassa	Essive+In
sulatetaan	None
tuota	None
putoamisessa	Essive+In
vainulta	Ablative+At
limonaadein	Instrumental
päivätty	None
paskannettu	None
katkea	None
mestaruudessa	Essive+In
koherentteja	Partitive
virkistyksineen	Comitative
sandinisteja	Partitive
alistamisen	Genitive
diagnostiikaksi	Translative
palestiinalaisen	Genitive
luoteispuolelle	Allative+At
interaktiivisia	Partitive
rahjustettava	None
olutkulttuureitta	Privative
henkeäsalpaavina	Formal
moraalisuutta	Partitive
sakon	Genitive
kotisivujen	Genitive
kuljeskelijoille	Allative+At
kykyä	Partitive
tynnyrintekijöineen	Comitative
suostuttelivat	None
sovitun	None
vaihtelevaan	Allative+In
otavalla	At+Essive
muistuttava	None
pakanallisina	Formal
edellisille	Allative+At
häipynyt	None
arkistosta	Ablative+In
tekoälyjen	Genitive
emilehdessä	Essive+In
hulluudella	At+Essive
aivopestä	None
pyörteisyyttä	Partitive
kihtiin	Allative+In
kaukonäköisinä	Formal
häviöllä	At+Essive
vastakkaisten	None
metsäpeuroja	Partitive
perimmäisenä	Formal
geometriaa	Partitive
puolustautunut	None
miespuoliselle	Allative+At
ynseiden	None
läntisemmän	None
organismina	Formal
vähävaraisen	None
tappoivat	None
pellossa	Essive+In
säteilyttäkäämme	None
päivittäisissä	Essive+In
tauotamme	None
intresseistä	Ablative+In
itsenäisille	Allative+At
puhelinvaihteen	Genitive
loppupuolissa	Essive+In
harhaoppisten	None
kuolemanrangaistuksia	Partitive
tiedostoiksi	Translative
jyrkille	Allative+At
kalkkisälpineen	Comitative
verrattu	None
metsäisiä	Partitive
universaalien	None
vandalismista	Ablative+In
lumivuohta	Partitive
kangistuttaisimme	None
sotatarvikkeista	Ablative+In
vaadittava	None
mandariinilla	At+Essive
ostan	None
kognitiiviseen	Allative+In
lantanoidien	Genitive
odotusaikaa	Partitive
vedenalaisten	None
luvun	Genitive
viisumeita	Partitive
klassismin	Genitive
teoksiin	Allative+In
jymissyt	None
polttoainetankin	Genitive
eläinpsykologiassa	Essive+In
leikkipuistoa	Partitive
stressitilanteessa	Essive+In
kaasumaisia	Partitive
teemapuistoja	Partitive
pehmeäkantisina	Formal
kuvainraastajista	Ablative+In
uhrilehdoista	Ablative+In
mainoksessa	Essive+In
isommille	Allative+At
tangolla	At+Essive
lisäyksen	Genitive
vaikertakaa	None
kostoa	Partitive
suuntaviivoja	Partitive
assosiaatioiden	Genitive
näkyvissä	Essive+In
signaalista	Ablative+In
samanaikaisen	None
varastoa	Partitive
maailmantaloutta	Partitive
harmoniassa	Essive+In
pahamaineista	Partitive
sadevesien	Genitive
mafian	Genitive
korotusta	Partitive
kuilujen	Genitive
hiussuonten	Genitive
arvostelevien	None
levyttivät	None
apumiehistä	Ablative+In
ennusteli	None
kotipaikan	Genitive
traktoria	Partitive
auringonvalossa	Essive+In
viittauksiin	Allative+In
erikoisjoukkojen	Genitive
leijonalla	At+Essive
vastuuttomalle	Allative+At
osakekeinottelussa	Essive+In
pikkuveljelle	Allative+At
myötätunnon	Genitive
sfinksittä	Privative
kiilata	None
torpedoinut	None
olleille	Allative+At
tunnistetaan	None
pidempänä	Formal
traditionaalisten	None
dieeteillä	At+Essive
tornadoja	Partitive
työterveyshuollon	Genitive
napsi	None
saippuaoopperoiden	Genitive
ilmahyökkäystä	Partitive
jakauksissa	Essive+In
mahtaileva	None
rahayksikköä	Partitive
työskennellä	None
ajelisitte	None
epäloogisuutta	Partitive
eristäytykäämme	None
kuolinilmoituksen	Genitive
kotimaisin	Instrumental
voimistua	None
räikein	Instrumental
kaivautuu	None
skeptikkojen	Genitive
parantavien	None
moottoriveneisiin	Allative+In
mansikkaluomesta	Ablative+In
valikoitui	None
seikkailuista	Ablative+In
merkitsevän	None
viihtynyt	None
peittona	Formal
klassillisten	None
sopraanolle	Allative+At
istutuksia	Partitive
fiaskoille	Allative+At
ympäristöasioihin	Allative+In
haihtumisen	Genitive
hävitykseltä	Ablative+At
puristuvat	None
perustuslaeista	Ablative+In
estäjillä	At+Essive
kolikkoja	Partitive
lompakossa	Essive+In
aikaisempana	Formal
emulsion	Genitive
faijoilla	At+Essive
ikävystytän	None
ankarassa	Essive+In
pehmeältä	Ablative+At
rastaiden	Genitive
jurotin	None
tyydyttynyttä	Partitive
hohkasitte	None
betoniseen	Allative+In
viet	None
rajoita	None
maailmanlaajuisten	None
päätavoitteista	Ablative+In
elastomeereihin	Allative+In
haasteellisen	None
ruokakauppaa	Partitive
luotettavuutta	Partitive
taipuvia	Partitive
hiekkasärkillä	At+Essive
reservien	Genitive
pamflettien	Genitive
niukkaa	Partitive
kurjistui	None
ehdotuksissa	Essive+In
keksittyjen	None
resistanssiin	Allative+In
illalliselle	Allative+At
käännyttivät	None
interrailataan	None
siteerasi	None
kyitä	Partitive
kilpailijalla	At+Essive
ylentäisivät	None
synteettisiin	Allative+In
viileimmasta	Ablative+In
koraalein	Instrumental
asiantuntevan	None
katrilleja	Partitive
deittailkoot	None
arpisuuksilta	Ablative+At
stressillä	At+Essive
hyppypäästäisiltä	Ablative+At
kantajana	Formal
käyttöjärjestelmässä	Essive+In
filharmonikoissa	Essive+In
viivästyä	None
laskelmassa	Essive+In
aseettomien	None
salamiin	Allative+In
työntöaluksen	Genitive
lehdistön	Genitive
liuennutta	Partitive
työväenyhdistyksissä	Essive+In
pummilla	At+Essive
kartioleikkauksista	Ablative+In
tulijoiden	Genitive
käyttäytymisenä	Formal
sysäsi	None
luettavaksi	Translative
unohtumattoman	None
käytänteitä	Partitive
pölyn	Genitive
laajakaistan	Genitive
laskussa	Essive+In
sukkulabusseissa	Essive+In
ajastin	None
samaistaa	None
gnostilaisen	None
assimilaatiota	Partitive
rimpuilisitte	None
sain	None
hautajaisiin	Allative+In
abbedissana	Formal
otsikkojen	Genitive
korvattava	None
haitalliseksi	Translative
nimellistä	Partitive
jumalattareen	Allative+In
vaikeuttaa	None
yhteensopivia	Partitive
savukkeen	Genitive
niittyleinikkiin	Allative+In
impressionismia	Partitive
ruteniumia	Partitive
nyrkkeilijöin	Instrumental
pohjoissaamea	Partitive
närkästyy	None
käynnistyvä	None
eteisen	Genitive
kaupunkilaisten	Genitive
muistellut	None
eristyi	None
kannustavat	None
moottorilta	Ablative+At
alkoholirikoksessa	Essive+In
turvatyynyn	Genitive
harvenee	None
paviljonkeja	Partitive
julkistaa	None
muutettiin	None
etsauksen	Genitive
oikolukua	Partitive
käyttäköön	None
lihaa	Partitive
pussailuille	Allative+At
sävelestä	Ablative+In
tuotevalikoimaan	Allative+In
oikeiden	None
futurismia	Partitive
välttäisi	None
vaiheikkaan	None
geostrategisen	None
erkaantunut	None
naurunalaiseksi	Translative
hankasilmuista	Ablative+In
vetojuhtia	Partitive
epävakaalla	At+Essive
heikontanemme	None
energianlähteenä	Formal
suufilaisuutta	Partitive
aivopestään	None
juopunemme	None
huijauksiin	Allative+In
verensiirrossa	Essive+In
jännitetty	None
syntinä	Formal
hirviammunnan	Genitive
muruja	Partitive
pahimmiksi	Translative
militarismin	Genitive
geneettisestä	Ablative+In
kasvatin	Genitive
arkkitehdille	Allative+At
mistelin	Genitive
lintutieteellistä	Partitive
maailmankuvaa	Partitive
puna-apilassa	Essive+In
täyty	None
lusikkaa	Partitive
halvaannuttaa	None
kaislahameista	Ablative+In
muinaisille	Allative+At
painonnostoon	Allative+In
parametrista	Ablative+In
joenrannan	Genitive
arkkipiispalle	Allative+At
skaalaisitte	None
haistattelee	None
noloilta	Ablative+At
pääsarjojen	Genitive
koston	Genitive
sammon	Genitive
subjektiosana	Formal
kiehtoo	None
opetustauluja	Partitive
nido	None
esitettävä	None
asettautua	None
kipeää	Partitive
aloittajalla	At+Essive
positiivisten	None
punajättikengurusta	Ablative+In
parane	None
oksankantoina	Formal
purkkeihin	Allative+In
kursseihin	Allative+In
provosoidaan	None
seinämää	Partitive
koreografialla	At+Essive
neuroleptisittä	Privative
toimintaelokuvaksi	Translative
akateemisen	None
säiliöitä	Partitive
häiritse	None
mäyrälle	Allative+At
fenatsonitta	Privative
hevosvoimien	Genitive
kauhuelokuvaan	Allative+In
epäsuotuisaksi	Translative
valloitti	None
vaalikampanjan	Genitive
härkäpavun	Genitive
epätäydellisinä	Formal
itäisten	None
sointuun	Allative+In
järkevissä	Essive+In
paikallistavat	None
syrjäytyi	None
naistutkimuksen	Genitive
fidžinnettäisiin	None
välikorvaan	Allative+In
kehittäjäksi	Translative
kuulostanut	None
valonnopeudella	At+Essive
tuberkuloosiin	Allative+In
tukevamman	None
tiedostan	None
ohennettiin	None
proosakirjailijoista	Ablative+In
herttaa	Partitive
ratkaisuihin	Allative+In
edellytystä	Partitive
taitakoon	None
petoksiin	Allative+In
aktiivisuudessa	Essive+In
mielipuolisen	None
plaanaa	None
rajallisen	None
esittäisit	None
pigmenttinä	Formal
posliinikaupalle	Allative+At
varttuivat	None
hammasharjaan	Allative+In
auringonsäteiden	Genitive
ryöstäjien	Genitive
läpimurrossa	Essive+In
keksittyihin	Allative+In
palkkaa	Partitive
puistokatujen	Genitive
tunnustautui	None
soittaisimme	None
puistoa	Partitive
tunnisteena	Formal
itsekriittisille	Allative+At
neekerein	Instrumental
jaostona	Formal
maalivahdilla	At+Essive
asiaankuulumattomien	None
kulmahampaita	Partitive
bullassa	Essive+In
kulmaa	None
sähkövalon	Genitive
taloustieteellistä	Partitive
merellistä	Partitive
tietoisina	Formal
lintukoitta	Privative
lainasanoina	Formal
ankkurointimaksuna	Formal
muusan	Genitive
tarpeelliseksi	Translative
hienoisessa	Essive+In
lainalle	Allative+At
lepikkorouskujen	Genitive
kuopanteina	Formal
kierroksista	Ablative+In
alanurkkaan	Allative+In
selvennän	None
oksideja	Partitive
lähetyksillä	At+Essive
näytetty	None
alajuoksuun	Allative+In
käyttöönottoon	Allative+In
kineettisten	None
karskin	None
silmämunan	Genitive
ohrasuurimoa	Partitive
jäljennettiin	None
komiteassa	Essive+In
hakaristiä	Partitive
kumilenkeillä	At+Essive
vesiohenteisen	None
örähdellevät	None
tietosanakirjoille	Allative+At
kahvoilla	At+Essive
estimoida	None
samannäköisen	None
outokumpuun	Allative+In
kalakukkoa	Partitive
Kiina-keskisiin	Allative+In
tunnusomaisesta	Ablative+In
polon	Genitive
oraita	Partitive
legitiimille	Allative+At
huipputasoilla	At+Essive
pakottavien	None
kranaatinsirpaleineen	Comitative
diggaria	Partitive
käväissyt	None
byrokraattistettava	None
lintuharrastajilla	At+Essive
ympäröivän	None
kemiallisen	None
farmiseuraan	Allative+In
kaksinpeleissä	Essive+In
pääteaseman	Genitive
yhteistyössä	Essive+In
liikevaihtoveron	Genitive
lainvastaisitta	Privative
laillistuisi	None
vinyylilevyjen	Genitive
lähetystyöntekijän	Genitive
punoitusta	Partitive
paniikkikohtauksen	Genitive
auringonjumalan	Genitive
lomailee	None
pumpattakoon	None
partaveitsellä	At+Essive
sarveisainetta	Partitive
tarkka-ampujista	Ablative+In
psykologeista	Ablative+In
asteikolta	Ablative+At
mielenosoittajaa	Partitive
paikkakunnista	Ablative+In
kaventavat	None
kaksinkertaistuvat	None
juoksetteitta	Privative
kelpaa	None
miekkailijoita	Partitive
toiveikkaana	Formal
resoluutiota	Partitive
sähkötuolia	Partitive
ekonomistiksi	Translative
stratifikaatioin	Instrumental
endosytoosilla	At+Essive
migreenistä	Ablative+In
kolmenlaista	Partitive
piirretyllä	At+Essive
rauhoitu	None
huuhtoo	None
viikkolehtenä	Formal
tietolähteitä	Partitive
apotiksi	Translative
arvostelusta	Ablative+In
arkistunet	None
pronssimitaliin	Allative+In
mentoreina	Formal
kreikankielisestä	Ablative+In
ampumisella	At+Essive
hassulta	Ablative+At
rinnastanevat	None
sivujokien	Genitive
rahoituksesta	Ablative+In
luokiksi	Translative
delfiiniä	Partitive
sisällysluetteloa	Partitive
pintaintegraaliin	Allative+In
ulkoasiainvaliokunnassa	Essive+In
vangitsisi	None
varovaisena	Formal
meritaimenen	Genitive
vastaajista	Ablative+In
hyvälaatuista	Partitive
isojen	Genitive
tyttöystävästä	Ablative+In
leinosta	Ablative+In
niveltykää	None
tehopisteiden	Genitive
läimäyttää	None
internoivat	None
maailmanhistorialta	Ablative+At
käynnistyimme	None
havaitsivat	None
tukholmalaisen	None
keitettyjä	Partitive
uhrikiviä	Partitive
olennoille	Allative+At
naamioitua	None
erilaistuvat	None
tarmokkaana	Formal
tasapäistin	None
kokonaismäärään	Allative+In
ahtaiksi	Translative
irtisanoutui	None
kolkkaava	None
loukkaavalla	At+Essive
kanalisoituisin	None
kertaluonteisia	Partitive
radiohiiliajoituksen	Genitive
hollannin	Genitive
varsaa	Partitive
tukehduttaa	None
ärsyttävästä	Ablative+In
oppituolin	Genitive
kulkuvälineen	Genitive
koeteltu	None
kannaksesta	Ablative+In
elämänlaatuun	Allative+In
voimistelulla	At+Essive
rukouksista	Ablative+In
kasvilajeja	Partitive
liuenneita	Partitive
monikulmiolla	At+Essive
olympialaisten	Genitive
leveää	Partitive
saivartelijoin	Instrumental
liehakkaista	Ablative+In
italiassa	Essive+In
tabujen	Genitive
yötyölisälle	Allative+At
yhteyteen	Allative+In
asemoida	None
maaemon	Genitive
ukonputkella	At+Essive
äänestäjällä	At+Essive
arvasi	None
kätkeytynyt	None
mekaniikan	Genitive
adoptoi	None
hajustitte	None
kveekareihin	Allative+In
verrattiin	None
siveltimen	Genitive
kreivinarvotta	Privative
luostariin	Allative+In
haploideja	Partitive
suomenajokoirissa	Essive+In
pohjoismaiseksi	Translative
todenmukaisena	Formal
holttina	Formal
kuvalehden	Genitive
dippauskastikkeilta	Ablative+At
tyranniuksina	Formal
hymnologioitta	Privative
synnytti	None
kinata	None
jäädyttänyt	None
pumpattu	None
ulvoa	None
eviä	Partitive
vanhentuneen	None
kaksipäiväiselle	Allative+At
normaalilämpöisyydettä	Privative
hiljentää	None
irtautuvat	None
neuroplastisuuksien	Genitive
luolamaalausten	Genitive
ortokuviksi	Translative
uskomme	None
vahvistettujen	None
huudoista	Ablative+In
povekkaimmilta	Ablative+At
muututtava	None
länsimaissa	Essive+In
tiukempaa	Partitive
sedittelisi	None
laivannen	None
avosoiden	Genitive
syventynyt	None
letkujen	Genitive
monipuolistuttava	None
periytyivät	None
menestyksekästä	Partitive
veikkoa	Partitive
soisella	At+Essive
satiirina	Formal
meriarkeologioihin	Allative+In
jykeväleukaisessa	Essive+In
lääkärintarkastuksessa	Essive+In
jatkumoa	Partitive
autopaikkoja	Partitive
jättämällä	At+Essive
varuskuntiin	Allative+In
yhteismitattomia	Partitive
riippumattomuudesta	Ablative+In
biokemiallisten	None
viljelee	None
olemattomien	None
polvistuvat	None
neoliittisella	At+Essive
köynnöstävä	None
ahmittava	None
vuosirenkaita	Partitive
historioitsijaa	Partitive
sesto	None
eläintarhassa	Essive+In
rikkauksien	Genitive
jäniseläimistä	Ablative+In
vyöhykkeestä	Ablative+In
syrjäyttänyt	None
linjaksi	Translative
kollektiivisubstantiivina	Formal
kielitaidon	Genitive
skruudattaisiin	None
yksityiseen	Allative+In
tunkivat	None
tyhjentynevät	None
noteerannut	None
filharmonisen	None
hyörintänä	Formal
likasi	None
hiihdetty	None
saneerattiin	None
hallinnollista	Partitive
haluja	Partitive
imperialististen	None
stradivariuksen	Genitive
lentopalloon	Allative+In
avajaisten	Genitive
siniaalloin	Instrumental
salametsästystä	Partitive
korruptioon	Allative+In
kellonajasta	Ablative+In
transformoinee	None
altolle	Allative+At
keulahahmon	Genitive
pudotteleva	None
englantia	Partitive
kastetaan	None
euroiksi	Translative
runoudesta	Ablative+In
pikkuplaneetoiksi	Translative
purun	Genitive
katoliselta	Ablative+At
briljanttisormuksiin	Allative+In
tuuhentaisin	None
säästyivät	None
arktisissa	Essive+In
väriaineisiin	Allative+In
peremmäksi	Translative
laitakaupungin	Genitive
väitelty	None
miettinyt	None
splitattiin	None
romaanista	Ablative+In
syventyisitte	None
vasemmistoliitossa	Essive+In
mehevien	None
kommandiittiyhtiön	Genitive
rauhoitteli	None
seinustettava	None
maksakirroosien	Genitive
koliiniesteraasin	Genitive
aarniometsien	Genitive
vuottaa	None
rakastumista	Partitive
kyproslaisen	Genitive
snookereitta	Privative
puoskarin	Genitive
selvitti	None
sukunimeksi	Translative
jarrupolkimiin	Allative+In
kunnostanut	None
nopeimpien	None
hyödynnettäisiin	None
tunnettava	None
kellukkeen	Genitive
melaniinia	Partitive
käytävien	Genitive
äännetty	None
antikommunismin	Genitive
patriarkaattia	Partitive
parantelin	None
salasin	None
vyöttävät	None
käsikirjassa	Essive+In
vesiliukumäille	Allative+At
otteluvoittoon	Allative+In
koiraeläimistä	Ablative+In
turvattomien	None
onnelan	Genitive
selvityksestä	Ablative+In
yhdistyisivät	None
korkeakoulusta	Ablative+In
painotuotteita	Partitive
ruskuu	None
metallisen	None
pehmeään	Allative+In
ylittänyt	None
puolustajalla	At+Essive
resonanssissa	Essive+In
erehtymättömänä	Formal
valistunut	None
voimailijoiden	Genitive
geneeristen	None
koulutukseksi	Translative
taistelupanssarivaunua	Partitive
voikukkia	Partitive
painui	None
tiikin	Genitive
hiillostunette	None
kriisiksi	Translative
oikeistoenemmistöistä	Ablative+In
surmata	None
semmoisia	Partitive
librettoa	Partitive
kansallisena	Formal
rakensin	None
troppiin	Allative+In
käyttötarkoituksissa	Essive+In
fakkiutunevat	None
viikoittaisena	Formal
kumulatiivisen	None
trimmaavat	None
pesiytynyt	None
huijataan	None
lukkarista	Ablative+In
lännenelokuvista	Ablative+In
savannien	Genitive
luetteloitiin	None
ruotsinkielisessä	Essive+In
sanoituksineen	Comitative
unohtuisi	None
arkistoon	Allative+In
markkinapaikoilla	At+Essive
hyppäsin	None
mutkistuu	None
suuran	Genitive
yläasteena	Formal
kehittyisi	None
kohdennatte	None
ponnistelee	None
äänestävät	None
formula-autoja	Partitive
yritit	None
tilanteella	At+Essive
aivokuolleen	Genitive
departementeista	Ablative+In
malignisoiduitte	None
asteekeilla	At+Essive
pidettynä	Formal
verhoiluun	Allative+In
kituuttanen	None
vaikene	None
laiminlyöntiä	Partitive
arkkitehtuureille	Allative+At
jäädytettävä	None
diakonialta	Ablative+At
kymmenotteluineen	Comitative
kiitollisitta	Privative
kisoiksi	Translative
varapresidentiksi	Translative
malliin	Allative+In
kainuulaisen	Genitive
profiileja	Partitive
kiviainekseen	Allative+In
edistettiin	None
kestänyt	None
houssa	Essive+In
nostattanut	None
saamelaisia	Partitive
tilikautena	Formal
meemejä	Partitive
kasvillisuudessa	Essive+In
pullean	None
lentotukikohdista	Ablative+In
työntekijään	Allative+In
kansioiden	Genitive
osakeyhtiön	Genitive
eläinkaupoissa	Essive+In
solukosta	Ablative+In
teet	None
kuntotarkastuksilla	At+Essive
stationaarisen	None
solistien	Genitive
merivalloissa	Essive+In
kruunusta	Ablative+In
höyryvoimaan	Allative+In
sukulaisilta	Ablative+At
evoluutioteoriaa	Partitive
pidättäytyy	None
julkaisujen	Genitive
kissamakien	Genitive
säilyisi	None
komediana	Formal
vastahyökkäykselle	Allative+At
haalistakaa	None
jännitykseen	Allative+In
ratsioiden	Genitive
epäonnistumisen	Genitive
lämminveristen	None
odotettua	Partitive
tutkimuskeskukseen	Allative+In
uurasti	None
vähemmistöhallituksessa	Essive+In
kampaajan	Genitive
hematurioiksi	Translative
yrittäjiksi	Translative
poikkeavammille	Allative+At
mestaruuskilpailun	Genitive
plantaasilla	At+Essive
tiedustelijoiden	Genitive
ammoniumkloridin	Genitive
poikkihuilulle	Allative+At
aloittelevat	None
ainavihantaa	Partitive
vääristellyt	None
ylempien	None
muurahaissuosijoille	Allative+At
parantaisivat	None
loukkaukseen	Allative+In
sähkömekaanisen	None
ajankohtaistan	None
republikaanien	Genitive
haudanhäpäisyssä	Essive+In
länsiluoteeksi	Translative
laukova	None
aurinkokennojen	Genitive
vallankaappauksissa	Essive+In
kovettuvat	None
bumerangin	Genitive
albumeina	Formal
taseina	Formal
harhautettiin	None
zarathustralaisuutta	Partitive
transsin	Genitive
toteutua	None
pelästyi	None
malesialaisen	Genitive
moralistissa	Essive+In
väsymistä	Partitive
majaan	Allative+In
riimitellyt	None
luontoäideille	Allative+At
millaisten	None
toimita	None
metsäpeuraa	Partitive
siirtolaisten	Genitive
abatasepteiltä	Ablative+At
sisarpuolta	Partitive
interaktiivisuuksista	Ablative+In
toipuu	None
monikansalliseen	Allative+In
syödä	None
tarinankertojia	Partitive
pyöräillä	None
biosfäärialuetta	Partitive
esittelevä	None
huipentuvat	None
elokuvallista	Partitive
jäähdytyksillä	At+Essive
edunvalvonnasta	Ablative+In
vääristynyt	None
päivityksillä	At+Essive
lammassuojaan	Allative+In
lukemattomista	Ablative+In
lakastuu	None
vetivät	None
suurempia	Partitive
etsimiselle	Allative+At
osallistumisella	At+Essive
raittiusseuran	Genitive
hissilipuksi	Translative
inspiroida	None
juopotteli	None
lennättää	None
TE-keskukselta	Ablative+At
sähköttää	None
hävittämiseen	Allative+In
ominaisin	Instrumental
puolittui	None
estäjien	Genitive
stopilla	At+Essive
aikomuksesta	Ablative+In
tainnuttakoot	None
siirtymällä	At+Essive
onnisti	None
järkyttyi	None
dynastiaan	Allative+In
sisällissodasta	Ablative+In
lumettui	None
proksimaalisen	None
ulommaksi	Translative
eheydyttiin	None
välikäden	Genitive
puheaikaa	Partitive
uimahyppääjänä	Formal
meteorologiasta	Ablative+In
hajutonta	Partitive
biogeenisuuksille	Allative+At
proletariaatiksi	Translative
kaupparekisterissä	Essive+In
joutuisivat	None
muonituksesta	Ablative+In
murskata	None
osakemarkkinoilla	At+Essive
tarkoittivat	None
julkisena	Formal
klaanilla	At+Essive
elämäkerralliseen	Allative+In
aktiivisuudesta	Ablative+In
sokkopaarmoista	Ablative+In
kriminalisoituivat	None
tunnistettaisiin	None
ambulansseissa	Essive+In
ylitetään	None
vedettömänä	Formal
viemme	None
hyvyyden	Genitive
asvaltoinnilla	At+Essive
vakiinnutettiin	None
tulipalon	Genitive
kansanmurhien	Genitive
moottoreissa	Essive+In
inositoleina	Formal
pauloihin	Allative+In
kaksiulotteiseen	Allative+In
aikajärjestyksen	Genitive
ennakkoasenteineen	Comitative
tietynlaista	Partitive
gambiitista	Ablative+In
servereineen	Comitative
painokseen	Allative+In
moskeijan	Genitive
televisioelokuvissa	Essive+In
simpukan	Genitive
listasin	None
formalismissa	Essive+In
maalajitteessa	Essive+In
lintuinfluenssan	Genitive
kirjoituksia	Partitive
myrskyisää	Partitive
ulkopoliittisen	None
valtaapitävän	None
polkupyöräilyn	Genitive
hyväksytään	None
iloitsivat	None
asukaslukuun	Allative+In
kaivausta	Partitive
välskärinä	Formal
nimisiksi	Translative
tutkinnassa	Essive+In
taivaltaisitte	None
puolantanen	None
ohjaustangossa	Essive+In
kuvauksina	Formal
vaihteita	Partitive
maksullisen	None
raseemisille	Allative+At
vähemmistöillä	At+Essive
devonin	Genitive
lamakauden	Genitive
keskeneräisyydestä	Ablative+In
muodostukseen	Allative+In
osatekijöiden	Genitive
raketinheittimiä	Partitive
suominen	None
palkkasotilaana	Formal
opetuslapsista	Ablative+In
vaurioitua	None
ympäristöstä	Ablative+In
retuutatte	None
bluffattiin	None
ruplaan	Allative+In
ruisjauhoista	Ablative+In
ferriyhdistein	Instrumental
elintenluovutuksesta	Ablative+In
oopperalaulajiksi	Translative
ahjoa	Partitive
sovittautuisivat	None
äidinkielessä	Essive+In
jäntevän	None
ehdoin	Instrumental
bridgelle	Allative+At
shakkinappuloiden	Genitive
pelastustyöntekijöiden	Genitive
digitaalistaisimme	None
latentteine	Comitative
syvennetään	None
koralleista	Ablative+In
alkusoitolla	At+Essive
keisarillisissa	Essive+In
finniksi	Translative
Ges-duureja	Partitive
sähköisiin	Allative+In
turvallisuusneuvostoa	Partitive
nimekkään	None
diskomusiikin	Genitive
kaupunkimaisesta	Ablative+In
osakekaupoilla	At+Essive
aikalaisille	Allative+At
sisällytetään	None
kuunnelmana	Formal
pilvetöntä	Partitive
sukupolvelle	Allative+At
sanoittajineen	Comitative
istuskellet	None
puolustuksena	Formal
kuopattiin	None
kiinteistöveron	Genitive
siteisiin	Allative+In
notkelmassa	Essive+In
atomienergioilla	At+Essive
harrastelijoita	Partitive
nosteelta	Ablative+At
varpuja	Partitive
epäile	None
supertähdeksi	Translative
keilaajana	Formal
lihonut	None
kognitiivisella	At+Essive
tukahdutettiin	None
järjestelmäkameroita	Partitive
pistiäisiä	Partitive
muurahaiskekona	Formal
laiskoja	Partitive
toiminnallisuudesta	Ablative+In
sopuleita	Partitive
kutea	None
urhojen	Genitive
coveria	Partitive
astiaan	Allative+In
paletilla	At+Essive
varonen	None
muutoksilla	At+Essive
luonnonkatastrofien	Genitive
verkottunut	None
sekoa	Partitive
seremoniallisen	None
keihäänheiton	Genitive
kerin	Instrumental
poteva	None
kostautui	None
lehtipuista	Ablative+In
hivenaineiden	Genitive
temperamenttisena	Formal
onnettomimmille	Allative+At
romantisoi	None
